Year,UNITID,FACSTAT,ARANK,HRTOTLT,HRTOTLM,HRTOTLW
2021,100654,0,0,208,104,104
2021,100654,10,0,205,103,102
2021,100654,10,1,39,32,7
2021,100654,10,2,36,20,16
2021,100654,10,3,84,35,49
2021,100654,10,4,46,16,30
2021,100654,20,0,71,49,22
2021,100654,20,1,37,30,7
2021,100654,20,2,23,12,11
2021,100654,20,3,7,3,4
2021,100654,20,4,4,4,0
2021,100654,30,0,53,21,32
2021,100654,30,2,9,4,5
2021,100654,30,3,43,16,27
2021,100654,30,4,1,1,0
2021,100654,40,0,81,33,48
2021,100654,40,1,2,2,0
2021,100654,40,2,4,4,0
2021,100654,40,3,34,16,18
2021,100654,40,4,41,11,30
2021,100654,42,0,81,33,48
2021,100654,42,1,2,2,0
2021,100654,42,2,4,4,0
2021,100654,42,3,34,16,18
2021,100654,42,4,41,11,30
2021,100654,50,0,3,1,2
2021,100663,0,0,2603,1449,1154
2021,100663,10,0,2603,1449,1154
2021,100663,10,1,746,503,243
2021,100663,10,2,720,410,310
2021,100663,10,3,933,452,481
2021,100663,10,4,204,84,120
2021,100663,20,0,883,589,294
2021,100663,20,1,592,419,173
2021,100663,20,2,290,170,120
2021,100663,20,3,1,0,1
2021,100663,30,0,542,287,255
2021,100663,30,1,12,3,9
2021,100663,30,2,125,71,54
2021,100663,30,3,405,213,192
2021,100663,40,0,1178,573,605
2021,100663,40,1,142,81,61
2021,100663,40,2,305,169,136
2021,100663,40,3,527,239,288
2021,100663,40,4,204,84,120
2021,100663,42,0,1178,573,605
2021,100663,42,1,142,81,61
2021,100663,42,2,305,169,136
2021,100663,42,3,527,239,288
2021,100663,42,4,204,84,120
2021,100690,0,0,34,29,5
2021,100690,10,0,34,29,5
2021,100690,10,1,12,10,2
2021,100690,10,2,10,9,1
2021,100690,10,3,10,8,2
2021,100690,10,4,2,2,0
2021,100690,40,0,34,29,5
2021,100690,40,1,12,10,2
2021,100690,40,2,10,9,1
2021,100690,40,3,10,8,2
2021,100690,40,4,2,2,0
2021,100690,42,0,29,24,5
2021,100690,42,1,10,8,2
2021,100690,42,2,9,8,1
2021,100690,42,3,8,6,2
2021,100690,42,4,2,2,0
2021,100690,43,0,5,5,0
2021,100690,43,1,2,2,0
2021,100690,43,2,1,1,0
2021,100690,43,3,2,2,0
2021,100706,0,0,351,188,163
2021,100706,10,0,351,188,163
2021,100706,10,1,73,59,14
2021,100706,10,2,96,64,32
2021,100706,10,3,91,37,54
2021,100706,10,4,16,1,15
2021,100706,10,5,75,27,48
2021,100706,20,0,158,119,39
2021,100706,20,1,72,59,13
2021,100706,20,2,85,60,25
2021,100706,20,3,1,0,1
2021,100706,30,0,62,33,29
2021,100706,30,2,4,2,2
2021,100706,30,3,58,31,27
2021,100706,40,0,131,36,95
2021,100706,40,1,1,0,1
2021,100706,40,2,7,2,5
2021,100706,40,3,32,6,26
2021,100706,40,4,16,1,15
2021,100706,40,5,75,27,48
2021,100706,41,0,125,35,90
2021,100706,41,1,1,0,1
2021,100706,41,2,7,2,5
2021,100706,41,3,32,6,26
2021,100706,41,4,14,1,13
2021,100706,41,5,71,26,45
2021,100706,42,0,6,1,5
2021,100706,42,4,2,0,2
2021,100706,42,5,4,1,3
2021,100706,44,0,125,35,90
2021,100706,44,1,1,0,1
2021,100706,44,2,7,2,5
2021,100706,44,3,32,6,26
2021,100706,44,4,14,1,13
2021,100706,44,5,71,26,45
2021,100724,0,0,215,110,105
2021,100724,10,0,211,110,101
2021,100724,10,1,62,37,25
2021,100724,10,2,54,27,27
2021,100724,10,3,64,35,29
2021,100724,10,4,31,11,20
2021,100724,20,0,107,57,50
2021,100724,20,1,62,37,25
2021,100724,20,2,42,19,23
2021,100724,20,3,3,1,2
2021,100724,30,0,60,38,22
2021,100724,30,2,10,7,3
2021,100724,30,3,50,31,19
2021,100724,40,0,44,15,29
2021,100724,40,2,2,1,1
2021,100724,40,3,11,3,8
2021,100724,40,4,31,11,20
2021,100724,42,0,44,15,29
2021,100724,42,2,2,1,1
2021,100724,42,3,11,3,8
2021,100724,42,4,31,11,20
2021,100724,50,0,4,0,4
2021,100751,0,0,1557,835,722
2021,100751,10,0,1557,835,722
2021,100751,10,1,334,232,102
2021,100751,10,2,403,229,174
2021,100751,10,3,479,224,255
2021,100751,10,4,339,148,191
2021,100751,10,5,2,2,0
2021,100751,20,0,631,407,224
2021,100751,20,1,303,217,86
2021,100751,20,2,325,189,136
2021,100751,20,3,3,1,2
2021,100751,30,0,369,200,169
2021,100751,30,1,18,10,8
2021,100751,30,2,23,18,5
2021,100751,30,3,328,172,156
2021,100751,40,0,557,228,329
2021,100751,40,1,13,5,8
2021,100751,40,2,55,22,33
2021,100751,40,3,148,51,97
2021,100751,40,4,339,148,191
2021,100751,40,5,2,2,0
2021,100751,42,0,554,227,327
2021,100751,42,1,13,5,8
2021,100751,42,2,55,22,33
2021,100751,42,3,146,50,96
2021,100751,42,4,338,148,190
2021,100751,42,5,2,2,0
2021,100751,43,0,3,1,2
2021,100751,43,3,2,1,1
2021,100751,43,4,1,0,1
2021,100760,0,0,41,18,23
2021,100760,10,0,37,15,22
2021,100760,10,6,37,15,22
2021,100760,20,0,30,15,15
2021,100760,20,6,30,15,15
2021,100760,30,0,5,0,5
2021,100760,30,6,5,0,5
2021,100760,40,0,2,0,2
2021,100760,40,6,2,0,2
2021,100760,42,0,2,0,2
2021,100760,42,6,2,0,2
2021,100760,50,0,4,3,1
2021,100812,0,0,81,38,43
2021,100812,10,0,81,38,43
2021,100812,10,1,26,14,12
2021,100812,10,2,22,5,17
2021,100812,10,3,30,16,14
2021,100812,10,4,3,3,0
2021,100812,20,0,51,22,29
2021,100812,20,1,26,14,12
2021,100812,20,2,20,4,16
2021,100812,20,3,5,4,1
2021,100812,30,0,27,13,14
2021,100812,30,2,2,1,1
2021,100812,30,3,25,12,13
2021,100812,40,0,3,3,0
2021,100812,40,4,3,3,0
2021,100812,42,0,3,3,0
2021,100812,42,4,3,3,0
2021,100830,0,0,223,111,112
2021,100830,10,0,217,107,110
2021,100830,10,1,51,33,18
2021,100830,10,2,57,36,21
2021,100830,10,3,67,25,42
2021,100830,10,4,1,0,1
2021,100830,10,5,41,13,28
2021,100830,20,0,106,70,36
2021,100830,20,1,51,33,18
2021,100830,20,2,49,35,14
2021,100830,20,3,6,2,4
2021,100830,30,0,55,24,31
2021,100830,30,2,5,1,4
2021,100830,30,3,50,23,27
2021,100830,40,0,56,13,43
2021,100830,40,2,3,0,3
2021,100830,40,3,11,0,11
2021,100830,40,4,1,0,1
2021,100830,40,5,41,13,28
2021,100830,42,0,56,13,43
2021,100830,42,2,3,0,3
2021,100830,42,3,11,0,11
2021,100830,42,4,1,0,1
2021,100830,42,5,41,13,28
2021,100830,50,0,6,4,2
2021,100858,0,0,1443,843,600
2021,100858,10,0,1443,843,600
2021,100858,10,1,395,290,105
2021,100858,10,2,406,229,177
2021,100858,10,3,391,211,180
2021,100858,10,4,68,28,40
2021,100858,10,5,170,78,92
2021,100858,10,6,13,7,6
2021,100858,20,0,721,484,237
2021,100858,20,1,379,286,93
2021,100858,20,2,342,198,144
2021,100858,30,0,358,212,146
2021,100858,30,1,5,3,2
2021,100858,30,2,21,15,6
2021,100858,30,3,332,194,138
2021,100858,40,0,364,147,217
2021,100858,40,1,11,1,10
2021,100858,40,2,43,16,27
2021,100858,40,3,59,17,42
2021,100858,40,4,68,28,40
2021,100858,40,5,170,78,92
2021,100858,40,6,13,7,6
2021,100858,43,0,364,147,217
2021,100858,43,1,11,1,10
2021,100858,43,2,43,16,27
2021,100858,43,3,59,17,42
2021,100858,43,4,68,28,40
2021,100858,43,5,170,78,92
2021,100858,43,6,13,7,6
2021,100937,0,0,101,54,47
2021,100937,10,0,101,54,47
2021,100937,10,1,36,26,10
2021,100937,10,2,23,13,10
2021,100937,10,3,28,10,18
2021,100937,10,4,1,0,1
2021,100937,10,5,13,5,8
2021,100937,20,0,58,38,20
2021,100937,20,1,36,26,10
2021,100937,20,2,22,12,10
2021,100937,30,0,23,8,15
2021,100937,30,2,1,1,0
2021,100937,30,3,22,7,15
2021,100937,40,0,20,8,12
2021,100937,40,3,6,3,3
2021,100937,40,4,1,0,1
2021,100937,40,5,13,5,8
2021,100937,42,0,20,8,12
2021,100937,42,3,6,3,3
2021,100937,42,4,1,0,1
2021,100937,42,5,13,5,8
2021,101028,0,0,40,14,26
2021,101028,10,0,40,14,26
2021,101028,10,6,40,14,26
2021,101028,20,0,27,10,17
2021,101028,20,6,27,10,17
2021,101028,30,0,13,4,9
2021,101028,30,6,13,4,9
2021,101116,0,0,5,2,3
2021,101116,10,0,5,2,3
2021,101116,10,4,5,2,3
2021,101116,40,0,5,2,3
2021,101116,40,4,5,2,3
2021,101116,41,0,5,2,3
2021,101116,41,4,5,2,3
2021,101116,45,0,5,2,3
2021,101116,45,4,5,2,3
2021,101143,0,0,57,31,26
2021,101143,10,0,57,31,26
2021,101143,10,4,57,31,26
2021,101143,20,0,41,20,21
2021,101143,20,4,41,20,21
2021,101143,30,0,14,10,4
2021,101143,30,4,14,10,4
2021,101143,40,0,2,1,1
2021,101143,40,4,2,1,1
2021,101143,42,0,2,1,1
2021,101143,42,4,2,1,1
2021,101161,0,0,168,78,90
2021,101161,10,0,168,78,90
2021,101161,10,6,168,78,90
2021,101161,20,0,124,56,68
2021,101161,20,6,124,56,68
2021,101161,30,0,40,21,19
2021,101161,30,6,40,21,19
2021,101161,40,0,4,1,3
2021,101161,40,6,4,1,3
2021,101161,42,0,4,1,3
2021,101161,42,6,4,1,3
2021,101189,0,0,129,64,65
2021,101189,10,0,129,64,65
2021,101189,10,1,40,27,13
2021,101189,10,2,26,17,9
2021,101189,10,3,38,9,29
2021,101189,10,4,2,1,1
2021,101189,10,5,22,10,12
2021,101189,10,6,1,0,1
2021,101189,20,0,47,33,14
2021,101189,20,1,35,25,10
2021,101189,20,2,12,8,4
2021,101189,30,0,54,17,37
2021,101189,30,1,5,2,3
2021,101189,30,2,10,6,4
2021,101189,30,3,37,9,28
2021,101189,30,4,1,0,1
2021,101189,30,6,1,0,1
2021,101189,40,0,28,14,14
2021,101189,40,2,4,3,1
2021,101189,40,3,1,0,1
2021,101189,40,4,1,1,0
2021,101189,40,5,22,10,12
2021,101189,42,0,28,14,14
2021,101189,42,2,4,3,1
2021,101189,42,3,1,0,1
2021,101189,42,4,1,1,0
2021,101189,42,5,22,10,12
2021,101240,0,0,125,60,65
2021,101240,10,0,125,60,65
2021,101240,10,6,125,60,65
2021,101240,20,0,106,49,57
2021,101240,20,6,106,49,57
2021,101240,30,0,15,10,5
2021,101240,30,6,15,10,5
2021,101240,40,0,4,1,3
2021,101240,40,6,4,1,3
2021,101240,42,0,4,1,3
2021,101240,42,6,4,1,3
2021,101286,0,0,125,43,82
2021,101286,10,0,125,43,82
2021,101286,10,6,125,43,82
2021,101286,20,0,99,32,67
2021,101286,20,6,99,32,67
2021,101286,30,0,25,10,15
2021,101286,30,6,25,10,15
2021,101286,40,0,1,1,0
2021,101286,40,6,1,1,0
2021,101286,42,0,1,1,0
2021,101286,42,6,1,1,0
2021,101295,0,0,122,47,75
2021,101295,10,0,122,47,75
2021,101295,10,6,122,47,75
2021,101295,20,0,80,26,54
2021,101295,20,6,80,26,54
2021,101295,30,0,37,20,17
2021,101295,30,6,37,20,17
2021,101295,40,0,5,1,4
2021,101295,40,6,5,1,4
2021,101295,42,0,5,1,4
2021,101295,42,6,5,1,4
2021,101301,0,0,42,17,25
2021,101301,10,0,42,17,25
2021,101301,10,6,42,17,25
2021,101301,20,0,14,6,8
2021,101301,20,6,14,6,8
2021,101301,30,0,17,7,10
2021,101301,30,6,17,7,10
2021,101301,40,0,11,4,7
2021,101301,40,6,11,4,7
2021,101301,42,0,10,3,7
2021,101301,42,6,10,3,7
2021,101301,43,0,1,1,0
2021,101301,43,6,1,1,0
2021,101365,0,0,16,3,13
2021,101365,10,0,16,3,13
2021,101365,10,1,1,0,1
2021,101365,10,3,7,2,5
2021,101365,10,4,8,1,7
2021,101365,40,0,16,3,13
2021,101365,40,1,1,0,1
2021,101365,40,3,7,2,5
2021,101365,40,4,8,1,7
2021,101365,41,0,16,3,13
2021,101365,41,1,1,0,1
2021,101365,41,3,7,2,5
2021,101365,41,4,8,1,7
2021,101365,45,0,16,3,13
2021,101365,45,1,1,0,1
2021,101365,45,3,7,2,5
2021,101365,45,4,8,1,7
2021,101435,0,0,53,29,24
2021,101435,10,0,53,29,24
2021,101435,10,1,18,12,6
2021,101435,10,2,7,3,4
2021,101435,10,3,19,10,9
2021,101435,10,4,9,4,5
2021,101435,20,0,22,14,8
2021,101435,20,1,17,12,5
2021,101435,20,2,5,2,3
2021,101435,30,0,18,9,9
2021,101435,30,3,18,9,9
2021,101435,40,0,13,6,7
2021,101435,40,1,1,0,1
2021,101435,40,2,2,1,1
2021,101435,40,3,1,1,0
2021,101435,40,4,9,4,5
2021,101435,41,0,3,1,2
2021,101435,41,2,2,1,1
2021,101435,41,4,1,0,1
2021,101435,42,0,10,5,5
2021,101435,42,1,1,0,1
2021,101435,42,3,1,1,0
2021,101435,42,4,8,4,4
2021,101435,44,0,3,1,2
2021,101435,44,2,2,1,1
2021,101435,44,4,1,0,1
2021,101453,0,0,6,6,0
2021,101453,10,0,6,6,0
2021,101453,10,6,6,6,0
2021,101453,40,0,6,6,0
2021,101453,40,6,6,6,0
2021,101453,42,0,6,6,0
2021,101453,42,6,6,6,0
2021,101462,0,0,26,11,15
2021,101462,10,0,26,11,15
2021,101462,10,6,26,11,15
2021,101462,20,0,9,5,4
2021,101462,20,6,9,5,4
2021,101462,30,0,13,5,8
2021,101462,30,6,13,5,8
2021,101462,40,0,4,1,3
2021,101462,40,6,4,1,3
2021,101462,42,0,4,1,3
2021,101462,42,6,4,1,3
2021,101471,0,0,56,38,18
2021,101471,10,0,56,38,18
2021,101471,10,6,56,38,18
2021,101471,20,0,33,25,8
2021,101471,20,6,33,25,8
2021,101471,30,0,12,7,5
2021,101471,30,6,12,7,5
2021,101471,40,0,11,6,5
2021,101471,40,6,11,6,5
2021,101471,42,0,11,6,5
2021,101471,42,6,11,6,5
2021,101480,0,0,350,169,181
2021,101480,10,0,350,169,181
2021,101480,10,1,88,52,36
2021,101480,10,2,66,35,31
2021,101480,10,3,102,45,57
2021,101480,10,4,94,37,57
2021,101480,20,0,127,76,51
2021,101480,20,1,80,47,33
2021,101480,20,2,47,29,18
2021,101480,30,0,169,72,97
2021,101480,30,1,8,5,3
2021,101480,30,2,19,6,13
2021,101480,30,3,102,45,57
2021,101480,30,4,40,16,24
2021,101480,40,0,54,21,33
2021,101480,40,4,54,21,33
2021,101480,42,0,54,21,33
2021,101480,42,4,54,21,33
2021,101505,0,0,128,46,82
2021,101505,10,0,128,46,82
2021,101505,10,6,128,46,82
2021,101505,20,0,96,31,65
2021,101505,20,6,96,31,65
2021,101505,30,0,17,10,7
2021,101505,30,6,17,10,7
2021,101505,40,0,15,5,10
2021,101505,40,6,15,5,10
2021,101505,42,0,13,4,9
2021,101505,42,6,13,4,9
2021,101505,43,0,2,1,1
2021,101505,43,6,2,1,1
2021,101514,0,0,149,60,89
2021,101514,10,0,149,60,89
2021,101514,10,6,149,60,89
2021,101514,20,0,114,46,68
2021,101514,20,6,114,46,68
2021,101514,30,0,26,12,14
2021,101514,30,6,26,12,14
2021,101514,40,0,9,2,7
2021,101514,40,6,9,2,7
2021,101514,42,0,8,2,6
2021,101514,42,6,8,2,6
2021,101514,43,0,1,0,1
2021,101514,43,6,1,0,1
2021,101569,0,0,76,38,38
2021,101569,10,0,76,38,38
2021,101569,10,6,76,38,38
2021,101569,20,0,59,29,30
2021,101569,20,6,59,29,30
2021,101569,30,0,16,8,8
2021,101569,30,6,16,8,8
2021,101569,40,0,1,1,0
2021,101569,40,6,1,1,0
2021,101569,43,0,1,1,0
2021,101569,43,6,1,1,0
2021,101587,0,0,119,51,68
2021,101587,10,0,119,51,68
2021,101587,10,1,29,20,9
2021,101587,10,2,37,13,24
2021,101587,10,3,28,11,17
2021,101587,10,4,20,5,15
2021,101587,10,5,5,2,3
2021,101587,20,0,52,30,22
2021,101587,20,1,23,16,7
2021,101587,20,2,26,11,15
2021,101587,20,3,3,3,0
2021,101587,30,0,24,11,13
2021,101587,30,1,3,2,1
2021,101587,30,2,7,2,5
2021,101587,30,3,14,7,7
2021,101587,40,0,43,10,33
2021,101587,40,1,3,2,1
2021,101587,40,2,4,0,4
2021,101587,40,3,11,1,10
2021,101587,40,4,20,5,15
2021,101587,40,5,5,2,3
2021,101587,42,0,43,10,33
2021,101587,42,1,3,2,1
2021,101587,42,2,4,0,4
2021,101587,42,3,11,1,10
2021,101587,42,4,20,5,15
2021,101587,42,5,5,2,3
2021,101602,0,0,55,23,32
2021,101602,10,0,55,23,32
2021,101602,10,6,55,23,32
2021,101602,20,0,35,13,22
2021,101602,20,6,35,13,22
2021,101602,30,0,18,9,9
2021,101602,30,6,18,9,9
2021,101602,40,0,2,1,1
2021,101602,40,6,2,1,1
2021,101602,42,0,2,1,1
2021,101602,42,6,2,1,1
2021,101648,0,0,21,12,9
2021,101648,10,0,21,12,9
2021,101648,10,6,21,12,9
2021,101648,20,0,14,8,6
2021,101648,20,6,14,8,6
2021,101648,30,0,7,4,3
2021,101648,30,6,7,4,3
2021,101675,0,0,78,32,46
2021,101675,10,0,78,32,46
2021,101675,10,1,7,6,1
2021,101675,10,2,6,3,3
2021,101675,10,3,20,5,15
2021,101675,10,4,45,18,27
2021,101675,20,0,5,5,0
2021,101675,20,1,5,5,0
2021,101675,30,0,61,24,37
2021,101675,30,1,2,1,1
2021,101675,30,2,5,3,2
2021,101675,30,3,12,3,9
2021,101675,30,4,42,17,25
2021,101675,40,0,12,3,9
2021,101675,40,2,1,0,1
2021,101675,40,3,8,2,6
2021,101675,40,4,3,1,2
2021,101675,42,0,12,3,9
2021,101675,42,2,1,0,1
2021,101675,42,3,8,2,6
2021,101675,42,4,3,1,2
2021,101693,0,0,71,31,40
2021,101693,10,0,71,31,40
2021,101693,10,1,13,8,5
2021,101693,10,2,29,12,17
2021,101693,10,3,26,10,16
2021,101693,10,4,3,1,2
2021,101693,20,0,12,10,2
2021,101693,20,1,9,8,1
2021,101693,20,2,3,2,1
2021,101693,30,0,56,20,36
2021,101693,30,1,4,0,4
2021,101693,30,2,26,10,16
2021,101693,30,3,26,10,16
2021,101693,40,0,3,1,2
2021,101693,40,4,3,1,2
2021,101693,42,0,3,1,2
2021,101693,42,4,3,1,2
2021,101709,0,0,140,69,71
2021,101709,10,0,140,69,71
2021,101709,10,1,38,24,14
2021,101709,10,2,53,26,27
2021,101709,10,3,32,14,18
2021,101709,10,4,17,5,12
2021,101709,20,0,91,50,41
2021,101709,20,1,38,24,14
2021,101709,20,2,53,26,27
2021,101709,30,0,31,13,18
2021,101709,30,3,31,13,18
2021,101709,40,0,18,6,12
2021,101709,40,3,1,1,0
2021,101709,40,4,17,5,12
2021,101709,41,0,14,6,8
2021,101709,41,3,1,1,0
2021,101709,41,4,13,5,8
2021,101709,42,0,4,0,4
2021,101709,42,4,4,0,4
2021,101709,45,0,14,6,8
2021,101709,45,3,1,1,0
2021,101709,45,4,13,5,8
2021,101736,0,0,71,32,39
2021,101736,10,0,71,32,39
2021,101736,10,6,71,32,39
2021,101736,20,0,56,24,32
2021,101736,20,6,56,24,32
2021,101736,30,0,15,8,7
2021,101736,30,6,15,8,7
2021,101879,0,0,290,148,142
2021,101879,10,0,290,148,142
2021,101879,10,1,82,50,32
2021,101879,10,2,63,34,29
2021,101879,10,3,81,44,37
2021,101879,10,5,64,20,44
2021,101879,20,0,146,82,64
2021,101879,20,1,81,49,32
2021,101879,20,2,58,30,28
2021,101879,20,3,7,3,4
2021,101879,30,0,77,43,34
2021,101879,30,1,1,1,0
2021,101879,30,2,5,4,1
2021,101879,30,3,71,38,33
2021,101879,40,0,67,23,44
2021,101879,40,3,3,3,0
2021,101879,40,5,64,20,44
2021,101879,41,0,23,5,18
2021,101879,41,3,1,1,0
2021,101879,41,5,22,4,18
2021,101879,42,0,44,18,26
2021,101879,42,3,2,2,0
2021,101879,42,5,42,16,26
2021,101879,44,0,23,5,18
2021,101879,44,3,1,1,0
2021,101879,44,5,22,4,18
2021,101897,0,0,54,24,30
2021,101897,10,0,54,24,30
2021,101897,10,6,54,24,30
2021,101897,40,0,54,24,30
2021,101897,40,6,54,24,30
2021,101897,42,0,53,24,29
2021,101897,42,6,53,24,29
2021,101897,43,0,1,0,1
2021,101897,43,6,1,0,1
2021,101912,0,0,100,58,42
2021,101912,10,0,100,58,42
2021,101912,10,1,23,17,6
2021,101912,10,2,33,15,18
2021,101912,10,3,44,26,18
2021,101912,20,0,12,9,3
2021,101912,20,1,10,8,2
2021,101912,20,2,2,1,1
2021,101912,30,0,88,49,39
2021,101912,30,1,13,9,4
2021,101912,30,2,31,14,17
2021,101912,30,3,44,26,18
2021,101994,0,0,14,5,9
2021,101994,10,0,14,5,9
2021,101994,10,6,14,5,9
2021,101994,20,0,11,5,6
2021,101994,20,6,11,5,6
2021,101994,30,0,3,0,3
2021,101994,30,6,3,0,3
2021,102030,0,0,57,19,38
2021,102030,10,0,57,19,38
2021,102030,10,6,57,19,38
2021,102030,20,0,46,15,31
2021,102030,20,6,46,15,31
2021,102030,30,0,11,4,7
2021,102030,30,6,11,4,7
2021,102049,0,0,364,175,189
2021,102049,10,0,364,175,189
2021,102049,10,1,136,86,50
2021,102049,10,2,75,35,40
2021,102049,10,3,127,49,78
2021,102049,10,4,26,5,21
2021,102049,20,0,181,113,68
2021,102049,20,1,124,82,42
2021,102049,20,2,55,29,26
2021,102049,20,3,2,2,0
2021,102049,30,0,88,39,49
2021,102049,30,1,3,2,1
2021,102049,30,2,11,4,7
2021,102049,30,3,74,33,41
2021,102049,40,0,95,23,72
2021,102049,40,1,9,2,7
2021,102049,40,2,9,2,7
2021,102049,40,3,51,14,37
2021,102049,40,4,26,5,21
2021,102049,42,0,37,6,31
2021,102049,42,1,6,0,6
2021,102049,42,2,4,0,4
2021,102049,42,3,21,6,15
2021,102049,42,4,6,0,6
2021,102049,43,0,58,17,41
2021,102049,43,1,3,2,1
2021,102049,43,2,5,2,3
2021,102049,43,3,30,8,22
2021,102049,43,4,20,5,15
2021,102067,0,0,99,40,59
2021,102067,10,0,99,40,59
2021,102067,10,6,99,40,59
2021,102067,20,0,67,30,37
2021,102067,20,6,67,30,37
2021,102067,30,0,25,9,16
2021,102067,30,6,25,9,16
2021,102067,40,0,7,1,6
2021,102067,40,6,7,1,6
2021,102067,42,0,7,1,6
2021,102067,42,6,7,1,6
2021,102076,0,0,41,23,18
2021,102076,10,0,41,23,18
2021,102076,10,6,41,23,18
2021,102076,20,0,26,14,12
2021,102076,20,6,26,14,12
2021,102076,30,0,15,9,6
2021,102076,30,6,15,9,6
2021,102094,0,0,805,418,387
2021,102094,10,0,805,418,387
2021,102094,10,1,159,120,39
2021,102094,10,2,182,97,85
2021,102094,10,3,350,167,183
2021,102094,10,4,113,34,79
2021,102094,10,5,1,0,1
2021,102094,20,0,251,167,84
2021,102094,20,1,131,100,31
2021,102094,20,2,118,66,52
2021,102094,20,3,2,1,1
2021,102094,30,0,116,64,52
2021,102094,30,1,2,0,2
2021,102094,30,2,6,2,4
2021,102094,30,3,108,62,46
2021,102094,40,0,438,187,251
2021,102094,40,1,26,20,6
2021,102094,40,2,58,29,29
2021,102094,40,3,240,104,136
2021,102094,40,4,113,34,79
2021,102094,40,5,1,0,1
2021,102094,42,0,438,187,251
2021,102094,42,1,26,20,6
2021,102094,42,2,58,29,29
2021,102094,42,3,240,104,136
2021,102094,42,4,113,34,79
2021,102094,42,5,1,0,1
2021,102234,0,0,83,39,44
2021,102234,10,0,83,39,44
2021,102234,10,1,7,3,4
2021,102234,10,2,33,21,12
2021,102234,10,3,31,13,18
2021,102234,10,4,12,2,10
2021,102234,20,0,38,24,14
2021,102234,20,1,5,3,2
2021,102234,20,2,33,21,12
2021,102234,30,0,20,9,11
2021,102234,30,1,1,0,1
2021,102234,30,3,19,9,10
2021,102234,40,0,25,6,19
2021,102234,40,1,1,0,1
2021,102234,40,3,12,4,8
2021,102234,40,4,12,2,10
2021,102234,42,0,25,6,19
2021,102234,42,1,1,0,1
2021,102234,42,3,12,4,8
2021,102234,42,4,12,2,10
2021,102270,0,0,47,22,25
2021,102270,10,0,46,21,25
2021,102270,10,1,3,2,1
2021,102270,10,2,19,10,9
2021,102270,10,3,19,7,12
2021,102270,10,4,5,2,3
2021,102270,20,0,15,7,8
2021,102270,20,1,3,2,1
2021,102270,20,2,11,5,6
2021,102270,20,3,1,0,1
2021,102270,30,0,31,14,17
2021,102270,30,2,8,5,3
2021,102270,30,3,18,7,11
2021,102270,30,4,5,2,3
2021,102270,50,0,1,1,0
2021,102298,0,0,38,17,21
2021,102298,10,0,38,17,21
2021,102298,10,1,1,0,1
2021,102298,10,2,6,3,3
2021,102298,10,3,26,12,14
2021,102298,10,4,5,2,3
2021,102298,20,0,3,2,1
2021,102298,20,1,1,0,1
2021,102298,20,2,2,2,0
2021,102298,30,0,35,15,20
2021,102298,30,2,4,1,3
2021,102298,30,3,26,12,14
2021,102298,30,4,5,2,3
2021,102313,0,0,50,26,24
2021,102313,10,0,50,26,24
2021,102313,10,6,50,26,24
2021,102313,20,0,33,19,14
2021,102313,20,6,33,19,14
2021,102313,30,0,17,7,10
2021,102313,30,6,17,7,10
2021,102368,0,0,458,224,234
2021,102368,10,0,458,224,234
2021,102368,10,1,60,48,12
2021,102368,10,2,140,77,63
2021,102368,10,3,120,51,69
2021,102368,10,5,134,44,90
2021,102368,10,6,4,4,0
2021,102368,20,0,199,124,75
2021,102368,20,1,59,48,11
2021,102368,20,2,120,67,53
2021,102368,20,3,19,8,11
2021,102368,20,6,1,1,0
2021,102368,30,0,100,41,59
2021,102368,30,1,1,0,1
2021,102368,30,2,19,10,9
2021,102368,30,3,80,31,49
2021,102368,40,0,159,59,100
2021,102368,40,2,1,0,1
2021,102368,40,3,21,12,9
2021,102368,40,5,134,44,90
2021,102368,40,6,3,3,0
2021,102368,41,0,159,59,100
2021,102368,41,2,1,0,1
2021,102368,41,3,21,12,9
2021,102368,41,5,134,44,90
2021,102368,41,6,3,3,0
2021,102368,45,0,159,59,100
2021,102368,45,2,1,0,1
2021,102368,45,3,21,12,9
2021,102368,45,5,134,44,90
2021,102368,45,6,3,3,0
2021,102377,0,0,236,132,104
2021,102377,10,0,236,132,104
2021,102377,10,1,52,40,12
2021,102377,10,2,83,44,39
2021,102377,10,3,86,42,44
2021,102377,10,4,13,5,8
2021,102377,10,5,2,1,1
2021,102377,20,0,107,68,39
2021,102377,20,1,48,36,12
2021,102377,20,2,53,29,24
2021,102377,20,3,6,3,3
2021,102377,30,0,69,39,30
2021,102377,30,1,2,2,0
2021,102377,30,2,13,8,5
2021,102377,30,3,53,29,24
2021,102377,30,4,1,0,1
2021,102377,40,0,60,25,35
2021,102377,40,1,2,2,0
2021,102377,40,2,17,7,10
2021,102377,40,3,27,10,17
2021,102377,40,4,12,5,7
2021,102377,40,5,2,1,1
2021,102377,42,0,60,25,35
2021,102377,42,1,2,2,0
2021,102377,42,2,17,7,10
2021,102377,42,3,27,10,17
2021,102377,42,4,12,5,7
2021,102377,42,5,2,1,1
2021,102395,0,0,5,4,1
2021,102395,10,0,5,4,1
2021,102395,10,2,3,3,0
2021,102395,10,3,1,0,1
2021,102395,10,5,1,1,0
2021,102395,40,0,5,4,1
2021,102395,40,2,3,3,0
2021,102395,40,3,1,0,1
2021,102395,40,5,1,1,0
2021,102395,41,0,5,4,1
2021,102395,41,2,3,3,0
2021,102395,41,3,1,0,1
2021,102395,41,5,1,1,0
2021,102395,45,0,5,4,1
2021,102395,45,2,3,3,0
2021,102395,45,3,1,0,1
2021,102395,45,5,1,1,0
2021,102429,0,0,110,54,56
2021,102429,10,0,109,53,56
2021,102429,10,6,109,53,56
2021,102429,20,0,87,41,46
2021,102429,20,6,87,41,46
2021,102429,30,0,22,12,10
2021,102429,30,6,22,12,10
2021,102429,50,0,1,1,0
2021,102553,0,0,410,196,214
2021,102553,10,0,410,196,214
2021,102553,10,1,123,66,57
2021,102553,10,2,92,52,40
2021,102553,10,3,164,69,95
2021,102553,10,4,31,9,22
2021,102553,20,0,207,113,94
2021,102553,20,1,121,65,56
2021,102553,20,2,85,47,38
2021,102553,20,3,1,1,0
2021,102553,30,0,89,35,54
2021,102553,30,1,1,0,1
2021,102553,30,2,4,2,2
2021,102553,30,3,84,33,51
2021,102553,40,0,114,48,66
2021,102553,40,1,1,1,0
2021,102553,40,2,3,3,0
2021,102553,40,3,79,35,44
2021,102553,40,4,31,9,22
2021,102553,41,0,36,10,26
2021,102553,41,2,1,1,0
2021,102553,41,3,28,9,19
2021,102553,41,4,7,0,7
2021,102553,42,0,77,37,40
2021,102553,42,1,1,1,0
2021,102553,42,2,2,2,0
2021,102553,42,3,51,26,25
2021,102553,42,4,23,8,15
2021,102553,43,0,1,1,0
2021,102553,43,4,1,1,0
2021,102553,44,0,28,10,18
2021,102553,44,2,1,1,0
2021,102553,44,3,24,9,15
2021,102553,44,4,3,0,3
2021,102553,45,0,8,0,8
2021,102553,45,3,4,0,4
2021,102553,45,4,4,0,4
2021,102614,0,0,263,145,118
2021,102614,10,0,262,145,117
2021,102614,10,1,67,42,25
2021,102614,10,2,86,51,35
2021,102614,10,3,81,39,42
2021,102614,10,4,25,12,13
2021,102614,10,6,3,1,2
2021,102614,20,0,146,91,55
2021,102614,20,1,66,42,24
2021,102614,20,2,79,49,30
2021,102614,20,3,1,0,1
2021,102614,30,0,37,17,20
2021,102614,30,2,2,1,1
2021,102614,30,3,35,16,19
2021,102614,40,0,79,37,42
2021,102614,40,1,1,0,1
2021,102614,40,2,5,1,4
2021,102614,40,3,45,23,22
2021,102614,40,4,25,12,13
2021,102614,40,6,3,1,2
2021,102614,41,0,2,1,1
2021,102614,41,3,1,0,1
2021,102614,41,4,1,1,0
2021,102614,42,0,32,14,18
2021,102614,42,2,1,0,1
2021,102614,42,3,22,9,13
2021,102614,42,4,8,4,4
2021,102614,42,6,1,1,0
2021,102614,43,0,45,22,23
2021,102614,43,1,1,0,1
2021,102614,43,2,4,1,3
2021,102614,43,3,22,14,8
2021,102614,43,4,16,7,9
2021,102614,43,6,2,0,2
2021,102614,44,0,2,1,1
2021,102614,44,3,1,0,1
2021,102614,44,4,1,1,0
2021,102614,50,0,1,0,1
2021,102632,0,0,86,42,44
2021,102632,10,0,86,42,44
2021,102632,10,1,15,10,5
2021,102632,10,2,32,13,19
2021,102632,10,3,38,19,19
2021,102632,10,4,1,0,1
2021,102632,20,0,44,23,21
2021,102632,20,1,14,10,4
2021,102632,20,2,29,12,17
2021,102632,20,3,1,1,0
2021,102632,30,0,16,8,8
2021,102632,30,3,16,8,8
2021,102632,40,0,26,11,15
2021,102632,40,1,1,0,1
2021,102632,40,2,3,1,2
2021,102632,40,3,21,10,11
2021,102632,40,4,1,0,1
2021,102632,41,0,7,2,5
2021,102632,41,1,1,0,1
2021,102632,41,2,1,1,0
2021,102632,41,3,5,1,4
2021,102632,42,0,17,8,9
2021,102632,42,2,2,0,2
2021,102632,42,3,15,8,7
2021,102632,43,0,2,1,1
2021,102632,43,3,1,1,0
2021,102632,43,4,1,0,1
2021,102632,44,0,5,1,4
2021,102632,44,1,1,0,1
2021,102632,44,3,4,1,3
2021,102632,45,0,2,1,1
2021,102632,45,2,1,1,0
2021,102632,45,3,1,0,1
2021,102669,0,0,49,20,29
2021,102669,10,0,49,20,29
2021,102669,10,1,9,5,4
2021,102669,10,2,15,7,8
2021,102669,10,3,19,6,13
2021,102669,10,4,6,2,4
2021,102669,40,0,49,20,29
2021,102669,40,1,9,5,4
2021,102669,40,2,15,7,8
2021,102669,40,3,19,6,13
2021,102669,40,4,6,2,4
2021,102669,41,0,39,20,19
2021,102669,41,1,7,5,2
2021,102669,41,2,12,7,5
2021,102669,41,3,16,6,10
2021,102669,41,4,4,2,2
2021,102669,42,0,10,0,10
2021,102669,42,1,2,0,2
2021,102669,42,2,3,0,3
2021,102669,42,3,3,0,3
2021,102669,42,4,2,0,2
2021,102669,44,0,39,20,19
2021,102669,44,1,7,5,2
2021,102669,44,2,12,7,5
2021,102669,44,3,16,6,10
2021,102669,44,4,4,2,2
2021,102845,0,0,87,35,52
2021,102845,10,0,87,35,52
2021,102845,10,4,87,35,52
2021,102845,40,0,87,35,52
2021,102845,40,4,87,35,52
2021,102845,41,0,87,35,52
2021,102845,41,4,87,35,52
2021,102845,45,0,87,35,52
2021,102845,45,4,87,35,52
2021,103501,0,0,3,1,2
2021,103501,10,0,3,1,2
2021,103501,10,4,3,1,2
2021,103501,40,0,3,1,2
2021,103501,40,4,3,1,2
2021,103501,42,0,3,1,2
2021,103501,42,4,3,1,2
2021,103893,0,0,26,4,22
2021,103893,10,0,26,4,22
2021,103893,10,4,26,4,22
2021,103893,40,0,26,4,22
2021,103893,40,4,26,4,22
2021,103893,41,0,26,4,22
2021,103893,41,4,26,4,22
2021,103893,45,0,26,4,22
2021,103893,45,4,26,4,22
2021,103909,0,0,16,3,13
2021,103909,10,0,16,3,13
2021,103909,10,4,16,3,13
2021,103909,40,0,16,3,13
2021,103909,40,4,16,3,13
2021,103909,41,0,16,3,13
2021,103909,41,4,16,3,13
2021,103909,45,0,16,3,13
2021,103909,45,4,16,3,13
2021,103927,0,0,11,1,10
2021,103927,10,0,11,1,10
2021,103927,10,4,11,1,10
2021,103927,40,0,11,1,10
2021,103927,40,4,11,1,10
2021,103927,41,0,11,1,10
2021,103927,41,4,11,1,10
2021,103927,45,0,11,1,10
2021,103927,45,4,11,1,10
2021,104090,0,0,30,9,21
2021,104090,10,0,30,9,21
2021,104090,10,4,30,9,21
2021,104090,40,0,30,9,21
2021,104090,40,4,30,9,21
2021,104090,41,0,30,9,21
2021,104090,41,4,30,9,21
2021,104090,45,0,30,9,21
2021,104090,45,4,30,9,21
2021,104151,0,0,3279,1695,1584
2021,104151,10,0,3279,1695,1584
2021,104151,10,1,872,560,312
2021,104151,10,2,764,423,341
2021,104151,10,3,690,307,383
2021,104151,10,4,355,140,215
2021,104151,10,5,594,264,330
2021,104151,10,6,4,1,3
2021,104151,20,0,1373,857,516
2021,104151,20,1,735,495,240
2021,104151,20,2,637,362,275
2021,104151,20,3,1,0,1
2021,104151,30,0,474,255,219
2021,104151,30,2,20,16,4
2021,104151,30,3,454,239,215
2021,104151,40,0,1432,583,849
2021,104151,40,1,137,65,72
2021,104151,40,2,107,45,62
2021,104151,40,3,235,68,167
2021,104151,40,4,355,140,215
2021,104151,40,5,594,264,330
2021,104151,40,6,4,1,3
2021,104151,41,0,200,94,106
2021,104151,41,1,30,17,13
2021,104151,41,2,16,11,5
2021,104151,41,3,7,4,3
2021,104151,41,5,147,62,85
2021,104151,42,0,1232,489,743
2021,104151,42,1,107,48,59
2021,104151,42,2,91,34,57
2021,104151,42,3,228,64,164
2021,104151,42,4,355,140,215
2021,104151,42,5,447,202,245
2021,104151,42,6,4,1,3
2021,104151,44,0,200,94,106
2021,104151,44,1,30,17,13
2021,104151,44,2,16,11,5
2021,104151,44,3,7,4,3
2021,104151,44,5,147,62,85
2021,104160,0,0,118,60,58
2021,104160,10,0,118,60,58
2021,104160,10,6,118,60,58
2021,104160,40,0,118,60,58
2021,104160,40,6,118,60,58
2021,104160,42,0,118,60,58
2021,104160,42,6,118,60,58
2021,104179,0,0,2143,1220,923
2021,104179,10,0,2138,1218,920
2021,104179,10,1,796,540,256
2021,104179,10,2,536,302,234
2021,104179,10,3,498,231,267
2021,104179,10,4,77,31,46
2021,104179,10,5,231,114,117
2021,104179,20,0,1133,743,390
2021,104179,20,1,717,493,224
2021,104179,20,2,416,250,166
2021,104179,30,0,338,178,160
2021,104179,30,1,4,3,1
2021,104179,30,2,27,16,11
2021,104179,30,3,307,159,148
2021,104179,40,0,667,297,370
2021,104179,40,1,75,44,31
2021,104179,40,2,93,36,57
2021,104179,40,3,191,72,119
2021,104179,40,4,77,31,46
2021,104179,40,5,231,114,117
2021,104179,41,0,106,49,57
2021,104179,41,1,10,5,5
2021,104179,41,2,21,6,15
2021,104179,41,3,17,3,14
2021,104179,41,5,58,35,23
2021,104179,42,0,561,248,313
2021,104179,42,1,65,39,26
2021,104179,42,2,72,30,42
2021,104179,42,3,174,69,105
2021,104179,42,4,77,31,46
2021,104179,42,5,173,79,94
2021,104179,44,0,106,49,57
2021,104179,44,1,10,5,5
2021,104179,44,2,21,6,15
2021,104179,44,3,17,3,14
2021,104179,44,5,58,35,23
2021,104179,50,0,5,2,3
2021,104346,0,0,92,41,51
2021,104346,10,0,92,41,51
2021,104346,10,1,92,41,51
2021,104346,40,0,92,41,51
2021,104346,40,1,92,41,51
2021,104346,42,0,5,5,0
2021,104346,42,1,5,5,0
2021,104346,43,0,87,36,51
2021,104346,43,1,87,36,51
2021,104425,0,0,99,40,59
2021,104425,10,0,99,40,59
2021,104425,10,6,99,40,59
2021,104425,40,0,99,40,59
2021,104425,40,6,99,40,59
2021,104425,42,0,99,40,59
2021,104425,42,6,99,40,59
2021,104577,0,0,87,53,34
2021,104577,10,0,87,53,34
2021,104577,10,1,28,16,12
2021,104577,10,2,59,37,22
2021,104577,40,0,87,53,34
2021,104577,40,1,28,16,12
2021,104577,40,2,59,37,22
2021,104577,42,0,87,53,34
2021,104577,42,1,28,16,12
2021,104577,42,2,59,37,22
2021,104586,0,0,148,110,38
2021,104586,10,0,148,110,38
2021,104586,10,1,23,18,5
2021,104586,10,2,47,35,12
2021,104586,10,3,60,45,15
2021,104586,10,4,18,12,6
2021,104586,20,0,52,39,13
2021,104586,20,1,22,17,5
2021,104586,20,2,30,22,8
2021,104586,30,0,68,51,17
2021,104586,30,1,1,1,0
2021,104586,30,2,15,12,3
2021,104586,30,3,52,38,14
2021,104586,40,0,28,20,8
2021,104586,40,2,2,1,1
2021,104586,40,3,8,7,1
2021,104586,40,4,18,12,6
2021,104586,42,0,28,20,8
2021,104586,42,2,2,1,1
2021,104586,42,3,8,7,1
2021,104586,42,4,18,12,6
2021,104708,0,0,263,118,145
2021,104708,10,0,263,118,145
2021,104708,10,6,263,118,145
2021,104708,20,0,185,87,98
2021,104708,20,6,185,87,98
2021,104708,30,0,57,23,34
2021,104708,30,6,57,23,34
2021,104708,40,0,21,8,13
2021,104708,40,6,21,8,13
2021,104708,42,0,16,5,11
2021,104708,42,6,16,5,11
2021,104708,43,0,5,3,2
2021,104708,43,6,5,3,2
2021,104717,0,0,516,226,290
2021,104717,10,0,516,226,290
2021,104717,10,1,23,13,10
2021,104717,10,2,37,19,18
2021,104717,10,3,89,41,48
2021,104717,10,4,343,149,194
2021,104717,10,5,10,4,6
2021,104717,10,6,14,0,14
2021,104717,20,0,4,3,1
2021,104717,20,1,2,2,0
2021,104717,20,2,1,1,0
2021,104717,20,3,1,0,1
2021,104717,40,0,512,223,289
2021,104717,40,1,21,11,10
2021,104717,40,2,36,18,18
2021,104717,40,3,88,41,47
2021,104717,40,4,343,149,194
2021,104717,40,5,10,4,6
2021,104717,40,6,14,0,14
2021,104717,41,0,220,82,138
2021,104717,41,1,1,0,1
2021,104717,41,2,9,1,8
2021,104717,41,3,13,3,10
2021,104717,41,4,183,78,105
2021,104717,41,6,14,0,14
2021,104717,42,0,292,141,151
2021,104717,42,1,20,11,9
2021,104717,42,2,27,17,10
2021,104717,42,3,75,38,37
2021,104717,42,4,160,71,89
2021,104717,42,5,10,4,6
2021,104717,45,0,220,82,138
2021,104717,45,1,1,0,1
2021,104717,45,2,9,1,8
2021,104717,45,3,13,3,10
2021,104717,45,4,183,78,105
2021,104717,45,6,14,0,14
2021,105145,0,0,112,38,74
2021,105145,10,0,101,35,66
2021,105145,10,6,101,35,66
2021,105145,20,0,59,24,35
2021,105145,20,6,59,24,35
2021,105145,30,0,40,11,29
2021,105145,30,6,40,11,29
2021,105145,40,0,2,0,2
2021,105145,40,6,2,0,2
2021,105145,42,0,1,0,1
2021,105145,42,6,1,0,1
2021,105145,43,0,1,0,1
2021,105145,43,6,1,0,1
2021,105145,50,0,11,3,8
2021,105154,0,0,290,134,156
2021,105154,10,0,290,134,156
2021,105154,10,6,290,134,156
2021,105154,20,0,205,95,110
2021,105154,20,6,205,95,110
2021,105154,30,0,56,22,34
2021,105154,30,6,56,22,34
2021,105154,40,0,29,17,12
2021,105154,40,6,29,17,12
2021,105154,42,0,26,15,11
2021,105154,42,6,26,15,11
2021,105154,43,0,3,2,1
2021,105154,43,6,3,2,1
2021,105206,0,0,75,35,40
2021,105206,10,0,75,35,40
2021,105206,10,4,75,35,40
2021,105206,40,0,75,35,40
2021,105206,40,4,75,35,40
2021,105206,42,0,75,35,40
2021,105206,42,4,75,35,40
2021,105215,0,0,26,26,0
2021,105215,50,0,26,26,0
2021,105297,0,0,63,43,20
2021,105297,10,0,63,43,20
2021,105297,10,1,12,8,4
2021,105297,10,2,16,12,4
2021,105297,10,3,13,8,5
2021,105297,10,4,22,15,7
2021,105297,40,0,63,43,20
2021,105297,40,1,12,8,4
2021,105297,40,2,16,12,4
2021,105297,40,3,13,8,5
2021,105297,40,4,22,15,7
2021,105297,41,0,59,39,20
2021,105297,41,1,12,8,4
2021,105297,41,2,15,11,4
2021,105297,41,3,11,6,5
2021,105297,41,4,21,14,7
2021,105297,42,0,4,4,0
2021,105297,42,2,1,1,0
2021,105297,42,3,2,2,0
2021,105297,42,4,1,1,0
2021,105297,44,0,59,39,20
2021,105297,44,1,12,8,4
2021,105297,44,2,15,11,4
2021,105297,44,3,11,6,5
2021,105297,44,4,21,14,7
2021,105330,0,0,977,477,500
2021,105330,10,0,977,477,500
2021,105330,10,1,258,160,98
2021,105330,10,2,215,113,102
2021,105330,10,3,241,86,155
2021,105330,10,4,30,17,13
2021,105330,10,5,233,101,132
2021,105330,20,0,380,239,141
2021,105330,20,1,235,153,82
2021,105330,20,2,145,86,59
2021,105330,30,0,109,49,60
2021,105330,30,2,1,1,0
2021,105330,30,3,108,48,60
2021,105330,40,0,488,189,299
2021,105330,40,1,23,7,16
2021,105330,40,2,69,26,43
2021,105330,40,3,133,38,95
2021,105330,40,4,30,17,13
2021,105330,40,5,233,101,132
2021,105330,41,0,74,30,44
2021,105330,41,1,21,6,15
2021,105330,41,2,10,4,6
2021,105330,41,5,43,20,23
2021,105330,42,0,414,159,255
2021,105330,42,1,2,1,1
2021,105330,42,2,59,22,37
2021,105330,42,3,133,38,95
2021,105330,42,4,30,17,13
2021,105330,42,5,190,81,109
2021,105330,44,0,74,30,44
2021,105330,44,1,21,6,15
2021,105330,44,2,10,4,6
2021,105330,44,5,43,20,23
2021,105349,0,0,75,34,41
2021,105349,10,0,75,34,41
2021,105349,10,4,75,34,41
2021,105349,40,0,75,34,41
2021,105349,40,4,75,34,41
2021,105349,42,0,75,34,41
2021,105349,42,4,75,34,41
2021,105428,0,0,147,66,81
2021,105428,10,0,144,66,78
2021,105428,10,6,144,66,78
2021,105428,20,0,85,43,42
2021,105428,20,6,85,43,42
2021,105428,30,0,51,23,28
2021,105428,30,6,51,23,28
2021,105428,40,0,8,0,8
2021,105428,40,6,8,0,8
2021,105428,42,0,8,0,8
2021,105428,42,6,8,0,8
2021,105428,50,0,3,0,3
2021,105525,0,0,246,109,137
2021,105525,10,0,246,109,137
2021,105525,10,6,246,109,137
2021,105525,40,0,246,109,137
2021,105525,40,6,246,109,137
2021,105525,42,0,246,109,137
2021,105525,42,6,246,109,137
2021,105534,0,0,68,10,58
2021,105534,10,0,68,10,58
2021,105534,10,4,68,10,58
2021,105534,40,0,68,10,58
2021,105534,40,4,68,10,58
2021,105534,41,0,68,10,58
2021,105534,41,4,68,10,58
2021,105534,45,0,68,10,58
2021,105534,45,4,68,10,58
2021,105543,0,0,45,10,35
2021,105543,10,0,45,10,35
2021,105543,10,4,45,10,35
2021,105543,40,0,45,10,35
2021,105543,40,4,45,10,35
2021,105543,41,0,45,10,35
2021,105543,41,4,45,10,35
2021,105543,45,0,45,10,35
2021,105543,45,4,45,10,35
2021,105589,0,0,49,17,32
2021,105589,10,0,49,17,32
2021,105589,10,2,20,10,10
2021,105589,10,3,29,7,22
2021,105589,40,0,49,17,32
2021,105589,40,2,20,10,10
2021,105589,40,3,29,7,22
2021,105589,41,0,23,10,13
2021,105589,41,2,19,10,9
2021,105589,41,3,4,0,4
2021,105589,42,0,26,7,19
2021,105589,42,2,1,0,1
2021,105589,42,3,25,7,18
2021,105589,44,0,23,10,13
2021,105589,44,2,19,10,9
2021,105589,44,3,4,0,4
2021,105659,0,0,27,25,2
2021,105659,10,0,27,25,2
2021,105659,10,4,27,25,2
2021,105659,40,0,27,25,2
2021,105659,40,4,27,25,2
2021,105659,41,0,27,25,2
2021,105659,41,4,27,25,2
2021,105659,45,0,27,25,2
2021,105659,45,4,27,25,2
2021,105668,0,0,48,16,32
2021,105668,10,0,20,5,15
2021,105668,10,6,20,5,15
2021,105668,20,0,15,5,10
2021,105668,20,6,15,5,10
2021,105668,30,0,5,0,5
2021,105668,30,6,5,0,5
2021,105668,50,0,28,11,17
2021,105747,0,0,126,63,63
2021,105747,10,0,126,63,63
2021,105747,10,6,126,63,63
2021,105747,20,0,105,53,52
2021,105747,20,6,105,53,52
2021,105747,30,0,14,8,6
2021,105747,30,6,14,8,6
2021,105747,40,0,7,2,5
2021,105747,40,6,7,2,5
2021,105747,42,0,5,1,4
2021,105747,42,6,5,1,4
2021,105747,43,0,2,1,1
2021,105747,43,6,2,1,1
2021,105792,0,0,56,27,29
2021,105792,10,0,56,27,29
2021,105792,10,6,56,27,29
2021,105792,20,0,44,21,23
2021,105792,20,6,44,21,23
2021,105792,30,0,9,4,5
2021,105792,30,6,9,4,5
2021,105792,40,0,3,2,1
2021,105792,40,6,3,2,1
2021,105792,42,0,3,2,1
2021,105792,42,6,3,2,1
2021,105899,0,0,29,20,9
2021,105899,10,0,29,20,9
2021,105899,10,1,3,2,1
2021,105899,10,2,12,7,5
2021,105899,10,3,11,9,2
2021,105899,10,4,3,2,1
2021,105899,40,0,29,20,9
2021,105899,40,1,3,2,1
2021,105899,40,2,12,7,5
2021,105899,40,3,11,9,2
2021,105899,40,4,3,2,1
2021,105899,42,0,29,20,9
2021,105899,42,1,3,2,1
2021,105899,42,2,12,7,5
2021,105899,42,3,11,9,2
2021,105899,42,4,3,2,1
2021,106041,0,0,55,55,0
2021,106041,50,0,55,55,0
2021,106148,0,0,102,52,50
2021,106148,10,0,102,52,50
2021,106148,10,4,102,52,50
2021,106148,40,0,102,52,50
2021,106148,40,4,102,52,50
2021,106148,42,0,102,52,50
2021,106148,42,4,102,52,50
2021,106245,0,0,368,209,159
2021,106245,10,0,368,209,159
2021,106245,10,1,109,75,34
2021,106245,10,2,97,62,35
2021,106245,10,3,101,48,53
2021,106245,10,4,61,24,37
2021,106245,20,0,203,133,70
2021,106245,20,1,107,74,33
2021,106245,20,2,92,59,33
2021,106245,20,3,4,0,4
2021,106245,30,0,96,48,48
2021,106245,30,1,2,1,1
2021,106245,30,2,4,2,2
2021,106245,30,3,90,45,45
2021,106245,40,0,69,28,41
2021,106245,40,2,1,1,0
2021,106245,40,3,7,3,4
2021,106245,40,4,61,24,37
2021,106245,42,0,69,28,41
2021,106245,42,2,1,1,0
2021,106245,42,3,7,3,4
2021,106245,42,4,61,24,37
2021,106263,0,0,197,66,131
2021,106263,10,0,197,66,131
2021,106263,10,1,45,26,19
2021,106263,10,2,45,15,30
2021,106263,10,3,85,24,61
2021,106263,10,4,22,1,21
2021,106263,20,0,67,31,36
2021,106263,20,1,42,23,19
2021,106263,20,2,24,8,16
2021,106263,20,3,1,0,1
2021,106263,30,0,122,34,88
2021,106263,30,1,3,3,0
2021,106263,30,2,19,7,12
2021,106263,30,3,84,24,60
2021,106263,30,4,16,0,16
2021,106263,40,0,8,1,7
2021,106263,40,2,2,0,2
2021,106263,40,4,6,1,5
2021,106263,42,0,8,1,7
2021,106263,42,2,2,0,2
2021,106263,42,4,6,1,5
2021,106306,0,0,10,4,6
2021,106306,10,0,10,4,6
2021,106306,10,1,1,1,0
2021,106306,10,3,8,2,6
2021,106306,10,4,1,1,0
2021,106306,40,0,10,4,6
2021,106306,40,1,1,1,0
2021,106306,40,3,8,2,6
2021,106306,40,4,1,1,0
2021,106306,42,0,10,4,6
2021,106306,42,1,1,1,0
2021,106306,42,3,8,2,6
2021,106306,42,4,1,1,0
2021,106342,0,0,49,34,15
2021,106342,10,0,49,34,15
2021,106342,10,1,7,7,0
2021,106342,10,2,19,12,7
2021,106342,10,3,16,10,6
2021,106342,10,4,7,5,2
2021,106342,20,0,28,20,8
2021,106342,20,1,7,7,0
2021,106342,20,2,18,12,6
2021,106342,20,3,2,1,1
2021,106342,20,4,1,0,1
2021,106342,30,0,14,9,5
2021,106342,30,2,1,0,1
2021,106342,30,3,13,9,4
2021,106342,40,0,7,5,2
2021,106342,40,3,1,0,1
2021,106342,40,4,6,5,1
2021,106342,41,0,4,3,1
2021,106342,41,4,4,3,1
2021,106342,42,0,3,2,1
2021,106342,42,3,1,0,1
2021,106342,42,4,2,2,0
2021,106342,44,0,4,3,1
2021,106342,44,4,4,3,1
2021,106397,0,0,1264,720,544
2021,106397,10,0,1264,720,544
2021,106397,10,1,316,234,82
2021,106397,10,2,304,191,113
2021,106397,10,3,221,126,95
2021,106397,10,4,304,125,179
2021,106397,10,5,119,44,75
2021,106397,20,0,596,407,189
2021,106397,20,1,307,226,81
2021,106397,20,2,289,181,108
2021,106397,30,0,223,126,97
2021,106397,30,2,6,4,2
2021,106397,30,3,217,122,95
2021,106397,40,0,445,187,258
2021,106397,40,1,9,8,1
2021,106397,40,2,9,6,3
2021,106397,40,3,4,4,0
2021,106397,40,4,304,125,179
2021,106397,40,5,119,44,75
2021,106397,41,0,401,171,230
2021,106397,41,1,7,7,0
2021,106397,41,2,9,6,3
2021,106397,41,3,4,4,0
2021,106397,41,4,271,111,160
2021,106397,41,5,110,43,67
2021,106397,42,0,26,10,16
2021,106397,42,1,2,1,1
2021,106397,42,4,20,8,12
2021,106397,42,5,4,1,3
2021,106397,43,0,18,6,12
2021,106397,43,4,13,6,7
2021,106397,43,5,5,0,5
2021,106397,44,0,129,57,72
2021,106397,44,4,91,40,51
2021,106397,44,5,38,17,21
2021,106397,45,0,272,114,158
2021,106397,45,1,7,7,0
2021,106397,45,2,9,6,3
2021,106397,45,3,4,4,0
2021,106397,45,4,180,71,109
2021,106397,45,5,72,26,46
2021,106412,0,0,160,90,70
2021,106412,10,0,160,90,70
2021,106412,10,1,20,15,5
2021,106412,10,2,29,18,11
2021,106412,10,3,54,34,20
2021,106412,10,4,57,23,34
2021,106412,20,0,49,34,15
2021,106412,20,1,20,15,5
2021,106412,20,2,20,13,7
2021,106412,20,3,9,6,3
2021,106412,30,0,45,25,20
2021,106412,30,2,9,5,4
2021,106412,30,3,36,20,16
2021,106412,40,0,66,31,35
2021,106412,40,3,9,8,1
2021,106412,40,4,57,23,34
2021,106412,42,0,66,31,35
2021,106412,42,3,9,8,1
2021,106412,42,4,57,23,34
2021,106449,0,0,95,49,46
2021,106449,10,0,95,49,46
2021,106449,10,1,5,5,0
2021,106449,10,2,5,1,4
2021,106449,10,3,35,17,18
2021,106449,10,4,50,26,24
2021,106449,20,0,11,11,0
2021,106449,20,1,5,5,0
2021,106449,20,2,1,1,0
2021,106449,20,3,5,5,0
2021,106449,40,0,84,38,46
2021,106449,40,2,4,0,4
2021,106449,40,3,30,12,18
2021,106449,40,4,50,26,24
2021,106449,42,0,84,38,46
2021,106449,42,2,4,0,4
2021,106449,42,3,30,12,18
2021,106449,42,4,50,26,24
2021,106458,0,0,509,237,272
2021,106458,10,0,505,234,271
2021,106458,10,1,109,67,42
2021,106458,10,2,120,59,61
2021,106458,10,3,166,63,103
2021,106458,10,4,110,45,65
2021,106458,20,0,220,117,103
2021,106458,20,1,104,63,41
2021,106458,20,2,111,53,58
2021,106458,20,3,5,1,4
2021,106458,30,0,121,56,65
2021,106458,30,1,4,3,1
2021,106458,30,2,7,4,3
2021,106458,30,3,108,48,60
2021,106458,30,4,2,1,1
2021,106458,40,0,164,61,103
2021,106458,40,1,1,1,0
2021,106458,40,2,2,2,0
2021,106458,40,3,53,14,39
2021,106458,40,4,108,44,64
2021,106458,42,0,164,61,103
2021,106458,42,1,1,1,0
2021,106458,42,2,2,2,0
2021,106458,42,3,53,14,39
2021,106458,42,4,108,44,64
2021,106458,50,0,4,3,1
2021,106467,0,0,338,167,171
2021,106467,10,0,333,166,167
2021,106467,10,1,64,41,23
2021,106467,10,2,77,39,38
2021,106467,10,3,96,54,42
2021,106467,10,4,39,7,32
2021,106467,10,6,57,25,32
2021,106467,20,0,145,83,62
2021,106467,20,1,63,41,22
2021,106467,20,2,67,33,34
2021,106467,20,3,15,9,6
2021,106467,30,0,76,45,31
2021,106467,30,1,1,0,1
2021,106467,30,2,8,6,2
2021,106467,30,3,67,39,28
2021,106467,40,0,112,38,74
2021,106467,40,2,2,0,2
2021,106467,40,3,14,6,8
2021,106467,40,4,39,7,32
2021,106467,40,6,57,25,32
2021,106467,42,0,112,38,74
2021,106467,42,2,2,0,2
2021,106467,42,3,14,6,8
2021,106467,42,4,39,7,32
2021,106467,42,6,57,25,32
2021,106467,50,0,5,1,4
2021,106485,0,0,155,77,78
2021,106485,10,0,155,77,78
2021,106485,10,1,21,17,4
2021,106485,10,2,39,18,21
2021,106485,10,3,24,14,10
2021,106485,10,4,71,28,43
2021,106485,20,0,61,35,26
2021,106485,20,1,21,17,4
2021,106485,20,2,38,17,21
2021,106485,20,3,1,1,0
2021,106485,20,4,1,0,1
2021,106485,30,0,25,14,11
2021,106485,30,2,1,1,0
2021,106485,30,3,22,12,10
2021,106485,30,4,2,1,1
2021,106485,40,0,69,28,41
2021,106485,40,3,1,1,0
2021,106485,40,4,68,27,41
2021,106485,42,0,69,28,41
2021,106485,42,3,1,1,0
2021,106485,42,4,68,27,41
2021,106546,0,0,56,4,52
2021,106546,10,0,56,4,52
2021,106546,10,6,56,4,52
2021,106546,40,0,56,4,52
2021,106546,40,6,56,4,52
2021,106546,41,0,53,4,49
2021,106546,41,6,53,4,49
2021,106546,43,0,3,0,3
2021,106546,43,6,3,0,3
2021,106546,45,0,53,4,49
2021,106546,45,6,53,4,49
2021,106625,0,0,57,23,34
2021,106625,10,0,57,23,34
2021,106625,10,6,57,23,34
2021,106625,40,0,57,23,34
2021,106625,40,6,57,23,34
2021,106625,42,0,57,23,34
2021,106625,42,6,57,23,34
2021,106704,0,0,532,249,283
2021,106704,10,0,532,249,283
2021,106704,10,1,103,68,35
2021,106704,10,2,143,79,64
2021,106704,10,3,116,50,66
2021,106704,10,4,69,9,60
2021,106704,10,5,74,31,43
2021,106704,10,6,27,12,15
2021,106704,20,0,250,150,100
2021,106704,20,1,102,68,34
2021,106704,20,2,141,77,64
2021,106704,20,3,7,5,2
2021,106704,30,0,113,47,66
2021,106704,30,2,2,2,0
2021,106704,30,3,109,45,64
2021,106704,30,4,2,0,2
2021,106704,40,0,169,52,117
2021,106704,40,1,1,0,1
2021,106704,40,4,67,9,58
2021,106704,40,5,74,31,43
2021,106704,40,6,27,12,15
2021,106704,41,0,142,40,102
2021,106704,41,1,1,0,1
2021,106704,41,4,67,9,58
2021,106704,41,5,74,31,43
2021,106704,42,0,27,12,15
2021,106704,42,6,27,12,15
2021,106704,45,0,142,40,102
2021,106704,45,1,1,0,1
2021,106704,45,4,67,9,58
2021,106704,45,5,74,31,43
2021,106713,0,0,28,13,15
2021,106713,10,0,28,13,15
2021,106713,10,1,8,4,4
2021,106713,10,2,8,3,5
2021,106713,10,3,12,6,6
2021,106713,40,0,28,13,15
2021,106713,40,1,8,4,4
2021,106713,40,2,8,3,5
2021,106713,40,3,12,6,6
2021,106713,41,0,28,13,15
2021,106713,41,1,8,4,4
2021,106713,41,2,8,3,5
2021,106713,41,3,12,6,6
2021,106713,45,0,28,13,15
2021,106713,45,1,8,4,4
2021,106713,45,2,8,3,5
2021,106713,45,3,12,6,6
2021,106795,0,0,48,15,33
2021,106795,10,0,48,15,33
2021,106795,10,4,48,15,33
2021,106795,40,0,48,15,33
2021,106795,40,4,48,15,33
2021,106795,42,0,48,15,33
2021,106795,42,4,48,15,33
2021,106810,0,0,12,5,7
2021,106810,10,0,12,5,7
2021,106810,10,3,12,5,7
2021,106810,40,0,12,5,7
2021,106810,40,3,12,5,7
2021,106810,43,0,12,5,7
2021,106810,43,3,12,5,7
2021,106883,0,0,42,24,18
2021,106883,10,0,42,24,18
2021,106883,10,6,42,24,18
2021,106883,40,0,42,24,18
2021,106883,40,6,42,24,18
2021,106883,42,0,5,4,1
2021,106883,42,6,5,4,1
2021,106883,43,0,37,20,17
2021,106883,43,6,37,20,17
2021,106980,0,0,93,36,57
2021,106980,10,0,93,36,57
2021,106980,10,1,7,1,6
2021,106980,10,2,13,8,5
2021,106980,10,3,73,27,46
2021,106980,40,0,93,36,57
2021,106980,40,1,7,1,6
2021,106980,40,2,13,8,5
2021,106980,40,3,73,27,46
2021,106980,43,0,93,36,57
2021,106980,43,1,7,1,6
2021,106980,43,2,13,8,5
2021,106980,43,3,73,27,46
2021,106999,0,0,45,14,31
2021,106999,10,0,38,11,27
2021,106999,10,6,38,11,27
2021,106999,40,0,38,11,27
2021,106999,40,6,38,11,27
2021,106999,42,0,38,11,27
2021,106999,42,6,38,11,27
2021,106999,50,0,7,3,4
2021,107044,0,0,293,172,121
2021,107044,10,0,293,172,121
2021,107044,10,1,65,53,12
2021,107044,10,2,97,62,35
2021,107044,10,3,97,44,53
2021,107044,10,4,29,11,18
2021,107044,10,5,5,2,3
2021,107044,40,0,293,172,121
2021,107044,40,1,65,53,12
2021,107044,40,2,97,62,35
2021,107044,40,3,97,44,53
2021,107044,40,4,29,11,18
2021,107044,40,5,5,2,3
2021,107044,41,0,245,151,94
2021,107044,41,1,63,51,12
2021,107044,41,2,95,60,35
2021,107044,41,3,73,37,36
2021,107044,41,4,12,3,9
2021,107044,41,5,2,0,2
2021,107044,42,0,48,21,27
2021,107044,42,1,2,2,0
2021,107044,42,2,2,2,0
2021,107044,42,3,24,7,17
2021,107044,42,4,17,8,9
2021,107044,42,5,3,2,1
2021,107044,44,0,135,77,58
2021,107044,44,1,5,4,1
2021,107044,44,2,58,37,21
2021,107044,44,3,58,33,25
2021,107044,44,4,12,3,9
2021,107044,44,5,2,0,2
2021,107044,45,0,110,74,36
2021,107044,45,1,58,47,11
2021,107044,45,2,37,23,14
2021,107044,45,3,15,4,11
2021,107071,0,0,165,84,81
2021,107071,10,0,165,84,81
2021,107071,10,1,49,38,11
2021,107071,10,2,33,15,18
2021,107071,10,3,59,19,40
2021,107071,10,4,21,10,11
2021,107071,10,5,2,1,1
2021,107071,10,6,1,1,0
2021,107071,20,0,77,50,27
2021,107071,20,1,49,38,11
2021,107071,20,2,25,10,15
2021,107071,20,3,3,2,1
2021,107071,30,0,43,14,29
2021,107071,30,2,8,5,3
2021,107071,30,3,34,8,26
2021,107071,30,4,1,1,0
2021,107071,40,0,45,20,25
2021,107071,40,3,22,9,13
2021,107071,40,4,20,9,11
2021,107071,40,5,2,1,1
2021,107071,40,6,1,1,0
2021,107071,42,0,45,20,25
2021,107071,42,3,22,9,13
2021,107071,42,4,20,9,11
2021,107071,42,5,2,1,1
2021,107071,42,6,1,1,0
2021,107080,0,0,91,46,45
2021,107080,10,0,91,46,45
2021,107080,10,1,43,23,20
2021,107080,10,2,21,12,9
2021,107080,10,3,17,8,9
2021,107080,10,4,10,3,7
2021,107080,20,0,63,34,29
2021,107080,20,1,43,23,20
2021,107080,20,2,20,11,9
2021,107080,30,0,13,7,6
2021,107080,30,2,1,1,0
2021,107080,30,3,12,6,6
2021,107080,40,0,15,5,10
2021,107080,40,3,5,2,3
2021,107080,40,4,10,3,7
2021,107080,41,0,14,5,9
2021,107080,41,3,4,2,2
2021,107080,41,4,10,3,7
2021,107080,42,0,1,0,1
2021,107080,42,3,1,0,1
2021,107080,44,0,10,4,6
2021,107080,44,3,4,2,2
2021,107080,44,4,6,2,4
2021,107080,45,0,4,1,3
2021,107080,45,4,4,1,3
2021,107141,0,0,73,47,26
2021,107141,10,0,73,47,26
2021,107141,10,1,18,16,2
2021,107141,10,2,27,21,6
2021,107141,10,3,26,9,17
2021,107141,10,4,2,1,1
2021,107141,40,0,73,47,26
2021,107141,40,1,18,16,2
2021,107141,40,2,27,21,6
2021,107141,40,3,26,9,17
2021,107141,40,4,2,1,1
2021,107141,41,0,72,47,25
2021,107141,41,1,18,16,2
2021,107141,41,2,27,21,6
2021,107141,41,3,25,9,16
2021,107141,41,4,2,1,1
2021,107141,42,0,1,0,1
2021,107141,42,3,1,0,1
2021,107141,44,0,72,47,25
2021,107141,44,1,18,16,2
2021,107141,44,2,27,21,6
2021,107141,44,3,25,9,16
2021,107141,44,4,2,1,1
2021,107318,0,0,38,23,15
2021,107318,10,0,38,23,15
2021,107318,10,4,38,23,15
2021,107318,40,0,38,23,15
2021,107318,40,4,38,23,15
2021,107318,42,0,38,23,15
2021,107318,42,4,38,23,15
2021,107327,0,0,38,20,18
2021,107327,10,0,38,20,18
2021,107327,10,1,1,0,1
2021,107327,10,2,7,3,4
2021,107327,10,3,4,1,3
2021,107327,10,6,26,16,10
2021,107327,40,0,38,20,18
2021,107327,40,1,1,0,1
2021,107327,40,2,7,3,4
2021,107327,40,3,4,1,3
2021,107327,40,6,26,16,10
2021,107327,42,0,38,20,18
2021,107327,42,1,1,0,1
2021,107327,42,2,7,3,4
2021,107327,42,3,4,1,3
2021,107327,42,6,26,16,10
2021,107460,0,0,68,31,37
2021,107460,10,0,68,31,37
2021,107460,10,1,16,4,12
2021,107460,10,2,6,3,3
2021,107460,10,3,10,4,6
2021,107460,10,4,36,20,16
2021,107460,40,0,68,31,37
2021,107460,40,1,16,4,12
2021,107460,40,2,6,3,3
2021,107460,40,3,10,4,6
2021,107460,40,4,36,20,16
2021,107460,42,0,68,31,37
2021,107460,42,1,16,4,12
2021,107460,42,2,6,3,3
2021,107460,42,3,10,4,6
2021,107460,42,4,36,20,16
2021,107512,0,0,106,61,45
2021,107512,10,0,106,61,45
2021,107512,10,1,43,32,11
2021,107512,10,2,29,11,18
2021,107512,10,3,18,10,8
2021,107512,10,4,10,5,5
2021,107512,10,5,6,3,3
2021,107512,20,0,65,42,23
2021,107512,20,1,41,32,9
2021,107512,20,2,23,9,14
2021,107512,20,3,1,1,0
2021,107512,30,0,21,8,13
2021,107512,30,1,1,0,1
2021,107512,30,2,6,2,4
2021,107512,30,3,10,5,5
2021,107512,30,4,4,1,3
2021,107512,40,0,20,11,9
2021,107512,40,1,1,0,1
2021,107512,40,3,7,4,3
2021,107512,40,4,6,4,2
2021,107512,40,5,6,3,3
2021,107512,42,0,20,11,9
2021,107512,42,1,1,0,1
2021,107512,42,3,7,4,3
2021,107512,42,4,6,4,2
2021,107512,42,5,6,3,3
2021,107521,0,0,39,20,19
2021,107521,10,0,39,20,19
2021,107521,10,1,1,1,0
2021,107521,10,2,5,1,4
2021,107521,10,3,1,0,1
2021,107521,10,4,32,18,14
2021,107521,40,0,39,20,19
2021,107521,40,1,1,1,0
2021,107521,40,2,5,1,4
2021,107521,40,3,1,0,1
2021,107521,40,4,32,18,14
2021,107521,42,0,39,20,19
2021,107521,42,1,1,1,0
2021,107521,42,2,5,1,4
2021,107521,42,3,1,0,1
2021,107521,42,4,32,18,14
2021,107549,0,0,34,17,17
2021,107549,10,0,34,17,17
2021,107549,10,4,34,17,17
2021,107549,40,0,34,17,17
2021,107549,40,4,34,17,17
2021,107549,42,0,34,17,17
2021,107549,42,4,34,17,17
2021,107558,0,0,51,29,22
2021,107558,10,0,51,29,22
2021,107558,10,1,15,10,5
2021,107558,10,2,11,3,8
2021,107558,10,3,22,16,6
2021,107558,10,4,3,0,3
2021,107558,20,0,20,11,9
2021,107558,20,1,15,10,5
2021,107558,20,2,5,1,4
2021,107558,30,0,23,16,7
2021,107558,30,2,2,0,2
2021,107558,30,3,21,16,5
2021,107558,40,0,8,2,6
2021,107558,40,2,4,2,2
2021,107558,40,3,1,0,1
2021,107558,40,4,3,0,3
2021,107558,41,0,8,2,6
2021,107558,41,2,4,2,2
2021,107558,41,3,1,0,1
2021,107558,41,4,3,0,3
2021,107558,45,0,8,2,6
2021,107558,45,2,4,2,2
2021,107558,45,3,1,0,1
2021,107558,45,4,3,0,3
2021,107585,0,0,62,31,31
2021,107585,10,0,62,31,31
2021,107585,10,6,62,31,31
2021,107585,40,0,62,31,31
2021,107585,40,6,62,31,31
2021,107585,42,0,62,31,31
2021,107585,42,6,62,31,31
2021,107600,0,0,30,13,17
2021,107600,10,0,30,13,17
2021,107600,10,1,1,1,0
2021,107600,10,2,7,4,3
2021,107600,10,3,14,8,6
2021,107600,10,4,8,0,8
2021,107600,20,0,5,3,2
2021,107600,20,1,1,1,0
2021,107600,20,2,4,2,2
2021,107600,30,0,13,8,5
2021,107600,30,2,2,1,1
2021,107600,30,3,11,7,4
2021,107600,40,0,12,2,10
2021,107600,40,2,1,1,0
2021,107600,40,3,3,1,2
2021,107600,40,4,8,0,8
2021,107600,42,0,12,2,10
2021,107600,42,2,1,1,0
2021,107600,42,3,3,1,2
2021,107600,42,4,8,0,8
2021,107619,0,0,53,19,34
2021,107619,10,0,53,19,34
2021,107619,10,4,53,19,34
2021,107619,40,0,53,19,34
2021,107619,40,4,53,19,34
2021,107619,42,0,53,19,34
2021,107619,42,4,53,19,34
2021,107637,0,0,48,14,34
2021,107637,10,0,48,14,34
2021,107637,10,4,48,14,34
2021,107637,40,0,48,14,34
2021,107637,40,4,48,14,34
2021,107637,42,0,11,2,9
2021,107637,42,4,11,2,9
2021,107637,43,0,37,12,25
2021,107637,43,4,37,12,25
2021,107664,0,0,154,71,83
2021,107664,10,0,154,71,83
2021,107664,10,6,154,71,83
2021,107664,40,0,154,71,83
2021,107664,40,6,154,71,83
2021,107664,42,0,10,8,2
2021,107664,42,6,10,8,2
2021,107664,43,0,144,63,81
2021,107664,43,6,144,63,81
2021,107725,0,0,42,16,26
2021,107725,10,0,41,16,25
2021,107725,10,4,41,16,25
2021,107725,40,0,41,16,25
2021,107725,40,4,41,16,25
2021,107725,42,0,41,16,25
2021,107725,42,4,41,16,25
2021,107725,50,0,1,0,1
2021,107743,0,0,20,8,12
2021,107743,10,0,20,8,12
2021,107743,10,4,20,8,12
2021,107743,40,0,20,8,12
2021,107743,40,4,20,8,12
2021,107743,42,0,20,8,12
2021,107743,42,4,20,8,12
2021,107840,0,0,11,7,4
2021,107840,10,0,11,7,4
2021,107840,10,4,11,7,4
2021,107840,40,0,11,7,4
2021,107840,40,4,11,7,4
2021,107840,42,0,11,7,4
2021,107840,42,4,11,7,4
2021,107877,0,0,28,15,13
2021,107877,10,0,27,15,12
2021,107877,10,1,4,3,1
2021,107877,10,2,5,3,2
2021,107877,10,3,15,7,8
2021,107877,10,4,3,2,1
2021,107877,20,0,8,4,4
2021,107877,20,1,3,2,1
2021,107877,20,2,4,2,2
2021,107877,20,3,1,0,1
2021,107877,30,0,14,7,7
2021,107877,30,1,1,1,0
2021,107877,30,2,1,1,0
2021,107877,30,3,12,5,7
2021,107877,40,0,5,4,1
2021,107877,40,3,2,2,0
2021,107877,40,4,3,2,1
2021,107877,42,0,5,4,1
2021,107877,42,3,2,2,0
2021,107877,42,4,3,2,1
2021,107877,50,0,1,0,1
2021,107974,0,0,42,15,27
2021,107974,10,0,40,14,26
2021,107974,10,1,7,2,5
2021,107974,10,2,6,0,6
2021,107974,10,3,3,1,2
2021,107974,10,4,24,11,13
2021,107974,20,0,4,1,3
2021,107974,20,1,4,1,3
2021,107974,40,0,36,13,23
2021,107974,40,1,3,1,2
2021,107974,40,2,6,0,6
2021,107974,40,3,3,1,2
2021,107974,40,4,24,11,13
2021,107974,42,0,36,13,23
2021,107974,42,1,3,1,2
2021,107974,42,2,6,0,6
2021,107974,42,3,3,1,2
2021,107974,42,4,24,11,13
2021,107974,50,0,2,1,1
2021,107983,0,0,151,76,75
2021,107983,10,0,151,76,75
2021,107983,10,1,22,13,9
2021,107983,10,2,39,18,21
2021,107983,10,3,54,29,25
2021,107983,10,4,36,16,20
2021,107983,20,0,63,30,33
2021,107983,20,1,22,13,9
2021,107983,20,2,35,16,19
2021,107983,20,3,6,1,5
2021,107983,30,0,42,25,17
2021,107983,30,2,3,2,1
2021,107983,30,3,39,23,16
2021,107983,40,0,46,21,25
2021,107983,40,2,1,0,1
2021,107983,40,3,9,5,4
2021,107983,40,4,36,16,20
2021,107983,42,0,46,21,25
2021,107983,42,2,1,0,1
2021,107983,42,3,9,5,4
2021,107983,42,4,36,16,20
2021,107992,0,0,63,34,29
2021,107992,10,0,63,34,29
2021,107992,10,6,63,34,29
2021,107992,40,0,63,34,29
2021,107992,40,6,63,34,29
2021,107992,42,0,63,34,29
2021,107992,42,6,63,34,29
2021,108092,0,0,221,106,115
2021,108092,10,0,221,106,115
2021,108092,10,1,35,22,13
2021,108092,10,2,49,26,23
2021,108092,10,3,77,37,40
2021,108092,10,4,60,21,39
2021,108092,20,0,13,10,3
2021,108092,20,1,7,6,1
2021,108092,20,2,3,3,0
2021,108092,20,3,3,1,2
2021,108092,40,0,208,96,112
2021,108092,40,1,28,16,12
2021,108092,40,2,46,23,23
2021,108092,40,3,74,36,38
2021,108092,40,4,60,21,39
2021,108092,41,0,131,67,64
2021,108092,41,1,26,15,11
2021,108092,41,2,43,21,22
2021,108092,41,3,62,31,31
2021,108092,42,0,77,29,48
2021,108092,42,1,2,1,1
2021,108092,42,2,3,2,1
2021,108092,42,3,12,5,7
2021,108092,42,4,60,21,39
2021,108092,44,0,131,67,64
2021,108092,44,1,26,15,11
2021,108092,44,2,43,21,22
2021,108092,44,3,62,31,31
2021,108232,0,0,133,79,54
2021,108232,10,0,133,79,54
2021,108232,10,6,133,79,54
2021,108232,40,0,133,79,54
2021,108232,40,6,133,79,54
2021,108232,41,0,132,78,54
2021,108232,41,6,132,78,54
2021,108232,43,0,1,1,0
2021,108232,43,6,1,1,0
2021,108232,45,0,132,78,54
2021,108232,45,6,132,78,54
2021,108667,0,0,74,37,37
2021,108667,10,0,74,37,37
2021,108667,10,4,74,37,37
2021,108667,20,0,43,26,17
2021,108667,20,4,43,26,17
2021,108667,30,0,27,9,18
2021,108667,30,4,27,9,18
2021,108667,40,0,4,2,2
2021,108667,40,4,4,2,2
2021,108667,43,0,4,2,2
2021,108667,43,4,4,2,2
2021,108807,0,0,173,74,99
2021,108807,10,0,173,74,99
2021,108807,10,4,173,74,99
2021,108807,20,0,91,42,49
2021,108807,20,4,91,42,49
2021,108807,30,0,61,25,36
2021,108807,30,4,61,25,36
2021,108807,40,0,21,7,14
2021,108807,40,4,21,7,14
2021,108807,42,0,3,1,2
2021,108807,42,4,3,1,2
2021,108807,43,0,18,6,12
2021,108807,43,4,18,6,12
2021,108852,0,0,7,2,5
2021,108852,10,0,7,2,5
2021,108852,10,4,7,2,5
2021,108852,40,0,7,2,5
2021,108852,40,4,7,2,5
2021,108852,43,0,7,2,5
2021,108852,43,4,7,2,5
2021,108870,0,0,13,9,4
2021,108870,10,0,13,9,4
2021,108870,10,1,6,4,2
2021,108870,10,5,7,5,2
2021,108870,40,0,13,9,4
2021,108870,40,1,6,4,2
2021,108870,40,5,7,5,2
2021,108870,42,0,13,9,4
2021,108870,42,1,6,4,2
2021,108870,42,5,7,5,2
2021,109040,0,0,40,12,28
2021,109040,50,0,40,12,28
2021,109086,0,0,4,2,2
2021,109086,10,0,4,2,2
2021,109086,10,6,4,2,2
2021,109086,40,0,4,2,2
2021,109086,40,6,4,2,2
2021,109086,41,0,2,2,0
2021,109086,41,6,2,2,0
2021,109086,43,0,2,0,2
2021,109086,43,6,2,0,2
2021,109086,45,0,2,2,0
2021,109086,45,6,2,2,0
2021,109208,0,0,347,143,204
2021,109208,10,0,347,143,204
2021,109208,10,4,347,143,204
2021,109208,20,0,278,120,158
2021,109208,20,4,278,120,158
2021,109208,30,0,66,21,45
2021,109208,30,4,66,21,45
2021,109208,40,0,3,2,1
2021,109208,40,4,3,2,1
2021,109208,43,0,3,2,1
2021,109208,43,4,3,2,1
2021,109350,0,0,177,102,75
2021,109350,10,0,173,100,73
2021,109350,10,4,173,100,73
2021,109350,20,0,122,70,52
2021,109350,20,4,122,70,52
2021,109350,30,0,50,30,20
2021,109350,30,4,50,30,20
2021,109350,40,0,1,0,1
2021,109350,40,4,1,0,1
2021,109350,42,0,1,0,1
2021,109350,42,4,1,0,1
2021,109350,50,0,4,2,2
2021,109651,0,0,142,96,46
2021,109651,10,0,142,96,46
2021,109651,10,1,56,35,21
2021,109651,10,2,70,49,21
2021,109651,10,3,14,11,3
2021,109651,10,4,2,1,1
2021,109651,40,0,142,96,46
2021,109651,40,1,56,35,21
2021,109651,40,2,70,49,21
2021,109651,40,3,14,11,3
2021,109651,40,4,2,1,1
2021,109651,41,0,61,37,24
2021,109651,41,1,34,19,15
2021,109651,41,2,25,16,9
2021,109651,41,3,2,2,0
2021,109651,42,0,81,59,22
2021,109651,42,1,22,16,6
2021,109651,42,2,45,33,12
2021,109651,42,3,12,9,3
2021,109651,42,4,2,1,1
2021,109651,44,0,61,37,24
2021,109651,44,1,34,19,15
2021,109651,44,2,25,16,9
2021,109651,44,3,2,2,0
2021,109785,0,0,432,180,252
2021,109785,10,0,432,180,252
2021,109785,10,1,142,84,58
2021,109785,10,2,122,49,73
2021,109785,10,3,148,44,104
2021,109785,10,4,20,3,17
2021,109785,40,0,432,180,252
2021,109785,40,1,142,84,58
2021,109785,40,2,122,49,73
2021,109785,40,3,148,44,104
2021,109785,40,4,20,3,17
2021,109785,41,0,294,135,159
2021,109785,41,1,124,73,51
2021,109785,41,2,98,44,54
2021,109785,41,3,68,18,50
2021,109785,41,4,4,0,4
2021,109785,42,0,138,45,93
2021,109785,42,1,18,11,7
2021,109785,42,2,24,5,19
2021,109785,42,3,80,26,54
2021,109785,42,4,16,3,13
2021,109785,44,0,294,135,159
2021,109785,44,1,124,73,51
2021,109785,44,2,98,44,54
2021,109785,44,3,68,18,50
2021,109785,44,4,4,0,4
2021,109819,0,0,340,178,162
2021,109819,10,0,340,178,162
2021,109819,10,4,340,178,162
2021,109819,20,0,254,133,121
2021,109819,20,4,254,133,121
2021,109819,30,0,60,27,33
2021,109819,30,4,60,27,33
2021,109819,40,0,26,18,8
2021,109819,40,4,26,18,8
2021,109819,42,0,8,6,2
2021,109819,42,4,8,6,2
2021,109819,43,0,18,12,6
2021,109819,43,4,18,12,6
2021,109907,0,0,38,20,18
2021,109907,10,0,38,20,18
2021,109907,10,1,23,13,10
2021,109907,10,2,10,4,6
2021,109907,10,3,5,3,2
2021,109907,20,0,30,16,14
2021,109907,20,1,19,11,8
2021,109907,20,2,7,3,4
2021,109907,20,3,4,2,2
2021,109907,30,0,8,4,4
2021,109907,30,1,4,2,2
2021,109907,30,2,3,1,2
2021,109907,30,3,1,1,0
2021,110060,0,0,7,5,2
2021,110060,10,0,7,5,2
2021,110060,10,6,7,5,2
2021,110060,40,0,7,5,2
2021,110060,40,6,7,5,2
2021,110060,42,0,7,5,2
2021,110060,42,6,7,5,2
2021,110097,0,0,268,167,101
2021,110097,10,0,268,167,101
2021,110097,10,1,74,66,8
2021,110097,10,2,140,75,65
2021,110097,10,3,43,21,22
2021,110097,10,4,11,5,6
2021,110097,20,0,53,45,8
2021,110097,20,1,43,37,6
2021,110097,20,2,10,8,2
2021,110097,30,0,215,122,93
2021,110097,30,1,31,29,2
2021,110097,30,2,130,67,63
2021,110097,30,3,43,21,22
2021,110097,30,4,11,5,6
2021,110219,0,0,11,5,6
2021,110219,10,0,11,5,6
2021,110219,10,4,11,5,6
2021,110219,40,0,11,5,6
2021,110219,40,4,11,5,6
2021,110219,41,0,11,5,6
2021,110219,41,4,11,5,6
2021,110219,45,0,11,5,6
2021,110219,45,4,11,5,6
2021,110246,0,0,185,84,101
2021,110246,10,0,185,84,101
2021,110246,10,4,185,84,101
2021,110246,20,0,142,66,76
2021,110246,20,4,142,66,76
2021,110246,30,0,40,16,24
2021,110246,30,4,40,16,24
2021,110246,40,0,3,2,1
2021,110246,40,4,3,2,1
2021,110246,42,0,3,2,1
2021,110246,42,4,3,2,1
2021,110316,0,0,56,25,31
2021,110316,10,0,56,25,31
2021,110316,10,1,22,13,9
2021,110316,10,2,15,4,11
2021,110316,10,3,15,6,9
2021,110316,10,5,4,2,2
2021,110316,40,0,56,25,31
2021,110316,40,1,22,13,9
2021,110316,40,2,15,4,11
2021,110316,40,3,15,6,9
2021,110316,40,5,4,2,2
2021,110316,41,0,43,18,25
2021,110316,41,1,19,11,8
2021,110316,41,2,12,3,9
2021,110316,41,3,12,4,8
2021,110316,42,0,13,7,6
2021,110316,42,1,3,2,1
2021,110316,42,2,3,1,2
2021,110316,42,3,3,2,1
2021,110316,42,5,4,2,2
2021,110316,44,0,43,18,25
2021,110316,44,1,19,11,8
2021,110316,44,2,12,3,9
2021,110316,44,3,12,4,8
2021,110334,0,0,210,84,126
2021,110334,10,0,210,84,126
2021,110334,10,4,210,84,126
2021,110334,20,0,139,65,74
2021,110334,20,4,139,65,74
2021,110334,30,0,36,11,25
2021,110334,30,4,36,11,25
2021,110334,40,0,35,8,27
2021,110334,40,4,35,8,27
2021,110334,42,0,35,8,27
2021,110334,42,4,35,8,27
2021,110361,0,0,358,187,171
2021,110361,10,0,358,187,171
2021,110361,10,1,126,84,42
2021,110361,10,2,101,47,54
2021,110361,10,3,98,41,57
2021,110361,10,4,4,1,3
2021,110361,10,5,18,10,8
2021,110361,10,6,11,4,7
2021,110361,20,0,164,98,66
2021,110361,20,1,112,74,38
2021,110361,20,2,52,24,28
2021,110361,30,0,161,74,87
2021,110361,30,1,14,10,4
2021,110361,30,2,49,23,26
2021,110361,30,3,98,41,57
2021,110361,40,0,33,15,18
2021,110361,40,4,4,1,3
2021,110361,40,5,18,10,8
2021,110361,40,6,11,4,7
2021,110361,42,0,33,15,18
2021,110361,42,4,4,1,3
2021,110361,42,5,18,10,8
2021,110361,42,6,11,4,7
2021,110370,0,0,93,45,48
2021,110370,10,0,93,45,48
2021,110370,10,1,27,15,12
2021,110370,10,2,45,20,25
2021,110370,10,3,21,10,11
2021,110370,20,0,47,26,21
2021,110370,20,1,23,15,8
2021,110370,20,2,24,11,13
2021,110370,30,0,24,11,13
2021,110370,30,2,8,3,5
2021,110370,30,3,16,8,8
2021,110370,40,0,22,8,14
2021,110370,40,1,4,0,4
2021,110370,40,2,13,6,7
2021,110370,40,3,5,2,3
2021,110370,41,0,22,8,14
2021,110370,41,1,4,0,4
2021,110370,41,2,13,6,7
2021,110370,41,3,5,2,3
2021,110370,44,0,22,8,14
2021,110370,44,1,4,0,4
2021,110370,44,2,13,6,7
2021,110370,44,3,5,2,3
2021,110398,0,0,59,26,33
2021,110398,10,0,59,26,33
2021,110398,10,1,42,20,22
2021,110398,10,2,2,1,1
2021,110398,10,5,15,5,10
2021,110398,20,0,35,20,15
2021,110398,20,1,35,20,15
2021,110398,30,0,2,1,1
2021,110398,30,2,2,1,1
2021,110398,40,0,22,5,17
2021,110398,40,1,7,0,7
2021,110398,40,5,15,5,10
2021,110398,41,0,21,5,16
2021,110398,41,1,7,0,7
2021,110398,41,5,14,5,9
2021,110398,42,0,1,0,1
2021,110398,42,5,1,0,1
2021,110398,44,0,21,5,16
2021,110398,44,1,7,0,7
2021,110398,44,5,14,5,9
2021,110404,0,0,360,270,90
2021,110404,10,0,356,269,87
2021,110404,10,1,265,212,53
2021,110404,10,3,44,26,18
2021,110404,10,4,27,20,7
2021,110404,10,5,20,11,9
2021,110404,20,0,265,212,53
2021,110404,20,1,265,212,53
2021,110404,30,0,43,26,17
2021,110404,30,3,43,26,17
2021,110404,40,0,48,31,17
2021,110404,40,3,1,0,1
2021,110404,40,4,27,20,7
2021,110404,40,5,20,11,9
2021,110404,41,0,44,30,14
2021,110404,41,3,1,0,1
2021,110404,41,4,25,19,6
2021,110404,41,5,18,11,7
2021,110404,42,0,2,1,1
2021,110404,42,4,2,1,1
2021,110404,43,0,2,0,2
2021,110404,43,5,2,0,2
2021,110404,44,0,44,30,14
2021,110404,44,3,1,0,1
2021,110404,44,4,25,19,6
2021,110404,44,5,18,11,7
2021,110404,50,0,4,1,3
2021,110413,0,0,171,84,87
2021,110413,10,0,171,84,87
2021,110413,10,1,63,32,31
2021,110413,10,2,43,19,24
2021,110413,10,3,41,23,18
2021,110413,10,4,1,0,1
2021,110413,10,5,23,10,13
2021,110413,20,0,98,48,50
2021,110413,20,1,57,27,30
2021,110413,20,2,38,18,20
2021,110413,20,3,3,3,0
2021,110413,30,0,35,16,19
2021,110413,30,1,1,1,0
2021,110413,30,2,5,1,4
2021,110413,30,3,28,14,14
2021,110413,30,4,1,0,1
2021,110413,40,0,38,20,18
2021,110413,40,1,5,4,1
2021,110413,40,3,10,6,4
2021,110413,40,5,23,10,13
2021,110413,41,0,4,3,1
2021,110413,41,1,4,3,1
2021,110413,42,0,34,17,17
2021,110413,42,1,1,1,0
2021,110413,42,3,10,6,4
2021,110413,42,5,23,10,13
2021,110413,44,0,4,3,1
2021,110413,44,1,4,3,1
2021,110422,0,0,860,529,331
2021,110422,10,0,860,529,331
2021,110422,10,1,306,212,94
2021,110422,10,2,174,104,70
2021,110422,10,3,166,86,80
2021,110422,10,5,211,124,87
2021,110422,10,6,3,3,0
2021,110422,20,0,464,307,157
2021,110422,20,1,302,210,92
2021,110422,20,2,159,94,65
2021,110422,20,6,3,3,0
2021,110422,30,0,185,98,87
2021,110422,30,1,4,2,2
2021,110422,30,2,15,10,5
2021,110422,30,3,166,86,80
2021,110422,40,0,211,124,87
2021,110422,40,5,211,124,87
2021,110422,41,0,111,58,53
2021,110422,41,5,111,58,53
2021,110422,42,0,93,63,30
2021,110422,42,5,93,63,30
2021,110422,43,0,7,3,4
2021,110422,43,5,7,3,4
2021,110422,44,0,111,58,53
2021,110422,44,5,111,58,53
2021,110468,0,0,115,44,71
2021,110468,10,0,115,44,71
2021,110468,10,1,45,23,22
2021,110468,10,2,27,10,17
2021,110468,10,3,42,10,32
2021,110468,10,5,1,1,0
2021,110468,40,0,115,44,71
2021,110468,40,1,45,23,22
2021,110468,40,2,27,10,17
2021,110468,40,3,42,10,32
2021,110468,40,5,1,1,0
2021,110468,41,0,115,44,71
2021,110468,41,1,45,23,22
2021,110468,41,2,27,10,17
2021,110468,41,3,42,10,32
2021,110468,41,5,1,1,0
2021,110468,44,0,115,44,71
2021,110468,44,1,45,23,22
2021,110468,44,2,27,10,17
2021,110468,44,3,42,10,32
2021,110468,44,5,1,1,0
2021,110486,0,0,340,175,165
2021,110486,10,0,340,175,165
2021,110486,10,1,74,45,29
2021,110486,10,2,63,38,25
2021,110486,10,3,94,47,47
2021,110486,10,5,109,45,64
2021,110486,20,0,137,83,54
2021,110486,20,1,74,45,29
2021,110486,20,2,63,38,25
2021,110486,30,0,94,47,47
2021,110486,30,3,94,47,47
2021,110486,40,0,109,45,64
2021,110486,40,5,109,45,64
2021,110486,41,0,52,18,34
2021,110486,41,5,52,18,34
2021,110486,42,0,52,25,27
2021,110486,42,5,52,25,27
2021,110486,43,0,5,2,3
2021,110486,43,5,5,2,3
2021,110486,44,0,52,18,34
2021,110486,44,5,52,18,34
2021,110495,0,0,359,183,176
2021,110495,10,0,359,183,176
2021,110495,10,1,130,77,53
2021,110495,10,2,79,44,35
2021,110495,10,3,64,22,42
2021,110495,10,5,86,40,46
2021,110495,20,0,205,119,86
2021,110495,20,1,130,77,53
2021,110495,20,2,75,42,33
2021,110495,30,0,68,24,44
2021,110495,30,2,4,2,2
2021,110495,30,3,64,22,42
2021,110495,40,0,86,40,46
2021,110495,40,5,86,40,46
2021,110495,41,0,60,27,33
2021,110495,41,5,60,27,33
2021,110495,42,0,24,12,12
2021,110495,42,5,24,12,12
2021,110495,43,0,2,1,1
2021,110495,43,5,2,1,1
2021,110495,44,0,60,27,33
2021,110495,44,5,60,27,33
2021,110510,0,0,489,243,246
2021,110510,10,0,489,243,246
2021,110510,10,1,176,98,78
2021,110510,10,2,106,58,48
2021,110510,10,3,113,47,66
2021,110510,10,5,93,39,54
2021,110510,10,6,1,1,0
2021,110510,20,0,275,155,120
2021,110510,20,1,175,98,77
2021,110510,20,2,95,53,42
2021,110510,20,3,4,3,1
2021,110510,20,6,1,1,0
2021,110510,30,0,121,49,72
2021,110510,30,1,1,0,1
2021,110510,30,2,11,5,6
2021,110510,30,3,109,44,65
2021,110510,40,0,93,39,54
2021,110510,40,5,93,39,54
2021,110510,41,0,62,24,38
2021,110510,41,5,62,24,38
2021,110510,42,0,25,12,13
2021,110510,42,5,25,12,13
2021,110510,43,0,6,3,3
2021,110510,43,5,6,3,3
2021,110510,44,0,62,24,38
2021,110510,44,5,62,24,38
2021,110529,0,0,663,373,290
2021,110529,10,0,663,373,290
2021,110529,10,1,225,142,83
2021,110529,10,2,152,84,68
2021,110529,10,3,145,74,71
2021,110529,10,5,140,72,68
2021,110529,10,6,1,1,0
2021,110529,20,0,375,225,150
2021,110529,20,1,225,142,83
2021,110529,20,2,145,79,66
2021,110529,20,3,4,3,1
2021,110529,20,6,1,1,0
2021,110529,30,0,148,76,72
2021,110529,30,2,7,5,2
2021,110529,30,3,141,71,70
2021,110529,40,0,140,72,68
2021,110529,40,5,140,72,68
2021,110529,41,0,97,56,41
2021,110529,41,5,97,56,41
2021,110529,42,0,41,15,26
2021,110529,42,5,41,15,26
2021,110529,43,0,2,1,1
2021,110529,43,5,2,1,1
2021,110529,44,0,97,56,41
2021,110529,44,5,97,56,41
2021,110538,0,0,516,260,256
2021,110538,10,0,516,260,256
2021,110538,10,1,164,100,64
2021,110538,10,2,118,53,65
2021,110538,10,3,124,60,64
2021,110538,10,5,110,47,63
2021,110538,20,0,280,151,129
2021,110538,20,1,164,100,64
2021,110538,20,2,113,51,62
2021,110538,20,3,3,0,3
2021,110538,30,0,126,62,64
2021,110538,30,2,5,2,3
2021,110538,30,3,121,60,61
2021,110538,40,0,110,47,63
2021,110538,40,5,110,47,63
2021,110538,41,0,77,30,47
2021,110538,41,5,77,30,47
2021,110538,42,0,32,16,16
2021,110538,42,5,32,16,16
2021,110538,43,0,1,1,0
2021,110538,43,5,1,1,0
2021,110538,44,0,77,30,47
2021,110538,44,5,77,30,47
2021,110547,0,0,420,183,237
2021,110547,10,0,420,183,237
2021,110547,10,1,113,64,49
2021,110547,10,2,79,30,49
2021,110547,10,3,101,39,62
2021,110547,10,5,127,50,77
2021,110547,20,0,184,90,94
2021,110547,20,1,112,63,49
2021,110547,20,2,72,27,45
2021,110547,30,0,109,43,66
2021,110547,30,1,1,1,0
2021,110547,30,2,7,3,4
2021,110547,30,3,101,39,62
2021,110547,40,0,127,50,77
2021,110547,40,5,127,50,77
2021,110547,41,0,72,35,37
2021,110547,41,5,72,35,37
2021,110547,42,0,54,14,40
2021,110547,42,5,54,14,40
2021,110547,43,0,1,1,0
2021,110547,43,5,1,1,0
2021,110547,44,0,72,35,37
2021,110547,44,5,72,35,37
2021,110556,0,0,796,405,391
2021,110556,10,0,796,405,391
2021,110556,10,1,234,154,80
2021,110556,10,2,148,69,79
2021,110556,10,3,184,92,92
2021,110556,10,5,227,89,138
2021,110556,10,6,3,1,2
2021,110556,20,0,379,222,157
2021,110556,20,1,234,154,80
2021,110556,20,2,142,66,76
2021,110556,20,3,1,1,0
2021,110556,20,6,2,1,1
2021,110556,30,0,190,94,96
2021,110556,30,2,6,3,3
2021,110556,30,3,183,91,92
2021,110556,30,6,1,0,1
2021,110556,40,0,227,89,138
2021,110556,40,5,227,89,138
2021,110556,41,0,163,63,100
2021,110556,41,5,163,63,100
2021,110556,42,0,57,24,33
2021,110556,42,5,57,24,33
2021,110556,43,0,7,2,5
2021,110556,43,5,7,2,5
2021,110556,44,0,163,63,100
2021,110556,44,5,163,63,100
2021,110565,0,0,1023,491,532
2021,110565,10,0,1023,491,532
2021,110565,10,1,360,209,151
2021,110565,10,2,248,118,130
2021,110565,10,3,183,76,107
2021,110565,10,5,232,88,144
2021,110565,20,0,597,318,279
2021,110565,20,1,360,209,151
2021,110565,20,2,237,109,128
2021,110565,30,0,194,85,109
2021,110565,30,2,11,9,2
2021,110565,30,3,183,76,107
2021,110565,40,0,232,88,144
2021,110565,40,5,232,88,144
2021,110565,41,0,173,69,104
2021,110565,41,5,173,69,104
2021,110565,42,0,57,17,40
2021,110565,42,5,57,17,40
2021,110565,43,0,2,2,0
2021,110565,43,5,2,2,0
2021,110565,44,0,173,69,104
2021,110565,44,5,173,69,104
2021,110574,0,0,387,179,208
2021,110574,10,0,387,179,208
2021,110574,10,1,127,64,63
2021,110574,10,2,87,44,43
2021,110574,10,3,116,49,67
2021,110574,10,5,57,22,35
2021,110574,20,0,190,98,92
2021,110574,20,1,118,59,59
2021,110574,20,2,67,35,32
2021,110574,20,3,5,4,1
2021,110574,30,0,140,59,81
2021,110574,30,1,9,5,4
2021,110574,30,2,20,9,11
2021,110574,30,3,111,45,66
2021,110574,40,0,57,22,35
2021,110574,40,5,57,22,35
2021,110574,41,0,41,14,27
2021,110574,41,5,41,14,27
2021,110574,42,0,13,5,8
2021,110574,42,5,13,5,8
2021,110574,43,0,3,3,0
2021,110574,43,5,3,3,0
2021,110574,44,0,41,14,27
2021,110574,44,5,41,14,27
2021,110583,0,0,1079,505,574
2021,110583,10,0,1079,505,574
2021,110583,10,1,350,193,157
2021,110583,10,2,221,100,121
2021,110583,10,3,214,84,130
2021,110583,10,5,290,127,163
2021,110583,10,6,4,1,3
2021,110583,20,0,574,294,280
2021,110583,20,1,350,193,157
2021,110583,20,2,218,99,119
2021,110583,20,3,2,1,1
2021,110583,20,6,4,1,3
2021,110583,30,0,215,84,131
2021,110583,30,2,3,1,2
2021,110583,30,3,212,83,129
2021,110583,40,0,290,127,163
2021,110583,40,5,290,127,163
2021,110583,41,0,229,100,129
2021,110583,41,5,229,100,129
2021,110583,42,0,58,27,31
2021,110583,42,5,58,27,31
2021,110583,43,0,3,0,3
2021,110583,43,5,3,0,3
2021,110583,44,0,229,100,129
2021,110583,44,5,229,100,129
2021,110592,0,0,696,332,364
2021,110592,10,0,696,332,364
2021,110592,10,1,251,133,118
2021,110592,10,2,99,46,53
2021,110592,10,3,158,69,89
2021,110592,10,5,188,84,104
2021,110592,20,0,349,178,171
2021,110592,20,1,251,133,118
2021,110592,20,2,98,45,53
2021,110592,30,0,159,70,89
2021,110592,30,2,1,1,0
2021,110592,30,3,158,69,89
2021,110592,40,0,188,84,104
2021,110592,40,5,188,84,104
2021,110592,41,0,109,46,63
2021,110592,41,5,109,46,63
2021,110592,42,0,67,32,35
2021,110592,42,5,67,32,35
2021,110592,43,0,12,6,6
2021,110592,43,5,12,6,6
2021,110592,44,0,109,46,63
2021,110592,44,5,109,46,63
2021,110608,0,0,929,446,483
2021,110608,10,0,929,446,483
2021,110608,10,1,370,196,174
2021,110608,10,2,208,99,109
2021,110608,10,3,146,70,76
2021,110608,10,5,197,77,120
2021,110608,10,6,8,4,4
2021,110608,20,0,576,293,283
2021,110608,20,1,370,196,174
2021,110608,20,2,198,94,104
2021,110608,20,3,1,0,1
2021,110608,20,6,7,3,4
2021,110608,30,0,156,76,80
2021,110608,30,2,10,5,5
2021,110608,30,3,145,70,75
2021,110608,30,6,1,1,0
2021,110608,40,0,197,77,120
2021,110608,40,5,197,77,120
2021,110608,41,0,142,59,83
2021,110608,41,5,142,59,83
2021,110608,42,0,35,11,24
2021,110608,42,5,35,11,24
2021,110608,43,0,20,7,13
2021,110608,43,5,20,7,13
2021,110608,44,0,142,59,83
2021,110608,44,5,142,59,83
2021,110617,0,0,826,394,432
2021,110617,10,0,826,394,432
2021,110617,10,1,313,168,145
2021,110617,10,2,141,71,70
2021,110617,10,3,203,84,119
2021,110617,10,5,164,67,97
2021,110617,10,6,5,4,1
2021,110617,20,0,453,242,211
2021,110617,20,1,313,168,145
2021,110617,20,2,137,71,66
2021,110617,20,6,3,3,0
2021,110617,30,0,209,85,124
2021,110617,30,2,4,0,4
2021,110617,30,3,203,84,119
2021,110617,30,6,2,1,1
2021,110617,40,0,164,67,97
2021,110617,40,5,164,67,97
2021,110617,41,0,126,48,78
2021,110617,41,5,126,48,78
2021,110617,42,0,36,17,19
2021,110617,42,5,36,17,19
2021,110617,43,0,2,2,0
2021,110617,43,5,2,2,0
2021,110617,44,0,126,48,78
2021,110617,44,5,126,48,78
2021,110635,0,0,1791,1022,769
2021,110635,10,0,1789,1022,767
2021,110635,10,1,848,547,301
2021,110635,10,2,359,201,158
2021,110635,10,3,294,145,149
2021,110635,10,4,1,1,0
2021,110635,10,5,264,124,140
2021,110635,10,6,23,4,19
2021,110635,20,0,1172,736,436
2021,110635,20,1,809,528,281
2021,110635,20,2,334,189,145
2021,110635,20,5,29,19,10
2021,110635,30,0,246,128,118
2021,110635,30,1,8,4,4
2021,110635,30,3,233,120,113
2021,110635,30,5,5,4,1
2021,110635,40,0,371,158,213
2021,110635,40,1,31,15,16
2021,110635,40,2,25,12,13
2021,110635,40,3,61,25,36
2021,110635,40,4,1,1,0
2021,110635,40,5,230,101,129
2021,110635,40,6,23,4,19
2021,110635,41,0,243,95,148
2021,110635,41,1,27,11,16
2021,110635,41,2,24,11,13
2021,110635,41,3,47,15,32
2021,110635,41,4,1,1,0
2021,110635,41,5,138,57,81
2021,110635,41,6,6,0,6
2021,110635,42,0,128,63,65
2021,110635,42,1,4,4,0
2021,110635,42,2,1,1,0
2021,110635,42,3,14,10,4
2021,110635,42,5,92,44,48
2021,110635,42,6,17,4,13
2021,110635,44,0,243,95,148
2021,110635,44,1,27,11,16
2021,110635,44,2,24,11,13
2021,110635,44,3,47,15,32
2021,110635,44,4,1,1,0
2021,110635,44,5,138,57,81
2021,110635,44,6,6,0,6
2021,110635,50,0,2,0,2
2021,110644,0,0,2647,1467,1180
2021,110644,10,0,2645,1467,1178
2021,110644,10,1,1249,797,452
2021,110644,10,2,543,279,264
2021,110644,10,3,586,273,313
2021,110644,10,4,10,2,8
2021,110644,10,5,256,116,140
2021,110644,10,6,1,0,1
2021,110644,20,0,1293,785,508
2021,110644,20,1,952,609,343
2021,110644,20,2,316,164,152
2021,110644,20,5,25,12,13
2021,110644,30,0,283,147,136
2021,110644,30,1,5,4,1
2021,110644,30,3,252,135,117
2021,110644,30,5,26,8,18
2021,110644,40,0,1069,535,534
2021,110644,40,1,292,184,108
2021,110644,40,2,227,115,112
2021,110644,40,3,334,138,196
2021,110644,40,4,10,2,8
2021,110644,40,5,205,96,109
2021,110644,40,6,1,0,1
2021,110644,41,0,933,466,467
2021,110644,41,1,289,182,107
2021,110644,41,2,227,115,112
2021,110644,41,3,306,122,184
2021,110644,41,4,10,2,8
2021,110644,41,5,101,45,56
2021,110644,42,0,134,68,66
2021,110644,42,1,3,2,1
2021,110644,42,3,28,16,12
2021,110644,42,5,102,50,52
2021,110644,42,6,1,0,1
2021,110644,43,0,2,1,1
2021,110644,43,5,2,1,1
2021,110644,44,0,933,466,467
2021,110644,44,1,289,182,107
2021,110644,44,2,227,115,112
2021,110644,44,3,306,122,184
2021,110644,44,4,10,2,8
2021,110644,44,5,101,45,56
2021,110644,50,0,2,0,2
2021,110653,0,0,2089,1197,892
2021,110653,10,0,2089,1197,892
2021,110653,10,1,918,616,302
2021,110653,10,2,405,213,192
2021,110653,10,3,478,233,245
2021,110653,10,4,45,27,18
2021,110653,10,5,243,108,135
2021,110653,20,0,1061,663,398
2021,110653,20,1,729,493,236
2021,110653,20,2,271,144,127
2021,110653,20,5,61,26,35
2021,110653,30,0,289,135,154
2021,110653,30,1,5,1,4
2021,110653,30,3,247,119,128
2021,110653,30,5,37,15,22
2021,110653,40,0,739,399,340
2021,110653,40,1,184,122,62
2021,110653,40,2,134,69,65
2021,110653,40,3,231,114,117
2021,110653,40,4,45,27,18
2021,110653,40,5,145,67,78
2021,110653,41,0,658,355,303
2021,110653,41,1,183,122,61
2021,110653,41,2,134,69,65
2021,110653,41,3,217,102,115
2021,110653,41,4,45,27,18
2021,110653,41,5,79,35,44
2021,110653,42,0,80,44,36
2021,110653,42,1,1,0,1
2021,110653,42,3,14,12,2
2021,110653,42,5,65,32,33
2021,110653,43,0,1,0,1
2021,110653,43,5,1,0,1
2021,110653,44,0,658,355,303
2021,110653,44,1,183,122,61
2021,110653,44,2,134,69,65
2021,110653,44,3,217,102,115
2021,110653,44,4,45,27,18
2021,110653,44,5,79,35,44
2021,110662,0,0,4127,2358,1769
2021,110662,10,0,4115,2349,1766
2021,110662,10,1,1723,1137,586
2021,110662,10,2,636,341,295
2021,110662,10,3,1132,571,561
2021,110662,10,4,334,168,166
2021,110662,10,5,283,130,153
2021,110662,10,6,7,2,5
2021,110662,20,0,1486,950,536
2021,110662,20,1,1209,800,409
2021,110662,20,2,269,147,122
2021,110662,20,5,8,3,5
2021,110662,30,0,308,152,156
2021,110662,30,1,6,2,4
2021,110662,30,3,297,146,151
2021,110662,30,5,5,4,1
2021,110662,40,0,2321,1247,1074
2021,110662,40,1,508,335,173
2021,110662,40,2,367,194,173
2021,110662,40,3,835,425,410
2021,110662,40,4,334,168,166
2021,110662,40,5,270,123,147
2021,110662,40,6,7,2,5
2021,110662,41,0,2166,1174,992
2021,110662,41,1,508,335,173
2021,110662,41,2,364,192,172
2021,110662,41,3,834,425,409
2021,110662,41,4,334,168,166
2021,110662,41,5,122,53,69
2021,110662,41,6,4,1,3
2021,110662,42,0,154,73,81
2021,110662,42,2,3,2,1
2021,110662,42,3,1,0,1
2021,110662,42,5,147,70,77
2021,110662,42,6,3,1,2
2021,110662,43,0,1,0,1
2021,110662,43,5,1,0,1
2021,110662,44,0,2166,1174,992
2021,110662,44,1,508,335,173
2021,110662,44,2,364,192,172
2021,110662,44,3,834,425,409
2021,110662,44,4,334,168,166
2021,110662,44,5,122,53,69
2021,110662,44,6,4,1,3
2021,110662,50,0,12,9,3
2021,110671,0,0,1001,593,408
2021,110671,10,0,1001,593,408
2021,110671,10,1,358,250,108
2021,110671,10,2,240,128,112
2021,110671,10,3,248,140,108
2021,110671,10,4,4,3,1
2021,110671,10,5,144,71,73
2021,110671,10,6,7,1,6
2021,110671,20,0,584,370,214
2021,110671,20,1,344,241,103
2021,110671,20,2,224,116,108
2021,110671,20,5,16,13,3
2021,110671,30,0,230,131,99
2021,110671,30,3,205,117,88
2021,110671,30,5,25,14,11
2021,110671,40,0,187,92,95
2021,110671,40,1,14,9,5
2021,110671,40,2,16,12,4
2021,110671,40,3,43,23,20
2021,110671,40,4,4,3,1
2021,110671,40,5,103,44,59
2021,110671,40,6,7,1,6
2021,110671,41,0,131,67,64
2021,110671,41,1,14,9,5
2021,110671,41,2,15,11,4
2021,110671,41,3,27,11,16
2021,110671,41,4,4,3,1
2021,110671,41,5,70,33,37
2021,110671,41,6,1,0,1
2021,110671,42,0,56,25,31
2021,110671,42,2,1,1,0
2021,110671,42,3,16,12,4
2021,110671,42,5,33,11,22
2021,110671,42,6,6,1,5
2021,110671,44,0,131,67,64
2021,110671,44,1,14,9,5
2021,110671,44,2,15,11,4
2021,110671,44,3,27,11,16
2021,110671,44,4,4,3,1
2021,110671,44,5,70,33,37
2021,110671,44,6,1,0,1
2021,110680,0,0,2843,1671,1172
2021,110680,10,0,2808,1654,1154
2021,110680,10,1,1265,862,403
2021,110680,10,2,586,326,260
2021,110680,10,3,703,351,352
2021,110680,10,5,254,115,139
2021,110680,20,0,1152,801,351
2021,110680,20,1,833,611,222
2021,110680,20,2,257,156,101
2021,110680,20,5,62,34,28
2021,110680,30,0,339,190,149
2021,110680,30,3,286,162,124
2021,110680,30,5,53,28,25
2021,110680,40,0,1317,663,654
2021,110680,40,1,432,251,181
2021,110680,40,2,329,170,159
2021,110680,40,3,417,189,228
2021,110680,40,5,139,53,86
2021,110680,41,0,1202,611,591
2021,110680,41,1,429,248,181
2021,110680,41,2,323,164,159
2021,110680,41,3,396,175,221
2021,110680,41,5,54,24,30
2021,110680,42,0,115,52,63
2021,110680,42,1,3,3,0
2021,110680,42,2,6,6,0
2021,110680,42,3,21,14,7
2021,110680,42,5,85,29,56
2021,110680,44,0,1202,611,591
2021,110680,44,1,429,248,181
2021,110680,44,2,323,164,159
2021,110680,44,3,396,175,221
2021,110680,44,5,54,24,30
2021,110680,50,0,35,17,18
2021,110699,0,0,2967,1405,1562
2021,110699,10,0,2967,1405,1562
2021,110699,10,1,1199,671,528
2021,110699,10,2,706,299,407
2021,110699,10,3,955,391,564
2021,110699,10,4,107,44,63
2021,110699,20,0,287,186,101
2021,110699,20,1,255,170,85
2021,110699,20,2,32,16,16
2021,110699,30,0,28,15,13
2021,110699,30,3,28,15,13
2021,110699,40,0,2652,1204,1448
2021,110699,40,1,944,501,443
2021,110699,40,2,674,283,391
2021,110699,40,3,927,376,551
2021,110699,40,4,107,44,63
2021,110699,41,0,2651,1203,1448
2021,110699,41,1,944,501,443
2021,110699,41,2,674,283,391
2021,110699,41,3,926,375,551
2021,110699,41,4,107,44,63
2021,110699,42,0,1,1,0
2021,110699,42,3,1,1,0
2021,110699,44,0,2651,1203,1448
2021,110699,44,1,944,501,443
2021,110699,44,2,674,283,391
2021,110699,44,3,926,375,551
2021,110699,44,4,107,44,63
2021,110705,0,0,1073,603,470
2021,110705,10,0,1073,603,470
2021,110705,10,1,515,316,199
2021,110705,10,2,162,85,77
2021,110705,10,3,200,116,84
2021,110705,10,5,194,86,108
2021,110705,10,6,2,0,2
2021,110705,20,0,714,419,295
2021,110705,20,1,515,316,199
2021,110705,20,2,162,85,77
2021,110705,20,5,37,18,19
2021,110705,30,0,204,110,94
2021,110705,30,3,182,100,82
2021,110705,30,5,22,10,12
2021,110705,40,0,155,74,81
2021,110705,40,3,18,16,2
2021,110705,40,5,135,58,77
2021,110705,40,6,2,0,2
2021,110705,41,0,79,33,46
2021,110705,41,5,77,33,44
2021,110705,41,6,2,0,2
2021,110705,42,0,76,41,35
2021,110705,42,3,18,16,2
2021,110705,42,5,58,25,33
2021,110705,44,0,79,33,46
2021,110705,44,5,77,33,44
2021,110705,44,6,2,0,2
2021,110714,0,0,696,365,331
2021,110714,10,0,694,365,329
2021,110714,10,1,286,180,106
2021,110714,10,2,136,71,65
2021,110714,10,3,149,70,79
2021,110714,10,5,119,43,76
2021,110714,10,6,4,1,3
2021,110714,20,0,438,258,180
2021,110714,20,1,286,180,106
2021,110714,20,2,136,71,65
2021,110714,20,5,16,7,9
2021,110714,30,0,160,73,87
2021,110714,30,3,142,67,75
2021,110714,30,5,18,6,12
2021,110714,40,0,96,34,62
2021,110714,40,3,7,3,4
2021,110714,40,5,85,30,55
2021,110714,40,6,4,1,3
2021,110714,41,0,53,20,33
2021,110714,41,3,3,2,1
2021,110714,41,5,48,17,31
2021,110714,41,6,2,1,1
2021,110714,42,0,42,14,28
2021,110714,42,3,4,1,3
2021,110714,42,5,36,13,23
2021,110714,42,6,2,0,2
2021,110714,43,0,1,0,1
2021,110714,43,5,1,0,1
2021,110714,44,0,53,20,33
2021,110714,44,3,3,2,1
2021,110714,44,5,48,17,31
2021,110714,44,6,2,1,1
2021,110714,50,0,2,0,2
2021,110778,0,0,22,8,14
2021,110778,10,0,22,8,14
2021,110778,10,6,22,8,14
2021,110778,40,0,22,8,14
2021,110778,40,6,22,8,14
2021,110778,42,0,15,7,8
2021,110778,42,6,15,7,8
2021,110778,43,0,7,1,6
2021,110778,43,6,7,1,6
2021,111081,0,0,152,84,68
2021,111081,10,0,152,84,68
2021,111081,10,6,152,84,68
2021,111081,40,0,152,84,68
2021,111081,40,6,152,84,68
2021,111081,41,0,123,73,50
2021,111081,41,6,123,73,50
2021,111081,42,0,29,11,18
2021,111081,42,6,29,11,18
2021,111081,44,0,123,73,50
2021,111081,44,6,123,73,50
2021,111188,0,0,67,49,18
2021,111188,10,0,67,49,18
2021,111188,10,1,16,11,5
2021,111188,10,2,21,16,5
2021,111188,10,3,15,10,5
2021,111188,10,5,15,12,3
2021,111188,20,0,38,28,10
2021,111188,20,1,16,11,5
2021,111188,20,2,21,16,5
2021,111188,20,3,1,1,0
2021,111188,30,0,14,9,5
2021,111188,30,3,14,9,5
2021,111188,40,0,15,12,3
2021,111188,40,5,15,12,3
2021,111188,41,0,7,4,3
2021,111188,41,5,7,4,3
2021,111188,42,0,8,8,0
2021,111188,42,5,8,8,0
2021,111188,44,0,7,4,3
2021,111188,44,5,7,4,3
2021,111391,0,0,34,20,14
2021,111391,10,0,34,20,14
2021,111391,10,1,17,12,5
2021,111391,10,2,5,2,3
2021,111391,10,3,3,1,2
2021,111391,10,4,9,5,4
2021,111391,20,0,19,12,7
2021,111391,20,1,16,11,5
2021,111391,20,2,3,1,2
2021,111391,30,0,6,3,3
2021,111391,30,1,1,1,0
2021,111391,30,2,2,1,1
2021,111391,30,3,3,1,2
2021,111391,40,0,9,5,4
2021,111391,40,4,9,5,4
2021,111391,41,0,9,5,4
2021,111391,41,4,9,5,4
2021,111391,44,0,9,5,4
2021,111391,44,4,9,5,4
2021,111434,0,0,87,34,53
2021,111434,10,0,87,34,53
2021,111434,10,4,87,34,53
2021,111434,20,0,61,23,38
2021,111434,20,4,61,23,38
2021,111434,30,0,19,8,11
2021,111434,30,4,19,8,11
2021,111434,40,0,7,3,4
2021,111434,40,4,7,3,4
2021,111434,42,0,1,1,0
2021,111434,42,4,1,1,0
2021,111434,43,0,6,2,4
2021,111434,43,4,6,2,4
2021,111461,0,0,219,99,120
2021,111461,10,0,186,84,102
2021,111461,10,1,121,58,63
2021,111461,10,2,51,20,31
2021,111461,10,3,14,6,8
2021,111461,20,0,155,71,84
2021,111461,20,1,121,58,63
2021,111461,20,2,34,13,21
2021,111461,30,0,31,13,18
2021,111461,30,2,17,7,10
2021,111461,30,3,14,6,8
2021,111461,50,0,33,15,18
2021,111638,0,0,6,3,3
2021,111638,10,0,6,3,3
2021,111638,10,1,2,2,0
2021,111638,10,2,3,1,2
2021,111638,10,5,1,0,1
2021,111638,40,0,6,3,3
2021,111638,40,1,2,2,0
2021,111638,40,2,3,1,2
2021,111638,40,5,1,0,1
2021,111638,41,0,6,3,3
2021,111638,41,1,2,2,0
2021,111638,41,2,3,1,2
2021,111638,41,5,1,0,1
2021,111638,45,0,6,3,3
2021,111638,45,1,2,2,0
2021,111638,45,2,3,1,2
2021,111638,45,5,1,0,1
2021,111887,0,0,298,127,171
2021,111887,10,0,298,127,171
2021,111887,10,4,298,127,171
2021,111887,20,0,223,97,126
2021,111887,20,4,223,97,126
2021,111887,30,0,28,17,11
2021,111887,30,4,28,17,11
2021,111887,40,0,47,13,34
2021,111887,40,4,47,13,34
2021,111887,43,0,47,13,34
2021,111887,43,4,47,13,34
2021,111896,0,0,69,36,33
2021,111896,10,0,69,36,33
2021,111896,10,4,69,36,33
2021,111896,20,0,51,28,23
2021,111896,20,4,51,28,23
2021,111896,30,0,11,6,5
2021,111896,30,4,11,6,5
2021,111896,40,0,7,2,5
2021,111896,40,4,7,2,5
2021,111896,42,0,1,0,1
2021,111896,42,4,1,0,1
2021,111896,43,0,6,2,4
2021,111896,43,4,6,2,4
2021,111920,0,0,185,97,88
2021,111920,10,0,185,97,88
2021,111920,10,4,185,97,88
2021,111920,20,0,136,71,65
2021,111920,20,4,136,71,65
2021,111920,30,0,31,14,17
2021,111920,30,4,31,14,17
2021,111920,40,0,18,12,6
2021,111920,40,4,18,12,6
2021,111920,43,0,18,12,6
2021,111920,43,4,18,12,6
2021,111939,0,0,248,103,145
2021,111939,10,0,248,103,145
2021,111939,10,4,248,103,145
2021,111939,20,0,189,75,114
2021,111939,20,4,189,75,114
2021,111939,30,0,41,15,26
2021,111939,30,4,41,15,26
2021,111939,40,0,18,13,5
2021,111939,40,4,18,13,5
2021,111939,42,0,3,2,1
2021,111939,42,4,3,2,1
2021,111939,43,0,15,11,4
2021,111939,43,4,15,11,4
2021,111948,0,0,555,308,247
2021,111948,10,0,555,308,247
2021,111948,10,1,162,114,48
2021,111948,10,2,156,85,71
2021,111948,10,3,210,93,117
2021,111948,10,4,24,13,11
2021,111948,10,6,3,3,0
2021,111948,20,0,244,159,85
2021,111948,20,1,139,102,37
2021,111948,20,2,105,57,48
2021,111948,30,0,107,48,59
2021,111948,30,2,7,4,3
2021,111948,30,3,100,44,56
2021,111948,40,0,204,101,103
2021,111948,40,1,23,12,11
2021,111948,40,2,44,24,20
2021,111948,40,3,110,49,61
2021,111948,40,4,24,13,11
2021,111948,40,6,3,3,0
2021,111948,41,0,180,85,95
2021,111948,41,1,22,11,11
2021,111948,41,2,40,20,20
2021,111948,41,3,96,42,54
2021,111948,41,4,19,9,10
2021,111948,41,6,3,3,0
2021,111948,42,0,19,14,5
2021,111948,42,2,4,4,0
2021,111948,42,3,11,6,5
2021,111948,42,4,4,4,0
2021,111948,43,0,5,2,3
2021,111948,43,1,1,1,0
2021,111948,43,3,3,1,2
2021,111948,43,4,1,0,1
2021,111948,44,0,180,85,95
2021,111948,44,1,22,11,11
2021,111948,44,2,40,20,20
2021,111948,44,3,96,42,54
2021,111948,44,4,19,9,10
2021,111948,44,6,3,3,0
2021,111966,0,0,64,24,40
2021,111966,10,0,64,24,40
2021,111966,10,1,5,2,3
2021,111966,10,2,12,7,5
2021,111966,10,3,34,12,22
2021,111966,10,4,13,3,10
2021,111966,40,0,64,24,40
2021,111966,40,1,5,2,3
2021,111966,40,2,12,7,5
2021,111966,40,3,34,12,22
2021,111966,40,4,13,3,10
2021,111966,41,0,33,16,17
2021,111966,41,1,2,2,0
2021,111966,41,2,9,5,4
2021,111966,41,3,18,7,11
2021,111966,41,4,4,2,2
2021,111966,42,0,31,8,23
2021,111966,42,1,3,0,3
2021,111966,42,2,3,2,1
2021,111966,42,3,16,5,11
2021,111966,42,4,9,1,8
2021,111966,44,0,33,16,17
2021,111966,44,1,2,2,0
2021,111966,44,2,9,5,4
2021,111966,44,3,18,7,11
2021,111966,44,4,4,2,2
2021,112075,0,0,101,53,48
2021,112075,10,0,101,53,48
2021,112075,10,1,30,20,10
2021,112075,10,2,24,10,14
2021,112075,10,3,47,23,24
2021,112075,40,0,101,53,48
2021,112075,40,1,30,20,10
2021,112075,40,2,24,10,14
2021,112075,40,3,47,23,24
2021,112075,41,0,80,48,32
2021,112075,41,1,28,20,8
2021,112075,41,2,23,10,13
2021,112075,41,3,29,18,11
2021,112075,42,0,21,5,16
2021,112075,42,1,2,0,2
2021,112075,42,2,1,0,1
2021,112075,42,3,18,5,13
2021,112075,44,0,80,48,32
2021,112075,44,1,28,20,8
2021,112075,44,2,23,10,13
2021,112075,44,3,29,18,11
2021,112084,0,0,11,8,3
2021,112084,10,0,11,8,3
2021,112084,10,1,1,1,0
2021,112084,10,2,3,3,0
2021,112084,10,3,5,3,2
2021,112084,10,4,2,1,1
2021,112084,40,0,11,8,3
2021,112084,40,1,1,1,0
2021,112084,40,2,3,3,0
2021,112084,40,3,5,3,2
2021,112084,40,4,2,1,1
2021,112084,42,0,11,8,3
2021,112084,42,1,1,1,0
2021,112084,42,2,3,3,0
2021,112084,42,3,5,3,2
2021,112084,42,4,2,1,1
2021,112127,0,0,7,3,4
2021,112127,10,0,7,3,4
2021,112127,10,1,1,0,1
2021,112127,10,2,4,3,1
2021,112127,10,3,1,0,1
2021,112127,10,4,1,0,1
2021,112127,20,0,2,1,1
2021,112127,20,1,1,0,1
2021,112127,20,2,1,1,0
2021,112127,30,0,1,1,0
2021,112127,30,2,1,1,0
2021,112127,40,0,4,1,3
2021,112127,40,2,2,1,1
2021,112127,40,3,1,0,1
2021,112127,40,4,1,0,1
2021,112127,41,0,4,1,3
2021,112127,41,2,2,1,1
2021,112127,41,3,1,0,1
2021,112127,41,4,1,0,1
2021,112127,44,0,4,1,3
2021,112127,44,2,2,1,1
2021,112127,44,3,1,0,1
2021,112127,44,4,1,0,1
2021,112172,0,0,163,72,91
2021,112172,10,0,163,72,91
2021,112172,10,4,163,72,91
2021,112172,20,0,142,65,77
2021,112172,20,4,142,65,77
2021,112172,30,0,19,7,12
2021,112172,30,4,19,7,12
2021,112172,40,0,2,0,2
2021,112172,40,4,2,0,2
2021,112172,43,0,2,0,2
2021,112172,43,4,2,0,2
2021,112190,0,0,507,201,306
2021,112190,10,0,507,201,306
2021,112190,10,4,507,201,306
2021,112190,20,0,363,153,210
2021,112190,20,4,363,153,210
2021,112190,30,0,126,43,83
2021,112190,30,4,126,43,83
2021,112190,40,0,18,5,13
2021,112190,40,4,18,5,13
2021,112190,43,0,18,5,13
2021,112190,43,4,18,5,13
2021,112251,0,0,92,51,41
2021,112251,10,0,92,51,41
2021,112251,10,1,53,34,19
2021,112251,10,2,26,11,15
2021,112251,10,3,13,6,7
2021,112251,20,0,65,40,25
2021,112251,20,1,46,31,15
2021,112251,20,2,19,9,10
2021,112251,30,0,10,7,3
2021,112251,30,2,1,1,0
2021,112251,30,3,9,6,3
2021,112251,40,0,17,4,13
2021,112251,40,1,7,3,4
2021,112251,40,2,6,1,5
2021,112251,40,3,4,0,4
2021,112251,41,0,14,4,10
2021,112251,41,1,6,3,3
2021,112251,41,2,6,1,5
2021,112251,41,3,2,0,2
2021,112251,42,0,3,0,3
2021,112251,42,1,1,0,1
2021,112251,42,3,2,0,2
2021,112251,44,0,13,4,9
2021,112251,44,1,6,3,3
2021,112251,44,2,5,1,4
2021,112251,44,3,2,0,2
2021,112251,45,0,1,0,1
2021,112251,45,2,1,0,1
2021,112260,0,0,180,115,65
2021,112260,10,0,180,115,65
2021,112260,10,1,66,49,17
2021,112260,10,2,56,38,18
2021,112260,10,3,56,28,28
2021,112260,10,4,2,0,2
2021,112260,20,0,115,82,33
2021,112260,20,1,64,48,16
2021,112260,20,2,51,34,17
2021,112260,30,0,20,8,12
2021,112260,30,3,20,8,12
2021,112260,40,0,45,25,20
2021,112260,40,1,2,1,1
2021,112260,40,2,5,4,1
2021,112260,40,3,36,20,16
2021,112260,40,4,2,0,2
2021,112260,41,0,32,21,11
2021,112260,41,1,2,1,1
2021,112260,41,2,4,4,0
2021,112260,41,3,25,16,9
2021,112260,41,4,1,0,1
2021,112260,42,0,13,4,9
2021,112260,42,2,1,0,1
2021,112260,42,3,11,4,7
2021,112260,42,4,1,0,1
2021,112260,44,0,32,21,11
2021,112260,44,1,2,1,1
2021,112260,44,2,4,4,0
2021,112260,44,3,25,16,9
2021,112260,44,4,1,0,1
2021,112385,0,0,49,20,29
2021,112385,10,0,49,20,29
2021,112385,10,4,49,20,29
2021,112385,20,0,41,19,22
2021,112385,20,4,41,19,22
2021,112385,30,0,7,1,6
2021,112385,30,4,7,1,6
2021,112385,40,0,1,0,1
2021,112385,40,4,1,0,1
2021,112385,43,0,1,0,1
2021,112385,43,4,1,0,1
2021,112394,0,0,11,8,3
2021,112394,10,0,11,8,3
2021,112394,10,1,4,2,2
2021,112394,10,2,4,3,1
2021,112394,10,3,2,2,0
2021,112394,10,4,1,1,0
2021,112394,40,0,11,8,3
2021,112394,40,1,4,2,2
2021,112394,40,2,4,3,1
2021,112394,40,3,2,2,0
2021,112394,40,4,1,1,0
2021,112394,41,0,7,5,2
2021,112394,41,1,2,0,2
2021,112394,41,2,3,3,0
2021,112394,41,3,2,2,0
2021,112394,42,0,4,3,1
2021,112394,42,1,2,2,0
2021,112394,42,2,1,0,1
2021,112394,42,4,1,1,0
2021,112394,45,0,7,5,2
2021,112394,45,1,2,0,2
2021,112394,45,2,3,3,0
2021,112394,45,3,2,2,0
2021,112525,0,0,307,133,174
2021,112525,10,0,307,133,174
2021,112525,10,1,66,38,28
2021,112525,10,2,94,41,53
2021,112525,10,3,134,50,84
2021,112525,10,4,13,4,9
2021,112525,20,0,70,43,27
2021,112525,20,1,44,28,16
2021,112525,20,2,26,15,11
2021,112525,30,0,34,10,24
2021,112525,30,1,4,1,3
2021,112525,30,2,11,2,9
2021,112525,30,3,19,7,12
2021,112525,40,0,203,80,123
2021,112525,40,1,18,9,9
2021,112525,40,2,57,24,33
2021,112525,40,3,115,43,72
2021,112525,40,4,13,4,9
2021,112525,42,0,200,80,120
2021,112525,42,1,18,9,9
2021,112525,42,2,56,24,32
2021,112525,42,3,114,43,71
2021,112525,42,4,12,4,8
2021,112525,43,0,3,0,3
2021,112525,43,2,1,0,1
2021,112525,43,3,1,0,1
2021,112525,43,4,1,0,1
2021,112561,0,0,54,27,27
2021,112561,10,0,54,27,27
2021,112561,10,4,54,27,27
2021,112561,20,0,24,11,13
2021,112561,20,4,24,11,13
2021,112561,30,0,6,3,3
2021,112561,30,4,6,3,3
2021,112561,40,0,24,13,11
2021,112561,40,4,24,13,11
2021,112561,42,0,21,12,9
2021,112561,42,4,21,12,9
2021,112561,43,0,3,1,2
2021,112561,43,4,3,1,2
2021,112570,0,0,8,6,2
2021,112570,10,0,8,6,2
2021,112570,10,4,8,6,2
2021,112570,40,0,8,6,2
2021,112570,40,4,8,6,2
2021,112570,41,0,8,6,2
2021,112570,41,4,8,6,2
2021,112570,45,0,8,6,2
2021,112570,45,4,8,6,2
2021,112686,0,0,98,40,58
2021,112686,10,0,98,40,58
2021,112686,10,4,98,40,58
2021,112686,20,0,70,31,39
2021,112686,20,4,70,31,39
2021,112686,30,0,28,9,19
2021,112686,30,4,28,9,19
2021,112826,0,0,102,41,61
2021,112826,10,0,102,41,61
2021,112826,10,4,102,41,61
2021,112826,20,0,53,19,34
2021,112826,20,4,53,19,34
2021,112826,30,0,32,17,15
2021,112826,30,4,32,17,15
2021,112826,40,0,17,5,12
2021,112826,40,4,17,5,12
2021,112826,42,0,5,1,4
2021,112826,42,4,5,1,4
2021,112826,43,0,12,4,8
2021,112826,43,4,12,4,8
2021,113096,0,0,193,90,103
2021,113096,10,0,193,90,103
2021,113096,10,4,193,90,103
2021,113096,20,0,147,67,80
2021,113096,20,4,147,67,80
2021,113096,30,0,43,22,21
2021,113096,30,4,43,22,21
2021,113096,40,0,3,1,2
2021,113096,40,4,3,1,2
2021,113096,43,0,3,1,2
2021,113096,43,4,3,1,2
2021,113111,0,0,80,39,41
2021,113111,10,0,64,34,30
2021,113111,10,4,64,34,30
2021,113111,20,0,51,27,24
2021,113111,20,4,51,27,24
2021,113111,30,0,13,7,6
2021,113111,30,4,13,7,6
2021,113111,50,0,16,5,11
2021,113193,0,0,138,72,66
2021,113193,10,0,138,72,66
2021,113193,10,4,138,72,66
2021,113193,20,0,117,61,56
2021,113193,20,4,117,61,56
2021,113193,30,0,16,7,9
2021,113193,30,4,16,7,9
2021,113193,40,0,5,4,1
2021,113193,40,4,5,4,1
2021,113193,43,0,5,4,1
2021,113193,43,4,5,4,1
2021,113218,0,0,92,41,51
2021,113218,10,0,92,41,51
2021,113218,10,4,92,41,51
2021,113218,20,0,54,27,27
2021,113218,20,4,54,27,27
2021,113218,30,0,18,7,11
2021,113218,30,4,18,7,11
2021,113218,40,0,20,7,13
2021,113218,40,4,20,7,13
2021,113218,42,0,16,3,13
2021,113218,42,4,16,3,13
2021,113218,43,0,4,4,0
2021,113218,43,4,4,4,0
2021,113236,0,0,227,102,125
2021,113236,10,0,227,102,125
2021,113236,10,4,227,102,125
2021,113236,20,0,180,82,98
2021,113236,20,4,180,82,98
2021,113236,30,0,42,18,24
2021,113236,30,4,42,18,24
2021,113236,40,0,5,2,3
2021,113236,40,4,5,2,3
2021,113236,42,0,2,1,1
2021,113236,42,4,2,1,1
2021,113236,43,0,3,1,2
2021,113236,43,4,3,1,2
2021,113333,0,0,242,102,140
2021,113333,10,0,242,102,140
2021,113333,10,4,242,102,140
2021,113333,20,0,181,79,102
2021,113333,20,4,181,79,102
2021,113333,30,0,58,22,36
2021,113333,30,4,58,22,36
2021,113333,40,0,3,1,2
2021,113333,40,4,3,1,2
2021,113333,42,0,3,1,2
2021,113333,42,4,3,1,2
2021,113573,0,0,121,56,65
2021,113573,10,0,121,56,65
2021,113573,10,1,44,27,17
2021,113573,10,2,19,3,16
2021,113573,10,3,28,13,15
2021,113573,10,4,30,13,17
2021,113573,20,0,57,29,28
2021,113573,20,1,38,22,16
2021,113573,20,2,10,3,7
2021,113573,20,3,8,3,5
2021,113573,20,4,1,1,0
2021,113573,30,0,57,22,35
2021,113573,30,1,6,5,1
2021,113573,30,2,9,0,9
2021,113573,30,3,20,10,10
2021,113573,30,4,22,7,15
2021,113573,40,0,7,5,2
2021,113573,40,4,7,5,2
2021,113573,43,0,7,5,2
2021,113573,43,4,7,5,2
2021,113582,0,0,3,1,2
2021,113582,10,0,3,1,2
2021,113582,10,4,3,1,2
2021,113582,40,0,3,1,2
2021,113582,40,4,3,1,2
2021,113582,41,0,3,1,2
2021,113582,41,4,3,1,2
2021,113582,45,0,3,1,2
2021,113582,45,4,3,1,2
2021,113634,0,0,287,133,154
2021,113634,10,0,287,133,154
2021,113634,10,4,287,133,154
2021,113634,20,0,195,95,100
2021,113634,20,4,195,95,100
2021,113634,30,0,58,21,37
2021,113634,30,4,58,21,37
2021,113634,40,0,34,17,17
2021,113634,40,4,34,17,17
2021,113634,43,0,34,17,17
2021,113634,43,4,34,17,17
2021,113698,0,0,103,43,60
2021,113698,10,0,103,43,60
2021,113698,10,1,26,9,17
2021,113698,10,2,23,11,12
2021,113698,10,3,50,20,30
2021,113698,10,4,4,3,1
2021,113698,20,0,34,12,22
2021,113698,20,1,26,9,17
2021,113698,20,2,8,3,5
2021,113698,30,0,33,17,16
2021,113698,30,2,12,6,6
2021,113698,30,3,21,11,10
2021,113698,40,0,36,14,22
2021,113698,40,2,3,2,1
2021,113698,40,3,29,9,20
2021,113698,40,4,4,3,1
2021,113698,42,0,36,14,22
2021,113698,42,2,3,2,1
2021,113698,42,3,29,9,20
2021,113698,42,4,4,3,1
2021,113704,0,0,11,9,2
2021,113704,10,0,11,9,2
2021,113704,10,1,8,6,2
2021,113704,10,2,1,1,0
2021,113704,10,3,2,2,0
2021,113704,40,0,11,9,2
2021,113704,40,1,8,6,2
2021,113704,40,2,1,1,0
2021,113704,40,3,2,2,0
2021,113704,42,0,11,9,2
2021,113704,42,1,8,6,2
2021,113704,42,2,1,1,0
2021,113704,42,3,2,2,0
2021,113856,0,0,314,139,175
2021,113856,10,0,314,139,175
2021,113856,10,4,314,139,175
2021,113856,20,0,282,129,153
2021,113856,20,4,282,129,153
2021,113856,30,0,27,8,19
2021,113856,30,4,27,8,19
2021,113856,40,0,5,2,3
2021,113856,40,4,5,2,3
2021,113856,43,0,5,2,3
2021,113856,43,4,5,2,3
2021,113980,0,0,321,159,162
2021,113980,10,0,321,159,162
2021,113980,10,4,321,159,162
2021,113980,20,0,276,129,147
2021,113980,20,4,276,129,147
2021,113980,30,0,43,28,15
2021,113980,30,4,43,28,15
2021,113980,40,0,2,2,0
2021,113980,40,4,2,2,0
2021,113980,42,0,1,1,0
2021,113980,42,4,1,1,0
2021,113980,43,0,1,1,0
2021,113980,43,4,1,1,0
2021,114266,0,0,130,45,85
2021,114266,10,0,130,45,85
2021,114266,10,4,130,45,85
2021,114266,20,0,44,21,23
2021,114266,20,4,44,21,23
2021,114266,30,0,58,20,38
2021,114266,30,4,58,20,38
2021,114266,40,0,28,4,24
2021,114266,40,4,28,4,24
2021,114266,42,0,15,2,13
2021,114266,42,4,15,2,13
2021,114266,43,0,13,2,11
2021,114266,43,4,13,2,11
2021,114354,0,0,9,5,4
2021,114354,10,0,9,5,4
2021,114354,10,4,9,5,4
2021,114354,40,0,9,5,4
2021,114354,40,4,9,5,4
2021,114354,43,0,9,5,4
2021,114354,43,4,9,5,4
2021,114433,0,0,28,16,12
2021,114433,10,0,28,16,12
2021,114433,10,4,28,16,12
2021,114433,20,0,13,8,5
2021,114433,20,4,13,8,5
2021,114433,30,0,13,7,6
2021,114433,30,4,13,7,6
2021,114433,40,0,2,1,1
2021,114433,40,4,2,1,1
2021,114433,42,0,1,0,1
2021,114433,42,4,1,0,1
2021,114433,43,0,1,1,0
2021,114433,43,4,1,1,0
2021,114549,0,0,50,15,35
2021,114549,10,0,50,15,35
2021,114549,10,6,50,15,35
2021,114549,40,0,50,15,35
2021,114549,40,6,50,15,35
2021,114549,41,0,50,15,35
2021,114549,41,6,50,15,35
2021,114549,44,0,48,14,34
2021,114549,44,6,48,14,34
2021,114549,45,0,2,1,1
2021,114549,45,6,2,1,1
2021,114716,0,0,171,72,99
2021,114716,10,0,171,72,99
2021,114716,10,4,171,72,99
2021,114716,20,0,132,57,75
2021,114716,20,4,132,57,75
2021,114716,30,0,34,14,20
2021,114716,30,4,34,14,20
2021,114716,40,0,5,1,4
2021,114716,40,4,5,1,4
2021,114716,42,0,5,1,4
2021,114716,42,4,5,1,4
2021,114789,0,0,373,176,197
2021,114789,10,0,373,176,197
2021,114789,10,4,373,176,197
2021,114789,20,0,241,119,122
2021,114789,20,4,241,119,122
2021,114789,30,0,82,39,43
2021,114789,30,4,82,39,43
2021,114789,40,0,50,18,32
2021,114789,40,4,50,18,32
2021,114789,42,0,31,11,20
2021,114789,42,4,31,11,20
2021,114789,43,0,19,7,12
2021,114789,43,4,19,7,12
2021,114813,0,0,112,52,60
2021,114813,10,0,112,52,60
2021,114813,10,1,19,13,6
2021,114813,10,2,41,25,16
2021,114813,10,3,44,11,33
2021,114813,10,4,8,3,5
2021,114813,20,0,50,33,17
2021,114813,20,1,14,10,4
2021,114813,20,2,34,22,12
2021,114813,20,3,2,1,1
2021,114813,30,0,33,11,22
2021,114813,30,1,2,1,1
2021,114813,30,2,4,1,3
2021,114813,30,3,24,7,17
2021,114813,30,4,3,2,1
2021,114813,40,0,29,8,21
2021,114813,40,1,3,2,1
2021,114813,40,2,3,2,1
2021,114813,40,3,18,3,15
2021,114813,40,4,5,1,4
2021,114813,42,0,29,8,21
2021,114813,42,1,3,2,1
2021,114813,42,2,3,2,1
2021,114813,42,3,18,3,15
2021,114813,42,4,5,1,4
2021,114831,0,0,1,0,1
2021,114831,10,0,1,0,1
2021,114831,10,4,1,0,1
2021,114831,40,0,1,0,1
2021,114831,40,4,1,0,1
2021,114831,42,0,1,0,1
2021,114831,42,4,1,0,1
2021,114840,0,0,46,31,15
2021,114840,10,0,46,31,15
2021,114840,10,1,16,13,3
2021,114840,10,2,20,12,8
2021,114840,10,3,9,6,3
2021,114840,10,4,1,0,1
2021,114840,20,0,31,22,9
2021,114840,20,1,14,11,3
2021,114840,20,2,17,11,6
2021,114840,30,0,14,9,5
2021,114840,30,1,2,2,0
2021,114840,30,2,3,1,2
2021,114840,30,3,9,6,3
2021,114840,40,0,1,0,1
2021,114840,40,4,1,0,1
2021,114840,41,0,1,0,1
2021,114840,41,4,1,0,1
2021,114840,44,0,1,0,1
2021,114840,44,4,1,0,1
2021,114859,0,0,316,162,154
2021,114859,10,0,316,162,154
2021,114859,10,4,316,162,154
2021,114859,20,0,271,137,134
2021,114859,20,4,271,137,134
2021,114859,30,0,34,20,14
2021,114859,30,4,34,20,14
2021,114859,40,0,11,5,6
2021,114859,40,4,11,5,6
2021,114859,42,0,2,1,1
2021,114859,42,4,2,1,1
2021,114859,43,0,9,4,5
2021,114859,43,4,9,4,5
2021,114938,0,0,73,33,40
2021,114938,10,0,73,33,40
2021,114938,10,4,73,33,40
2021,114938,20,0,43,18,25
2021,114938,20,4,43,18,25
2021,114938,30,0,23,11,12
2021,114938,30,4,23,11,12
2021,114938,40,0,7,4,3
2021,114938,40,4,7,4,3
2021,114938,41,0,1,1,0
2021,114938,41,4,1,1,0
2021,114938,42,0,2,0,2
2021,114938,42,4,2,0,2
2021,114938,43,0,4,3,1
2021,114938,43,4,4,3,1
2021,114938,45,0,1,1,0
2021,114938,45,4,1,1,0
2021,115001,0,0,205,83,122
2021,115001,10,0,205,83,122
2021,115001,10,4,205,83,122
2021,115001,20,0,156,67,89
2021,115001,20,4,156,67,89
2021,115001,30,0,27,13,14
2021,115001,30,4,27,13,14
2021,115001,40,0,22,3,19
2021,115001,40,4,22,3,19
2021,115001,42,0,4,1,3
2021,115001,42,4,4,1,3
2021,115001,43,0,18,2,16
2021,115001,43,4,18,2,16
2021,115010,0,0,16,6,10
2021,115010,50,0,16,6,10
2021,115083,0,0,54,26,28
2021,115083,10,0,54,26,28
2021,115083,10,1,28,15,13
2021,115083,10,2,17,7,10
2021,115083,10,3,2,0,2
2021,115083,10,5,7,4,3
2021,115083,20,0,24,12,12
2021,115083,20,1,21,11,10
2021,115083,20,2,3,1,2
2021,115083,30,0,2,1,1
2021,115083,30,2,2,1,1
2021,115083,40,0,28,13,15
2021,115083,40,1,7,4,3
2021,115083,40,2,12,5,7
2021,115083,40,3,2,0,2
2021,115083,40,5,7,4,3
2021,115083,41,0,14,5,9
2021,115083,41,1,6,3,3
2021,115083,41,2,7,2,5
2021,115083,41,3,1,0,1
2021,115083,42,0,14,8,6
2021,115083,42,1,1,1,0
2021,115083,42,2,5,3,2
2021,115083,42,3,1,0,1
2021,115083,42,5,7,4,3
2021,115083,44,0,14,5,9
2021,115083,44,1,6,3,3
2021,115083,44,2,7,2,5
2021,115083,44,3,1,0,1
2021,115126,0,0,122,46,76
2021,115126,10,0,122,46,76
2021,115126,10,4,122,46,76
2021,115126,20,0,101,37,64
2021,115126,20,4,101,37,64
2021,115126,30,0,21,9,12
2021,115126,30,4,21,9,12
2021,115214,0,0,10,5,5
2021,115214,10,0,9,5,4
2021,115214,10,1,2,2,0
2021,115214,10,2,4,2,2
2021,115214,10,3,2,1,1
2021,115214,10,5,1,0,1
2021,115214,20,0,2,1,1
2021,115214,20,2,2,1,1
2021,115214,30,0,1,1,0
2021,115214,30,3,1,1,0
2021,115214,40,0,6,3,3
2021,115214,40,1,2,2,0
2021,115214,40,2,2,1,1
2021,115214,40,3,1,0,1
2021,115214,40,5,1,0,1
2021,115214,41,0,6,3,3
2021,115214,41,1,2,2,0
2021,115214,41,2,2,1,1
2021,115214,41,3,1,0,1
2021,115214,41,5,1,0,1
2021,115214,44,0,6,3,3
2021,115214,44,1,2,2,0
2021,115214,44,2,2,1,1
2021,115214,44,3,1,0,1
2021,115214,44,5,1,0,1
2021,115214,50,0,1,0,1
2021,115296,0,0,249,109,140
2021,115296,10,0,249,109,140
2021,115296,10,4,249,109,140
2021,115296,20,0,156,77,79
2021,115296,20,4,156,77,79
2021,115296,30,0,44,15,29
2021,115296,30,4,44,15,29
2021,115296,40,0,49,17,32
2021,115296,40,4,49,17,32
2021,115296,42,0,29,8,21
2021,115296,42,4,29,8,21
2021,115296,43,0,20,9,11
2021,115296,43,4,20,9,11
2021,115393,0,0,134,65,69
2021,115393,10,0,134,65,69
2021,115393,10,4,134,65,69
2021,115393,20,0,81,38,43
2021,115393,20,4,81,38,43
2021,115393,30,0,36,16,20
2021,115393,30,4,36,16,20
2021,115393,40,0,17,11,6
2021,115393,40,4,17,11,6
2021,115393,42,0,7,3,4
2021,115393,42,4,7,3,4
2021,115393,43,0,10,8,2
2021,115393,43,4,10,8,2
2021,115409,0,0,102,59,43
2021,115409,10,0,96,57,39
2021,115409,10,1,49,35,14
2021,115409,10,2,23,9,14
2021,115409,10,3,19,12,7
2021,115409,10,4,5,1,4
2021,115409,20,0,70,43,27
2021,115409,20,1,49,35,14
2021,115409,20,2,21,8,13
2021,115409,30,0,21,13,8
2021,115409,30,2,2,1,1
2021,115409,30,3,19,12,7
2021,115409,40,0,5,1,4
2021,115409,40,4,5,1,4
2021,115409,42,0,5,1,4
2021,115409,42,4,5,1,4
2021,115409,50,0,6,2,4
2021,115728,0,0,35,11,24
2021,115728,10,0,35,11,24
2021,115728,10,1,5,3,2
2021,115728,10,2,11,4,7
2021,115728,10,3,18,4,14
2021,115728,10,4,1,0,1
2021,115728,20,0,13,7,6
2021,115728,20,1,4,3,1
2021,115728,20,2,9,4,5
2021,115728,30,0,7,1,6
2021,115728,30,1,1,0,1
2021,115728,30,2,1,0,1
2021,115728,30,3,5,1,4
2021,115728,40,0,15,3,12
2021,115728,40,2,1,0,1
2021,115728,40,3,13,3,10
2021,115728,40,4,1,0,1
2021,115728,42,0,15,3,12
2021,115728,42,2,1,0,1
2021,115728,42,3,13,3,10
2021,115728,42,4,1,0,1
2021,115746,0,0,33,14,19
2021,115746,10,0,33,14,19
2021,115746,10,1,28,13,15
2021,115746,10,2,5,1,4
2021,115746,40,0,33,14,19
2021,115746,40,1,28,13,15
2021,115746,40,2,5,1,4
2021,115746,41,0,31,13,18
2021,115746,41,1,27,13,14
2021,115746,41,2,4,0,4
2021,115746,42,0,2,1,1
2021,115746,42,1,1,0,1
2021,115746,42,2,1,1,0
2021,115746,44,0,31,13,18
2021,115746,44,1,27,13,14
2021,115746,44,2,4,0,4
2021,115755,0,0,259,128,131
2021,115755,10,0,259,128,131
2021,115755,10,1,94,56,38
2021,115755,10,2,64,26,38
2021,115755,10,3,52,21,31
2021,115755,10,5,49,25,24
2021,115755,20,0,158,82,76
2021,115755,20,1,94,56,38
2021,115755,20,2,63,25,38
2021,115755,20,3,1,1,0
2021,115755,30,0,52,21,31
2021,115755,30,2,1,1,0
2021,115755,30,3,51,20,31
2021,115755,40,0,49,25,24
2021,115755,40,5,49,25,24
2021,115755,41,0,37,18,19
2021,115755,41,5,37,18,19
2021,115755,42,0,4,3,1
2021,115755,42,5,4,3,1
2021,115755,43,0,8,4,4
2021,115755,43,5,8,4,4
2021,115755,44,0,37,18,19
2021,115755,44,5,37,18,19
2021,115773,0,0,8,2,6
2021,115773,10,0,8,2,6
2021,115773,10,1,3,2,1
2021,115773,10,3,2,0,2
2021,115773,10,4,3,0,3
2021,115773,40,0,8,2,6
2021,115773,40,1,3,2,1
2021,115773,40,3,2,0,2
2021,115773,40,4,3,0,3
2021,115773,41,0,8,2,6
2021,115773,41,1,3,2,1
2021,115773,41,3,2,0,2
2021,115773,41,4,3,0,3
2021,115773,44,0,8,2,6
2021,115773,44,1,3,2,1
2021,115773,44,3,2,0,2
2021,115773,44,4,3,0,3
2021,115861,0,0,151,68,83
2021,115861,10,0,151,68,83
2021,115861,10,4,151,68,83
2021,115861,20,0,93,50,43
2021,115861,20,4,93,50,43
2021,115861,30,0,22,12,10
2021,115861,30,4,22,12,10
2021,115861,40,0,36,6,30
2021,115861,40,4,36,6,30
2021,115861,42,0,10,3,7
2021,115861,42,4,10,3,7
2021,115861,43,0,26,3,23
2021,115861,43,4,26,3,23
2021,115931,0,0,13,8,5
2021,115931,10,0,13,8,5
2021,115931,10,6,13,8,5
2021,115931,40,0,13,8,5
2021,115931,40,6,13,8,5
2021,115931,41,0,13,8,5
2021,115931,41,6,13,8,5
2021,115931,45,0,13,8,5
2021,115931,45,6,13,8,5
2021,116439,0,0,152,83,69
2021,116439,10,0,152,83,69
2021,116439,10,4,152,83,69
2021,116439,20,0,127,73,54
2021,116439,20,4,127,73,54
2021,116439,30,0,25,10,15
2021,116439,30,4,25,10,15
2021,116846,0,0,8,7,1
2021,116846,10,0,6,5,1
2021,116846,10,1,6,5,1
2021,116846,20,0,6,5,1
2021,116846,20,1,6,5,1
2021,116846,50,0,2,2,0
2021,117052,0,0,153,74,79
2021,117052,10,0,153,74,79
2021,117052,10,4,153,74,79
2021,117052,20,0,97,51,46
2021,117052,20,4,97,51,46
2021,117052,30,0,26,13,13
2021,117052,30,4,26,13,13
2021,117052,40,0,30,10,20
2021,117052,40,4,30,10,20
2021,117052,42,0,27,8,19
2021,117052,42,4,27,8,19
2021,117052,43,0,3,2,1
2021,117052,43,4,3,2,1
2021,117104,0,0,18,12,6
2021,117104,10,0,18,12,6
2021,117104,10,1,3,3,0
2021,117104,10,2,6,4,2
2021,117104,10,3,9,5,4
2021,117104,40,0,18,12,6
2021,117104,40,1,3,3,0
2021,117104,40,2,6,4,2
2021,117104,40,3,9,5,4
2021,117104,41,0,5,5,0
2021,117104,41,1,3,3,0
2021,117104,41,2,2,2,0
2021,117104,42,0,13,7,6
2021,117104,42,2,4,2,2
2021,117104,42,3,9,5,4
2021,117104,44,0,5,5,0
2021,117104,44,1,3,3,0
2021,117104,44,2,2,2,0
2021,117140,0,0,217,107,110
2021,117140,10,0,217,107,110
2021,117140,10,1,88,52,36
2021,117140,10,2,62,25,37
2021,117140,10,3,44,20,24
2021,117140,10,4,23,10,13
2021,117140,20,0,136,70,66
2021,117140,20,1,76,44,32
2021,117140,20,2,58,25,33
2021,117140,20,3,2,1,1
2021,117140,30,0,28,16,12
2021,117140,30,1,1,1,0
2021,117140,30,2,2,0,2
2021,117140,30,3,25,15,10
2021,117140,40,0,53,21,32
2021,117140,40,1,11,7,4
2021,117140,40,2,2,0,2
2021,117140,40,3,17,4,13
2021,117140,40,4,23,10,13
2021,117140,42,0,53,21,32
2021,117140,42,1,11,7,4
2021,117140,42,2,2,0,2
2021,117140,42,3,17,4,13
2021,117140,42,4,23,10,13
2021,117168,0,0,27,20,7
2021,117168,10,0,27,20,7
2021,117168,10,1,4,3,1
2021,117168,10,2,13,10,3
2021,117168,10,3,10,7,3
2021,117168,40,0,27,20,7
2021,117168,40,1,4,3,1
2021,117168,40,2,13,10,3
2021,117168,40,3,10,7,3
2021,117168,41,0,21,17,4
2021,117168,41,1,4,3,1
2021,117168,41,2,12,9,3
2021,117168,41,3,5,5,0
2021,117168,42,0,6,3,3
2021,117168,42,2,1,1,0
2021,117168,42,3,5,2,3
2021,117168,44,0,20,16,4
2021,117168,44,1,3,2,1
2021,117168,44,2,12,9,3
2021,117168,44,3,5,5,0
2021,117168,45,0,1,1,0
2021,117168,45,1,1,1,0
2021,117195,0,0,33,16,17
2021,117195,10,0,33,16,17
2021,117195,10,4,33,16,17
2021,117195,20,0,24,12,12
2021,117195,20,4,24,12,12
2021,117195,30,0,9,4,5
2021,117195,30,4,9,4,5
2021,117247,0,0,124,56,68
2021,117247,10,0,124,56,68
2021,117247,10,4,124,56,68
2021,117247,20,0,84,43,41
2021,117247,20,4,84,43,41
2021,117247,30,0,36,12,24
2021,117247,30,4,36,12,24
2021,117247,40,0,4,1,3
2021,117247,40,4,4,1,3
2021,117247,43,0,4,1,3
2021,117247,43,4,4,1,3
2021,117274,0,0,43,23,20
2021,117274,10,0,43,23,20
2021,117274,10,4,43,23,20
2021,117274,20,0,27,17,10
2021,117274,20,4,27,17,10
2021,117274,30,0,14,4,10
2021,117274,30,4,14,4,10
2021,117274,40,0,2,2,0
2021,117274,40,4,2,2,0
2021,117274,42,0,2,2,0
2021,117274,42,4,2,2,0
2021,117520,0,0,32,16,16
2021,117520,10,0,32,16,16
2021,117520,10,1,25,12,13
2021,117520,10,2,4,3,1
2021,117520,10,3,1,0,1
2021,117520,10,4,2,1,1
2021,117520,40,0,32,16,16
2021,117520,40,1,25,12,13
2021,117520,40,2,4,3,1
2021,117520,40,3,1,0,1
2021,117520,40,4,2,1,1
2021,117520,41,0,32,16,16
2021,117520,41,1,25,12,13
2021,117520,41,2,4,3,1
2021,117520,41,3,1,0,1
2021,117520,41,4,2,1,1
2021,117520,45,0,32,16,16
2021,117520,45,1,25,12,13
2021,117520,45,2,4,3,1
2021,117520,45,3,1,0,1
2021,117520,45,4,2,1,1
2021,117557,0,0,13,8,5
2021,117557,10,0,13,8,5
2021,117557,10,1,6,4,2
2021,117557,10,2,3,3,0
2021,117557,10,3,3,1,2
2021,117557,10,5,1,0,1
2021,117557,40,0,13,8,5
2021,117557,40,1,6,4,2
2021,117557,40,2,3,3,0
2021,117557,40,3,3,1,2
2021,117557,40,5,1,0,1
2021,117557,42,0,13,8,5
2021,117557,42,1,6,4,2
2021,117557,42,2,3,3,0
2021,117557,42,3,3,1,2
2021,117557,42,5,1,0,1
2021,117575,0,0,5,5,0
2021,117575,10,0,5,5,0
2021,117575,10,1,5,5,0
2021,117575,40,0,5,5,0
2021,117575,40,1,5,5,0
2021,117575,41,0,5,5,0
2021,117575,41,1,5,5,0
2021,117575,45,0,5,5,0
2021,117575,45,1,5,5,0
2021,117627,0,0,104,58,46
2021,117627,10,0,104,58,46
2021,117627,10,1,26,19,7
2021,117627,10,2,35,20,15
2021,117627,10,3,31,15,16
2021,117627,10,4,2,1,1
2021,117627,10,5,10,3,7
2021,117627,20,0,47,33,14
2021,117627,20,1,21,16,5
2021,117627,20,2,19,12,7
2021,117627,20,3,7,5,2
2021,117627,30,0,22,9,13
2021,117627,30,1,3,2,1
2021,117627,30,2,9,6,3
2021,117627,30,3,7,0,7
2021,117627,30,5,3,1,2
2021,117627,40,0,35,16,19
2021,117627,40,1,2,1,1
2021,117627,40,2,7,2,5
2021,117627,40,3,17,10,7
2021,117627,40,4,2,1,1
2021,117627,40,5,7,2,5
2021,117627,41,0,35,16,19
2021,117627,41,1,2,1,1
2021,117627,41,2,7,2,5
2021,117627,41,3,17,10,7
2021,117627,41,4,2,1,1
2021,117627,41,5,7,2,5
2021,117627,45,0,35,16,19
2021,117627,45,1,2,1,1
2021,117627,45,2,7,2,5
2021,117627,45,3,17,10,7
2021,117627,45,4,2,1,1
2021,117627,45,5,7,2,5
2021,117636,0,0,381,158,223
2021,117636,10,0,381,158,223
2021,117636,10,1,56,31,25
2021,117636,10,2,68,27,41
2021,117636,10,3,217,89,128
2021,117636,10,4,40,11,29
2021,117636,20,0,16,9,7
2021,117636,20,1,10,6,4
2021,117636,20,2,3,2,1
2021,117636,20,3,3,1,2
2021,117636,30,0,49,24,25
2021,117636,30,1,15,7,8
2021,117636,30,2,12,7,5
2021,117636,30,3,22,10,12
2021,117636,40,0,316,125,191
2021,117636,40,1,31,18,13
2021,117636,40,2,53,18,35
2021,117636,40,3,192,78,114
2021,117636,40,4,40,11,29
2021,117636,41,0,94,44,50
2021,117636,41,1,14,9,5
2021,117636,41,2,16,7,9
2021,117636,41,3,63,28,35
2021,117636,41,4,1,0,1
2021,117636,42,0,222,81,141
2021,117636,42,1,17,9,8
2021,117636,42,2,37,11,26
2021,117636,42,3,129,50,79
2021,117636,42,4,39,11,28
2021,117636,44,0,94,44,50
2021,117636,44,1,14,9,5
2021,117636,44,2,16,7,9
2021,117636,44,3,63,28,35
2021,117636,44,4,1,0,1
2021,117645,0,0,302,135,167
2021,117645,10,0,302,135,167
2021,117645,10,4,302,135,167
2021,117645,20,0,231,105,126
2021,117645,20,4,231,105,126
2021,117645,30,0,64,26,38
2021,117645,30,4,64,26,38
2021,117645,40,0,7,4,3
2021,117645,40,4,7,4,3
2021,117645,42,0,7,4,3
2021,117645,42,4,7,4,3
2021,117672,0,0,32,17,15
2021,117672,10,0,31,16,15
2021,117672,10,1,3,2,1
2021,117672,10,2,5,3,2
2021,117672,10,3,19,8,11
2021,117672,10,4,4,3,1
2021,117672,40,0,31,16,15
2021,117672,40,1,3,2,1
2021,117672,40,2,5,3,2
2021,117672,40,3,19,8,11
2021,117672,40,4,4,3,1
2021,117672,42,0,31,16,15
2021,117672,42,1,3,2,1
2021,117672,42,2,5,3,2
2021,117672,42,3,19,8,11
2021,117672,42,4,4,3,1
2021,117672,50,0,1,1,0
2021,117681,0,0,11,3,8
2021,117681,10,0,11,3,8
2021,117681,10,4,11,3,8
2021,117681,20,0,10,3,7
2021,117681,20,4,10,3,7
2021,117681,30,0,1,0,1
2021,117681,30,4,1,0,1
2021,117690,0,0,86,42,44
2021,117690,10,0,86,42,44
2021,117690,10,4,86,42,44
2021,117690,20,0,77,37,40
2021,117690,20,4,77,37,40
2021,117690,30,0,7,4,3
2021,117690,30,4,7,4,3
2021,117690,40,0,2,1,1
2021,117690,40,4,2,1,1
2021,117690,42,0,1,1,0
2021,117690,42,4,1,1,0
2021,117690,43,0,1,0,1
2021,117690,43,4,1,0,1
2021,117706,0,0,227,94,133
2021,117706,10,0,227,94,133
2021,117706,10,4,227,94,133
2021,117706,20,0,201,87,114
2021,117706,20,4,201,87,114
2021,117706,30,0,22,6,16
2021,117706,30,4,22,6,16
2021,117706,40,0,4,1,3
2021,117706,40,4,4,1,3
2021,117706,42,0,4,1,3
2021,117706,42,4,4,1,3
2021,117715,0,0,80,27,53
2021,117715,10,0,80,27,53
2021,117715,10,4,80,27,53
2021,117715,20,0,57,22,35
2021,117715,20,4,57,22,35
2021,117715,30,0,11,2,9
2021,117715,30,4,11,2,9
2021,117715,40,0,12,3,9
2021,117715,40,4,12,3,9
2021,117715,42,0,6,1,5
2021,117715,42,4,6,1,5
2021,117715,43,0,6,2,4
2021,117715,43,4,6,2,4
2021,117724,0,0,172,93,79
2021,117724,10,0,172,93,79
2021,117724,10,4,172,93,79
2021,117724,20,0,144,77,67
2021,117724,20,4,144,77,67
2021,117724,30,0,26,16,10
2021,117724,30,4,26,16,10
2021,117724,40,0,2,0,2
2021,117724,40,4,2,0,2
2021,117724,42,0,1,0,1
2021,117724,42,4,1,0,1
2021,117724,43,0,1,0,1
2021,117724,43,4,1,0,1
2021,117733,0,0,180,86,94
2021,117733,10,0,180,86,94
2021,117733,10,4,180,86,94
2021,117733,20,0,153,78,75
2021,117733,20,4,153,78,75
2021,117733,30,0,22,8,14
2021,117733,30,4,22,8,14
2021,117733,40,0,5,0,5
2021,117733,40,4,5,0,5
2021,117733,42,0,4,0,4
2021,117733,42,4,4,0,4
2021,117733,43,0,1,0,1
2021,117733,43,4,1,0,1
2021,117751,0,0,69,57,12
2021,117751,10,0,69,57,12
2021,117751,10,1,22,21,1
2021,117751,10,2,15,13,2
2021,117751,10,3,27,21,6
2021,117751,10,4,2,1,1
2021,117751,10,5,3,1,2
2021,117751,40,0,69,57,12
2021,117751,40,1,22,21,1
2021,117751,40,2,15,13,2
2021,117751,40,3,27,21,6
2021,117751,40,4,2,1,1
2021,117751,40,5,3,1,2
2021,117751,42,0,69,57,12
2021,117751,42,1,22,21,1
2021,117751,42,2,15,13,2
2021,117751,42,3,27,21,6
2021,117751,42,4,2,1,1
2021,117751,42,5,3,1,2
2021,117788,0,0,164,72,92
2021,117788,10,0,164,72,92
2021,117788,10,4,164,72,92
2021,117788,20,0,134,61,73
2021,117788,20,4,134,61,73
2021,117788,30,0,23,9,14
2021,117788,30,4,23,9,14
2021,117788,40,0,7,2,5
2021,117788,40,4,7,2,5
2021,117788,42,0,1,0,1
2021,117788,42,4,1,0,1
2021,117788,43,0,6,2,4
2021,117788,43,4,6,2,4
2021,117803,0,0,25,4,21
2021,117803,10,0,25,4,21
2021,117803,10,6,25,4,21
2021,117803,40,0,25,4,21
2021,117803,40,6,25,4,21
2021,117803,41,0,25,4,21
2021,117803,41,6,25,4,21
2021,117803,45,0,25,4,21
2021,117803,45,6,25,4,21
2021,117867,0,0,105,45,60
2021,117867,10,0,105,45,60
2021,117867,10,4,105,45,60
2021,117867,20,0,87,39,48
2021,117867,20,4,87,39,48
2021,117867,30,0,14,6,8
2021,117867,30,4,14,6,8
2021,117867,40,0,4,0,4
2021,117867,40,4,4,0,4
2021,117867,42,0,4,0,4
2021,117867,42,4,4,0,4
2021,117894,0,0,143,70,73
2021,117894,10,0,143,70,73
2021,117894,10,4,143,70,73
2021,117894,20,0,80,37,43
2021,117894,20,4,80,37,43
2021,117894,30,0,38,20,18
2021,117894,30,4,38,20,18
2021,117894,40,0,25,13,12
2021,117894,40,4,25,13,12
2021,117894,42,0,3,2,1
2021,117894,42,4,3,2,1
2021,117894,43,0,22,11,11
2021,117894,43,4,22,11,11
2021,117946,0,0,620,303,317
2021,117946,10,0,620,303,317
2021,117946,10,1,242,141,101
2021,117946,10,2,143,55,88
2021,117946,10,3,190,92,98
2021,117946,10,4,39,11,28
2021,117946,10,6,6,4,2
2021,117946,20,0,332,181,151
2021,117946,20,1,220,131,89
2021,117946,20,2,109,48,61
2021,117946,20,3,3,2,1
2021,117946,30,0,100,44,56
2021,117946,30,2,4,1,3
2021,117946,30,3,96,43,53
2021,117946,40,0,188,78,110
2021,117946,40,1,22,10,12
2021,117946,40,2,30,6,24
2021,117946,40,3,91,47,44
2021,117946,40,4,39,11,28
2021,117946,40,6,6,4,2
2021,117946,41,0,188,78,110
2021,117946,41,1,22,10,12
2021,117946,41,2,30,6,24
2021,117946,41,3,91,47,44
2021,117946,41,4,39,11,28
2021,117946,41,6,6,4,2
2021,117946,44,0,188,78,110
2021,117946,44,1,22,10,12
2021,117946,44,2,30,6,24
2021,117946,44,3,91,47,44
2021,117946,44,4,39,11,28
2021,117946,44,6,6,4,2
2021,118198,0,0,15,7,8
2021,118198,10,0,15,7,8
2021,118198,10,4,15,7,8
2021,118198,40,0,15,7,8
2021,118198,40,4,15,7,8
2021,118198,41,0,15,7,8
2021,118198,41,4,15,7,8
2021,118198,45,0,15,7,8
2021,118198,45,4,15,7,8
2021,118347,0,0,120,51,69
2021,118347,10,0,120,51,69
2021,118347,10,4,120,51,69
2021,118347,20,0,95,40,55
2021,118347,20,4,95,40,55
2021,118347,30,0,16,6,10
2021,118347,30,4,16,6,10
2021,118347,40,0,9,5,4
2021,118347,40,4,9,5,4
2021,118347,43,0,9,5,4
2021,118347,43,4,9,5,4
2021,118541,0,0,25,14,11
2021,118541,10,0,25,14,11
2021,118541,10,1,16,8,8
2021,118541,10,2,6,3,3
2021,118541,10,3,3,3,0
2021,118541,40,0,25,14,11
2021,118541,40,1,16,8,8
2021,118541,40,2,6,3,3
2021,118541,40,3,3,3,0
2021,118541,41,0,25,14,11
2021,118541,41,1,16,8,8
2021,118541,41,2,6,3,3
2021,118541,41,3,3,3,0
2021,118541,44,0,25,14,11
2021,118541,44,1,16,8,8
2021,118541,44,2,6,3,3
2021,118541,44,3,3,3,0
2021,118684,0,0,60,31,29
2021,118684,10,0,60,31,29
2021,118684,10,4,60,31,29
2021,118684,20,0,17,9,8
2021,118684,20,4,17,9,8
2021,118684,30,0,29,16,13
2021,118684,30,4,29,16,13
2021,118684,40,0,14,6,8
2021,118684,40,4,14,6,8
2021,118684,42,0,14,6,8
2021,118684,42,4,14,6,8
2021,118693,0,0,24,12,12
2021,118693,10,0,24,12,12
2021,118693,10,1,6,1,5
2021,118693,10,2,9,6,3
2021,118693,10,3,5,3,2
2021,118693,10,5,4,2,2
2021,118693,40,0,24,12,12
2021,118693,40,1,6,1,5
2021,118693,40,2,9,6,3
2021,118693,40,3,5,3,2
2021,118693,40,5,4,2,2
2021,118693,41,0,19,9,10
2021,118693,41,1,5,1,4
2021,118693,41,2,8,5,3
2021,118693,41,3,5,3,2
2021,118693,41,5,1,0,1
2021,118693,42,0,5,3,2
2021,118693,42,1,1,0,1
2021,118693,42,2,1,1,0
2021,118693,42,5,3,2,1
2021,118693,44,0,19,9,10
2021,118693,44,1,5,1,4
2021,118693,44,2,8,5,3
2021,118693,44,3,5,3,2
2021,118693,44,5,1,0,1
2021,118718,0,0,182,83,99
2021,118718,10,0,182,83,99
2021,118718,10,4,182,83,99
2021,118718,20,0,141,63,78
2021,118718,20,4,141,63,78
2021,118718,30,0,35,18,17
2021,118718,30,4,35,18,17
2021,118718,40,0,6,2,4
2021,118718,40,4,6,2,4
2021,118718,42,0,6,2,4
2021,118718,42,4,6,2,4
2021,118772,0,0,65,22,43
2021,118772,10,0,65,22,43
2021,118772,10,4,65,22,43
2021,118772,20,0,35,13,22
2021,118772,20,4,35,13,22
2021,118772,30,0,23,9,14
2021,118772,30,4,23,9,14
2021,118772,40,0,7,0,7
2021,118772,40,4,7,0,7
2021,118772,42,0,1,0,1
2021,118772,42,4,1,0,1
2021,118772,43,0,6,0,6
2021,118772,43,4,6,0,6
2021,118888,0,0,68,19,49
2021,118888,10,0,68,19,49
2021,118888,10,1,33,12,21
2021,118888,10,2,15,2,13
2021,118888,10,3,20,5,15
2021,118888,20,0,38,11,27
2021,118888,20,1,24,8,16
2021,118888,20,2,11,2,9
2021,118888,20,3,3,1,2
2021,118888,30,0,4,1,3
2021,118888,30,3,4,1,3
2021,118888,40,0,26,7,19
2021,118888,40,1,9,4,5
2021,118888,40,2,4,0,4
2021,118888,40,3,13,3,10
2021,118888,41,0,3,1,2
2021,118888,41,1,2,1,1
2021,118888,41,2,1,0,1
2021,118888,42,0,23,6,17
2021,118888,42,1,7,3,4
2021,118888,42,2,3,0,3
2021,118888,42,3,13,3,10
2021,118888,44,0,3,1,2
2021,118888,44,1,2,1,1
2021,118888,44,2,1,0,1
2021,118912,0,0,174,81,93
2021,118912,10,0,174,81,93
2021,118912,10,4,174,81,93
2021,118912,20,0,137,68,69
2021,118912,20,4,137,68,69
2021,118912,30,0,34,12,22
2021,118912,30,4,34,12,22
2021,118912,40,0,3,1,2
2021,118912,40,4,3,1,2
2021,118912,43,0,3,1,2
2021,118912,43,4,3,1,2
2021,118930,0,0,164,61,103
2021,118930,10,0,164,61,103
2021,118930,10,4,164,61,103
2021,118930,20,0,106,38,68
2021,118930,20,4,106,38,68
2021,118930,30,0,32,16,16
2021,118930,30,4,32,16,16
2021,118930,40,0,26,7,19
2021,118930,40,4,26,7,19
2021,118930,43,0,26,7,19
2021,118930,43,4,26,7,19
2021,118976,0,0,255,113,142
2021,118976,10,0,255,113,142
2021,118976,10,4,255,113,142
2021,118976,20,0,89,38,51
2021,118976,20,4,89,38,51
2021,118976,30,0,51,34,17
2021,118976,30,4,51,34,17
2021,118976,40,0,115,41,74
2021,118976,40,4,115,41,74
2021,118976,42,0,104,36,68
2021,118976,42,4,104,36,68
2021,118976,43,0,11,5,6
2021,118976,43,4,11,5,6
2021,119058,0,0,69,34,35
2021,119058,10,0,69,34,35
2021,119058,10,1,19,7,12
2021,119058,10,2,26,13,13
2021,119058,10,3,10,6,4
2021,119058,10,6,14,8,6
2021,119058,40,0,69,34,35
2021,119058,40,1,19,7,12
2021,119058,40,2,26,13,13
2021,119058,40,3,10,6,4
2021,119058,40,6,14,8,6
2021,119058,41,0,66,32,34
2021,119058,41,1,19,7,12
2021,119058,41,2,26,13,13
2021,119058,41,3,10,6,4
2021,119058,41,6,11,6,5
2021,119058,42,0,3,2,1
2021,119058,42,6,3,2,1
2021,119058,44,0,66,32,34
2021,119058,44,1,19,7,12
2021,119058,44,2,26,13,13
2021,119058,44,3,10,6,4
2021,119058,44,6,11,6,5
2021,119067,0,0,127,58,69
2021,119067,10,0,127,58,69
2021,119067,10,4,127,58,69
2021,119067,20,0,71,40,31
2021,119067,20,4,71,40,31
2021,119067,30,0,43,14,29
2021,119067,30,4,43,14,29
2021,119067,40,0,13,4,9
2021,119067,40,4,13,4,9
2021,119067,42,0,1,0,1
2021,119067,42,4,1,0,1
2021,119067,43,0,12,4,8
2021,119067,43,4,12,4,8
2021,119137,0,0,172,77,95
2021,119137,10,0,172,77,95
2021,119137,10,4,172,77,95
2021,119137,20,0,137,62,75
2021,119137,20,4,137,62,75
2021,119137,30,0,28,12,16
2021,119137,30,4,28,12,16
2021,119137,40,0,7,3,4
2021,119137,40,4,7,3,4
2021,119137,42,0,6,3,3
2021,119137,42,4,6,3,3
2021,119137,43,0,1,0,1
2021,119137,43,4,1,0,1
2021,119164,0,0,445,206,239
2021,119164,10,0,445,206,239
2021,119164,10,4,445,206,239
2021,119164,20,0,345,161,184
2021,119164,20,4,345,161,184
2021,119164,30,0,87,41,46
2021,119164,30,4,87,41,46
2021,119164,40,0,13,4,9
2021,119164,40,4,13,4,9
2021,119164,42,0,5,1,4
2021,119164,42,4,5,1,4
2021,119164,43,0,8,3,5
2021,119164,43,4,8,3,5
2021,119173,0,0,135,38,97
2021,119173,10,0,135,38,97
2021,119173,10,1,36,13,23
2021,119173,10,2,37,11,26
2021,119173,10,3,51,10,41
2021,119173,10,4,5,4,1
2021,119173,10,5,6,0,6
2021,119173,20,0,59,17,42
2021,119173,20,1,33,11,22
2021,119173,20,2,21,5,16
2021,119173,20,3,5,1,4
2021,119173,30,0,21,7,14
2021,119173,30,1,1,1,0
2021,119173,30,2,10,4,6
2021,119173,30,3,10,2,8
2021,119173,40,0,55,14,41
2021,119173,40,1,2,1,1
2021,119173,40,2,6,2,4
2021,119173,40,3,36,7,29
2021,119173,40,4,5,4,1
2021,119173,40,5,6,0,6
2021,119173,42,0,55,14,41
2021,119173,42,1,2,1,1
2021,119173,42,2,6,2,4
2021,119173,42,3,36,7,29
2021,119173,42,4,5,4,1
2021,119173,42,5,6,0,6
2021,119216,0,0,181,84,97
2021,119216,10,0,181,84,97
2021,119216,10,4,181,84,97
2021,119216,20,0,148,65,83
2021,119216,20,4,148,65,83
2021,119216,30,0,24,14,10
2021,119216,30,4,24,14,10
2021,119216,40,0,9,5,4
2021,119216,40,4,9,5,4
2021,119216,42,0,9,5,4
2021,119216,42,4,9,5,4
2021,119270,0,0,53,43,10
2021,119270,10,0,53,43,10
2021,119270,10,4,53,43,10
2021,119270,40,0,53,43,10
2021,119270,40,4,53,43,10
2021,119270,41,0,53,43,10
2021,119270,41,4,53,43,10
2021,119270,45,0,53,43,10
2021,119270,45,4,53,43,10
2021,119331,0,0,114,38,76
2021,119331,10,0,114,38,76
2021,119331,10,4,114,38,76
2021,119331,20,0,84,30,54
2021,119331,20,4,84,30,54
2021,119331,30,0,28,8,20
2021,119331,30,4,28,8,20
2021,119331,40,0,2,0,2
2021,119331,40,4,2,0,2
2021,119331,42,0,1,0,1
2021,119331,42,4,1,0,1
2021,119331,43,0,1,0,1
2021,119331,43,4,1,0,1
2021,119605,0,0,237,113,124
2021,119605,10,0,237,113,124
2021,119605,10,1,107,57,50
2021,119605,10,2,60,31,29
2021,119605,10,3,57,18,39
2021,119605,10,4,13,7,6
2021,119605,40,0,237,113,124
2021,119605,40,1,107,57,50
2021,119605,40,2,60,31,29
2021,119605,40,3,57,18,39
2021,119605,40,4,13,7,6
2021,119605,41,0,222,108,114
2021,119605,41,1,106,57,49
2021,119605,41,2,60,31,29
2021,119605,41,3,43,13,30
2021,119605,41,4,13,7,6
2021,119605,42,0,15,5,10
2021,119605,42,1,1,0,1
2021,119605,42,3,14,5,9
2021,119605,44,0,222,108,114
2021,119605,44,1,106,57,49
2021,119605,44,2,60,31,29
2021,119605,44,3,43,13,30
2021,119605,44,4,13,7,6
2021,119678,0,0,301,247,54
2021,119678,10,0,301,247,54
2021,119678,10,1,95,78,17
2021,119678,10,2,84,69,15
2021,119678,10,3,47,37,10
2021,119678,10,5,75,63,12
2021,119678,20,0,121,97,24
2021,119678,20,1,70,57,13
2021,119678,20,2,51,40,11
2021,119678,30,0,56,46,10
2021,119678,30,2,9,9,0
2021,119678,30,3,47,37,10
2021,119678,40,0,124,104,20
2021,119678,40,1,25,21,4
2021,119678,40,2,24,20,4
2021,119678,40,5,75,63,12
2021,119678,42,0,124,104,20
2021,119678,42,1,25,21,4
2021,119678,42,2,24,20,4
2021,119678,42,5,75,63,12
2021,119775,0,0,10,6,4
2021,119775,10,0,10,6,4
2021,119775,10,1,4,3,1
2021,119775,10,2,4,1,3
2021,119775,10,3,2,2,0
2021,119775,40,0,10,6,4
2021,119775,40,1,4,3,1
2021,119775,40,2,4,1,3
2021,119775,40,3,2,2,0
2021,119775,42,0,10,6,4
2021,119775,42,1,4,3,1
2021,119775,42,2,4,1,3
2021,119775,42,3,2,2,0
2021,120078,0,0,14,4,10
2021,120078,50,0,14,4,10
2021,120166,0,0,4,4,0
2021,120166,10,0,4,4,0
2021,120166,10,4,4,4,0
2021,120166,40,0,4,4,0
2021,120166,40,4,4,4,0
2021,120166,41,0,4,4,0
2021,120166,41,4,4,4,0
2021,120166,45,0,4,4,0
2021,120166,45,4,4,4,0
2021,120184,0,0,8,3,5
2021,120184,10,0,8,3,5
2021,120184,10,1,2,0,2
2021,120184,10,2,5,2,3
2021,120184,10,4,1,1,0
2021,120184,20,0,3,0,3
2021,120184,20,1,2,0,2
2021,120184,20,2,1,0,1
2021,120184,40,0,5,3,2
2021,120184,40,2,4,2,2
2021,120184,40,4,1,1,0
2021,120184,42,0,5,3,2
2021,120184,42,2,4,2,2
2021,120184,42,4,1,1,0
2021,120254,0,0,194,95,99
2021,120254,10,0,194,95,99
2021,120254,10,1,66,32,34
2021,120254,10,2,47,22,25
2021,120254,10,3,28,14,14
2021,120254,10,6,53,27,26
2021,120254,20,0,111,52,59
2021,120254,20,1,66,32,34
2021,120254,20,2,45,20,25
2021,120254,30,0,30,16,14
2021,120254,30,2,2,2,0
2021,120254,30,3,28,14,14
2021,120254,40,0,53,27,26
2021,120254,40,6,53,27,26
2021,120254,41,0,39,19,20
2021,120254,41,6,39,19,20
2021,120254,42,0,14,8,6
2021,120254,42,6,14,8,6
2021,120254,44,0,39,19,20
2021,120254,44,6,39,19,20
2021,120290,0,0,120,50,70
2021,120290,10,0,120,50,70
2021,120290,10,4,120,50,70
2021,120290,20,0,75,32,43
2021,120290,20,4,75,32,43
2021,120290,30,0,35,17,18
2021,120290,30,4,35,17,18
2021,120290,40,0,10,1,9
2021,120290,40,4,10,1,9
2021,120290,42,0,8,1,7
2021,120290,42,4,8,1,7
2021,120290,43,0,2,0,2
2021,120290,43,4,2,0,2
2021,120342,0,0,260,125,135
2021,120342,10,0,260,125,135
2021,120342,10,4,260,125,135
2021,120342,20,0,209,105,104
2021,120342,20,4,209,105,104
2021,120342,30,0,49,20,29
2021,120342,30,4,49,20,29
2021,120342,40,0,2,0,2
2021,120342,40,4,2,0,2
2021,120342,43,0,2,0,2
2021,120342,43,4,2,0,2
2021,120403,0,0,47,17,30
2021,120403,10,0,47,17,30
2021,120403,10,1,15,6,9
2021,120403,10,2,17,7,10
2021,120403,10,3,15,4,11
2021,120403,40,0,47,17,30
2021,120403,40,1,15,6,9
2021,120403,40,2,17,7,10
2021,120403,40,3,15,4,11
2021,120403,41,0,23,11,12
2021,120403,41,1,12,5,7
2021,120403,41,2,10,6,4
2021,120403,41,3,1,0,1
2021,120403,42,0,24,6,18
2021,120403,42,1,3,1,2
2021,120403,42,2,7,1,6
2021,120403,42,3,14,4,10
2021,120403,44,0,23,11,12
2021,120403,44,1,12,5,7
2021,120403,44,2,10,6,4
2021,120403,44,3,1,0,1
2021,120421,0,0,103,47,56
2021,120421,10,0,103,47,56
2021,120421,10,4,103,47,56
2021,120421,20,0,78,39,39
2021,120421,20,4,78,39,39
2021,120421,30,0,19,5,14
2021,120421,30,4,19,5,14
2021,120421,40,0,6,3,3
2021,120421,40,4,6,3,3
2021,120421,42,0,5,2,3
2021,120421,42,4,5,2,3
2021,120421,43,0,1,1,0
2021,120421,43,4,1,1,0
2021,120537,0,0,34,14,20
2021,120537,10,0,34,14,20
2021,120537,10,1,4,2,2
2021,120537,10,2,15,8,7
2021,120537,10,3,15,4,11
2021,120537,40,0,34,14,20
2021,120537,40,1,4,2,2
2021,120537,40,2,15,8,7
2021,120537,40,3,15,4,11
2021,120537,42,0,34,14,20
2021,120537,42,1,4,2,2
2021,120537,42,2,15,8,7
2021,120537,42,3,15,4,11
2021,120661,0,0,18,5,13
2021,120661,10,0,18,5,13
2021,120661,10,4,18,5,13
2021,120661,40,0,18,5,13
2021,120661,40,4,18,5,13
2021,120661,41,0,18,5,13
2021,120661,41,4,18,5,13
2021,120661,45,0,18,5,13
2021,120661,45,4,18,5,13
2021,120698,0,0,51,16,35
2021,120698,10,0,51,16,35
2021,120698,10,1,20,10,10
2021,120698,10,2,13,1,12
2021,120698,10,3,18,5,13
2021,120698,20,0,24,6,18
2021,120698,20,1,15,6,9
2021,120698,20,2,9,0,9
2021,120698,30,0,8,3,5
2021,120698,30,1,2,2,0
2021,120698,30,2,1,0,1
2021,120698,30,3,5,1,4
2021,120698,40,0,19,7,12
2021,120698,40,1,3,2,1
2021,120698,40,2,3,1,2
2021,120698,40,3,13,4,9
2021,120698,42,0,19,7,12
2021,120698,42,1,3,2,1
2021,120698,42,2,3,1,2
2021,120698,42,3,13,4,9
2021,120768,0,0,25,4,21
2021,120768,10,0,25,4,21
2021,120768,10,6,25,4,21
2021,120768,40,0,25,4,21
2021,120768,40,6,25,4,21
2021,120768,42,0,25,4,21
2021,120768,42,6,25,4,21
2021,120795,0,0,8,4,4
2021,120795,10,0,8,4,4
2021,120795,10,1,2,1,1
2021,120795,10,2,1,1,0
2021,120795,10,3,5,2,3
2021,120795,20,0,2,1,1
2021,120795,20,1,2,1,1
2021,120795,40,0,6,3,3
2021,120795,40,2,1,1,0
2021,120795,40,3,5,2,3
2021,120795,41,0,6,3,3
2021,120795,41,2,1,1,0
2021,120795,41,3,5,2,3
2021,120795,44,0,6,3,3
2021,120795,44,2,1,1,0
2021,120795,44,3,5,2,3
2021,120865,0,0,65,32,33
2021,120865,10,0,65,32,33
2021,120865,10,1,29,17,12
2021,120865,10,2,9,5,4
2021,120865,10,3,24,8,16
2021,120865,10,4,3,2,1
2021,120865,20,0,24,12,12
2021,120865,20,1,18,9,9
2021,120865,20,2,6,3,3
2021,120865,30,0,21,12,9
2021,120865,30,1,8,5,3
2021,120865,30,2,2,2,0
2021,120865,30,3,9,3,6
2021,120865,30,4,2,2,0
2021,120865,40,0,20,8,12
2021,120865,40,1,3,3,0
2021,120865,40,2,1,0,1
2021,120865,40,3,15,5,10
2021,120865,40,4,1,0,1
2021,120865,42,0,20,8,12
2021,120865,42,1,3,3,0
2021,120865,42,2,1,0,1
2021,120865,42,3,15,5,10
2021,120865,42,4,1,0,1
2021,120883,0,0,410,216,194
2021,120883,10,0,410,216,194
2021,120883,10,1,155,92,63
2021,120883,10,2,114,64,50
2021,120883,10,3,110,43,67
2021,120883,10,4,16,8,8
2021,120883,10,5,15,9,6
2021,120883,20,0,231,138,93
2021,120883,20,1,134,84,50
2021,120883,20,2,93,51,42
2021,120883,20,3,4,3,1
2021,120883,30,0,47,24,23
2021,120883,30,1,1,1,0
2021,120883,30,2,3,3,0
2021,120883,30,3,43,20,23
2021,120883,40,0,132,54,78
2021,120883,40,1,20,7,13
2021,120883,40,2,18,10,8
2021,120883,40,3,63,20,43
2021,120883,40,4,16,8,8
2021,120883,40,5,15,9,6
2021,120883,41,0,132,54,78
2021,120883,41,1,20,7,13
2021,120883,41,2,18,10,8
2021,120883,41,3,63,20,43
2021,120883,41,4,16,8,8
2021,120883,41,5,15,9,6
2021,120883,44,0,132,54,78
2021,120883,44,1,20,7,13
2021,120883,44,2,18,10,8
2021,120883,44,3,63,20,43
2021,120883,44,4,16,8,8
2021,120883,44,5,15,9,6
2021,120953,0,0,36,21,15
2021,120953,10,0,36,21,15
2021,120953,10,4,36,21,15
2021,120953,20,0,17,11,6
2021,120953,20,4,17,11,6
2021,120953,30,0,19,10,9
2021,120953,30,4,19,10,9
2021,120971,0,0,276,128,148
2021,120971,10,0,276,128,148
2021,120971,10,4,276,128,148
2021,120971,20,0,112,53,59
2021,120971,20,4,112,53,59
2021,120971,30,0,161,73,88
2021,120971,30,4,161,73,88
2021,120971,40,0,3,2,1
2021,120971,40,4,3,2,1
2021,120971,43,0,3,2,1
2021,120971,43,4,3,2,1
2021,121044,0,0,427,182,245
2021,121044,10,0,427,182,245
2021,121044,10,4,427,182,245
2021,121044,20,0,209,81,128
2021,121044,20,4,209,81,128
2021,121044,30,0,185,84,101
2021,121044,30,4,185,84,101
2021,121044,40,0,33,17,16
2021,121044,40,4,33,17,16
2021,121044,42,0,10,2,8
2021,121044,42,4,10,2,8
2021,121044,43,0,23,15,8
2021,121044,43,4,23,15,8
2021,121150,0,0,412,218,194
2021,121150,10,0,412,218,194
2021,121150,10,1,126,87,39
2021,121150,10,2,83,39,44
2021,121150,10,3,96,44,52
2021,121150,10,4,36,18,18
2021,121150,10,5,19,9,10
2021,121150,10,6,52,21,31
2021,121150,20,0,190,121,69
2021,121150,20,1,117,82,35
2021,121150,20,2,69,35,34
2021,121150,20,3,4,4,0
2021,121150,30,0,70,34,36
2021,121150,30,1,2,1,1
2021,121150,30,2,11,3,8
2021,121150,30,3,57,30,27
2021,121150,40,0,152,63,89
2021,121150,40,1,7,4,3
2021,121150,40,2,3,1,2
2021,121150,40,3,35,10,25
2021,121150,40,4,36,18,18
2021,121150,40,5,19,9,10
2021,121150,40,6,52,21,31
2021,121150,42,0,152,63,89
2021,121150,42,1,7,4,3
2021,121150,42,2,3,1,2
2021,121150,42,3,35,10,25
2021,121150,42,4,36,18,18
2021,121150,42,5,19,9,10
2021,121150,42,6,52,21,31
2021,121178,0,0,3,1,2
2021,121178,10,0,3,1,2
2021,121178,10,4,3,1,2
2021,121178,20,0,2,1,1
2021,121178,20,4,2,1,1
2021,121178,30,0,1,0,1
2021,121178,30,4,1,0,1
2021,121257,0,0,95,41,54
2021,121257,10,0,95,41,54
2021,121257,10,1,43,22,21
2021,121257,10,2,17,6,11
2021,121257,10,3,24,9,15
2021,121257,10,4,9,4,5
2021,121257,10,5,2,0,2
2021,121257,20,0,60,28,32
2021,121257,20,1,43,22,21
2021,121257,20,2,17,6,11
2021,121257,30,0,14,3,11
2021,121257,30,3,14,3,11
2021,121257,40,0,21,10,11
2021,121257,40,3,10,6,4
2021,121257,40,4,9,4,5
2021,121257,40,5,2,0,2
2021,121257,41,0,2,2,0
2021,121257,41,3,2,2,0
2021,121257,42,0,17,8,9
2021,121257,42,3,8,4,4
2021,121257,42,4,8,4,4
2021,121257,42,5,1,0,1
2021,121257,43,0,2,0,2
2021,121257,43,4,1,0,1
2021,121257,43,5,1,0,1
2021,121257,44,0,2,2,0
2021,121257,44,3,2,2,0
2021,121275,0,0,5,3,2
2021,121275,10,0,5,3,2
2021,121275,10,4,5,3,2
2021,121275,40,0,5,3,2
2021,121275,40,4,5,3,2
2021,121275,41,0,5,3,2
2021,121275,41,4,5,3,2
2021,121275,45,0,5,3,2
2021,121275,45,4,5,3,2
2021,121309,0,0,141,69,72
2021,121309,10,0,141,69,72
2021,121309,10,1,81,52,29
2021,121309,10,2,41,11,30
2021,121309,10,3,19,6,13
2021,121309,20,0,75,47,28
2021,121309,20,1,72,47,25
2021,121309,20,2,3,0,3
2021,121309,30,0,54,18,36
2021,121309,30,1,7,4,3
2021,121309,30,2,30,9,21
2021,121309,30,3,17,5,12
2021,121309,40,0,12,4,8
2021,121309,40,1,2,1,1
2021,121309,40,2,8,2,6
2021,121309,40,3,2,1,1
2021,121309,41,0,2,1,1
2021,121309,41,1,2,1,1
2021,121309,42,0,10,3,7
2021,121309,42,2,8,2,6
2021,121309,42,3,2,1,1
2021,121309,44,0,2,1,1
2021,121309,44,1,2,1,1
2021,121345,0,0,225,118,107
2021,121345,10,0,176,100,76
2021,121345,10,1,91,52,39
2021,121345,10,2,56,33,23
2021,121345,10,3,29,15,14
2021,121345,20,0,145,85,60
2021,121345,20,1,89,52,37
2021,121345,20,2,56,33,23
2021,121345,30,0,29,15,14
2021,121345,30,3,29,15,14
2021,121345,40,0,2,0,2
2021,121345,40,1,2,0,2
2021,121345,41,0,2,0,2
2021,121345,41,1,2,0,2
2021,121345,44,0,2,0,2
2021,121345,44,1,2,0,2
2021,121345,50,0,49,18,31
2021,121363,0,0,72,31,41
2021,121363,10,0,72,31,41
2021,121363,10,4,72,31,41
2021,121363,20,0,54,23,31
2021,121363,20,4,54,23,31
2021,121363,30,0,10,4,6
2021,121363,30,4,10,4,6
2021,121363,40,0,8,4,4
2021,121363,40,4,8,4,4
2021,121363,42,0,4,2,2
2021,121363,42,4,4,2,2
2021,121363,43,0,4,2,2
2021,121363,43,4,4,2,2
2021,121619,0,0,244,111,133
2021,121619,10,0,244,111,133
2021,121619,10,4,244,111,133
2021,121619,20,0,75,32,43
2021,121619,20,4,75,32,43
2021,121619,30,0,155,74,81
2021,121619,30,4,155,74,81
2021,121619,40,0,14,5,9
2021,121619,40,4,14,5,9
2021,121619,42,0,7,3,4
2021,121619,42,4,7,3,4
2021,121619,43,0,7,2,5
2021,121619,43,4,7,2,5
2021,121691,0,0,199,94,105
2021,121691,10,0,199,94,105
2021,121691,10,1,114,52,62
2021,121691,10,2,27,17,10
2021,121691,10,3,20,10,10
2021,121691,10,5,11,3,8
2021,121691,10,6,27,12,15
2021,121691,20,0,141,69,72
2021,121691,20,1,114,52,62
2021,121691,20,2,27,17,10
2021,121691,30,0,20,10,10
2021,121691,30,3,20,10,10
2021,121691,40,0,38,15,23
2021,121691,40,5,11,3,8
2021,121691,40,6,27,12,15
2021,121691,41,0,16,6,10
2021,121691,41,5,11,3,8
2021,121691,41,6,5,3,2
2021,121691,42,0,22,9,13
2021,121691,42,6,22,9,13
2021,121691,44,0,16,6,10
2021,121691,44,5,11,3,8
2021,121691,44,6,5,3,2
2021,121707,0,0,68,33,35
2021,121707,10,0,68,33,35
2021,121707,10,4,68,33,35
2021,121707,20,0,55,29,26
2021,121707,20,4,55,29,26
2021,121707,30,0,9,2,7
2021,121707,30,4,9,2,7
2021,121707,40,0,4,2,2
2021,121707,40,4,4,2,2
2021,121707,42,0,4,2,2
2021,121707,42,4,4,2,2
2021,121886,0,0,206,99,107
2021,121886,10,0,206,99,107
2021,121886,10,4,206,99,107
2021,121886,20,0,166,84,82
2021,121886,20,4,166,84,82
2021,121886,30,0,34,11,23
2021,121886,30,4,34,11,23
2021,121886,40,0,6,4,2
2021,121886,40,4,6,4,2
2021,121886,43,0,6,4,2
2021,121886,43,4,6,4,2
2021,121901,0,0,267,124,143
2021,121901,10,0,267,124,143
2021,121901,10,4,267,124,143
2021,121901,20,0,195,95,100
2021,121901,20,4,195,95,100
2021,121901,30,0,66,28,38
2021,121901,30,4,66,28,38
2021,121901,40,0,6,1,5
2021,121901,40,4,6,1,5
2021,121901,42,0,4,1,3
2021,121901,42,4,4,1,3
2021,121901,43,0,2,0,2
2021,121901,43,4,2,0,2
2021,122180,0,0,286,132,154
2021,122180,10,0,286,132,154
2021,122180,10,4,286,132,154
2021,122180,20,0,225,105,120
2021,122180,20,4,225,105,120
2021,122180,30,0,59,25,34
2021,122180,30,4,59,25,34
2021,122180,40,0,2,2,0
2021,122180,40,4,2,2,0
2021,122180,43,0,2,2,0
2021,122180,43,4,2,2,0
2021,122205,0,0,239,98,141
2021,122205,10,0,239,98,141
2021,122205,10,4,239,98,141
2021,122205,20,0,211,87,124
2021,122205,20,4,211,87,124
2021,122205,30,0,27,10,17
2021,122205,30,4,27,10,17
2021,122205,40,0,1,1,0
2021,122205,40,4,1,1,0
2021,122205,43,0,1,1,0
2021,122205,43,4,1,1,0
2021,122296,0,0,181,47,134
2021,122296,10,0,181,47,134
2021,122296,10,1,20,9,11
2021,122296,10,2,22,4,18
2021,122296,10,3,104,25,79
2021,122296,10,4,35,9,26
2021,122296,40,0,181,47,134
2021,122296,40,1,20,9,11
2021,122296,40,2,22,4,18
2021,122296,40,3,104,25,79
2021,122296,40,4,35,9,26
2021,122296,41,0,31,7,24
2021,122296,41,1,11,3,8
2021,122296,41,2,7,2,5
2021,122296,41,3,13,2,11
2021,122296,42,0,150,40,110
2021,122296,42,1,9,6,3
2021,122296,42,2,15,2,13
2021,122296,42,3,91,23,68
2021,122296,42,4,35,9,26
2021,122296,44,0,31,7,24
2021,122296,44,1,11,3,8
2021,122296,44,2,7,2,5
2021,122296,44,3,13,2,11
2021,122339,0,0,171,61,110
2021,122339,10,0,171,61,110
2021,122339,10,4,171,61,110
2021,122339,20,0,9,1,8
2021,122339,20,4,9,1,8
2021,122339,30,0,160,60,100
2021,122339,30,4,160,60,100
2021,122339,40,0,2,0,2
2021,122339,40,4,2,0,2
2021,122339,43,0,2,0,2
2021,122339,43,4,2,0,2
2021,122375,0,0,252,111,141
2021,122375,10,0,252,111,141
2021,122375,10,4,252,111,141
2021,122375,20,0,19,11,8
2021,122375,20,4,19,11,8
2021,122375,30,0,228,97,131
2021,122375,30,4,228,97,131
2021,122375,40,0,5,3,2
2021,122375,40,4,5,3,2
2021,122375,43,0,5,3,2
2021,122375,43,4,5,3,2
2021,122384,0,0,126,71,55
2021,122384,10,0,126,71,55
2021,122384,10,4,126,71,55
2021,122384,20,0,5,4,1
2021,122384,20,4,5,4,1
2021,122384,30,0,117,64,53
2021,122384,30,4,117,64,53
2021,122384,40,0,4,3,1
2021,122384,40,4,4,3,1
2021,122384,43,0,4,3,1
2021,122384,43,4,4,3,1
2021,122409,0,0,974,520,454
2021,122409,10,0,974,520,454
2021,122409,10,1,293,190,103
2021,122409,10,2,248,136,112
2021,122409,10,3,210,96,114
2021,122409,10,5,219,95,124
2021,122409,10,6,4,3,1
2021,122409,20,0,542,328,214
2021,122409,20,1,293,190,103
2021,122409,20,2,244,134,110
2021,122409,20,3,1,1,0
2021,122409,20,6,4,3,1
2021,122409,30,0,213,97,116
2021,122409,30,2,4,2,2
2021,122409,30,3,209,95,114
2021,122409,40,0,219,95,124
2021,122409,40,5,219,95,124
2021,122409,41,0,136,56,80
2021,122409,41,5,136,56,80
2021,122409,42,0,58,24,34
2021,122409,42,5,58,24,34
2021,122409,43,0,25,15,10
2021,122409,43,5,25,15,10
2021,122409,44,0,136,56,80
2021,122409,44,5,136,56,80
2021,122436,0,0,495,246,249
2021,122436,10,0,495,246,249
2021,122436,10,1,222,131,91
2021,122436,10,2,136,68,68
2021,122436,10,3,122,41,81
2021,122436,10,4,15,6,9
2021,122436,20,0,281,163,118
2021,122436,20,1,162,98,64
2021,122436,20,2,118,64,54
2021,122436,20,3,1,1,0
2021,122436,30,0,68,24,44
2021,122436,30,2,5,1,4
2021,122436,30,3,63,23,40
2021,122436,40,0,146,59,87
2021,122436,40,1,60,33,27
2021,122436,40,2,13,3,10
2021,122436,40,3,58,17,41
2021,122436,40,4,15,6,9
2021,122436,41,0,81,29,52
2021,122436,41,1,35,15,20
2021,122436,41,2,10,2,8
2021,122436,41,3,26,9,17
2021,122436,41,4,10,3,7
2021,122436,42,0,65,30,35
2021,122436,42,1,25,18,7
2021,122436,42,2,3,1,2
2021,122436,42,3,32,8,24
2021,122436,42,4,5,3,2
2021,122436,44,0,40,15,25
2021,122436,44,1,10,4,6
2021,122436,44,3,21,9,12
2021,122436,44,4,9,2,7
2021,122436,45,0,41,14,27
2021,122436,45,1,25,11,14
2021,122436,45,2,10,2,8
2021,122436,45,3,5,0,5
2021,122436,45,4,1,1,0
2021,122454,0,0,14,8,6
2021,122454,10,0,14,8,6
2021,122454,10,1,2,1,1
2021,122454,10,2,9,5,4
2021,122454,10,3,3,2,1
2021,122454,20,0,11,6,5
2021,122454,20,1,2,1,1
2021,122454,20,2,9,5,4
2021,122454,30,0,3,2,1
2021,122454,30,3,3,2,1
2021,122506,0,0,29,23,6
2021,122506,10,0,29,23,6
2021,122506,10,6,29,23,6
2021,122506,40,0,29,23,6
2021,122506,40,6,29,23,6
2021,122506,41,0,1,1,0
2021,122506,41,6,1,1,0
2021,122506,42,0,28,22,6
2021,122506,42,6,28,22,6
2021,122506,45,0,1,1,0
2021,122506,45,6,1,1,0
2021,122597,0,0,866,403,463
2021,122597,10,0,866,403,463
2021,122597,10,1,345,176,169
2021,122597,10,2,172,76,96
2021,122597,10,3,161,52,109
2021,122597,10,5,186,98,88
2021,122597,10,6,2,1,1
2021,122597,20,0,518,252,266
2021,122597,20,1,345,176,169
2021,122597,20,2,170,75,95
2021,122597,20,3,1,0,1
2021,122597,20,6,2,1,1
2021,122597,30,0,162,53,109
2021,122597,30,2,2,1,1
2021,122597,30,3,160,52,108
2021,122597,40,0,186,98,88
2021,122597,40,5,186,98,88
2021,122597,41,0,108,56,52
2021,122597,41,5,108,56,52
2021,122597,42,0,63,35,28
2021,122597,42,5,63,35,28
2021,122597,43,0,15,7,8
2021,122597,43,5,15,7,8
2021,122597,44,0,108,56,52
2021,122597,44,5,108,56,52
2021,122612,0,0,444,195,249
2021,122612,10,0,444,195,249
2021,122612,10,1,160,88,72
2021,122612,10,2,147,58,89
2021,122612,10,3,118,38,80
2021,122612,10,4,19,11,8
2021,122612,20,0,261,124,137
2021,122612,20,1,141,76,65
2021,122612,20,2,119,47,72
2021,122612,20,3,1,1,0
2021,122612,30,0,61,23,38
2021,122612,30,2,6,3,3
2021,122612,30,3,55,20,35
2021,122612,40,0,122,48,74
2021,122612,40,1,19,12,7
2021,122612,40,2,22,8,14
2021,122612,40,3,62,17,45
2021,122612,40,4,19,11,8
2021,122612,41,0,70,28,42
2021,122612,41,1,16,11,5
2021,122612,41,2,19,7,12
2021,122612,41,3,27,5,22
2021,122612,41,4,8,5,3
2021,122612,42,0,49,19,30
2021,122612,42,1,3,1,2
2021,122612,42,2,3,1,2
2021,122612,42,3,33,12,21
2021,122612,42,4,10,5,5
2021,122612,43,0,3,1,2
2021,122612,43,3,2,0,2
2021,122612,43,4,1,1,0
2021,122612,44,0,68,27,41
2021,122612,44,1,16,11,5
2021,122612,44,2,19,7,12
2021,122612,44,3,26,5,21
2021,122612,44,4,7,4,3
2021,122612,45,0,2,1,1
2021,122612,45,3,1,0,1
2021,122612,45,4,1,1,0
2021,122649,0,0,6,2,4
2021,122649,10,0,6,2,4
2021,122649,10,1,6,2,4
2021,122649,40,0,6,2,4
2021,122649,40,1,6,2,4
2021,122649,41,0,4,2,2
2021,122649,41,1,4,2,2
2021,122649,42,0,2,0,2
2021,122649,42,1,2,0,2
2021,122649,44,0,4,2,2
2021,122649,44,1,4,2,2
2021,122658,0,0,233,114,119
2021,122658,10,0,233,114,119
2021,122658,10,4,233,114,119
2021,122658,20,0,161,82,79
2021,122658,20,4,161,82,79
2021,122658,30,0,33,15,18
2021,122658,30,4,33,15,18
2021,122658,40,0,39,17,22
2021,122658,40,4,39,17,22
2021,122658,42,0,4,1,3
2021,122658,42,4,4,1,3
2021,122658,43,0,35,16,19
2021,122658,43,4,35,16,19
2021,122685,0,0,53,12,41
2021,122685,10,0,53,12,41
2021,122685,10,4,53,12,41
2021,122685,40,0,53,12,41
2021,122685,40,4,53,12,41
2021,122685,41,0,53,12,41
2021,122685,41,4,53,12,41
2021,122685,45,0,53,12,41
2021,122685,45,4,53,12,41
2021,122694,0,0,24,7,17
2021,122694,10,0,24,7,17
2021,122694,10,4,24,7,17
2021,122694,40,0,24,7,17
2021,122694,40,4,24,7,17
2021,122694,41,0,24,7,17
2021,122694,41,4,24,7,17
2021,122694,45,0,24,7,17
2021,122694,45,4,24,7,17
2021,122728,0,0,49,34,15
2021,122728,10,0,49,34,15
2021,122728,10,1,4,2,2
2021,122728,10,2,27,19,8
2021,122728,10,3,15,10,5
2021,122728,10,6,3,3,0
2021,122728,20,0,11,7,4
2021,122728,20,1,3,1,2
2021,122728,20,2,8,6,2
2021,122728,30,0,35,24,11
2021,122728,30,1,1,1,0
2021,122728,30,2,19,13,6
2021,122728,30,3,15,10,5
2021,122728,40,0,3,3,0
2021,122728,40,6,3,3,0
2021,122728,42,0,2,2,0
2021,122728,42,6,2,2,0
2021,122728,43,0,1,1,0
2021,122728,43,6,1,1,0
2021,122746,0,0,124,46,78
2021,122746,10,0,124,46,78
2021,122746,10,4,124,46,78
2021,122746,20,0,46,17,29
2021,122746,20,4,46,17,29
2021,122746,30,0,53,22,31
2021,122746,30,4,53,22,31
2021,122746,40,0,25,7,18
2021,122746,40,4,25,7,18
2021,122746,42,0,19,7,12
2021,122746,42,4,19,7,12
2021,122746,43,0,6,0,6
2021,122746,43,4,6,0,6
2021,122755,0,0,904,423,481
2021,122755,10,0,904,423,481
2021,122755,10,1,269,145,124
2021,122755,10,2,164,67,97
2021,122755,10,3,274,129,145
2021,122755,10,5,195,81,114
2021,122755,10,6,2,1,1
2021,122755,20,0,436,215,221
2021,122755,20,1,269,145,124
2021,122755,20,2,163,67,96
2021,122755,20,3,2,2,0
2021,122755,20,6,2,1,1
2021,122755,30,0,273,127,146
2021,122755,30,2,1,0,1
2021,122755,30,3,272,127,145
2021,122755,40,0,195,81,114
2021,122755,40,5,195,81,114
2021,122755,41,0,130,56,74
2021,122755,41,5,130,56,74
2021,122755,42,0,62,24,38
2021,122755,42,5,62,24,38
2021,122755,43,0,3,1,2
2021,122755,43,5,3,1,2
2021,122755,44,0,130,56,74
2021,122755,44,5,130,56,74
2021,122782,0,0,1,0,1
2021,122782,10,0,1,0,1
2021,122782,10,4,1,0,1
2021,122782,20,0,1,0,1
2021,122782,20,4,1,0,1
2021,122791,0,0,154,69,85
2021,122791,10,0,154,69,85
2021,122791,10,4,154,69,85
2021,122791,20,0,111,52,59
2021,122791,20,4,111,52,59
2021,122791,30,0,36,15,21
2021,122791,30,4,36,15,21
2021,122791,40,0,7,2,5
2021,122791,40,4,7,2,5
2021,122791,43,0,7,2,5
2021,122791,43,4,7,2,5
2021,122889,0,0,225,103,122
2021,122889,10,0,225,103,122
2021,122889,10,4,225,103,122
2021,122889,20,0,180,84,96
2021,122889,20,4,180,84,96
2021,122889,30,0,25,10,15
2021,122889,30,4,25,10,15
2021,122889,40,0,20,9,11
2021,122889,40,4,20,9,11
2021,122889,42,0,20,9,11
2021,122889,42,4,20,9,11
2021,122931,0,0,583,301,282
2021,122931,10,0,583,301,282
2021,122931,10,1,146,87,59
2021,122931,10,2,149,87,62
2021,122931,10,3,110,46,64
2021,122931,10,5,178,81,97
2021,122931,20,0,293,172,121
2021,122931,20,1,146,87,59
2021,122931,20,2,147,85,62
2021,122931,30,0,112,48,64
2021,122931,30,2,2,2,0
2021,122931,30,3,110,46,64
2021,122931,40,0,178,81,97
2021,122931,40,5,178,81,97
2021,122931,41,0,160,70,90
2021,122931,41,5,160,70,90
2021,122931,42,0,18,11,7
2021,122931,42,5,18,11,7
2021,122931,44,0,113,54,59
2021,122931,44,5,113,54,59
2021,122931,45,0,47,16,31
2021,122931,45,5,47,16,31
2021,122977,0,0,324,138,186
2021,122977,10,0,324,138,186
2021,122977,10,4,324,138,186
2021,122977,20,0,252,111,141
2021,122977,20,4,252,111,141
2021,122977,30,0,57,21,36
2021,122977,30,4,57,21,36
2021,122977,40,0,15,6,9
2021,122977,40,4,15,6,9
2021,122977,42,0,2,1,1
2021,122977,42,4,2,1,1
2021,122977,43,0,13,5,8
2021,122977,43,4,13,5,8
2021,123013,0,0,294,119,175
2021,123013,10,0,294,119,175
2021,123013,10,4,294,119,175
2021,123013,20,0,233,94,139
2021,123013,20,4,233,94,139
2021,123013,30,0,58,24,34
2021,123013,30,4,58,24,34
2021,123013,40,0,3,1,2
2021,123013,40,4,3,1,2
2021,123013,43,0,3,1,2
2021,123013,43,4,3,1,2
2021,123095,0,0,61,20,41
2021,123095,10,0,19,5,14
2021,123095,10,6,19,5,14
2021,123095,40,0,19,5,14
2021,123095,40,6,19,5,14
2021,123095,41,0,17,4,13
2021,123095,41,6,17,4,13
2021,123095,42,0,2,1,1
2021,123095,42,6,2,1,1
2021,123095,44,0,17,4,13
2021,123095,44,6,17,4,13
2021,123095,50,0,42,15,27
2021,123165,0,0,99,43,56
2021,123165,10,0,99,43,56
2021,123165,10,1,25,9,16
2021,123165,10,2,35,16,19
2021,123165,10,3,37,18,19
2021,123165,10,6,2,0,2
2021,123165,20,0,60,25,35
2021,123165,20,1,25,9,16
2021,123165,20,2,35,16,19
2021,123165,30,0,25,8,17
2021,123165,30,3,25,8,17
2021,123165,40,0,14,10,4
2021,123165,40,3,12,10,2
2021,123165,40,6,2,0,2
2021,123165,41,0,2,1,1
2021,123165,41,3,1,1,0
2021,123165,41,6,1,0,1
2021,123165,42,0,12,9,3
2021,123165,42,3,11,9,2
2021,123165,42,6,1,0,1
2021,123165,44,0,2,1,1
2021,123165,44,3,1,1,0
2021,123165,44,6,1,0,1
2021,123217,0,0,215,104,111
2021,123217,10,0,215,104,111
2021,123217,10,4,215,104,111
2021,123217,20,0,128,56,72
2021,123217,20,4,128,56,72
2021,123217,30,0,62,33,29
2021,123217,30,4,62,33,29
2021,123217,40,0,25,15,10
2021,123217,40,4,25,15,10
2021,123217,42,0,7,5,2
2021,123217,42,4,7,5,2
2021,123217,43,0,18,10,8
2021,123217,43,4,18,10,8
2021,123299,0,0,131,77,54
2021,123299,10,0,131,77,54
2021,123299,10,4,131,77,54
2021,123299,20,0,71,50,21
2021,123299,20,4,71,50,21
2021,123299,30,0,12,3,9
2021,123299,30,4,12,3,9
2021,123299,40,0,48,24,24
2021,123299,40,4,48,24,24
2021,123299,42,0,48,24,24
2021,123299,42,4,48,24,24
2021,123341,0,0,246,99,147
2021,123341,10,0,246,99,147
2021,123341,10,4,246,99,147
2021,123341,20,0,182,71,111
2021,123341,20,4,182,71,111
2021,123341,30,0,58,24,34
2021,123341,30,4,58,24,34
2021,123341,40,0,6,4,2
2021,123341,40,4,6,4,2
2021,123341,42,0,6,4,2
2021,123341,42,4,6,4,2
2021,123448,0,0,6,5,1
2021,123448,10,0,6,5,1
2021,123448,10,2,2,1,1
2021,123448,10,3,1,1,0
2021,123448,10,6,3,3,0
2021,123448,20,0,1,0,1
2021,123448,20,2,1,0,1
2021,123448,40,0,5,5,0
2021,123448,40,2,1,1,0
2021,123448,40,3,1,1,0
2021,123448,40,6,3,3,0
2021,123448,42,0,5,5,0
2021,123448,42,2,1,1,0
2021,123448,42,3,1,1,0
2021,123448,42,6,3,3,0
2021,123457,0,0,35,21,14
2021,123457,10,0,35,21,14
2021,123457,10,1,3,3,0
2021,123457,10,2,5,3,2
2021,123457,10,3,18,12,6
2021,123457,10,4,2,1,1
2021,123457,10,6,7,2,5
2021,123457,40,0,35,21,14
2021,123457,40,1,3,3,0
2021,123457,40,2,5,3,2
2021,123457,40,3,18,12,6
2021,123457,40,4,2,1,1
2021,123457,40,6,7,2,5
2021,123457,41,0,35,21,14
2021,123457,41,1,3,3,0
2021,123457,41,2,5,3,2
2021,123457,41,3,18,12,6
2021,123457,41,4,2,1,1
2021,123457,41,6,7,2,5
2021,123457,44,0,35,21,14
2021,123457,44,1,3,3,0
2021,123457,44,2,5,3,2
2021,123457,44,3,18,12,6
2021,123457,44,4,2,1,1
2021,123457,44,6,7,2,5
2021,123484,0,0,32,16,16
2021,123484,10,0,32,16,16
2021,123484,10,4,32,16,16
2021,123484,20,0,21,11,10
2021,123484,20,4,21,11,10
2021,123484,30,0,11,5,6
2021,123484,30,4,11,5,6
2021,123509,0,0,144,61,83
2021,123509,10,0,144,61,83
2021,123509,10,4,144,61,83
2021,123509,20,0,106,47,59
2021,123509,20,4,106,47,59
2021,123509,30,0,31,9,22
2021,123509,30,4,31,9,22
2021,123509,40,0,7,5,2
2021,123509,40,4,7,5,2
2021,123509,43,0,7,5,2
2021,123509,43,4,7,5,2
2021,123527,0,0,174,75,99
2021,123527,10,0,133,66,67
2021,123527,10,4,133,66,67
2021,123527,20,0,120,59,61
2021,123527,20,4,120,59,61
2021,123527,30,0,13,7,6
2021,123527,30,4,13,7,6
2021,123527,50,0,41,9,32
2021,123554,0,0,214,87,127
2021,123554,10,0,214,87,127
2021,123554,10,1,82,40,42
2021,123554,10,2,81,29,52
2021,123554,10,3,43,16,27
2021,123554,10,6,8,2,6
2021,123554,20,0,138,60,78
2021,123554,20,1,81,39,42
2021,123554,20,2,57,21,36
2021,123554,30,0,50,19,31
2021,123554,30,2,11,5,6
2021,123554,30,3,39,14,25
2021,123554,40,0,26,8,18
2021,123554,40,1,1,1,0
2021,123554,40,2,13,3,10
2021,123554,40,3,4,2,2
2021,123554,40,6,8,2,6
2021,123554,42,0,26,8,18
2021,123554,42,1,1,1,0
2021,123554,42,2,13,3,10
2021,123554,42,3,4,2,2
2021,123554,42,6,8,2,6
2021,123563,0,0,127,53,74
2021,123563,10,0,127,53,74
2021,123563,10,4,127,53,74
2021,123563,20,0,120,53,67
2021,123563,20,4,120,53,67
2021,123563,30,0,7,0,7
2021,123563,30,4,7,0,7
2021,123572,0,0,244,120,124
2021,123572,10,0,244,120,124
2021,123572,10,1,118,70,48
2021,123572,10,2,49,20,29
2021,123572,10,3,52,18,34
2021,123572,10,5,25,12,13
2021,123572,20,0,164,89,75
2021,123572,20,1,118,70,48
2021,123572,20,2,46,19,27
2021,123572,30,0,55,19,36
2021,123572,30,2,3,1,2
2021,123572,30,3,52,18,34
2021,123572,40,0,25,12,13
2021,123572,40,5,25,12,13
2021,123572,41,0,18,9,9
2021,123572,41,5,18,9,9
2021,123572,42,0,7,3,4
2021,123572,42,5,7,3,4
2021,123572,44,0,18,9,9
2021,123572,44,5,18,9,9
2021,123633,0,0,11,6,5
2021,123633,10,0,11,6,5
2021,123633,10,6,11,6,5
2021,123633,40,0,11,6,5
2021,123633,40,6,11,6,5
2021,123633,41,0,11,6,5
2021,123633,41,6,11,6,5
2021,123633,45,0,11,6,5
2021,123633,45,6,11,6,5
2021,123651,0,0,83,38,45
2021,123651,10,0,83,38,45
2021,123651,10,1,30,17,13
2021,123651,10,2,25,9,16
2021,123651,10,3,23,9,14
2021,123651,10,4,5,3,2
2021,123651,20,0,43,20,23
2021,123651,20,1,27,15,12
2021,123651,20,2,16,5,11
2021,123651,30,0,18,7,11
2021,123651,30,1,1,0,1
2021,123651,30,2,4,2,2
2021,123651,30,3,12,4,8
2021,123651,30,4,1,1,0
2021,123651,40,0,22,11,11
2021,123651,40,1,2,2,0
2021,123651,40,2,5,2,3
2021,123651,40,3,11,5,6
2021,123651,40,4,4,2,2
2021,123651,42,0,22,11,11
2021,123651,42,1,2,2,0
2021,123651,42,2,5,2,3
2021,123651,42,3,11,5,6
2021,123651,42,4,4,2,2
2021,123679,0,0,31,6,25
2021,123679,10,0,31,6,25
2021,123679,10,4,31,6,25
2021,123679,40,0,31,6,25
2021,123679,40,4,31,6,25
2021,123679,41,0,31,6,25
2021,123679,41,4,31,6,25
2021,123679,45,0,31,6,25
2021,123679,45,4,31,6,25
2021,123800,0,0,194,82,112
2021,123800,10,0,194,82,112
2021,123800,10,1,158,67,91
2021,123800,10,3,35,15,20
2021,123800,10,4,1,0,1
2021,123800,20,0,158,67,91
2021,123800,20,1,158,67,91
2021,123800,30,0,35,15,20
2021,123800,30,3,35,15,20
2021,123800,40,0,1,0,1
2021,123800,40,4,1,0,1
2021,123800,43,0,1,0,1
2021,123800,43,4,1,0,1
2021,123916,0,0,17,4,13
2021,123916,10,0,17,4,13
2021,123916,10,1,2,0,2
2021,123916,10,2,1,0,1
2021,123916,10,3,12,4,8
2021,123916,10,4,2,0,2
2021,123916,40,0,17,4,13
2021,123916,40,1,2,0,2
2021,123916,40,2,1,0,1
2021,123916,40,3,12,4,8
2021,123916,40,4,2,0,2
2021,123916,41,0,6,2,4
2021,123916,41,1,2,0,2
2021,123916,41,2,1,0,1
2021,123916,41,3,3,2,1
2021,123916,42,0,9,2,7
2021,123916,42,3,9,2,7
2021,123916,43,0,2,0,2
2021,123916,43,4,2,0,2
2021,123916,44,0,3,1,2
2021,123916,44,2,1,0,1
2021,123916,44,3,2,1,1
2021,123916,45,0,3,1,2
2021,123916,45,1,2,0,2
2021,123916,45,3,1,1,0
2021,123943,0,0,79,32,47
2021,123943,10,0,79,32,47
2021,123943,10,1,7,6,1
2021,123943,10,2,23,13,10
2021,123943,10,3,48,12,36
2021,123943,10,4,1,1,0
2021,123943,20,0,17,11,6
2021,123943,20,1,6,5,1
2021,123943,20,2,11,6,5
2021,123943,30,0,43,13,30
2021,123943,30,1,1,1,0
2021,123943,30,2,10,7,3
2021,123943,30,3,32,5,27
2021,123943,40,0,19,8,11
2021,123943,40,2,2,0,2
2021,123943,40,3,16,7,9
2021,123943,40,4,1,1,0
2021,123943,41,0,19,8,11
2021,123943,41,2,2,0,2
2021,123943,41,3,16,7,9
2021,123943,41,4,1,1,0
2021,123943,44,0,19,8,11
2021,123943,44,2,2,0,2
2021,123943,44,3,16,7,9
2021,123943,44,4,1,1,0
2021,123952,0,0,45,27,18
2021,123952,10,0,45,27,18
2021,123952,10,6,45,27,18
2021,123952,40,0,45,27,18
2021,123952,40,6,45,27,18
2021,123952,41,0,45,27,18
2021,123952,41,6,45,27,18
2021,123952,44,0,45,27,18
2021,123952,44,6,45,27,18
2021,123961,0,0,2394,1433,961
2021,123961,10,0,2394,1433,961
2021,123961,10,1,1066,729,337
2021,123961,10,2,674,363,311
2021,123961,10,3,495,268,227
2021,123961,10,5,159,73,86
2021,123961,20,0,1178,822,356
2021,123961,20,1,828,605,223
2021,123961,20,2,350,217,133
2021,123961,30,0,325,183,142
2021,123961,30,2,14,7,7
2021,123961,30,3,311,176,135
2021,123961,40,0,891,428,463
2021,123961,40,1,238,124,114
2021,123961,40,2,310,139,171
2021,123961,40,3,184,92,92
2021,123961,40,5,159,73,86
2021,123961,41,0,373,191,182
2021,123961,41,1,135,71,64
2021,123961,41,2,132,64,68
2021,123961,41,3,63,34,29
2021,123961,41,5,43,22,21
2021,123961,42,0,518,237,281
2021,123961,42,1,103,53,50
2021,123961,42,2,178,75,103
2021,123961,42,3,121,58,63
2021,123961,42,5,116,51,65
2021,123961,44,0,373,191,182
2021,123961,44,1,135,71,64
2021,123961,44,2,132,64,68
2021,123961,44,3,63,34,29
2021,123961,44,5,43,22,21
2021,123970,0,0,61,32,29
2021,123970,10,0,61,32,29
2021,123970,10,1,41,25,16
2021,123970,10,2,20,7,13
2021,123970,20,0,27,20,7
2021,123970,20,1,27,20,7
2021,123970,30,0,3,2,1
2021,123970,30,2,3,2,1
2021,123970,40,0,31,10,21
2021,123970,40,1,14,5,9
2021,123970,40,2,17,5,12
2021,123970,41,0,10,0,10
2021,123970,41,1,9,0,9
2021,123970,41,2,1,0,1
2021,123970,42,0,19,8,11
2021,123970,42,1,3,3,0
2021,123970,42,2,16,5,11
2021,123970,43,0,2,2,0
2021,123970,43,1,2,2,0
2021,123970,44,0,10,0,10
2021,123970,44,1,9,0,9
2021,123970,44,2,1,0,1
2021,124113,0,0,44,21,23
2021,124113,10,0,43,21,22
2021,124113,10,1,34,16,18
2021,124113,10,2,9,5,4
2021,124113,20,0,34,16,18
2021,124113,20,1,34,16,18
2021,124113,30,0,9,5,4
2021,124113,30,2,9,5,4
2021,124113,50,0,1,0,1
2021,124283,0,0,19,13,6
2021,124283,10,0,19,13,6
2021,124283,10,1,19,13,6
2021,124283,20,0,19,13,6
2021,124283,20,1,19,13,6
2021,124292,0,0,53,50,3
2021,124292,10,0,53,50,3
2021,124292,10,1,53,50,3
2021,124292,40,0,53,50,3
2021,124292,40,1,53,50,3
2021,124292,41,0,44,41,3
2021,124292,41,1,44,41,3
2021,124292,42,0,9,9,0
2021,124292,42,1,9,9,0
2021,124292,44,0,4,4,0
2021,124292,44,1,4,4,0
2021,124292,45,0,40,37,3
2021,124292,45,1,40,37,3
2021,124487,0,0,11,9,2
2021,124487,10,0,11,9,2
2021,124487,10,6,11,9,2
2021,124487,40,0,11,9,2
2021,124487,40,6,11,9,2
2021,124487,43,0,11,9,2
2021,124487,43,6,11,9,2
2021,124557,0,0,247,136,111
2021,124557,50,0,247,136,111
2021,124706,0,0,26,9,17
2021,124706,10,0,26,9,17
2021,124706,10,4,26,9,17
2021,124706,40,0,26,9,17
2021,124706,40,4,26,9,17
2021,124706,41,0,26,9,17
2021,124706,41,4,26,9,17
2021,124706,45,0,26,9,17
2021,124706,45,4,26,9,17
2021,124937,0,0,20,9,11
2021,124937,10,0,20,9,11
2021,124937,10,4,20,9,11
2021,124937,40,0,20,9,11
2021,124937,40,4,20,9,11
2021,124937,41,0,20,9,11
2021,124937,41,4,20,9,11
2021,124937,45,0,20,9,11
2021,124937,45,4,20,9,11
2021,125028,0,0,163,75,88
2021,125028,10,0,163,75,88
2021,125028,10,4,163,75,88
2021,125028,20,0,130,65,65
2021,125028,20,4,130,65,65
2021,125028,30,0,29,9,20
2021,125028,30,4,29,9,20
2021,125028,40,0,4,1,3
2021,125028,40,4,4,1,3
2021,125028,42,0,4,1,3
2021,125028,42,4,4,1,3
2021,125091,0,0,94,56,38
2021,125091,10,0,94,56,38
2021,125091,10,4,93,56,37
2021,125091,10,6,1,0,1
2021,125091,20,0,74,46,28
2021,125091,20,4,74,46,28
2021,125091,30,0,19,10,9
2021,125091,30,4,19,10,9
2021,125091,40,0,1,0,1
2021,125091,40,6,1,0,1
2021,125091,42,0,1,0,1
2021,125091,42,6,1,0,1
2021,125170,0,0,64,34,30
2021,125170,10,0,64,34,30
2021,125170,10,4,64,34,30
2021,125170,20,0,48,27,21
2021,125170,20,4,48,27,21
2021,125170,30,0,13,6,7
2021,125170,30,4,13,6,7
2021,125170,40,0,3,1,2
2021,125170,40,4,3,1,2
2021,125170,43,0,3,1,2
2021,125170,43,4,3,1,2
2021,125231,0,0,251,66,185
2021,125231,10,0,251,66,185
2021,125231,10,6,251,66,185
2021,125231,40,0,251,66,185
2021,125231,40,6,251,66,185
2021,125231,41,0,251,66,185
2021,125231,41,6,251,66,185
2021,125231,45,0,251,66,185
2021,125231,45,6,251,66,185
2021,125462,0,0,32,19,13
2021,125462,10,0,32,19,13
2021,125462,10,4,32,19,13
2021,125462,20,0,27,15,12
2021,125462,20,4,27,15,12
2021,125462,30,0,5,4,1
2021,125462,30,4,5,4,1
2021,125471,0,0,102,40,62
2021,125471,10,0,102,40,62
2021,125471,10,4,102,40,62
2021,125471,20,0,85,34,51
2021,125471,20,4,85,34,51
2021,125471,30,0,12,5,7
2021,125471,30,4,12,5,7
2021,125471,40,0,5,1,4
2021,125471,40,4,5,1,4
2021,125471,42,0,3,1,2
2021,125471,42,4,3,1,2
2021,125471,43,0,2,0,2
2021,125471,43,4,2,0,2
2021,125499,0,0,166,69,97
2021,125499,10,0,166,69,97
2021,125499,10,4,166,69,97
2021,125499,20,0,124,51,73
2021,125499,20,4,124,51,73
2021,125499,30,0,39,16,23
2021,125499,30,4,39,16,23
2021,125499,40,0,3,2,1
2021,125499,40,4,3,2,1
2021,125499,43,0,3,2,1
2021,125499,43,4,3,2,1
2021,125532,0,0,28,2,26
2021,125532,10,0,28,2,26
2021,125532,10,4,28,2,26
2021,125532,40,0,28,2,26
2021,125532,40,4,28,2,26
2021,125532,41,0,28,2,26
2021,125532,41,4,28,2,26
2021,125532,45,0,28,2,26
2021,125532,45,4,28,2,26
2021,125718,0,0,11,11,0
2021,125718,10,0,11,11,0
2021,125718,10,1,5,5,0
2021,125718,10,2,5,5,0
2021,125718,10,3,1,1,0
2021,125718,20,0,7,7,0
2021,125718,20,1,4,4,0
2021,125718,20,2,2,2,0
2021,125718,20,3,1,1,0
2021,125718,30,0,4,4,0
2021,125718,30,1,1,1,0
2021,125718,30,2,3,3,0
2021,125727,0,0,99,59,40
2021,125727,10,0,99,59,40
2021,125727,10,1,50,37,13
2021,125727,10,2,23,10,13
2021,125727,10,3,22,9,13
2021,125727,10,4,4,3,1
2021,125727,20,0,58,38,20
2021,125727,20,1,45,33,12
2021,125727,20,2,13,5,8
2021,125727,30,0,23,10,13
2021,125727,30,1,4,3,1
2021,125727,30,2,5,2,3
2021,125727,30,3,14,5,9
2021,125727,40,0,18,11,7
2021,125727,40,1,1,1,0
2021,125727,40,2,5,3,2
2021,125727,40,3,8,4,4
2021,125727,40,4,4,3,1
2021,125727,42,0,15,8,7
2021,125727,42,2,5,3,2
2021,125727,42,3,7,3,4
2021,125727,42,4,3,2,1
2021,125727,43,0,3,3,0
2021,125727,43,1,1,1,0
2021,125727,43,3,1,1,0
2021,125727,43,4,1,1,0
2021,125763,0,0,108,56,52
2021,125763,10,0,108,56,52
2021,125763,10,1,39,23,16
2021,125763,10,2,36,15,21
2021,125763,10,3,13,4,9
2021,125763,10,5,20,14,6
2021,125763,20,0,70,36,34
2021,125763,20,1,38,22,16
2021,125763,20,2,32,14,18
2021,125763,30,0,17,5,12
2021,125763,30,2,4,1,3
2021,125763,30,3,13,4,9
2021,125763,40,0,21,15,6
2021,125763,40,1,1,1,0
2021,125763,40,5,20,14,6
2021,125763,42,0,20,15,5
2021,125763,42,1,1,1,0
2021,125763,42,5,19,14,5
2021,125763,43,0,1,0,1
2021,125763,43,5,1,0,1
2021,125897,0,0,63,34,29
2021,125897,10,0,63,34,29
2021,125897,10,1,31,19,12
2021,125897,10,2,17,8,9
2021,125897,10,3,15,7,8
2021,125897,40,0,63,34,29
2021,125897,40,1,31,19,12
2021,125897,40,2,17,8,9
2021,125897,40,3,15,7,8
2021,125897,41,0,48,27,21
2021,125897,41,1,31,19,12
2021,125897,41,2,17,8,9
2021,125897,42,0,15,7,8
2021,125897,42,3,15,7,8
2021,125897,44,0,48,27,21
2021,125897,44,1,31,19,12
2021,125897,44,2,17,8,9
2021,126012,0,0,23,3,20
2021,126012,10,0,23,3,20
2021,126012,10,1,3,0,3
2021,126012,10,2,1,0,1
2021,126012,10,3,4,0,4
2021,126012,10,6,15,3,12
2021,126012,20,0,4,0,4
2021,126012,20,1,2,0,2
2021,126012,20,2,1,0,1
2021,126012,20,3,1,0,1
2021,126012,30,0,4,0,4
2021,126012,30,1,1,0,1
2021,126012,30,3,3,0,3
2021,126012,40,0,15,3,12
2021,126012,40,6,15,3,12
2021,126012,41,0,15,3,12
2021,126012,41,6,15,3,12
2021,126012,45,0,15,3,12
2021,126012,45,6,15,3,12
2021,126049,0,0,4,4,0
2021,126049,10,0,4,4,0
2021,126049,10,1,4,4,0
2021,126049,20,0,4,4,0
2021,126049,20,1,4,4,0
2021,126100,0,0,9,8,1
2021,126100,10,0,9,8,1
2021,126100,10,4,9,8,1
2021,126100,20,0,6,5,1
2021,126100,20,4,6,5,1
2021,126100,30,0,2,2,0
2021,126100,30,4,2,2,0
2021,126100,40,0,1,1,0
2021,126100,40,4,1,1,0
2021,126100,42,0,1,1,0
2021,126100,42,4,1,1,0
2021,126119,0,0,87,39,48
2021,126119,10,0,87,39,48
2021,126119,10,4,87,39,48
2021,126119,20,0,50,24,26
2021,126119,20,4,50,24,26
2021,126119,30,0,13,6,7
2021,126119,30,4,13,6,7
2021,126119,40,0,24,9,15
2021,126119,40,4,24,9,15
2021,126119,42,0,12,4,8
2021,126119,42,4,12,4,8
2021,126119,43,0,12,5,7
2021,126119,43,4,12,5,7
2021,126182,0,0,105,49,56
2021,126182,10,0,105,49,56
2021,126182,10,1,16,8,8
2021,126182,10,2,10,4,6
2021,126182,10,3,17,8,9
2021,126182,10,6,62,29,33
2021,126182,20,0,29,15,14
2021,126182,20,1,16,8,8
2021,126182,20,2,9,4,5
2021,126182,20,3,4,3,1
2021,126182,30,0,16,7,9
2021,126182,30,2,1,0,1
2021,126182,30,3,12,4,8
2021,126182,30,6,3,3,0
2021,126182,40,0,60,27,33
2021,126182,40,3,1,1,0
2021,126182,40,6,59,26,33
2021,126182,42,0,60,27,33
2021,126182,42,3,1,1,0
2021,126182,42,6,59,26,33
2021,126207,0,0,125,59,66
2021,126207,10,0,125,59,66
2021,126207,10,1,68,28,40
2021,126207,10,2,8,3,5
2021,126207,10,3,4,3,1
2021,126207,10,4,45,25,20
2021,126207,20,0,80,34,46
2021,126207,20,1,68,28,40
2021,126207,20,2,8,3,5
2021,126207,20,3,4,3,1
2021,126207,30,0,32,14,18
2021,126207,30,4,32,14,18
2021,126207,40,0,13,11,2
2021,126207,40,4,13,11,2
2021,126207,41,0,13,11,2
2021,126207,41,4,13,11,2
2021,126207,45,0,13,11,2
2021,126207,45,4,13,11,2
2021,126289,0,0,113,47,66
2021,126289,10,0,113,47,66
2021,126289,10,1,113,47,66
2021,126289,20,0,77,31,46
2021,126289,20,1,77,31,46
2021,126289,30,0,36,16,20
2021,126289,30,1,36,16,20
2021,126359,0,0,8,2,6
2021,126359,10,0,8,2,6
2021,126359,10,1,1,1,0
2021,126359,10,4,7,1,6
2021,126359,40,0,8,2,6
2021,126359,40,1,1,1,0
2021,126359,40,4,7,1,6
2021,126359,41,0,8,2,6
2021,126359,41,1,1,1,0
2021,126359,41,4,7,1,6
2021,126359,45,0,8,2,6
2021,126359,45,1,1,1,0
2021,126359,45,4,7,1,6
2021,126562,0,0,4710,1882,2828
2021,126562,10,0,4710,1882,2828
2021,126562,10,1,706,443,263
2021,126562,10,2,972,498,474
2021,126562,10,3,1230,493,737
2021,126562,10,4,1802,448,1354
2021,126562,20,0,573,370,203
2021,126562,20,1,378,249,129
2021,126562,20,2,195,121,74
2021,126562,30,0,2117,990,1127
2021,126562,30,1,314,190,124
2021,126562,30,2,690,337,353
2021,126562,30,3,1113,463,650
2021,126562,40,0,2020,522,1498
2021,126562,40,1,14,4,10
2021,126562,40,2,87,40,47
2021,126562,40,3,117,30,87
2021,126562,40,4,1802,448,1354
2021,126562,41,0,1777,406,1371
2021,126562,41,1,9,1,8
2021,126562,41,2,48,21,27
2021,126562,41,3,64,12,52
2021,126562,41,4,1656,372,1284
2021,126562,42,0,240,116,124
2021,126562,42,1,5,3,2
2021,126562,42,2,39,19,20
2021,126562,42,3,51,18,33
2021,126562,42,4,145,76,69
2021,126562,43,0,3,0,3
2021,126562,43,3,2,0,2
2021,126562,43,4,1,0,1
2021,126562,45,0,1777,406,1371
2021,126562,45,1,9,1,8
2021,126562,45,2,48,21,27
2021,126562,45,3,64,12,52
2021,126562,45,4,1656,372,1284
2021,126580,0,0,468,231,237
2021,126580,10,0,468,231,237
2021,126580,10,1,81,56,25
2021,126580,10,2,90,48,42
2021,126580,10,3,108,52,56
2021,126580,10,4,187,74,113
2021,126580,10,6,2,1,1
2021,126580,20,0,171,104,67
2021,126580,20,1,81,56,25
2021,126580,20,2,90,48,42
2021,126580,30,0,108,52,56
2021,126580,30,3,108,52,56
2021,126580,40,0,189,75,114
2021,126580,40,4,187,74,113
2021,126580,40,6,2,1,1
2021,126580,42,0,187,74,113
2021,126580,42,4,187,74,113
2021,126580,43,0,2,1,1
2021,126580,43,6,2,1,1
2021,126605,0,0,25,25,0
2021,126605,50,0,25,25,0
2021,126614,0,0,1694,994,700
2021,126614,10,0,1694,994,700
2021,126614,10,1,517,372,145
2021,126614,10,2,375,211,164
2021,126614,10,3,318,176,142
2021,126614,10,4,484,235,249
2021,126614,20,0,879,575,304
2021,126614,20,1,517,372,145
2021,126614,20,2,362,203,159
2021,126614,30,0,331,184,147
2021,126614,30,2,13,8,5
2021,126614,30,3,318,176,142
2021,126614,40,0,484,235,249
2021,126614,40,4,484,235,249
2021,126614,41,0,6,3,3
2021,126614,41,4,6,3,3
2021,126614,42,0,478,232,246
2021,126614,42,4,478,232,246
2021,126614,45,0,6,3,3
2021,126614,45,4,6,3,3
2021,126669,0,0,115,67,48
2021,126669,10,0,115,67,48
2021,126669,10,1,23,15,8
2021,126669,10,2,33,22,11
2021,126669,10,3,57,30,27
2021,126669,10,4,2,0,2
2021,126669,40,0,115,67,48
2021,126669,40,1,23,15,8
2021,126669,40,2,33,22,11
2021,126669,40,3,57,30,27
2021,126669,40,4,2,0,2
2021,126669,41,0,49,24,25
2021,126669,41,1,3,1,2
2021,126669,41,2,16,9,7
2021,126669,41,3,30,14,16
2021,126669,42,0,66,43,23
2021,126669,42,1,20,14,6
2021,126669,42,2,17,13,4
2021,126669,42,3,27,16,11
2021,126669,42,4,2,0,2
2021,126669,45,0,49,24,25
2021,126669,45,1,3,1,2
2021,126669,45,2,16,9,7
2021,126669,45,3,30,14,16
2021,126678,0,0,226,110,116
2021,126678,10,0,226,110,116
2021,126678,10,1,62,31,31
2021,126678,10,2,62,27,35
2021,126678,10,3,95,47,48
2021,126678,10,5,6,4,2
2021,126678,10,6,1,1,0
2021,126678,20,0,121,56,65
2021,126678,20,1,60,29,31
2021,126678,20,2,61,27,34
2021,126678,30,0,67,27,40
2021,126678,30,1,1,1,0
2021,126678,30,2,1,0,1
2021,126678,30,3,65,26,39
2021,126678,40,0,38,27,11
2021,126678,40,1,1,1,0
2021,126678,40,3,30,21,9
2021,126678,40,5,6,4,2
2021,126678,40,6,1,1,0
2021,126678,41,0,5,3,2
2021,126678,41,5,5,3,2
2021,126678,42,0,33,24,9
2021,126678,42,1,1,1,0
2021,126678,42,3,30,21,9
2021,126678,42,5,1,1,0
2021,126678,42,6,1,1,0
2021,126678,45,0,5,3,2
2021,126678,45,5,5,3,2
2021,126687,0,0,39,8,31
2021,126687,10,0,39,8,31
2021,126687,10,4,39,8,31
2021,126687,40,0,39,8,31
2021,126687,40,4,39,8,31
2021,126687,41,0,39,8,31
2021,126687,41,4,39,8,31
2021,126687,45,0,39,8,31
2021,126687,45,4,39,8,31
2021,126711,0,0,116,58,58
2021,126711,10,0,116,58,58
2021,126711,10,1,53,28,25
2021,126711,10,2,40,19,21
2021,126711,10,3,23,11,12
2021,126711,40,0,116,58,58
2021,126711,40,1,53,28,25
2021,126711,40,2,40,19,21
2021,126711,40,3,23,11,12
2021,126711,42,0,116,58,58
2021,126711,42,1,53,28,25
2021,126711,42,2,40,19,21
2021,126711,42,3,23,11,12
2021,126748,0,0,32,17,15
2021,126748,10,0,32,17,15
2021,126748,10,4,32,17,15
2021,126748,40,0,32,17,15
2021,126748,40,4,32,17,15
2021,126748,42,0,32,17,15
2021,126748,42,4,32,17,15
2021,126775,0,0,335,223,112
2021,126775,10,0,335,223,112
2021,126775,10,1,102,81,21
2021,126775,10,2,69,48,21
2021,126775,10,3,43,28,15
2021,126775,10,4,76,41,35
2021,126775,10,5,21,10,11
2021,126775,10,6,24,15,9
2021,126775,20,0,162,122,40
2021,126775,20,1,97,76,21
2021,126775,20,2,65,46,19
2021,126775,30,0,48,32,16
2021,126775,30,1,2,2,0
2021,126775,30,2,3,2,1
2021,126775,30,3,43,28,15
2021,126775,40,0,125,69,56
2021,126775,40,1,3,3,0
2021,126775,40,2,1,0,1
2021,126775,40,4,76,41,35
2021,126775,40,5,21,10,11
2021,126775,40,6,24,15,9
2021,126775,42,0,110,63,47
2021,126775,42,1,3,3,0
2021,126775,42,2,1,0,1
2021,126775,42,4,76,41,35
2021,126775,42,5,21,10,11
2021,126775,42,6,9,9,0
2021,126775,43,0,15,6,9
2021,126775,43,6,15,6,9
2021,126784,0,0,5,5,0
2021,126784,50,0,5,5,0
2021,126818,0,0,1600,878,722
2021,126818,10,0,1428,777,651
2021,126818,10,1,464,316,148
2021,126818,10,2,402,212,190
2021,126818,10,3,363,164,199
2021,126818,10,4,199,85,114
2021,126818,20,0,783,492,291
2021,126818,20,1,447,305,142
2021,126818,20,2,335,187,148
2021,126818,20,3,1,0,1
2021,126818,30,0,254,129,125
2021,126818,30,1,6,3,3
2021,126818,30,2,13,6,7
2021,126818,30,3,235,120,115
2021,126818,40,0,391,156,235
2021,126818,40,1,11,8,3
2021,126818,40,2,54,19,35
2021,126818,40,3,127,44,83
2021,126818,40,4,199,85,114
2021,126818,41,0,371,147,224
2021,126818,41,1,11,8,3
2021,126818,41,2,54,19,35
2021,126818,41,3,121,42,79
2021,126818,41,4,185,78,107
2021,126818,42,0,20,9,11
2021,126818,42,3,6,2,4
2021,126818,42,4,14,7,7
2021,126818,44,0,371,147,224
2021,126818,44,1,11,8,3
2021,126818,44,2,54,19,35
2021,126818,44,3,121,42,79
2021,126818,44,4,185,78,107
2021,126818,50,0,172,101,71
2021,126827,0,0,58,23,35
2021,126827,50,0,58,23,35
2021,126863,0,0,57,23,34
2021,126863,10,0,57,23,34
2021,126863,10,6,57,23,34
2021,126863,40,0,57,23,34
2021,126863,40,6,57,23,34
2021,126863,42,0,57,23,34
2021,126863,42,6,57,23,34
2021,126942,0,0,105,48,57
2021,126942,10,0,105,48,57
2021,126942,10,1,52,29,23
2021,126942,10,2,21,10,11
2021,126942,10,3,32,9,23
2021,126942,40,0,105,48,57
2021,126942,40,1,52,29,23
2021,126942,40,2,21,10,11
2021,126942,40,3,32,9,23
2021,126942,42,0,105,48,57
2021,126942,42,1,52,29,23
2021,126942,42,2,21,10,11
2021,126942,42,3,32,9,23
2021,126951,0,0,44,40,4
2021,126951,10,0,44,40,4
2021,126951,10,4,44,40,4
2021,126951,40,0,44,40,4
2021,126951,40,4,44,40,4
2021,126951,41,0,44,40,4
2021,126951,41,4,44,40,4
2021,126951,45,0,44,40,4
2021,126951,45,4,44,40,4
2021,126979,0,0,28,18,10
2021,126979,10,0,27,18,9
2021,126979,10,1,10,8,2
2021,126979,10,2,7,5,2
2021,126979,10,3,9,5,4
2021,126979,10,4,1,0,1
2021,126979,20,0,15,11,4
2021,126979,20,1,10,8,2
2021,126979,20,2,4,2,2
2021,126979,20,3,1,1,0
2021,126979,30,0,6,4,2
2021,126979,30,2,2,2,0
2021,126979,30,3,4,2,2
2021,126979,40,0,6,3,3
2021,126979,40,2,1,1,0
2021,126979,40,3,4,2,2
2021,126979,40,4,1,0,1
2021,126979,42,0,6,3,3
2021,126979,42,2,1,1,0
2021,126979,42,3,4,2,2
2021,126979,42,4,1,0,1
2021,126979,50,0,1,0,1
2021,127060,0,0,780,394,386
2021,127060,10,0,780,394,386
2021,127060,10,1,227,143,84
2021,127060,10,2,205,92,113
2021,127060,10,3,155,71,84
2021,127060,10,4,1,0,1
2021,127060,10,5,192,88,104
2021,127060,20,0,374,214,160
2021,127060,20,1,196,126,70
2021,127060,20,2,178,88,90
2021,127060,30,0,129,65,64
2021,127060,30,3,128,65,63
2021,127060,30,4,1,0,1
2021,127060,40,0,277,115,162
2021,127060,40,1,31,17,14
2021,127060,40,2,27,4,23
2021,127060,40,3,27,6,21
2021,127060,40,5,192,88,104
2021,127060,41,0,240,95,145
2021,127060,41,1,31,17,14
2021,127060,41,2,27,4,23
2021,127060,41,3,27,6,21
2021,127060,41,5,155,68,87
2021,127060,42,0,37,20,17
2021,127060,42,5,37,20,17
2021,127060,44,0,240,95,145
2021,127060,44,1,31,17,14
2021,127060,44,2,27,4,23
2021,127060,44,3,27,6,21
2021,127060,44,5,155,68,87
2021,127185,0,0,200,97,103
2021,127185,10,0,200,97,103
2021,127185,10,1,62,31,31
2021,127185,10,2,40,16,24
2021,127185,10,3,61,36,25
2021,127185,10,4,10,4,6
2021,127185,10,5,27,10,17
2021,127185,20,0,99,48,51
2021,127185,20,1,59,31,28
2021,127185,20,2,39,16,23
2021,127185,20,3,1,1,0
2021,127185,30,0,54,29,25
2021,127185,30,2,1,0,1
2021,127185,30,3,53,29,24
2021,127185,40,0,47,20,27
2021,127185,40,1,3,0,3
2021,127185,40,3,7,6,1
2021,127185,40,4,10,4,6
2021,127185,40,5,27,10,17
2021,127185,41,0,24,10,14
2021,127185,41,5,24,10,14
2021,127185,42,0,20,10,10
2021,127185,42,3,7,6,1
2021,127185,42,4,10,4,6
2021,127185,42,5,3,0,3
2021,127185,43,0,3,0,3
2021,127185,43,1,3,0,3
2021,127185,44,0,2,1,1
2021,127185,44,5,2,1,1
2021,127185,45,0,22,9,13
2021,127185,45,5,22,9,13
2021,127200,0,0,244,104,140
2021,127200,10,0,244,104,140
2021,127200,10,1,244,104,140
2021,127200,20,0,193,86,107
2021,127200,20,1,193,86,107
2021,127200,30,0,44,13,31
2021,127200,30,1,44,13,31
2021,127200,40,0,7,5,2
2021,127200,40,1,7,5,2
2021,127200,42,0,7,5,2
2021,127200,42,1,7,5,2
2021,127273,0,0,17,9,8
2021,127273,10,0,17,9,8
2021,127273,10,1,8,4,4
2021,127273,10,2,3,2,1
2021,127273,10,3,5,3,2
2021,127273,10,6,1,0,1
2021,127273,20,0,11,6,5
2021,127273,20,1,8,4,4
2021,127273,20,2,3,2,1
2021,127273,30,0,2,1,1
2021,127273,30,3,2,1,1
2021,127273,40,0,4,2,2
2021,127273,40,3,3,2,1
2021,127273,40,6,1,0,1
2021,127273,41,0,4,2,2
2021,127273,41,3,3,2,1
2021,127273,41,6,1,0,1
2021,127273,44,0,4,2,2
2021,127273,44,3,3,2,1
2021,127273,44,6,1,0,1
2021,127389,0,0,25,12,13
2021,127389,10,0,25,12,13
2021,127389,10,1,25,12,13
2021,127389,20,0,22,12,10
2021,127389,20,1,22,12,10
2021,127389,30,0,3,0,3
2021,127389,30,1,3,0,3
2021,127556,0,0,317,163,154
2021,127556,10,0,317,163,154
2021,127556,10,1,54,36,18
2021,127556,10,2,64,38,26
2021,127556,10,3,72,30,42
2021,127556,10,4,123,57,66
2021,127556,10,5,3,1,2
2021,127556,10,6,1,1,0
2021,127556,20,0,117,73,44
2021,127556,20,1,54,36,18
2021,127556,20,2,62,36,26
2021,127556,20,3,1,1,0
2021,127556,30,0,74,31,43
2021,127556,30,2,2,2,0
2021,127556,30,3,71,29,42
2021,127556,30,4,1,0,1
2021,127556,40,0,126,59,67
2021,127556,40,4,122,57,65
2021,127556,40,5,3,1,2
2021,127556,40,6,1,1,0
2021,127556,42,0,124,58,66
2021,127556,42,4,122,57,65
2021,127556,42,5,1,0,1
2021,127556,42,6,1,1,0
2021,127556,43,0,2,1,1
2021,127556,43,5,2,1,1
2021,127565,0,0,566,268,298
2021,127565,10,0,566,268,298
2021,127565,10,1,235,124,111
2021,127565,10,2,116,52,64
2021,127565,10,3,89,42,47
2021,127565,10,5,126,50,76
2021,127565,20,0,317,165,152
2021,127565,20,1,234,124,110
2021,127565,20,2,82,41,41
2021,127565,20,3,1,0,1
2021,127565,30,0,118,50,68
2021,127565,30,2,34,11,23
2021,127565,30,3,83,38,45
2021,127565,30,5,1,1,0
2021,127565,40,0,131,53,78
2021,127565,40,1,1,0,1
2021,127565,40,3,5,4,1
2021,127565,40,5,125,49,76
2021,127565,42,0,131,53,78
2021,127565,42,1,1,0,1
2021,127565,42,3,5,4,1
2021,127565,42,5,125,49,76
2021,127617,0,0,39,21,18
2021,127617,10,0,39,21,18
2021,127617,10,6,39,21,18
2021,127617,40,0,39,21,18
2021,127617,40,6,39,21,18
2021,127617,42,0,39,21,18
2021,127617,42,6,39,21,18
2021,127653,0,0,62,19,43
2021,127653,10,0,62,19,43
2021,127653,10,1,9,3,6
2021,127653,10,2,17,8,9
2021,127653,10,3,14,5,9
2021,127653,10,4,22,3,19
2021,127653,40,0,62,19,43
2021,127653,40,1,9,3,6
2021,127653,40,2,17,8,9
2021,127653,40,3,14,5,9
2021,127653,40,4,22,3,19
2021,127653,41,0,40,16,24
2021,127653,41,1,9,3,6
2021,127653,41,2,17,8,9
2021,127653,41,3,14,5,9
2021,127653,42,0,22,3,19
2021,127653,42,4,22,3,19
2021,127653,44,0,40,16,24
2021,127653,44,1,9,3,6
2021,127653,44,2,17,8,9
2021,127653,44,3,14,5,9
2021,127714,0,0,7,6,1
2021,127714,10,0,7,6,1
2021,127714,10,6,7,6,1
2021,127714,40,0,7,6,1
2021,127714,40,6,7,6,1
2021,127714,42,0,7,6,1
2021,127714,42,6,7,6,1
2021,127732,0,0,45,20,25
2021,127732,10,0,45,20,25
2021,127732,10,1,11,7,4
2021,127732,10,2,23,9,14
2021,127732,10,3,11,4,7
2021,127732,40,0,45,20,25
2021,127732,40,1,11,7,4
2021,127732,40,2,23,9,14
2021,127732,40,3,11,4,7
2021,127732,42,0,45,20,25
2021,127732,42,1,11,7,4
2021,127732,42,2,23,9,14
2021,127732,42,3,11,4,7
2021,127741,0,0,421,199,222
2021,127741,10,0,421,199,222
2021,127741,10,1,158,93,65
2021,127741,10,2,115,54,61
2021,127741,10,3,103,41,62
2021,127741,10,4,15,2,13
2021,127741,10,5,30,9,21
2021,127741,20,0,245,137,108
2021,127741,20,1,155,91,64
2021,127741,20,2,90,46,44
2021,127741,30,0,87,34,53
2021,127741,30,1,2,2,0
2021,127741,30,2,17,6,11
2021,127741,30,3,68,26,42
2021,127741,40,0,89,28,61
2021,127741,40,1,1,0,1
2021,127741,40,2,8,2,6
2021,127741,40,3,35,15,20
2021,127741,40,4,15,2,13
2021,127741,40,5,30,9,21
2021,127741,42,0,89,28,61
2021,127741,42,1,1,0,1
2021,127741,42,2,8,2,6
2021,127741,42,3,35,15,20
2021,127741,42,4,15,2,13
2021,127741,42,5,30,9,21
2021,127778,0,0,25,11,14
2021,127778,10,0,25,11,14
2021,127778,10,6,25,11,14
2021,127778,40,0,25,11,14
2021,127778,40,6,25,11,14
2021,127778,42,0,25,11,14
2021,127778,42,6,25,11,14
2021,127820,0,0,198,79,119
2021,127820,10,0,198,79,119
2021,127820,10,6,198,79,119
2021,127820,40,0,198,79,119
2021,127820,40,6,198,79,119
2021,127820,42,0,198,79,119
2021,127820,42,6,198,79,119
2021,127884,0,0,85,36,49
2021,127884,10,0,85,36,49
2021,127884,10,6,85,36,49
2021,127884,40,0,85,36,49
2021,127884,40,6,85,36,49
2021,127884,43,0,85,36,49
2021,127884,43,6,85,36,49
2021,127909,0,0,95,36,59
2021,127909,10,0,95,36,59
2021,127909,10,4,95,36,59
2021,127909,40,0,95,36,59
2021,127909,40,4,95,36,59
2021,127909,42,0,95,36,59
2021,127909,42,4,95,36,59
2021,127918,0,0,329,132,197
2021,127918,10,0,329,132,197
2021,127918,10,1,82,43,39
2021,127918,10,2,104,41,63
2021,127918,10,3,80,22,58
2021,127918,10,4,41,15,26
2021,127918,10,5,18,11,7
2021,127918,10,6,4,0,4
2021,127918,20,0,86,45,41
2021,127918,20,1,37,23,14
2021,127918,20,2,49,22,27
2021,127918,30,0,34,15,19
2021,127918,30,1,3,3,0
2021,127918,30,2,3,3,0
2021,127918,30,3,28,9,19
2021,127918,40,0,209,72,137
2021,127918,40,1,42,17,25
2021,127918,40,2,52,16,36
2021,127918,40,3,52,13,39
2021,127918,40,4,41,15,26
2021,127918,40,5,18,11,7
2021,127918,40,6,4,0,4
2021,127918,41,0,127,42,85
2021,127918,41,1,35,14,21
2021,127918,41,2,46,14,32
2021,127918,41,3,32,7,25
2021,127918,41,4,12,7,5
2021,127918,41,6,2,0,2
2021,127918,42,0,82,30,52
2021,127918,42,1,7,3,4
2021,127918,42,2,6,2,4
2021,127918,42,3,20,6,14
2021,127918,42,4,29,8,21
2021,127918,42,5,18,11,7
2021,127918,42,6,2,0,2
2021,127918,44,0,127,42,85
2021,127918,44,1,35,14,21
2021,127918,44,2,46,14,32
2021,127918,44,3,32,7,25
2021,127918,44,4,12,7,5
2021,127918,44,6,2,0,2
2021,127945,0,0,62,34,28
2021,127945,10,0,62,34,28
2021,127945,10,1,5,1,4
2021,127945,10,2,24,14,10
2021,127945,10,3,28,17,11
2021,127945,10,4,5,2,3
2021,127945,40,0,62,34,28
2021,127945,40,1,5,1,4
2021,127945,40,2,24,14,10
2021,127945,40,3,28,17,11
2021,127945,40,4,5,2,3
2021,127945,41,0,62,34,28
2021,127945,41,1,5,1,4
2021,127945,41,2,24,14,10
2021,127945,41,3,28,17,11
2021,127945,41,4,5,2,3
2021,127945,45,0,62,34,28
2021,127945,45,1,5,1,4
2021,127945,45,2,24,14,10
2021,127945,45,3,28,17,11
2021,127945,45,4,5,2,3
2021,128106,0,0,181,96,85
2021,128106,10,0,181,96,85
2021,128106,10,1,37,26,11
2021,128106,10,2,36,20,16
2021,128106,10,3,53,25,28
2021,128106,10,5,25,9,16
2021,128106,10,6,30,16,14
2021,128106,20,0,78,49,29
2021,128106,20,1,37,26,11
2021,128106,20,2,36,20,16
2021,128106,20,3,5,3,2
2021,128106,30,0,33,16,17
2021,128106,30,3,33,16,17
2021,128106,40,0,70,31,39
2021,128106,40,3,15,6,9
2021,128106,40,5,25,9,16
2021,128106,40,6,30,16,14
2021,128106,41,0,17,5,12
2021,128106,41,3,7,2,5
2021,128106,41,5,10,3,7
2021,128106,42,0,45,21,24
2021,128106,42,3,7,3,4
2021,128106,42,5,15,6,9
2021,128106,42,6,23,12,11
2021,128106,43,0,8,5,3
2021,128106,43,3,1,1,0
2021,128106,43,6,7,4,3
2021,128106,45,0,17,5,12
2021,128106,45,3,7,2,5
2021,128106,45,5,10,3,7
2021,128179,0,0,14,12,2
2021,128179,10,0,14,12,2
2021,128179,10,4,14,12,2
2021,128179,40,0,14,12,2
2021,128179,40,4,14,12,2
2021,128179,41,0,14,12,2
2021,128179,41,4,14,12,2
2021,128179,45,0,14,12,2
2021,128179,45,4,14,12,2
2021,128188,0,0,52,20,32
2021,128188,10,0,52,20,32
2021,128188,10,4,52,20,32
2021,128188,40,0,52,20,32
2021,128188,40,4,52,20,32
2021,128188,41,0,52,20,32
2021,128188,41,4,52,20,32
2021,128188,45,0,52,20,32
2021,128188,45,4,52,20,32
2021,128258,0,0,47,26,21
2021,128258,10,0,47,26,21
2021,128258,10,6,47,26,21
2021,128258,40,0,47,26,21
2021,128258,40,6,47,26,21
2021,128258,42,0,47,26,21
2021,128258,42,6,47,26,21
2021,128328,0,0,220,151,69
2021,128328,10,0,220,151,69
2021,128328,10,1,69,50,19
2021,128328,10,2,59,43,16
2021,128328,10,3,77,47,30
2021,128328,10,4,15,11,4
2021,128328,40,0,220,151,69
2021,128328,40,1,69,50,19
2021,128328,40,2,59,43,16
2021,128328,40,3,77,47,30
2021,128328,40,4,15,11,4
2021,128328,41,0,184,127,57
2021,128328,41,1,61,45,16
2021,128328,41,2,52,38,14
2021,128328,41,3,68,42,26
2021,128328,41,4,3,2,1
2021,128328,42,0,20,14,6
2021,128328,42,3,9,5,4
2021,128328,42,4,11,9,2
2021,128328,43,0,16,10,6
2021,128328,43,1,8,5,3
2021,128328,43,2,7,5,2
2021,128328,43,4,1,0,1
2021,128328,44,0,184,127,57
2021,128328,44,1,61,45,16
2021,128328,44,2,52,38,14
2021,128328,44,3,68,42,26
2021,128328,44,4,3,2,1
2021,128391,0,0,133,80,53
2021,128391,10,0,133,80,53
2021,128391,10,1,49,32,17
2021,128391,10,2,12,7,5
2021,128391,10,3,23,13,10
2021,128391,10,5,49,28,21
2021,128391,20,0,59,37,22
2021,128391,20,1,48,31,17
2021,128391,20,2,10,5,5
2021,128391,20,3,1,1,0
2021,128391,30,0,25,15,10
2021,128391,30,1,1,1,0
2021,128391,30,2,2,2,0
2021,128391,30,3,22,12,10
2021,128391,40,0,49,28,21
2021,128391,40,5,49,28,21
2021,128391,42,0,49,28,21
2021,128391,42,5,49,28,21
2021,128498,0,0,47,22,25
2021,128498,10,0,47,22,25
2021,128498,10,1,19,12,7
2021,128498,10,2,10,4,6
2021,128498,10,3,17,6,11
2021,128498,10,4,1,0,1
2021,128498,20,0,4,2,2
2021,128498,20,1,4,2,2
2021,128498,40,0,43,20,23
2021,128498,40,1,15,10,5
2021,128498,40,2,10,4,6
2021,128498,40,3,17,6,11
2021,128498,40,4,1,0,1
2021,128498,41,0,42,19,23
2021,128498,41,1,14,9,5
2021,128498,41,2,10,4,6
2021,128498,41,3,17,6,11
2021,128498,41,4,1,0,1
2021,128498,43,0,1,1,0
2021,128498,43,1,1,1,0
2021,128498,44,0,42,19,23
2021,128498,44,1,14,9,5
2021,128498,44,2,10,4,6
2021,128498,44,3,17,6,11
2021,128498,44,4,1,0,1
2021,128577,0,0,33,20,13
2021,128577,10,0,24,11,13
2021,128577,10,1,14,7,7
2021,128577,10,2,4,2,2
2021,128577,10,3,5,2,3
2021,128577,10,5,1,0,1
2021,128577,20,0,15,7,8
2021,128577,20,1,14,7,7
2021,128577,20,2,1,0,1
2021,128577,30,0,9,4,5
2021,128577,30,2,3,2,1
2021,128577,30,3,5,2,3
2021,128577,30,5,1,0,1
2021,128577,50,0,9,9,0
2021,128744,0,0,134,70,64
2021,128744,10,0,134,70,64
2021,128744,10,1,7,5,2
2021,128744,10,2,38,24,14
2021,128744,10,3,51,21,30
2021,128744,10,4,37,20,17
2021,128744,10,5,1,0,1
2021,128744,40,0,134,70,64
2021,128744,40,1,7,5,2
2021,128744,40,2,38,24,14
2021,128744,40,3,51,21,30
2021,128744,40,4,37,20,17
2021,128744,40,5,1,0,1
2021,128744,42,0,134,70,64
2021,128744,42,1,7,5,2
2021,128744,42,2,38,24,14
2021,128744,42,3,51,21,30
2021,128744,42,4,37,20,17
2021,128744,42,5,1,0,1
2021,128771,0,0,416,234,182
2021,128771,10,0,416,234,182
2021,128771,10,1,186,120,66
2021,128771,10,2,148,75,73
2021,128771,10,3,81,39,42
2021,128771,10,4,1,0,1
2021,128771,20,0,311,182,129
2021,128771,20,1,185,119,66
2021,128771,20,2,120,60,60
2021,128771,20,3,6,3,3
2021,128771,30,0,85,42,43
2021,128771,30,1,1,1,0
2021,128771,30,2,24,14,10
2021,128771,30,3,60,27,33
2021,128771,40,0,20,10,10
2021,128771,40,2,4,1,3
2021,128771,40,3,15,9,6
2021,128771,40,4,1,0,1
2021,128771,42,0,20,10,10
2021,128771,42,2,4,1,3
2021,128771,42,3,15,9,6
2021,128771,42,4,1,0,1
2021,128902,0,0,200,97,103
2021,128902,10,0,200,97,103
2021,128902,10,1,70,38,32
2021,128902,10,2,54,25,29
2021,128902,10,3,53,25,28
2021,128902,10,4,6,4,2
2021,128902,10,5,17,5,12
2021,128902,20,0,108,54,54
2021,128902,20,1,60,31,29
2021,128902,20,2,48,23,25
2021,128902,30,0,32,10,22
2021,128902,30,3,32,10,22
2021,128902,40,0,60,33,27
2021,128902,40,1,10,7,3
2021,128902,40,2,6,2,4
2021,128902,40,3,21,15,6
2021,128902,40,4,6,4,2
2021,128902,40,5,17,5,12
2021,128902,41,0,54,29,25
2021,128902,41,1,10,7,3
2021,128902,41,2,5,2,3
2021,128902,41,3,18,12,6
2021,128902,41,4,4,3,1
2021,128902,41,5,17,5,12
2021,128902,42,0,5,4,1
2021,128902,42,2,1,0,1
2021,128902,42,3,3,3,0
2021,128902,42,4,1,1,0
2021,128902,43,0,1,0,1
2021,128902,43,4,1,0,1
2021,128902,44,0,14,9,5
2021,128902,44,3,11,7,4
2021,128902,44,4,1,1,0
2021,128902,44,5,2,1,1
2021,128902,45,0,40,20,20
2021,128902,45,1,10,7,3
2021,128902,45,2,5,2,3
2021,128902,45,3,7,5,2
2021,128902,45,4,3,2,1
2021,128902,45,5,15,4,11
2021,129020,0,0,2122,1168,954
2021,129020,10,0,2122,1168,954
2021,129020,10,1,650,428,222
2021,129020,10,2,609,335,274
2021,129020,10,3,758,361,397
2021,129020,10,4,58,27,31
2021,129020,10,5,46,17,29
2021,129020,10,6,1,0,1
2021,129020,20,0,993,631,362
2021,129020,20,1,582,391,191
2021,129020,20,2,409,238,171
2021,129020,20,3,2,2,0
2021,129020,30,0,332,167,165
2021,129020,30,1,4,3,1
2021,129020,30,2,41,29,12
2021,129020,30,3,286,135,151
2021,129020,30,4,1,0,1
2021,129020,40,0,797,370,427
2021,129020,40,1,64,34,30
2021,129020,40,2,159,68,91
2021,129020,40,3,470,224,246
2021,129020,40,4,57,27,30
2021,129020,40,5,46,17,29
2021,129020,40,6,1,0,1
2021,129020,41,0,257,106,151
2021,129020,41,1,16,4,12
2021,129020,41,2,75,26,49
2021,129020,41,3,122,58,64
2021,129020,41,4,15,8,7
2021,129020,41,5,29,10,19
2021,129020,42,0,534,262,272
2021,129020,42,1,48,30,18
2021,129020,42,2,84,42,42
2021,129020,42,3,343,164,179
2021,129020,42,4,42,19,23
2021,129020,42,5,16,7,9
2021,129020,42,6,1,0,1
2021,129020,43,0,6,2,4
2021,129020,43,3,5,2,3
2021,129020,43,5,1,0,1
2021,129020,44,0,257,106,151
2021,129020,44,1,16,4,12
2021,129020,44,2,75,26,49
2021,129020,44,3,122,58,64
2021,129020,44,4,15,8,7
2021,129020,44,5,29,10,19
2021,129154,0,0,78,27,51
2021,129154,10,0,78,27,51
2021,129154,10,1,5,2,3
2021,129154,10,2,21,6,15
2021,129154,10,3,40,14,26
2021,129154,10,4,12,5,7
2021,129154,40,0,78,27,51
2021,129154,40,1,5,2,3
2021,129154,40,2,21,6,15
2021,129154,40,3,40,14,26
2021,129154,40,4,12,5,7
2021,129154,41,0,14,3,11
2021,129154,41,1,4,1,3
2021,129154,41,2,10,2,8
2021,129154,42,0,64,24,40
2021,129154,42,1,1,1,0
2021,129154,42,2,11,4,7
2021,129154,42,3,40,14,26
2021,129154,42,4,12,5,7
2021,129154,44,0,14,3,11
2021,129154,44,1,4,1,3
2021,129154,44,2,10,2,8
2021,129215,0,0,183,100,83
2021,129215,10,0,183,100,83
2021,129215,10,1,90,50,40
2021,129215,10,2,53,31,22
2021,129215,10,3,38,17,21
2021,129215,10,4,2,2,0
2021,129215,20,0,145,83,62
2021,129215,20,1,90,50,40
2021,129215,20,2,53,31,22
2021,129215,20,3,2,2,0
2021,129215,30,0,31,14,17
2021,129215,30,3,31,14,17
2021,129215,40,0,7,3,4
2021,129215,40,3,5,1,4
2021,129215,40,4,2,2,0
2021,129215,42,0,6,3,3
2021,129215,42,3,4,1,3
2021,129215,42,4,2,2,0
2021,129215,43,0,1,0,1
2021,129215,43,3,1,0,1
2021,129242,0,0,323,139,184
2021,129242,10,0,323,139,184
2021,129242,10,1,83,37,46
2021,129242,10,2,99,44,55
2021,129242,10,3,110,47,63
2021,129242,10,4,31,11,20
2021,129242,20,0,177,78,99
2021,129242,20,1,83,37,46
2021,129242,20,2,90,40,50
2021,129242,20,3,4,1,3
2021,129242,30,0,51,23,28
2021,129242,30,2,2,1,1
2021,129242,30,3,49,22,27
2021,129242,40,0,95,38,57
2021,129242,40,2,7,3,4
2021,129242,40,3,57,24,33
2021,129242,40,4,31,11,20
2021,129242,42,0,93,37,56
2021,129242,42,2,7,3,4
2021,129242,42,3,57,24,33
2021,129242,42,4,29,10,19
2021,129242,43,0,2,1,1
2021,129242,43,4,2,1,1
2021,129367,0,0,62,26,36
2021,129367,10,0,62,26,36
2021,129367,10,1,30,15,15
2021,129367,10,2,16,7,9
2021,129367,10,3,15,4,11
2021,129367,10,5,1,0,1
2021,129367,20,0,35,19,16
2021,129367,20,1,28,14,14
2021,129367,20,2,7,5,2
2021,129367,30,0,26,7,19
2021,129367,30,1,2,1,1
2021,129367,30,2,9,2,7
2021,129367,30,3,15,4,11
2021,129367,40,0,1,0,1
2021,129367,40,5,1,0,1
2021,129367,41,0,1,0,1
2021,129367,41,5,1,0,1
2021,129367,44,0,1,0,1
2021,129367,44,5,1,0,1
2021,129428,0,0,5,4,1
2021,129428,10,0,5,4,1
2021,129428,10,1,4,3,1
2021,129428,10,5,1,1,0
2021,129428,40,0,5,4,1
2021,129428,40,1,4,3,1
2021,129428,40,5,1,1,0
2021,129428,41,0,5,4,1
2021,129428,41,1,4,3,1
2021,129428,41,5,1,1,0
2021,129428,44,0,5,4,1
2021,129428,44,1,4,3,1
2021,129428,44,5,1,1,0
2021,129491,0,0,9,5,4
2021,129491,10,0,8,5,3
2021,129491,10,1,1,1,0
2021,129491,10,2,3,2,1
2021,129491,10,4,4,2,2
2021,129491,40,0,8,5,3
2021,129491,40,1,1,1,0
2021,129491,40,2,3,2,1
2021,129491,40,4,4,2,2
2021,129491,41,0,8,5,3
2021,129491,41,1,1,1,0
2021,129491,41,2,3,2,1
2021,129491,41,4,4,2,2
2021,129491,44,0,8,5,3
2021,129491,44,1,1,1,0
2021,129491,44,2,3,2,1
2021,129491,44,4,4,2,2
2021,129491,50,0,1,0,1
2021,129525,0,0,340,173,167
2021,129525,10,0,340,173,167
2021,129525,10,1,88,62,26
2021,129525,10,2,111,57,54
2021,129525,10,3,101,37,64
2021,129525,10,4,12,7,5
2021,129525,10,6,28,10,18
2021,129525,20,0,171,100,71
2021,129525,20,1,86,60,26
2021,129525,20,2,82,39,43
2021,129525,20,3,3,1,2
2021,129525,30,0,75,31,44
2021,129525,30,1,1,1,0
2021,129525,30,2,15,9,6
2021,129525,30,3,58,20,38
2021,129525,30,6,1,1,0
2021,129525,40,0,94,42,52
2021,129525,40,1,1,1,0
2021,129525,40,2,14,9,5
2021,129525,40,3,40,16,24
2021,129525,40,4,12,7,5
2021,129525,40,6,27,9,18
2021,129525,41,0,39,20,19
2021,129525,41,1,1,1,0
2021,129525,41,2,12,8,4
2021,129525,41,3,21,8,13
2021,129525,41,4,5,3,2
2021,129525,42,0,39,16,23
2021,129525,42,2,1,0,1
2021,129525,42,3,16,8,8
2021,129525,42,4,7,4,3
2021,129525,42,6,15,4,11
2021,129525,43,0,16,6,10
2021,129525,43,2,1,1,0
2021,129525,43,3,3,0,3
2021,129525,43,6,12,5,7
2021,129525,44,0,39,20,19
2021,129525,44,1,1,1,0
2021,129525,44,2,12,8,4
2021,129525,44,3,21,8,13
2021,129525,44,4,5,3,2
2021,129534,0,0,12,7,5
2021,129534,10,0,12,7,5
2021,129534,10,1,3,2,1
2021,129534,10,2,2,0,2
2021,129534,10,3,2,2,0
2021,129534,10,4,5,3,2
2021,129534,40,0,12,7,5
2021,129534,40,1,3,2,1
2021,129534,40,2,2,0,2
2021,129534,40,3,2,2,0
2021,129534,40,4,5,3,2
2021,129534,41,0,7,4,3
2021,129534,41,1,2,1,1
2021,129534,41,2,1,0,1
2021,129534,41,3,2,2,0
2021,129534,41,4,2,1,1
2021,129534,42,0,3,2,1
2021,129534,42,4,3,2,1
2021,129534,43,0,2,1,1
2021,129534,43,1,1,1,0
2021,129534,43,2,1,0,1
2021,129534,44,0,7,4,3
2021,129534,44,1,2,1,1
2021,129534,44,2,1,0,1
2021,129534,44,3,2,2,0
2021,129534,44,4,2,1,1
2021,129543,0,0,73,33,40
2021,129543,10,0,73,33,40
2021,129543,10,1,34,13,21
2021,129543,10,2,16,7,9
2021,129543,10,3,13,6,7
2021,129543,10,4,7,5,2
2021,129543,10,5,3,2,1
2021,129543,20,0,50,21,29
2021,129543,20,1,34,13,21
2021,129543,20,2,13,6,7
2021,129543,20,3,3,2,1
2021,129543,30,0,20,10,10
2021,129543,30,2,3,1,2
2021,129543,30,3,10,4,6
2021,129543,30,4,7,5,2
2021,129543,40,0,3,2,1
2021,129543,40,5,3,2,1
2021,129543,42,0,3,2,1
2021,129543,42,5,3,2,1
2021,129695,0,0,89,32,57
2021,129695,10,0,89,32,57
2021,129695,10,1,57,21,36
2021,129695,10,2,15,4,11
2021,129695,10,3,11,6,5
2021,129695,10,4,6,1,5
2021,129695,20,0,70,26,44
2021,129695,20,1,56,21,35
2021,129695,20,2,9,4,5
2021,129695,20,3,4,1,3
2021,129695,20,4,1,0,1
2021,129695,30,0,19,6,13
2021,129695,30,1,1,0,1
2021,129695,30,2,6,0,6
2021,129695,30,3,7,5,2
2021,129695,30,4,5,1,4
2021,129729,0,0,92,35,57
2021,129729,10,0,92,35,57
2021,129729,10,1,66,25,41
2021,129729,10,2,16,7,9
2021,129729,10,3,7,2,5
2021,129729,10,4,3,1,2
2021,129729,20,0,69,24,45
2021,129729,20,1,60,21,39
2021,129729,20,2,9,3,6
2021,129729,30,0,23,11,12
2021,129729,30,1,6,4,2
2021,129729,30,2,7,4,3
2021,129729,30,3,7,2,5
2021,129729,30,4,3,1,2
2021,129756,0,0,42,22,20
2021,129756,10,0,42,22,20
2021,129756,10,1,32,17,15
2021,129756,10,2,6,3,3
2021,129756,10,3,2,1,1
2021,129756,10,4,1,0,1
2021,129756,10,5,1,1,0
2021,129756,20,0,31,16,15
2021,129756,20,1,29,15,14
2021,129756,20,2,2,1,1
2021,129756,30,0,10,5,5
2021,129756,30,1,3,2,1
2021,129756,30,2,4,2,2
2021,129756,30,3,2,1,1
2021,129756,30,4,1,0,1
2021,129756,40,0,1,1,0
2021,129756,40,5,1,1,0
2021,129756,43,0,1,1,0
2021,129756,43,5,1,1,0
2021,129774,0,0,18,10,8
2021,129774,10,0,18,10,8
2021,129774,10,1,2,1,1
2021,129774,10,2,8,4,4
2021,129774,10,3,8,5,3
2021,129774,40,0,18,10,8
2021,129774,40,1,2,1,1
2021,129774,40,2,8,4,4
2021,129774,40,3,8,5,3
2021,129774,41,0,11,6,5
2021,129774,41,1,2,1,1
2021,129774,41,2,8,4,4
2021,129774,41,3,1,1,0
2021,129774,42,0,7,4,3
2021,129774,42,3,7,4,3
2021,129774,44,0,11,6,5
2021,129774,44,1,2,1,1
2021,129774,44,2,8,4,4
2021,129774,44,3,1,1,0
2021,129808,0,0,59,26,33
2021,129808,10,0,58,26,32
2021,129808,10,1,34,18,16
2021,129808,10,2,13,4,9
2021,129808,10,3,8,3,5
2021,129808,10,5,3,1,2
2021,129808,20,0,41,21,20
2021,129808,20,1,34,18,16
2021,129808,20,2,6,3,3
2021,129808,20,3,1,0,1
2021,129808,30,0,14,4,10
2021,129808,30,2,7,1,6
2021,129808,30,3,7,3,4
2021,129808,40,0,3,1,2
2021,129808,40,5,3,1,2
2021,129808,42,0,3,1,2
2021,129808,42,5,3,1,2
2021,129808,50,0,1,0,1
2021,129941,0,0,244,148,96
2021,129941,10,0,244,148,96
2021,129941,10,1,42,30,12
2021,129941,10,2,71,46,25
2021,129941,10,3,60,32,28
2021,129941,10,4,1,1,0
2021,129941,10,5,70,39,31
2021,129941,20,0,109,72,37
2021,129941,20,1,42,30,12
2021,129941,20,2,66,42,24
2021,129941,20,3,1,0,1
2021,129941,30,0,53,29,24
2021,129941,30,2,4,3,1
2021,129941,30,3,49,26,23
2021,129941,40,0,82,47,35
2021,129941,40,2,1,1,0
2021,129941,40,3,10,6,4
2021,129941,40,4,1,1,0
2021,129941,40,5,70,39,31
2021,129941,41,0,59,35,24
2021,129941,41,2,1,1,0
2021,129941,41,3,7,5,2
2021,129941,41,5,51,29,22
2021,129941,42,0,23,12,11
2021,129941,42,3,3,1,2
2021,129941,42,4,1,1,0
2021,129941,42,5,19,10,9
2021,129941,44,0,59,35,24
2021,129941,44,2,1,1,0
2021,129941,44,3,7,5,2
2021,129941,44,5,51,29,22
2021,130004,0,0,89,39,50
2021,130004,10,0,89,39,50
2021,130004,10,1,61,30,31
2021,130004,10,2,10,4,6
2021,130004,10,3,10,3,7
2021,130004,10,4,3,1,2
2021,130004,10,5,5,1,4
2021,130004,20,0,62,31,31
2021,130004,20,1,58,28,30
2021,130004,20,2,4,3,1
2021,130004,30,0,18,7,11
2021,130004,30,1,3,2,1
2021,130004,30,2,4,1,3
2021,130004,30,3,10,3,7
2021,130004,30,4,1,1,0
2021,130004,40,0,9,1,8
2021,130004,40,2,2,0,2
2021,130004,40,4,2,0,2
2021,130004,40,5,5,1,4
2021,130004,42,0,9,1,8
2021,130004,42,2,2,0,2
2021,130004,42,4,2,0,2
2021,130004,42,5,5,1,4
2021,130040,0,0,28,8,20
2021,130040,10,0,28,8,20
2021,130040,10,1,14,4,10
2021,130040,10,2,4,1,3
2021,130040,10,3,4,2,2
2021,130040,10,4,4,1,3
2021,130040,10,5,2,0,2
2021,130040,20,0,17,6,11
2021,130040,20,1,14,4,10
2021,130040,20,2,2,1,1
2021,130040,20,3,1,1,0
2021,130040,30,0,11,2,9
2021,130040,30,2,2,0,2
2021,130040,30,3,3,1,2
2021,130040,30,4,4,1,3
2021,130040,30,5,2,0,2
2021,130110,0,0,14,8,6
2021,130110,10,0,14,8,6
2021,130110,10,6,14,8,6
2021,130110,40,0,14,8,6
2021,130110,40,6,14,8,6
2021,130110,42,0,14,8,6
2021,130110,42,6,14,8,6
2021,130183,0,0,63,28,35
2021,130183,10,0,63,28,35
2021,130183,10,6,63,28,35
2021,130183,40,0,63,28,35
2021,130183,40,6,63,28,35
2021,130183,41,0,63,28,35
2021,130183,41,6,63,28,35
2021,130183,45,0,63,28,35
2021,130183,45,6,63,28,35
2021,130217,0,0,28,15,13
2021,130217,10,0,26,13,13
2021,130217,10,1,18,8,10
2021,130217,10,2,4,2,2
2021,130217,10,3,3,2,1
2021,130217,10,4,1,1,0
2021,130217,20,0,21,10,11
2021,130217,20,1,18,8,10
2021,130217,20,2,3,2,1
2021,130217,30,0,5,3,2
2021,130217,30,2,1,0,1
2021,130217,30,3,3,2,1
2021,130217,30,4,1,1,0
2021,130217,50,0,2,2,0
2021,130226,0,0,392,166,226
2021,130226,10,0,392,166,226
2021,130226,10,1,136,67,69
2021,130226,10,2,147,64,83
2021,130226,10,3,96,30,66
2021,130226,10,4,13,5,8
2021,130226,20,0,198,101,97
2021,130226,20,1,115,61,54
2021,130226,20,2,83,40,43
2021,130226,30,0,42,19,23
2021,130226,30,1,1,0,1
2021,130226,30,2,5,3,2
2021,130226,30,3,35,16,19
2021,130226,30,4,1,0,1
2021,130226,40,0,152,46,106
2021,130226,40,1,20,6,14
2021,130226,40,2,59,21,38
2021,130226,40,3,61,14,47
2021,130226,40,4,12,5,7
2021,130226,41,0,144,45,99
2021,130226,41,1,20,6,14
2021,130226,41,2,58,21,37
2021,130226,41,3,54,13,41
2021,130226,41,4,12,5,7
2021,130226,42,0,8,1,7
2021,130226,42,2,1,0,1
2021,130226,42,3,7,1,6
2021,130226,44,0,144,45,99
2021,130226,44,1,20,6,14
2021,130226,44,2,58,21,37
2021,130226,44,3,54,13,41
2021,130226,44,4,12,5,7
2021,130253,0,0,351,134,217
2021,130253,10,0,351,134,217
2021,130253,10,1,52,31,21
2021,130253,10,2,99,40,59
2021,130253,10,3,149,48,101
2021,130253,10,4,27,8,19
2021,130253,10,5,24,7,17
2021,130253,20,0,112,60,52
2021,130253,20,1,48,29,19
2021,130253,20,2,63,31,32
2021,130253,20,3,1,0,1
2021,130253,30,0,77,38,39
2021,130253,30,2,9,4,5
2021,130253,30,3,68,34,34
2021,130253,40,0,162,36,126
2021,130253,40,1,4,2,2
2021,130253,40,2,27,5,22
2021,130253,40,3,80,14,66
2021,130253,40,4,27,8,19
2021,130253,40,5,24,7,17
2021,130253,42,0,162,36,126
2021,130253,42,1,4,2,2
2021,130253,42,2,27,5,22
2021,130253,42,3,80,14,66
2021,130253,42,4,27,8,19
2021,130253,42,5,24,7,17
2021,130314,0,0,123,32,91
2021,130314,10,0,123,32,91
2021,130314,10,1,16,8,8
2021,130314,10,2,45,16,29
2021,130314,10,3,55,8,47
2021,130314,10,4,7,0,7
2021,130314,20,0,52,22,30
2021,130314,20,1,16,8,8
2021,130314,20,2,35,14,21
2021,130314,20,3,1,0,1
2021,130314,30,0,37,6,31
2021,130314,30,2,2,0,2
2021,130314,30,3,34,6,28
2021,130314,30,4,1,0,1
2021,130314,40,0,34,4,30
2021,130314,40,2,8,2,6
2021,130314,40,3,20,2,18
2021,130314,40,4,6,0,6
2021,130314,41,0,31,4,27
2021,130314,41,2,8,2,6
2021,130314,41,3,20,2,18
2021,130314,41,4,3,0,3
2021,130314,42,0,3,0,3
2021,130314,42,4,3,0,3
2021,130314,44,0,31,4,27
2021,130314,44,2,8,2,6
2021,130314,44,3,20,2,18
2021,130314,44,4,3,0,3
2021,130396,0,0,96,41,55
2021,130396,10,0,96,41,55
2021,130396,10,1,54,21,33
2021,130396,10,2,16,7,9
2021,130396,10,3,21,8,13
2021,130396,10,4,4,4,0
2021,130396,10,5,1,1,0
2021,130396,20,0,61,24,37
2021,130396,20,1,54,21,33
2021,130396,20,2,7,3,4
2021,130396,30,0,34,16,18
2021,130396,30,2,9,4,5
2021,130396,30,3,21,8,13
2021,130396,30,4,4,4,0
2021,130396,40,0,1,1,0
2021,130396,40,5,1,1,0
2021,130396,42,0,1,1,0
2021,130396,42,5,1,1,0
2021,130493,0,0,417,196,221
2021,130493,10,0,417,196,221
2021,130493,10,1,174,97,77
2021,130493,10,2,153,68,85
2021,130493,10,3,87,31,56
2021,130493,10,4,3,0,3
2021,130493,20,0,315,159,156
2021,130493,20,1,173,96,77
2021,130493,20,2,137,61,76
2021,130493,20,3,5,2,3
2021,130493,30,0,91,36,55
2021,130493,30,1,1,1,0
2021,130493,30,2,16,7,9
2021,130493,30,3,74,28,46
2021,130493,40,0,11,1,10
2021,130493,40,3,8,1,7
2021,130493,40,4,3,0,3
2021,130493,42,0,11,1,10
2021,130493,42,3,8,1,7
2021,130493,42,4,3,0,3
2021,130590,0,0,240,126,114
2021,130590,10,0,240,126,114
2021,130590,10,1,60,42,18
2021,130590,10,2,55,25,30
2021,130590,10,3,42,16,26
2021,130590,10,5,27,9,18
2021,130590,10,6,56,34,22
2021,130590,20,0,102,61,41
2021,130590,20,1,53,38,15
2021,130590,20,2,49,23,26
2021,130590,30,0,42,16,26
2021,130590,30,3,42,16,26
2021,130590,40,0,96,49,47
2021,130590,40,1,7,4,3
2021,130590,40,2,6,2,4
2021,130590,40,5,27,9,18
2021,130590,40,6,56,34,22
2021,130590,41,0,68,35,33
2021,130590,41,1,7,4,3
2021,130590,41,2,6,2,4
2021,130590,41,5,26,9,17
2021,130590,41,6,29,20,9
2021,130590,42,0,25,13,12
2021,130590,42,6,25,13,12
2021,130590,43,0,3,1,2
2021,130590,43,5,1,0,1
2021,130590,43,6,2,1,1
2021,130590,44,0,68,35,33
2021,130590,44,1,7,4,3
2021,130590,44,2,6,2,4
2021,130590,44,5,26,9,17
2021,130590,44,6,29,20,9
2021,130606,0,0,60,24,36
2021,130606,10,0,60,24,36
2021,130606,10,1,36,16,20
2021,130606,10,2,5,0,5
2021,130606,10,3,2,1,1
2021,130606,10,4,7,3,4
2021,130606,10,5,10,4,6
2021,130606,20,0,37,16,21
2021,130606,20,1,36,16,20
2021,130606,20,2,1,0,1
2021,130606,30,0,13,4,9
2021,130606,30,2,4,0,4
2021,130606,30,3,2,1,1
2021,130606,30,4,7,3,4
2021,130606,40,0,10,4,6
2021,130606,40,5,10,4,6
2021,130606,42,0,10,4,6
2021,130606,42,5,10,4,6
2021,130624,0,0,142,97,45
2021,130624,10,0,142,97,45
2021,130624,10,1,32,22,10
2021,130624,10,2,18,10,8
2021,130624,10,3,9,6,3
2021,130624,10,4,79,57,22
2021,130624,10,6,4,2,2
2021,130624,20,0,68,45,23
2021,130624,20,1,32,22,10
2021,130624,20,2,17,9,8
2021,130624,20,3,4,3,1
2021,130624,20,4,15,11,4
2021,130624,30,0,5,3,2
2021,130624,30,2,1,1,0
2021,130624,30,3,4,2,2
2021,130624,40,0,69,49,20
2021,130624,40,3,1,1,0
2021,130624,40,4,64,46,18
2021,130624,40,6,4,2,2
2021,130624,41,0,60,44,16
2021,130624,41,4,60,44,16
2021,130624,42,0,9,5,4
2021,130624,42,3,1,1,0
2021,130624,42,4,4,2,2
2021,130624,42,6,4,2,2
2021,130624,44,0,60,44,16
2021,130624,44,4,60,44,16
2021,130697,0,0,402,211,191
2021,130697,10,0,402,211,191
2021,130697,10,1,111,75,36
2021,130697,10,2,83,37,46
2021,130697,10,3,79,36,43
2021,130697,10,6,129,63,66
2021,130697,20,0,193,112,81
2021,130697,20,1,111,75,36
2021,130697,20,2,82,37,45
2021,130697,30,0,80,36,44
2021,130697,30,2,1,0,1
2021,130697,30,3,79,36,43
2021,130697,40,0,129,63,66
2021,130697,40,6,129,63,66
2021,130697,41,0,84,41,43
2021,130697,41,6,84,41,43
2021,130697,42,0,45,22,23
2021,130697,42,6,45,22,23
2021,130697,44,0,84,41,43
2021,130697,44,6,84,41,43
2021,130776,0,0,204,98,106
2021,130776,10,0,204,98,106
2021,130776,10,1,105,56,49
2021,130776,10,2,59,29,30
2021,130776,10,3,37,13,24
2021,130776,10,4,3,0,3
2021,130776,20,0,157,78,79
2021,130776,20,1,105,56,49
2021,130776,20,2,50,22,28
2021,130776,20,3,2,0,2
2021,130776,30,0,38,19,19
2021,130776,30,2,9,7,2
2021,130776,30,3,29,12,17
2021,130776,40,0,9,1,8
2021,130776,40,3,6,1,5
2021,130776,40,4,3,0,3
2021,130776,42,0,9,1,8
2021,130776,42,3,6,1,5
2021,130776,42,4,3,0,3
2021,130794,0,0,2739,1611,1128
2021,130794,10,0,2739,1611,1128
2021,130794,10,1,1017,732,285
2021,130794,10,2,572,324,248
2021,130794,10,3,682,346,336
2021,130794,10,5,468,209,259
2021,130794,20,0,1089,770,319
2021,130794,20,1,953,686,267
2021,130794,20,2,136,84,52
2021,130794,30,0,1080,569,511
2021,130794,30,2,419,230,189
2021,130794,30,3,661,339,322
2021,130794,40,0,570,272,298
2021,130794,40,1,64,46,18
2021,130794,40,2,17,10,7
2021,130794,40,3,21,7,14
2021,130794,40,5,468,209,259
2021,130794,41,0,320,170,150
2021,130794,41,1,56,42,14
2021,130794,41,2,17,10,7
2021,130794,41,3,19,6,13
2021,130794,41,5,228,112,116
2021,130794,42,0,233,93,140
2021,130794,42,1,8,4,4
2021,130794,42,3,2,1,1
2021,130794,42,5,223,88,135
2021,130794,43,0,17,9,8
2021,130794,43,5,17,9,8
2021,130794,44,0,314,166,148
2021,130794,44,1,50,38,12
2021,130794,44,2,17,10,7
2021,130794,44,3,19,6,13
2021,130794,44,5,228,112,116
2021,130794,45,0,6,4,2
2021,130794,45,1,6,4,2
2021,130882,0,0,2,1,1
2021,130882,10,0,2,1,1
2021,130882,10,6,2,1,1
2021,130882,40,0,2,1,1
2021,130882,40,6,2,1,1
2021,130882,41,0,2,1,1
2021,130882,41,6,2,1,1
2021,130882,45,0,2,1,1
2021,130882,45,6,2,1,1
2021,130907,0,0,378,131,247
2021,130907,10,0,378,131,247
2021,130907,10,6,378,131,247
2021,130907,40,0,378,131,247
2021,130907,40,6,378,131,247
2021,130907,41,0,378,131,247
2021,130907,41,6,378,131,247
2021,130907,45,0,378,131,247
2021,130907,45,6,378,131,247
2021,130934,0,0,234,119,115
2021,130934,10,0,229,116,113
2021,130934,10,1,57,39,18
2021,130934,10,2,85,44,41
2021,130934,10,3,54,23,31
2021,130934,10,4,4,3,1
2021,130934,10,5,29,7,22
2021,130934,20,0,124,75,49
2021,130934,20,1,56,38,18
2021,130934,20,2,68,37,31
2021,130934,30,0,38,15,23
2021,130934,30,2,14,6,8
2021,130934,30,3,24,9,15
2021,130934,40,0,67,26,41
2021,130934,40,1,1,1,0
2021,130934,40,2,3,1,2
2021,130934,40,3,30,14,16
2021,130934,40,4,4,3,1
2021,130934,40,5,29,7,22
2021,130934,42,0,67,26,41
2021,130934,42,1,1,1,0
2021,130934,42,2,3,1,2
2021,130934,42,3,30,14,16
2021,130934,42,4,4,3,1
2021,130934,42,5,29,7,22
2021,130934,50,0,5,3,2
2021,130943,0,0,1227,673,554
2021,130943,10,0,1227,673,554
2021,130943,10,1,398,266,132
2021,130943,10,2,367,196,171
2021,130943,10,3,380,192,188
2021,130943,10,4,82,19,63
2021,130943,20,0,664,414,250
2021,130943,20,1,371,251,120
2021,130943,20,2,293,163,130
2021,130943,30,0,206,108,98
2021,130943,30,2,2,1,1
2021,130943,30,3,204,107,97
2021,130943,40,0,357,151,206
2021,130943,40,1,27,15,12
2021,130943,40,2,72,32,40
2021,130943,40,3,176,85,91
2021,130943,40,4,82,19,63
2021,130943,41,0,287,114,173
2021,130943,41,1,25,14,11
2021,130943,41,2,64,26,38
2021,130943,41,3,127,57,70
2021,130943,41,4,71,17,54
2021,130943,42,0,70,37,33
2021,130943,42,1,2,1,1
2021,130943,42,2,8,6,2
2021,130943,42,3,49,28,21
2021,130943,42,4,11,2,9
2021,130943,44,0,287,114,173
2021,130943,44,1,25,14,11
2021,130943,44,2,64,26,38
2021,130943,44,3,127,57,70
2021,130943,44,4,71,17,54
2021,130989,0,0,20,13,7
2021,130989,10,0,20,13,7
2021,130989,10,1,4,2,2
2021,130989,10,2,8,6,2
2021,130989,10,3,8,5,3
2021,130989,40,0,20,13,7
2021,130989,40,1,4,2,2
2021,130989,40,2,8,6,2
2021,130989,40,3,8,5,3
2021,130989,42,0,20,13,7
2021,130989,42,1,4,2,2
2021,130989,42,2,8,6,2
2021,130989,42,3,8,5,3
2021,131113,0,0,92,35,57
2021,131113,10,0,92,35,57
2021,131113,10,1,8,1,7
2021,131113,10,2,33,14,19
2021,131113,10,3,51,20,31
2021,131113,40,0,92,35,57
2021,131113,40,1,8,1,7
2021,131113,40,2,33,14,19
2021,131113,40,3,51,20,31
2021,131113,41,0,92,35,57
2021,131113,41,1,8,1,7
2021,131113,41,2,33,14,19
2021,131113,41,3,51,20,31
2021,131113,44,0,92,35,57
2021,131113,44,1,8,1,7
2021,131113,44,2,33,14,19
2021,131113,44,3,51,20,31
2021,131159,0,0,812,409,403
2021,131159,10,0,812,409,403
2021,131159,10,1,187,120,67
2021,131159,10,2,183,92,91
2021,131159,10,3,123,57,66
2021,131159,10,4,319,140,179
2021,131159,20,0,349,202,147
2021,131159,20,1,181,116,65
2021,131159,20,2,165,86,79
2021,131159,20,3,3,0,3
2021,131159,30,0,84,36,48
2021,131159,30,2,8,3,5
2021,131159,30,3,76,33,43
2021,131159,40,0,379,171,208
2021,131159,40,1,6,4,2
2021,131159,40,2,10,3,7
2021,131159,40,3,44,24,20
2021,131159,40,4,319,140,179
2021,131159,41,0,226,101,125
2021,131159,41,1,6,4,2
2021,131159,41,2,10,3,7
2021,131159,41,3,34,17,17
2021,131159,41,4,176,77,99
2021,131159,42,0,153,70,83
2021,131159,42,3,10,7,3
2021,131159,42,4,143,63,80
2021,131159,44,0,226,101,125
2021,131159,44,1,6,4,2
2021,131159,44,2,10,3,7
2021,131159,44,3,34,17,17
2021,131159,44,4,176,77,99
2021,131283,0,0,335,199,136
2021,131283,10,0,335,199,136
2021,131283,10,1,101,73,28
2021,131283,10,2,132,77,55
2021,131283,10,3,94,47,47
2021,131283,10,4,8,2,6
2021,131283,20,0,196,126,70
2021,131283,20,1,93,67,26
2021,131283,20,2,103,59,44
2021,131283,30,0,48,33,15
2021,131283,30,1,1,0,1
2021,131283,30,2,8,7,1
2021,131283,30,3,39,26,13
2021,131283,40,0,91,40,51
2021,131283,40,1,7,6,1
2021,131283,40,2,21,11,10
2021,131283,40,3,55,21,34
2021,131283,40,4,8,2,6
2021,131283,42,0,91,40,51
2021,131283,42,1,7,6,1
2021,131283,42,2,21,11,10
2021,131283,42,3,55,21,34
2021,131283,42,4,8,2,6
2021,131399,0,0,202,105,97
2021,131399,10,0,202,105,97
2021,131399,10,1,43,23,20
2021,131399,10,2,75,34,41
2021,131399,10,3,78,45,33
2021,131399,10,4,6,3,3
2021,131399,20,0,97,43,54
2021,131399,20,1,41,22,19
2021,131399,20,2,46,18,28
2021,131399,20,3,8,2,6
2021,131399,20,4,2,1,1
2021,131399,30,0,79,51,28
2021,131399,30,2,26,14,12
2021,131399,30,3,53,37,16
2021,131399,40,0,26,11,15
2021,131399,40,1,2,1,1
2021,131399,40,2,3,2,1
2021,131399,40,3,17,6,11
2021,131399,40,4,4,2,2
2021,131399,41,0,15,7,8
2021,131399,41,1,2,1,1
2021,131399,41,2,1,1,0
2021,131399,41,3,10,4,6
2021,131399,41,4,2,1,1
2021,131399,42,0,11,4,7
2021,131399,42,2,2,1,1
2021,131399,42,3,7,2,5
2021,131399,42,4,2,1,1
2021,131399,44,0,15,7,8
2021,131399,44,1,2,1,1
2021,131399,44,2,1,1,0
2021,131399,44,3,10,4,6
2021,131399,44,4,2,1,1
2021,131405,0,0,27,24,3
2021,131405,10,0,22,21,1
2021,131405,10,1,3,3,0
2021,131405,10,2,3,3,0
2021,131405,10,3,10,9,1
2021,131405,10,4,6,6,0
2021,131405,40,0,22,21,1
2021,131405,40,1,3,3,0
2021,131405,40,2,3,3,0
2021,131405,40,3,10,9,1
2021,131405,40,4,6,6,0
2021,131405,41,0,22,21,1
2021,131405,41,1,3,3,0
2021,131405,41,2,3,3,0
2021,131405,41,3,10,9,1
2021,131405,41,4,6,6,0
2021,131405,44,0,22,21,1
2021,131405,44,1,3,3,0
2021,131405,44,2,3,3,0
2021,131405,44,3,10,9,1
2021,131405,44,4,6,6,0
2021,131405,50,0,5,3,2
2021,131450,0,0,180,75,105
2021,131450,10,0,175,72,103
2021,131450,10,1,58,24,34
2021,131450,10,2,37,14,23
2021,131450,10,3,47,21,26
2021,131450,10,4,15,9,6
2021,131450,10,5,18,4,14
2021,131450,20,0,90,40,50
2021,131450,20,1,56,23,33
2021,131450,20,2,28,12,16
2021,131450,20,3,6,5,1
2021,131450,30,0,55,22,33
2021,131450,30,1,2,1,1
2021,131450,30,2,9,2,7
2021,131450,30,3,39,15,24
2021,131450,30,4,5,4,1
2021,131450,40,0,30,10,20
2021,131450,40,3,2,1,1
2021,131450,40,4,10,5,5
2021,131450,40,5,18,4,14
2021,131450,42,0,30,10,20
2021,131450,42,3,2,1,1
2021,131450,42,4,10,5,5
2021,131450,42,5,18,4,14
2021,131450,50,0,5,3,2
2021,131469,0,0,1247,663,584
2021,131469,10,0,1247,663,584
2021,131469,10,1,438,293,145
2021,131469,10,2,386,199,187
2021,131469,10,3,252,112,140
2021,131469,10,4,2,1,1
2021,131469,10,6,169,58,111
2021,131469,20,0,650,406,244
2021,131469,20,1,386,256,130
2021,131469,20,2,263,150,113
2021,131469,20,6,1,0,1
2021,131469,30,0,153,71,82
2021,131469,30,1,4,3,1
2021,131469,30,2,19,8,11
2021,131469,30,3,130,60,70
2021,131469,40,0,444,186,258
2021,131469,40,1,48,34,14
2021,131469,40,2,104,41,63
2021,131469,40,3,122,52,70
2021,131469,40,4,2,1,1
2021,131469,40,6,168,58,110
2021,131469,41,0,225,102,123
2021,131469,41,1,26,21,5
2021,131469,41,2,65,25,40
2021,131469,41,3,71,30,41
2021,131469,41,4,1,1,0
2021,131469,41,6,62,25,37
2021,131469,42,0,218,84,134
2021,131469,42,1,22,13,9
2021,131469,42,2,38,16,22
2021,131469,42,3,51,22,29
2021,131469,42,4,1,0,1
2021,131469,42,6,106,33,73
2021,131469,43,0,1,0,1
2021,131469,43,2,1,0,1
2021,131469,44,0,225,102,123
2021,131469,44,1,26,21,5
2021,131469,44,2,65,25,40
2021,131469,44,3,71,30,41
2021,131469,44,4,1,1,0
2021,131469,44,6,62,25,37
2021,131496,0,0,1266,686,580
2021,131496,10,0,1266,686,580
2021,131496,10,1,449,286,163
2021,131496,10,2,234,130,104
2021,131496,10,3,120,61,59
2021,131496,10,6,463,209,254
2021,131496,20,0,645,396,249
2021,131496,20,1,433,276,157
2021,131496,20,2,211,120,91
2021,131496,20,3,1,0,1
2021,131496,30,0,146,73,73
2021,131496,30,1,9,4,5
2021,131496,30,2,18,8,10
2021,131496,30,3,118,60,58
2021,131496,30,6,1,1,0
2021,131496,40,0,475,217,258
2021,131496,40,1,7,6,1
2021,131496,40,2,5,2,3
2021,131496,40,3,1,1,0
2021,131496,40,6,462,208,254
2021,131496,41,0,239,113,126
2021,131496,41,1,1,1,0
2021,131496,41,6,238,112,126
2021,131496,42,0,179,72,107
2021,131496,42,1,6,5,1
2021,131496,42,2,3,1,2
2021,131496,42,3,1,1,0
2021,131496,42,6,169,65,104
2021,131496,43,0,57,32,25
2021,131496,43,2,2,1,1
2021,131496,43,6,55,31,24
2021,131496,44,0,239,113,126
2021,131496,44,1,1,1,0
2021,131496,44,6,238,112,126
2021,131520,0,0,937,484,453
2021,131520,10,0,937,484,453
2021,131520,10,1,232,154,78
2021,131520,10,2,287,149,138
2021,131520,10,3,243,100,143
2021,131520,10,4,63,24,39
2021,131520,10,5,112,57,55
2021,131520,20,0,471,278,193
2021,131520,20,1,227,152,75
2021,131520,20,2,240,126,114
2021,131520,20,3,3,0,3
2021,131520,20,4,1,0,1
2021,131520,30,0,142,64,78
2021,131520,30,2,9,4,5
2021,131520,30,3,132,59,73
2021,131520,30,4,1,1,0
2021,131520,40,0,324,142,182
2021,131520,40,1,5,2,3
2021,131520,40,2,38,19,19
2021,131520,40,3,108,41,67
2021,131520,40,4,61,23,38
2021,131520,40,5,112,57,55
2021,131520,41,0,118,40,78
2021,131520,41,1,4,2,2
2021,131520,41,2,31,15,16
2021,131520,41,3,68,21,47
2021,131520,41,4,15,2,13
2021,131520,42,0,206,102,104
2021,131520,42,1,1,0,1
2021,131520,42,2,7,4,3
2021,131520,42,3,40,20,20
2021,131520,42,4,46,21,25
2021,131520,42,5,112,57,55
2021,131520,44,0,118,40,78
2021,131520,44,1,4,2,2
2021,131520,44,2,31,15,16
2021,131520,44,3,68,21,47
2021,131520,44,4,15,2,13
2021,131803,0,0,204,76,128
2021,131803,10,0,204,76,128
2021,131803,10,1,121,56,65
2021,131803,10,4,68,10,58
2021,131803,10,6,15,10,5
2021,131803,40,0,204,76,128
2021,131803,40,1,121,56,65
2021,131803,40,4,68,10,58
2021,131803,40,6,15,10,5
2021,131803,41,0,153,47,106
2021,131803,41,1,70,27,43
2021,131803,41,4,68,10,58
2021,131803,41,6,15,10,5
2021,131803,42,0,51,29,22
2021,131803,42,1,51,29,22
2021,131803,45,0,153,47,106
2021,131803,45,1,70,27,43
2021,131803,45,4,68,10,58
2021,131803,45,6,15,10,5
2021,131876,0,0,63,14,49
2021,131876,10,0,55,12,43
2021,131876,10,1,1,0,1
2021,131876,10,2,21,5,16
2021,131876,10,3,33,7,26
2021,131876,20,0,22,5,17
2021,131876,20,1,1,0,1
2021,131876,20,2,21,5,16
2021,131876,30,0,13,3,10
2021,131876,30,3,13,3,10
2021,131876,40,0,20,4,16
2021,131876,40,3,20,4,16
2021,131876,42,0,20,4,16
2021,131876,42,3,20,4,16
2021,131876,50,0,8,2,6
2021,131973,0,0,18,10,8
2021,131973,10,0,18,10,8
2021,131973,10,1,12,6,6
2021,131973,10,2,4,2,2
2021,131973,10,3,2,2,0
2021,131973,20,0,10,6,4
2021,131973,20,1,10,6,4
2021,131973,30,0,4,2,2
2021,131973,30,2,4,2,2
2021,131973,40,0,4,2,2
2021,131973,40,1,2,0,2
2021,131973,40,3,2,2,0
2021,131973,41,0,4,2,2
2021,131973,41,1,2,0,2
2021,131973,41,3,2,2,0
2021,131973,44,0,1,0,1
2021,131973,44,1,1,0,1
2021,131973,45,0,3,2,1
2021,131973,45,1,1,0,1
2021,131973,45,3,2,2,0
2021,132408,0,0,20,12,8
2021,132408,10,0,20,12,8
2021,132408,10,1,8,7,1
2021,132408,10,2,4,3,1
2021,132408,10,3,4,2,2
2021,132408,10,4,4,0,4
2021,132408,20,0,3,2,1
2021,132408,20,1,3,2,1
2021,132408,30,0,1,1,0
2021,132408,30,2,1,1,0
2021,132408,40,0,16,9,7
2021,132408,40,1,5,5,0
2021,132408,40,2,3,2,1
2021,132408,40,3,4,2,2
2021,132408,40,4,4,0,4
2021,132408,42,0,16,9,7
2021,132408,42,1,5,5,0
2021,132408,42,2,3,2,1
2021,132408,42,3,4,2,2
2021,132408,42,4,4,0,4
2021,132471,0,0,275,118,157
2021,132471,10,0,275,118,157
2021,132471,10,1,73,37,36
2021,132471,10,2,92,35,57
2021,132471,10,3,87,36,51
2021,132471,10,4,23,10,13
2021,132471,20,0,6,2,4
2021,132471,20,1,6,2,4
2021,132471,30,0,13,6,7
2021,132471,30,2,7,3,4
2021,132471,30,3,6,3,3
2021,132471,40,0,256,110,146
2021,132471,40,1,67,35,32
2021,132471,40,2,85,32,53
2021,132471,40,3,81,33,48
2021,132471,40,4,23,10,13
2021,132471,41,0,123,50,73
2021,132471,41,1,47,27,20
2021,132471,41,2,43,15,28
2021,132471,41,3,33,8,25
2021,132471,42,0,133,60,73
2021,132471,42,1,20,8,12
2021,132471,42,2,42,17,25
2021,132471,42,3,48,25,23
2021,132471,42,4,23,10,13
2021,132471,44,0,123,50,73
2021,132471,44,1,47,27,20
2021,132471,44,2,43,15,28
2021,132471,44,3,33,8,25
2021,132602,0,0,139,78,61
2021,132602,10,0,139,78,61
2021,132602,10,1,14,8,6
2021,132602,10,2,30,16,14
2021,132602,10,3,62,37,25
2021,132602,10,4,33,17,16
2021,132602,20,0,37,19,18
2021,132602,20,1,12,6,6
2021,132602,20,2,22,10,12
2021,132602,20,3,3,3,0
2021,132602,30,0,59,39,20
2021,132602,30,1,2,2,0
2021,132602,30,2,8,6,2
2021,132602,30,3,47,29,18
2021,132602,30,4,2,2,0
2021,132602,40,0,43,20,23
2021,132602,40,3,12,5,7
2021,132602,40,4,31,15,16
2021,132602,42,0,43,20,23
2021,132602,42,3,12,5,7
2021,132602,42,4,31,15,16
2021,132657,0,0,124,72,52
2021,132657,10,0,124,72,52
2021,132657,10,1,35,21,14
2021,132657,10,2,50,28,22
2021,132657,10,3,32,18,14
2021,132657,10,4,4,3,1
2021,132657,10,5,1,1,0
2021,132657,10,6,2,1,1
2021,132657,40,0,124,72,52
2021,132657,40,1,35,21,14
2021,132657,40,2,50,28,22
2021,132657,40,3,32,18,14
2021,132657,40,4,4,3,1
2021,132657,40,5,1,1,0
2021,132657,40,6,2,1,1
2021,132657,42,0,124,72,52
2021,132657,42,1,35,21,14
2021,132657,42,2,50,28,22
2021,132657,42,3,32,18,14
2021,132657,42,4,4,3,1
2021,132657,42,5,1,1,0
2021,132657,42,6,2,1,1
2021,132693,0,0,255,112,143
2021,132693,10,0,255,112,143
2021,132693,10,1,53,21,32
2021,132693,10,2,49,19,30
2021,132693,10,3,56,26,30
2021,132693,10,4,97,46,51
2021,132693,20,0,163,72,91
2021,132693,20,1,52,21,31
2021,132693,20,2,45,19,26
2021,132693,20,3,54,24,30
2021,132693,20,4,12,8,4
2021,132693,30,0,79,35,44
2021,132693,30,1,1,0,1
2021,132693,30,3,1,1,0
2021,132693,30,4,77,34,43
2021,132693,40,0,13,5,8
2021,132693,40,2,4,0,4
2021,132693,40,3,1,1,0
2021,132693,40,4,8,4,4
2021,132693,43,0,13,5,8
2021,132693,43,2,4,0,4
2021,132693,43,3,1,1,0
2021,132693,43,4,8,4,4
2021,132709,0,0,369,171,198
2021,132709,10,0,369,171,198
2021,132709,10,1,55,30,25
2021,132709,10,2,156,66,90
2021,132709,10,3,131,56,75
2021,132709,10,4,27,19,8
2021,132709,20,0,277,129,148
2021,132709,20,1,55,30,25
2021,132709,20,2,156,66,90
2021,132709,20,3,56,26,30
2021,132709,20,4,10,7,3
2021,132709,30,0,90,41,49
2021,132709,30,3,74,29,45
2021,132709,30,4,16,12,4
2021,132709,40,0,2,1,1
2021,132709,40,3,1,1,0
2021,132709,40,4,1,0,1
2021,132709,43,0,2,1,1
2021,132709,43,3,1,1,0
2021,132709,43,4,1,0,1
2021,132842,0,0,29,11,18
2021,132842,10,0,29,11,18
2021,132842,10,1,3,1,2
2021,132842,10,2,11,4,7
2021,132842,10,3,15,6,9
2021,132842,40,0,29,11,18
2021,132842,40,1,3,1,2
2021,132842,40,2,11,4,7
2021,132842,40,3,15,6,9
2021,132842,41,0,23,7,16
2021,132842,41,1,3,1,2
2021,132842,41,2,9,2,7
2021,132842,41,3,11,4,7
2021,132842,42,0,6,4,2
2021,132842,42,2,2,2,0
2021,132842,42,3,4,2,2
2021,132842,44,0,23,7,16
2021,132842,44,1,3,1,2
2021,132842,44,2,9,2,7
2021,132842,44,3,11,4,7
2021,132851,0,0,115,44,71
2021,132851,10,0,115,44,71
2021,132851,10,1,13,4,9
2021,132851,10,2,35,18,17
2021,132851,10,3,16,6,10
2021,132851,10,4,6,5,1
2021,132851,10,6,45,11,34
2021,132851,20,0,73,32,41
2021,132851,20,1,13,4,9
2021,132851,20,2,33,17,16
2021,132851,20,3,16,6,10
2021,132851,20,4,5,4,1
2021,132851,20,6,6,1,5
2021,132851,30,0,39,12,27
2021,132851,30,2,2,1,1
2021,132851,30,4,1,1,0
2021,132851,30,6,36,10,26
2021,132851,40,0,3,0,3
2021,132851,40,6,3,0,3
2021,132851,43,0,3,0,3
2021,132851,43,6,3,0,3
2021,132879,0,0,13,6,7
2021,132879,10,0,13,6,7
2021,132879,10,1,6,2,4
2021,132879,10,2,3,3,0
2021,132879,10,3,4,1,3
2021,132879,40,0,13,6,7
2021,132879,40,1,6,2,4
2021,132879,40,2,3,3,0
2021,132879,40,3,4,1,3
2021,132879,42,0,13,6,7
2021,132879,42,1,6,2,4
2021,132879,42,2,3,3,0
2021,132879,42,3,4,1,3
2021,132903,0,0,1551,873,678
2021,132903,10,0,1551,873,678
2021,132903,10,1,379,279,100
2021,132903,10,2,386,222,164
2021,132903,10,3,297,165,132
2021,132903,10,4,190,75,115
2021,132903,10,5,299,132,167
2021,132903,20,0,728,484,244
2021,132903,20,1,368,270,98
2021,132903,20,2,359,213,146
2021,132903,20,3,1,1,0
2021,132903,30,0,269,159,110
2021,132903,30,1,1,1,0
2021,132903,30,2,6,4,2
2021,132903,30,3,262,154,108
2021,132903,40,0,554,230,324
2021,132903,40,1,10,8,2
2021,132903,40,2,21,5,16
2021,132903,40,3,34,10,24
2021,132903,40,4,190,75,115
2021,132903,40,5,299,132,167
2021,132903,42,0,554,230,324
2021,132903,42,1,10,8,2
2021,132903,42,2,21,5,16
2021,132903,42,3,34,10,24
2021,132903,42,4,190,75,115
2021,132903,42,5,299,132,167
2021,133021,0,0,41,15,26
2021,133021,10,0,41,15,26
2021,133021,10,1,8,4,4
2021,133021,10,2,1,0,1
2021,133021,10,3,18,7,11
2021,133021,10,4,14,4,10
2021,133021,20,0,19,8,11
2021,133021,20,1,8,4,4
2021,133021,20,2,1,0,1
2021,133021,20,3,8,4,4
2021,133021,20,4,2,0,2
2021,133021,30,0,20,7,13
2021,133021,30,3,8,3,5
2021,133021,30,4,12,4,8
2021,133021,40,0,2,0,2
2021,133021,40,3,2,0,2
2021,133021,42,0,2,0,2
2021,133021,42,3,2,0,2
2021,133386,0,0,226,114,112
2021,133386,10,0,226,114,112
2021,133386,10,1,125,69,56
2021,133386,10,2,53,21,32
2021,133386,10,3,40,17,23
2021,133386,10,4,8,7,1
2021,133386,20,0,175,94,81
2021,133386,20,1,125,69,56
2021,133386,20,2,42,18,24
2021,133386,20,3,8,7,1
2021,133386,30,0,51,20,31
2021,133386,30,2,11,3,8
2021,133386,30,3,32,10,22
2021,133386,30,4,8,7,1
2021,133465,0,0,23,7,16
2021,133465,10,0,23,7,16
2021,133465,10,2,1,0,1
2021,133465,10,3,14,2,12
2021,133465,10,4,8,5,3
2021,133465,40,0,23,7,16
2021,133465,40,2,1,0,1
2021,133465,40,3,14,2,12
2021,133465,40,4,8,5,3
2021,133465,41,0,23,7,16
2021,133465,41,2,1,0,1
2021,133465,41,3,14,2,12
2021,133465,41,4,8,5,3
2021,133465,45,0,23,7,16
2021,133465,45,2,1,0,1
2021,133465,45,3,14,2,12
2021,133465,45,4,8,5,3
2021,133492,0,0,162,77,85
2021,133492,10,0,162,77,85
2021,133492,10,1,43,27,16
2021,133492,10,2,33,15,18
2021,133492,10,3,64,25,39
2021,133492,10,4,22,10,12
2021,133492,20,0,86,46,40
2021,133492,20,1,43,27,16
2021,133492,20,2,33,15,18
2021,133492,20,3,10,4,6
2021,133492,30,0,32,10,22
2021,133492,30,3,32,10,22
2021,133492,40,0,44,21,23
2021,133492,40,3,22,11,11
2021,133492,40,4,22,10,12
2021,133492,42,0,44,21,23
2021,133492,42,3,22,11,11
2021,133492,42,4,22,10,12
2021,133508,0,0,196,92,104
2021,133508,10,0,196,92,104
2021,133508,10,6,196,92,104
2021,133508,20,0,110,49,61
2021,133508,20,6,110,49,61
2021,133508,30,0,78,39,39
2021,133508,30,6,78,39,39
2021,133508,40,0,8,4,4
2021,133508,40,6,8,4,4
2021,133508,42,0,8,4,4
2021,133508,42,6,8,4,4
2021,133526,0,0,46,27,19
2021,133526,10,0,46,27,19
2021,133526,10,1,11,8,3
2021,133526,10,2,9,4,5
2021,133526,10,3,19,10,9
2021,133526,10,4,7,5,2
2021,133526,20,0,10,7,3
2021,133526,20,1,10,7,3
2021,133526,30,0,24,12,12
2021,133526,30,1,1,1,0
2021,133526,30,2,8,4,4
2021,133526,30,3,15,7,8
2021,133526,40,0,12,8,4
2021,133526,40,2,1,0,1
2021,133526,40,3,4,3,1
2021,133526,40,4,7,5,2
2021,133526,43,0,12,8,4
2021,133526,43,2,1,0,1
2021,133526,43,3,4,3,1
2021,133526,43,4,7,5,2
2021,133553,0,0,359,246,113
2021,133553,10,0,359,246,113
2021,133553,10,1,96,77,19
2021,133553,10,2,109,81,28
2021,133553,10,3,130,76,54
2021,133553,10,4,24,12,12
2021,133553,20,0,161,121,40
2021,133553,20,1,91,75,16
2021,133553,20,2,70,46,24
2021,133553,30,0,54,33,21
2021,133553,30,2,3,2,1
2021,133553,30,3,51,31,20
2021,133553,40,0,144,92,52
2021,133553,40,1,5,2,3
2021,133553,40,2,36,33,3
2021,133553,40,3,79,45,34
2021,133553,40,4,24,12,12
2021,133553,42,0,144,92,52
2021,133553,42,1,5,2,3
2021,133553,42,2,36,33,3
2021,133553,42,3,79,45,34
2021,133553,42,4,24,12,12
2021,133650,0,0,576,297,279
2021,133650,10,0,529,286,243
2021,133650,10,1,156,111,45
2021,133650,10,2,166,87,79
2021,133650,10,3,136,64,72
2021,133650,10,4,71,24,47
2021,133650,20,0,289,178,111
2021,133650,20,1,147,105,42
2021,133650,20,2,129,64,65
2021,133650,20,3,13,9,4
2021,133650,30,0,99,53,46
2021,133650,30,1,4,3,1
2021,133650,30,2,29,17,12
2021,133650,30,3,66,33,33
2021,133650,40,0,141,55,86
2021,133650,40,1,5,3,2
2021,133650,40,2,8,6,2
2021,133650,40,3,57,22,35
2021,133650,40,4,71,24,47
2021,133650,42,0,141,55,86
2021,133650,42,1,5,3,2
2021,133650,42,2,8,6,2
2021,133650,42,3,57,22,35
2021,133650,42,4,71,24,47
2021,133650,50,0,47,11,36
2021,133669,0,0,859,468,391
2021,133669,10,0,859,468,391
2021,133669,10,1,252,173,79
2021,133669,10,2,246,131,115
2021,133669,10,3,142,83,59
2021,133669,10,4,214,79,135
2021,133669,10,5,1,0,1
2021,133669,10,6,4,2,2
2021,133669,20,0,467,286,181
2021,133669,20,1,245,169,76
2021,133669,20,2,222,117,105
2021,133669,30,0,121,75,46
2021,133669,30,2,8,5,3
2021,133669,30,3,113,70,43
2021,133669,40,0,271,107,164
2021,133669,40,1,7,4,3
2021,133669,40,2,16,9,7
2021,133669,40,3,29,13,16
2021,133669,40,4,214,79,135
2021,133669,40,5,1,0,1
2021,133669,40,6,4,2,2
2021,133669,42,0,271,107,164
2021,133669,42,1,7,4,3
2021,133669,42,2,16,9,7
2021,133669,42,3,29,13,16
2021,133669,42,4,214,79,135
2021,133669,42,5,1,0,1
2021,133669,42,6,4,2,2
2021,133702,0,0,338,151,187
2021,133702,10,0,338,151,187
2021,133702,10,6,338,151,187
2021,133702,20,0,234,100,134
2021,133702,20,6,234,100,134
2021,133702,30,0,98,49,49
2021,133702,30,6,98,49,49
2021,133702,40,0,6,2,4
2021,133702,40,6,6,2,4
2021,133702,43,0,6,2,4
2021,133702,43,6,6,2,4
2021,133711,0,0,119,56,63
2021,133711,10,0,119,56,63
2021,133711,10,1,20,10,10
2021,133711,10,2,40,16,24
2021,133711,10,3,53,27,26
2021,133711,10,4,2,1,1
2021,133711,10,5,4,2,2
2021,133711,40,0,119,56,63
2021,133711,40,1,20,10,10
2021,133711,40,2,40,16,24
2021,133711,40,3,53,27,26
2021,133711,40,4,2,1,1
2021,133711,40,5,4,2,2
2021,133711,41,0,81,38,43
2021,133711,41,1,10,5,5
2021,133711,41,2,35,14,21
2021,133711,41,3,32,17,15
2021,133711,41,4,1,1,0
2021,133711,41,5,3,1,2
2021,133711,42,0,38,18,20
2021,133711,42,1,10,5,5
2021,133711,42,2,5,2,3
2021,133711,42,3,21,10,11
2021,133711,42,4,1,0,1
2021,133711,42,5,1,1,0
2021,133711,44,0,81,38,43
2021,133711,44,1,10,5,5
2021,133711,44,2,35,14,21
2021,133711,44,3,32,17,15
2021,133711,44,4,1,1,0
2021,133711,44,5,3,1,2
2021,133809,0,0,41,28,13
2021,133809,10,0,41,28,13
2021,133809,10,1,16,13,3
2021,133809,10,2,8,5,3
2021,133809,10,3,14,8,6
2021,133809,10,4,3,2,1
2021,133809,20,0,24,18,6
2021,133809,20,1,16,13,3
2021,133809,20,2,8,5,3
2021,133809,30,0,14,8,6
2021,133809,30,3,14,8,6
2021,133809,40,0,3,2,1
2021,133809,40,4,3,2,1
2021,133809,42,0,3,2,1
2021,133809,42,4,3,2,1
2021,133845,0,0,20,2,18
2021,133845,10,0,20,2,18
2021,133845,10,4,20,2,18
2021,133845,40,0,20,2,18
2021,133845,40,4,20,2,18
2021,133845,41,0,20,2,18
2021,133845,41,4,20,2,18
2021,133845,45,0,20,2,18
2021,133845,45,4,20,2,18
2021,133854,0,0,10,2,8
2021,133854,10,0,10,2,8
2021,133854,10,4,10,2,8
2021,133854,40,0,10,2,8
2021,133854,40,4,10,2,8
2021,133854,41,0,10,2,8
2021,133854,41,4,10,2,8
2021,133854,45,0,10,2,8
2021,133854,45,4,10,2,8
2021,133863,0,0,9,1,8
2021,133863,10,0,9,1,8
2021,133863,10,4,9,1,8
2021,133863,40,0,9,1,8
2021,133863,40,4,9,1,8
2021,133863,41,0,9,1,8
2021,133863,41,4,9,1,8
2021,133863,45,0,9,1,8
2021,133863,45,4,9,1,8
2021,133872,0,0,94,25,69
2021,133872,10,0,94,25,69
2021,133872,10,1,11,7,4
2021,133872,10,2,28,5,23
2021,133872,10,3,40,11,29
2021,133872,10,4,15,2,13
2021,133872,40,0,94,25,69
2021,133872,40,1,11,7,4
2021,133872,40,2,28,5,23
2021,133872,40,3,40,11,29
2021,133872,40,4,15,2,13
2021,133872,42,0,93,25,68
2021,133872,42,1,11,7,4
2021,133872,42,2,28,5,23
2021,133872,42,3,40,11,29
2021,133872,42,4,14,2,12
2021,133872,43,0,1,0,1
2021,133872,43,4,1,0,1
2021,133881,0,0,267,197,70
2021,133881,10,0,267,197,70
2021,133881,10,1,73,61,12
2021,133881,10,2,81,67,14
2021,133881,10,3,90,60,30
2021,133881,10,4,23,9,14
2021,133881,20,0,86,66,20
2021,133881,20,1,45,33,12
2021,133881,20,2,41,33,8
2021,133881,30,0,59,44,15
2021,133881,30,1,2,2,0
2021,133881,30,2,10,10,0
2021,133881,30,3,47,32,15
2021,133881,40,0,122,87,35
2021,133881,40,1,26,26,0
2021,133881,40,2,30,24,6
2021,133881,40,3,43,28,15
2021,133881,40,4,23,9,14
2021,133881,41,0,87,68,19
2021,133881,41,1,24,24,0
2021,133881,41,2,30,24,6
2021,133881,41,3,33,20,13
2021,133881,42,0,35,19,16
2021,133881,42,1,2,2,0
2021,133881,42,3,10,8,2
2021,133881,42,4,23,9,14
2021,133881,44,0,87,68,19
2021,133881,44,1,24,24,0
2021,133881,44,2,30,24,6
2021,133881,44,3,33,20,13
2021,133951,0,0,1424,792,632
2021,133951,10,0,1415,790,625
2021,133951,10,1,318,237,81
2021,133951,10,2,350,198,152
2021,133951,10,3,289,132,157
2021,133951,10,4,425,212,213
2021,133951,10,5,13,3,10
2021,133951,10,6,20,8,12
2021,133951,20,0,537,363,174
2021,133951,20,1,272,203,69
2021,133951,20,2,264,159,105
2021,133951,20,3,1,1,0
2021,133951,30,0,204,114,90
2021,133951,30,1,12,9,3
2021,133951,30,2,29,17,12
2021,133951,30,3,163,88,75
2021,133951,40,0,674,313,361
2021,133951,40,1,34,25,9
2021,133951,40,2,57,22,35
2021,133951,40,3,125,43,82
2021,133951,40,4,425,212,213
2021,133951,40,5,13,3,10
2021,133951,40,6,20,8,12
2021,133951,41,0,38,19,19
2021,133951,41,1,9,6,3
2021,133951,41,2,8,5,3
2021,133951,41,3,11,2,9
2021,133951,41,4,10,6,4
2021,133951,42,0,636,294,342
2021,133951,42,1,25,19,6
2021,133951,42,2,49,17,32
2021,133951,42,3,114,41,73
2021,133951,42,4,415,206,209
2021,133951,42,5,13,3,10
2021,133951,42,6,20,8,12
2021,133951,44,0,38,19,19
2021,133951,44,1,9,6,3
2021,133951,44,2,8,5,3
2021,133951,44,3,11,2,9
2021,133951,44,4,10,6,4
2021,133951,50,0,9,2,7
2021,133960,0,0,23,10,13
2021,133960,10,0,23,10,13
2021,133960,10,1,5,2,3
2021,133960,10,2,8,3,5
2021,133960,10,3,7,4,3
2021,133960,10,4,3,1,2
2021,133960,20,0,4,0,4
2021,133960,20,1,2,0,2
2021,133960,20,2,2,0,2
2021,133960,30,0,19,10,9
2021,133960,30,1,3,2,1
2021,133960,30,2,6,3,3
2021,133960,30,3,7,4,3
2021,133960,30,4,3,1,2
2021,133979,0,0,65,34,31
2021,133979,10,0,65,34,31
2021,133979,10,1,6,3,3
2021,133979,10,2,26,13,13
2021,133979,10,3,23,13,10
2021,133979,10,4,10,5,5
2021,133979,20,0,23,12,11
2021,133979,20,1,6,3,3
2021,133979,20,2,17,9,8
2021,133979,30,0,32,17,15
2021,133979,30,2,9,4,5
2021,133979,30,3,23,13,10
2021,133979,40,0,10,5,5
2021,133979,40,4,10,5,5
2021,133979,42,0,10,5,5
2021,133979,42,4,10,5,5
2021,133997,0,0,7,4,3
2021,133997,50,0,7,4,3
2021,134079,0,0,158,81,77
2021,134079,10,0,158,81,77
2021,134079,10,1,20,14,6
2021,134079,10,2,59,30,29
2021,134079,10,3,60,28,32
2021,134079,10,4,19,9,10
2021,134079,20,0,57,29,28
2021,134079,20,1,14,9,5
2021,134079,20,2,43,20,23
2021,134079,30,0,51,27,24
2021,134079,30,1,1,1,0
2021,134079,30,2,5,3,2
2021,134079,30,3,45,23,22
2021,134079,40,0,50,25,25
2021,134079,40,1,5,4,1
2021,134079,40,2,11,7,4
2021,134079,40,3,15,5,10
2021,134079,40,4,19,9,10
2021,134079,41,0,25,14,11
2021,134079,41,1,5,4,1
2021,134079,41,2,10,7,3
2021,134079,41,3,4,1,3
2021,134079,41,4,6,2,4
2021,134079,42,0,25,11,14
2021,134079,42,2,1,0,1
2021,134079,42,3,11,4,7
2021,134079,42,4,13,7,6
2021,134079,45,0,25,14,11
2021,134079,45,1,5,4,1
2021,134079,45,2,10,7,3
2021,134079,45,3,4,1,3
2021,134079,45,4,6,2,4
2021,134097,0,0,1615,921,694
2021,134097,10,0,1599,911,688
2021,134097,10,1,514,368,146
2021,134097,10,2,377,206,171
2021,134097,10,3,308,159,149
2021,134097,10,6,400,178,222
2021,134097,20,0,851,554,297
2021,134097,20,1,500,360,140
2021,134097,20,2,351,194,157
2021,134097,30,0,292,157,135
2021,134097,30,1,3,3,0
2021,134097,30,2,16,8,8
2021,134097,30,3,273,146,127
2021,134097,40,0,456,200,256
2021,134097,40,1,11,5,6
2021,134097,40,2,10,4,6
2021,134097,40,3,35,13,22
2021,134097,40,6,400,178,222
2021,134097,42,0,456,200,256
2021,134097,42,1,11,5,6
2021,134097,42,2,10,4,6
2021,134097,42,3,35,13,22
2021,134097,42,6,400,178,222
2021,134097,50,0,16,10,6
2021,134130,0,0,2903,1739,1164
2021,134130,10,0,2903,1739,1164
2021,134130,10,1,1051,787,264
2021,134130,10,2,587,358,229
2021,134130,10,3,722,367,355
2021,134130,10,5,453,187,266
2021,134130,10,6,90,40,50
2021,134130,20,0,1503,1064,439
2021,134130,20,1,989,745,244
2021,134130,20,2,512,317,195
2021,134130,20,3,2,2,0
2021,134130,30,0,682,383,299
2021,134130,30,1,26,20,6
2021,134130,30,2,55,31,24
2021,134130,30,3,601,332,269
2021,134130,40,0,718,292,426
2021,134130,40,1,36,22,14
2021,134130,40,2,20,10,10
2021,134130,40,3,119,33,86
2021,134130,40,5,453,187,266
2021,134130,40,6,90,40,50
2021,134130,42,0,718,292,426
2021,134130,42,1,36,22,14
2021,134130,42,2,20,10,10
2021,134130,42,3,119,33,86
2021,134130,42,5,453,187,266
2021,134130,42,6,90,40,50
2021,134237,0,0,745,540,205
2021,134237,10,0,745,540,205
2021,134237,10,1,457,326,131
2021,134237,10,2,130,84,46
2021,134237,10,6,158,130,28
2021,134237,40,0,745,540,205
2021,134237,40,1,457,326,131
2021,134237,40,2,130,84,46
2021,134237,40,6,158,130,28
2021,134237,41,0,745,540,205
2021,134237,41,1,457,326,131
2021,134237,41,2,130,84,46
2021,134237,41,6,158,130,28
2021,134237,45,0,745,540,205
2021,134237,45,1,457,326,131
2021,134237,45,2,130,84,46
2021,134237,45,6,158,130,28
2021,134343,0,0,133,51,82
2021,134343,10,0,133,51,82
2021,134343,10,1,24,11,13
2021,134343,10,2,21,10,11
2021,134343,10,3,25,8,17
2021,134343,10,4,6,1,5
2021,134343,10,6,57,21,36
2021,134343,20,0,36,17,19
2021,134343,20,1,22,11,11
2021,134343,20,2,13,6,7
2021,134343,20,3,1,0,1
2021,134343,30,0,29,7,22
2021,134343,30,1,2,0,2
2021,134343,30,2,8,4,4
2021,134343,30,3,16,3,13
2021,134343,30,4,3,0,3
2021,134343,40,0,68,27,41
2021,134343,40,3,8,5,3
2021,134343,40,4,3,1,2
2021,134343,40,6,57,21,36
2021,134343,43,0,68,27,41
2021,134343,43,3,8,5,3
2021,134343,43,4,3,1,2
2021,134343,43,6,57,21,36
2021,134495,0,0,308,129,179
2021,134495,10,0,306,128,178
2021,134495,10,1,43,18,25
2021,134495,10,2,48,21,27
2021,134495,10,3,105,44,61
2021,134495,10,4,83,36,47
2021,134495,10,6,27,9,18
2021,134495,20,0,222,93,129
2021,134495,20,1,43,18,25
2021,134495,20,2,47,20,27
2021,134495,20,3,105,44,61
2021,134495,20,4,27,11,16
2021,134495,30,0,64,28,36
2021,134495,30,4,50,24,26
2021,134495,30,6,14,4,10
2021,134495,40,0,20,7,13
2021,134495,40,2,1,1,0
2021,134495,40,4,6,1,5
2021,134495,40,6,13,5,8
2021,134495,42,0,7,2,5
2021,134495,42,2,1,1,0
2021,134495,42,4,6,1,5
2021,134495,43,0,13,5,8
2021,134495,43,6,13,5,8
2021,134495,50,0,2,1,1
2021,134510,0,0,8,7,1
2021,134510,10,0,8,7,1
2021,134510,10,4,8,7,1
2021,134510,40,0,8,7,1
2021,134510,40,4,8,7,1
2021,134510,42,0,8,7,1
2021,134510,42,4,8,7,1
2021,134608,0,0,215,99,116
2021,134608,10,0,215,99,116
2021,134608,10,1,46,22,24
2021,134608,10,2,50,25,25
2021,134608,10,3,48,22,26
2021,134608,10,4,71,30,41
2021,134608,20,0,126,62,64
2021,134608,20,1,46,22,24
2021,134608,20,2,48,24,24
2021,134608,20,3,27,14,13
2021,134608,20,4,5,2,3
2021,134608,30,0,62,27,35
2021,134608,30,2,2,1,1
2021,134608,30,3,19,7,12
2021,134608,30,4,41,19,22
2021,134608,40,0,27,10,17
2021,134608,40,3,2,1,1
2021,134608,40,4,25,9,16
2021,134608,43,0,27,10,17
2021,134608,43,3,2,1,1
2021,134608,43,4,25,9,16
2021,134811,0,0,7,5,2
2021,134811,10,0,7,5,2
2021,134811,10,4,7,5,2
2021,134811,40,0,7,5,2
2021,134811,40,4,7,5,2
2021,134811,41,0,7,5,2
2021,134811,41,4,7,5,2
2021,134811,45,0,7,5,2
2021,134811,45,4,7,5,2
2021,134945,0,0,211,87,124
2021,134945,10,0,211,87,124
2021,134945,10,1,55,27,28
2021,134945,10,2,44,24,20
2021,134945,10,3,91,24,67
2021,134945,10,4,21,12,9
2021,134945,20,0,94,46,48
2021,134945,20,1,53,26,27
2021,134945,20,2,37,19,18
2021,134945,20,3,4,1,3
2021,134945,30,0,57,21,36
2021,134945,30,2,5,3,2
2021,134945,30,3,52,18,34
2021,134945,40,0,60,20,40
2021,134945,40,1,2,1,1
2021,134945,40,2,2,2,0
2021,134945,40,3,35,5,30
2021,134945,40,4,21,12,9
2021,134945,42,0,60,20,40
2021,134945,42,1,2,1,1
2021,134945,42,2,2,2,0
2021,134945,42,3,35,5,30
2021,134945,42,4,21,12,9
2021,135081,0,0,1284,443,841
2021,135081,10,0,1284,443,841
2021,135081,10,4,1284,443,841
2021,135081,40,0,1284,443,841
2021,135081,40,4,1284,443,841
2021,135081,41,0,1284,443,841
2021,135081,41,4,1284,443,841
2021,135081,45,0,1284,443,841
2021,135081,45,4,1284,443,841
2021,135160,0,0,73,28,45
2021,135160,10,0,73,28,45
2021,135160,10,6,73,28,45
2021,135160,20,0,23,11,12
2021,135160,20,6,23,11,12
2021,135160,30,0,49,17,32
2021,135160,30,6,49,17,32
2021,135160,40,0,1,0,1
2021,135160,40,6,1,0,1
2021,135160,42,0,1,0,1
2021,135160,42,6,1,0,1
2021,135188,0,0,61,24,37
2021,135188,10,0,61,24,37
2021,135188,10,1,3,0,3
2021,135188,10,2,8,3,5
2021,135188,10,3,26,10,16
2021,135188,10,4,23,11,12
2021,135188,10,5,1,0,1
2021,135188,20,0,42,16,26
2021,135188,20,1,3,0,3
2021,135188,20,2,8,3,5
2021,135188,20,3,26,10,16
2021,135188,20,4,5,3,2
2021,135188,30,0,17,8,9
2021,135188,30,4,17,8,9
2021,135188,40,0,2,0,2
2021,135188,40,4,1,0,1
2021,135188,40,5,1,0,1
2021,135188,43,0,2,0,2
2021,135188,43,4,1,0,1
2021,135188,43,5,1,0,1
2021,135364,0,0,21,20,1
2021,135364,10,0,21,20,1
2021,135364,10,1,4,4,0
2021,135364,10,2,7,6,1
2021,135364,10,3,10,10,0
2021,135364,40,0,21,20,1
2021,135364,40,1,4,4,0
2021,135364,40,2,7,6,1
2021,135364,40,3,10,10,0
2021,135364,42,0,21,20,1
2021,135364,42,1,4,4,0
2021,135364,42,2,7,6,1
2021,135364,42,3,10,10,0
2021,135391,0,0,137,59,78
2021,135391,10,0,137,59,78
2021,135391,10,1,41,24,17
2021,135391,10,2,28,5,23
2021,135391,10,3,29,12,17
2021,135391,10,4,18,11,7
2021,135391,10,5,6,5,1
2021,135391,10,6,15,2,13
2021,135391,20,0,83,36,47
2021,135391,20,1,41,24,17
2021,135391,20,2,25,4,21
2021,135391,20,3,13,8,5
2021,135391,20,4,4,0,4
2021,135391,30,0,33,17,16
2021,135391,30,2,3,1,2
2021,135391,30,3,16,4,12
2021,135391,30,4,13,11,2
2021,135391,30,5,1,1,0
2021,135391,40,0,21,6,15
2021,135391,40,4,1,0,1
2021,135391,40,5,5,4,1
2021,135391,40,6,15,2,13
2021,135391,42,0,21,6,15
2021,135391,42,4,1,0,1
2021,135391,42,5,5,4,1
2021,135391,42,6,15,2,13
2021,135717,0,0,735,353,382
2021,135717,10,0,735,353,382
2021,135717,10,1,183,86,97
2021,135717,10,2,291,144,147
2021,135717,10,3,157,76,81
2021,135717,10,4,104,47,57
2021,135717,20,0,551,265,286
2021,135717,20,1,167,77,90
2021,135717,20,2,267,129,138
2021,135717,20,3,105,52,53
2021,135717,20,4,12,7,5
2021,135717,30,0,184,88,96
2021,135717,30,1,16,9,7
2021,135717,30,2,24,15,9
2021,135717,30,3,52,24,28
2021,135717,30,4,92,40,52
2021,135726,0,0,1453,917,536
2021,135726,10,0,1453,917,536
2021,135726,10,1,607,448,159
2021,135726,10,2,338,217,121
2021,135726,10,3,208,110,98
2021,135726,10,4,1,1,0
2021,135726,10,5,299,141,158
2021,135726,20,0,829,590,239
2021,135726,20,1,576,427,149
2021,135726,20,2,253,163,90
2021,135726,30,0,177,105,72
2021,135726,30,1,8,6,2
2021,135726,30,2,30,23,7
2021,135726,30,3,139,76,63
2021,135726,40,0,447,222,225
2021,135726,40,1,23,15,8
2021,135726,40,2,55,31,24
2021,135726,40,3,69,34,35
2021,135726,40,4,1,1,0
2021,135726,40,5,299,141,158
2021,135726,41,0,86,36,50
2021,135726,41,5,86,36,50
2021,135726,42,0,361,186,175
2021,135726,42,1,23,15,8
2021,135726,42,2,55,31,24
2021,135726,42,3,69,34,35
2021,135726,42,4,1,1,0
2021,135726,42,5,213,105,108
2021,135726,44,0,86,36,50
2021,135726,44,5,86,36,50
2021,136145,0,0,28,12,16
2021,136145,10,0,28,12,16
2021,136145,10,6,28,12,16
2021,136145,20,0,11,8,3
2021,136145,20,6,11,8,3
2021,136145,30,0,7,3,4
2021,136145,30,6,7,3,4
2021,136145,40,0,10,1,9
2021,136145,40,6,10,1,9
2021,136145,43,0,10,1,9
2021,136145,43,6,10,1,9
2021,136172,0,0,537,259,278
2021,136172,10,0,537,259,278
2021,136172,10,1,96,56,40
2021,136172,10,2,157,82,75
2021,136172,10,3,124,50,74
2021,136172,10,4,125,52,73
2021,136172,10,5,34,19,15
2021,136172,10,6,1,0,1
2021,136172,20,0,249,138,111
2021,136172,20,1,96,56,40
2021,136172,20,2,153,82,71
2021,136172,30,0,111,44,67
2021,136172,30,2,2,0,2
2021,136172,30,3,109,44,65
2021,136172,40,0,177,77,100
2021,136172,40,2,2,0,2
2021,136172,40,3,15,6,9
2021,136172,40,4,125,52,73
2021,136172,40,5,34,19,15
2021,136172,40,6,1,0,1
2021,136172,42,0,177,77,100
2021,136172,42,2,2,0,2
2021,136172,42,3,15,6,9
2021,136172,42,4,125,52,73
2021,136172,42,5,34,19,15
2021,136172,42,6,1,0,1
2021,136215,0,0,836,372,464
2021,136215,10,0,836,372,464
2021,136215,10,1,198,106,92
2021,136215,10,2,236,114,122
2021,136215,10,3,357,134,223
2021,136215,10,4,42,18,24
2021,136215,10,5,3,0,3
2021,136215,20,0,28,14,14
2021,136215,20,1,26,12,14
2021,136215,20,2,2,2,0
2021,136215,40,0,808,358,450
2021,136215,40,1,172,94,78
2021,136215,40,2,234,112,122
2021,136215,40,3,357,134,223
2021,136215,40,4,42,18,24
2021,136215,40,5,3,0,3
2021,136215,41,0,396,190,206
2021,136215,41,1,145,82,63
2021,136215,41,2,172,81,91
2021,136215,41,3,79,27,52
2021,136215,42,0,412,168,244
2021,136215,42,1,27,12,15
2021,136215,42,2,62,31,31
2021,136215,42,3,278,107,171
2021,136215,42,4,42,18,24
2021,136215,42,5,3,0,3
2021,136215,44,0,396,190,206
2021,136215,44,1,145,82,63
2021,136215,44,2,172,81,91
2021,136215,44,3,79,27,52
2021,136233,0,0,75,32,43
2021,136233,10,0,75,32,43
2021,136233,10,1,28,16,12
2021,136233,10,3,10,3,7
2021,136233,10,6,37,13,24
2021,136233,20,0,34,18,16
2021,136233,20,1,28,16,12
2021,136233,20,3,5,2,3
2021,136233,20,6,1,0,1
2021,136233,30,0,25,5,20
2021,136233,30,3,3,0,3
2021,136233,30,6,22,5,17
2021,136233,40,0,16,9,7
2021,136233,40,3,2,1,1
2021,136233,40,6,14,8,6
2021,136233,43,0,16,9,7
2021,136233,43,3,2,1,1
2021,136233,43,6,14,8,6
2021,136330,0,0,158,86,72
2021,136330,10,0,158,86,72
2021,136330,10,1,45,36,9
2021,136330,10,2,60,29,31
2021,136330,10,3,44,19,25
2021,136330,10,4,9,2,7
2021,136330,40,0,158,86,72
2021,136330,40,1,45,36,9
2021,136330,40,2,60,29,31
2021,136330,40,3,44,19,25
2021,136330,40,4,9,2,7
2021,136330,42,0,158,86,72
2021,136330,42,1,45,36,9
2021,136330,42,2,60,29,31
2021,136330,42,3,44,19,25
2021,136330,42,4,9,2,7
2021,136358,0,0,312,135,177
2021,136358,10,0,312,135,177
2021,136358,10,1,59,23,36
2021,136358,10,2,36,17,19
2021,136358,10,3,77,37,40
2021,136358,10,4,140,58,82
2021,136358,20,0,142,55,87
2021,136358,20,1,46,20,26
2021,136358,20,2,13,4,9
2021,136358,20,3,30,15,15
2021,136358,20,4,53,16,37
2021,136358,30,0,142,64,78
2021,136358,30,1,13,3,10
2021,136358,30,2,23,13,10
2021,136358,30,3,46,21,25
2021,136358,30,4,60,27,33
2021,136358,40,0,28,16,12
2021,136358,40,3,1,1,0
2021,136358,40,4,27,15,12
2021,136358,42,0,27,16,11
2021,136358,42,3,1,1,0
2021,136358,42,4,26,15,11
2021,136358,43,0,1,0,1
2021,136358,43,4,1,0,1
2021,136400,0,0,139,55,84
2021,136400,10,0,136,52,84
2021,136400,10,1,30,11,19
2021,136400,10,2,25,11,14
2021,136400,10,3,39,14,25
2021,136400,10,4,42,16,26
2021,136400,20,0,88,29,59
2021,136400,20,1,27,10,17
2021,136400,20,2,23,9,14
2021,136400,20,3,27,9,18
2021,136400,20,4,11,1,10
2021,136400,30,0,48,23,25
2021,136400,30,1,3,1,2
2021,136400,30,2,2,2,0
2021,136400,30,3,12,5,7
2021,136400,30,4,31,15,16
2021,136400,50,0,3,3,0
2021,136473,0,0,154,67,87
2021,136473,10,0,154,67,87
2021,136473,10,1,38,19,19
2021,136473,10,2,23,8,15
2021,136473,10,3,31,15,16
2021,136473,10,4,45,21,24
2021,136473,10,5,14,4,10
2021,136473,10,6,3,0,3
2021,136473,20,0,86,39,47
2021,136473,20,1,38,19,19
2021,136473,20,2,22,7,15
2021,136473,20,3,20,8,12
2021,136473,20,4,6,5,1
2021,136473,30,0,54,24,30
2021,136473,30,2,1,1,0
2021,136473,30,3,11,7,4
2021,136473,30,4,39,16,23
2021,136473,30,6,3,0,3
2021,136473,40,0,14,4,10
2021,136473,40,5,14,4,10
2021,136473,42,0,14,4,10
2021,136473,42,5,14,4,10
2021,136516,0,0,143,63,80
2021,136516,10,0,143,63,80
2021,136516,10,6,143,63,80
2021,136516,20,0,110,53,57
2021,136516,20,6,110,53,57
2021,136516,30,0,28,10,18
2021,136516,30,6,28,10,18
2021,136516,40,0,5,0,5
2021,136516,40,6,5,0,5
2021,136516,42,0,5,0,5
2021,136516,42,6,5,0,5
2021,136701,0,0,15,12,3
2021,136701,10,0,15,12,3
2021,136701,10,1,6,5,1
2021,136701,10,2,3,2,1
2021,136701,10,3,6,5,1
2021,136701,40,0,15,12,3
2021,136701,40,1,6,5,1
2021,136701,40,2,3,2,1
2021,136701,40,3,6,5,1
2021,136701,42,0,15,12,3
2021,136701,42,1,6,5,1
2021,136701,42,2,3,2,1
2021,136701,42,3,6,5,1
2021,136774,0,0,118,80,38
2021,136774,10,0,118,80,38
2021,136774,10,6,118,80,38
2021,136774,40,0,118,80,38
2021,136774,40,6,118,80,38
2021,136774,42,0,118,80,38
2021,136774,42,6,118,80,38
2021,136950,0,0,220,106,114
2021,136950,10,0,220,106,114
2021,136950,10,1,73,39,34
2021,136950,10,2,61,34,27
2021,136950,10,3,59,19,40
2021,136950,10,4,1,1,0
2021,136950,10,5,26,13,13
2021,136950,20,0,123,68,55
2021,136950,20,1,72,38,34
2021,136950,20,2,51,30,21
2021,136950,30,0,48,17,31
2021,136950,30,2,8,3,5
2021,136950,30,3,40,14,26
2021,136950,40,0,49,21,28
2021,136950,40,1,1,1,0
2021,136950,40,2,2,1,1
2021,136950,40,3,19,5,14
2021,136950,40,4,1,1,0
2021,136950,40,5,26,13,13
2021,136950,41,0,35,15,20
2021,136950,41,1,1,1,0
2021,136950,41,2,1,0,1
2021,136950,41,3,7,1,6
2021,136950,41,5,26,13,13
2021,136950,42,0,13,5,8
2021,136950,42,2,1,1,0
2021,136950,42,3,11,3,8
2021,136950,42,4,1,1,0
2021,136950,43,0,1,1,0
2021,136950,43,3,1,1,0
2021,136950,44,0,9,2,7
2021,136950,44,1,1,1,0
2021,136950,44,2,1,0,1
2021,136950,44,3,7,1,6
2021,136950,45,0,26,13,13
2021,136950,45,5,26,13,13
2021,137032,0,0,118,62,56
2021,137032,10,0,118,62,56
2021,137032,10,1,19,11,8
2021,137032,10,2,46,29,17
2021,137032,10,3,36,16,20
2021,137032,10,4,17,6,11
2021,137032,20,0,72,42,30
2021,137032,20,1,18,10,8
2021,137032,20,2,40,26,14
2021,137032,20,3,14,6,8
2021,137032,30,0,17,5,12
2021,137032,30,2,4,1,3
2021,137032,30,3,13,4,9
2021,137032,40,0,29,15,14
2021,137032,40,1,1,1,0
2021,137032,40,2,2,2,0
2021,137032,40,3,9,6,3
2021,137032,40,4,17,6,11
2021,137032,42,0,29,15,14
2021,137032,42,1,1,1,0
2021,137032,42,2,2,2,0
2021,137032,42,3,9,6,3
2021,137032,42,4,17,6,11
2021,137078,0,0,320,127,193
2021,137078,10,0,320,127,193
2021,137078,10,6,320,127,193
2021,137078,20,0,244,113,131
2021,137078,20,6,244,113,131
2021,137078,30,0,66,14,52
2021,137078,30,6,66,14,52
2021,137078,40,0,10,0,10
2021,137078,40,6,10,0,10
2021,137078,43,0,10,0,10
2021,137078,43,6,10,0,10
2021,137096,0,0,258,113,145
2021,137096,10,0,258,113,145
2021,137096,10,6,258,113,145
2021,137096,20,0,160,68,92
2021,137096,20,6,160,68,92
2021,137096,30,0,98,45,53
2021,137096,30,6,98,45,53
2021,137209,0,0,199,77,122
2021,137209,10,0,199,77,122
2021,137209,10,6,199,77,122
2021,137209,20,0,141,51,90
2021,137209,20,6,141,51,90
2021,137209,30,0,58,26,32
2021,137209,30,6,58,26,32
2021,137272,0,0,10,4,6
2021,137272,10,0,8,4,4
2021,137272,10,1,6,4,2
2021,137272,10,4,2,0,2
2021,137272,40,0,8,4,4
2021,137272,40,1,6,4,2
2021,137272,40,4,2,0,2
2021,137272,42,0,8,4,4
2021,137272,42,1,6,4,2
2021,137272,42,4,2,0,2
2021,137272,50,0,2,0,2
2021,137281,0,0,138,69,69
2021,137281,10,0,122,63,59
2021,137281,10,1,26,14,12
2021,137281,10,4,93,47,46
2021,137281,10,6,3,2,1
2021,137281,20,0,57,35,22
2021,137281,20,1,22,12,10
2021,137281,20,4,34,22,12
2021,137281,20,6,1,1,0
2021,137281,30,0,65,28,37
2021,137281,30,1,4,2,2
2021,137281,30,4,59,25,34
2021,137281,30,6,2,1,1
2021,137281,50,0,16,6,10
2021,137315,0,0,67,21,46
2021,137315,10,0,67,21,46
2021,137315,10,4,67,21,46
2021,137315,20,0,36,13,23
2021,137315,20,4,36,13,23
2021,137315,30,0,28,5,23
2021,137315,30,4,28,5,23
2021,137315,40,0,3,3,0
2021,137315,40,4,3,3,0
2021,137315,42,0,3,3,0
2021,137315,42,4,3,3,0
2021,137351,0,0,1993,1058,935
2021,137351,10,0,1993,1058,935
2021,137351,10,1,487,336,151
2021,137351,10,2,543,295,248
2021,137351,10,3,494,234,260
2021,137351,10,4,438,179,259
2021,137351,10,6,31,14,17
2021,137351,20,0,813,515,298
2021,137351,20,1,426,295,131
2021,137351,20,2,387,220,167
2021,137351,30,0,190,97,93
2021,137351,30,1,8,7,1
2021,137351,30,2,21,7,14
2021,137351,30,3,161,83,78
2021,137351,40,0,990,446,544
2021,137351,40,1,53,34,19
2021,137351,40,2,135,68,67
2021,137351,40,3,333,151,182
2021,137351,40,4,438,179,259
2021,137351,40,6,31,14,17
2021,137351,42,0,966,434,532
2021,137351,42,1,53,34,19
2021,137351,42,2,135,68,67
2021,137351,42,3,333,151,182
2021,137351,42,4,438,179,259
2021,137351,42,6,7,2,5
2021,137351,43,0,24,12,12
2021,137351,43,6,24,12,12
2021,137476,0,0,91,49,42
2021,137476,10,0,91,49,42
2021,137476,10,1,33,23,10
2021,137476,10,2,15,7,8
2021,137476,10,3,25,13,12
2021,137476,10,4,13,4,9
2021,137476,10,5,4,1,3
2021,137476,10,6,1,1,0
2021,137476,20,0,15,11,4
2021,137476,20,1,15,11,4
2021,137476,30,0,5,4,1
2021,137476,30,1,1,0,1
2021,137476,30,3,4,4,0
2021,137476,40,0,71,34,37
2021,137476,40,1,17,12,5
2021,137476,40,2,15,7,8
2021,137476,40,3,21,9,12
2021,137476,40,4,13,4,9
2021,137476,40,5,4,1,3
2021,137476,40,6,1,1,0
2021,137476,42,0,71,34,37
2021,137476,42,1,17,12,5
2021,137476,42,2,15,7,8
2021,137476,42,3,21,9,12
2021,137476,42,4,13,4,9
2021,137476,42,5,4,1,3
2021,137476,42,6,1,1,0
2021,137546,0,0,267,134,133
2021,137546,10,0,267,134,133
2021,137546,10,1,101,58,43
2021,137546,10,2,68,36,32
2021,137546,10,3,93,38,55
2021,137546,10,4,1,0,1
2021,137546,10,5,3,1,2
2021,137546,10,6,1,1,0
2021,137546,20,0,164,91,73
2021,137546,20,1,99,56,43
2021,137546,20,2,65,35,30
2021,137546,30,0,53,22,31
2021,137546,30,2,3,1,2
2021,137546,30,3,50,21,29
2021,137546,40,0,50,21,29
2021,137546,40,1,2,2,0
2021,137546,40,3,43,17,26
2021,137546,40,4,1,0,1
2021,137546,40,5,3,1,2
2021,137546,40,6,1,1,0
2021,137546,41,0,11,5,6
2021,137546,41,1,2,2,0
2021,137546,41,3,9,3,6
2021,137546,42,0,39,16,23
2021,137546,42,3,34,14,20
2021,137546,42,4,1,0,1
2021,137546,42,5,3,1,2
2021,137546,42,6,1,1,0
2021,137546,44,0,11,5,6
2021,137546,44,1,2,2,0
2021,137546,44,3,9,3,6
2021,137564,0,0,121,63,58
2021,137564,10,0,121,63,58
2021,137564,10,1,38,27,11
2021,137564,10,2,45,20,25
2021,137564,10,3,30,14,16
2021,137564,10,4,3,2,1
2021,137564,10,5,5,0,5
2021,137564,40,0,121,63,58
2021,137564,40,1,38,27,11
2021,137564,40,2,45,20,25
2021,137564,40,3,30,14,16
2021,137564,40,4,3,2,1
2021,137564,40,5,5,0,5
2021,137564,42,0,121,63,58
2021,137564,42,1,38,27,11
2021,137564,42,2,45,20,25
2021,137564,42,3,30,14,16
2021,137564,42,4,3,2,1
2021,137564,42,5,5,0,5
2021,137759,0,0,206,75,131
2021,137759,10,0,163,63,100
2021,137759,10,1,74,30,44
2021,137759,10,2,42,17,25
2021,137759,10,3,43,15,28
2021,137759,10,6,4,1,3
2021,137759,20,0,117,47,70
2021,137759,20,1,74,30,44
2021,137759,20,2,39,15,24
2021,137759,20,3,4,2,2
2021,137759,30,0,7,2,5
2021,137759,30,2,1,1,0
2021,137759,30,3,6,1,5
2021,137759,40,0,39,14,25
2021,137759,40,2,2,1,1
2021,137759,40,3,33,12,21
2021,137759,40,6,4,1,3
2021,137759,42,0,39,14,25
2021,137759,42,2,2,1,1
2021,137759,42,3,33,12,21
2021,137759,42,6,4,1,3
2021,137759,50,0,43,12,31
2021,137777,0,0,9,9,0
2021,137777,10,0,7,7,0
2021,137777,10,1,7,7,0
2021,137777,40,0,7,7,0
2021,137777,40,1,7,7,0
2021,137777,41,0,7,7,0
2021,137777,41,1,7,7,0
2021,137777,45,0,7,7,0
2021,137777,45,1,7,7,0
2021,137777,50,0,2,2,0
2021,137801,0,0,11,6,5
2021,137801,50,0,11,6,5
2021,137847,0,0,442,235,207
2021,137847,10,0,425,225,200
2021,137847,10,1,49,32,17
2021,137847,10,2,140,86,54
2021,137847,10,3,204,95,109
2021,137847,10,5,32,12,20
2021,137847,20,0,128,81,47
2021,137847,20,1,42,28,14
2021,137847,20,2,84,52,32
2021,137847,20,3,2,1,1
2021,137847,30,0,147,77,70
2021,137847,30,1,6,3,3
2021,137847,30,2,44,30,14
2021,137847,30,3,97,44,53
2021,137847,40,0,150,67,83
2021,137847,40,1,1,1,0
2021,137847,40,2,12,4,8
2021,137847,40,3,105,50,55
2021,137847,40,5,32,12,20
2021,137847,42,0,150,67,83
2021,137847,42,1,1,1,0
2021,137847,42,2,12,4,8
2021,137847,42,3,105,50,55
2021,137847,42,5,32,12,20
2021,137847,50,0,17,10,7
2021,137953,0,0,11,8,3
2021,137953,10,0,11,8,3
2021,137953,10,1,6,5,1
2021,137953,10,2,5,3,2
2021,137953,40,0,11,8,3
2021,137953,40,1,6,5,1
2021,137953,40,2,5,3,2
2021,137953,42,0,11,8,3
2021,137953,42,1,6,5,1
2021,137953,42,2,5,3,2
2021,137962,0,0,8,4,4
2021,137962,10,0,8,4,4
2021,137962,10,1,2,2,0
2021,137962,10,2,2,1,1
2021,137962,10,3,4,1,3
2021,137962,40,0,8,4,4
2021,137962,40,1,2,2,0
2021,137962,40,2,2,1,1
2021,137962,40,3,4,1,3
2021,137962,42,0,8,4,4
2021,137962,42,1,2,2,0
2021,137962,42,2,2,1,1
2021,137962,42,3,4,1,3
2021,138187,0,0,858,367,491
2021,138187,10,0,858,367,491
2021,138187,10,6,858,367,491
2021,138187,20,0,348,153,195
2021,138187,20,6,348,153,195
2021,138187,30,0,90,29,61
2021,138187,30,6,90,29,61
2021,138187,40,0,420,185,235
2021,138187,40,6,420,185,235
2021,138187,42,0,102,49,53
2021,138187,42,6,102,49,53
2021,138187,43,0,318,136,182
2021,138187,43,6,318,136,182
2021,138275,0,0,35,22,13
2021,138275,10,0,35,22,13
2021,138275,10,1,6,4,2
2021,138275,10,2,12,6,6
2021,138275,10,3,13,11,2
2021,138275,10,4,4,1,3
2021,138275,40,0,35,22,13
2021,138275,40,1,6,4,2
2021,138275,40,2,12,6,6
2021,138275,40,3,13,11,2
2021,138275,40,4,4,1,3
2021,138275,42,0,35,22,13
2021,138275,42,1,6,4,2
2021,138275,42,2,12,6,6
2021,138275,42,3,13,11,2
2021,138275,42,4,4,1,3
2021,138293,0,0,28,15,13
2021,138293,10,0,28,15,13
2021,138293,10,1,4,4,0
2021,138293,10,2,6,3,3
2021,138293,10,3,18,8,10
2021,138293,40,0,28,15,13
2021,138293,40,1,4,4,0
2021,138293,40,2,6,3,3
2021,138293,40,3,18,8,10
2021,138293,42,0,28,15,13
2021,138293,42,1,4,4,0
2021,138293,42,2,6,3,3
2021,138293,42,3,18,8,10
2021,138309,0,0,146,22,124
2021,138309,10,0,146,22,124
2021,138309,10,4,146,22,124
2021,138309,40,0,146,22,124
2021,138309,40,4,146,22,124
2021,138309,41,0,146,22,124
2021,138309,41,4,146,22,124
2021,138309,45,0,146,22,124
2021,138309,45,4,146,22,124
2021,138354,0,0,327,174,153
2021,138354,10,0,327,174,153
2021,138354,10,1,82,56,26
2021,138354,10,2,72,41,31
2021,138354,10,3,97,46,51
2021,138354,10,4,46,17,29
2021,138354,10,5,30,14,16
2021,138354,20,0,155,96,59
2021,138354,20,1,81,55,26
2021,138354,20,2,69,39,30
2021,138354,20,3,5,2,3
2021,138354,30,0,63,38,25
2021,138354,30,2,2,2,0
2021,138354,30,3,61,36,25
2021,138354,40,0,109,40,69
2021,138354,40,1,1,1,0
2021,138354,40,2,1,0,1
2021,138354,40,3,31,8,23
2021,138354,40,4,46,17,29
2021,138354,40,5,30,14,16
2021,138354,41,0,43,15,28
2021,138354,41,1,1,1,0
2021,138354,41,2,1,0,1
2021,138354,41,3,1,1,0
2021,138354,41,4,25,6,19
2021,138354,41,5,15,7,8
2021,138354,42,0,18,4,14
2021,138354,42,3,11,3,8
2021,138354,42,4,4,1,3
2021,138354,42,5,3,0,3
2021,138354,43,0,48,21,27
2021,138354,43,3,19,4,15
2021,138354,43,4,17,10,7
2021,138354,43,5,12,7,5
2021,138354,44,0,43,15,28
2021,138354,44,1,1,1,0
2021,138354,44,2,1,0,1
2021,138354,44,3,1,1,0
2021,138354,44,4,25,6,19
2021,138354,44,5,15,7,8
2021,138558,0,0,139,70,69
2021,138558,10,0,139,70,69
2021,138558,10,1,29,18,11
2021,138558,10,2,37,17,20
2021,138558,10,3,54,27,27
2021,138558,10,4,5,2,3
2021,138558,10,5,14,6,8
2021,138558,20,0,75,38,37
2021,138558,20,1,27,17,10
2021,138558,20,2,33,14,19
2021,138558,20,3,15,7,8
2021,138558,30,0,44,23,21
2021,138558,30,1,2,1,1
2021,138558,30,2,4,3,1
2021,138558,30,3,38,19,19
2021,138558,40,0,20,9,11
2021,138558,40,3,1,1,0
2021,138558,40,4,5,2,3
2021,138558,40,5,14,6,8
2021,138558,42,0,20,9,11
2021,138558,42,3,1,1,0
2021,138558,42,4,5,2,3
2021,138558,42,5,14,6,8
2021,138600,0,0,80,25,55
2021,138600,10,0,80,25,55
2021,138600,10,1,38,16,22
2021,138600,10,2,23,5,18
2021,138600,10,3,7,0,7
2021,138600,10,4,11,4,7
2021,138600,10,6,1,0,1
2021,138600,20,0,60,21,39
2021,138600,20,1,38,16,22
2021,138600,20,2,22,5,17
2021,138600,30,0,8,0,8
2021,138600,30,2,1,0,1
2021,138600,30,3,7,0,7
2021,138600,40,0,12,4,8
2021,138600,40,4,11,4,7
2021,138600,40,6,1,0,1
2021,138600,42,0,12,4,8
2021,138600,42,4,11,4,7
2021,138600,42,6,1,0,1
2021,138655,0,0,4,2,2
2021,138655,10,0,4,2,2
2021,138655,10,4,4,2,2
2021,138655,40,0,4,2,2
2021,138655,40,4,4,2,2
2021,138655,41,0,4,2,2
2021,138655,41,4,4,2,2
2021,138655,45,0,4,2,2
2021,138655,45,4,4,2,2
2021,138682,0,0,80,27,53
2021,138682,10,0,75,24,51
2021,138682,10,4,75,24,51
2021,138682,40,0,75,24,51
2021,138682,40,4,75,24,51
2021,138682,42,0,64,16,48
2021,138682,42,4,64,16,48
2021,138682,43,0,11,8,3
2021,138682,43,4,11,8,3
2021,138682,50,0,5,3,2
2021,138716,0,0,205,91,114
2021,138716,10,0,204,90,114
2021,138716,10,1,42,28,14
2021,138716,10,2,50,24,26
2021,138716,10,3,62,24,38
2021,138716,10,4,39,8,31
2021,138716,10,5,11,6,5
2021,138716,20,0,90,53,37
2021,138716,20,1,42,28,14
2021,138716,20,2,45,22,23
2021,138716,20,3,3,3,0
2021,138716,30,0,36,16,20
2021,138716,30,2,4,1,3
2021,138716,30,3,32,15,17
2021,138716,40,0,78,21,57
2021,138716,40,2,1,1,0
2021,138716,40,3,27,6,21
2021,138716,40,4,39,8,31
2021,138716,40,5,11,6,5
2021,138716,41,0,1,0,1
2021,138716,41,4,1,0,1
2021,138716,42,0,77,21,56
2021,138716,42,2,1,1,0
2021,138716,42,3,27,6,21
2021,138716,42,4,38,8,30
2021,138716,42,5,11,6,5
2021,138716,45,0,1,0,1
2021,138716,45,4,1,0,1
2021,138716,50,0,1,1,0
2021,138761,0,0,28,12,16
2021,138761,10,0,28,12,16
2021,138761,10,1,1,0,1
2021,138761,10,2,7,4,3
2021,138761,10,3,18,8,10
2021,138761,10,4,2,0,2
2021,138761,20,0,7,2,5
2021,138761,20,1,1,0,1
2021,138761,20,2,5,2,3
2021,138761,20,3,1,0,1
2021,138761,30,0,10,5,5
2021,138761,30,2,2,2,0
2021,138761,30,3,8,3,5
2021,138761,40,0,11,5,6
2021,138761,40,3,9,5,4
2021,138761,40,4,2,0,2
2021,138761,42,0,4,1,3
2021,138761,42,3,2,1,1
2021,138761,42,4,2,0,2
2021,138761,43,0,7,4,3
2021,138761,43,3,7,4,3
2021,138813,0,0,5,3,2
2021,138813,10,0,5,3,2
2021,138813,10,4,5,3,2
2021,138813,40,0,5,3,2
2021,138813,40,4,5,3,2
2021,138813,41,0,5,3,2
2021,138813,41,4,5,3,2
2021,138813,45,0,5,3,2
2021,138813,45,4,5,3,2
2021,138840,0,0,96,41,55
2021,138840,10,0,96,41,55
2021,138840,10,4,96,41,55
2021,138840,40,0,96,41,55
2021,138840,40,4,96,41,55
2021,138840,41,0,96,41,55
2021,138840,41,4,96,41,55
2021,138840,45,0,96,41,55
2021,138840,45,4,96,41,55
2021,138868,0,0,42,19,23
2021,138868,10,0,42,19,23
2021,138868,10,1,16,10,6
2021,138868,10,2,6,1,5
2021,138868,10,3,9,4,5
2021,138868,10,4,11,4,7
2021,138868,40,0,42,19,23
2021,138868,40,1,16,10,6
2021,138868,40,2,6,1,5
2021,138868,40,3,9,4,5
2021,138868,40,4,11,4,7
2021,138868,42,0,42,19,23
2021,138868,42,1,16,10,6
2021,138868,42,2,6,1,5
2021,138868,42,3,9,4,5
2021,138868,42,4,11,4,7
2021,138901,0,0,38,22,16
2021,138901,10,0,38,22,16
2021,138901,10,1,3,2,1
2021,138901,10,2,12,7,5
2021,138901,10,3,5,3,2
2021,138901,10,4,13,6,7
2021,138901,10,5,1,1,0
2021,138901,10,6,4,3,1
2021,138901,20,0,14,7,7
2021,138901,20,1,3,2,1
2021,138901,20,2,10,5,5
2021,138901,20,3,1,0,1
2021,138901,30,0,4,4,0
2021,138901,30,2,2,2,0
2021,138901,30,3,2,2,0
2021,138901,40,0,20,11,9
2021,138901,40,3,2,1,1
2021,138901,40,4,13,6,7
2021,138901,40,5,1,1,0
2021,138901,40,6,4,3,1
2021,138901,42,0,20,11,9
2021,138901,42,3,2,1,1
2021,138901,42,4,13,6,7
2021,138901,42,5,1,1,0
2021,138901,42,6,4,3,1
2021,138929,0,0,19,9,10
2021,138929,10,0,15,8,7
2021,138929,10,1,6,5,1
2021,138929,10,2,9,3,6
2021,138929,20,0,14,7,7
2021,138929,20,1,6,5,1
2021,138929,20,2,8,2,6
2021,138929,40,0,1,1,0
2021,138929,40,2,1,1,0
2021,138929,42,0,1,1,0
2021,138929,42,2,1,1,0
2021,138929,50,0,4,1,3
2021,138947,0,0,186,100,86
2021,138947,10,0,186,100,86
2021,138947,10,1,42,35,7
2021,138947,10,2,70,36,34
2021,138947,10,3,38,13,25
2021,138947,10,4,27,12,15
2021,138947,10,5,9,4,5
2021,138947,20,0,106,68,38
2021,138947,20,1,42,35,7
2021,138947,20,2,60,31,29
2021,138947,20,3,4,2,2
2021,138947,30,0,30,11,19
2021,138947,30,2,7,3,4
2021,138947,30,3,21,7,14
2021,138947,30,5,2,1,1
2021,138947,40,0,50,21,29
2021,138947,40,2,3,2,1
2021,138947,40,3,13,4,9
2021,138947,40,4,27,12,15
2021,138947,40,5,7,3,4
2021,138947,42,0,8,5,3
2021,138947,42,3,2,1,1
2021,138947,42,4,5,3,2
2021,138947,42,5,1,1,0
2021,138947,43,0,42,16,26
2021,138947,43,2,3,2,1
2021,138947,43,3,11,3,8
2021,138947,43,4,22,9,13
2021,138947,43,5,6,2,4
2021,138956,0,0,127,58,69
2021,138956,10,0,127,58,69
2021,138956,10,6,127,58,69
2021,138956,40,0,127,58,69
2021,138956,40,6,127,58,69
2021,138956,42,0,127,58,69
2021,138956,42,6,127,58,69
2021,139144,0,0,167,94,73
2021,139144,10,0,167,94,73
2021,139144,10,1,40,29,11
2021,139144,10,2,49,27,22
2021,139144,10,3,59,31,28
2021,139144,10,4,6,3,3
2021,139144,10,5,13,4,9
2021,139144,20,0,85,54,31
2021,139144,20,1,39,28,11
2021,139144,20,2,45,25,20
2021,139144,20,3,1,1,0
2021,139144,30,0,35,17,18
2021,139144,30,1,1,1,0
2021,139144,30,2,2,1,1
2021,139144,30,3,32,15,17
2021,139144,40,0,47,23,24
2021,139144,40,2,2,1,1
2021,139144,40,3,26,15,11
2021,139144,40,4,6,3,3
2021,139144,40,5,13,4,9
2021,139144,43,0,47,23,24
2021,139144,43,2,2,1,1
2021,139144,43,3,26,15,11
2021,139144,43,4,6,3,3
2021,139144,43,5,13,4,9
2021,139153,0,0,8,5,3
2021,139153,10,0,8,5,3
2021,139153,10,2,1,1,0
2021,139153,10,3,7,4,3
2021,139153,40,0,8,5,3
2021,139153,40,2,1,1,0
2021,139153,40,3,7,4,3
2021,139153,41,0,8,5,3
2021,139153,41,2,1,1,0
2021,139153,41,3,7,4,3
2021,139153,45,0,8,5,3
2021,139153,45,2,1,1,0
2021,139153,45,3,7,4,3
2021,139199,0,0,163,42,121
2021,139199,10,0,163,42,121
2021,139199,10,1,18,6,12
2021,139199,10,2,60,21,39
2021,139199,10,3,78,14,64
2021,139199,10,4,7,1,6
2021,139199,40,0,163,42,121
2021,139199,40,1,18,6,12
2021,139199,40,2,60,21,39
2021,139199,40,3,78,14,64
2021,139199,40,4,7,1,6
2021,139199,41,0,82,24,58
2021,139199,41,1,16,5,11
2021,139199,41,2,44,16,28
2021,139199,41,3,21,3,18
2021,139199,41,4,1,0,1
2021,139199,42,0,68,15,53
2021,139199,42,2,14,5,9
2021,139199,42,3,53,10,43
2021,139199,42,4,1,0,1
2021,139199,43,0,13,3,10
2021,139199,43,1,2,1,1
2021,139199,43,2,2,0,2
2021,139199,43,3,4,1,3
2021,139199,43,4,5,1,4
2021,139199,44,0,82,24,58
2021,139199,44,1,16,5,11
2021,139199,44,2,44,16,28
2021,139199,44,3,21,3,18
2021,139199,44,4,1,0,1
2021,139205,0,0,25,16,9
2021,139205,10,0,25,16,9
2021,139205,10,1,2,1,1
2021,139205,10,2,7,3,4
2021,139205,10,3,16,12,4
2021,139205,40,0,25,16,9
2021,139205,40,1,2,1,1
2021,139205,40,2,7,3,4
2021,139205,40,3,16,12,4
2021,139205,41,0,2,1,1
2021,139205,41,1,1,1,0
2021,139205,41,3,1,0,1
2021,139205,42,0,23,15,8
2021,139205,42,1,1,0,1
2021,139205,42,2,7,3,4
2021,139205,42,3,15,12,3
2021,139205,44,0,2,1,1
2021,139205,44,1,1,1,0
2021,139205,44,3,1,0,1
2021,139250,0,0,99,44,55
2021,139250,10,0,99,44,55
2021,139250,10,1,14,5,9
2021,139250,10,2,23,14,9
2021,139250,10,3,39,15,24
2021,139250,10,4,6,4,2
2021,139250,10,5,16,5,11
2021,139250,10,6,1,1,0
2021,139250,20,0,31,15,16
2021,139250,20,1,12,4,8
2021,139250,20,2,19,11,8
2021,139250,30,0,37,14,23
2021,139250,30,2,2,2,0
2021,139250,30,3,35,12,23
2021,139250,40,0,31,15,16
2021,139250,40,1,2,1,1
2021,139250,40,2,2,1,1
2021,139250,40,3,4,3,1
2021,139250,40,4,6,4,2
2021,139250,40,5,16,5,11
2021,139250,40,6,1,1,0
2021,139250,42,0,31,15,16
2021,139250,42,1,2,1,1
2021,139250,42,2,2,1,1
2021,139250,42,3,4,3,1
2021,139250,42,4,6,4,2
2021,139250,42,5,16,5,11
2021,139250,42,6,1,1,0
2021,139278,0,0,128,47,81
2021,139278,10,0,128,47,81
2021,139278,10,4,128,47,81
2021,139278,40,0,128,47,81
2021,139278,40,4,128,47,81
2021,139278,42,0,116,45,71
2021,139278,42,4,116,45,71
2021,139278,43,0,12,2,10
2021,139278,43,4,12,2,10
2021,139311,0,0,206,91,115
2021,139311,10,0,206,91,115
2021,139311,10,1,66,34,32
2021,139311,10,2,51,25,26
2021,139311,10,3,38,15,23
2021,139311,10,4,10,0,10
2021,139311,10,5,41,17,24
2021,139311,20,0,111,59,52
2021,139311,20,1,65,34,31
2021,139311,20,2,46,25,21
2021,139311,30,0,40,14,26
2021,139311,30,1,1,0,1
2021,139311,30,2,5,0,5
2021,139311,30,3,34,14,20
2021,139311,40,0,55,18,37
2021,139311,40,3,4,1,3
2021,139311,40,4,10,0,10
2021,139311,40,5,41,17,24
2021,139311,42,0,55,18,37
2021,139311,42,3,4,1,3
2021,139311,42,4,10,0,10
2021,139311,42,5,41,17,24
2021,139348,0,0,21,10,11
2021,139348,10,0,21,10,11
2021,139348,10,1,9,3,6
2021,139348,10,2,10,6,4
2021,139348,10,3,1,0,1
2021,139348,10,5,1,1,0
2021,139348,20,0,19,9,10
2021,139348,20,1,9,3,6
2021,139348,20,2,10,6,4
2021,139348,30,0,1,0,1
2021,139348,30,3,1,0,1
2021,139348,40,0,1,1,0
2021,139348,40,5,1,1,0
2021,139348,41,0,1,1,0
2021,139348,41,5,1,1,0
2021,139348,44,0,1,1,0
2021,139348,44,5,1,1,0
2021,139357,0,0,109,34,75
2021,139357,10,0,109,34,75
2021,139357,10,4,109,34,75
2021,139357,40,0,109,34,75
2021,139357,40,4,109,34,75
2021,139357,41,0,109,34,75
2021,139357,41,4,109,34,75
2021,139357,45,0,109,34,75
2021,139357,45,4,109,34,75
2021,139366,0,0,328,168,160
2021,139366,10,0,328,168,160
2021,139366,10,1,101,63,38
2021,139366,10,2,81,43,38
2021,139366,10,3,75,35,40
2021,139366,10,4,26,7,19
2021,139366,10,5,45,20,25
2021,139366,20,0,180,106,74
2021,139366,20,1,100,62,38
2021,139366,20,2,78,43,35
2021,139366,20,3,2,1,1
2021,139366,30,0,77,37,40
2021,139366,30,1,1,1,0
2021,139366,30,2,2,0,2
2021,139366,30,3,68,33,35
2021,139366,30,4,3,1,2
2021,139366,30,5,3,2,1
2021,139366,40,0,71,25,46
2021,139366,40,2,1,0,1
2021,139366,40,3,5,1,4
2021,139366,40,4,23,6,17
2021,139366,40,5,42,18,24
2021,139366,41,0,1,1,0
2021,139366,41,5,1,1,0
2021,139366,42,0,70,24,46
2021,139366,42,2,1,0,1
2021,139366,42,3,5,1,4
2021,139366,42,4,23,6,17
2021,139366,42,5,41,17,24
2021,139366,45,0,1,1,0
2021,139366,45,5,1,1,0
2021,139384,0,0,117,53,64
2021,139384,50,0,117,53,64
2021,139393,0,0,59,42,17
2021,139393,10,0,59,42,17
2021,139393,10,1,32,28,4
2021,139393,10,2,15,6,9
2021,139393,10,3,10,7,3
2021,139393,10,6,2,1,1
2021,139393,20,0,36,28,8
2021,139393,20,1,28,24,4
2021,139393,20,2,8,4,4
2021,139393,30,0,22,13,9
2021,139393,30,1,4,4,0
2021,139393,30,2,7,2,5
2021,139393,30,3,10,7,3
2021,139393,30,6,1,0,1
2021,139393,40,0,1,1,0
2021,139393,40,6,1,1,0
2021,139393,42,0,1,1,0
2021,139393,42,6,1,1,0
2021,139463,0,0,156,68,88
2021,139463,10,0,155,68,87
2021,139463,10,1,32,18,14
2021,139463,10,2,61,23,38
2021,139463,10,3,51,23,28
2021,139463,10,5,10,3,7
2021,139463,10,6,1,1,0
2021,139463,20,0,96,42,54
2021,139463,20,1,32,18,14
2021,139463,20,2,58,23,35
2021,139463,20,3,6,1,5
2021,139463,30,0,41,19,22
2021,139463,30,2,2,0,2
2021,139463,30,3,39,19,20
2021,139463,40,0,18,7,11
2021,139463,40,2,1,0,1
2021,139463,40,3,6,3,3
2021,139463,40,5,10,3,7
2021,139463,40,6,1,1,0
2021,139463,42,0,18,7,11
2021,139463,42,2,1,0,1
2021,139463,42,3,6,3,3
2021,139463,42,5,10,3,7
2021,139463,42,6,1,1,0
2021,139463,50,0,1,0,1
2021,139579,0,0,31,11,20
2021,139579,10,0,31,11,20
2021,139579,10,1,1,1,0
2021,139579,10,2,5,2,3
2021,139579,10,3,22,8,14
2021,139579,10,4,3,0,3
2021,139579,40,0,31,11,20
2021,139579,40,1,1,1,0
2021,139579,40,2,5,2,3
2021,139579,40,3,22,8,14
2021,139579,40,4,3,0,3
2021,139579,41,0,31,11,20
2021,139579,41,1,1,1,0
2021,139579,41,2,5,2,3
2021,139579,41,3,22,8,14
2021,139579,41,4,3,0,3
2021,139579,45,0,31,11,20
2021,139579,45,1,1,1,0
2021,139579,45,2,5,2,3
2021,139579,45,3,22,8,14
2021,139579,45,4,3,0,3
2021,139621,0,0,64,33,31
2021,139621,10,0,64,33,31
2021,139621,10,1,22,12,10
2021,139621,10,2,26,13,13
2021,139621,10,3,8,5,3
2021,139621,10,4,8,3,5
2021,139621,20,0,47,25,22
2021,139621,20,1,21,11,10
2021,139621,20,2,24,12,12
2021,139621,20,3,2,2,0
2021,139621,30,0,14,6,8
2021,139621,30,1,1,1,0
2021,139621,30,2,2,1,1
2021,139621,30,3,6,3,3
2021,139621,30,4,5,1,4
2021,139621,40,0,3,2,1
2021,139621,40,4,3,2,1
2021,139621,42,0,3,2,1
2021,139621,42,4,3,2,1
2021,139630,0,0,46,25,21
2021,139630,10,0,46,25,21
2021,139630,10,1,17,10,7
2021,139630,10,2,13,6,7
2021,139630,10,3,14,9,5
2021,139630,10,4,2,0,2
2021,139630,40,0,46,25,21
2021,139630,40,1,17,10,7
2021,139630,40,2,13,6,7
2021,139630,40,3,14,9,5
2021,139630,40,4,2,0,2
2021,139630,42,0,46,25,21
2021,139630,42,1,17,10,7
2021,139630,42,2,13,6,7
2021,139630,42,3,14,9,5
2021,139630,42,4,2,0,2
2021,139658,0,0,1416,784,632
2021,139658,10,0,1406,780,626
2021,139658,10,1,571,391,180
2021,139658,10,2,297,155,142
2021,139658,10,3,327,156,171
2021,139658,10,4,81,22,59
2021,139658,10,5,130,56,74
2021,139658,20,0,725,473,252
2021,139658,20,1,500,351,149
2021,139658,20,2,225,122,103
2021,139658,30,0,258,124,134
2021,139658,30,1,6,3,3
2021,139658,30,2,20,12,8
2021,139658,30,3,232,109,123
2021,139658,40,0,423,183,240
2021,139658,40,1,65,37,28
2021,139658,40,2,52,21,31
2021,139658,40,3,95,47,48
2021,139658,40,4,81,22,59
2021,139658,40,5,130,56,74
2021,139658,41,0,200,91,109
2021,139658,41,1,43,24,19
2021,139658,41,2,18,8,10
2021,139658,41,3,13,6,7
2021,139658,41,4,1,0,1
2021,139658,41,5,125,53,72
2021,139658,42,0,212,89,123
2021,139658,42,1,21,12,9
2021,139658,42,2,33,12,21
2021,139658,42,3,81,40,41
2021,139658,42,4,72,22,50
2021,139658,42,5,5,3,2
2021,139658,43,0,11,3,8
2021,139658,43,1,1,1,0
2021,139658,43,2,1,1,0
2021,139658,43,3,1,1,0
2021,139658,43,4,8,0,8
2021,139658,44,0,200,91,109
2021,139658,44,1,43,24,19
2021,139658,44,2,18,8,10
2021,139658,44,3,13,6,7
2021,139658,44,4,1,0,1
2021,139658,44,5,125,53,72
2021,139658,50,0,10,4,6
2021,139700,0,0,123,54,69
2021,139700,10,0,122,53,69
2021,139700,10,1,34,18,16
2021,139700,10,2,31,16,15
2021,139700,10,3,34,12,22
2021,139700,10,4,23,7,16
2021,139700,20,0,62,34,28
2021,139700,20,1,34,18,16
2021,139700,20,2,26,15,11
2021,139700,20,3,2,1,1
2021,139700,30,0,29,10,19
2021,139700,30,2,5,1,4
2021,139700,30,3,24,9,15
2021,139700,40,0,31,9,22
2021,139700,40,3,8,2,6
2021,139700,40,4,23,7,16
2021,139700,41,0,1,0,1
2021,139700,41,4,1,0,1
2021,139700,42,0,30,9,21
2021,139700,42,3,8,2,6
2021,139700,42,4,22,7,15
2021,139700,45,0,1,0,1
2021,139700,45,4,1,0,1
2021,139700,50,0,1,1,0
2021,139719,0,0,101,56,45
2021,139719,10,0,101,56,45
2021,139719,10,1,28,25,3
2021,139719,10,2,25,14,11
2021,139719,10,3,37,13,24
2021,139719,10,4,5,1,4
2021,139719,10,5,5,2,3
2021,139719,10,6,1,1,0
2021,139719,20,0,50,36,14
2021,139719,20,1,27,24,3
2021,139719,20,2,21,10,11
2021,139719,20,3,2,2,0
2021,139719,30,0,30,10,20
2021,139719,30,3,30,10,20
2021,139719,40,0,21,10,11
2021,139719,40,1,1,1,0
2021,139719,40,2,4,4,0
2021,139719,40,3,5,1,4
2021,139719,40,4,5,1,4
2021,139719,40,5,5,2,3
2021,139719,40,6,1,1,0
2021,139719,42,0,21,10,11
2021,139719,42,1,1,1,0
2021,139719,42,2,4,4,0
2021,139719,42,3,5,1,4
2021,139719,42,4,5,1,4
2021,139719,42,5,5,2,3
2021,139719,42,6,1,1,0
2021,139755,0,0,1053,753,300
2021,139755,10,0,942,678,264
2021,139755,10,1,409,337,72
2021,139755,10,2,254,181,73
2021,139755,10,3,184,107,77
2021,139755,10,5,83,47,36
2021,139755,10,6,12,6,6
2021,139755,20,0,651,508,143
2021,139755,20,1,404,332,72
2021,139755,20,2,246,175,71
2021,139755,20,3,1,1,0
2021,139755,30,0,197,118,79
2021,139755,30,1,5,5,0
2021,139755,30,2,8,6,2
2021,139755,30,3,183,106,77
2021,139755,30,5,1,1,0
2021,139755,40,0,94,52,42
2021,139755,40,5,82,46,36
2021,139755,40,6,12,6,6
2021,139755,41,0,1,1,0
2021,139755,41,5,1,1,0
2021,139755,42,0,93,51,42
2021,139755,42,5,81,45,36
2021,139755,42,6,12,6,6
2021,139755,45,0,1,1,0
2021,139755,45,5,1,1,0
2021,139755,50,0,111,75,36
2021,139764,0,0,117,54,63
2021,139764,10,0,117,54,63
2021,139764,10,1,36,22,14
2021,139764,10,2,25,13,12
2021,139764,10,3,25,9,16
2021,139764,10,4,2,1,1
2021,139764,10,5,29,9,20
2021,139764,20,0,59,34,25
2021,139764,20,1,36,22,14
2021,139764,20,2,23,12,11
2021,139764,30,0,27,10,17
2021,139764,30,2,2,1,1
2021,139764,30,3,25,9,16
2021,139764,40,0,31,10,21
2021,139764,40,4,2,1,1
2021,139764,40,5,29,9,20
2021,139764,42,0,31,10,21
2021,139764,42,4,2,1,1
2021,139764,42,5,29,9,20
2021,139861,0,0,331,149,182
2021,139861,10,0,331,149,182
2021,139861,10,1,109,61,48
2021,139861,10,2,77,29,48
2021,139861,10,3,67,33,34
2021,139861,10,4,2,0,2
2021,139861,10,5,75,25,50
2021,139861,10,6,1,1,0
2021,139861,20,0,186,90,96
2021,139861,20,1,109,61,48
2021,139861,20,2,77,29,48
2021,139861,30,0,66,34,32
2021,139861,30,3,65,33,32
2021,139861,30,5,1,1,0
2021,139861,40,0,79,25,54
2021,139861,40,3,2,0,2
2021,139861,40,4,2,0,2
2021,139861,40,5,74,24,50
2021,139861,40,6,1,1,0
2021,139861,41,0,1,1,0
2021,139861,41,6,1,1,0
2021,139861,42,0,78,24,54
2021,139861,42,3,2,0,2
2021,139861,42,4,2,0,2
2021,139861,42,5,74,24,50
2021,139861,45,0,1,1,0
2021,139861,45,6,1,1,0
2021,139931,0,0,996,480,516
2021,139931,10,0,996,480,516
2021,139931,10,1,226,134,92
2021,139931,10,2,270,158,112
2021,139931,10,3,231,111,120
2021,139931,10,4,97,26,71
2021,139931,10,5,172,51,121
2021,139931,20,0,500,295,205
2021,139931,20,1,226,134,92
2021,139931,20,2,265,156,109
2021,139931,20,3,9,5,4
2021,139931,30,0,190,91,99
2021,139931,30,3,190,91,99
2021,139931,40,0,306,94,212
2021,139931,40,2,5,2,3
2021,139931,40,3,32,15,17
2021,139931,40,4,97,26,71
2021,139931,40,5,172,51,121
2021,139931,42,0,306,94,212
2021,139931,42,2,5,2,3
2021,139931,42,3,32,15,17
2021,139931,42,4,97,26,71
2021,139931,42,5,172,51,121
2021,139940,0,0,1288,645,643
2021,139940,10,0,1195,608,587
2021,139940,10,1,297,195,102
2021,139940,10,2,316,163,153
2021,139940,10,3,236,111,125
2021,139940,10,4,51,9,42
2021,139940,10,5,189,82,107
2021,139940,10,6,106,48,58
2021,139940,20,0,528,316,212
2021,139940,20,1,280,186,94
2021,139940,20,2,247,130,117
2021,139940,20,3,1,0,1
2021,139940,30,0,177,84,93
2021,139940,30,2,14,10,4
2021,139940,30,3,156,74,82
2021,139940,30,4,7,0,7
2021,139940,40,0,490,208,282
2021,139940,40,1,17,9,8
2021,139940,40,2,55,23,32
2021,139940,40,3,79,37,42
2021,139940,40,4,44,9,35
2021,139940,40,5,189,82,107
2021,139940,40,6,106,48,58
2021,139940,41,0,6,0,6
2021,139940,41,4,1,0,1
2021,139940,41,6,5,0,5
2021,139940,42,0,484,208,276
2021,139940,42,1,17,9,8
2021,139940,42,2,55,23,32
2021,139940,42,3,79,37,42
2021,139940,42,4,43,9,34
2021,139940,42,5,189,82,107
2021,139940,42,6,101,48,53
2021,139940,45,0,6,0,6
2021,139940,45,4,1,0,1
2021,139940,45,6,5,0,5
2021,139940,50,0,93,37,56
2021,139959,0,0,2115,1241,874
2021,139959,10,0,2115,1241,874
2021,139959,10,1,734,523,211
2021,139959,10,2,529,299,230
2021,139959,10,3,368,193,175
2021,139959,10,4,63,33,30
2021,139959,10,5,270,133,137
2021,139959,10,6,151,60,91
2021,139959,20,0,1245,815,430
2021,139959,20,1,732,522,210
2021,139959,20,2,512,292,220
2021,139959,20,3,1,1,0
2021,139959,30,0,365,188,177
2021,139959,30,1,2,1,1
2021,139959,30,2,17,7,10
2021,139959,30,3,346,180,166
2021,139959,40,0,505,238,267
2021,139959,40,3,21,12,9
2021,139959,40,4,63,33,30
2021,139959,40,5,270,133,137
2021,139959,40,6,151,60,91
2021,139959,41,0,2,1,1
2021,139959,41,4,1,1,0
2021,139959,41,6,1,0,1
2021,139959,42,0,503,237,266
2021,139959,42,3,21,12,9
2021,139959,42,4,62,32,30
2021,139959,42,5,270,133,137
2021,139959,42,6,150,60,90
2021,139959,45,0,2,1,1
2021,139959,45,4,1,1,0
2021,139959,45,6,1,0,1
2021,139968,0,0,88,43,45
2021,139968,10,0,88,43,45
2021,139968,10,1,41,25,16
2021,139968,10,2,18,8,10
2021,139968,10,3,16,2,14
2021,139968,10,4,2,1,1
2021,139968,10,5,11,7,4
2021,139968,20,0,54,29,25
2021,139968,20,1,39,23,16
2021,139968,20,2,14,6,8
2021,139968,20,3,1,0,1
2021,139968,30,0,15,3,12
2021,139968,30,2,1,1,0
2021,139968,30,3,14,2,12
2021,139968,40,0,19,11,8
2021,139968,40,1,2,2,0
2021,139968,40,2,3,1,2
2021,139968,40,3,1,0,1
2021,139968,40,4,2,1,1
2021,139968,40,5,11,7,4
2021,139968,42,0,19,11,8
2021,139968,42,1,2,2,0
2021,139968,42,2,3,1,2
2021,139968,42,3,1,0,1
2021,139968,42,4,2,1,1
2021,139968,42,5,11,7,4
2021,139986,0,0,98,43,55
2021,139986,50,0,98,43,55
2021,140003,0,0,5,2,3
2021,140003,10,0,5,2,3
2021,140003,10,4,5,2,3
2021,140003,40,0,5,2,3
2021,140003,40,4,5,2,3
2021,140003,41,0,5,2,3
2021,140003,41,4,5,2,3
2021,140003,45,0,5,2,3
2021,140003,45,4,5,2,3
2021,140012,0,0,119,65,54
2021,140012,10,0,119,65,54
2021,140012,10,2,1,1,0
2021,140012,10,4,118,64,54
2021,140012,40,0,119,65,54
2021,140012,40,2,1,1,0
2021,140012,40,4,118,64,54
2021,140012,41,0,114,63,51
2021,140012,41,2,1,1,0
2021,140012,41,4,113,62,51
2021,140012,43,0,5,2,3
2021,140012,43,4,5,2,3
2021,140012,45,0,114,63,51
2021,140012,45,2,1,1,0
2021,140012,45,4,113,62,51
2021,140146,0,0,14,9,5
2021,140146,10,0,14,9,5
2021,140146,10,1,5,3,2
2021,140146,10,2,4,3,1
2021,140146,10,3,5,3,2
2021,140146,20,0,8,5,3
2021,140146,20,1,5,3,2
2021,140146,20,2,3,2,1
2021,140146,30,0,4,3,1
2021,140146,30,2,1,1,0
2021,140146,30,3,3,2,1
2021,140146,40,0,2,1,1
2021,140146,40,3,2,1,1
2021,140146,41,0,1,0,1
2021,140146,41,3,1,0,1
2021,140146,42,0,1,1,0
2021,140146,42,3,1,1,0
2021,140146,44,0,1,0,1
2021,140146,44,3,1,0,1
2021,140234,0,0,60,29,31
2021,140234,10,0,60,29,31
2021,140234,10,1,20,12,8
2021,140234,10,2,14,4,10
2021,140234,10,3,23,12,11
2021,140234,10,4,2,0,2
2021,140234,10,6,1,1,0
2021,140234,20,0,32,16,16
2021,140234,20,1,20,12,8
2021,140234,20,2,11,4,7
2021,140234,20,3,1,0,1
2021,140234,30,0,15,10,5
2021,140234,30,3,14,9,5
2021,140234,30,6,1,1,0
2021,140234,40,0,13,3,10
2021,140234,40,2,3,0,3
2021,140234,40,3,8,3,5
2021,140234,40,4,2,0,2
2021,140234,41,0,8,1,7
2021,140234,41,2,2,0,2
2021,140234,41,3,5,1,4
2021,140234,41,4,1,0,1
2021,140234,42,0,4,1,3
2021,140234,42,2,1,0,1
2021,140234,42,3,2,1,1
2021,140234,42,4,1,0,1
2021,140234,43,0,1,1,0
2021,140234,43,3,1,1,0
2021,140234,44,0,8,1,7
2021,140234,44,2,2,0,2
2021,140234,44,3,5,1,4
2021,140234,44,4,1,0,1
2021,140243,0,0,106,51,55
2021,140243,10,0,106,51,55
2021,140243,10,4,106,51,55
2021,140243,40,0,106,51,55
2021,140243,40,4,106,51,55
2021,140243,42,0,106,51,55
2021,140243,42,4,106,51,55
2021,140252,0,0,117,69,48
2021,140252,10,0,117,69,48
2021,140252,10,1,15,8,7
2021,140252,10,2,33,22,11
2021,140252,10,3,68,38,30
2021,140252,10,4,1,1,0
2021,140252,40,0,117,69,48
2021,140252,40,1,15,8,7
2021,140252,40,2,33,22,11
2021,140252,40,3,68,38,30
2021,140252,40,4,1,1,0
2021,140252,42,0,79,48,31
2021,140252,42,1,13,6,7
2021,140252,42,2,26,19,7
2021,140252,42,3,40,23,17
2021,140252,43,0,38,21,17
2021,140252,43,1,2,2,0
2021,140252,43,2,7,3,4
2021,140252,43,3,28,15,13
2021,140252,43,4,1,1,0
2021,140331,0,0,187,87,100
2021,140331,10,0,187,87,100
2021,140331,10,6,187,87,100
2021,140331,40,0,187,87,100
2021,140331,40,6,187,87,100
2021,140331,42,0,179,84,95
2021,140331,42,6,179,84,95
2021,140331,43,0,8,3,5
2021,140331,43,6,8,3,5
2021,140340,0,0,10,1,9
2021,140340,10,0,10,1,9
2021,140340,10,1,3,1,2
2021,140340,10,2,1,0,1
2021,140340,10,3,6,0,6
2021,140340,40,0,10,1,9
2021,140340,40,1,3,1,2
2021,140340,40,2,1,0,1
2021,140340,40,3,6,0,6
2021,140340,41,0,10,1,9
2021,140340,41,1,3,1,2
2021,140340,41,2,1,0,1
2021,140340,41,3,6,0,6
2021,140340,45,0,10,1,9
2021,140340,45,1,3,1,2
2021,140340,45,2,1,0,1
2021,140340,45,3,6,0,6
2021,140447,0,0,461,230,231
2021,140447,10,0,461,230,231
2021,140447,10,1,136,93,43
2021,140447,10,2,132,63,69
2021,140447,10,3,154,61,93
2021,140447,10,4,18,4,14
2021,140447,10,5,21,9,12
2021,140447,20,0,204,125,79
2021,140447,20,1,121,83,38
2021,140447,20,2,82,41,41
2021,140447,20,3,1,1,0
2021,140447,30,0,108,48,60
2021,140447,30,2,10,6,4
2021,140447,30,3,98,42,56
2021,140447,40,0,149,57,92
2021,140447,40,1,15,10,5
2021,140447,40,2,40,16,24
2021,140447,40,3,55,18,37
2021,140447,40,4,18,4,14
2021,140447,40,5,21,9,12
2021,140447,41,0,6,2,4
2021,140447,41,1,1,1,0
2021,140447,41,2,2,1,1
2021,140447,41,3,3,0,3
2021,140447,42,0,143,55,88
2021,140447,42,1,14,9,5
2021,140447,42,2,38,15,23
2021,140447,42,3,52,18,34
2021,140447,42,4,18,4,14
2021,140447,42,5,21,9,12
2021,140447,44,0,5,2,3
2021,140447,44,1,1,1,0
2021,140447,44,2,2,1,1
2021,140447,44,3,2,0,2
2021,140447,45,0,1,0,1
2021,140447,45,3,1,0,1
2021,140553,0,0,148,91,57
2021,140553,10,0,131,79,52
2021,140553,10,1,36,23,13
2021,140553,10,2,53,33,20
2021,140553,10,3,42,23,19
2021,140553,20,0,87,56,31
2021,140553,20,1,36,23,13
2021,140553,20,2,50,32,18
2021,140553,20,3,1,1,0
2021,140553,30,0,13,5,8
2021,140553,30,2,2,1,1
2021,140553,30,3,11,4,7
2021,140553,40,0,31,18,13
2021,140553,40,2,1,0,1
2021,140553,40,3,30,18,12
2021,140553,42,0,31,18,13
2021,140553,42,2,1,0,1
2021,140553,42,3,30,18,12
2021,140553,50,0,17,12,5
2021,140562,0,0,247,113,134
2021,140562,10,0,247,113,134
2021,140562,10,1,78,51,27
2021,140562,10,2,63,28,35
2021,140562,10,3,78,25,53
2021,140562,10,4,28,9,19
2021,140562,40,0,247,113,134
2021,140562,40,1,78,51,27
2021,140562,40,2,63,28,35
2021,140562,40,3,78,25,53
2021,140562,40,4,28,9,19
2021,140562,41,0,61,39,22
2021,140562,41,1,47,33,14
2021,140562,41,2,9,4,5
2021,140562,41,3,5,2,3
2021,140562,42,0,186,74,112
2021,140562,42,1,31,18,13
2021,140562,42,2,54,24,30
2021,140562,42,3,73,23,50
2021,140562,42,4,28,9,19
2021,140562,44,0,61,39,22
2021,140562,44,1,47,33,14
2021,140562,44,2,9,4,5
2021,140562,44,3,5,2,3
2021,140678,0,0,60,32,28
2021,140678,10,0,60,32,28
2021,140678,10,6,60,32,28
2021,140678,40,0,60,32,28
2021,140678,40,6,60,32,28
2021,140678,42,0,59,32,27
2021,140678,42,6,59,32,27
2021,140678,43,0,1,0,1
2021,140678,43,6,1,0,1
2021,140696,0,0,87,46,41
2021,140696,10,0,87,46,41
2021,140696,10,1,18,12,6
2021,140696,10,2,13,5,8
2021,140696,10,3,26,11,15
2021,140696,10,4,2,2,0
2021,140696,10,5,25,14,11
2021,140696,10,6,3,2,1
2021,140696,20,0,31,17,14
2021,140696,20,1,18,12,6
2021,140696,20,2,13,5,8
2021,140696,30,0,15,5,10
2021,140696,30,3,15,5,10
2021,140696,40,0,41,24,17
2021,140696,40,3,11,6,5
2021,140696,40,4,2,2,0
2021,140696,40,5,25,14,11
2021,140696,40,6,3,2,1
2021,140696,41,0,12,7,5
2021,140696,41,5,9,5,4
2021,140696,41,6,3,2,1
2021,140696,42,0,29,17,12
2021,140696,42,3,11,6,5
2021,140696,42,4,2,2,0
2021,140696,42,5,16,9,7
2021,140696,44,0,9,5,4
2021,140696,44,5,9,5,4
2021,140696,45,0,3,2,1
2021,140696,45,6,3,2,1
2021,140720,0,0,25,16,9
2021,140720,10,0,25,16,9
2021,140720,10,1,2,2,0
2021,140720,10,2,4,4,0
2021,140720,10,3,13,8,5
2021,140720,10,4,6,2,4
2021,140720,20,0,2,2,0
2021,140720,20,1,2,2,0
2021,140720,30,0,13,9,4
2021,140720,30,2,3,3,0
2021,140720,30,3,10,6,4
2021,140720,40,0,10,5,5
2021,140720,40,2,1,1,0
2021,140720,40,3,3,2,1
2021,140720,40,4,6,2,4
2021,140720,42,0,10,5,5
2021,140720,42,2,1,1,0
2021,140720,42,3,3,2,1
2021,140720,42,4,6,2,4
2021,140818,0,0,111,49,62
2021,140818,10,0,111,49,62
2021,140818,10,1,36,20,16
2021,140818,10,2,41,15,26
2021,140818,10,3,33,14,19
2021,140818,10,4,1,0,1
2021,140818,20,0,14,8,6
2021,140818,20,1,14,8,6
2021,140818,30,0,1,1,0
2021,140818,30,1,1,1,0
2021,140818,40,0,96,40,56
2021,140818,40,1,21,11,10
2021,140818,40,2,41,15,26
2021,140818,40,3,33,14,19
2021,140818,40,4,1,0,1
2021,140818,42,0,96,40,56
2021,140818,42,1,21,11,10
2021,140818,42,2,41,15,26
2021,140818,42,3,33,14,19
2021,140818,42,4,1,0,1
2021,140872,0,0,71,31,40
2021,140872,10,0,71,31,40
2021,140872,10,1,13,5,8
2021,140872,10,2,16,8,8
2021,140872,10,3,35,14,21
2021,140872,10,4,5,2,3
2021,140872,10,5,2,2,0
2021,140872,20,0,26,11,15
2021,140872,20,1,10,3,7
2021,140872,20,2,14,7,7
2021,140872,20,3,2,1,1
2021,140872,30,0,10,8,2
2021,140872,30,2,1,1,0
2021,140872,30,3,9,7,2
2021,140872,40,0,35,12,23
2021,140872,40,1,3,2,1
2021,140872,40,2,1,0,1
2021,140872,40,3,24,6,18
2021,140872,40,4,5,2,3
2021,140872,40,5,2,2,0
2021,140872,42,0,35,12,23
2021,140872,42,1,3,2,1
2021,140872,42,2,1,0,1
2021,140872,42,3,24,6,18
2021,140872,42,4,5,2,3
2021,140872,42,5,2,2,0
2021,140942,0,0,92,44,48
2021,140942,10,0,92,44,48
2021,140942,10,6,92,44,48
2021,140942,40,0,92,44,48
2021,140942,40,6,92,44,48
2021,140942,41,0,90,44,46
2021,140942,41,6,90,44,46
2021,140942,43,0,2,0,2
2021,140942,43,6,2,0,2
2021,140942,45,0,90,44,46
2021,140942,45,6,90,44,46
2021,140951,0,0,658,381,277
2021,140951,10,0,658,381,277
2021,140951,10,1,658,381,277
2021,140951,40,0,658,381,277
2021,140951,40,1,658,381,277
2021,140951,42,0,658,381,277
2021,140951,42,1,658,381,277
2021,140960,0,0,153,85,68
2021,140960,10,0,149,83,66
2021,140960,10,1,29,23,6
2021,140960,10,2,36,17,19
2021,140960,10,3,51,27,24
2021,140960,10,4,20,11,9
2021,140960,10,5,8,3,5
2021,140960,10,6,5,2,3
2021,140960,20,0,66,42,24
2021,140960,20,1,29,23,6
2021,140960,20,2,33,17,16
2021,140960,20,3,4,2,2
2021,140960,30,0,47,24,23
2021,140960,30,2,3,0,3
2021,140960,30,3,44,24,20
2021,140960,40,0,36,17,19
2021,140960,40,3,3,1,2
2021,140960,40,4,20,11,9
2021,140960,40,5,8,3,5
2021,140960,40,6,5,2,3
2021,140960,41,0,3,2,1
2021,140960,41,4,3,2,1
2021,140960,42,0,33,15,18
2021,140960,42,3,3,1,2
2021,140960,42,4,17,9,8
2021,140960,42,5,8,3,5
2021,140960,42,6,5,2,3
2021,140960,45,0,3,2,1
2021,140960,45,4,3,2,1
2021,140960,50,0,4,2,2
2021,140988,0,0,76,40,36
2021,140988,10,0,76,40,36
2021,140988,10,1,6,5,1
2021,140988,10,2,30,19,11
2021,140988,10,3,35,14,21
2021,140988,10,4,4,1,3
2021,140988,10,6,1,1,0
2021,140988,20,0,13,10,3
2021,140988,20,1,5,4,1
2021,140988,20,2,8,6,2
2021,140988,30,0,61,29,32
2021,140988,30,1,1,1,0
2021,140988,30,2,22,13,9
2021,140988,30,3,35,14,21
2021,140988,30,4,3,1,2
2021,140988,40,0,2,1,1
2021,140988,40,4,1,0,1
2021,140988,40,6,1,1,0
2021,140988,42,0,2,1,1
2021,140988,42,4,1,0,1
2021,140988,42,6,1,1,0
2021,141006,0,0,54,30,24
2021,141006,10,0,54,30,24
2021,141006,10,4,54,30,24
2021,141006,40,0,54,30,24
2021,141006,40,4,54,30,24
2021,141006,42,0,54,30,24
2021,141006,42,4,54,30,24
2021,141060,0,0,183,46,137
2021,141060,10,0,183,46,137
2021,141060,10,1,26,7,19
2021,141060,10,2,55,15,40
2021,141060,10,3,48,9,39
2021,141060,10,4,22,4,18
2021,141060,10,5,32,11,21
2021,141060,20,0,81,22,59
2021,141060,20,1,26,7,19
2021,141060,20,2,55,15,40
2021,141060,30,0,48,9,39
2021,141060,30,3,48,9,39
2021,141060,40,0,54,15,39
2021,141060,40,4,22,4,18
2021,141060,40,5,32,11,21
2021,141060,41,0,33,5,28
2021,141060,41,4,13,1,12
2021,141060,41,5,20,4,16
2021,141060,42,0,21,10,11
2021,141060,42,4,9,3,6
2021,141060,42,5,12,7,5
2021,141060,44,0,33,5,28
2021,141060,44,4,13,1,12
2021,141060,44,5,20,4,16
2021,141167,0,0,48,16,32
2021,141167,10,0,48,16,32
2021,141167,10,1,4,1,3
2021,141167,10,2,10,3,7
2021,141167,10,3,19,6,13
2021,141167,10,4,15,6,9
2021,141167,40,0,48,16,32
2021,141167,40,1,4,1,3
2021,141167,40,2,10,3,7
2021,141167,40,3,19,6,13
2021,141167,40,4,15,6,9
2021,141167,43,0,48,16,32
2021,141167,43,1,4,1,3
2021,141167,43,2,10,3,7
2021,141167,43,3,19,6,13
2021,141167,43,4,15,6,9
2021,141185,0,0,43,27,16
2021,141185,10,0,43,27,16
2021,141185,10,1,13,12,1
2021,141185,10,2,7,4,3
2021,141185,10,3,23,11,12
2021,141185,20,0,11,10,1
2021,141185,20,1,10,9,1
2021,141185,20,2,1,1,0
2021,141185,30,0,17,10,7
2021,141185,30,1,3,3,0
2021,141185,30,2,6,3,3
2021,141185,30,3,8,4,4
2021,141185,40,0,15,7,8
2021,141185,40,3,15,7,8
2021,141185,42,0,15,7,8
2021,141185,42,3,15,7,8
2021,141237,0,0,53,30,23
2021,141237,10,0,53,30,23
2021,141237,10,1,13,9,4
2021,141237,10,2,16,9,7
2021,141237,10,3,21,10,11
2021,141237,10,4,2,2,0
2021,141237,10,6,1,0,1
2021,141237,40,0,53,30,23
2021,141237,40,1,13,9,4
2021,141237,40,2,16,9,7
2021,141237,40,3,21,10,11
2021,141237,40,4,2,2,0
2021,141237,40,6,1,0,1
2021,141237,42,0,53,30,23
2021,141237,42,1,13,9,4
2021,141237,42,2,16,9,7
2021,141237,42,3,21,10,11
2021,141237,42,4,2,2,0
2021,141237,42,6,1,0,1
2021,141255,0,0,129,50,79
2021,141255,10,0,129,50,79
2021,141255,10,4,129,50,79
2021,141255,40,0,129,50,79
2021,141255,40,4,129,50,79
2021,141255,41,0,129,50,79
2021,141255,41,4,129,50,79
2021,141255,45,0,129,50,79
2021,141255,45,4,129,50,79
2021,141264,0,0,415,195,220
2021,141264,10,0,414,195,219
2021,141264,10,1,136,83,53
2021,141264,10,2,91,46,45
2021,141264,10,3,91,36,55
2021,141264,10,4,24,6,18
2021,141264,10,5,72,24,48
2021,141264,20,0,222,127,95
2021,141264,20,1,136,83,53
2021,141264,20,2,85,44,41
2021,141264,20,3,1,0,1
2021,141264,30,0,77,32,45
2021,141264,30,2,4,1,3
2021,141264,30,3,73,31,42
2021,141264,40,0,115,36,79
2021,141264,40,2,2,1,1
2021,141264,40,3,17,5,12
2021,141264,40,4,24,6,18
2021,141264,40,5,72,24,48
2021,141264,41,0,1,0,1
2021,141264,41,4,1,0,1
2021,141264,42,0,114,36,78
2021,141264,42,2,2,1,1
2021,141264,42,3,17,5,12
2021,141264,42,4,23,6,17
2021,141264,42,5,72,24,48
2021,141264,45,0,1,0,1
2021,141264,45,4,1,0,1
2021,141264,50,0,1,0,1
2021,141325,0,0,47,16,31
2021,141325,10,0,47,16,31
2021,141325,10,1,18,5,13
2021,141325,10,2,16,5,11
2021,141325,10,3,13,6,7
2021,141325,20,0,32,10,22
2021,141325,20,1,18,5,13
2021,141325,20,2,14,5,9
2021,141325,30,0,12,5,7
2021,141325,30,2,2,0,2
2021,141325,30,3,10,5,5
2021,141325,40,0,3,1,2
2021,141325,40,3,3,1,2
2021,141325,42,0,3,1,2
2021,141325,42,3,3,1,2
2021,141334,0,0,480,204,276
2021,141334,10,0,479,204,275
2021,141334,10,1,146,86,60
2021,141334,10,2,102,44,58
2021,141334,10,3,98,33,65
2021,141334,10,4,49,14,35
2021,141334,10,5,84,27,57
2021,141334,20,0,244,129,115
2021,141334,20,1,146,86,60
2021,141334,20,2,97,42,55
2021,141334,20,3,1,1,0
2021,141334,30,0,72,29,43
2021,141334,30,2,3,1,2
2021,141334,30,3,69,28,41
2021,141334,40,0,163,46,117
2021,141334,40,2,2,1,1
2021,141334,40,3,28,4,24
2021,141334,40,4,49,14,35
2021,141334,40,5,84,27,57
2021,141334,41,0,2,0,2
2021,141334,41,4,2,0,2
2021,141334,42,0,161,46,115
2021,141334,42,2,2,1,1
2021,141334,42,3,28,4,24
2021,141334,42,4,47,14,33
2021,141334,42,5,84,27,57
2021,141334,45,0,2,0,2
2021,141334,45,4,2,0,2
2021,141334,50,0,1,0,1
2021,141361,0,0,59,35,24
2021,141361,10,0,59,35,24
2021,141361,10,1,10,6,4
2021,141361,10,2,17,15,2
2021,141361,10,3,22,10,12
2021,141361,10,4,10,4,6
2021,141361,20,0,27,21,6
2021,141361,20,1,10,6,4
2021,141361,20,2,17,15,2
2021,141361,30,0,22,10,12
2021,141361,30,3,22,10,12
2021,141361,40,0,10,4,6
2021,141361,40,4,10,4,6
2021,141361,42,0,10,4,6
2021,141361,42,4,10,4,6
2021,141486,0,0,88,45,43
2021,141486,10,0,88,45,43
2021,141486,10,1,21,15,6
2021,141486,10,2,29,15,14
2021,141486,10,3,27,10,17
2021,141486,10,5,11,5,6
2021,141486,20,0,32,22,10
2021,141486,20,1,20,15,5
2021,141486,20,2,12,7,5
2021,141486,30,0,11,5,6
2021,141486,30,2,3,1,2
2021,141486,30,3,8,4,4
2021,141486,40,0,45,18,27
2021,141486,40,1,1,0,1
2021,141486,40,2,14,7,7
2021,141486,40,3,19,6,13
2021,141486,40,5,11,5,6
2021,141486,42,0,45,18,27
2021,141486,42,1,1,0,1
2021,141486,42,2,14,7,7
2021,141486,42,3,19,6,13
2021,141486,42,5,11,5,6
2021,141565,0,0,182,100,82
2021,141565,10,0,182,100,82
2021,141565,10,1,77,41,36
2021,141565,10,2,55,35,20
2021,141565,10,3,27,16,11
2021,141565,10,4,23,8,15
2021,141565,20,0,130,75,55
2021,141565,20,1,77,41,36
2021,141565,20,2,52,33,19
2021,141565,20,3,1,1,0
2021,141565,30,0,27,17,10
2021,141565,30,2,3,2,1
2021,141565,30,3,24,15,9
2021,141565,40,0,25,8,17
2021,141565,40,3,2,0,2
2021,141565,40,4,23,8,15
2021,141565,41,0,13,1,12
2021,141565,41,3,1,0,1
2021,141565,41,4,12,1,11
2021,141565,42,0,12,7,5
2021,141565,42,3,1,0,1
2021,141565,42,4,11,7,4
2021,141565,44,0,13,1,12
2021,141565,44,3,1,0,1
2021,141565,44,4,12,1,11
2021,141574,0,0,1066,567,499
2021,141574,10,0,1066,567,499
2021,141574,10,1,429,270,159
2021,141574,10,2,313,144,169
2021,141574,10,3,222,119,103
2021,141574,10,4,102,34,68
2021,141574,20,0,709,400,309
2021,141574,20,1,421,263,158
2021,141574,20,2,288,137,151
2021,141574,30,0,160,92,68
2021,141574,30,2,2,1,1
2021,141574,30,3,158,91,67
2021,141574,40,0,197,75,122
2021,141574,40,1,8,7,1
2021,141574,40,2,23,6,17
2021,141574,40,3,64,28,36
2021,141574,40,4,102,34,68
2021,141574,41,0,60,21,39
2021,141574,41,2,3,1,2
2021,141574,41,3,16,7,9
2021,141574,41,4,41,13,28
2021,141574,42,0,137,54,83
2021,141574,42,1,8,7,1
2021,141574,42,2,20,5,15
2021,141574,42,3,48,21,27
2021,141574,42,4,61,21,40
2021,141574,44,0,60,21,39
2021,141574,44,2,3,1,2
2021,141574,44,3,16,7,9
2021,141574,44,4,41,13,28
2021,141644,0,0,151,78,73
2021,141644,10,0,151,78,73
2021,141644,10,1,19,12,7
2021,141644,10,2,37,20,17
2021,141644,10,3,59,30,29
2021,141644,10,4,12,6,6
2021,141644,10,5,24,10,14
2021,141644,40,0,151,78,73
2021,141644,40,1,19,12,7
2021,141644,40,2,37,20,17
2021,141644,40,3,59,30,29
2021,141644,40,4,12,6,6
2021,141644,40,5,24,10,14
2021,141644,41,0,127,68,59
2021,141644,41,1,19,12,7
2021,141644,41,2,37,20,17
2021,141644,41,3,59,30,29
2021,141644,41,4,12,6,6
2021,141644,42,0,24,10,14
2021,141644,42,5,24,10,14
2021,141644,44,0,127,68,59
2021,141644,44,1,19,12,7
2021,141644,44,2,37,20,17
2021,141644,44,3,59,30,29
2021,141644,44,4,12,6,6
2021,141680,0,0,85,53,32
2021,141680,10,0,85,53,32
2021,141680,10,1,20,11,9
2021,141680,10,2,19,13,6
2021,141680,10,3,25,18,7
2021,141680,10,4,21,11,10
2021,141680,20,0,60,39,21
2021,141680,20,1,20,11,9
2021,141680,20,2,19,13,6
2021,141680,20,3,21,15,6
2021,141680,30,0,23,13,10
2021,141680,30,3,3,3,0
2021,141680,30,4,20,10,10
2021,141680,40,0,2,1,1
2021,141680,40,3,1,0,1
2021,141680,40,4,1,1,0
2021,141680,42,0,2,1,1
2021,141680,42,3,1,0,1
2021,141680,42,4,1,1,0
2021,141796,0,0,157,81,76
2021,141796,10,0,157,81,76
2021,141796,10,1,46,25,21
2021,141796,10,2,25,13,12
2021,141796,10,3,45,23,22
2021,141796,10,4,41,20,21
2021,141796,20,0,109,59,50
2021,141796,20,1,45,24,21
2021,141796,20,2,25,13,12
2021,141796,20,3,39,22,17
2021,141796,30,0,34,18,16
2021,141796,30,3,2,0,2
2021,141796,30,4,32,18,14
2021,141796,40,0,14,4,10
2021,141796,40,1,1,1,0
2021,141796,40,3,4,1,3
2021,141796,40,4,9,2,7
2021,141796,42,0,14,4,10
2021,141796,42,1,1,1,0
2021,141796,42,3,4,1,3
2021,141796,42,4,9,2,7
2021,141802,0,0,44,23,21
2021,141802,10,0,44,23,21
2021,141802,10,1,11,6,5
2021,141802,10,2,6,3,3
2021,141802,10,3,20,10,10
2021,141802,10,4,7,4,3
2021,141802,20,0,36,19,17
2021,141802,20,1,11,6,5
2021,141802,20,2,6,3,3
2021,141802,20,3,19,10,9
2021,141802,30,0,6,4,2
2021,141802,30,4,6,4,2
2021,141802,40,0,2,0,2
2021,141802,40,3,1,0,1
2021,141802,40,4,1,0,1
2021,141802,41,0,1,0,1
2021,141802,41,3,1,0,1
2021,141802,42,0,1,0,1
2021,141802,42,4,1,0,1
2021,141802,44,0,1,0,1
2021,141802,44,3,1,0,1
2021,141811,0,0,129,61,68
2021,141811,10,0,129,61,68
2021,141811,10,1,40,23,17
2021,141811,10,2,23,10,13
2021,141811,10,3,38,16,22
2021,141811,10,4,28,12,16
2021,141811,20,0,101,49,52
2021,141811,20,1,40,23,17
2021,141811,20,2,23,10,13
2021,141811,20,3,38,16,22
2021,141811,30,0,26,12,14
2021,141811,30,4,26,12,14
2021,141811,40,0,2,0,2
2021,141811,40,4,2,0,2
2021,141811,42,0,2,0,2
2021,141811,42,4,2,0,2
2021,141839,0,0,70,31,39
2021,141839,10,0,70,31,39
2021,141839,10,1,14,3,11
2021,141839,10,2,17,8,9
2021,141839,10,3,21,13,8
2021,141839,10,4,18,7,11
2021,141839,20,0,52,24,28
2021,141839,20,1,14,3,11
2021,141839,20,2,17,8,9
2021,141839,20,3,21,13,8
2021,141839,30,0,10,4,6
2021,141839,30,4,10,4,6
2021,141839,40,0,8,3,5
2021,141839,40,4,8,3,5
2021,141839,41,0,1,1,0
2021,141839,41,4,1,1,0
2021,141839,42,0,7,2,5
2021,141839,42,4,7,2,5
2021,141839,44,0,1,1,0
2021,141839,44,4,1,1,0
2021,141981,0,0,85,44,41
2021,141981,10,0,85,44,41
2021,141981,10,1,29,18,11
2021,141981,10,2,18,10,8
2021,141981,10,3,29,10,19
2021,141981,10,4,9,6,3
2021,141981,20,0,47,28,19
2021,141981,20,1,29,18,11
2021,141981,20,2,18,10,8
2021,141981,30,0,28,10,18
2021,141981,30,3,28,10,18
2021,141981,40,0,10,6,4
2021,141981,40,3,1,0,1
2021,141981,40,4,9,6,3
2021,141981,41,0,5,2,3
2021,141981,41,3,1,0,1
2021,141981,41,4,4,2,2
2021,141981,42,0,5,4,1
2021,141981,42,4,5,4,1
2021,141981,44,0,5,2,3
2021,141981,44,3,1,0,1
2021,141981,44,4,4,2,2
2021,141990,0,0,42,21,21
2021,141990,10,0,42,21,21
2021,141990,10,1,11,9,2
2021,141990,10,2,7,3,4
2021,141990,10,3,13,5,8
2021,141990,10,4,11,4,7
2021,141990,20,0,31,17,14
2021,141990,20,1,11,9,2
2021,141990,20,2,7,3,4
2021,141990,20,3,13,5,8
2021,141990,30,0,8,4,4
2021,141990,30,4,8,4,4
2021,141990,40,0,3,0,3
2021,141990,40,4,3,0,3
2021,141990,42,0,3,0,3
2021,141990,42,4,3,0,3
2021,142054,0,0,19,1,18
2021,142054,10,0,19,1,18
2021,142054,10,4,19,1,18
2021,142054,40,0,19,1,18
2021,142054,40,4,19,1,18
2021,142054,41,0,19,1,18
2021,142054,41,4,19,1,18
2021,142054,45,0,19,1,18
2021,142054,45,4,19,1,18
2021,142090,0,0,8,5,3
2021,142090,10,0,8,5,3
2021,142090,10,1,8,5,3
2021,142090,40,0,8,5,3
2021,142090,40,1,8,5,3
2021,142090,41,0,8,5,3
2021,142090,41,1,8,5,3
2021,142090,44,0,8,5,3
2021,142090,44,1,8,5,3
2021,142115,0,0,791,396,395
2021,142115,10,0,791,396,395
2021,142115,10,1,185,112,73
2021,142115,10,2,236,118,118
2021,142115,10,3,184,92,92
2021,142115,10,4,17,8,9
2021,142115,10,5,142,55,87
2021,142115,10,6,27,11,16
2021,142115,20,0,358,205,153
2021,142115,20,1,179,109,70
2021,142115,20,2,177,95,82
2021,142115,20,3,2,1,1
2021,142115,30,0,127,67,60
2021,142115,30,2,27,13,14
2021,142115,30,3,100,54,46
2021,142115,40,0,306,124,182
2021,142115,40,1,6,3,3
2021,142115,40,2,32,10,22
2021,142115,40,3,82,37,45
2021,142115,40,4,17,8,9
2021,142115,40,5,142,55,87
2021,142115,40,6,27,11,16
2021,142115,42,0,306,124,182
2021,142115,42,1,6,3,3
2021,142115,42,2,32,10,22
2021,142115,42,3,82,37,45
2021,142115,42,4,17,8,9
2021,142115,42,5,142,55,87
2021,142115,42,6,27,11,16
2021,142179,0,0,57,27,30
2021,142179,10,0,57,27,30
2021,142179,10,4,56,26,30
2021,142179,10,6,1,1,0
2021,142179,40,0,57,27,30
2021,142179,40,4,56,26,30
2021,142179,40,6,1,1,0
2021,142179,42,0,51,27,24
2021,142179,42,4,50,26,24
2021,142179,42,6,1,1,0
2021,142179,43,0,6,0,6
2021,142179,43,4,6,0,6
2021,142276,0,0,592,304,288
2021,142276,10,0,587,301,286
2021,142276,10,1,123,80,43
2021,142276,10,2,138,66,72
2021,142276,10,3,174,76,98
2021,142276,10,4,87,52,35
2021,142276,10,5,65,27,38
2021,142276,20,0,212,127,85
2021,142276,20,1,119,80,39
2021,142276,20,2,93,47,46
2021,142276,30,0,97,44,53
2021,142276,30,1,1,0,1
2021,142276,30,2,6,4,2
2021,142276,30,3,89,40,49
2021,142276,30,4,1,0,1
2021,142276,40,0,278,130,148
2021,142276,40,1,3,0,3
2021,142276,40,2,39,15,24
2021,142276,40,3,85,36,49
2021,142276,40,4,86,52,34
2021,142276,40,5,65,27,38
2021,142276,42,0,278,130,148
2021,142276,42,1,3,0,3
2021,142276,42,2,39,15,24
2021,142276,42,3,85,36,49
2021,142276,42,4,86,52,34
2021,142276,42,5,65,27,38
2021,142276,50,0,5,3,2
2021,142285,0,0,521,331,190
2021,142285,10,0,521,331,190
2021,142285,10,1,162,121,41
2021,142285,10,2,162,102,60
2021,142285,10,3,126,72,54
2021,142285,10,4,51,22,29
2021,142285,10,6,20,14,6
2021,142285,20,0,292,206,86
2021,142285,20,1,158,119,39
2021,142285,20,2,131,86,45
2021,142285,20,3,1,0,1
2021,142285,20,4,2,1,1
2021,142285,30,0,93,52,41
2021,142285,30,2,2,2,0
2021,142285,30,3,91,50,41
2021,142285,40,0,136,73,63
2021,142285,40,1,4,2,2
2021,142285,40,2,29,14,15
2021,142285,40,3,34,22,12
2021,142285,40,4,49,21,28
2021,142285,40,6,20,14,6
2021,142285,41,0,3,1,2
2021,142285,41,2,1,0,1
2021,142285,41,3,2,1,1
2021,142285,42,0,133,72,61
2021,142285,42,1,4,2,2
2021,142285,42,2,28,14,14
2021,142285,42,3,32,21,11
2021,142285,42,4,49,21,28
2021,142285,42,6,20,14,6
2021,142285,44,0,3,1,2
2021,142285,44,2,1,0,1
2021,142285,44,3,2,1,1
2021,142294,0,0,76,46,30
2021,142294,10,0,76,46,30
2021,142294,10,1,27,17,10
2021,142294,10,2,17,7,10
2021,142294,10,3,13,9,4
2021,142294,10,4,11,9,2
2021,142294,10,5,7,3,4
2021,142294,10,6,1,1,0
2021,142294,20,0,43,23,20
2021,142294,20,1,26,16,10
2021,142294,20,2,17,7,10
2021,142294,30,0,14,10,4
2021,142294,30,1,1,1,0
2021,142294,30,3,13,9,4
2021,142294,40,0,19,13,6
2021,142294,40,4,11,9,2
2021,142294,40,5,7,3,4
2021,142294,40,6,1,1,0
2021,142294,42,0,12,8,4
2021,142294,42,4,4,4,0
2021,142294,42,5,7,3,4
2021,142294,42,6,1,1,0
2021,142294,43,0,7,5,2
2021,142294,43,4,7,5,2
2021,142328,0,0,162,68,94
2021,142328,10,0,162,68,94
2021,142328,10,1,44,25,19
2021,142328,10,2,48,17,31
2021,142328,10,3,51,19,32
2021,142328,10,4,19,7,12
2021,142328,20,0,87,33,54
2021,142328,20,1,36,19,17
2021,142328,20,2,40,13,27
2021,142328,20,3,8,1,7
2021,142328,20,4,3,0,3
2021,142328,30,0,30,10,20
2021,142328,30,2,1,1,0
2021,142328,30,3,25,7,18
2021,142328,30,4,4,2,2
2021,142328,40,0,45,25,20
2021,142328,40,1,8,6,2
2021,142328,40,2,7,3,4
2021,142328,40,3,18,11,7
2021,142328,40,4,12,5,7
2021,142328,42,0,45,25,20
2021,142328,42,1,8,6,2
2021,142328,42,2,7,3,4
2021,142328,42,3,18,11,7
2021,142328,42,4,12,5,7
2021,142443,0,0,136,76,60
2021,142443,10,0,136,76,60
2021,142443,10,1,41,21,20
2021,142443,10,2,52,33,19
2021,142443,10,3,42,21,21
2021,142443,10,6,1,1,0
2021,142443,20,0,93,55,38
2021,142443,20,1,41,21,20
2021,142443,20,2,50,32,18
2021,142443,20,3,1,1,0
2021,142443,20,6,1,1,0
2021,142443,30,0,25,12,13
2021,142443,30,3,25,12,13
2021,142443,40,0,18,9,9
2021,142443,40,2,2,1,1
2021,142443,40,3,16,8,8
2021,142443,42,0,18,9,9
2021,142443,42,2,2,1,1
2021,142443,42,3,16,8,8
2021,142461,0,0,97,48,49
2021,142461,10,0,97,48,49
2021,142461,10,1,28,20,8
2021,142461,10,2,33,15,18
2021,142461,10,3,36,13,23
2021,142461,20,0,39,24,15
2021,142461,20,1,25,18,7
2021,142461,20,2,13,6,7
2021,142461,20,3,1,0,1
2021,142461,30,0,57,24,33
2021,142461,30,1,3,2,1
2021,142461,30,2,20,9,11
2021,142461,30,3,34,13,21
2021,142461,40,0,1,0,1
2021,142461,40,3,1,0,1
2021,142461,42,0,1,0,1
2021,142461,42,3,1,0,1
2021,142522,0,0,565,466,99
2021,142522,50,0,565,466,99
2021,142559,0,0,137,64,73
2021,142559,10,0,137,64,73
2021,142559,10,1,51,21,30
2021,142559,10,2,19,10,9
2021,142559,10,3,19,13,6
2021,142559,10,4,48,20,28
2021,142559,40,0,137,64,73
2021,142559,40,1,51,21,30
2021,142559,40,2,19,10,9
2021,142559,40,3,19,13,6
2021,142559,40,4,48,20,28
2021,142559,42,0,137,64,73
2021,142559,42,1,51,21,30
2021,142559,42,2,19,10,9
2021,142559,42,3,19,13,6
2021,142559,42,4,48,20,28
2021,142832,0,0,77,24,53
2021,142832,10,0,77,24,53
2021,142832,10,1,14,4,10
2021,142832,10,2,24,8,16
2021,142832,10,3,31,10,21
2021,142832,10,6,8,2,6
2021,142832,40,0,77,24,53
2021,142832,40,1,14,4,10
2021,142832,40,2,24,8,16
2021,142832,40,3,31,10,21
2021,142832,40,6,8,2,6
2021,142832,41,0,66,21,45
2021,142832,41,1,14,4,10
2021,142832,41,2,23,8,15
2021,142832,41,3,21,7,14
2021,142832,41,6,8,2,6
2021,142832,42,0,11,3,8
2021,142832,42,2,1,0,1
2021,142832,42,3,10,3,7
2021,142832,44,0,58,19,39
2021,142832,44,1,14,4,10
2021,142832,44,2,23,8,15
2021,142832,44,3,21,7,14
2021,142832,45,0,8,2,6
2021,142832,45,6,8,2,6
2021,142887,0,0,18,11,7
2021,142887,10,0,18,11,7
2021,142887,10,4,18,11,7
2021,142887,40,0,18,11,7
2021,142887,40,4,18,11,7
2021,142887,42,0,10,6,4
2021,142887,42,4,10,6,4
2021,142887,43,0,8,5,3
2021,142887,43,4,8,5,3
2021,143048,0,0,153,83,70
2021,143048,10,0,153,83,70
2021,143048,10,1,53,30,23
2021,143048,10,2,67,40,27
2021,143048,10,3,28,11,17
2021,143048,10,6,5,2,3
2021,143048,20,0,120,70,50
2021,143048,20,1,53,30,23
2021,143048,20,2,67,40,27
2021,143048,30,0,28,11,17
2021,143048,30,3,28,11,17
2021,143048,40,0,5,2,3
2021,143048,40,6,5,2,3
2021,143048,42,0,5,2,3
2021,143048,42,6,5,2,3
2021,143084,0,0,197,100,97
2021,143084,10,0,197,100,97
2021,143084,10,1,67,41,26
2021,143084,10,2,49,24,25
2021,143084,10,3,33,12,21
2021,143084,10,4,48,23,25
2021,143084,20,0,116,65,51
2021,143084,20,1,67,41,26
2021,143084,20,2,49,24,25
2021,143084,30,0,33,12,21
2021,143084,30,3,33,12,21
2021,143084,40,0,48,23,25
2021,143084,40,4,48,23,25
2021,143084,42,0,48,23,25
2021,143084,42,4,48,23,25
2021,143118,0,0,136,52,84
2021,143118,10,0,136,52,84
2021,143118,10,1,19,9,10
2021,143118,10,2,44,20,24
2021,143118,10,3,56,17,39
2021,143118,10,5,17,6,11
2021,143118,20,0,54,25,29
2021,143118,20,1,18,8,10
2021,143118,20,2,36,17,19
2021,143118,30,0,18,8,10
2021,143118,30,3,18,8,10
2021,143118,40,0,64,19,45
2021,143118,40,1,1,1,0
2021,143118,40,2,8,3,5
2021,143118,40,3,38,9,29
2021,143118,40,5,17,6,11
2021,143118,42,0,64,19,45
2021,143118,42,1,1,1,0
2021,143118,42,2,8,3,5
2021,143118,42,3,38,9,29
2021,143118,42,5,17,6,11
2021,143215,0,0,131,59,72
2021,143215,10,0,131,59,72
2021,143215,10,1,57,25,32
2021,143215,10,2,34,18,16
2021,143215,10,3,24,5,19
2021,143215,10,4,16,11,5
2021,143215,20,0,80,40,40
2021,143215,20,1,57,25,32
2021,143215,20,2,21,13,8
2021,143215,20,4,2,2,0
2021,143215,30,0,51,19,32
2021,143215,30,2,13,5,8
2021,143215,30,3,24,5,19
2021,143215,30,4,14,9,5
2021,143233,0,0,8,5,3
2021,143233,10,0,8,5,3
2021,143233,10,1,5,4,1
2021,143233,10,2,1,0,1
2021,143233,10,3,2,1,1
2021,143233,20,0,6,4,2
2021,143233,20,1,5,4,1
2021,143233,20,2,1,0,1
2021,143233,30,0,2,1,1
2021,143233,30,3,2,1,1
2021,143279,0,0,92,35,57
2021,143279,10,0,92,35,57
2021,143279,10,1,43,17,26
2021,143279,10,2,14,4,10
2021,143279,10,3,10,4,6
2021,143279,10,4,25,10,15
2021,143279,20,0,73,28,45
2021,143279,20,1,43,17,26
2021,143279,20,2,14,4,10
2021,143279,20,3,10,4,6
2021,143279,20,4,6,3,3
2021,143279,30,0,13,6,7
2021,143279,30,4,13,6,7
2021,143279,40,0,6,1,5
2021,143279,40,4,6,1,5
2021,143279,42,0,6,1,5
2021,143279,42,4,6,1,5
2021,143288,0,0,35,17,18
2021,143288,10,0,35,17,18
2021,143288,10,1,35,17,18
2021,143288,20,0,21,11,10
2021,143288,20,1,21,11,10
2021,143288,30,0,12,6,6
2021,143288,30,1,12,6,6
2021,143288,40,0,2,0,2
2021,143288,40,1,2,0,2
2021,143288,42,0,2,0,2
2021,143288,42,1,2,0,2
2021,143297,0,0,34,2,32
2021,143297,10,0,34,2,32
2021,143297,10,1,2,0,2
2021,143297,10,2,6,0,6
2021,143297,10,3,22,2,20
2021,143297,10,4,4,0,4
2021,143297,40,0,34,2,32
2021,143297,40,1,2,0,2
2021,143297,40,2,6,0,6
2021,143297,40,3,22,2,20
2021,143297,40,4,4,0,4
2021,143297,42,0,34,2,32
2021,143297,42,1,2,0,2
2021,143297,42,2,6,0,6
2021,143297,42,3,22,2,20
2021,143297,42,4,4,0,4
2021,143358,0,0,319,184,135
2021,143358,10,0,319,184,135
2021,143358,10,1,79,63,16
2021,143358,10,2,88,54,34
2021,143358,10,3,108,45,63
2021,143358,10,4,29,18,11
2021,143358,10,5,14,4,10
2021,143358,10,6,1,0,1
2021,143358,20,0,164,110,54
2021,143358,20,1,78,62,16
2021,143358,20,2,78,45,33
2021,143358,20,3,3,2,1
2021,143358,20,5,5,1,4
2021,143358,30,0,74,44,30
2021,143358,30,1,1,1,0
2021,143358,30,2,10,9,1
2021,143358,30,3,56,30,26
2021,143358,30,4,1,1,0
2021,143358,30,5,6,3,3
2021,143358,40,0,81,30,51
2021,143358,40,3,49,13,36
2021,143358,40,4,28,17,11
2021,143358,40,5,3,0,3
2021,143358,40,6,1,0,1
2021,143358,42,0,81,30,51
2021,143358,42,3,49,13,36
2021,143358,42,4,28,17,11
2021,143358,42,5,3,0,3
2021,143358,42,6,1,0,1
2021,143613,0,0,39,16,23
2021,143613,10,0,39,16,23
2021,143613,10,6,39,16,23
2021,143613,20,0,28,11,17
2021,143613,20,6,28,11,17
2021,143613,30,0,11,5,6
2021,143613,30,6,11,5,6
2021,143659,0,0,22,13,9
2021,143659,10,0,22,13,9
2021,143659,10,1,10,7,3
2021,143659,10,2,5,3,2
2021,143659,10,3,7,3,4
2021,143659,20,0,14,10,4
2021,143659,20,1,10,7,3
2021,143659,20,2,4,3,1
2021,143659,30,0,8,3,5
2021,143659,30,2,1,0,1
2021,143659,30,3,7,3,4
2021,143853,0,0,210,84,126
2021,143853,10,0,206,83,123
2021,143853,10,1,38,14,24
2021,143853,10,2,60,23,37
2021,143853,10,3,103,45,58
2021,143853,10,4,5,1,4
2021,143853,20,0,69,29,40
2021,143853,20,1,35,14,21
2021,143853,20,2,33,15,18
2021,143853,20,3,1,0,1
2021,143853,30,0,35,12,23
2021,143853,30,2,7,0,7
2021,143853,30,3,28,12,16
2021,143853,40,0,102,42,60
2021,143853,40,1,3,0,3
2021,143853,40,2,20,8,12
2021,143853,40,3,74,33,41
2021,143853,40,4,5,1,4
2021,143853,41,0,102,42,60
2021,143853,41,1,3,0,3
2021,143853,41,2,20,8,12
2021,143853,41,3,74,33,41
2021,143853,41,4,5,1,4
2021,143853,44,0,102,42,60
2021,143853,44,1,3,0,3
2021,143853,44,2,20,8,12
2021,143853,44,3,74,33,41
2021,143853,44,4,5,1,4
2021,143853,50,0,4,1,3
2021,143978,0,0,59,20,39
2021,143978,10,0,59,20,39
2021,143978,10,1,17,7,10
2021,143978,10,2,28,8,20
2021,143978,10,3,14,5,9
2021,143978,40,0,59,20,39
2021,143978,40,1,17,7,10
2021,143978,40,2,28,8,20
2021,143978,40,3,14,5,9
2021,143978,41,0,59,20,39
2021,143978,41,1,17,7,10
2021,143978,41,2,28,8,20
2021,143978,41,3,14,5,9
2021,143978,44,0,59,20,39
2021,143978,44,1,17,7,10
2021,143978,44,2,28,8,20
2021,143978,44,3,14,5,9
2021,144005,0,0,155,75,80
2021,144005,10,0,155,75,80
2021,144005,10,1,41,24,17
2021,144005,10,2,45,21,24
2021,144005,10,3,48,21,27
2021,144005,10,5,21,9,12
2021,144005,20,0,86,46,40
2021,144005,20,1,41,24,17
2021,144005,20,2,39,19,20
2021,144005,20,3,6,3,3
2021,144005,30,0,46,21,25
2021,144005,30,2,3,2,1
2021,144005,30,3,42,18,24
2021,144005,30,5,1,1,0
2021,144005,40,0,23,8,15
2021,144005,40,2,3,0,3
2021,144005,40,5,20,8,12
2021,144005,42,0,23,8,15
2021,144005,42,2,3,0,3
2021,144005,42,5,20,8,12
2021,144014,0,0,10,6,4
2021,144014,10,0,10,6,4
2021,144014,10,1,4,2,2
2021,144014,10,2,4,3,1
2021,144014,10,3,2,1,1
2021,144014,20,0,8,5,3
2021,144014,20,1,4,2,2
2021,144014,20,2,4,3,1
2021,144014,30,0,1,1,0
2021,144014,30,3,1,1,0
2021,144014,40,0,1,0,1
2021,144014,40,3,1,0,1
2021,144014,41,0,1,0,1
2021,144014,41,3,1,0,1
2021,144014,44,0,1,0,1
2021,144014,44,3,1,0,1
2021,144050,0,0,2579,1554,1025
2021,144050,10,0,2579,1554,1025
2021,144050,10,1,886,661,225
2021,144050,10,2,487,278,209
2021,144050,10,3,609,323,286
2021,144050,10,4,103,58,45
2021,144050,10,5,396,183,213
2021,144050,10,6,98,51,47
2021,144050,20,0,868,633,235
2021,144050,20,1,663,504,159
2021,144050,20,2,205,129,76
2021,144050,30,0,321,188,133
2021,144050,30,2,35,23,12
2021,144050,30,3,286,165,121
2021,144050,40,0,1390,733,657
2021,144050,40,1,223,157,66
2021,144050,40,2,247,126,121
2021,144050,40,3,323,158,165
2021,144050,40,4,103,58,45
2021,144050,40,5,396,183,213
2021,144050,40,6,98,51,47
2021,144050,41,0,1256,657,599
2021,144050,41,1,216,151,65
2021,144050,41,2,243,124,119
2021,144050,41,3,318,153,165
2021,144050,41,4,78,46,32
2021,144050,41,5,310,137,173
2021,144050,41,6,91,46,45
2021,144050,42,0,114,61,53
2021,144050,42,1,1,1,0
2021,144050,42,3,2,2,0
2021,144050,42,4,24,11,13
2021,144050,42,5,82,44,38
2021,144050,42,6,5,3,2
2021,144050,43,0,20,15,5
2021,144050,43,1,6,5,1
2021,144050,43,2,4,2,2
2021,144050,43,3,3,3,0
2021,144050,43,4,1,1,0
2021,144050,43,5,4,2,2
2021,144050,43,6,2,2,0
2021,144050,44,0,1242,646,596
2021,144050,44,1,213,148,65
2021,144050,44,2,243,124,119
2021,144050,44,3,318,153,165
2021,144050,44,4,78,46,32
2021,144050,44,5,299,129,170
2021,144050,44,6,91,46,45
2021,144050,45,0,14,11,3
2021,144050,45,1,3,3,0
2021,144050,45,5,11,8,3
2021,144157,0,0,64,30,34
2021,144157,10,0,64,30,34
2021,144157,10,1,3,1,2
2021,144157,10,2,13,3,10
2021,144157,10,3,20,7,13
2021,144157,10,4,20,14,6
2021,144157,10,6,8,5,3
2021,144157,20,0,50,21,29
2021,144157,20,1,3,1,2
2021,144157,20,2,13,3,10
2021,144157,20,3,20,7,13
2021,144157,20,4,14,10,4
2021,144157,30,0,6,4,2
2021,144157,30,4,6,4,2
2021,144157,40,0,8,5,3
2021,144157,40,6,8,5,3
2021,144157,42,0,8,5,3
2021,144157,42,6,8,5,3
2021,144166,0,0,116,34,82
2021,144166,10,0,116,34,82
2021,144166,10,1,5,1,4
2021,144166,10,2,9,2,7
2021,144166,10,3,35,8,27
2021,144166,10,4,67,23,44
2021,144166,20,0,88,26,62
2021,144166,20,1,5,1,4
2021,144166,20,2,8,2,6
2021,144166,20,3,35,8,27
2021,144166,20,4,40,15,25
2021,144166,30,0,28,8,20
2021,144166,30,2,1,0,1
2021,144166,30,4,27,8,19
2021,144175,0,0,40,17,23
2021,144175,10,0,40,17,23
2021,144175,10,1,4,2,2
2021,144175,10,2,13,4,9
2021,144175,10,3,15,3,12
2021,144175,10,4,8,8,0
2021,144175,20,0,40,17,23
2021,144175,20,1,4,2,2
2021,144175,20,2,13,4,9
2021,144175,20,3,15,3,12
2021,144175,20,4,8,8,0
2021,144184,0,0,62,31,31
2021,144184,10,0,62,31,31
2021,144184,10,1,5,4,1
2021,144184,10,2,13,5,8
2021,144184,10,3,12,7,5
2021,144184,10,4,29,14,15
2021,144184,10,6,3,1,2
2021,144184,20,0,54,28,26
2021,144184,20,1,5,4,1
2021,144184,20,2,13,5,8
2021,144184,20,3,12,7,5
2021,144184,20,4,24,12,12
2021,144184,30,0,5,2,3
2021,144184,30,4,5,2,3
2021,144184,40,0,3,1,2
2021,144184,40,6,3,1,2
2021,144184,42,0,3,1,2
2021,144184,42,6,3,1,2
2021,144193,0,0,52,25,27
2021,144193,10,0,52,25,27
2021,144193,10,1,4,1,3
2021,144193,10,2,11,4,7
2021,144193,10,3,11,6,5
2021,144193,10,4,26,14,12
2021,144193,20,0,46,21,25
2021,144193,20,1,4,1,3
2021,144193,20,2,11,4,7
2021,144193,20,3,11,6,5
2021,144193,20,4,20,10,10
2021,144193,30,0,6,4,2
2021,144193,30,4,6,4,2
2021,144209,0,0,99,42,57
2021,144209,10,0,99,42,57
2021,144209,10,1,14,8,6
2021,144209,10,2,29,8,21
2021,144209,10,3,35,17,18
2021,144209,10,4,21,9,12
2021,144209,20,0,95,41,54
2021,144209,20,1,14,8,6
2021,144209,20,2,29,8,21
2021,144209,20,3,35,17,18
2021,144209,20,4,17,8,9
2021,144209,30,0,4,1,3
2021,144209,30,4,4,1,3
2021,144218,0,0,80,36,44
2021,144218,10,0,80,36,44
2021,144218,10,1,19,5,14
2021,144218,10,2,30,12,18
2021,144218,10,3,18,10,8
2021,144218,10,4,13,9,4
2021,144218,20,0,78,35,43
2021,144218,20,1,19,5,14
2021,144218,20,2,30,12,18
2021,144218,20,3,18,10,8
2021,144218,20,4,11,8,3
2021,144218,30,0,2,1,1
2021,144218,30,4,2,1,1
2021,144281,0,0,246,135,111
2021,144281,10,0,246,135,111
2021,144281,10,1,39,22,17
2021,144281,10,2,129,74,55
2021,144281,10,3,27,14,13
2021,144281,10,5,51,25,26
2021,144281,20,0,168,96,72
2021,144281,20,1,39,22,17
2021,144281,20,2,129,74,55
2021,144281,30,0,27,14,13
2021,144281,30,3,27,14,13
2021,144281,40,0,51,25,26
2021,144281,40,5,51,25,26
2021,144281,42,0,51,25,26
2021,144281,42,5,51,25,26
2021,144351,0,0,267,122,145
2021,144351,10,0,267,122,145
2021,144351,10,1,38,21,17
2021,144351,10,2,40,12,28
2021,144351,10,3,22,6,16
2021,144351,10,4,167,83,84
2021,144351,20,0,32,17,15
2021,144351,20,1,29,15,14
2021,144351,20,2,3,2,1
2021,144351,30,0,49,18,31
2021,144351,30,1,8,6,2
2021,144351,30,2,27,7,20
2021,144351,30,3,14,5,9
2021,144351,40,0,186,87,99
2021,144351,40,1,1,0,1
2021,144351,40,2,10,3,7
2021,144351,40,3,8,1,7
2021,144351,40,4,167,83,84
2021,144351,41,0,1,0,1
2021,144351,41,3,1,0,1
2021,144351,42,0,19,4,15
2021,144351,42,1,1,0,1
2021,144351,42,2,10,3,7
2021,144351,42,3,7,1,6
2021,144351,42,4,1,0,1
2021,144351,43,0,166,83,83
2021,144351,43,4,166,83,83
2021,144351,44,0,1,0,1
2021,144351,44,3,1,0,1
2021,144564,0,0,59,25,34
2021,144564,10,0,59,25,34
2021,144564,10,1,22,9,13
2021,144564,10,4,25,12,13
2021,144564,10,6,12,4,8
2021,144564,20,0,39,17,22
2021,144564,20,1,18,9,9
2021,144564,20,4,13,5,8
2021,144564,20,6,8,3,5
2021,144564,30,0,18,7,11
2021,144564,30,1,4,0,4
2021,144564,30,4,12,7,5
2021,144564,30,6,2,0,2
2021,144564,40,0,2,1,1
2021,144564,40,6,2,1,1
2021,144564,43,0,2,1,1
2021,144564,43,6,2,1,1
2021,144740,0,0,862,454,408
2021,144740,10,0,862,454,408
2021,144740,10,1,208,125,83
2021,144740,10,2,331,171,160
2021,144740,10,3,103,50,53
2021,144740,10,4,220,108,112
2021,144740,20,0,536,297,239
2021,144740,20,1,208,125,83
2021,144740,20,2,327,171,156
2021,144740,20,3,1,1,0
2021,144740,30,0,103,48,55
2021,144740,30,2,3,0,3
2021,144740,30,3,100,48,52
2021,144740,40,0,223,109,114
2021,144740,40,2,1,0,1
2021,144740,40,3,2,1,1
2021,144740,40,4,220,108,112
2021,144740,41,0,58,24,34
2021,144740,41,2,1,0,1
2021,144740,41,4,57,24,33
2021,144740,42,0,165,85,80
2021,144740,42,3,2,1,1
2021,144740,42,4,163,84,79
2021,144740,44,0,58,24,34
2021,144740,44,2,1,0,1
2021,144740,44,4,57,24,33
2021,144865,0,0,256,121,135
2021,144865,10,0,256,121,135
2021,144865,10,1,123,62,61
2021,144865,10,2,67,35,32
2021,144865,10,3,50,18,32
2021,144865,10,4,16,6,10
2021,144865,20,0,251,119,132
2021,144865,20,1,123,62,61
2021,144865,20,2,67,35,32
2021,144865,20,3,49,18,31
2021,144865,20,4,12,4,8
2021,144865,40,0,5,2,3
2021,144865,40,3,1,0,1
2021,144865,40,4,4,2,2
2021,144865,42,0,5,2,3
2021,144865,42,3,1,0,1
2021,144865,42,4,4,2,2
2021,144883,0,0,9,5,4
2021,144883,10,0,9,5,4
2021,144883,10,2,3,0,3
2021,144883,10,3,6,5,1
2021,144883,40,0,9,5,4
2021,144883,40,2,3,0,3
2021,144883,40,3,6,5,1
2021,144883,42,0,9,5,4
2021,144883,42,2,3,0,3
2021,144883,42,3,6,5,1
2021,144892,0,0,389,195,194
2021,144892,10,0,389,195,194
2021,144892,10,1,138,76,62
2021,144892,10,2,72,39,33
2021,144892,10,3,59,24,35
2021,144892,10,4,120,56,64
2021,144892,20,0,211,115,96
2021,144892,20,1,138,76,62
2021,144892,20,2,72,39,33
2021,144892,20,3,1,0,1
2021,144892,30,0,57,26,31
2021,144892,30,3,55,24,31
2021,144892,30,4,2,2,0
2021,144892,40,0,121,54,67
2021,144892,40,3,3,0,3
2021,144892,40,4,118,54,64
2021,144892,41,0,32,12,20
2021,144892,41,4,32,12,20
2021,144892,42,0,71,32,39
2021,144892,42,3,3,0,3
2021,144892,42,4,68,32,36
2021,144892,43,0,18,10,8
2021,144892,43,4,18,10,8
2021,144892,44,0,32,12,20
2021,144892,44,4,32,12,20
2021,144944,0,0,136,70,66
2021,144944,10,0,136,70,66
2021,144944,10,1,57,28,29
2021,144944,10,2,31,20,11
2021,144944,10,3,23,11,12
2021,144944,10,4,25,11,14
2021,144944,20,0,97,52,45
2021,144944,20,1,56,27,29
2021,144944,20,2,29,19,10
2021,144944,20,3,9,5,4
2021,144944,20,4,3,1,2
2021,144944,30,0,38,17,21
2021,144944,30,1,1,1,0
2021,144944,30,2,2,1,1
2021,144944,30,3,14,6,8
2021,144944,30,4,21,9,12
2021,144944,40,0,1,1,0
2021,144944,40,4,1,1,0
2021,144944,42,0,1,1,0
2021,144944,42,4,1,1,0
2021,144962,0,0,165,63,102
2021,144962,10,0,165,63,102
2021,144962,10,1,54,22,32
2021,144962,10,2,32,12,20
2021,144962,10,3,55,20,35
2021,144962,10,4,1,1,0
2021,144962,10,5,19,7,12
2021,144962,10,6,4,1,3
2021,144962,20,0,82,33,49
2021,144962,20,1,54,22,32
2021,144962,20,2,26,10,16
2021,144962,20,3,2,1,1
2021,144962,30,0,36,14,22
2021,144962,30,2,1,0,1
2021,144962,30,3,33,12,21
2021,144962,30,5,1,1,0
2021,144962,30,6,1,1,0
2021,144962,40,0,47,16,31
2021,144962,40,2,5,2,3
2021,144962,40,3,20,7,13
2021,144962,40,4,1,1,0
2021,144962,40,5,18,6,12
2021,144962,40,6,3,0,3
2021,144962,42,0,47,16,31
2021,144962,42,2,5,2,3
2021,144962,42,3,20,7,13
2021,144962,42,4,1,1,0
2021,144962,42,5,18,6,12
2021,144962,42,6,3,0,3
2021,144971,0,0,33,17,16
2021,144971,10,0,33,17,16
2021,144971,10,1,6,4,2
2021,144971,10,2,13,6,7
2021,144971,10,3,14,7,7
2021,144971,20,0,15,8,7
2021,144971,20,1,6,4,2
2021,144971,20,2,9,4,5
2021,144971,30,0,12,6,6
2021,144971,30,2,1,1,0
2021,144971,30,3,11,5,6
2021,144971,40,0,6,3,3
2021,144971,40,2,3,1,2
2021,144971,40,3,3,2,1
2021,144971,42,0,6,3,3
2021,144971,42,2,3,1,2
2021,144971,42,3,3,2,1
2021,145239,0,0,26,1,25
2021,145239,10,0,26,1,25
2021,145239,10,4,26,1,25
2021,145239,40,0,26,1,25
2021,145239,40,4,26,1,25
2021,145239,41,0,26,1,25
2021,145239,41,4,26,1,25
2021,145239,45,0,26,1,25
2021,145239,45,4,26,1,25
2021,145275,0,0,29,17,12
2021,145275,10,0,29,17,12
2021,145275,10,1,13,8,5
2021,145275,10,2,9,5,4
2021,145275,10,3,5,2,3
2021,145275,10,4,2,2,0
2021,145275,20,0,14,7,7
2021,145275,20,1,11,6,5
2021,145275,20,2,3,1,2
2021,145275,30,0,2,2,0
2021,145275,30,3,2,2,0
2021,145275,40,0,13,8,5
2021,145275,40,1,2,2,0
2021,145275,40,2,6,4,2
2021,145275,40,3,3,0,3
2021,145275,40,4,2,2,0
2021,145275,41,0,13,8,5
2021,145275,41,1,2,2,0
2021,145275,41,2,6,4,2
2021,145275,41,3,3,0,3
2021,145275,41,4,2,2,0
2021,145275,44,0,13,8,5
2021,145275,44,1,2,2,0
2021,145275,44,2,6,4,2
2021,145275,44,3,3,0,3
2021,145275,44,4,2,2,0
2021,145336,0,0,246,104,142
2021,145336,10,0,246,104,142
2021,145336,10,1,32,18,14
2021,145336,10,2,65,28,37
2021,145336,10,3,75,25,50
2021,145336,10,4,1,0,1
2021,145336,10,5,56,23,33
2021,145336,10,6,17,10,7
2021,145336,20,0,73,38,35
2021,145336,20,1,32,18,14
2021,145336,20,2,41,20,21
2021,145336,30,0,100,33,67
2021,145336,30,2,24,8,16
2021,145336,30,3,75,25,50
2021,145336,30,4,1,0,1
2021,145336,40,0,73,33,40
2021,145336,40,5,56,23,33
2021,145336,40,6,17,10,7
2021,145336,42,0,69,32,37
2021,145336,42,5,55,23,32
2021,145336,42,6,14,9,5
2021,145336,43,0,4,1,3
2021,145336,43,5,1,0,1
2021,145336,43,6,3,1,2
2021,145372,0,0,51,30,21
2021,145372,10,0,51,30,21
2021,145372,10,1,10,8,2
2021,145372,10,2,12,8,4
2021,145372,10,3,22,11,11
2021,145372,10,4,7,3,4
2021,145372,20,0,22,16,6
2021,145372,20,1,10,8,2
2021,145372,20,2,9,6,3
2021,145372,20,3,3,2,1
2021,145372,30,0,19,9,10
2021,145372,30,2,2,1,1
2021,145372,30,3,17,8,9
2021,145372,40,0,10,5,5
2021,145372,40,2,1,1,0
2021,145372,40,3,2,1,1
2021,145372,40,4,7,3,4
2021,145372,42,0,10,5,5
2021,145372,42,2,1,1,0
2021,145372,42,3,2,1,1
2021,145372,42,4,7,3,4
2021,145497,0,0,14,10,4
2021,145497,10,0,14,10,4
2021,145497,10,1,1,1,0
2021,145497,10,2,4,1,3
2021,145497,10,3,9,8,1
2021,145497,40,0,14,10,4
2021,145497,40,1,1,1,0
2021,145497,40,2,4,1,3
2021,145497,40,3,9,8,1
2021,145497,42,0,14,10,4
2021,145497,42,1,1,1,0
2021,145497,42,2,4,1,3
2021,145497,42,3,9,8,1
2021,145521,0,0,48,23,25
2021,145521,10,0,48,23,25
2021,145521,10,6,48,23,25
2021,145521,20,0,38,18,20
2021,145521,20,6,38,18,20
2021,145521,30,0,10,5,5
2021,145521,30,6,10,5,5
2021,145558,0,0,171,90,81
2021,145558,10,0,169,90,79
2021,145558,10,1,39,26,13
2021,145558,10,2,59,33,26
2021,145558,10,3,58,28,30
2021,145558,10,4,11,3,8
2021,145558,10,5,2,0,2
2021,145558,20,0,35,24,11
2021,145558,20,1,32,22,10
2021,145558,20,2,3,2,1
2021,145558,30,0,62,36,26
2021,145558,30,1,3,2,1
2021,145558,30,2,35,23,12
2021,145558,30,3,18,10,8
2021,145558,30,4,6,1,5
2021,145558,40,0,72,30,42
2021,145558,40,1,4,2,2
2021,145558,40,2,21,8,13
2021,145558,40,3,40,18,22
2021,145558,40,4,5,2,3
2021,145558,40,5,2,0,2
2021,145558,41,0,22,11,11
2021,145558,41,1,1,1,0
2021,145558,41,2,12,5,7
2021,145558,41,3,8,5,3
2021,145558,41,4,1,0,1
2021,145558,42,0,50,19,31
2021,145558,42,1,3,1,2
2021,145558,42,2,9,3,6
2021,145558,42,3,32,13,19
2021,145558,42,4,4,2,2
2021,145558,42,5,2,0,2
2021,145558,44,0,22,11,11
2021,145558,44,1,1,1,0
2021,145558,44,2,12,5,7
2021,145558,44,3,8,5,3
2021,145558,44,4,1,0,1
2021,145558,50,0,2,0,2
2021,145600,0,0,2261,1149,1112
2021,145600,10,0,2261,1149,1112
2021,145600,10,1,559,366,193
2021,145600,10,2,623,316,307
2021,145600,10,3,748,340,408
2021,145600,10,4,136,42,94
2021,145600,10,5,185,84,101
2021,145600,10,6,10,1,9
2021,145600,20,0,926,564,362
2021,145600,20,1,487,331,156
2021,145600,20,2,437,232,205
2021,145600,20,3,2,1,1
2021,145600,30,0,409,218,191
2021,145600,30,1,14,10,4
2021,145600,30,2,55,24,31
2021,145600,30,3,340,184,156
2021,145600,40,0,926,367,559
2021,145600,40,1,58,25,33
2021,145600,40,2,131,60,71
2021,145600,40,3,406,155,251
2021,145600,40,4,136,42,94
2021,145600,40,5,185,84,101
2021,145600,40,6,10,1,9
2021,145600,41,0,321,139,182
2021,145600,41,1,32,12,20
2021,145600,41,2,85,37,48
2021,145600,41,3,118,48,70
2021,145600,41,4,10,0,10
2021,145600,41,5,75,41,34
2021,145600,41,6,1,1,0
2021,145600,42,0,605,228,377
2021,145600,42,1,26,13,13
2021,145600,42,2,46,23,23
2021,145600,42,3,288,107,181
2021,145600,42,4,126,42,84
2021,145600,42,5,110,43,67
2021,145600,42,6,9,0,9
2021,145600,44,0,321,139,182
2021,145600,44,1,32,12,20
2021,145600,44,2,85,37,48
2021,145600,44,3,118,48,70
2021,145600,44,4,10,0,10
2021,145600,44,5,75,41,34
2021,145600,44,6,1,1,0
2021,145619,0,0,129,61,68
2021,145619,10,0,129,61,68
2021,145619,10,1,46,25,21
2021,145619,10,2,34,16,18
2021,145619,10,3,37,15,22
2021,145619,10,4,12,5,7
2021,145619,20,0,74,38,36
2021,145619,20,1,45,25,20
2021,145619,20,2,29,13,16
2021,145619,30,0,27,10,17
2021,145619,30,2,2,1,1
2021,145619,30,3,25,9,16
2021,145619,40,0,28,13,15
2021,145619,40,1,1,0,1
2021,145619,40,2,3,2,1
2021,145619,40,3,12,6,6
2021,145619,40,4,12,5,7
2021,145619,42,0,28,13,15
2021,145619,42,1,1,0,1
2021,145619,42,2,3,2,1
2021,145619,42,3,12,6,6
2021,145619,42,4,12,5,7
2021,145628,0,0,52,12,40
2021,145628,10,0,51,12,39
2021,145628,10,1,6,2,4
2021,145628,10,2,27,7,20
2021,145628,10,3,18,3,15
2021,145628,20,0,33,9,24
2021,145628,20,1,6,2,4
2021,145628,20,2,27,7,20
2021,145628,30,0,18,3,15
2021,145628,30,3,18,3,15
2021,145628,50,0,1,0,1
2021,145637,0,0,2423,1443,980
2021,145637,10,0,2423,1443,980
2021,145637,10,1,865,621,244
2021,145637,10,2,567,312,255
2021,145637,10,3,688,358,330
2021,145637,10,4,88,42,46
2021,145637,10,5,185,95,90
2021,145637,10,6,30,15,15
2021,145637,20,0,1324,878,446
2021,145637,20,1,831,606,225
2021,145637,20,2,474,266,208
2021,145637,20,3,19,6,13
2021,145637,30,0,466,261,205
2021,145637,30,1,1,1,0
2021,145637,30,2,3,2,1
2021,145637,30,3,462,258,204
2021,145637,40,0,633,304,329
2021,145637,40,1,33,14,19
2021,145637,40,2,90,44,46
2021,145637,40,3,207,94,113
2021,145637,40,4,88,42,46
2021,145637,40,5,185,95,90
2021,145637,40,6,30,15,15
2021,145637,41,0,149,84,65
2021,145637,41,1,26,9,17
2021,145637,41,2,59,33,26
2021,145637,41,3,49,34,15
2021,145637,41,4,1,1,0
2021,145637,41,5,14,7,7
2021,145637,42,0,484,220,264
2021,145637,42,1,7,5,2
2021,145637,42,2,31,11,20
2021,145637,42,3,158,60,98
2021,145637,42,4,87,41,46
2021,145637,42,5,171,88,83
2021,145637,42,6,30,15,15
2021,145637,44,0,149,84,65
2021,145637,44,1,26,9,17
2021,145637,44,2,59,33,26
2021,145637,44,3,49,34,15
2021,145637,44,4,1,1,0
2021,145637,44,5,14,7,7
2021,145646,0,0,110,63,47
2021,145646,10,0,110,63,47
2021,145646,10,1,39,30,9
2021,145646,10,2,44,21,23
2021,145646,10,3,22,9,13
2021,145646,10,4,5,3,2
2021,145646,20,0,83,51,32
2021,145646,20,1,38,29,9
2021,145646,20,2,43,21,22
2021,145646,20,3,2,1,1
2021,145646,30,0,17,6,11
2021,145646,30,3,15,5,10
2021,145646,30,4,2,1,1
2021,145646,40,0,10,6,4
2021,145646,40,1,1,1,0
2021,145646,40,2,1,0,1
2021,145646,40,3,5,3,2
2021,145646,40,4,3,2,1
2021,145646,42,0,10,6,4
2021,145646,42,1,1,1,0
2021,145646,42,2,1,0,1
2021,145646,42,3,5,3,2
2021,145646,42,4,3,2,1
2021,145682,0,0,154,72,82
2021,145682,10,0,154,72,82
2021,145682,10,1,103,46,57
2021,145682,10,2,15,7,8
2021,145682,10,3,19,14,5
2021,145682,10,4,16,5,11
2021,145682,10,6,1,0,1
2021,145682,20,0,135,66,69
2021,145682,20,1,103,46,57
2021,145682,20,2,15,7,8
2021,145682,20,3,17,13,4
2021,145682,30,0,18,6,12
2021,145682,30,3,2,1,1
2021,145682,30,4,16,5,11
2021,145682,40,0,1,0,1
2021,145682,40,6,1,0,1
2021,145682,42,0,1,0,1
2021,145682,42,6,1,0,1
2021,145691,0,0,75,34,41
2021,145691,10,0,75,34,41
2021,145691,10,1,21,12,9
2021,145691,10,2,16,11,5
2021,145691,10,3,29,8,21
2021,145691,10,4,9,3,6
2021,145691,20,0,36,23,13
2021,145691,20,1,21,12,9
2021,145691,20,2,15,11,4
2021,145691,30,0,17,6,11
2021,145691,30,3,15,5,10
2021,145691,30,4,2,1,1
2021,145691,40,0,22,5,17
2021,145691,40,2,1,0,1
2021,145691,40,3,14,3,11
2021,145691,40,4,7,2,5
2021,145691,41,0,21,5,16
2021,145691,41,2,1,0,1
2021,145691,41,3,13,3,10
2021,145691,41,4,7,2,5
2021,145691,42,0,1,0,1
2021,145691,42,3,1,0,1
2021,145691,44,0,21,5,16
2021,145691,44,2,1,0,1
2021,145691,44,3,13,3,10
2021,145691,44,4,7,2,5
2021,145707,0,0,41,13,28
2021,145707,10,0,41,13,28
2021,145707,10,1,6,3,3
2021,145707,10,2,5,1,4
2021,145707,10,3,11,5,6
2021,145707,10,4,19,4,15
2021,145707,20,0,25,11,14
2021,145707,20,1,6,3,3
2021,145707,20,2,5,1,4
2021,145707,20,3,11,5,6
2021,145707,20,4,3,2,1
2021,145707,30,0,15,2,13
2021,145707,30,4,15,2,13
2021,145707,40,0,1,0,1
2021,145707,40,4,1,0,1
2021,145707,43,0,1,0,1
2021,145707,43,4,1,0,1
2021,145725,0,0,389,276,113
2021,145725,10,0,389,276,113
2021,145725,10,1,162,126,36
2021,145725,10,2,99,70,29
2021,145725,10,3,57,39,18
2021,145725,10,4,10,6,4
2021,145725,10,5,53,29,24
2021,145725,10,6,8,6,2
2021,145725,20,0,210,161,49
2021,145725,20,1,130,106,24
2021,145725,20,2,80,55,25
2021,145725,30,0,43,31,12
2021,145725,30,2,5,2,3
2021,145725,30,3,38,29,9
2021,145725,40,0,136,84,52
2021,145725,40,1,32,20,12
2021,145725,40,2,14,13,1
2021,145725,40,3,19,10,9
2021,145725,40,4,10,6,4
2021,145725,40,5,53,29,24
2021,145725,40,6,8,6,2
2021,145725,42,0,136,84,52
2021,145725,42,1,32,20,12
2021,145725,42,2,14,13,1
2021,145725,42,3,19,10,9
2021,145725,42,4,10,6,4
2021,145725,42,5,53,29,24
2021,145725,42,6,8,6,2
2021,145813,0,0,878,408,470
2021,145813,10,0,878,408,470
2021,145813,10,1,267,156,111
2021,145813,10,2,215,113,102
2021,145813,10,3,163,69,94
2021,145813,10,5,233,70,163
2021,145813,20,0,479,267,212
2021,145813,20,1,267,156,111
2021,145813,20,2,210,110,100
2021,145813,20,3,2,1,1
2021,145813,30,0,166,71,95
2021,145813,30,2,5,3,2
2021,145813,30,3,161,68,93
2021,145813,40,0,233,70,163
2021,145813,40,5,233,70,163
2021,145813,42,0,219,68,151
2021,145813,42,5,219,68,151
2021,145813,43,0,14,2,12
2021,145813,43,5,14,2,12
2021,145831,0,0,72,34,38
2021,145831,10,0,72,34,38
2021,145831,10,4,72,34,38
2021,145831,20,0,56,27,29
2021,145831,20,4,56,27,29
2021,145831,30,0,16,7,9
2021,145831,30,4,16,7,9
2021,146205,0,0,66,28,38
2021,146205,10,0,66,28,38
2021,146205,10,1,16,6,10
2021,146205,10,2,6,2,4
2021,146205,10,3,21,9,12
2021,146205,10,4,23,11,12
2021,146205,20,0,49,20,29
2021,146205,20,1,16,6,10
2021,146205,20,2,6,2,4
2021,146205,20,3,21,9,12
2021,146205,20,4,6,3,3
2021,146205,30,0,17,8,9
2021,146205,30,4,17,8,9
2021,146278,0,0,47,27,20
2021,146278,10,0,45,25,20
2021,146278,10,1,7,5,2
2021,146278,10,2,2,2,0
2021,146278,10,3,20,10,10
2021,146278,10,4,11,7,4
2021,146278,10,6,5,1,4
2021,146278,20,0,25,16,9
2021,146278,20,1,7,5,2
2021,146278,20,2,2,2,0
2021,146278,20,3,16,9,7
2021,146278,30,0,17,8,9
2021,146278,30,3,4,1,3
2021,146278,30,4,9,6,3
2021,146278,30,6,4,1,3
2021,146278,40,0,3,1,2
2021,146278,40,4,2,1,1
2021,146278,40,6,1,0,1
2021,146278,42,0,2,1,1
2021,146278,42,4,2,1,1
2021,146278,43,0,1,0,1
2021,146278,43,6,1,0,1
2021,146278,50,0,2,2,0
2021,146296,0,0,202,93,109
2021,146296,10,0,202,93,109
2021,146296,10,1,150,67,83
2021,146296,10,2,29,12,17
2021,146296,10,3,23,14,9
2021,146296,20,0,171,80,91
2021,146296,20,1,144,66,78
2021,146296,20,2,21,9,12
2021,146296,20,3,6,5,1
2021,146296,30,0,31,13,18
2021,146296,30,1,6,1,5
2021,146296,30,2,8,3,5
2021,146296,30,3,17,9,8
2021,146339,0,0,52,31,21
2021,146339,10,0,52,31,21
2021,146339,10,1,22,13,9
2021,146339,10,2,8,5,3
2021,146339,10,3,22,13,9
2021,146339,20,0,18,10,8
2021,146339,20,1,17,10,7
2021,146339,20,2,1,0,1
2021,146339,30,0,11,7,4
2021,146339,30,2,3,2,1
2021,146339,30,3,8,5,3
2021,146339,40,0,23,14,9
2021,146339,40,1,5,3,2
2021,146339,40,2,4,3,1
2021,146339,40,3,14,8,6
2021,146339,42,0,23,14,9
2021,146339,42,1,5,3,2
2021,146339,42,2,4,3,1
2021,146339,42,3,14,8,6
2021,146348,0,0,60,22,38
2021,146348,10,0,60,22,38
2021,146348,10,1,55,19,36
2021,146348,10,3,5,3,2
2021,146348,20,0,55,19,36
2021,146348,20,1,55,19,36
2021,146348,30,0,5,3,2
2021,146348,30,3,5,3,2
2021,146366,0,0,64,31,33
2021,146366,10,0,64,31,33
2021,146366,10,1,20,11,9
2021,146366,10,2,10,4,6
2021,146366,10,3,34,16,18
2021,146366,20,0,48,25,23
2021,146366,20,1,20,11,9
2021,146366,20,2,10,4,6
2021,146366,20,3,18,10,8
2021,146366,30,0,15,5,10
2021,146366,30,3,15,5,10
2021,146366,40,0,1,1,0
2021,146366,40,3,1,1,0
2021,146366,43,0,1,1,0
2021,146366,43,3,1,1,0
2021,146418,0,0,54,23,31
2021,146418,10,0,54,23,31
2021,146418,10,6,54,23,31
2021,146418,20,0,50,22,28
2021,146418,20,6,50,22,28
2021,146418,30,0,4,1,3
2021,146418,30,6,4,1,3
2021,146427,0,0,106,62,44
2021,146427,10,0,106,62,44
2021,146427,10,1,31,19,12
2021,146427,10,2,39,24,15
2021,146427,10,3,28,16,12
2021,146427,10,4,8,3,5
2021,146427,20,0,71,43,28
2021,146427,20,1,30,18,12
2021,146427,20,2,39,24,15
2021,146427,20,3,2,1,1
2021,146427,30,0,19,12,7
2021,146427,30,3,19,12,7
2021,146427,40,0,16,7,9
2021,146427,40,1,1,1,0
2021,146427,40,3,7,3,4
2021,146427,40,4,8,3,5
2021,146427,41,0,7,4,3
2021,146427,41,1,1,1,0
2021,146427,41,3,2,1,1
2021,146427,41,4,4,2,2
2021,146427,42,0,6,2,4
2021,146427,42,3,3,1,2
2021,146427,42,4,3,1,2
2021,146427,43,0,3,1,2
2021,146427,43,3,2,1,1
2021,146427,43,4,1,0,1
2021,146427,44,0,2,0,2
2021,146427,44,3,1,0,1
2021,146427,44,4,1,0,1
2021,146427,45,0,5,4,1
2021,146427,45,1,1,1,0
2021,146427,45,3,1,1,0
2021,146427,45,4,3,2,1
2021,146472,0,0,217,102,115
2021,146472,10,0,217,102,115
2021,146472,10,4,217,102,115
2021,146472,20,0,171,76,95
2021,146472,20,4,171,76,95
2021,146472,30,0,44,26,18
2021,146472,30,4,44,26,18
2021,146472,40,0,2,0,2
2021,146472,40,4,2,0,2
2021,146472,41,0,2,0,2
2021,146472,41,4,2,0,2
2021,146472,44,0,2,0,2
2021,146472,44,4,2,0,2
2021,146481,0,0,107,53,54
2021,146481,10,0,107,53,54
2021,146481,10,1,24,17,7
2021,146481,10,2,31,16,15
2021,146481,10,3,48,18,30
2021,146481,10,5,4,2,2
2021,146481,20,0,54,33,21
2021,146481,20,1,24,17,7
2021,146481,20,2,30,16,14
2021,146481,30,0,31,11,20
2021,146481,30,3,31,11,20
2021,146481,40,0,22,9,13
2021,146481,40,2,1,0,1
2021,146481,40,3,17,7,10
2021,146481,40,5,4,2,2
2021,146481,41,0,20,9,11
2021,146481,41,2,1,0,1
2021,146481,41,3,15,7,8
2021,146481,41,5,4,2,2
2021,146481,42,0,2,0,2
2021,146481,42,3,2,0,2
2021,146481,44,0,10,5,5
2021,146481,44,2,1,0,1
2021,146481,44,3,9,5,4
2021,146481,45,0,10,4,6
2021,146481,45,3,6,2,4
2021,146481,45,5,4,2,2
2021,146490,0,0,2,1,1
2021,146490,10,0,2,1,1
2021,146490,10,6,2,1,1
2021,146490,40,0,2,1,1
2021,146490,40,6,2,1,1
2021,146490,41,0,2,1,1
2021,146490,41,6,2,1,1
2021,146490,45,0,2,1,1
2021,146490,45,6,2,1,1
2021,146506,0,0,100,46,54
2021,146506,10,0,100,46,54
2021,146506,10,6,100,46,54
2021,146506,20,0,87,41,46
2021,146506,20,6,87,41,46
2021,146506,30,0,13,5,8
2021,146506,30,6,13,5,8
2021,146533,0,0,15,0,15
2021,146533,10,0,15,0,15
2021,146533,10,2,2,0,2
2021,146533,10,3,5,0,5
2021,146533,10,4,8,0,8
2021,146533,40,0,15,0,15
2021,146533,40,2,2,0,2
2021,146533,40,3,5,0,5
2021,146533,40,4,8,0,8
2021,146533,42,0,15,0,15
2021,146533,42,2,2,0,2
2021,146533,42,3,5,0,5
2021,146533,42,4,8,0,8
2021,146603,0,0,94,38,56
2021,146603,10,0,94,38,56
2021,146603,10,1,45,18,27
2021,146603,10,2,29,9,20
2021,146603,10,3,10,6,4
2021,146603,10,4,10,5,5
2021,146603,20,0,81,37,44
2021,146603,20,1,45,18,27
2021,146603,20,2,23,9,14
2021,146603,20,3,8,6,2
2021,146603,20,4,5,4,1
2021,146603,30,0,13,1,12
2021,146603,30,2,6,0,6
2021,146603,30,3,2,0,2
2021,146603,30,4,5,1,4
2021,146612,0,0,233,103,130
2021,146612,10,0,233,103,130
2021,146612,10,1,59,31,28
2021,146612,10,2,66,30,36
2021,146612,10,3,94,36,58
2021,146612,10,4,14,6,8
2021,146612,20,0,94,49,45
2021,146612,20,1,55,30,25
2021,146612,20,2,38,18,20
2021,146612,20,3,1,1,0
2021,146612,30,0,52,17,35
2021,146612,30,1,3,0,3
2021,146612,30,2,14,5,9
2021,146612,30,3,35,12,23
2021,146612,40,0,87,37,50
2021,146612,40,1,1,1,0
2021,146612,40,2,14,7,7
2021,146612,40,3,58,23,35
2021,146612,40,4,14,6,8
2021,146612,42,0,87,37,50
2021,146612,42,1,1,1,0
2021,146612,42,2,14,7,7
2021,146612,42,3,58,23,35
2021,146612,42,4,14,6,8
2021,146667,0,0,23,17,6
2021,146667,10,0,23,17,6
2021,146667,10,1,13,10,3
2021,146667,10,2,4,3,1
2021,146667,10,3,6,4,2
2021,146667,40,0,23,17,6
2021,146667,40,1,13,10,3
2021,146667,40,2,4,3,1
2021,146667,40,3,6,4,2
2021,146667,42,0,23,17,6
2021,146667,42,1,13,10,3
2021,146667,42,2,4,3,1
2021,146667,42,3,6,4,2
2021,146676,0,0,31,17,14
2021,146676,10,0,31,17,14
2021,146676,10,1,1,1,0
2021,146676,10,2,14,7,7
2021,146676,10,3,15,8,7
2021,146676,10,4,1,1,0
2021,146676,20,0,15,8,7
2021,146676,20,1,1,1,0
2021,146676,20,2,12,6,6
2021,146676,20,3,2,1,1
2021,146676,30,0,14,7,7
2021,146676,30,2,2,1,1
2021,146676,30,3,12,6,6
2021,146676,40,0,2,2,0
2021,146676,40,3,1,1,0
2021,146676,40,4,1,1,0
2021,146676,42,0,2,2,0
2021,146676,42,3,1,1,0
2021,146676,42,4,1,1,0
2021,146685,0,0,121,55,66
2021,146685,10,0,121,55,66
2021,146685,10,1,78,39,39
2021,146685,10,2,7,1,6
2021,146685,10,3,21,9,12
2021,146685,10,4,15,6,9
2021,146685,20,0,96,45,51
2021,146685,20,1,78,39,39
2021,146685,20,2,7,1,6
2021,146685,20,3,4,3,1
2021,146685,20,4,7,2,5
2021,146685,30,0,25,10,15
2021,146685,30,3,17,6,11
2021,146685,30,4,8,4,4
2021,146700,0,0,39,33,6
2021,146700,10,0,39,33,6
2021,146700,10,4,39,33,6
2021,146700,40,0,39,33,6
2021,146700,40,4,39,33,6
2021,146700,41,0,39,33,6
2021,146700,41,4,39,33,6
2021,146700,45,0,39,33,6
2021,146700,45,4,39,33,6
2021,146719,0,0,931,471,460
2021,146719,10,0,931,471,460
2021,146719,10,1,184,122,62
2021,146719,10,2,203,107,96
2021,146719,10,3,151,73,78
2021,146719,10,4,393,169,224
2021,146719,20,0,380,228,152
2021,146719,20,1,183,122,61
2021,146719,20,2,197,106,91
2021,146719,30,0,158,74,84
2021,146719,30,1,1,0,1
2021,146719,30,2,6,1,5
2021,146719,30,3,151,73,78
2021,146719,40,0,393,169,224
2021,146719,40,4,393,169,224
2021,146719,41,0,341,138,203
2021,146719,41,4,341,138,203
2021,146719,42,0,52,31,21
2021,146719,42,4,52,31,21
2021,146719,44,0,341,138,203
2021,146719,44,4,341,138,203
2021,146728,0,0,12,7,5
2021,146728,10,0,12,7,5
2021,146728,10,1,5,3,2
2021,146728,10,2,3,3,0
2021,146728,10,3,3,1,2
2021,146728,10,5,1,0,1
2021,146728,20,0,6,4,2
2021,146728,20,1,5,3,2
2021,146728,20,2,1,1,0
2021,146728,30,0,4,2,2
2021,146728,30,2,1,1,0
2021,146728,30,3,3,1,2
2021,146728,40,0,2,1,1
2021,146728,40,2,1,1,0
2021,146728,40,5,1,0,1
2021,146728,41,0,2,1,1
2021,146728,41,2,1,1,0
2021,146728,41,5,1,0,1
2021,146728,44,0,2,1,1
2021,146728,44,2,1,1,0
2021,146728,44,5,1,0,1
2021,146755,0,0,13,1,12
2021,146755,10,0,13,1,12
2021,146755,10,1,1,0,1
2021,146755,10,2,3,0,3
2021,146755,10,3,4,0,4
2021,146755,10,4,5,1,4
2021,146755,40,0,13,1,12
2021,146755,40,1,1,0,1
2021,146755,40,2,3,0,3
2021,146755,40,3,4,0,4
2021,146755,40,4,5,1,4
2021,146755,42,0,13,1,12
2021,146755,42,1,1,0,1
2021,146755,42,2,3,0,3
2021,146755,42,3,4,0,4
2021,146755,42,4,5,1,4
2021,146816,0,0,7,4,3
2021,146816,10,0,7,4,3
2021,146816,10,2,2,1,1
2021,146816,10,3,5,3,2
2021,146816,40,0,7,4,3
2021,146816,40,2,2,1,1
2021,146816,40,3,5,3,2
2021,146816,42,0,7,4,3
2021,146816,42,2,2,1,1
2021,146816,42,3,5,3,2
2021,146977,0,0,12,5,7
2021,146977,10,0,12,5,7
2021,146977,10,1,6,4,2
2021,146977,10,2,3,0,3
2021,146977,10,3,2,0,2
2021,146977,10,4,1,1,0
2021,146977,20,0,7,4,3
2021,146977,20,1,6,4,2
2021,146977,20,2,1,0,1
2021,146977,30,0,2,0,2
2021,146977,30,3,2,0,2
2021,146977,40,0,3,1,2
2021,146977,40,2,2,0,2
2021,146977,40,4,1,1,0
2021,146977,41,0,3,1,2
2021,146977,41,2,2,0,2
2021,146977,41,4,1,1,0
2021,146977,44,0,2,0,2
2021,146977,44,2,2,0,2
2021,146977,45,0,1,1,0
2021,146977,45,4,1,1,0
2021,147004,0,0,89,36,53
2021,147004,10,0,89,36,53
2021,147004,10,6,89,36,53
2021,147004,20,0,80,32,48
2021,147004,20,6,80,32,48
2021,147004,30,0,8,4,4
2021,147004,30,6,8,4,4
2021,147004,40,0,1,0,1
2021,147004,40,6,1,0,1
2021,147004,42,0,1,0,1
2021,147004,42,6,1,0,1
2021,147013,0,0,74,30,44
2021,147013,10,0,74,30,44
2021,147013,10,1,27,10,17
2021,147013,10,2,22,10,12
2021,147013,10,3,17,6,11
2021,147013,10,4,4,2,2
2021,147013,10,5,1,1,0
2021,147013,10,6,3,1,2
2021,147013,20,0,49,19,30
2021,147013,20,1,27,10,17
2021,147013,20,2,21,9,12
2021,147013,20,3,1,0,1
2021,147013,30,0,17,7,10
2021,147013,30,2,1,1,0
2021,147013,30,3,16,6,10
2021,147013,40,0,8,4,4
2021,147013,40,4,4,2,2
2021,147013,40,5,1,1,0
2021,147013,40,6,3,1,2
2021,147013,42,0,8,4,4
2021,147013,42,4,4,2,2
2021,147013,42,5,1,1,0
2021,147013,42,6,3,1,2
2021,147031,0,0,4,2,2
2021,147031,10,0,4,2,2
2021,147031,10,1,2,2,0
2021,147031,10,2,1,0,1
2021,147031,10,3,1,0,1
2021,147031,40,0,4,2,2
2021,147031,40,1,2,2,0
2021,147031,40,2,1,0,1
2021,147031,40,3,1,0,1
2021,147031,41,0,4,2,2
2021,147031,41,1,2,2,0
2021,147031,41,2,1,0,1
2021,147031,41,3,1,0,1
2021,147031,44,0,4,2,2
2021,147031,44,1,2,2,0
2021,147031,44,2,1,0,1
2021,147031,44,3,1,0,1
2021,147129,0,0,38,3,35
2021,147129,10,0,38,3,35
2021,147129,10,1,4,1,3
2021,147129,10,2,4,0,4
2021,147129,10,3,15,1,14
2021,147129,10,4,15,1,14
2021,147129,40,0,38,3,35
2021,147129,40,1,4,1,3
2021,147129,40,2,4,0,4
2021,147129,40,3,15,1,14
2021,147129,40,4,15,1,14
2021,147129,41,0,13,0,13
2021,147129,41,2,2,0,2
2021,147129,41,3,6,0,6
2021,147129,41,4,5,0,5
2021,147129,42,0,25,3,22
2021,147129,42,1,4,1,3
2021,147129,42,2,2,0,2
2021,147129,42,3,9,1,8
2021,147129,42,4,10,1,9
2021,147129,44,0,13,0,13
2021,147129,44,2,2,0,2
2021,147129,44,3,6,0,6
2021,147129,44,4,5,0,5
2021,147244,0,0,155,77,78
2021,147244,10,0,155,77,78
2021,147244,10,1,30,19,11
2021,147244,10,2,47,27,20
2021,147244,10,3,45,18,27
2021,147244,10,4,25,11,14
2021,147244,10,5,8,2,6
2021,147244,20,0,67,39,28
2021,147244,20,1,30,19,11
2021,147244,20,2,37,20,17
2021,147244,30,0,52,23,29
2021,147244,30,2,10,7,3
2021,147244,30,3,38,16,22
2021,147244,30,4,4,0,4
2021,147244,40,0,36,15,21
2021,147244,40,3,7,2,5
2021,147244,40,4,21,11,10
2021,147244,40,5,8,2,6
2021,147244,42,0,36,15,21
2021,147244,42,3,7,2,5
2021,147244,42,4,21,11,10
2021,147244,42,5,8,2,6
2021,147341,0,0,75,41,34
2021,147341,10,0,75,41,34
2021,147341,10,1,26,14,12
2021,147341,10,2,18,12,6
2021,147341,10,3,25,12,13
2021,147341,10,5,6,3,3
2021,147341,20,0,41,24,17
2021,147341,20,1,26,14,12
2021,147341,20,2,15,10,5
2021,147341,30,0,19,9,10
2021,147341,30,2,2,2,0
2021,147341,30,3,17,7,10
2021,147341,40,0,15,8,7
2021,147341,40,2,1,0,1
2021,147341,40,3,8,5,3
2021,147341,40,5,6,3,3
2021,147341,41,0,4,2,2
2021,147341,41,2,1,0,1
2021,147341,41,3,3,2,1
2021,147341,42,0,11,6,5
2021,147341,42,3,5,3,2
2021,147341,42,5,6,3,3
2021,147341,44,0,4,2,2
2021,147341,44,2,1,0,1
2021,147341,44,3,3,2,1
2021,147369,0,0,72,51,21
2021,147369,10,0,72,51,21
2021,147369,10,1,35,29,6
2021,147369,10,2,10,5,5
2021,147369,10,3,15,9,6
2021,147369,10,4,12,8,4
2021,147369,40,0,72,51,21
2021,147369,40,1,35,29,6
2021,147369,40,2,10,5,5
2021,147369,40,3,15,9,6
2021,147369,40,4,12,8,4
2021,147369,42,0,72,51,21
2021,147369,42,1,35,29,6
2021,147369,42,2,10,5,5
2021,147369,42,3,15,9,6
2021,147369,42,4,12,8,4
2021,147378,0,0,182,75,107
2021,147378,10,0,182,75,107
2021,147378,10,1,76,33,43
2021,147378,10,2,41,19,22
2021,147378,10,3,40,16,24
2021,147378,10,4,25,7,18
2021,147378,20,0,172,71,101
2021,147378,20,1,76,33,43
2021,147378,20,2,41,19,22
2021,147378,20,3,38,15,23
2021,147378,20,4,17,4,13
2021,147378,30,0,10,4,6
2021,147378,30,3,2,1,1
2021,147378,30,4,8,3,5
2021,147396,0,0,7,7,0
2021,147396,10,0,7,7,0
2021,147396,10,6,7,7,0
2021,147396,40,0,7,7,0
2021,147396,40,6,7,7,0
2021,147396,42,0,1,1,0
2021,147396,42,6,1,1,0
2021,147396,43,0,6,6,0
2021,147396,43,6,6,6,0
2021,147411,0,0,71,32,39
2021,147411,10,0,71,32,39
2021,147411,10,4,71,32,39
2021,147411,20,0,48,25,23
2021,147411,20,4,48,25,23
2021,147411,30,0,21,7,14
2021,147411,30,4,21,7,14
2021,147411,40,0,2,0,2
2021,147411,40,4,2,0,2
2021,147411,42,0,1,0,1
2021,147411,42,4,1,0,1
2021,147411,43,0,1,0,1
2021,147411,43,4,1,0,1
2021,147536,0,0,187,57,130
2021,147536,10,0,187,57,130
2021,147536,10,1,15,5,10
2021,147536,10,2,51,14,37
2021,147536,10,3,115,32,83
2021,147536,10,5,6,6,0
2021,147536,20,0,43,17,26
2021,147536,20,1,8,3,5
2021,147536,20,2,31,11,20
2021,147536,20,3,4,3,1
2021,147536,30,0,4,1,3
2021,147536,30,2,1,0,1
2021,147536,30,3,3,1,2
2021,147536,40,0,140,39,101
2021,147536,40,1,7,2,5
2021,147536,40,2,19,3,16
2021,147536,40,3,108,28,80
2021,147536,40,5,6,6,0
2021,147536,41,0,83,33,50
2021,147536,41,1,5,1,4
2021,147536,41,2,14,3,11
2021,147536,41,3,58,23,35
2021,147536,41,5,6,6,0
2021,147536,42,0,57,6,51
2021,147536,42,1,2,1,1
2021,147536,42,2,5,0,5
2021,147536,42,3,50,5,45
2021,147536,44,0,83,33,50
2021,147536,44,1,5,1,4
2021,147536,44,2,14,3,11
2021,147536,44,3,58,23,35
2021,147536,44,5,6,6,0
2021,147590,0,0,50,27,23
2021,147590,10,0,48,27,21
2021,147590,10,1,10,5,5
2021,147590,10,2,8,5,3
2021,147590,10,3,17,9,8
2021,147590,10,4,13,8,5
2021,147590,20,0,9,5,4
2021,147590,20,1,7,3,4
2021,147590,20,2,2,2,0
2021,147590,30,0,12,9,3
2021,147590,30,1,1,1,0
2021,147590,30,2,2,2,0
2021,147590,30,3,5,2,3
2021,147590,30,4,4,4,0
2021,147590,40,0,27,13,14
2021,147590,40,1,2,1,1
2021,147590,40,2,4,1,3
2021,147590,40,3,12,7,5
2021,147590,40,4,9,4,5
2021,147590,42,0,27,13,14
2021,147590,42,1,2,1,1
2021,147590,42,2,4,1,3
2021,147590,42,3,12,7,5
2021,147590,42,4,9,4,5
2021,147590,50,0,2,0,2
2021,147660,0,0,165,73,92
2021,147660,10,0,165,73,92
2021,147660,10,1,53,34,19
2021,147660,10,2,53,19,34
2021,147660,10,3,56,19,37
2021,147660,10,5,3,1,2
2021,147660,20,0,82,44,38
2021,147660,20,1,45,31,14
2021,147660,20,2,37,13,24
2021,147660,30,0,37,15,22
2021,147660,30,1,2,1,1
2021,147660,30,2,8,4,4
2021,147660,30,3,27,10,17
2021,147660,40,0,46,14,32
2021,147660,40,1,6,2,4
2021,147660,40,2,8,2,6
2021,147660,40,3,29,9,20
2021,147660,40,5,3,1,2
2021,147660,41,0,39,13,26
2021,147660,41,1,5,2,3
2021,147660,41,2,8,2,6
2021,147660,41,3,23,8,15
2021,147660,41,5,3,1,2
2021,147660,42,0,7,1,6
2021,147660,42,1,1,0,1
2021,147660,42,3,6,1,5
2021,147660,44,0,39,13,26
2021,147660,44,1,5,2,3
2021,147660,44,2,8,2,6
2021,147660,44,3,23,8,15
2021,147660,44,5,3,1,2
2021,147679,0,0,112,53,59
2021,147679,10,0,112,53,59
2021,147679,10,1,53,31,22
2021,147679,10,2,37,14,23
2021,147679,10,3,20,7,13
2021,147679,10,6,2,1,1
2021,147679,20,0,60,31,29
2021,147679,20,1,50,28,22
2021,147679,20,2,10,3,7
2021,147679,30,0,18,12,6
2021,147679,30,1,1,1,0
2021,147679,30,2,9,6,3
2021,147679,30,3,8,5,3
2021,147679,40,0,34,10,24
2021,147679,40,1,2,2,0
2021,147679,40,2,18,5,13
2021,147679,40,3,12,2,10
2021,147679,40,6,2,1,1
2021,147679,41,0,28,7,21
2021,147679,41,1,2,2,0
2021,147679,41,2,17,4,13
2021,147679,41,3,9,1,8
2021,147679,42,0,6,3,3
2021,147679,42,2,1,1,0
2021,147679,42,3,3,1,2
2021,147679,42,6,2,1,1
2021,147679,44,0,28,7,21
2021,147679,44,1,2,2,0
2021,147679,44,2,17,4,13
2021,147679,44,3,9,1,8
2021,147697,0,0,5,3,2
2021,147697,10,0,5,3,2
2021,147697,10,1,5,3,2
2021,147697,40,0,5,3,2
2021,147697,40,1,5,3,2
2021,147697,41,0,5,3,2
2021,147697,41,1,5,3,2
2021,147697,45,0,5,3,2
2021,147697,45,1,5,3,2
2021,147703,0,0,797,407,390
2021,147703,10,0,797,407,390
2021,147703,10,1,243,150,93
2021,147703,10,2,233,119,114
2021,147703,10,3,139,65,74
2021,147703,10,4,156,62,94
2021,147703,10,6,26,11,15
2021,147703,20,0,449,253,196
2021,147703,20,1,242,150,92
2021,147703,20,2,204,102,102
2021,147703,20,3,3,1,2
2021,147703,30,0,147,75,72
2021,147703,30,2,26,15,11
2021,147703,30,3,121,60,61
2021,147703,40,0,201,79,122
2021,147703,40,1,1,0,1
2021,147703,40,2,3,2,1
2021,147703,40,3,15,4,11
2021,147703,40,4,156,62,94
2021,147703,40,6,26,11,15
2021,147703,41,0,45,17,28
2021,147703,41,1,1,0,1
2021,147703,41,2,3,2,1
2021,147703,41,3,15,4,11
2021,147703,41,6,26,11,15
2021,147703,42,0,156,62,94
2021,147703,42,4,156,62,94
2021,147703,44,0,45,17,28
2021,147703,44,1,1,0,1
2021,147703,44,2,3,2,1
2021,147703,44,3,15,4,11
2021,147703,44,6,26,11,15
2021,147767,0,0,2353,1353,1000
2021,147767,10,0,2353,1353,1000
2021,147767,10,1,1040,721,319
2021,147767,10,2,595,310,285
2021,147767,10,3,602,265,337
2021,147767,10,4,20,8,12
2021,147767,10,5,96,49,47
2021,147767,20,0,1036,727,309
2021,147767,20,1,749,558,191
2021,147767,20,2,287,169,118
2021,147767,30,0,319,172,147
2021,147767,30,2,44,27,17
2021,147767,30,3,275,145,130
2021,147767,40,0,998,454,544
2021,147767,40,1,291,163,128
2021,147767,40,2,264,114,150
2021,147767,40,3,327,120,207
2021,147767,40,4,20,8,12
2021,147767,40,5,96,49,47
2021,147767,41,0,985,451,534
2021,147767,41,1,291,163,128
2021,147767,41,2,264,114,150
2021,147767,41,3,327,120,207
2021,147767,41,4,20,8,12
2021,147767,41,5,83,46,37
2021,147767,42,0,13,3,10
2021,147767,42,5,13,3,10
2021,147767,44,0,985,451,534
2021,147767,44,1,291,163,128
2021,147767,44,2,264,114,150
2021,147767,44,3,327,120,207
2021,147767,44,4,20,8,12
2021,147767,44,5,83,46,37
2021,147776,0,0,272,126,146
2021,147776,10,0,272,126,146
2021,147776,10,1,56,29,27
2021,147776,10,2,100,48,52
2021,147776,10,3,49,19,30
2021,147776,10,4,61,26,35
2021,147776,10,6,6,4,2
2021,147776,20,0,136,66,70
2021,147776,20,1,55,29,26
2021,147776,20,2,77,35,42
2021,147776,20,3,1,1,0
2021,147776,20,6,3,1,2
2021,147776,30,0,75,34,41
2021,147776,30,1,1,0,1
2021,147776,30,2,23,13,10
2021,147776,30,3,48,18,30
2021,147776,30,6,3,3,0
2021,147776,40,0,61,26,35
2021,147776,40,4,61,26,35
2021,147776,42,0,61,26,35
2021,147776,42,4,61,26,35
2021,147800,0,0,151,59,92
2021,147800,10,0,151,59,92
2021,147800,10,1,88,39,49
2021,147800,10,2,33,12,21
2021,147800,10,3,13,2,11
2021,147800,10,4,3,1,2
2021,147800,10,6,14,5,9
2021,147800,20,0,122,48,74
2021,147800,20,1,85,37,48
2021,147800,20,2,29,11,18
2021,147800,20,3,8,0,8
2021,147800,30,0,26,11,15
2021,147800,30,1,3,2,1
2021,147800,30,2,4,1,3
2021,147800,30,3,5,2,3
2021,147800,30,4,3,1,2
2021,147800,30,6,11,5,6
2021,147800,40,0,3,0,3
2021,147800,40,6,3,0,3
2021,147800,43,0,3,0,3
2021,147800,43,6,3,0,3
2021,147828,0,0,110,64,46
2021,147828,10,0,110,64,46
2021,147828,10,1,38,26,12
2021,147828,10,2,39,24,15
2021,147828,10,3,33,14,19
2021,147828,20,0,5,5,0
2021,147828,20,1,5,5,0
2021,147828,40,0,105,59,46
2021,147828,40,1,33,21,12
2021,147828,40,2,39,24,15
2021,147828,40,3,33,14,19
2021,147828,41,0,31,19,12
2021,147828,41,1,16,10,6
2021,147828,41,2,15,9,6
2021,147828,42,0,74,40,34
2021,147828,42,1,17,11,6
2021,147828,42,2,24,15,9
2021,147828,42,3,33,14,19
2021,147828,44,0,31,19,12
2021,147828,44,1,16,10,6
2021,147828,44,2,15,9,6
2021,147916,0,0,147,71,76
2021,147916,10,0,147,71,76
2021,147916,10,1,54,30,24
2021,147916,10,2,65,21,44
2021,147916,10,3,7,6,1
2021,147916,10,4,21,14,7
2021,147916,20,0,126,57,69
2021,147916,20,1,54,30,24
2021,147916,20,2,65,21,44
2021,147916,20,3,7,6,1
2021,147916,30,0,4,2,2
2021,147916,30,4,4,2,2
2021,147916,40,0,17,12,5
2021,147916,40,4,17,12,5
2021,147916,42,0,17,12,5
2021,147916,42,4,17,12,5
2021,148007,0,0,80,31,49
2021,148007,10,0,80,31,49
2021,148007,10,1,38,20,18
2021,148007,10,2,27,9,18
2021,148007,10,3,15,2,13
2021,148007,20,0,65,29,36
2021,148007,20,1,38,20,18
2021,148007,20,2,27,9,18
2021,148007,30,0,13,1,12
2021,148007,30,3,13,1,12
2021,148007,40,0,2,1,1
2021,148007,40,3,2,1,1
2021,148007,42,0,2,1,1
2021,148007,42,3,2,1,1
2021,148016,0,0,63,33,30
2021,148016,10,0,63,33,30
2021,148016,10,1,22,13,9
2021,148016,10,2,14,6,8
2021,148016,10,3,24,13,11
2021,148016,10,4,3,1,2
2021,148016,40,0,63,33,30
2021,148016,40,1,22,13,9
2021,148016,40,2,14,6,8
2021,148016,40,3,24,13,11
2021,148016,40,4,3,1,2
2021,148016,42,0,63,33,30
2021,148016,42,1,22,13,9
2021,148016,42,2,14,6,8
2021,148016,42,3,24,13,11
2021,148016,42,4,3,1,2
2021,148131,0,0,52,33,19
2021,148131,10,0,52,33,19
2021,148131,10,1,11,9,2
2021,148131,10,2,15,10,5
2021,148131,10,3,26,14,12
2021,148131,20,0,24,18,6
2021,148131,20,1,11,9,2
2021,148131,20,2,13,9,4
2021,148131,30,0,12,7,5
2021,148131,30,3,12,7,5
2021,148131,40,0,16,8,8
2021,148131,40,2,2,1,1
2021,148131,40,3,14,7,7
2021,148131,42,0,16,8,8
2021,148131,42,2,2,1,1
2021,148131,42,3,14,7,7
2021,148256,0,0,49,22,27
2021,148256,10,0,49,22,27
2021,148256,10,1,29,14,15
2021,148256,10,2,18,7,11
2021,148256,10,4,2,1,1
2021,148256,20,0,47,21,26
2021,148256,20,1,29,14,15
2021,148256,20,2,18,7,11
2021,148256,30,0,2,1,1
2021,148256,30,4,2,1,1
2021,148292,0,0,57,25,32
2021,148292,10,0,57,25,32
2021,148292,10,1,20,7,13
2021,148292,10,2,14,7,7
2021,148292,10,3,10,4,6
2021,148292,10,4,13,7,6
2021,148292,20,0,49,19,30
2021,148292,20,1,20,7,13
2021,148292,20,2,10,3,7
2021,148292,20,3,10,4,6
2021,148292,20,4,9,5,4
2021,148292,30,0,8,6,2
2021,148292,30,2,4,4,0
2021,148292,30,4,4,2,2
2021,148380,0,0,116,57,59
2021,148380,10,0,116,57,59
2021,148380,10,1,45,21,24
2021,148380,10,2,46,24,22
2021,148380,10,3,17,5,12
2021,148380,10,4,2,1,1
2021,148380,10,6,6,6,0
2021,148380,20,0,95,45,50
2021,148380,20,1,44,20,24
2021,148380,20,2,42,22,20
2021,148380,20,3,9,3,6
2021,148380,30,0,14,5,9
2021,148380,30,1,1,1,0
2021,148380,30,2,3,1,2
2021,148380,30,3,8,2,6
2021,148380,30,4,2,1,1
2021,148380,40,0,7,7,0
2021,148380,40,2,1,1,0
2021,148380,40,6,6,6,0
2021,148380,41,0,7,7,0
2021,148380,41,2,1,1,0
2021,148380,41,6,6,6,0
2021,148380,44,0,7,7,0
2021,148380,44,2,1,1,0
2021,148380,44,6,6,6,0
2021,148405,0,0,70,27,43
2021,148405,10,0,70,27,43
2021,148405,10,1,15,9,6
2021,148405,10,2,22,13,9
2021,148405,10,3,31,5,26
2021,148405,10,5,2,0,2
2021,148405,20,0,36,21,15
2021,148405,20,1,15,9,6
2021,148405,20,2,16,12,4
2021,148405,20,3,5,0,5
2021,148405,30,0,28,6,22
2021,148405,30,2,4,1,3
2021,148405,30,3,24,5,19
2021,148405,40,0,6,0,6
2021,148405,40,2,2,0,2
2021,148405,40,3,2,0,2
2021,148405,40,5,2,0,2
2021,148405,41,0,6,0,6
2021,148405,41,2,2,0,2
2021,148405,41,3,2,0,2
2021,148405,41,5,2,0,2
2021,148405,44,0,6,0,6
2021,148405,44,2,2,0,2
2021,148405,44,3,2,0,2
2021,148405,44,5,2,0,2
2021,148487,0,0,181,98,83
2021,148487,10,0,181,98,83
2021,148487,10,1,43,28,15
2021,148487,10,2,59,31,28
2021,148487,10,3,46,23,23
2021,148487,10,4,1,0,1
2021,148487,10,5,22,11,11
2021,148487,10,6,10,5,5
2021,148487,20,0,97,54,43
2021,148487,20,1,38,24,14
2021,148487,20,2,55,29,26
2021,148487,20,3,3,1,2
2021,148487,20,6,1,0,1
2021,148487,30,0,15,7,8
2021,148487,30,3,13,7,6
2021,148487,30,5,1,0,1
2021,148487,30,6,1,0,1
2021,148487,40,0,69,37,32
2021,148487,40,1,5,4,1
2021,148487,40,2,4,2,2
2021,148487,40,3,30,15,15
2021,148487,40,4,1,0,1
2021,148487,40,5,21,11,10
2021,148487,40,6,8,5,3
2021,148487,41,0,29,13,16
2021,148487,41,1,5,4,1
2021,148487,41,2,3,2,1
2021,148487,41,3,11,3,8
2021,148487,41,4,1,0,1
2021,148487,41,5,7,3,4
2021,148487,41,6,2,1,1
2021,148487,42,0,39,23,16
2021,148487,42,2,1,0,1
2021,148487,42,3,19,12,7
2021,148487,42,5,14,8,6
2021,148487,42,6,5,3,2
2021,148487,43,0,1,1,0
2021,148487,43,6,1,1,0
2021,148487,44,0,29,13,16
2021,148487,44,1,5,4,1
2021,148487,44,2,3,2,1
2021,148487,44,3,11,3,8
2021,148487,44,4,1,0,1
2021,148487,44,5,7,3,4
2021,148487,44,6,2,1,1
2021,148496,0,0,143,56,87
2021,148496,10,0,143,56,87
2021,148496,10,1,54,20,34
2021,148496,10,2,37,18,19
2021,148496,10,3,30,12,18
2021,148496,10,4,1,0,1
2021,148496,10,5,21,6,15
2021,148496,20,0,91,41,50
2021,148496,20,1,53,20,33
2021,148496,20,2,31,16,15
2021,148496,20,3,7,5,2
2021,148496,30,0,27,9,18
2021,148496,30,2,6,2,4
2021,148496,30,3,20,7,13
2021,148496,30,4,1,0,1
2021,148496,40,0,25,6,19
2021,148496,40,1,1,0,1
2021,148496,40,3,3,0,3
2021,148496,40,5,21,6,15
2021,148496,42,0,25,6,19
2021,148496,42,1,1,0,1
2021,148496,42,3,3,0,3
2021,148496,42,5,21,6,15
2021,148511,0,0,1222,531,691
2021,148511,10,0,1222,531,691
2021,148511,10,1,151,100,51
2021,148511,10,2,218,113,105
2021,148511,10,3,612,254,358
2021,148511,10,4,154,39,115
2021,148511,10,5,31,8,23
2021,148511,10,6,56,17,39
2021,148511,20,0,369,213,156
2021,148511,20,1,151,100,51
2021,148511,20,2,218,113,105
2021,148511,30,0,766,293,473
2021,148511,30,3,612,254,358
2021,148511,30,4,154,39,115
2021,148511,40,0,87,25,62
2021,148511,40,5,31,8,23
2021,148511,40,6,56,17,39
2021,148511,42,0,87,25,62
2021,148511,42,5,31,8,23
2021,148511,42,6,56,17,39
2021,148575,0,0,37,3,34
2021,148575,10,0,37,3,34
2021,148575,10,1,6,0,6
2021,148575,10,2,4,1,3
2021,148575,10,3,22,2,20
2021,148575,10,4,5,0,5
2021,148575,40,0,37,3,34
2021,148575,40,1,6,0,6
2021,148575,40,2,4,1,3
2021,148575,40,3,22,2,20
2021,148575,40,4,5,0,5
2021,148575,43,0,37,3,34
2021,148575,43,1,6,0,6
2021,148575,43,2,4,1,3
2021,148575,43,3,22,2,20
2021,148575,43,4,5,0,5
2021,148584,0,0,91,35,56
2021,148584,10,0,91,35,56
2021,148584,10,1,25,14,11
2021,148584,10,2,22,10,12
2021,148584,10,3,25,3,22
2021,148584,10,4,19,8,11
2021,148584,20,0,42,21,21
2021,148584,20,1,21,11,10
2021,148584,20,2,21,10,11
2021,148584,30,0,22,3,19
2021,148584,30,2,1,0,1
2021,148584,30,3,21,3,18
2021,148584,40,0,27,11,16
2021,148584,40,1,4,3,1
2021,148584,40,3,4,0,4
2021,148584,40,4,19,8,11
2021,148584,42,0,27,11,16
2021,148584,42,1,4,3,1
2021,148584,42,3,4,0,4
2021,148584,42,4,19,8,11
2021,148593,0,0,16,1,15
2021,148593,10,0,16,1,15
2021,148593,10,2,2,0,2
2021,148593,10,3,13,1,12
2021,148593,10,4,1,0,1
2021,148593,40,0,16,1,15
2021,148593,40,2,2,0,2
2021,148593,40,3,13,1,12
2021,148593,40,4,1,0,1
2021,148593,42,0,16,1,15
2021,148593,42,2,2,0,2
2021,148593,42,3,13,1,12
2021,148593,42,4,1,0,1
2021,148627,0,0,125,52,73
2021,148627,10,0,125,52,73
2021,148627,10,1,26,12,14
2021,148627,10,2,38,18,20
2021,148627,10,3,20,10,10
2021,148627,10,4,2,0,2
2021,148627,10,5,33,10,23
2021,148627,10,6,6,2,4
2021,148627,20,0,64,30,34
2021,148627,20,1,26,12,14
2021,148627,20,2,37,18,19
2021,148627,20,3,1,0,1
2021,148627,30,0,21,11,10
2021,148627,30,2,1,0,1
2021,148627,30,3,19,10,9
2021,148627,30,5,1,1,0
2021,148627,40,0,40,11,29
2021,148627,40,4,2,0,2
2021,148627,40,5,32,9,23
2021,148627,40,6,6,2,4
2021,148627,42,0,40,11,29
2021,148627,42,4,2,0,2
2021,148627,42,5,32,9,23
2021,148627,42,6,6,2,4
2021,148654,0,0,191,107,84
2021,148654,10,0,191,107,84
2021,148654,10,1,27,19,8
2021,148654,10,2,84,47,37
2021,148654,10,3,53,25,28
2021,148654,10,4,26,15,11
2021,148654,10,5,1,1,0
2021,148654,20,0,113,66,47
2021,148654,20,1,27,19,8
2021,148654,20,2,79,44,35
2021,148654,20,3,7,3,4
2021,148654,30,0,42,22,20
2021,148654,30,2,3,2,1
2021,148654,30,3,39,20,19
2021,148654,40,0,36,19,17
2021,148654,40,2,2,1,1
2021,148654,40,3,7,2,5
2021,148654,40,4,26,15,11
2021,148654,40,5,1,1,0
2021,148654,42,0,36,19,17
2021,148654,42,2,2,1,1
2021,148654,42,3,7,2,5
2021,148654,42,4,26,15,11
2021,148654,42,5,1,1,0
2021,148672,0,0,47,22,25
2021,148672,10,0,47,22,25
2021,148672,10,1,14,9,5
2021,148672,10,2,11,5,6
2021,148672,10,3,20,6,14
2021,148672,10,4,2,2,0
2021,148672,20,0,33,15,18
2021,148672,20,1,10,6,4
2021,148672,20,2,10,4,6
2021,148672,20,3,11,3,8
2021,148672,20,4,2,2,0
2021,148672,30,0,14,7,7
2021,148672,30,1,4,3,1
2021,148672,30,2,1,1,0
2021,148672,30,3,9,3,6
2021,148821,0,0,31,14,17
2021,148821,10,0,31,14,17
2021,148821,10,6,31,14,17
2021,148821,20,0,24,10,14
2021,148821,20,6,24,10,14
2021,148821,30,0,7,4,3
2021,148821,30,6,7,4,3
2021,148876,0,0,9,7,2
2021,148876,10,0,9,7,2
2021,148876,10,1,7,5,2
2021,148876,10,3,2,2,0
2021,148876,40,0,9,7,2
2021,148876,40,1,7,5,2
2021,148876,40,3,2,2,0
2021,148876,41,0,9,7,2
2021,148876,41,1,7,5,2
2021,148876,41,3,2,2,0
2021,148876,44,0,9,7,2
2021,148876,44,1,7,5,2
2021,148876,44,3,2,2,0
2021,148885,0,0,14,11,3
2021,148885,10,0,14,11,3
2021,148885,10,1,3,2,1
2021,148885,10,2,4,4,0
2021,148885,10,3,4,2,2
2021,148885,10,4,3,3,0
2021,148885,40,0,14,11,3
2021,148885,40,1,3,2,1
2021,148885,40,2,4,4,0
2021,148885,40,3,4,2,2
2021,148885,40,4,3,3,0
2021,148885,41,0,14,11,3
2021,148885,41,1,3,2,1
2021,148885,41,2,4,4,0
2021,148885,41,3,4,2,2
2021,148885,41,4,3,3,0
2021,148885,44,0,14,11,3
2021,148885,44,1,3,2,1
2021,148885,44,2,4,4,0
2021,148885,44,3,4,2,2
2021,148885,44,4,3,3,0
2021,148937,0,0,30,16,14
2021,148937,10,0,30,16,14
2021,148937,10,4,30,16,14
2021,148937,20,0,19,13,6
2021,148937,20,4,19,13,6
2021,148937,30,0,10,3,7
2021,148937,30,4,10,3,7
2021,148937,40,0,1,0,1
2021,148937,40,4,1,0,1
2021,148937,42,0,1,0,1
2021,148937,42,4,1,0,1
2021,148982,0,0,3,2,1
2021,148982,10,0,3,2,1
2021,148982,10,1,1,1,0
2021,148982,10,2,1,0,1
2021,148982,10,3,1,1,0
2021,148982,40,0,3,2,1
2021,148982,40,1,1,1,0
2021,148982,40,2,1,0,1
2021,148982,40,3,1,1,0
2021,148982,41,0,1,1,0
2021,148982,41,1,1,1,0
2021,148982,42,0,2,1,1
2021,148982,42,2,1,0,1
2021,148982,42,3,1,1,0
2021,148982,44,0,1,1,0
2021,148982,44,1,1,1,0
2021,148991,0,0,31,13,18
2021,148991,10,0,31,13,18
2021,148991,10,6,31,13,18
2021,148991,20,0,28,13,15
2021,148991,20,6,28,13,15
2021,148991,30,0,3,0,3
2021,148991,30,6,3,0,3
2021,149028,0,0,21,3,18
2021,149028,10,0,21,3,18
2021,149028,10,1,1,1,0
2021,149028,10,2,1,0,1
2021,149028,10,3,12,1,11
2021,149028,10,4,7,1,6
2021,149028,40,0,21,3,18
2021,149028,40,1,1,1,0
2021,149028,40,2,1,0,1
2021,149028,40,3,12,1,11
2021,149028,40,4,7,1,6
2021,149028,41,0,21,3,18
2021,149028,41,1,1,1,0
2021,149028,41,2,1,0,1
2021,149028,41,3,12,1,11
2021,149028,41,4,7,1,6
2021,149028,45,0,21,3,18
2021,149028,45,1,1,1,0
2021,149028,45,2,1,0,1
2021,149028,45,3,12,1,11
2021,149028,45,4,7,1,6
2021,149222,0,0,981,578,403
2021,149222,10,0,981,578,403
2021,149222,10,1,226,159,67
2021,149222,10,2,325,196,129
2021,149222,10,3,308,163,145
2021,149222,10,4,73,39,34
2021,149222,10,5,49,21,28
2021,149222,20,0,376,258,118
2021,149222,20,1,181,135,46
2021,149222,20,2,194,122,72
2021,149222,20,3,1,1,0
2021,149222,30,0,150,89,61
2021,149222,30,1,2,2,0
2021,149222,30,2,31,21,10
2021,149222,30,3,117,66,51
2021,149222,40,0,455,231,224
2021,149222,40,1,43,22,21
2021,149222,40,2,100,53,47
2021,149222,40,3,190,96,94
2021,149222,40,4,73,39,34
2021,149222,40,5,49,21,28
2021,149222,41,0,289,148,141
2021,149222,41,1,41,20,21
2021,149222,41,2,98,51,47
2021,149222,41,3,101,59,42
2021,149222,41,4,13,1,12
2021,149222,41,5,36,17,19
2021,149222,42,0,18,10,8
2021,149222,42,1,1,1,0
2021,149222,42,2,2,2,0
2021,149222,42,3,11,5,6
2021,149222,42,4,4,2,2
2021,149222,43,0,148,73,75
2021,149222,43,1,1,1,0
2021,149222,43,3,78,32,46
2021,149222,43,4,56,36,20
2021,149222,43,5,13,4,9
2021,149222,44,0,289,148,141
2021,149222,44,1,41,20,21
2021,149222,44,2,98,51,47
2021,149222,44,3,101,59,42
2021,149222,44,4,13,1,12
2021,149222,44,5,36,17,19
2021,149231,0,0,645,310,335
2021,149231,10,0,645,310,335
2021,149231,10,1,192,113,79
2021,149231,10,2,165,93,72
2021,149231,10,3,133,58,75
2021,149231,10,4,154,46,108
2021,149231,10,5,1,0,1
2021,149231,20,0,328,190,138
2021,149231,20,1,185,109,76
2021,149231,20,2,143,81,62
2021,149231,30,0,118,49,69
2021,149231,30,2,6,4,2
2021,149231,30,3,112,45,67
2021,149231,40,0,199,71,128
2021,149231,40,1,7,4,3
2021,149231,40,2,16,8,8
2021,149231,40,3,21,13,8
2021,149231,40,4,154,46,108
2021,149231,40,5,1,0,1
2021,149231,41,0,79,33,46
2021,149231,41,1,3,0,3
2021,149231,41,2,9,1,8
2021,149231,41,3,5,1,4
2021,149231,41,4,62,31,31
2021,149231,42,0,119,37,82
2021,149231,42,1,4,4,0
2021,149231,42,2,7,7,0
2021,149231,42,3,16,12,4
2021,149231,42,4,91,14,77
2021,149231,42,5,1,0,1
2021,149231,43,0,1,1,0
2021,149231,43,4,1,1,0
2021,149231,44,0,18,3,15
2021,149231,44,1,3,0,3
2021,149231,44,2,9,1,8
2021,149231,44,3,5,1,4
2021,149231,44,4,1,1,0
2021,149231,45,0,61,30,31
2021,149231,45,4,61,30,31
2021,149329,0,0,7,7,0
2021,149329,10,0,7,7,0
2021,149329,10,4,7,7,0
2021,149329,40,0,7,7,0
2021,149329,40,4,7,7,0
2021,149329,42,0,7,7,0
2021,149329,42,4,7,7,0
2021,149365,0,0,72,32,40
2021,149365,10,0,72,32,40
2021,149365,10,6,72,32,40
2021,149365,20,0,52,28,24
2021,149365,20,6,52,28,24
2021,149365,30,0,14,3,11
2021,149365,30,6,14,3,11
2021,149365,40,0,6,1,5
2021,149365,40,6,6,1,5
2021,149365,41,0,4,0,4
2021,149365,41,6,4,0,4
2021,149365,42,0,2,1,1
2021,149365,42,6,2,1,1
2021,149365,44,0,4,0,4
2021,149365,44,6,4,0,4
2021,149505,0,0,67,33,34
2021,149505,10,0,67,33,34
2021,149505,10,1,20,16,4
2021,149505,10,2,18,5,13
2021,149505,10,3,29,12,17
2021,149505,20,0,26,19,7
2021,149505,20,1,19,15,4
2021,149505,20,2,7,4,3
2021,149505,30,0,23,10,13
2021,149505,30,1,1,1,0
2021,149505,30,2,9,1,8
2021,149505,30,3,13,8,5
2021,149505,40,0,18,4,14
2021,149505,40,2,2,0,2
2021,149505,40,3,16,4,12
2021,149505,41,0,3,1,2
2021,149505,41,3,3,1,2
2021,149505,42,0,15,3,12
2021,149505,42,2,2,0,2
2021,149505,42,3,13,3,10
2021,149505,44,0,3,1,2
2021,149505,44,3,3,1,2
2021,149514,0,0,56,41,15
2021,149514,10,0,56,41,15
2021,149514,10,1,20,16,4
2021,149514,10,2,21,17,4
2021,149514,10,3,13,6,7
2021,149514,10,4,2,2,0
2021,149514,20,0,29,22,7
2021,149514,20,1,19,15,4
2021,149514,20,2,10,7,3
2021,149514,30,0,13,8,5
2021,149514,30,2,6,5,1
2021,149514,30,3,7,3,4
2021,149514,40,0,14,11,3
2021,149514,40,1,1,1,0
2021,149514,40,2,5,5,0
2021,149514,40,3,6,3,3
2021,149514,40,4,2,2,0
2021,149514,42,0,14,11,3
2021,149514,42,1,1,1,0
2021,149514,42,2,5,5,0
2021,149514,42,3,6,3,3
2021,149514,42,4,2,2,0
2021,149532,0,0,97,47,50
2021,149532,10,0,97,47,50
2021,149532,10,6,97,47,50
2021,149532,20,0,79,40,39
2021,149532,20,6,79,40,39
2021,149532,30,0,7,4,3
2021,149532,30,6,7,4,3
2021,149532,40,0,11,3,8
2021,149532,40,6,11,3,8
2021,149532,41,0,11,3,8
2021,149532,41,6,11,3,8
2021,149532,44,0,11,3,8
2021,149532,44,6,11,3,8
2021,149639,0,0,11,5,6
2021,149639,10,0,11,5,6
2021,149639,10,1,5,1,4
2021,149639,10,2,4,2,2
2021,149639,10,3,2,2,0
2021,149639,40,0,11,5,6
2021,149639,40,1,5,1,4
2021,149639,40,2,4,2,2
2021,149639,40,3,2,2,0
2021,149639,41,0,11,5,6
2021,149639,41,1,5,1,4
2021,149639,41,2,4,2,2
2021,149639,41,3,2,2,0
2021,149639,45,0,11,5,6
2021,149639,45,1,5,1,4
2021,149639,45,2,4,2,2
2021,149639,45,3,2,2,0
2021,149727,0,0,92,44,48
2021,149727,10,0,92,44,48
2021,149727,10,1,28,14,14
2021,149727,10,2,24,9,15
2021,149727,10,3,32,16,16
2021,149727,10,4,8,5,3
2021,149727,20,0,84,39,45
2021,149727,20,1,28,14,14
2021,149727,20,2,24,9,15
2021,149727,20,3,32,16,16
2021,149727,30,0,8,5,3
2021,149727,30,4,8,5,3
2021,149763,0,0,40,7,33
2021,149763,10,0,40,7,33
2021,149763,10,2,5,1,4
2021,149763,10,3,12,1,11
2021,149763,10,4,23,5,18
2021,149763,40,0,40,7,33
2021,149763,40,2,5,1,4
2021,149763,40,3,12,1,11
2021,149763,40,4,23,5,18
2021,149763,41,0,35,7,28
2021,149763,41,2,5,1,4
2021,149763,41,3,12,1,11
2021,149763,41,4,18,5,13
2021,149763,42,0,5,0,5
2021,149763,42,4,5,0,5
2021,149763,44,0,31,7,24
2021,149763,44,2,3,1,2
2021,149763,44,3,10,1,9
2021,149763,44,4,18,5,13
2021,149763,45,0,4,0,4
2021,149763,45,2,2,0,2
2021,149763,45,3,2,0,2
2021,149772,0,0,443,244,199
2021,149772,10,0,443,244,199
2021,149772,10,1,200,130,70
2021,149772,10,2,92,53,39
2021,149772,10,3,66,32,34
2021,149772,10,4,81,26,55
2021,149772,10,5,4,3,1
2021,149772,20,0,288,181,107
2021,149772,20,1,200,130,70
2021,149772,20,2,88,51,37
2021,149772,30,0,69,34,35
2021,149772,30,2,3,2,1
2021,149772,30,3,66,32,34
2021,149772,40,0,86,29,57
2021,149772,40,2,1,0,1
2021,149772,40,4,81,26,55
2021,149772,40,5,4,3,1
2021,149772,41,0,86,29,57
2021,149772,41,2,1,0,1
2021,149772,41,4,81,26,55
2021,149772,41,5,4,3,1
2021,149772,45,0,86,29,57
2021,149772,45,2,1,0,1
2021,149772,45,4,81,26,55
2021,149772,45,5,4,3,1
2021,149781,0,0,212,133,79
2021,149781,10,0,212,133,79
2021,149781,10,1,59,44,15
2021,149781,10,2,85,56,29
2021,149781,10,3,63,33,30
2021,149781,10,4,5,0,5
2021,149781,20,0,126,90,36
2021,149781,20,1,56,42,14
2021,149781,20,2,70,48,22
2021,149781,30,0,58,29,29
2021,149781,30,1,3,2,1
2021,149781,30,2,9,5,4
2021,149781,30,3,46,22,24
2021,149781,40,0,28,14,14
2021,149781,40,2,6,3,3
2021,149781,40,3,17,11,6
2021,149781,40,4,5,0,5
2021,149781,42,0,28,14,14
2021,149781,42,2,6,3,3
2021,149781,42,3,17,11,6
2021,149781,42,4,5,0,5
2021,149842,0,0,201,78,123
2021,149842,10,0,201,78,123
2021,149842,10,1,77,35,42
2021,149842,10,2,62,26,36
2021,149842,10,3,39,11,28
2021,149842,10,4,21,5,16
2021,149842,10,6,2,1,1
2021,149842,20,0,178,73,105
2021,149842,20,1,77,35,42
2021,149842,20,2,61,26,35
2021,149842,20,3,33,10,23
2021,149842,20,4,7,2,5
2021,149842,30,0,23,5,18
2021,149842,30,2,1,0,1
2021,149842,30,3,6,1,5
2021,149842,30,4,14,3,11
2021,149842,30,6,2,1,1
2021,150066,0,0,96,55,41
2021,150066,10,0,96,55,41
2021,150066,10,1,38,27,11
2021,150066,10,2,19,10,9
2021,150066,10,3,37,17,20
2021,150066,10,4,2,1,1
2021,150066,20,0,44,30,14
2021,150066,20,1,34,25,9
2021,150066,20,2,9,5,4
2021,150066,20,3,1,0,1
2021,150066,30,0,32,19,13
2021,150066,30,1,3,2,1
2021,150066,30,2,7,5,2
2021,150066,30,3,22,12,10
2021,150066,40,0,20,6,14
2021,150066,40,1,1,0,1
2021,150066,40,2,3,0,3
2021,150066,40,3,14,5,9
2021,150066,40,4,2,1,1
2021,150066,42,0,20,6,14
2021,150066,42,1,1,0,1
2021,150066,42,2,3,0,3
2021,150066,42,3,14,5,9
2021,150066,42,4,2,1,1
2021,150136,0,0,1042,517,525
2021,150136,10,0,1039,515,524
2021,150136,10,1,204,132,72
2021,150136,10,2,236,121,115
2021,150136,10,3,206,110,96
2021,150136,10,4,251,91,160
2021,150136,10,5,139,59,80
2021,150136,10,6,3,2,1
2021,150136,20,0,437,251,186
2021,150136,20,1,203,131,72
2021,150136,20,2,221,115,106
2021,150136,20,3,13,5,8
2021,150136,30,0,202,104,98
2021,150136,30,2,15,6,9
2021,150136,30,3,186,98,88
2021,150136,30,4,1,0,1
2021,150136,40,0,400,160,240
2021,150136,40,1,1,1,0
2021,150136,40,3,7,7,0
2021,150136,40,4,250,91,159
2021,150136,40,5,139,59,80
2021,150136,40,6,3,2,1
2021,150136,41,0,1,0,1
2021,150136,41,4,1,0,1
2021,150136,42,0,399,160,239
2021,150136,42,1,1,1,0
2021,150136,42,3,7,7,0
2021,150136,42,4,249,91,158
2021,150136,42,5,139,59,80
2021,150136,42,6,3,2,1
2021,150136,44,0,1,0,1
2021,150136,44,4,1,0,1
2021,150136,50,0,3,2,1
2021,150145,0,0,63,29,34
2021,150145,10,0,63,29,34
2021,150145,10,1,12,9,3
2021,150145,10,2,23,12,11
2021,150145,10,3,28,8,20
2021,150145,20,0,30,19,11
2021,150145,20,1,11,9,2
2021,150145,20,2,18,9,9
2021,150145,20,3,1,1,0
2021,150145,30,0,22,7,15
2021,150145,30,1,1,0,1
2021,150145,30,2,5,3,2
2021,150145,30,3,16,4,12
2021,150145,40,0,11,3,8
2021,150145,40,3,11,3,8
2021,150145,42,0,11,3,8
2021,150145,42,3,11,3,8
2021,150163,0,0,368,179,189
2021,150163,10,0,368,179,189
2021,150163,10,1,117,64,53
2021,150163,10,2,103,50,53
2021,150163,10,3,61,29,32
2021,150163,10,4,53,17,36
2021,150163,10,5,34,19,15
2021,150163,20,0,190,102,88
2021,150163,20,1,113,62,51
2021,150163,20,2,77,40,37
2021,150163,30,0,52,31,21
2021,150163,30,2,8,7,1
2021,150163,30,3,43,24,19
2021,150163,30,4,1,0,1
2021,150163,40,0,126,46,80
2021,150163,40,1,4,2,2
2021,150163,40,2,18,3,15
2021,150163,40,3,18,5,13
2021,150163,40,4,52,17,35
2021,150163,40,5,34,19,15
2021,150163,41,0,126,46,80
2021,150163,41,1,4,2,2
2021,150163,41,2,18,3,15
2021,150163,41,3,18,5,13
2021,150163,41,4,52,17,35
2021,150163,41,5,34,19,15
2021,150163,44,0,126,46,80
2021,150163,44,1,4,2,2
2021,150163,44,2,18,3,15
2021,150163,44,3,18,5,13
2021,150163,44,4,52,17,35
2021,150163,44,5,34,19,15
2021,150172,0,0,24,14,10
2021,150172,10,0,24,14,10
2021,150172,10,1,3,2,1
2021,150172,10,2,8,4,4
2021,150172,10,3,4,4,0
2021,150172,10,4,9,4,5
2021,150172,20,0,12,7,5
2021,150172,20,1,3,2,1
2021,150172,20,2,8,4,4
2021,150172,20,3,1,1,0
2021,150172,30,0,3,3,0
2021,150172,30,3,3,3,0
2021,150172,40,0,9,4,5
2021,150172,40,4,9,4,5
2021,150172,41,0,1,1,0
2021,150172,41,4,1,1,0
2021,150172,42,0,8,3,5
2021,150172,42,4,8,3,5
2021,150172,44,0,1,1,0
2021,150172,44,4,1,1,0
2021,150215,0,0,16,7,9
2021,150215,10,0,15,7,8
2021,150215,10,1,2,2,0
2021,150215,10,2,5,2,3
2021,150215,10,3,5,0,5
2021,150215,10,6,3,3,0
2021,150215,20,0,7,4,3
2021,150215,20,1,2,2,0
2021,150215,20,2,5,2,3
2021,150215,30,0,6,3,3
2021,150215,30,3,3,0,3
2021,150215,30,6,3,3,0
2021,150215,40,0,2,0,2
2021,150215,40,3,2,0,2
2021,150215,41,0,2,0,2
2021,150215,41,3,2,0,2
2021,150215,44,0,2,0,2
2021,150215,44,3,2,0,2
2021,150215,50,0,1,0,1
2021,150288,0,0,21,20,1
2021,150288,10,0,18,18,0
2021,150288,10,1,11,11,0
2021,150288,10,2,3,3,0
2021,150288,10,3,4,4,0
2021,150288,20,0,14,14,0
2021,150288,20,1,11,11,0
2021,150288,20,2,3,3,0
2021,150288,30,0,4,4,0
2021,150288,30,3,4,4,0
2021,150288,50,0,3,2,1
2021,150400,0,0,189,103,86
2021,150400,10,0,189,103,86
2021,150400,10,1,86,49,37
2021,150400,10,2,51,27,24
2021,150400,10,3,47,25,22
2021,150400,10,4,5,2,3
2021,150400,20,0,131,73,58
2021,150400,20,1,85,48,37
2021,150400,20,2,44,24,20
2021,150400,20,3,2,1,1
2021,150400,30,0,16,6,10
2021,150400,30,2,2,1,1
2021,150400,30,3,14,5,9
2021,150400,40,0,42,24,18
2021,150400,40,1,1,1,0
2021,150400,40,2,5,2,3
2021,150400,40,3,31,19,12
2021,150400,40,4,5,2,3
2021,150400,41,0,30,18,12
2021,150400,41,1,1,1,0
2021,150400,41,2,4,1,3
2021,150400,41,3,22,15,7
2021,150400,41,4,3,1,2
2021,150400,42,0,12,6,6
2021,150400,42,2,1,1,0
2021,150400,42,3,9,4,5
2021,150400,42,4,2,1,1
2021,150400,44,0,30,18,12
2021,150400,44,1,1,1,0
2021,150400,44,2,4,1,3
2021,150400,44,3,22,15,7
2021,150400,44,4,3,1,2
2021,150455,0,0,98,55,43
2021,150455,10,0,91,53,38
2021,150455,10,1,31,21,10
2021,150455,10,2,21,12,9
2021,150455,10,3,39,20,19
2021,150455,20,0,47,28,19
2021,150455,20,1,27,17,10
2021,150455,20,2,20,11,9
2021,150455,30,0,19,8,11
2021,150455,30,3,19,8,11
2021,150455,40,0,25,17,8
2021,150455,40,1,4,4,0
2021,150455,40,2,1,1,0
2021,150455,40,3,20,12,8
2021,150455,42,0,25,17,8
2021,150455,42,1,4,4,0
2021,150455,42,2,1,1,0
2021,150455,42,3,20,12,8
2021,150455,50,0,7,2,5
2021,150534,0,0,149,77,72
2021,150534,10,0,149,77,72
2021,150534,10,1,44,35,9
2021,150534,10,2,42,17,25
2021,150534,10,3,59,24,35
2021,150534,10,4,3,1,2
2021,150534,10,5,1,0,1
2021,150534,20,0,76,51,25
2021,150534,20,1,42,33,9
2021,150534,20,2,33,17,16
2021,150534,20,3,1,1,0
2021,150534,30,0,30,10,20
2021,150534,30,1,1,1,0
2021,150534,30,2,8,0,8
2021,150534,30,3,21,9,12
2021,150534,40,0,43,16,27
2021,150534,40,1,1,1,0
2021,150534,40,2,1,0,1
2021,150534,40,3,37,14,23
2021,150534,40,4,3,1,2
2021,150534,40,5,1,0,1
2021,150534,42,0,43,16,27
2021,150534,42,1,1,1,0
2021,150534,42,2,1,0,1
2021,150534,42,3,37,14,23
2021,150534,42,4,3,1,2
2021,150534,42,5,1,0,1
2021,150604,0,0,74,38,36
2021,150604,10,0,74,38,36
2021,150604,10,1,19,13,6
2021,150604,10,2,14,7,7
2021,150604,10,3,26,11,15
2021,150604,10,4,14,6,8
2021,150604,10,5,1,1,0
2021,150604,20,0,33,20,13
2021,150604,20,1,19,13,6
2021,150604,20,2,14,7,7
2021,150604,30,0,19,10,9
2021,150604,30,3,17,8,9
2021,150604,30,4,2,2,0
2021,150604,40,0,22,8,14
2021,150604,40,3,9,3,6
2021,150604,40,4,12,4,8
2021,150604,40,5,1,1,0
2021,150604,41,0,1,1,0
2021,150604,41,4,1,1,0
2021,150604,42,0,21,7,14
2021,150604,42,3,9,3,6
2021,150604,42,4,11,3,8
2021,150604,42,5,1,1,0
2021,150604,44,0,1,1,0
2021,150604,44,4,1,1,0
2021,150668,0,0,66,31,35
2021,150668,10,0,63,29,34
2021,150668,10,1,31,18,13
2021,150668,10,2,18,6,12
2021,150668,10,3,14,5,9
2021,150668,20,0,29,16,13
2021,150668,20,1,24,14,10
2021,150668,20,2,5,2,3
2021,150668,30,0,7,5,2
2021,150668,30,1,2,2,0
2021,150668,30,2,2,1,1
2021,150668,30,3,3,2,1
2021,150668,40,0,27,8,19
2021,150668,40,1,5,2,3
2021,150668,40,2,11,3,8
2021,150668,40,3,11,3,8
2021,150668,42,0,27,8,19
2021,150668,42,1,5,2,3
2021,150668,42,2,11,3,8
2021,150668,42,3,11,3,8
2021,150668,50,0,3,2,1
2021,150677,0,0,49,31,18
2021,150677,10,0,49,31,18
2021,150677,10,1,16,13,3
2021,150677,10,2,6,2,4
2021,150677,10,3,24,14,10
2021,150677,10,4,3,2,1
2021,150677,40,0,49,31,18
2021,150677,40,1,16,13,3
2021,150677,40,2,6,2,4
2021,150677,40,3,24,14,10
2021,150677,40,4,3,2,1
2021,150677,42,0,49,31,18
2021,150677,42,1,16,13,3
2021,150677,42,2,6,2,4
2021,150677,42,3,24,14,10
2021,150677,42,4,3,2,1
2021,150756,0,0,98,60,38
2021,150756,10,0,98,60,38
2021,150756,10,1,49,32,17
2021,150756,10,2,22,14,8
2021,150756,10,3,23,11,12
2021,150756,10,4,4,3,1
2021,150756,20,0,59,36,23
2021,150756,20,1,47,30,17
2021,150756,20,2,12,6,6
2021,150756,30,0,25,14,11
2021,150756,30,2,5,4,1
2021,150756,30,3,18,9,9
2021,150756,30,4,2,1,1
2021,150756,40,0,14,10,4
2021,150756,40,1,2,2,0
2021,150756,40,2,5,4,1
2021,150756,40,3,5,2,3
2021,150756,40,4,2,2,0
2021,150756,41,0,3,2,1
2021,150756,41,2,2,1,1
2021,150756,41,3,1,1,0
2021,150756,42,0,11,8,3
2021,150756,42,1,2,2,0
2021,150756,42,2,3,3,0
2021,150756,42,3,4,1,3
2021,150756,42,4,2,2,0
2021,150756,44,0,1,0,1
2021,150756,44,2,1,0,1
2021,150756,45,0,2,2,0
2021,150756,45,2,1,1,0
2021,150756,45,3,1,1,0
2021,150774,0,0,29,15,14
2021,150774,10,0,27,14,13
2021,150774,10,1,3,2,1
2021,150774,10,2,5,2,3
2021,150774,10,3,9,6,3
2021,150774,10,4,8,3,5
2021,150774,10,5,2,1,1
2021,150774,20,0,7,4,3
2021,150774,20,1,3,2,1
2021,150774,20,2,4,2,2
2021,150774,30,0,7,5,2
2021,150774,30,2,1,0,1
2021,150774,30,3,6,5,1
2021,150774,40,0,13,5,8
2021,150774,40,3,3,1,2
2021,150774,40,4,8,3,5
2021,150774,40,5,2,1,1
2021,150774,41,0,3,1,2
2021,150774,41,4,1,0,1
2021,150774,41,5,2,1,1
2021,150774,42,0,10,4,6
2021,150774,42,3,3,1,2
2021,150774,42,4,7,3,4
2021,150774,44,0,3,1,2
2021,150774,44,4,1,0,1
2021,150774,44,5,2,1,1
2021,150774,50,0,2,1,1
2021,150941,0,0,75,39,36
2021,150941,10,0,75,39,36
2021,150941,10,1,18,13,5
2021,150941,10,2,18,10,8
2021,150941,10,3,33,13,20
2021,150941,10,4,5,3,2
2021,150941,10,6,1,0,1
2021,150941,20,0,24,18,6
2021,150941,20,1,16,12,4
2021,150941,20,2,8,6,2
2021,150941,30,0,41,16,25
2021,150941,30,1,1,1,0
2021,150941,30,2,9,3,6
2021,150941,30,3,31,12,19
2021,150941,40,0,10,5,5
2021,150941,40,1,1,0,1
2021,150941,40,2,1,1,0
2021,150941,40,3,2,1,1
2021,150941,40,4,5,3,2
2021,150941,40,6,1,0,1
2021,150941,42,0,10,5,5
2021,150941,42,1,1,0,1
2021,150941,42,2,1,1,0
2021,150941,42,3,2,1,1
2021,150941,42,4,5,3,2
2021,150941,42,6,1,0,1
2021,150987,0,0,1115,457,658
2021,150987,10,0,1115,457,658
2021,150987,10,1,75,32,43
2021,150987,10,2,291,108,183
2021,150987,10,3,483,210,273
2021,150987,10,4,260,103,157
2021,150987,10,5,6,4,2
2021,150987,40,0,1115,457,658
2021,150987,40,1,75,32,43
2021,150987,40,2,291,108,183
2021,150987,40,3,483,210,273
2021,150987,40,4,260,103,157
2021,150987,40,5,6,4,2
2021,150987,42,0,1094,444,650
2021,150987,42,1,75,32,43
2021,150987,42,2,291,108,183
2021,150987,42,3,481,209,272
2021,150987,42,4,243,92,151
2021,150987,42,5,4,3,1
2021,150987,43,0,21,13,8
2021,150987,43,3,2,1,1
2021,150987,43,4,17,11,6
2021,150987,43,5,2,1,1
2021,151102,0,0,364,210,154
2021,151102,10,0,228,146,82
2021,151102,10,1,61,44,17
2021,151102,10,2,99,57,42
2021,151102,10,3,65,43,22
2021,151102,10,4,3,2,1
2021,151102,20,0,154,98,56
2021,151102,20,1,57,42,15
2021,151102,20,2,96,55,41
2021,151102,20,4,1,1,0
2021,151102,30,0,44,29,15
2021,151102,30,2,3,2,1
2021,151102,30,3,41,27,14
2021,151102,40,0,30,19,11
2021,151102,40,1,4,2,2
2021,151102,40,3,24,16,8
2021,151102,40,4,2,1,1
2021,151102,41,0,5,4,1
2021,151102,41,1,1,1,0
2021,151102,41,3,4,3,1
2021,151102,42,0,2,2,0
2021,151102,42,3,2,2,0
2021,151102,43,0,23,13,10
2021,151102,43,1,3,1,2
2021,151102,43,3,18,11,7
2021,151102,43,4,2,1,1
2021,151102,45,0,5,4,1
2021,151102,45,1,1,1,0
2021,151102,45,3,4,3,1
2021,151102,50,0,136,64,72
2021,151111,0,0,2693,1497,1196
2021,151111,10,0,2692,1497,1195
2021,151111,10,1,518,370,148
2021,151111,10,2,610,357,253
2021,151111,10,3,1223,628,595
2021,151111,10,5,341,142,199
2021,151111,20,0,776,524,252
2021,151111,20,1,429,317,112
2021,151111,20,2,345,205,140
2021,151111,20,3,2,2,0
2021,151111,30,0,352,191,161
2021,151111,30,1,7,5,2
2021,151111,30,2,52,27,25
2021,151111,30,3,293,159,134
2021,151111,40,0,1564,782,782
2021,151111,40,1,82,48,34
2021,151111,40,2,213,125,88
2021,151111,40,3,928,467,461
2021,151111,40,5,341,142,199
2021,151111,41,0,1476,750,726
2021,151111,41,1,80,47,33
2021,151111,41,2,211,123,88
2021,151111,41,3,898,455,443
2021,151111,41,5,287,125,162
2021,151111,42,0,88,32,56
2021,151111,42,1,2,1,1
2021,151111,42,2,2,2,0
2021,151111,42,3,30,12,18
2021,151111,42,5,54,17,37
2021,151111,44,0,814,419,395
2021,151111,44,1,17,11,6
2021,151111,44,2,78,42,36
2021,151111,44,3,523,275,248
2021,151111,44,5,196,91,105
2021,151111,45,0,662,331,331
2021,151111,45,1,63,36,27
2021,151111,45,2,133,81,52
2021,151111,45,3,375,180,195
2021,151111,45,5,91,34,57
2021,151111,50,0,1,0,1
2021,151263,0,0,297,126,171
2021,151263,10,0,297,126,171
2021,151263,10,1,45,19,26
2021,151263,10,2,76,35,41
2021,151263,10,3,147,60,87
2021,151263,10,4,29,12,17
2021,151263,20,0,110,49,61
2021,151263,20,1,43,19,24
2021,151263,20,2,67,30,37
2021,151263,30,0,95,40,55
2021,151263,30,1,1,0,1
2021,151263,30,2,6,4,2
2021,151263,30,3,87,36,51
2021,151263,30,4,1,0,1
2021,151263,40,0,92,37,55
2021,151263,40,1,1,0,1
2021,151263,40,2,3,1,2
2021,151263,40,3,60,24,36
2021,151263,40,4,28,12,16
2021,151263,42,0,92,37,55
2021,151263,42,1,1,0,1
2021,151263,42,2,3,1,2
2021,151263,42,3,60,24,36
2021,151263,42,4,28,12,16
2021,151290,0,0,63,37,26
2021,151290,10,0,63,37,26
2021,151290,10,1,8,5,3
2021,151290,10,2,23,15,8
2021,151290,10,3,26,15,11
2021,151290,10,4,5,1,4
2021,151290,10,5,1,1,0
2021,151290,20,0,23,15,8
2021,151290,20,1,7,5,2
2021,151290,20,2,16,10,6
2021,151290,30,0,34,20,14
2021,151290,30,1,1,0,1
2021,151290,30,2,7,5,2
2021,151290,30,3,26,15,11
2021,151290,40,0,6,2,4
2021,151290,40,4,5,1,4
2021,151290,40,5,1,1,0
2021,151290,42,0,6,2,4
2021,151290,42,4,5,1,4
2021,151290,42,5,1,1,0
2021,151306,0,0,345,155,190
2021,151306,10,0,345,155,190
2021,151306,10,1,47,27,20
2021,151306,10,2,121,64,57
2021,151306,10,3,107,40,67
2021,151306,10,4,70,24,46
2021,151306,20,0,169,93,76
2021,151306,20,1,46,27,19
2021,151306,20,2,118,63,55
2021,151306,20,3,5,3,2
2021,151306,30,0,78,33,45
2021,151306,30,2,1,1,0
2021,151306,30,3,77,32,45
2021,151306,40,0,98,29,69
2021,151306,40,1,1,0,1
2021,151306,40,2,2,0,2
2021,151306,40,3,25,5,20
2021,151306,40,4,70,24,46
2021,151306,41,0,91,29,62
2021,151306,41,1,1,0,1
2021,151306,41,2,2,0,2
2021,151306,41,3,24,5,19
2021,151306,41,4,64,24,40
2021,151306,42,0,7,0,7
2021,151306,42,3,1,0,1
2021,151306,42,4,6,0,6
2021,151306,44,0,10,4,6
2021,151306,44,3,1,0,1
2021,151306,44,4,9,4,5
2021,151306,45,0,81,25,56
2021,151306,45,1,1,0,1
2021,151306,45,2,2,0,2
2021,151306,45,3,23,5,18
2021,151306,45,4,55,20,35
2021,151324,0,0,424,224,200
2021,151324,10,0,424,224,200
2021,151324,10,1,132,84,48
2021,151324,10,2,93,42,51
2021,151324,10,3,88,44,44
2021,151324,10,4,102,47,55
2021,151324,10,5,9,7,2
2021,151324,20,0,215,122,93
2021,151324,20,1,132,84,48
2021,151324,20,2,82,37,45
2021,151324,20,3,1,1,0
2021,151324,30,0,98,48,50
2021,151324,30,2,11,5,6
2021,151324,30,3,87,43,44
2021,151324,40,0,111,54,57
2021,151324,40,4,102,47,55
2021,151324,40,5,9,7,2
2021,151324,41,0,102,47,55
2021,151324,41,4,102,47,55
2021,151324,42,0,9,7,2
2021,151324,42,5,9,7,2
2021,151324,44,0,102,47,55
2021,151324,44,4,102,47,55
2021,151333,0,0,125,49,76
2021,151333,10,0,125,49,76
2021,151333,10,1,11,9,2
2021,151333,10,2,29,12,17
2021,151333,10,3,44,17,27
2021,151333,10,5,41,11,30
2021,151333,20,0,27,17,10
2021,151333,20,1,9,8,1
2021,151333,20,2,18,9,9
2021,151333,30,0,45,20,25
2021,151333,30,1,1,1,0
2021,151333,30,2,8,3,5
2021,151333,30,3,36,16,20
2021,151333,40,0,53,12,41
2021,151333,40,1,1,0,1
2021,151333,40,2,3,0,3
2021,151333,40,3,8,1,7
2021,151333,40,5,41,11,30
2021,151333,41,0,43,7,36
2021,151333,41,1,1,0,1
2021,151333,41,2,3,0,3
2021,151333,41,3,8,1,7
2021,151333,41,5,31,6,25
2021,151333,42,0,10,5,5
2021,151333,42,5,10,5,5
2021,151333,44,0,10,1,9
2021,151333,44,1,1,0,1
2021,151333,44,2,2,0,2
2021,151333,44,3,2,0,2
2021,151333,44,5,5,1,4
2021,151333,45,0,33,6,27
2021,151333,45,2,1,0,1
2021,151333,45,3,6,1,5
2021,151333,45,5,26,5,21
2021,151342,0,0,235,113,122
2021,151342,10,0,235,113,122
2021,151342,10,1,60,33,27
2021,151342,10,2,69,40,29
2021,151342,10,3,58,23,35
2021,151342,10,5,48,17,31
2021,151342,20,0,118,68,50
2021,151342,20,1,57,32,25
2021,151342,20,2,61,36,25
2021,151342,30,0,26,17,9
2021,151342,30,1,1,1,0
2021,151342,30,2,2,2,0
2021,151342,30,3,23,14,9
2021,151342,40,0,91,28,63
2021,151342,40,1,2,0,2
2021,151342,40,2,6,2,4
2021,151342,40,3,35,9,26
2021,151342,40,5,48,17,31
2021,151342,41,0,64,14,50
2021,151342,41,1,2,0,2
2021,151342,41,2,6,2,4
2021,151342,41,3,17,1,16
2021,151342,41,5,39,11,28
2021,151342,42,0,27,14,13
2021,151342,42,3,18,8,10
2021,151342,42,5,9,6,3
2021,151342,44,0,11,1,10
2021,151342,44,1,2,0,2
2021,151342,44,2,1,1,0
2021,151342,44,3,1,0,1
2021,151342,44,5,7,0,7
2021,151342,45,0,53,13,40
2021,151342,45,2,5,1,4
2021,151342,45,3,16,1,15
2021,151342,45,5,32,11,21
2021,151351,0,0,2089,1229,860
2021,151351,10,0,2089,1229,860
2021,151351,10,1,734,510,224
2021,151351,10,2,509,295,214
2021,151351,10,3,402,210,192
2021,151351,10,5,444,214,230
2021,151351,20,0,1012,684,328
2021,151351,20,1,634,456,178
2021,151351,20,2,378,228,150
2021,151351,30,0,367,203,164
2021,151351,30,1,5,3,2
2021,151351,30,2,73,42,31
2021,151351,30,3,289,158,131
2021,151351,40,0,710,342,368
2021,151351,40,1,95,51,44
2021,151351,40,2,58,25,33
2021,151351,40,3,113,52,61
2021,151351,40,5,444,214,230
2021,151351,41,0,583,281,302
2021,151351,41,1,93,51,42
2021,151351,41,2,55,24,31
2021,151351,41,3,46,16,30
2021,151351,41,5,389,190,199
2021,151351,42,0,127,61,66
2021,151351,42,1,2,0,2
2021,151351,42,2,3,1,2
2021,151351,42,3,67,36,31
2021,151351,42,5,55,24,31
2021,151351,44,0,15,6,9
2021,151351,44,1,5,4,1
2021,151351,44,2,3,0,3
2021,151351,44,3,1,0,1
2021,151351,44,5,6,2,4
2021,151351,45,0,568,275,293
2021,151351,45,1,88,47,41
2021,151351,45,2,52,24,28
2021,151351,45,3,45,16,29
2021,151351,45,5,383,188,195
2021,151360,0,0,137,57,80
2021,151360,10,0,137,57,80
2021,151360,10,1,24,14,10
2021,151360,10,2,46,25,21
2021,151360,10,3,43,12,31
2021,151360,10,5,24,6,18
2021,151360,20,0,60,35,25
2021,151360,20,1,21,12,9
2021,151360,20,2,39,23,16
2021,151360,30,0,17,6,11
2021,151360,30,2,3,1,2
2021,151360,30,3,14,5,9
2021,151360,40,0,60,16,44
2021,151360,40,1,3,2,1
2021,151360,40,2,4,1,3
2021,151360,40,3,29,7,22
2021,151360,40,5,24,6,18
2021,151360,41,0,46,12,34
2021,151360,41,1,2,1,1
2021,151360,41,2,4,1,3
2021,151360,41,3,26,7,19
2021,151360,41,5,14,3,11
2021,151360,42,0,14,4,10
2021,151360,42,1,1,1,0
2021,151360,42,3,3,0,3
2021,151360,42,5,10,3,7
2021,151360,44,0,6,4,2
2021,151360,44,3,3,3,0
2021,151360,44,5,3,1,2
2021,151360,45,0,40,8,32
2021,151360,45,1,2,1,1
2021,151360,45,2,4,1,3
2021,151360,45,3,23,4,19
2021,151360,45,5,11,2,9
2021,151379,0,0,183,76,107
2021,151379,10,0,183,76,107
2021,151379,10,1,49,22,27
2021,151379,10,2,57,28,29
2021,151379,10,3,39,11,28
2021,151379,10,5,38,15,23
2021,151379,20,0,92,47,45
2021,151379,20,1,41,21,20
2021,151379,20,2,51,26,25
2021,151379,30,0,31,11,20
2021,151379,30,2,5,2,3
2021,151379,30,3,26,9,17
2021,151379,40,0,60,18,42
2021,151379,40,1,8,1,7
2021,151379,40,2,1,0,1
2021,151379,40,3,13,2,11
2021,151379,40,5,38,15,23
2021,151379,41,0,54,16,38
2021,151379,41,1,8,1,7
2021,151379,41,2,1,0,1
2021,151379,41,3,8,1,7
2021,151379,41,5,37,14,23
2021,151379,42,0,6,2,4
2021,151379,42,3,5,1,4
2021,151379,42,5,1,1,0
2021,151379,45,0,54,16,38
2021,151379,45,1,8,1,7
2021,151379,45,2,1,0,1
2021,151379,45,3,8,1,7
2021,151379,45,5,37,14,23
2021,151388,0,0,108,38,70
2021,151388,10,0,108,38,70
2021,151388,10,1,7,4,3
2021,151388,10,2,30,12,18
2021,151388,10,3,41,13,28
2021,151388,10,5,30,9,21
2021,151388,20,0,38,15,23
2021,151388,20,1,7,4,3
2021,151388,20,2,26,8,18
2021,151388,20,3,5,3,2
2021,151388,30,0,33,13,20
2021,151388,30,2,4,4,0
2021,151388,30,3,29,9,20
2021,151388,40,0,37,10,27
2021,151388,40,3,7,1,6
2021,151388,40,5,30,9,21
2021,151388,41,0,26,7,19
2021,151388,41,3,5,0,5
2021,151388,41,5,21,7,14
2021,151388,42,0,11,3,8
2021,151388,42,3,2,1,1
2021,151388,42,5,9,2,7
2021,151388,44,0,3,0,3
2021,151388,44,3,2,0,2
2021,151388,44,5,1,0,1
2021,151388,45,0,23,7,16
2021,151388,45,3,3,0,3
2021,151388,45,5,20,7,13
2021,151467,0,0,15,2,13
2021,151467,10,0,15,2,13
2021,151467,10,4,15,2,13
2021,151467,40,0,15,2,13
2021,151467,40,4,15,2,13
2021,151467,41,0,15,2,13
2021,151467,41,4,15,2,13
2021,151467,45,0,15,2,13
2021,151467,45,4,15,2,13
2021,151661,0,0,34,32,2
2021,151661,10,0,34,32,2
2021,151661,10,4,34,32,2
2021,151661,40,0,34,32,2
2021,151661,40,4,34,32,2
2021,151661,41,0,34,32,2
2021,151661,41,4,34,32,2
2021,151661,45,0,34,32,2
2021,151661,45,4,34,32,2
2021,151777,0,0,94,37,57
2021,151777,10,0,94,37,57
2021,151777,10,1,25,10,15
2021,151777,10,2,36,17,19
2021,151777,10,3,29,10,19
2021,151777,10,4,4,0,4
2021,151777,20,0,52,23,29
2021,151777,20,1,25,10,15
2021,151777,20,2,27,13,14
2021,151777,30,0,19,7,12
2021,151777,30,2,2,1,1
2021,151777,30,3,17,6,11
2021,151777,40,0,23,7,16
2021,151777,40,2,7,3,4
2021,151777,40,3,12,4,8
2021,151777,40,4,4,0,4
2021,151777,42,0,23,7,16
2021,151777,42,2,7,3,4
2021,151777,42,3,12,4,8
2021,151777,42,4,4,0,4
2021,151786,0,0,188,83,105
2021,151786,10,0,188,83,105
2021,151786,10,1,21,16,5
2021,151786,10,2,26,16,10
2021,151786,10,3,131,49,82
2021,151786,10,4,10,2,8
2021,151786,20,0,26,19,7
2021,151786,20,1,11,10,1
2021,151786,20,2,13,8,5
2021,151786,20,3,2,1,1
2021,151786,30,0,45,20,25
2021,151786,30,1,1,0,1
2021,151786,30,2,5,5,0
2021,151786,30,3,39,15,24
2021,151786,40,0,117,44,73
2021,151786,40,1,9,6,3
2021,151786,40,2,8,3,5
2021,151786,40,3,90,33,57
2021,151786,40,4,10,2,8
2021,151786,42,0,117,44,73
2021,151786,42,1,9,6,3
2021,151786,42,2,8,3,5
2021,151786,42,3,90,33,57
2021,151786,42,4,10,2,8
2021,151801,0,0,269,128,141
2021,151801,10,0,269,128,141
2021,151801,10,1,82,52,30
2021,151801,10,2,81,44,37
2021,151801,10,3,104,32,72
2021,151801,10,4,1,0,1
2021,151801,10,5,1,0,1
2021,151801,40,0,269,128,141
2021,151801,40,1,82,52,30
2021,151801,40,2,81,44,37
2021,151801,40,3,104,32,72
2021,151801,40,4,1,0,1
2021,151801,40,5,1,0,1
2021,151801,41,0,256,121,135
2021,151801,41,1,76,48,28
2021,151801,41,2,79,42,37
2021,151801,41,3,100,31,69
2021,151801,41,4,1,0,1
2021,151801,42,0,13,7,6
2021,151801,42,1,6,4,2
2021,151801,42,2,2,2,0
2021,151801,42,3,4,1,3
2021,151801,42,5,1,0,1
2021,151801,44,0,256,121,135
2021,151801,44,1,76,48,28
2021,151801,44,2,79,42,37
2021,151801,44,3,100,31,69
2021,151801,44,4,1,0,1
2021,151810,0,0,11,7,4
2021,151810,10,0,11,7,4
2021,151810,10,1,2,2,0
2021,151810,10,2,2,2,0
2021,151810,10,3,7,3,4
2021,151810,40,0,11,7,4
2021,151810,40,1,2,2,0
2021,151810,40,2,2,2,0
2021,151810,40,3,7,3,4
2021,151810,41,0,11,7,4
2021,151810,41,1,2,2,0
2021,151810,41,2,2,2,0
2021,151810,41,3,7,3,4
2021,151810,45,0,11,7,4
2021,151810,45,1,2,2,0
2021,151810,45,2,2,2,0
2021,151810,45,3,7,3,4
2021,151865,0,0,10,5,5
2021,151865,10,0,10,5,5
2021,151865,10,1,1,1,0
2021,151865,10,2,6,3,3
2021,151865,10,3,3,1,2
2021,151865,20,0,6,3,3
2021,151865,20,2,6,3,3
2021,151865,30,0,3,1,2
2021,151865,30,3,3,1,2
2021,151865,40,0,1,1,0
2021,151865,40,1,1,1,0
2021,151865,42,0,1,1,0
2021,151865,42,1,1,1,0
2021,152080,0,0,1243,835,408
2021,152080,10,0,1212,819,393
2021,152080,10,1,433,352,81
2021,152080,10,2,281,173,108
2021,152080,10,3,194,128,66
2021,152080,10,4,1,0,1
2021,152080,10,6,303,166,137
2021,152080,20,0,695,515,180
2021,152080,20,1,433,352,81
2021,152080,20,2,262,163,99
2021,152080,30,0,214,138,76
2021,152080,30,2,19,10,9
2021,152080,30,3,194,128,66
2021,152080,30,4,1,0,1
2021,152080,40,0,303,166,137
2021,152080,40,6,303,166,137
2021,152080,41,0,214,124,90
2021,152080,41,6,214,124,90
2021,152080,42,0,85,40,45
2021,152080,42,6,85,40,45
2021,152080,43,0,4,2,2
2021,152080,43,6,4,2,2
2021,152080,44,0,214,124,90
2021,152080,44,6,214,124,90
2021,152080,50,0,31,16,15
2021,152099,0,0,34,22,12
2021,152099,10,0,34,22,12
2021,152099,10,1,9,7,2
2021,152099,10,2,7,4,3
2021,152099,10,3,8,5,3
2021,152099,10,5,10,6,4
2021,152099,40,0,34,22,12
2021,152099,40,1,9,7,2
2021,152099,40,2,7,4,3
2021,152099,40,3,8,5,3
2021,152099,40,5,10,6,4
2021,152099,42,0,34,22,12
2021,152099,42,1,9,7,2
2021,152099,42,2,7,4,3
2021,152099,42,3,8,5,3
2021,152099,42,5,10,6,4
2021,152318,0,0,187,134,53
2021,152318,10,0,187,134,53
2021,152318,10,1,75,58,17
2021,152318,10,2,62,48,14
2021,152318,10,3,49,28,21
2021,152318,10,4,1,0,1
2021,152318,20,0,134,103,31
2021,152318,20,1,75,58,17
2021,152318,20,2,59,45,14
2021,152318,30,0,37,22,15
2021,152318,30,2,1,1,0
2021,152318,30,3,36,21,15
2021,152318,40,0,16,9,7
2021,152318,40,2,2,2,0
2021,152318,40,3,13,7,6
2021,152318,40,4,1,0,1
2021,152318,42,0,16,9,7
2021,152318,42,2,2,2,0
2021,152318,42,3,13,7,6
2021,152318,42,4,1,0,1
2021,152336,0,0,126,41,85
2021,152336,10,0,126,41,85
2021,152336,10,1,13,6,7
2021,152336,10,2,21,12,9
2021,152336,10,3,63,17,46
2021,152336,10,4,26,6,20
2021,152336,10,5,3,0,3
2021,152336,20,0,37,20,17
2021,152336,20,1,13,6,7
2021,152336,20,2,16,10,6
2021,152336,20,3,8,4,4
2021,152336,30,0,34,14,20
2021,152336,30,2,4,2,2
2021,152336,30,3,26,10,16
2021,152336,30,4,4,2,2
2021,152336,40,0,55,7,48
2021,152336,40,2,1,0,1
2021,152336,40,3,29,3,26
2021,152336,40,4,22,4,18
2021,152336,40,5,3,0,3
2021,152336,42,0,55,7,48
2021,152336,42,2,1,0,1
2021,152336,42,3,29,3,26
2021,152336,42,4,22,4,18
2021,152336,42,5,3,0,3
2021,152381,0,0,56,19,37
2021,152381,10,0,56,19,37
2021,152381,10,1,6,3,3
2021,152381,10,2,19,5,14
2021,152381,10,3,19,7,12
2021,152381,10,4,2,1,1
2021,152381,10,5,10,3,7
2021,152381,20,0,23,7,16
2021,152381,20,1,6,3,3
2021,152381,20,2,17,4,13
2021,152381,30,0,18,5,13
2021,152381,30,2,2,1,1
2021,152381,30,3,16,4,12
2021,152381,40,0,15,7,8
2021,152381,40,3,3,3,0
2021,152381,40,4,2,1,1
2021,152381,40,5,10,3,7
2021,152381,41,0,9,4,5
2021,152381,41,3,2,2,0
2021,152381,41,4,1,0,1
2021,152381,41,5,6,2,4
2021,152381,42,0,6,3,3
2021,152381,42,3,1,1,0
2021,152381,42,4,1,1,0
2021,152381,42,5,4,1,3
2021,152381,44,0,9,4,5
2021,152381,44,3,2,2,0
2021,152381,44,4,1,0,1
2021,152381,44,5,6,2,4
2021,152390,0,0,143,41,102
2021,152390,10,0,143,41,102
2021,152390,10,1,25,9,16
2021,152390,10,2,50,19,31
2021,152390,10,3,43,8,35
2021,152390,10,5,6,1,5
2021,152390,10,6,19,4,15
2021,152390,20,0,75,28,47
2021,152390,20,1,25,9,16
2021,152390,20,2,47,18,29
2021,152390,20,3,3,1,2
2021,152390,30,0,35,7,28
2021,152390,30,2,3,1,2
2021,152390,30,3,32,6,26
2021,152390,40,0,33,6,27
2021,152390,40,3,8,1,7
2021,152390,40,5,6,1,5
2021,152390,40,6,19,4,15
2021,152390,41,0,8,1,7
2021,152390,41,5,2,0,2
2021,152390,41,6,6,1,5
2021,152390,42,0,18,4,14
2021,152390,42,3,7,1,6
2021,152390,42,5,3,1,2
2021,152390,42,6,8,2,6
2021,152390,43,0,7,1,6
2021,152390,43,3,1,0,1
2021,152390,43,5,1,0,1
2021,152390,43,6,5,1,4
2021,152390,44,0,8,1,7
2021,152390,44,5,2,0,2
2021,152390,44,6,6,1,5
2021,152451,0,0,12,10,2
2021,152451,10,0,12,10,2
2021,152451,10,1,4,4,0
2021,152451,10,2,4,3,1
2021,152451,10,3,4,3,1
2021,152451,20,0,8,7,1
2021,152451,20,1,4,4,0
2021,152451,20,2,4,3,1
2021,152451,30,0,4,3,1
2021,152451,30,3,4,3,1
2021,152530,0,0,128,84,44
2021,152530,10,0,128,84,44
2021,152530,10,1,40,34,6
2021,152530,10,2,34,19,15
2021,152530,10,3,49,26,23
2021,152530,10,4,5,5,0
2021,152530,20,0,66,50,16
2021,152530,20,1,37,32,5
2021,152530,20,2,29,18,11
2021,152530,30,0,42,23,19
2021,152530,30,1,3,2,1
2021,152530,30,2,3,1,2
2021,152530,30,3,36,20,16
2021,152530,40,0,20,11,9
2021,152530,40,2,2,0,2
2021,152530,40,3,13,6,7
2021,152530,40,4,5,5,0
2021,152530,42,0,20,11,9
2021,152530,42,2,2,0,2
2021,152530,42,3,13,6,7
2021,152530,42,4,5,5,0
2021,152567,0,0,133,76,57
2021,152567,10,0,133,76,57
2021,152567,10,1,19,16,3
2021,152567,10,2,39,24,15
2021,152567,10,3,57,26,31
2021,152567,10,4,9,5,4
2021,152567,10,5,9,5,4
2021,152567,40,0,133,76,57
2021,152567,40,1,19,16,3
2021,152567,40,2,39,24,15
2021,152567,40,3,57,26,31
2021,152567,40,4,9,5,4
2021,152567,40,5,9,5,4
2021,152567,42,0,133,76,57
2021,152567,42,1,19,16,3
2021,152567,42,2,39,24,15
2021,152567,42,3,57,26,31
2021,152567,42,4,9,5,4
2021,152567,42,5,9,5,4
2021,152600,0,0,214,108,106
2021,152600,10,0,214,108,106
2021,152600,10,1,59,41,18
2021,152600,10,2,83,37,46
2021,152600,10,3,63,23,40
2021,152600,10,5,9,7,2
2021,152600,20,0,135,78,57
2021,152600,20,1,59,41,18
2021,152600,20,2,75,36,39
2021,152600,20,3,1,1,0
2021,152600,30,0,52,20,32
2021,152600,30,2,6,1,5
2021,152600,30,3,46,19,27
2021,152600,40,0,27,10,17
2021,152600,40,2,2,0,2
2021,152600,40,3,16,3,13
2021,152600,40,5,9,7,2
2021,152600,42,0,27,10,17
2021,152600,42,2,2,0,2
2021,152600,42,3,16,3,13
2021,152600,42,5,9,7,2
2021,152637,0,0,170,85,85
2021,152637,10,0,170,85,85
2021,152637,10,1,28,7,21
2021,152637,10,2,41,21,20
2021,152637,10,3,72,32,40
2021,152637,10,4,29,25,4
2021,152637,20,0,40,15,25
2021,152637,20,1,23,6,17
2021,152637,20,2,16,8,8
2021,152637,20,4,1,1,0
2021,152637,30,0,19,7,12
2021,152637,30,1,1,0,1
2021,152637,30,2,9,4,5
2021,152637,30,3,9,3,6
2021,152637,40,0,111,63,48
2021,152637,40,1,4,1,3
2021,152637,40,2,16,9,7
2021,152637,40,3,63,29,34
2021,152637,40,4,28,24,4
2021,152637,42,0,111,63,48
2021,152637,42,1,4,1,3
2021,152637,42,2,16,9,7
2021,152637,42,3,63,29,34
2021,152637,42,4,28,24,4
2021,152673,0,0,93,55,38
2021,152673,10,0,93,55,38
2021,152673,10,1,26,18,8
2021,152673,10,2,38,20,18
2021,152673,10,3,27,17,10
2021,152673,10,4,2,0,2
2021,152673,20,0,63,37,26
2021,152673,20,1,26,18,8
2021,152673,20,2,37,19,18
2021,152673,30,0,17,11,6
2021,152673,30,3,17,11,6
2021,152673,40,0,13,7,6
2021,152673,40,2,1,1,0
2021,152673,40,3,10,6,4
2021,152673,40,4,2,0,2
2021,152673,41,0,11,7,4
2021,152673,41,2,1,1,0
2021,152673,41,3,8,6,2
2021,152673,41,4,2,0,2
2021,152673,42,0,2,0,2
2021,152673,42,3,2,0,2
2021,152673,44,0,10,6,4
2021,152673,44,3,8,6,2
2021,152673,44,4,2,0,2
2021,152673,45,0,1,1,0
2021,152673,45,2,1,1,0
2021,152798,0,0,39,7,32
2021,152798,10,0,39,7,32
2021,152798,10,1,7,2,5
2021,152798,10,2,16,2,14
2021,152798,10,3,14,2,12
2021,152798,10,4,2,1,1
2021,152798,40,0,39,7,32
2021,152798,40,1,7,2,5
2021,152798,40,2,16,2,14
2021,152798,40,3,14,2,12
2021,152798,40,4,2,1,1
2021,152798,41,0,5,2,3
2021,152798,41,1,2,2,0
2021,152798,41,2,1,0,1
2021,152798,41,3,2,0,2
2021,152798,42,0,34,5,29
2021,152798,42,1,5,0,5
2021,152798,42,2,15,2,13
2021,152798,42,3,12,2,10
2021,152798,42,4,2,1,1
2021,152798,44,0,5,2,3
2021,152798,44,1,2,2,0
2021,152798,44,2,1,0,1
2021,152798,44,3,2,0,2
2021,152992,0,0,63,30,33
2021,152992,10,0,63,30,33
2021,152992,10,1,8,7,1
2021,152992,10,2,18,10,8
2021,152992,10,3,32,12,20
2021,152992,10,4,5,1,4
2021,152992,20,0,22,16,6
2021,152992,20,1,7,6,1
2021,152992,20,2,13,8,5
2021,152992,20,3,2,2,0
2021,152992,30,0,34,11,23
2021,152992,30,1,1,1,0
2021,152992,30,2,5,2,3
2021,152992,30,3,27,8,19
2021,152992,30,4,1,0,1
2021,152992,40,0,7,3,4
2021,152992,40,3,3,2,1
2021,152992,40,4,4,1,3
2021,152992,42,0,5,1,4
2021,152992,42,3,2,1,1
2021,152992,42,4,3,0,3
2021,152992,43,0,2,2,0
2021,152992,43,3,1,1,0
2021,152992,43,4,1,1,0
2021,153001,0,0,60,30,30
2021,153001,10,0,60,30,30
2021,153001,10,1,11,6,5
2021,153001,10,2,14,4,10
2021,153001,10,3,25,12,13
2021,153001,10,4,10,8,2
2021,153001,20,0,26,12,14
2021,153001,20,1,11,6,5
2021,153001,20,2,13,4,9
2021,153001,20,3,2,2,0
2021,153001,30,0,19,9,10
2021,153001,30,2,1,0,1
2021,153001,30,3,18,9,9
2021,153001,40,0,15,9,6
2021,153001,40,3,5,1,4
2021,153001,40,4,10,8,2
2021,153001,42,0,15,9,6
2021,153001,42,3,5,1,4
2021,153001,42,4,10,8,2
2021,153108,0,0,94,48,46
2021,153108,10,0,94,48,46
2021,153108,10,1,33,20,13
2021,153108,10,2,33,15,18
2021,153108,10,3,15,6,9
2021,153108,10,5,13,7,6
2021,153108,20,0,63,33,30
2021,153108,20,1,31,19,12
2021,153108,20,2,32,14,18
2021,153108,30,0,18,8,10
2021,153108,30,1,2,1,1
2021,153108,30,2,1,1,0
2021,153108,30,3,15,6,9
2021,153108,40,0,13,7,6
2021,153108,40,5,13,7,6
2021,153108,41,0,13,7,6
2021,153108,41,5,13,7,6
2021,153108,45,0,13,7,6
2021,153108,45,5,13,7,6
2021,153126,0,0,80,25,55
2021,153126,10,0,80,25,55
2021,153126,10,1,18,5,13
2021,153126,10,2,18,8,10
2021,153126,10,3,34,12,22
2021,153126,10,4,10,0,10
2021,153126,20,0,37,14,23
2021,153126,20,1,18,5,13
2021,153126,20,2,18,8,10
2021,153126,20,3,1,1,0
2021,153126,30,0,18,3,15
2021,153126,30,3,18,3,15
2021,153126,40,0,25,8,17
2021,153126,40,3,15,8,7
2021,153126,40,4,10,0,10
2021,153126,41,0,13,5,8
2021,153126,41,3,11,5,6
2021,153126,41,4,2,0,2
2021,153126,42,0,12,3,9
2021,153126,42,3,4,3,1
2021,153126,42,4,8,0,8
2021,153126,44,0,13,5,8
2021,153126,44,3,11,5,6
2021,153126,44,4,2,0,2
2021,153144,0,0,124,58,66
2021,153144,10,0,107,52,55
2021,153144,10,1,25,18,7
2021,153144,10,2,35,16,19
2021,153144,10,3,45,17,28
2021,153144,10,4,2,1,1
2021,153144,20,0,61,35,26
2021,153144,20,1,25,18,7
2021,153144,20,2,35,16,19
2021,153144,20,3,1,1,0
2021,153144,30,0,20,8,12
2021,153144,30,3,20,8,12
2021,153144,40,0,26,9,17
2021,153144,40,3,24,8,16
2021,153144,40,4,2,1,1
2021,153144,41,0,19,6,13
2021,153144,41,3,17,5,12
2021,153144,41,4,2,1,1
2021,153144,42,0,7,3,4
2021,153144,42,3,7,3,4
2021,153144,44,0,19,6,13
2021,153144,44,3,17,5,12
2021,153144,44,4,2,1,1
2021,153144,50,0,17,6,11
2021,153162,0,0,82,37,45
2021,153162,10,0,75,34,41
2021,153162,10,1,44,19,25
2021,153162,10,2,13,6,7
2021,153162,10,3,18,9,9
2021,153162,20,0,57,25,32
2021,153162,20,1,44,19,25
2021,153162,20,2,13,6,7
2021,153162,30,0,18,9,9
2021,153162,30,3,18,9,9
2021,153162,50,0,7,3,4
2021,153214,0,0,350,169,181
2021,153214,10,0,350,169,181
2021,153214,10,1,229,118,111
2021,153214,10,2,56,23,33
2021,153214,10,4,65,28,37
2021,153214,40,0,350,169,181
2021,153214,40,1,229,118,111
2021,153214,40,2,56,23,33
2021,153214,40,4,65,28,37
2021,153214,42,0,350,169,181
2021,153214,42,1,229,118,111
2021,153214,42,2,56,23,33
2021,153214,42,4,65,28,37
2021,153241,0,0,20,9,11
2021,153241,10,0,20,9,11
2021,153241,10,1,1,1,0
2021,153241,10,2,1,1,0
2021,153241,10,3,12,6,6
2021,153241,10,4,6,1,5
2021,153241,40,0,20,9,11
2021,153241,40,1,1,1,0
2021,153241,40,2,1,1,0
2021,153241,40,3,12,6,6
2021,153241,40,4,6,1,5
2021,153241,41,0,15,8,7
2021,153241,41,1,1,1,0
2021,153241,41,2,1,1,0
2021,153241,41,3,9,6,3
2021,153241,41,4,4,0,4
2021,153241,42,0,4,1,3
2021,153241,42,3,2,0,2
2021,153241,42,4,2,1,1
2021,153241,43,0,1,0,1
2021,153241,43,3,1,0,1
2021,153241,44,0,15,8,7
2021,153241,44,1,1,1,0
2021,153241,44,2,1,1,0
2021,153241,44,3,9,6,3
2021,153241,44,4,4,0,4
2021,153250,0,0,90,63,27
2021,153250,10,0,90,63,27
2021,153250,10,1,44,35,9
2021,153250,10,2,19,13,6
2021,153250,10,3,12,8,4
2021,153250,10,4,15,7,8
2021,153250,40,0,90,63,27
2021,153250,40,1,44,35,9
2021,153250,40,2,19,13,6
2021,153250,40,3,12,8,4
2021,153250,40,4,15,7,8
2021,153250,41,0,90,63,27
2021,153250,41,1,44,35,9
2021,153250,41,2,19,13,6
2021,153250,41,3,12,8,4
2021,153250,41,4,15,7,8
2021,153250,44,0,90,63,27
2021,153250,44,1,44,35,9
2021,153250,44,2,19,13,6
2021,153250,44,3,12,8,4
2021,153250,44,4,15,7,8
2021,153269,0,0,310,159,151
2021,153269,10,0,310,159,151
2021,153269,10,1,113,60,53
2021,153269,10,2,107,58,49
2021,153269,10,3,71,30,41
2021,153269,10,4,19,11,8
2021,153269,20,0,168,94,74
2021,153269,20,1,101,59,42
2021,153269,20,2,67,35,32
2021,153269,30,0,78,37,41
2021,153269,30,1,2,0,2
2021,153269,30,2,19,13,6
2021,153269,30,3,57,24,33
2021,153269,40,0,64,28,36
2021,153269,40,1,10,1,9
2021,153269,40,2,21,10,11
2021,153269,40,3,14,6,8
2021,153269,40,4,19,11,8
2021,153269,41,0,64,28,36
2021,153269,41,1,10,1,9
2021,153269,41,2,21,10,11
2021,153269,41,3,14,6,8
2021,153269,41,4,19,11,8
2021,153269,45,0,64,28,36
2021,153269,45,1,10,1,9
2021,153269,45,2,21,10,11
2021,153269,45,3,14,6,8
2021,153269,45,4,19,11,8
2021,153278,0,0,107,53,54
2021,153278,10,0,107,53,54
2021,153278,10,1,22,17,5
2021,153278,10,2,34,18,16
2021,153278,10,3,48,17,31
2021,153278,10,4,3,1,2
2021,153278,20,0,20,16,4
2021,153278,20,1,16,14,2
2021,153278,20,2,4,2,2
2021,153278,30,0,15,10,5
2021,153278,30,1,1,0,1
2021,153278,30,2,5,4,1
2021,153278,30,3,9,6,3
2021,153278,40,0,72,27,45
2021,153278,40,1,5,3,2
2021,153278,40,2,25,12,13
2021,153278,40,3,39,11,28
2021,153278,40,4,3,1,2
2021,153278,41,0,72,27,45
2021,153278,41,1,5,3,2
2021,153278,41,2,25,12,13
2021,153278,41,3,39,11,28
2021,153278,41,4,3,1,2
2021,153278,44,0,72,27,45
2021,153278,44,1,5,3,2
2021,153278,44,2,25,12,13
2021,153278,44,3,39,11,28
2021,153278,44,4,3,1,2
2021,153296,0,0,27,17,10
2021,153296,10,0,27,17,10
2021,153296,10,1,17,10,7
2021,153296,10,2,3,3,0
2021,153296,10,3,5,3,2
2021,153296,10,4,2,1,1
2021,153296,40,0,27,17,10
2021,153296,40,1,17,10,7
2021,153296,40,2,3,3,0
2021,153296,40,3,5,3,2
2021,153296,40,4,2,1,1
2021,153296,41,0,27,17,10
2021,153296,41,1,17,10,7
2021,153296,41,2,3,3,0
2021,153296,41,3,5,3,2
2021,153296,41,4,2,1,1
2021,153296,45,0,27,17,10
2021,153296,45,1,17,10,7
2021,153296,45,2,3,3,0
2021,153296,45,3,5,3,2
2021,153296,45,4,2,1,1
2021,153302,0,0,21,16,5
2021,153302,10,0,21,16,5
2021,153302,10,6,21,16,5
2021,153302,40,0,21,16,5
2021,153302,40,6,21,16,5
2021,153302,41,0,21,16,5
2021,153302,41,6,21,16,5
2021,153302,45,0,21,16,5
2021,153302,45,6,21,16,5
2021,153311,0,0,127,52,75
2021,153311,10,0,127,52,75
2021,153311,10,4,127,52,75
2021,153311,40,0,127,52,75
2021,153311,40,4,127,52,75
2021,153311,42,0,127,52,75
2021,153311,42,4,127,52,75
2021,153320,0,0,20,15,5
2021,153320,10,0,20,15,5
2021,153320,10,1,6,6,0
2021,153320,10,2,4,3,1
2021,153320,10,3,10,6,4
2021,153320,40,0,20,15,5
2021,153320,40,1,6,6,0
2021,153320,40,2,4,3,1
2021,153320,40,3,10,6,4
2021,153320,42,0,20,15,5
2021,153320,42,1,6,6,0
2021,153320,42,2,4,3,1
2021,153320,42,3,10,6,4
2021,153366,0,0,66,26,40
2021,153366,10,0,66,26,40
2021,153366,10,1,17,8,9
2021,153366,10,2,11,6,5
2021,153366,10,3,23,8,15
2021,153366,10,4,7,4,3
2021,153366,10,6,8,0,8
2021,153366,20,0,27,13,14
2021,153366,20,1,17,8,9
2021,153366,20,2,10,5,5
2021,153366,30,0,24,9,15
2021,153366,30,2,1,1,0
2021,153366,30,3,23,8,15
2021,153366,40,0,15,4,11
2021,153366,40,4,7,4,3
2021,153366,40,6,8,0,8
2021,153366,41,0,15,4,11
2021,153366,41,4,7,4,3
2021,153366,41,6,8,0,8
2021,153366,44,0,15,4,11
2021,153366,44,4,7,4,3
2021,153366,44,6,8,0,8
2021,153375,0,0,90,42,48
2021,153375,10,0,90,42,48
2021,153375,10,1,30,21,9
2021,153375,10,2,18,6,12
2021,153375,10,3,30,11,19
2021,153375,10,4,10,4,6
2021,153375,10,6,2,0,2
2021,153375,20,0,43,25,18
2021,153375,20,1,25,19,6
2021,153375,20,2,18,6,12
2021,153375,30,0,20,8,12
2021,153375,30,1,1,0,1
2021,153375,30,3,19,8,11
2021,153375,40,0,27,9,18
2021,153375,40,1,4,2,2
2021,153375,40,3,11,3,8
2021,153375,40,4,10,4,6
2021,153375,40,6,2,0,2
2021,153375,41,0,9,4,5
2021,153375,41,1,2,1,1
2021,153375,41,3,6,3,3
2021,153375,41,4,1,0,1
2021,153375,42,0,18,5,13
2021,153375,42,1,2,1,1
2021,153375,42,3,5,0,5
2021,153375,42,4,9,4,5
2021,153375,42,6,2,0,2
2021,153375,44,0,9,4,5
2021,153375,44,1,2,1,1
2021,153375,44,3,6,3,3
2021,153375,44,4,1,0,1
2021,153384,0,0,205,104,101
2021,153384,10,0,205,104,101
2021,153384,10,1,53,30,23
2021,153384,10,2,64,39,25
2021,153384,10,3,71,25,46
2021,153384,10,4,3,3,0
2021,153384,10,5,14,7,7
2021,153384,20,0,111,66,45
2021,153384,20,1,52,29,23
2021,153384,20,2,59,37,22
2021,153384,30,0,34,11,23
2021,153384,30,2,1,0,1
2021,153384,30,3,33,11,22
2021,153384,40,0,60,27,33
2021,153384,40,1,1,1,0
2021,153384,40,2,4,2,2
2021,153384,40,3,38,14,24
2021,153384,40,4,3,3,0
2021,153384,40,5,14,7,7
2021,153384,41,0,43,20,23
2021,153384,41,1,1,1,0
2021,153384,41,2,4,2,2
2021,153384,41,3,23,9,14
2021,153384,41,4,2,2,0
2021,153384,41,5,13,6,7
2021,153384,42,0,17,7,10
2021,153384,42,3,15,5,10
2021,153384,42,4,1,1,0
2021,153384,42,5,1,1,0
2021,153384,44,0,35,18,17
2021,153384,44,1,1,1,0
2021,153384,44,2,4,2,2
2021,153384,44,3,23,9,14
2021,153384,44,4,2,2,0
2021,153384,44,5,5,4,1
2021,153384,45,0,8,2,6
2021,153384,45,5,8,2,6
2021,153445,0,0,109,47,62
2021,153445,10,0,109,47,62
2021,153445,10,6,109,47,62
2021,153445,40,0,109,47,62
2021,153445,40,6,109,47,62
2021,153445,42,0,109,47,62
2021,153445,42,6,109,47,62
2021,153472,0,0,128,63,65
2021,153472,10,0,125,63,62
2021,153472,10,1,45,22,23
2021,153472,10,2,26,17,9
2021,153472,10,4,46,18,28
2021,153472,10,6,8,6,2
2021,153472,40,0,125,63,62
2021,153472,40,1,45,22,23
2021,153472,40,2,26,17,9
2021,153472,40,4,46,18,28
2021,153472,40,6,8,6,2
2021,153472,42,0,125,63,62
2021,153472,42,1,45,22,23
2021,153472,42,2,26,17,9
2021,153472,42,4,46,18,28
2021,153472,42,6,8,6,2
2021,153472,50,0,3,0,3
2021,153524,0,0,92,51,41
2021,153524,10,0,92,51,41
2021,153524,10,1,15,6,9
2021,153524,10,2,7,3,4
2021,153524,10,3,5,2,3
2021,153524,10,4,65,40,25
2021,153524,40,0,92,51,41
2021,153524,40,1,15,6,9
2021,153524,40,2,7,3,4
2021,153524,40,3,5,2,3
2021,153524,40,4,65,40,25
2021,153524,42,0,92,51,41
2021,153524,42,1,15,6,9
2021,153524,42,2,7,3,4
2021,153524,42,3,5,2,3
2021,153524,42,4,65,40,25
2021,153533,0,0,73,36,37
2021,153533,10,0,73,36,37
2021,153533,10,1,30,10,20
2021,153533,10,2,6,3,3
2021,153533,10,3,27,16,11
2021,153533,10,4,10,7,3
2021,153533,40,0,73,36,37
2021,153533,40,1,30,10,20
2021,153533,40,2,6,3,3
2021,153533,40,3,27,16,11
2021,153533,40,4,10,7,3
2021,153533,42,0,73,36,37
2021,153533,42,1,30,10,20
2021,153533,42,2,6,3,3
2021,153533,42,3,27,16,11
2021,153533,42,4,10,7,3
2021,153603,0,0,1485,931,554
2021,153603,10,0,1485,931,554
2021,153603,10,1,547,407,140
2021,153603,10,2,525,296,229
2021,153603,10,3,395,224,171
2021,153603,10,5,18,4,14
2021,153603,20,0,897,613,284
2021,153603,20,1,488,371,117
2021,153603,20,2,408,242,166
2021,153603,20,3,1,0,1
2021,153603,30,0,254,161,93
2021,153603,30,2,12,10,2
2021,153603,30,3,242,151,91
2021,153603,40,0,334,157,177
2021,153603,40,1,59,36,23
2021,153603,40,2,105,44,61
2021,153603,40,3,152,73,79
2021,153603,40,5,18,4,14
2021,153603,41,0,271,138,133
2021,153603,41,1,57,35,22
2021,153603,41,2,92,42,50
2021,153603,41,3,121,61,60
2021,153603,41,5,1,0,1
2021,153603,42,0,25,10,15
2021,153603,42,1,2,1,1
2021,153603,42,2,7,1,6
2021,153603,42,3,16,8,8
2021,153603,43,0,38,9,29
2021,153603,43,2,6,1,5
2021,153603,43,3,15,4,11
2021,153603,43,5,17,4,13
2021,153603,44,0,271,138,133
2021,153603,44,1,57,35,22
2021,153603,44,2,92,42,50
2021,153603,44,3,121,61,60
2021,153603,44,5,1,0,1
2021,153621,0,0,36,19,17
2021,153621,10,0,36,19,17
2021,153621,10,1,8,3,5
2021,153621,10,2,7,4,3
2021,153621,10,3,16,8,8
2021,153621,10,4,4,3,1
2021,153621,10,6,1,1,0
2021,153621,20,0,14,5,9
2021,153621,20,1,8,3,5
2021,153621,20,2,5,2,3
2021,153621,20,3,1,0,1
2021,153621,30,0,8,4,4
2021,153621,30,3,8,4,4
2021,153621,40,0,14,10,4
2021,153621,40,2,2,2,0
2021,153621,40,3,7,4,3
2021,153621,40,4,4,3,1
2021,153621,40,6,1,1,0
2021,153621,42,0,14,10,4
2021,153621,42,2,2,2,0
2021,153621,42,3,7,4,3
2021,153621,42,4,4,3,1
2021,153621,42,6,1,1,0
2021,153630,0,0,101,51,50
2021,153630,10,0,101,51,50
2021,153630,10,1,11,2,9
2021,153630,10,2,6,2,4
2021,153630,10,3,38,22,16
2021,153630,10,4,45,25,20
2021,153630,10,6,1,0,1
2021,153630,40,0,101,51,50
2021,153630,40,1,11,2,9
2021,153630,40,2,6,2,4
2021,153630,40,3,38,22,16
2021,153630,40,4,45,25,20
2021,153630,40,6,1,0,1
2021,153630,42,0,101,51,50
2021,153630,42,1,11,2,9
2021,153630,42,2,6,2,4
2021,153630,42,3,38,22,16
2021,153630,42,4,45,25,20
2021,153630,42,6,1,0,1
2021,153658,0,0,2503,1454,1049
2021,153658,10,0,2503,1454,1049
2021,153658,10,1,777,556,221
2021,153658,10,2,865,437,428
2021,153658,10,3,645,362,283
2021,153658,10,4,5,2,3
2021,153658,10,5,140,58,82
2021,153658,10,6,71,39,32
2021,153658,20,0,1000,697,303
2021,153658,20,1,593,451,142
2021,153658,20,2,407,246,161
2021,153658,30,0,323,173,150
2021,153658,30,1,5,1,4
2021,153658,30,2,107,15,92
2021,153658,30,3,211,157,54
2021,153658,40,0,1180,584,596
2021,153658,40,1,179,104,75
2021,153658,40,2,351,176,175
2021,153658,40,3,434,205,229
2021,153658,40,4,5,2,3
2021,153658,40,5,140,58,82
2021,153658,40,6,71,39,32
2021,153658,41,0,1057,514,543
2021,153658,41,1,177,103,74
2021,153658,41,2,345,172,173
2021,153658,41,3,393,180,213
2021,153658,41,4,3,1,2
2021,153658,41,5,139,58,81
2021,153658,42,0,123,70,53
2021,153658,42,1,2,1,1
2021,153658,42,2,6,4,2
2021,153658,42,3,41,25,16
2021,153658,42,4,2,1,1
2021,153658,42,5,1,0,1
2021,153658,42,6,71,39,32
2021,153658,44,0,1057,514,543
2021,153658,44,1,177,103,74
2021,153658,44,2,345,172,173
2021,153658,44,3,393,180,213
2021,153658,44,4,3,1,2
2021,153658,44,5,139,58,81
2021,153737,0,0,255,140,115
2021,153737,10,0,247,135,112
2021,153737,10,1,96,59,37
2021,153737,10,2,50,24,26
2021,153737,10,3,55,30,25
2021,153737,10,4,44,21,23
2021,153737,10,6,2,1,1
2021,153737,40,0,247,135,112
2021,153737,40,1,96,59,37
2021,153737,40,2,50,24,26
2021,153737,40,3,55,30,25
2021,153737,40,4,44,21,23
2021,153737,40,6,2,1,1
2021,153737,42,0,247,135,112
2021,153737,42,1,96,59,37
2021,153737,42,2,50,24,26
2021,153737,42,3,55,30,25
2021,153737,42,4,44,21,23
2021,153737,42,6,2,1,1
2021,153737,50,0,8,5,3
2021,153825,0,0,98,53,45
2021,153825,10,0,98,53,45
2021,153825,10,1,28,20,8
2021,153825,10,2,39,19,20
2021,153825,10,3,30,14,16
2021,153825,10,4,1,0,1
2021,153825,20,0,65,38,27
2021,153825,20,1,26,19,7
2021,153825,20,2,39,19,20
2021,153825,30,0,23,10,13
2021,153825,30,3,23,10,13
2021,153825,40,0,10,5,5
2021,153825,40,1,2,1,1
2021,153825,40,3,7,4,3
2021,153825,40,4,1,0,1
2021,153825,41,0,6,3,3
2021,153825,41,3,6,3,3
2021,153825,42,0,4,2,2
2021,153825,42,1,2,1,1
2021,153825,42,3,1,1,0
2021,153825,42,4,1,0,1
2021,153825,44,0,6,3,3
2021,153825,44,3,6,3,3
2021,153834,0,0,134,73,61
2021,153834,10,0,134,73,61
2021,153834,10,1,55,38,17
2021,153834,10,2,52,23,29
2021,153834,10,3,21,11,10
2021,153834,10,4,6,1,5
2021,153834,20,0,104,59,45
2021,153834,20,1,54,37,17
2021,153834,20,2,50,22,28
2021,153834,30,0,8,4,4
2021,153834,30,2,1,1,0
2021,153834,30,3,7,3,4
2021,153834,40,0,22,10,12
2021,153834,40,1,1,1,0
2021,153834,40,2,1,0,1
2021,153834,40,3,14,8,6
2021,153834,40,4,6,1,5
2021,153834,42,0,22,10,12
2021,153834,42,1,1,1,0
2021,153834,42,2,1,0,1
2021,153834,42,3,14,8,6
2021,153834,42,4,6,1,5
2021,153861,0,0,114,77,37
2021,153861,10,0,113,76,37
2021,153861,10,1,17,14,3
2021,153861,10,2,20,13,7
2021,153861,10,3,35,22,13
2021,153861,10,4,39,25,14
2021,153861,10,5,2,2,0
2021,153861,40,0,113,76,37
2021,153861,40,1,17,14,3
2021,153861,40,2,20,13,7
2021,153861,40,3,35,22,13
2021,153861,40,4,39,25,14
2021,153861,40,5,2,2,0
2021,153861,41,0,113,76,37
2021,153861,41,1,17,14,3
2021,153861,41,2,20,13,7
2021,153861,41,3,35,22,13
2021,153861,41,4,39,25,14
2021,153861,41,5,2,2,0
2021,153861,45,0,113,76,37
2021,153861,45,1,17,14,3
2021,153861,45,2,20,13,7
2021,153861,45,3,35,22,13
2021,153861,45,4,39,25,14
2021,153861,45,5,2,2,0
2021,153861,50,0,1,1,0
2021,153922,0,0,44,25,19
2021,153922,10,0,44,25,19
2021,153922,10,1,30,18,12
2021,153922,10,2,8,4,4
2021,153922,10,3,5,2,3
2021,153922,10,4,1,1,0
2021,153922,40,0,44,25,19
2021,153922,40,1,30,18,12
2021,153922,40,2,8,4,4
2021,153922,40,3,5,2,3
2021,153922,40,4,1,1,0
2021,153922,41,0,44,25,19
2021,153922,41,1,30,18,12
2021,153922,41,2,8,4,4
2021,153922,41,3,5,2,3
2021,153922,41,4,1,1,0
2021,153922,45,0,44,25,19
2021,153922,45,1,30,18,12
2021,153922,45,2,8,4,4
2021,153922,45,3,5,2,3
2021,153922,45,4,1,1,0
2021,153977,0,0,57,7,50
2021,153977,10,0,57,7,50
2021,153977,10,1,6,2,4
2021,153977,10,2,4,1,3
2021,153977,10,3,40,2,38
2021,153977,10,4,7,2,5
2021,153977,40,0,57,7,50
2021,153977,40,1,6,2,4
2021,153977,40,2,4,1,3
2021,153977,40,3,40,2,38
2021,153977,40,4,7,2,5
2021,153977,41,0,57,7,50
2021,153977,41,1,6,2,4
2021,153977,41,2,4,1,3
2021,153977,41,3,40,2,38
2021,153977,41,4,7,2,5
2021,153977,44,0,57,7,50
2021,153977,44,1,6,2,4
2021,153977,44,2,4,1,3
2021,153977,44,3,40,2,38
2021,153977,44,4,7,2,5
2021,154004,0,0,75,33,42
2021,154004,10,0,75,33,42
2021,154004,10,1,15,7,8
2021,154004,10,2,31,17,14
2021,154004,10,3,27,8,19
2021,154004,10,4,2,1,1
2021,154004,20,0,40,22,18
2021,154004,20,1,15,7,8
2021,154004,20,2,25,15,10
2021,154004,30,0,22,6,16
2021,154004,30,2,4,1,3
2021,154004,30,3,16,4,12
2021,154004,30,4,2,1,1
2021,154004,40,0,13,5,8
2021,154004,40,2,2,1,1
2021,154004,40,3,11,4,7
2021,154004,41,0,12,5,7
2021,154004,41,2,2,1,1
2021,154004,41,3,10,4,6
2021,154004,42,0,1,0,1
2021,154004,42,3,1,0,1
2021,154004,45,0,12,5,7
2021,154004,45,2,2,1,1
2021,154004,45,3,10,4,6
2021,154013,0,0,78,33,45
2021,154013,10,0,78,33,45
2021,154013,10,1,14,7,7
2021,154013,10,2,18,9,9
2021,154013,10,3,44,16,28
2021,154013,10,5,2,1,1
2021,154013,20,0,31,15,16
2021,154013,20,1,14,7,7
2021,154013,20,2,16,8,8
2021,154013,20,3,1,0,1
2021,154013,30,0,18,10,8
2021,154013,30,2,2,1,1
2021,154013,30,3,16,9,7
2021,154013,40,0,29,8,21
2021,154013,40,3,27,7,20
2021,154013,40,5,2,1,1
2021,154013,41,0,29,8,21
2021,154013,41,3,27,7,20
2021,154013,41,5,2,1,1
2021,154013,44,0,29,8,21
2021,154013,44,3,27,7,20
2021,154013,44,5,2,1,1
2021,154022,0,0,118,40,78
2021,154022,10,0,118,40,78
2021,154022,10,1,27,12,15
2021,154022,10,2,48,12,36
2021,154022,10,3,37,14,23
2021,154022,10,4,6,2,4
2021,154022,40,0,118,40,78
2021,154022,40,1,27,12,15
2021,154022,40,2,48,12,36
2021,154022,40,3,37,14,23
2021,154022,40,4,6,2,4
2021,154022,41,0,118,40,78
2021,154022,41,1,27,12,15
2021,154022,41,2,48,12,36
2021,154022,41,3,37,14,23
2021,154022,41,4,6,2,4
2021,154022,45,0,118,40,78
2021,154022,45,1,27,12,15
2021,154022,45,2,48,12,36
2021,154022,45,3,37,14,23
2021,154022,45,4,6,2,4
2021,154059,0,0,66,37,29
2021,154059,10,0,66,37,29
2021,154059,10,5,66,37,29
2021,154059,40,0,66,37,29
2021,154059,40,5,66,37,29
2021,154059,42,0,66,37,29
2021,154059,42,5,66,37,29
2021,154095,0,0,446,223,223
2021,154095,10,0,446,223,223
2021,154095,10,1,122,72,50
2021,154095,10,2,151,79,72
2021,154095,10,3,87,38,49
2021,154095,10,4,86,34,52
2021,154095,20,0,285,154,131
2021,154095,20,1,122,72,50
2021,154095,20,2,148,79,69
2021,154095,20,3,6,2,4
2021,154095,20,4,9,1,8
2021,154095,30,0,85,36,49
2021,154095,30,2,3,0,3
2021,154095,30,3,81,36,45
2021,154095,30,4,1,0,1
2021,154095,40,0,76,33,43
2021,154095,40,4,76,33,43
2021,154095,41,0,59,26,33
2021,154095,41,4,59,26,33
2021,154095,43,0,17,7,10
2021,154095,43,4,17,7,10
2021,154095,44,0,59,26,33
2021,154095,44,4,59,26,33
2021,154101,0,0,73,40,33
2021,154101,10,0,73,40,33
2021,154101,10,1,30,20,10
2021,154101,10,2,16,9,7
2021,154101,10,3,12,4,8
2021,154101,10,4,7,2,5
2021,154101,10,6,8,5,3
2021,154101,20,0,43,26,17
2021,154101,20,1,28,19,9
2021,154101,20,2,13,7,6
2021,154101,20,3,2,0,2
2021,154101,30,0,26,12,14
2021,154101,30,1,2,1,1
2021,154101,30,2,3,2,1
2021,154101,30,3,10,4,6
2021,154101,30,4,5,2,3
2021,154101,30,6,6,3,3
2021,154101,40,0,4,2,2
2021,154101,40,4,2,0,2
2021,154101,40,6,2,2,0
2021,154101,42,0,4,2,2
2021,154101,42,4,2,0,2
2021,154101,42,6,2,2,0
2021,154110,0,0,110,46,64
2021,154110,10,0,106,45,61
2021,154110,10,6,106,45,61
2021,154110,40,0,106,45,61
2021,154110,40,6,106,45,61
2021,154110,42,0,106,45,61
2021,154110,42,6,106,45,61
2021,154110,50,0,4,1,3
2021,154129,0,0,34,24,10
2021,154129,10,0,34,24,10
2021,154129,10,6,34,24,10
2021,154129,40,0,34,24,10
2021,154129,40,6,34,24,10
2021,154129,42,0,34,24,10
2021,154129,42,6,34,24,10
2021,154156,0,0,79,35,44
2021,154156,10,0,79,35,44
2021,154156,10,1,14,9,5
2021,154156,10,2,32,12,20
2021,154156,10,3,31,14,17
2021,154156,10,4,2,0,2
2021,154156,20,0,30,16,14
2021,154156,20,1,10,7,3
2021,154156,20,2,20,9,11
2021,154156,30,0,6,3,3
2021,154156,30,2,2,1,1
2021,154156,30,3,4,2,2
2021,154156,40,0,43,16,27
2021,154156,40,1,4,2,2
2021,154156,40,2,10,2,8
2021,154156,40,3,27,12,15
2021,154156,40,4,2,0,2
2021,154156,42,0,43,16,27
2021,154156,42,1,4,2,2
2021,154156,42,2,10,2,8
2021,154156,42,3,27,12,15
2021,154156,42,4,2,0,2
2021,154174,0,0,133,69,64
2021,154174,10,0,132,69,63
2021,154174,10,1,32,21,11
2021,154174,10,2,55,26,29
2021,154174,10,3,31,16,15
2021,154174,10,4,14,6,8
2021,154174,40,0,132,69,63
2021,154174,40,1,32,21,11
2021,154174,40,2,55,26,29
2021,154174,40,3,31,16,15
2021,154174,40,4,14,6,8
2021,154174,41,0,132,69,63
2021,154174,41,1,32,21,11
2021,154174,41,2,55,26,29
2021,154174,41,3,31,16,15
2021,154174,41,4,14,6,8
2021,154174,45,0,132,69,63
2021,154174,45,1,32,21,11
2021,154174,45,2,55,26,29
2021,154174,45,3,31,16,15
2021,154174,45,4,14,6,8
2021,154174,50,0,1,0,1
2021,154235,0,0,191,89,102
2021,154235,10,0,191,89,102
2021,154235,10,1,87,51,36
2021,154235,10,2,37,16,21
2021,154235,10,3,49,17,32
2021,154235,10,4,10,3,7
2021,154235,10,5,8,2,6
2021,154235,20,0,123,67,56
2021,154235,20,1,86,51,35
2021,154235,20,2,34,16,18
2021,154235,20,3,3,0,3
2021,154235,30,0,33,13,20
2021,154235,30,2,2,0,2
2021,154235,30,3,31,13,18
2021,154235,40,0,35,9,26
2021,154235,40,1,1,0,1
2021,154235,40,2,1,0,1
2021,154235,40,3,15,4,11
2021,154235,40,4,10,3,7
2021,154235,40,5,8,2,6
2021,154235,42,0,35,9,26
2021,154235,42,1,1,0,1
2021,154235,42,2,1,0,1
2021,154235,42,3,15,4,11
2021,154235,42,4,10,3,7
2021,154235,42,5,8,2,6
2021,154262,0,0,17,1,16
2021,154262,10,0,17,1,16
2021,154262,10,2,6,1,5
2021,154262,10,3,5,0,5
2021,154262,10,4,6,0,6
2021,154262,40,0,17,1,16
2021,154262,40,2,6,1,5
2021,154262,40,3,5,0,5
2021,154262,40,4,6,0,6
2021,154262,41,0,5,1,4
2021,154262,41,2,2,1,1
2021,154262,41,3,3,0,3
2021,154262,42,0,12,0,12
2021,154262,42,2,4,0,4
2021,154262,42,3,2,0,2
2021,154262,42,4,6,0,6
2021,154262,45,0,5,1,4
2021,154262,45,2,2,1,1
2021,154262,45,3,3,0,3
2021,154350,0,0,77,41,36
2021,154350,10,0,75,40,35
2021,154350,10,1,34,18,16
2021,154350,10,2,10,8,2
2021,154350,10,3,28,12,16
2021,154350,10,4,3,2,1
2021,154350,20,0,40,20,20
2021,154350,20,1,33,18,15
2021,154350,20,2,3,1,2
2021,154350,20,3,4,1,3
2021,154350,30,0,26,14,12
2021,154350,30,1,1,0,1
2021,154350,30,2,7,7,0
2021,154350,30,3,17,7,10
2021,154350,30,4,1,0,1
2021,154350,40,0,9,6,3
2021,154350,40,3,7,4,3
2021,154350,40,4,2,2,0
2021,154350,42,0,9,6,3
2021,154350,42,3,7,4,3
2021,154350,42,4,2,2,0
2021,154350,50,0,2,1,1
2021,154378,0,0,89,34,55
2021,154378,10,0,69,30,39
2021,154378,10,4,69,30,39
2021,154378,40,0,69,30,39
2021,154378,40,4,69,30,39
2021,154378,41,0,69,30,39
2021,154378,41,4,69,30,39
2021,154378,45,0,69,30,39
2021,154378,45,4,69,30,39
2021,154378,50,0,20,4,16
2021,154396,0,0,38,21,17
2021,154396,10,0,38,21,17
2021,154396,10,4,38,21,17
2021,154396,40,0,38,21,17
2021,154396,40,4,38,21,17
2021,154396,42,0,38,21,17
2021,154396,42,4,38,21,17
2021,154493,0,0,44,18,26
2021,154493,10,0,44,18,26
2021,154493,10,1,9,6,3
2021,154493,10,2,15,5,10
2021,154493,10,3,14,4,10
2021,154493,10,5,6,3,3
2021,154493,20,0,24,11,13
2021,154493,20,1,9,6,3
2021,154493,20,2,15,5,10
2021,154493,30,0,14,4,10
2021,154493,30,3,14,4,10
2021,154493,40,0,6,3,3
2021,154493,40,5,6,3,3
2021,154493,42,0,6,3,3
2021,154493,42,5,6,3,3
2021,154518,0,0,49,29,20
2021,154518,10,0,49,29,20
2021,154518,10,1,11,6,5
2021,154518,10,2,9,5,4
2021,154518,10,3,24,16,8
2021,154518,10,4,5,2,3
2021,154518,20,0,19,10,9
2021,154518,20,1,11,6,5
2021,154518,20,2,8,4,4
2021,154518,30,0,19,13,6
2021,154518,30,2,1,1,0
2021,154518,30,3,18,12,6
2021,154518,40,0,11,6,5
2021,154518,40,3,6,4,2
2021,154518,40,4,5,2,3
2021,154518,42,0,11,6,5
2021,154518,42,3,6,4,2
2021,154518,42,4,5,2,3
2021,154527,0,0,81,42,39
2021,154527,10,0,81,42,39
2021,154527,10,1,26,14,12
2021,154527,10,2,27,13,14
2021,154527,10,3,21,12,9
2021,154527,10,5,5,3,2
2021,154527,10,6,2,0,2
2021,154527,20,0,51,25,26
2021,154527,20,1,26,14,12
2021,154527,20,2,25,11,14
2021,154527,30,0,23,14,9
2021,154527,30,2,2,2,0
2021,154527,30,3,21,12,9
2021,154527,40,0,7,3,4
2021,154527,40,5,5,3,2
2021,154527,40,6,2,0,2
2021,154527,42,0,7,3,4
2021,154527,42,5,5,3,2
2021,154527,42,6,2,0,2
2021,154536,0,0,10,6,4
2021,154536,10,0,10,6,4
2021,154536,10,1,6,4,2
2021,154536,10,2,2,2,0
2021,154536,10,3,2,0,2
2021,154536,20,0,8,6,2
2021,154536,20,1,6,4,2
2021,154536,20,2,2,2,0
2021,154536,30,0,2,0,2
2021,154536,30,3,2,0,2
2021,154572,0,0,66,32,34
2021,154572,10,0,65,32,33
2021,154572,10,4,1,0,1
2021,154572,10,6,64,32,32
2021,154572,40,0,65,32,33
2021,154572,40,4,1,0,1
2021,154572,40,6,64,32,32
2021,154572,42,0,65,32,33
2021,154572,42,4,1,0,1
2021,154572,42,6,64,32,32
2021,154572,50,0,1,0,1
2021,154590,0,0,49,28,21
2021,154590,10,0,47,28,19
2021,154590,10,1,5,3,2
2021,154590,10,2,4,4,0
2021,154590,10,3,18,11,7
2021,154590,10,4,20,10,10
2021,154590,20,0,10,8,2
2021,154590,20,1,4,3,1
2021,154590,20,2,2,2,0
2021,154590,20,3,4,3,1
2021,154590,30,0,8,5,3
2021,154590,30,2,2,2,0
2021,154590,30,3,5,2,3
2021,154590,30,4,1,1,0
2021,154590,40,0,29,15,14
2021,154590,40,1,1,0,1
2021,154590,40,3,9,6,3
2021,154590,40,4,19,9,10
2021,154590,42,0,29,15,14
2021,154590,42,1,1,0,1
2021,154590,42,3,9,6,3
2021,154590,42,4,19,9,10
2021,154590,50,0,2,0,2
2021,154642,0,0,29,14,15
2021,154642,10,0,29,14,15
2021,154642,10,4,29,14,15
2021,154642,20,0,21,10,11
2021,154642,20,4,21,10,11
2021,154642,30,0,8,4,4
2021,154642,30,4,8,4,4
2021,154688,0,0,66,28,38
2021,154688,10,0,66,28,38
2021,154688,10,1,20,12,8
2021,154688,10,2,15,7,8
2021,154688,10,3,31,9,22
2021,154688,20,0,36,19,17
2021,154688,20,1,16,10,6
2021,154688,20,2,7,4,3
2021,154688,20,3,13,5,8
2021,154688,30,0,17,6,11
2021,154688,30,1,3,2,1
2021,154688,30,2,2,0,2
2021,154688,30,3,12,4,8
2021,154688,40,0,13,3,10
2021,154688,40,1,1,0,1
2021,154688,40,2,6,3,3
2021,154688,40,3,6,0,6
2021,154688,41,0,11,3,8
2021,154688,41,2,6,3,3
2021,154688,41,3,5,0,5
2021,154688,42,0,2,0,2
2021,154688,42,1,1,0,1
2021,154688,42,3,1,0,1
2021,154688,45,0,11,3,8
2021,154688,45,2,6,3,3
2021,154688,45,3,5,0,5
2021,154697,0,0,55,27,28
2021,154697,10,0,55,27,28
2021,154697,10,6,55,27,28
2021,154697,20,0,36,18,18
2021,154697,20,6,36,18,18
2021,154697,30,0,19,9,10
2021,154697,30,6,19,9,10
2021,154712,0,0,140,96,44
2021,154712,10,0,139,95,44
2021,154712,10,1,27,22,5
2021,154712,10,2,44,29,15
2021,154712,10,3,62,42,20
2021,154712,10,4,6,2,4
2021,154712,20,0,58,41,17
2021,154712,20,1,26,21,5
2021,154712,20,2,28,17,11
2021,154712,20,3,4,3,1
2021,154712,30,0,28,21,7
2021,154712,30,1,1,1,0
2021,154712,30,2,9,7,2
2021,154712,30,3,18,13,5
2021,154712,40,0,53,33,20
2021,154712,40,2,7,5,2
2021,154712,40,3,40,26,14
2021,154712,40,4,6,2,4
2021,154712,41,0,11,8,3
2021,154712,41,3,11,8,3
2021,154712,42,0,42,25,17
2021,154712,42,2,7,5,2
2021,154712,42,3,29,18,11
2021,154712,42,4,6,2,4
2021,154712,45,0,11,8,3
2021,154712,45,3,11,8,3
2021,154712,50,0,1,1,0
2021,154721,0,0,46,23,23
2021,154721,10,0,44,23,21
2021,154721,10,1,6,4,2
2021,154721,10,2,14,9,5
2021,154721,10,3,24,10,14
2021,154721,20,0,20,13,7
2021,154721,20,1,6,4,2
2021,154721,20,2,14,9,5
2021,154721,30,0,22,9,13
2021,154721,30,3,22,9,13
2021,154721,40,0,2,1,1
2021,154721,40,3,2,1,1
2021,154721,42,0,2,1,1
2021,154721,42,3,2,1,1
2021,154721,50,0,2,0,2
2021,154749,0,0,35,14,21
2021,154749,10,0,35,14,21
2021,154749,10,1,11,6,5
2021,154749,10,2,11,3,8
2021,154749,10,3,8,2,6
2021,154749,10,4,5,3,2
2021,154749,20,0,17,7,10
2021,154749,20,1,10,5,5
2021,154749,20,2,7,2,5
2021,154749,30,0,7,2,5
2021,154749,30,2,2,1,1
2021,154749,30,3,5,1,4
2021,154749,40,0,11,5,6
2021,154749,40,1,1,1,0
2021,154749,40,2,2,0,2
2021,154749,40,3,3,1,2
2021,154749,40,4,5,3,2
2021,154749,42,0,11,5,6
2021,154749,42,1,1,1,0
2021,154749,42,2,2,0,2
2021,154749,42,3,3,1,2
2021,154749,42,4,5,3,2
2021,154800,0,0,143,68,75
2021,154800,10,0,143,68,75
2021,154800,10,1,75,32,43
2021,154800,10,2,49,24,25
2021,154800,10,3,18,12,6
2021,154800,10,5,1,0,1
2021,154800,40,0,143,68,75
2021,154800,40,1,75,32,43
2021,154800,40,2,49,24,25
2021,154800,40,3,18,12,6
2021,154800,40,5,1,0,1
2021,154800,42,0,142,68,74
2021,154800,42,1,75,32,43
2021,154800,42,2,49,24,25
2021,154800,42,3,18,12,6
2021,154800,43,0,1,0,1
2021,154800,43,5,1,0,1
2021,154855,0,0,11,8,3
2021,154855,10,0,11,8,3
2021,154855,10,6,11,8,3
2021,154855,40,0,11,8,3
2021,154855,40,6,11,8,3
2021,154855,42,0,11,8,3
2021,154855,42,6,11,8,3
2021,154907,0,0,38,24,14
2021,154907,10,0,38,24,14
2021,154907,10,4,38,24,14
2021,154907,20,0,21,12,9
2021,154907,20,4,21,12,9
2021,154907,30,0,17,12,5
2021,154907,30,4,17,12,5
2021,154925,0,0,47,31,16
2021,154925,10,0,44,30,14
2021,154925,10,4,44,30,14
2021,154925,20,0,37,26,11
2021,154925,20,4,37,26,11
2021,154925,30,0,7,4,3
2021,154925,30,4,7,4,3
2021,154925,50,0,3,1,2
2021,154934,0,0,44,17,27
2021,154934,10,0,44,17,27
2021,154934,10,4,44,17,27
2021,154934,40,0,44,17,27
2021,154934,40,4,44,17,27
2021,154934,42,0,44,17,27
2021,154934,42,4,44,17,27
2021,154952,0,0,63,35,28
2021,154952,10,0,58,34,24
2021,154952,10,4,58,34,24
2021,154952,20,0,53,29,24
2021,154952,20,4,53,29,24
2021,154952,30,0,5,5,0
2021,154952,30,4,5,5,0
2021,154952,50,0,5,1,4
2021,154998,0,0,44,21,23
2021,154998,10,0,44,21,23
2021,154998,10,1,24,14,10
2021,154998,10,2,10,3,7
2021,154998,10,3,4,1,3
2021,154998,10,4,6,3,3
2021,154998,20,0,30,15,15
2021,154998,20,1,20,11,9
2021,154998,20,2,6,2,4
2021,154998,20,3,3,1,2
2021,154998,20,4,1,1,0
2021,154998,30,0,14,6,8
2021,154998,30,1,4,3,1
2021,154998,30,2,4,1,3
2021,154998,30,3,1,0,1
2021,154998,30,4,5,2,3
2021,155007,0,0,16,6,10
2021,155007,10,0,16,6,10
2021,155007,10,2,1,0,1
2021,155007,10,3,14,6,8
2021,155007,10,4,1,0,1
2021,155007,40,0,16,6,10
2021,155007,40,2,1,0,1
2021,155007,40,3,14,6,8
2021,155007,40,4,1,0,1
2021,155007,42,0,15,6,9
2021,155007,42,2,1,0,1
2021,155007,42,3,13,6,7
2021,155007,42,4,1,0,1
2021,155007,43,0,1,0,1
2021,155007,43,3,1,0,1
2021,155025,0,0,227,114,113
2021,155025,10,0,227,114,113
2021,155025,10,1,61,40,21
2021,155025,10,2,61,29,32
2021,155025,10,3,69,35,34
2021,155025,10,4,36,10,26
2021,155025,20,0,115,65,50
2021,155025,20,1,61,40,21
2021,155025,20,2,54,25,29
2021,155025,30,0,75,39,36
2021,155025,30,2,7,4,3
2021,155025,30,3,68,35,33
2021,155025,40,0,37,10,27
2021,155025,40,3,1,0,1
2021,155025,40,4,36,10,26
2021,155025,42,0,37,10,27
2021,155025,42,3,1,0,1
2021,155025,42,4,36,10,26
2021,155052,0,0,35,17,18
2021,155052,10,0,35,17,18
2021,155052,10,4,35,17,18
2021,155052,40,0,35,17,18
2021,155052,40,4,35,17,18
2021,155052,42,0,35,17,18
2021,155052,42,4,35,17,18
2021,155061,0,0,364,193,171
2021,155061,10,0,364,193,171
2021,155061,10,1,60,36,24
2021,155061,10,2,71,39,32
2021,155061,10,3,122,65,57
2021,155061,10,4,93,47,46
2021,155061,10,5,18,6,12
2021,155061,20,0,130,75,55
2021,155061,20,1,56,34,22
2021,155061,20,2,60,32,28
2021,155061,20,3,14,9,5
2021,155061,30,0,85,42,43
2021,155061,30,1,3,1,2
2021,155061,30,2,9,5,4
2021,155061,30,3,73,36,37
2021,155061,40,0,149,76,73
2021,155061,40,1,1,1,0
2021,155061,40,2,2,2,0
2021,155061,40,3,35,20,15
2021,155061,40,4,93,47,46
2021,155061,40,5,18,6,12
2021,155061,42,0,149,76,73
2021,155061,42,1,1,1,0
2021,155061,42,2,2,2,0
2021,155061,42,3,35,20,15
2021,155061,42,4,93,47,46
2021,155061,42,5,18,6,12
2021,155070,0,0,14,9,5
2021,155070,10,0,14,9,5
2021,155070,10,6,14,9,5
2021,155070,40,0,14,9,5
2021,155070,40,6,14,9,5
2021,155070,42,0,14,9,5
2021,155070,42,6,14,9,5
2021,155089,0,0,62,32,30
2021,155089,10,0,62,32,30
2021,155089,10,1,18,13,5
2021,155089,10,2,14,7,7
2021,155089,10,3,29,12,17
2021,155089,10,5,1,0,1
2021,155089,20,0,10,5,5
2021,155089,20,1,10,5,5
2021,155089,30,0,47,24,23
2021,155089,30,1,7,7,0
2021,155089,30,2,14,7,7
2021,155089,30,3,26,10,16
2021,155089,40,0,5,3,2
2021,155089,40,1,1,1,0
2021,155089,40,3,3,2,1
2021,155089,40,5,1,0,1
2021,155089,42,0,5,3,2
2021,155089,42,1,1,1,0
2021,155089,42,3,3,2,1
2021,155089,42,5,1,0,1
2021,155098,0,0,38,16,22
2021,155098,10,0,36,16,20
2021,155098,10,4,36,16,20
2021,155098,20,0,24,10,14
2021,155098,20,4,24,10,14
2021,155098,30,0,12,6,6
2021,155098,30,4,12,6,6
2021,155098,50,0,2,0,2
2021,155104,0,0,69,32,37
2021,155104,10,0,67,30,37
2021,155104,10,1,33,13,20
2021,155104,10,2,19,10,9
2021,155104,10,3,14,6,8
2021,155104,10,4,1,1,0
2021,155104,20,0,51,23,28
2021,155104,20,1,32,13,19
2021,155104,20,2,19,10,9
2021,155104,30,0,16,7,9
2021,155104,30,1,1,0,1
2021,155104,30,3,14,6,8
2021,155104,30,4,1,1,0
2021,155104,50,0,2,2,0
2021,155140,0,0,29,15,14
2021,155140,50,0,29,15,14
2021,155177,0,0,28,17,11
2021,155177,10,0,28,17,11
2021,155177,10,1,28,17,11
2021,155177,40,0,28,17,11
2021,155177,40,1,28,17,11
2021,155177,42,0,28,17,11
2021,155177,42,1,28,17,11
2021,155186,0,0,54,30,24
2021,155186,10,0,54,30,24
2021,155186,10,6,54,30,24
2021,155186,40,0,54,30,24
2021,155186,40,6,54,30,24
2021,155186,42,0,54,30,24
2021,155186,42,6,54,30,24
2021,155195,0,0,142,72,70
2021,155195,10,0,102,49,53
2021,155195,10,1,60,29,31
2021,155195,10,2,5,4,1
2021,155195,10,3,12,5,7
2021,155195,10,4,25,11,14
2021,155195,20,0,77,38,39
2021,155195,20,1,60,29,31
2021,155195,20,2,5,4,1
2021,155195,20,3,12,5,7
2021,155195,30,0,25,11,14
2021,155195,30,4,25,11,14
2021,155195,50,0,40,23,17
2021,155201,0,0,28,13,15
2021,155201,10,0,28,13,15
2021,155201,10,1,18,7,11
2021,155201,10,2,10,6,4
2021,155201,20,0,19,8,11
2021,155201,20,1,18,7,11
2021,155201,20,2,1,1,0
2021,155201,30,0,9,5,4
2021,155201,30,2,9,5,4
2021,155210,0,0,313,151,162
2021,155210,10,0,313,151,162
2021,155210,10,1,168,86,82
2021,155210,10,2,69,30,39
2021,155210,10,3,72,31,41
2021,155210,10,6,4,4,0
2021,155210,40,0,313,151,162
2021,155210,40,1,168,86,82
2021,155210,40,2,69,30,39
2021,155210,40,3,72,31,41
2021,155210,40,6,4,4,0
2021,155210,42,0,313,151,162
2021,155210,42,1,168,86,82
2021,155210,42,2,69,30,39
2021,155210,42,3,72,31,41
2021,155210,42,6,4,4,0
2021,155283,0,0,17,1,16
2021,155283,10,0,17,1,16
2021,155283,10,4,17,1,16
2021,155283,40,0,17,1,16
2021,155283,40,4,17,1,16
2021,155283,41,0,17,1,16
2021,155283,41,4,17,1,16
2021,155283,45,0,17,1,16
2021,155283,45,4,17,1,16
2021,155292,0,0,153,82,71
2021,155292,10,0,153,82,71
2021,155292,10,1,23,15,8
2021,155292,10,2,18,10,8
2021,155292,10,3,22,10,12
2021,155292,10,4,90,47,43
2021,155292,20,0,134,74,60
2021,155292,20,1,23,15,8
2021,155292,20,2,17,10,7
2021,155292,20,3,20,9,11
2021,155292,20,4,74,40,34
2021,155292,30,0,19,8,11
2021,155292,30,2,1,0,1
2021,155292,30,3,2,1,1
2021,155292,30,4,16,7,9
2021,155308,0,0,6,3,3
2021,155308,10,0,6,3,3
2021,155308,10,1,2,0,2
2021,155308,10,2,4,3,1
2021,155308,40,0,6,3,3
2021,155308,40,1,2,0,2
2021,155308,40,2,4,3,1
2021,155308,42,0,6,3,3
2021,155308,42,1,2,0,2
2021,155308,42,2,4,3,1
2021,155317,0,0,2391,1374,1017
2021,155317,10,0,2391,1374,1017
2021,155317,10,1,631,447,184
2021,155317,10,2,679,376,303
2021,155317,10,3,897,478,419
2021,155317,10,4,62,28,34
2021,155317,10,5,122,45,77
2021,155317,20,0,887,596,291
2021,155317,20,1,524,385,139
2021,155317,20,2,363,211,152
2021,155317,30,0,237,142,95
2021,155317,30,1,2,1,1
2021,155317,30,2,15,8,7
2021,155317,30,3,220,133,87
2021,155317,40,0,1267,636,631
2021,155317,40,1,105,61,44
2021,155317,40,2,301,157,144
2021,155317,40,3,677,345,332
2021,155317,40,4,62,28,34
2021,155317,40,5,122,45,77
2021,155317,41,0,783,454,329
2021,155317,41,1,82,54,28
2021,155317,41,2,228,132,96
2021,155317,41,3,392,235,157
2021,155317,41,4,6,5,1
2021,155317,41,5,75,28,47
2021,155317,42,0,478,182,296
2021,155317,42,1,23,7,16
2021,155317,42,2,73,25,48
2021,155317,42,3,284,110,174
2021,155317,42,4,56,23,33
2021,155317,42,5,42,17,25
2021,155317,43,0,6,0,6
2021,155317,43,3,1,0,1
2021,155317,43,5,5,0,5
2021,155317,44,0,739,437,302
2021,155317,44,1,82,54,28
2021,155317,44,2,228,132,96
2021,155317,44,3,392,235,157
2021,155317,44,4,6,5,1
2021,155317,44,5,31,11,20
2021,155317,45,0,44,17,27
2021,155317,45,5,44,17,27
2021,155335,0,0,79,31,48
2021,155335,10,0,79,31,48
2021,155335,10,1,12,7,5
2021,155335,10,2,31,17,14
2021,155335,10,3,27,5,22
2021,155335,10,4,9,2,7
2021,155335,20,0,30,16,14
2021,155335,20,1,11,6,5
2021,155335,20,2,19,10,9
2021,155335,30,0,49,15,34
2021,155335,30,1,1,1,0
2021,155335,30,2,12,7,5
2021,155335,30,3,27,5,22
2021,155335,30,4,9,2,7
2021,155399,0,0,954,541,413
2021,155399,10,0,951,540,411
2021,155399,10,1,286,202,84
2021,155399,10,2,271,158,113
2021,155399,10,3,174,87,87
2021,155399,10,4,151,63,88
2021,155399,10,5,69,30,39
2021,155399,20,0,522,338,184
2021,155399,20,1,266,189,77
2021,155399,20,2,255,148,107
2021,155399,20,3,1,1,0
2021,155399,30,0,143,77,66
2021,155399,30,1,2,1,1
2021,155399,30,2,5,4,1
2021,155399,30,3,134,71,63
2021,155399,30,4,1,0,1
2021,155399,30,5,1,1,0
2021,155399,40,0,286,125,161
2021,155399,40,1,18,12,6
2021,155399,40,2,11,6,5
2021,155399,40,3,39,15,24
2021,155399,40,4,150,63,87
2021,155399,40,5,68,29,39
2021,155399,41,0,142,72,70
2021,155399,41,1,9,8,1
2021,155399,41,2,10,6,4
2021,155399,41,3,15,6,9
2021,155399,41,4,72,36,36
2021,155399,41,5,36,16,20
2021,155399,42,0,142,51,91
2021,155399,42,1,9,4,5
2021,155399,42,2,1,0,1
2021,155399,42,3,23,8,15
2021,155399,42,4,77,26,51
2021,155399,42,5,32,13,19
2021,155399,43,0,2,2,0
2021,155399,43,3,1,1,0
2021,155399,43,4,1,1,0
2021,155399,45,0,142,72,70
2021,155399,45,1,9,8,1
2021,155399,45,2,10,6,4
2021,155399,45,3,15,6,9
2021,155399,45,4,72,36,36
2021,155399,45,5,36,16,20
2021,155399,50,0,3,1,2
2021,155414,0,0,49,20,29
2021,155414,10,0,48,19,29
2021,155414,10,1,6,4,2
2021,155414,10,2,16,6,10
2021,155414,10,3,23,8,15
2021,155414,10,4,3,1,2
2021,155414,20,0,20,9,11
2021,155414,20,1,6,4,2
2021,155414,20,2,14,5,9
2021,155414,30,0,18,7,11
2021,155414,30,2,1,0,1
2021,155414,30,3,17,7,10
2021,155414,40,0,10,3,7
2021,155414,40,2,1,1,0
2021,155414,40,3,6,1,5
2021,155414,40,4,3,1,2
2021,155414,42,0,10,3,7
2021,155414,42,2,1,1,0
2021,155414,42,3,6,1,5
2021,155414,42,4,3,1,2
2021,155414,50,0,1,1,0
2021,155450,0,0,33,13,20
2021,155450,10,0,33,13,20
2021,155450,10,1,19,8,11
2021,155450,10,2,3,1,2
2021,155450,10,3,7,2,5
2021,155450,10,4,4,2,2
2021,155450,20,0,24,9,15
2021,155450,20,1,19,8,11
2021,155450,20,2,3,1,2
2021,155450,20,4,2,0,2
2021,155450,30,0,9,4,5
2021,155450,30,3,7,2,5
2021,155450,30,4,2,2,0
2021,155487,0,0,26,16,10
2021,155487,10,0,25,15,10
2021,155487,10,4,25,15,10
2021,155487,40,0,25,15,10
2021,155487,40,4,25,15,10
2021,155487,42,0,25,15,10
2021,155487,42,4,25,15,10
2021,155487,50,0,1,1,0
2021,155496,0,0,8,7,1
2021,155496,10,0,8,7,1
2021,155496,10,1,3,2,1
2021,155496,10,2,3,3,0
2021,155496,10,3,2,2,0
2021,155496,40,0,8,7,1
2021,155496,40,1,3,2,1
2021,155496,40,2,3,3,0
2021,155496,40,3,2,2,0
2021,155496,42,0,8,7,1
2021,155496,42,1,3,2,1
2021,155496,42,2,3,3,0
2021,155496,42,3,2,2,0
2021,155511,0,0,46,28,18
2021,155511,10,0,46,28,18
2021,155511,10,1,12,8,4
2021,155511,10,2,19,12,7
2021,155511,10,3,15,8,7
2021,155511,20,0,27,17,10
2021,155511,20,1,12,8,4
2021,155511,20,2,15,9,6
2021,155511,30,0,17,10,7
2021,155511,30,2,4,3,1
2021,155511,30,3,13,7,6
2021,155511,40,0,2,1,1
2021,155511,40,3,2,1,1
2021,155511,42,0,2,1,1
2021,155511,42,3,2,1,1
2021,155520,0,0,69,33,36
2021,155520,10,0,69,33,36
2021,155520,10,1,29,18,11
2021,155520,10,2,16,9,7
2021,155520,10,3,24,6,18
2021,155520,40,0,69,33,36
2021,155520,40,1,29,18,11
2021,155520,40,2,16,9,7
2021,155520,40,3,24,6,18
2021,155520,42,0,69,33,36
2021,155520,42,1,29,18,11
2021,155520,42,2,16,9,7
2021,155520,42,3,24,6,18
2021,155566,0,0,55,29,26
2021,155566,10,0,55,29,26
2021,155566,10,1,21,11,10
2021,155566,10,2,7,2,5
2021,155566,10,3,16,8,8
2021,155566,10,4,11,8,3
2021,155566,20,0,31,16,15
2021,155566,20,1,19,9,10
2021,155566,20,2,6,2,4
2021,155566,20,3,2,1,1
2021,155566,20,4,4,4,0
2021,155566,30,0,13,5,8
2021,155566,30,3,8,2,6
2021,155566,30,4,5,3,2
2021,155566,40,0,11,8,3
2021,155566,40,1,2,2,0
2021,155566,40,2,1,0,1
2021,155566,40,3,6,5,1
2021,155566,40,4,2,1,1
2021,155566,42,0,11,8,3
2021,155566,42,1,2,2,0
2021,155566,42,2,1,0,1
2021,155566,42,3,6,5,1
2021,155566,42,4,2,1,1
2021,155593,0,0,53,29,24
2021,155593,10,0,52,28,24
2021,155593,10,4,52,28,24
2021,155593,20,0,32,18,14
2021,155593,20,4,32,18,14
2021,155593,30,0,20,10,10
2021,155593,30,4,20,10,10
2021,155593,50,0,1,1,0
2021,155618,0,0,29,19,10
2021,155618,10,0,29,19,10
2021,155618,10,4,29,19,10
2021,155618,20,0,19,10,9
2021,155618,20,4,19,10,9
2021,155618,30,0,10,9,1
2021,155618,30,4,10,9,1
2021,155627,0,0,27,19,8
2021,155627,10,0,27,19,8
2021,155627,10,1,5,3,2
2021,155627,10,2,12,8,4
2021,155627,10,3,10,8,2
2021,155627,20,0,10,5,5
2021,155627,20,1,5,3,2
2021,155627,20,2,5,2,3
2021,155627,30,0,5,4,1
2021,155627,30,2,3,2,1
2021,155627,30,3,2,2,0
2021,155627,40,0,12,10,2
2021,155627,40,2,4,4,0
2021,155627,40,3,8,6,2
2021,155627,42,0,12,10,2
2021,155627,42,2,4,4,0
2021,155627,42,3,8,6,2
2021,155636,0,0,4,0,4
2021,155636,10,0,4,0,4
2021,155636,10,1,1,0,1
2021,155636,10,2,1,0,1
2021,155636,10,3,2,0,2
2021,155636,20,0,1,0,1
2021,155636,20,1,1,0,1
2021,155636,40,0,3,0,3
2021,155636,40,2,1,0,1
2021,155636,40,3,2,0,2
2021,155636,42,0,3,0,3
2021,155636,42,2,1,0,1
2021,155636,42,3,2,0,2
2021,155681,0,0,267,154,113
2021,155681,10,0,267,154,113
2021,155681,10,1,105,66,39
2021,155681,10,2,69,45,24
2021,155681,10,3,42,23,19
2021,155681,10,4,51,20,31
2021,155681,20,0,181,113,68
2021,155681,20,1,105,66,39
2021,155681,20,2,69,45,24
2021,155681,20,3,7,2,5
2021,155681,30,0,35,21,14
2021,155681,30,3,35,21,14
2021,155681,40,0,51,20,31
2021,155681,40,4,51,20,31
2021,155681,42,0,51,20,31
2021,155681,42,4,51,20,31
2021,155715,0,0,39,27,12
2021,155715,10,0,39,27,12
2021,155715,10,4,39,27,12
2021,155715,20,0,26,16,10
2021,155715,20,4,26,16,10
2021,155715,30,0,13,11,2
2021,155715,30,4,13,11,2
2021,155812,0,0,79,26,53
2021,155812,10,0,79,26,53
2021,155812,10,1,6,4,2
2021,155812,10,2,26,13,13
2021,155812,10,3,20,2,18
2021,155812,10,4,27,7,20
2021,155812,20,0,23,13,10
2021,155812,20,1,6,4,2
2021,155812,20,2,17,9,8
2021,155812,30,0,24,6,18
2021,155812,30,2,9,4,5
2021,155812,30,3,10,1,9
2021,155812,30,4,5,1,4
2021,155812,40,0,32,7,25
2021,155812,40,3,10,1,9
2021,155812,40,4,22,6,16
2021,155812,42,0,32,7,25
2021,155812,42,3,10,1,9
2021,155812,42,4,22,6,16
2021,155830,0,0,26,14,12
2021,155830,10,0,26,14,12
2021,155830,10,4,26,14,12
2021,155830,20,0,16,13,3
2021,155830,20,4,16,13,3
2021,155830,30,0,10,1,9
2021,155830,30,4,10,1,9
2021,155858,0,0,57,30,27
2021,155858,10,0,57,30,27
2021,155858,10,4,57,30,27
2021,155858,40,0,57,30,27
2021,155858,40,4,57,30,27
2021,155858,42,0,57,30,27
2021,155858,42,4,57,30,27
2021,155900,0,0,42,23,19
2021,155900,10,0,42,23,19
2021,155900,10,1,11,9,2
2021,155900,10,2,15,4,11
2021,155900,10,3,12,7,5
2021,155900,10,4,4,3,1
2021,155900,20,0,22,12,10
2021,155900,20,1,11,9,2
2021,155900,20,2,11,3,8
2021,155900,30,0,11,5,6
2021,155900,30,2,1,0,1
2021,155900,30,3,10,5,5
2021,155900,40,0,9,6,3
2021,155900,40,2,3,1,2
2021,155900,40,3,2,2,0
2021,155900,40,4,4,3,1
2021,155900,42,0,9,6,3
2021,155900,42,2,3,1,2
2021,155900,42,3,2,2,0
2021,155900,42,4,4,3,1
2021,155937,0,0,47,25,22
2021,155937,10,0,47,25,22
2021,155937,10,1,4,3,1
2021,155937,10,2,9,6,3
2021,155937,10,3,34,16,18
2021,155937,20,0,30,14,16
2021,155937,20,1,4,3,1
2021,155937,20,2,9,6,3
2021,155937,20,3,17,5,12
2021,155937,30,0,17,11,6
2021,155937,30,3,17,11,6
2021,155973,0,0,35,21,14
2021,155973,10,0,35,21,14
2021,155973,10,1,7,4,3
2021,155973,10,2,8,5,3
2021,155973,10,3,20,12,8
2021,155973,20,0,9,5,4
2021,155973,20,1,7,4,3
2021,155973,20,2,2,1,1
2021,155973,30,0,15,8,7
2021,155973,30,2,3,1,2
2021,155973,30,3,12,7,5
2021,155973,40,0,11,8,3
2021,155973,40,2,3,3,0
2021,155973,40,3,8,5,3
2021,155973,42,0,11,8,3
2021,155973,42,2,3,3,0
2021,155973,42,3,8,5,3
2021,156082,0,0,259,114,145
2021,156082,10,0,259,114,145
2021,156082,10,1,70,36,34
2021,156082,10,2,46,18,28
2021,156082,10,3,58,28,30
2021,156082,10,5,84,32,52
2021,156082,10,6,1,0,1
2021,156082,20,0,117,56,61
2021,156082,20,1,68,35,33
2021,156082,20,2,41,17,24
2021,156082,20,3,8,4,4
2021,156082,30,0,52,24,28
2021,156082,30,2,4,1,3
2021,156082,30,3,48,23,25
2021,156082,40,0,90,34,56
2021,156082,40,1,2,1,1
2021,156082,40,2,1,0,1
2021,156082,40,3,2,1,1
2021,156082,40,5,84,32,52
2021,156082,40,6,1,0,1
2021,156082,42,0,90,34,56
2021,156082,42,1,2,1,1
2021,156082,42,2,1,0,1
2021,156082,42,3,2,1,1
2021,156082,42,5,84,32,52
2021,156082,42,6,1,0,1
2021,156107,0,0,85,47,38
2021,156107,10,0,85,47,38
2021,156107,10,4,85,47,38
2021,156107,20,0,34,18,16
2021,156107,20,4,34,18,16
2021,156107,30,0,51,29,22
2021,156107,30,4,51,29,22
2021,156125,0,0,541,289,252
2021,156125,10,0,541,289,252
2021,156125,10,1,150,97,53
2021,156125,10,2,184,96,88
2021,156125,10,3,199,92,107
2021,156125,10,4,2,1,1
2021,156125,10,6,6,3,3
2021,156125,20,0,255,171,84
2021,156125,20,1,116,83,33
2021,156125,20,2,134,86,48
2021,156125,20,3,3,1,2
2021,156125,20,6,2,1,1
2021,156125,30,0,117,58,59
2021,156125,30,3,113,56,57
2021,156125,30,6,4,2,2
2021,156125,40,0,169,60,109
2021,156125,40,1,34,14,20
2021,156125,40,2,50,10,40
2021,156125,40,3,83,35,48
2021,156125,40,4,2,1,1
2021,156125,42,0,161,60,101
2021,156125,42,1,33,14,19
2021,156125,42,2,47,10,37
2021,156125,42,3,79,35,44
2021,156125,42,4,2,1,1
2021,156125,43,0,8,0,8
2021,156125,43,1,1,0,1
2021,156125,43,2,3,0,3
2021,156125,43,3,4,0,4
2021,156134,0,0,34,21,13
2021,156134,10,0,32,20,12
2021,156134,10,4,32,20,12
2021,156134,40,0,32,20,12
2021,156134,40,4,32,20,12
2021,156134,41,0,32,20,12
2021,156134,41,4,32,20,12
2021,156134,44,0,32,20,12
2021,156134,44,4,32,20,12
2021,156134,50,0,2,1,1
2021,156189,0,0,29,14,15
2021,156189,10,0,29,14,15
2021,156189,10,1,9,6,3
2021,156189,10,2,5,3,2
2021,156189,10,3,11,4,7
2021,156189,10,4,4,1,3
2021,156189,40,0,29,14,15
2021,156189,40,1,9,6,3
2021,156189,40,2,5,3,2
2021,156189,40,3,11,4,7
2021,156189,40,4,4,1,3
2021,156189,43,0,29,14,15
2021,156189,43,1,9,6,3
2021,156189,43,2,5,3,2
2021,156189,43,3,11,4,7
2021,156189,43,4,4,1,3
2021,156213,0,0,79,42,37
2021,156213,10,0,79,42,37
2021,156213,10,1,29,21,8
2021,156213,10,2,19,13,6
2021,156213,10,3,30,8,22
2021,156213,10,4,1,0,1
2021,156213,20,0,36,25,11
2021,156213,20,1,24,18,6
2021,156213,20,2,12,7,5
2021,156213,30,0,31,13,18
2021,156213,30,1,5,3,2
2021,156213,30,2,6,5,1
2021,156213,30,3,20,5,15
2021,156213,40,0,12,4,8
2021,156213,40,2,1,1,0
2021,156213,40,3,10,3,7
2021,156213,40,4,1,0,1
2021,156213,41,0,3,2,1
2021,156213,41,2,1,1,0
2021,156213,41,3,2,1,1
2021,156213,42,0,9,2,7
2021,156213,42,3,8,2,6
2021,156213,42,4,1,0,1
2021,156213,44,0,3,2,1
2021,156213,44,2,1,1,0
2021,156213,44,3,2,1,1
2021,156222,0,0,45,38,7
2021,156222,10,0,45,38,7
2021,156222,10,1,31,27,4
2021,156222,10,2,11,10,1
2021,156222,10,3,3,1,2
2021,156222,20,0,35,30,5
2021,156222,20,1,31,27,4
2021,156222,20,2,4,3,1
2021,156222,30,0,7,6,1
2021,156222,30,2,5,5,0
2021,156222,30,3,2,1,1
2021,156222,40,0,3,2,1
2021,156222,40,2,2,2,0
2021,156222,40,3,1,0,1
2021,156222,42,0,3,2,1
2021,156222,42,2,2,2,0
2021,156222,42,3,1,0,1
2021,156231,0,0,67,36,31
2021,156231,10,0,67,36,31
2021,156231,10,1,26,16,10
2021,156231,10,2,16,8,8
2021,156231,10,3,10,4,6
2021,156231,10,4,15,8,7
2021,156231,20,0,18,11,7
2021,156231,20,1,18,11,7
2021,156231,40,0,49,25,24
2021,156231,40,1,8,5,3
2021,156231,40,2,16,8,8
2021,156231,40,3,10,4,6
2021,156231,40,4,15,8,7
2021,156231,42,0,3,1,2
2021,156231,42,1,1,1,0
2021,156231,42,2,1,0,1
2021,156231,42,3,1,0,1
2021,156231,43,0,46,24,22
2021,156231,43,1,7,4,3
2021,156231,43,2,15,8,7
2021,156231,43,3,9,4,5
2021,156231,43,4,15,8,7
2021,156286,0,0,179,70,109
2021,156286,10,0,179,70,109
2021,156286,10,1,36,25,11
2021,156286,10,2,62,24,38
2021,156286,10,3,63,16,47
2021,156286,10,4,18,5,13
2021,156286,20,0,87,46,41
2021,156286,20,1,35,25,10
2021,156286,20,2,51,21,30
2021,156286,20,3,1,0,1
2021,156286,30,0,51,12,39
2021,156286,30,2,7,2,5
2021,156286,30,3,44,10,34
2021,156286,40,0,41,12,29
2021,156286,40,1,1,0,1
2021,156286,40,2,4,1,3
2021,156286,40,3,18,6,12
2021,156286,40,4,18,5,13
2021,156286,42,0,41,12,29
2021,156286,42,1,1,0,1
2021,156286,42,2,4,1,3
2021,156286,42,3,18,6,12
2021,156286,42,4,18,5,13
2021,156295,0,0,151,73,78
2021,156295,10,0,151,73,78
2021,156295,10,1,33,17,16
2021,156295,10,2,64,36,28
2021,156295,10,3,48,18,30
2021,156295,10,4,4,2,2
2021,156295,10,6,2,0,2
2021,156295,20,0,78,44,34
2021,156295,20,1,29,15,14
2021,156295,20,2,49,29,20
2021,156295,30,0,35,12,23
2021,156295,30,1,2,0,2
2021,156295,30,2,5,2,3
2021,156295,30,3,28,10,18
2021,156295,40,0,38,17,21
2021,156295,40,1,2,2,0
2021,156295,40,2,10,5,5
2021,156295,40,3,20,8,12
2021,156295,40,4,4,2,2
2021,156295,40,6,2,0,2
2021,156295,41,0,31,15,16
2021,156295,41,1,2,2,0
2021,156295,41,2,10,5,5
2021,156295,41,3,14,7,7
2021,156295,41,4,3,1,2
2021,156295,41,6,2,0,2
2021,156295,42,0,7,2,5
2021,156295,42,3,6,1,5
2021,156295,42,4,1,1,0
2021,156295,44,0,30,15,15
2021,156295,44,1,2,2,0
2021,156295,44,2,10,5,5
2021,156295,44,3,14,7,7
2021,156295,44,4,2,1,1
2021,156295,44,6,2,0,2
2021,156295,45,0,1,0,1
2021,156295,45,4,1,0,1
2021,156338,0,0,90,42,48
2021,156338,10,0,90,42,48
2021,156338,10,1,20,14,6
2021,156338,10,2,28,10,18
2021,156338,10,3,25,11,14
2021,156338,10,4,17,7,10
2021,156338,40,0,90,42,48
2021,156338,40,1,20,14,6
2021,156338,40,2,28,10,18
2021,156338,40,3,25,11,14
2021,156338,40,4,17,7,10
2021,156338,42,0,28,12,16
2021,156338,42,1,6,2,4
2021,156338,42,2,7,3,4
2021,156338,42,3,10,5,5
2021,156338,42,4,5,2,3
2021,156338,43,0,62,30,32
2021,156338,43,1,14,12,2
2021,156338,43,2,21,7,14
2021,156338,43,3,15,6,9
2021,156338,43,4,12,5,7
2021,156356,0,0,42,19,23
2021,156356,10,0,42,19,23
2021,156356,10,1,6,3,3
2021,156356,10,2,15,7,8
2021,156356,10,3,17,7,10
2021,156356,10,4,4,2,2
2021,156356,20,0,19,7,12
2021,156356,20,1,6,3,3
2021,156356,20,2,12,4,8
2021,156356,20,3,1,0,1
2021,156356,30,0,12,7,5
2021,156356,30,2,2,2,0
2021,156356,30,3,10,5,5
2021,156356,40,0,11,5,6
2021,156356,40,2,1,1,0
2021,156356,40,3,6,2,4
2021,156356,40,4,4,2,2
2021,156356,42,0,11,5,6
2021,156356,42,2,1,1,0
2021,156356,42,3,6,2,4
2021,156356,42,4,4,2,2
2021,156365,0,0,257,114,143
2021,156365,10,0,224,106,118
2021,156365,10,1,48,27,21
2021,156365,10,2,57,28,29
2021,156365,10,3,70,32,38
2021,156365,10,4,49,19,30
2021,156365,20,0,72,36,36
2021,156365,20,1,40,22,18
2021,156365,20,2,28,14,14
2021,156365,20,3,4,0,4
2021,156365,30,0,103,51,52
2021,156365,30,1,8,5,3
2021,156365,30,2,29,14,15
2021,156365,30,3,66,32,34
2021,156365,40,0,49,19,30
2021,156365,40,4,49,19,30
2021,156365,42,0,49,19,30
2021,156365,42,4,49,19,30
2021,156365,50,0,33,8,25
2021,156392,0,0,191,87,104
2021,156392,10,0,191,87,104
2021,156392,10,1,54,23,31
2021,156392,10,2,51,29,22
2021,156392,10,3,29,11,18
2021,156392,10,4,53,21,32
2021,156392,10,5,4,3,1
2021,156392,20,0,72,40,32
2021,156392,20,1,46,21,25
2021,156392,20,2,26,19,7
2021,156392,30,0,32,12,20
2021,156392,30,1,2,1,1
2021,156392,30,2,8,2,6
2021,156392,30,3,7,4,3
2021,156392,30,4,15,5,10
2021,156392,40,0,87,35,52
2021,156392,40,1,6,1,5
2021,156392,40,2,17,8,9
2021,156392,40,3,22,7,15
2021,156392,40,4,38,16,22
2021,156392,40,5,4,3,1
2021,156392,42,0,14,6,8
2021,156392,42,1,1,0,1
2021,156392,42,2,3,1,2
2021,156392,42,3,7,3,4
2021,156392,42,4,3,2,1
2021,156392,43,0,73,29,44
2021,156392,43,1,5,1,4
2021,156392,43,2,14,7,7
2021,156392,43,3,15,4,11
2021,156392,43,4,35,14,21
2021,156392,43,5,4,3,1
2021,156408,0,0,143,78,65
2021,156408,10,0,143,78,65
2021,156408,10,1,35,24,11
2021,156408,10,2,48,25,23
2021,156408,10,3,54,25,29
2021,156408,10,4,4,3,1
2021,156408,10,6,2,1,1
2021,156408,20,0,83,49,34
2021,156408,20,1,35,24,11
2021,156408,20,2,48,25,23
2021,156408,30,0,28,12,16
2021,156408,30,3,28,12,16
2021,156408,40,0,32,17,15
2021,156408,40,3,26,13,13
2021,156408,40,4,4,3,1
2021,156408,40,6,2,1,1
2021,156408,41,0,21,13,8
2021,156408,41,3,16,10,6
2021,156408,41,4,3,2,1
2021,156408,41,6,2,1,1
2021,156408,42,0,11,4,7
2021,156408,42,3,10,3,7
2021,156408,42,4,1,1,0
2021,156408,44,0,21,13,8
2021,156408,44,3,16,10,6
2021,156408,44,4,3,2,1
2021,156408,44,6,2,1,1
2021,156417,0,0,7,6,1
2021,156417,10,0,7,6,1
2021,156417,10,1,3,3,0
2021,156417,10,2,1,1,0
2021,156417,10,3,2,2,0
2021,156417,10,4,1,0,1
2021,156417,40,0,7,6,1
2021,156417,40,1,3,3,0
2021,156417,40,2,1,1,0
2021,156417,40,3,2,2,0
2021,156417,40,4,1,0,1
2021,156417,41,0,1,1,0
2021,156417,41,1,1,1,0
2021,156417,42,0,6,5,1
2021,156417,42,1,2,2,0
2021,156417,42,2,1,1,0
2021,156417,42,3,2,2,0
2021,156417,42,4,1,0,1
2021,156417,44,0,1,1,0
2021,156417,44,1,1,1,0
2021,156471,0,0,70,6,64
2021,156471,10,0,70,6,64
2021,156471,10,2,4,0,4
2021,156471,10,3,8,0,8
2021,156471,10,4,58,6,52
2021,156471,40,0,70,6,64
2021,156471,40,2,4,0,4
2021,156471,40,3,8,0,8
2021,156471,40,4,58,6,52
2021,156471,41,0,70,6,64
2021,156471,41,2,4,0,4
2021,156471,41,3,8,0,8
2021,156471,41,4,58,6,52
2021,156471,45,0,70,6,64
2021,156471,45,2,4,0,4
2021,156471,45,3,8,0,8
2021,156471,45,4,58,6,52
2021,156541,0,0,259,126,133
2021,156541,10,0,259,126,133
2021,156541,10,1,56,33,23
2021,156541,10,2,100,51,49
2021,156541,10,3,84,31,53
2021,156541,10,4,19,11,8
2021,156541,20,0,36,21,15
2021,156541,20,1,26,15,11
2021,156541,20,2,10,6,4
2021,156541,30,0,121,42,79
2021,156541,30,1,14,8,6
2021,156541,30,2,50,17,33
2021,156541,30,3,55,16,39
2021,156541,30,4,2,1,1
2021,156541,40,0,102,63,39
2021,156541,40,1,16,10,6
2021,156541,40,2,40,28,12
2021,156541,40,3,29,15,14
2021,156541,40,4,17,10,7
2021,156541,42,0,102,63,39
2021,156541,42,1,16,10,6
2021,156541,42,2,40,28,12
2021,156541,42,3,29,15,14
2021,156541,42,4,17,10,7
2021,156620,0,0,513,251,262
2021,156620,10,0,513,251,262
2021,156620,10,1,156,92,64
2021,156620,10,2,150,69,81
2021,156620,10,3,124,53,71
2021,156620,10,4,1,1,0
2021,156620,10,5,54,29,25
2021,156620,10,6,28,7,21
2021,156620,20,0,297,156,141
2021,156620,20,1,155,92,63
2021,156620,20,2,129,59,70
2021,156620,20,3,12,4,8
2021,156620,20,6,1,1,0
2021,156620,30,0,129,57,72
2021,156620,30,2,21,10,11
2021,156620,30,3,108,47,61
2021,156620,40,0,87,38,49
2021,156620,40,1,1,0,1
2021,156620,40,3,4,2,2
2021,156620,40,4,1,1,0
2021,156620,40,5,54,29,25
2021,156620,40,6,27,6,21
2021,156620,42,0,84,38,46
2021,156620,42,1,1,0,1
2021,156620,42,3,4,2,2
2021,156620,42,4,1,1,0
2021,156620,42,5,53,29,24
2021,156620,42,6,25,6,19
2021,156620,43,0,3,0,3
2021,156620,43,5,1,0,1
2021,156620,43,6,2,0,2
2021,156648,0,0,108,62,46
2021,156648,10,0,108,62,46
2021,156648,10,1,43,22,21
2021,156648,10,2,31,20,11
2021,156648,10,3,16,10,6
2021,156648,10,4,17,10,7
2021,156648,10,5,1,0,1
2021,156648,20,0,48,25,23
2021,156648,20,1,27,12,15
2021,156648,20,2,21,13,8
2021,156648,40,0,60,37,23
2021,156648,40,1,16,10,6
2021,156648,40,2,10,7,3
2021,156648,40,3,16,10,6
2021,156648,40,4,17,10,7
2021,156648,40,5,1,0,1
2021,156648,42,0,3,3,0
2021,156648,42,1,1,1,0
2021,156648,42,2,1,1,0
2021,156648,42,4,1,1,0
2021,156648,43,0,57,34,23
2021,156648,43,1,15,9,6
2021,156648,43,2,9,6,3
2021,156648,43,3,16,10,6
2021,156648,43,4,16,9,7
2021,156648,43,5,1,0,1
2021,156727,0,0,137,9,128
2021,156727,10,0,137,9,128
2021,156727,10,1,2,0,2
2021,156727,10,2,18,1,17
2021,156727,10,3,37,2,35
2021,156727,10,4,78,6,72
2021,156727,10,6,2,0,2
2021,156727,40,0,137,9,128
2021,156727,40,1,2,0,2
2021,156727,40,2,18,1,17
2021,156727,40,3,37,2,35
2021,156727,40,4,78,6,72
2021,156727,40,6,2,0,2
2021,156727,42,0,137,9,128
2021,156727,42,1,2,0,2
2021,156727,42,2,18,1,17
2021,156727,42,3,37,2,35
2021,156727,42,4,78,6,72
2021,156727,42,6,2,0,2
2021,156745,0,0,79,41,38
2021,156745,10,0,79,41,38
2021,156745,10,1,38,21,17
2021,156745,10,2,16,11,5
2021,156745,10,3,16,6,10
2021,156745,10,4,6,2,4
2021,156745,10,5,3,1,2
2021,156745,20,0,53,30,23
2021,156745,20,1,37,20,17
2021,156745,20,2,15,10,5
2021,156745,20,3,1,0,1
2021,156745,30,0,17,8,9
2021,156745,30,1,1,1,0
2021,156745,30,2,1,1,0
2021,156745,30,3,15,6,9
2021,156745,40,0,9,3,6
2021,156745,40,4,6,2,4
2021,156745,40,5,3,1,2
2021,156745,42,0,9,3,6
2021,156745,42,4,6,2,4
2021,156745,42,5,3,1,2
2021,156790,0,0,73,34,39
2021,156790,10,0,73,34,39
2021,156790,10,1,32,17,15
2021,156790,10,2,17,5,12
2021,156790,10,3,13,8,5
2021,156790,10,4,8,3,5
2021,156790,10,5,3,1,2
2021,156790,20,0,22,12,10
2021,156790,20,1,22,12,10
2021,156790,40,0,51,22,29
2021,156790,40,1,10,5,5
2021,156790,40,2,17,5,12
2021,156790,40,3,13,8,5
2021,156790,40,4,8,3,5
2021,156790,40,5,3,1,2
2021,156790,42,0,10,6,4
2021,156790,42,1,4,2,2
2021,156790,42,2,2,1,1
2021,156790,42,3,1,1,0
2021,156790,42,4,3,2,1
2021,156790,43,0,41,16,25
2021,156790,43,1,6,3,3
2021,156790,43,2,15,4,11
2021,156790,43,3,12,7,5
2021,156790,43,4,5,1,4
2021,156790,43,5,3,1,2
2021,156851,0,0,35,12,23
2021,156851,10,0,35,12,23
2021,156851,10,1,13,5,8
2021,156851,10,2,8,3,5
2021,156851,10,3,6,2,4
2021,156851,10,4,8,2,6
2021,156851,20,0,14,6,8
2021,156851,20,1,13,5,8
2021,156851,20,2,1,1,0
2021,156851,30,0,2,0,2
2021,156851,30,2,2,0,2
2021,156851,40,0,19,6,13
2021,156851,40,2,5,2,3
2021,156851,40,3,6,2,4
2021,156851,40,4,8,2,6
2021,156851,42,0,2,1,1
2021,156851,42,3,2,1,1
2021,156851,43,0,17,5,12
2021,156851,43,2,5,2,3
2021,156851,43,3,4,1,3
2021,156851,43,4,8,2,6
2021,156860,0,0,52,19,33
2021,156860,10,0,52,19,33
2021,156860,10,1,13,7,6
2021,156860,10,2,9,6,3
2021,156860,10,3,10,1,9
2021,156860,10,4,20,5,15
2021,156860,20,0,15,7,8
2021,156860,20,1,12,6,6
2021,156860,20,2,3,1,2
2021,156860,40,0,37,12,25
2021,156860,40,1,1,1,0
2021,156860,40,2,6,5,1
2021,156860,40,3,10,1,9
2021,156860,40,4,20,5,15
2021,156860,43,0,37,12,25
2021,156860,43,1,1,1,0
2021,156860,43,2,6,5,1
2021,156860,43,3,10,1,9
2021,156860,43,4,20,5,15
2021,156921,0,0,180,80,100
2021,156921,10,0,180,80,100
2021,156921,10,1,46,17,29
2021,156921,10,2,45,23,22
2021,156921,10,3,28,12,16
2021,156921,10,4,61,28,33
2021,156921,20,0,67,31,36
2021,156921,20,1,38,16,22
2021,156921,20,2,29,15,14
2021,156921,30,0,8,2,6
2021,156921,30,1,2,0,2
2021,156921,30,2,6,2,4
2021,156921,40,0,105,47,58
2021,156921,40,1,6,1,5
2021,156921,40,2,10,6,4
2021,156921,40,3,28,12,16
2021,156921,40,4,61,28,33
2021,156921,42,0,17,6,11
2021,156921,42,1,2,0,2
2021,156921,42,2,2,1,1
2021,156921,42,3,5,3,2
2021,156921,42,4,8,2,6
2021,156921,43,0,88,41,47
2021,156921,43,1,4,1,3
2021,156921,43,2,8,5,3
2021,156921,43,3,23,9,14
2021,156921,43,4,53,26,27
2021,157021,0,0,8,3,5
2021,157021,50,0,8,3,5
2021,157030,0,0,3,3,0
2021,157030,10,0,3,3,0
2021,157030,10,1,3,3,0
2021,157030,40,0,3,3,0
2021,157030,40,1,3,3,0
2021,157030,41,0,3,3,0
2021,157030,41,1,3,3,0
2021,157030,45,0,3,3,0
2021,157030,45,1,3,3,0
2021,157058,0,0,114,63,51
2021,157058,10,0,114,63,51
2021,157058,10,1,27,20,7
2021,157058,10,2,39,23,16
2021,157058,10,3,41,16,25
2021,157058,10,4,7,4,3
2021,157058,20,0,71,45,26
2021,157058,20,1,26,19,7
2021,157058,20,2,35,21,14
2021,157058,20,3,10,5,5
2021,157058,30,0,19,10,9
2021,157058,30,1,1,1,0
2021,157058,30,2,1,1,0
2021,157058,30,3,17,8,9
2021,157058,40,0,24,8,16
2021,157058,40,2,3,1,2
2021,157058,40,3,14,3,11
2021,157058,40,4,7,4,3
2021,157058,42,0,24,8,16
2021,157058,42,2,3,1,2
2021,157058,42,3,14,3,11
2021,157058,42,4,7,4,3
2021,157076,0,0,45,20,25
2021,157076,10,0,45,20,25
2021,157076,10,1,1,1,0
2021,157076,10,2,16,8,8
2021,157076,10,3,26,10,16
2021,157076,10,4,2,1,1
2021,157076,20,0,15,8,7
2021,157076,20,1,1,1,0
2021,157076,20,2,14,7,7
2021,157076,30,0,22,10,12
2021,157076,30,2,2,1,1
2021,157076,30,3,19,9,10
2021,157076,30,4,1,0,1
2021,157076,40,0,8,2,6
2021,157076,40,3,7,1,6
2021,157076,40,4,1,1,0
2021,157076,42,0,7,1,6
2021,157076,42,3,7,1,6
2021,157076,43,0,1,1,0
2021,157076,43,4,1,1,0
2021,157085,0,0,1713,1000,713
2021,157085,10,0,1713,1000,713
2021,157085,10,1,624,455,169
2021,157085,10,2,502,292,210
2021,157085,10,3,363,157,206
2021,157085,10,4,10,8,2
2021,157085,10,5,214,88,126
2021,157085,20,0,1100,734,366
2021,157085,20,1,621,453,168
2021,157085,20,2,479,281,198
2021,157085,30,0,378,165,213
2021,157085,30,2,22,10,12
2021,157085,30,3,356,155,201
2021,157085,40,0,235,101,134
2021,157085,40,1,3,2,1
2021,157085,40,2,1,1,0
2021,157085,40,3,7,2,5
2021,157085,40,4,10,8,2
2021,157085,40,5,214,88,126
2021,157085,41,0,161,68,93
2021,157085,41,5,161,68,93
2021,157085,42,0,61,25,36
2021,157085,42,1,3,2,1
2021,157085,42,2,1,1,0
2021,157085,42,3,6,1,5
2021,157085,42,4,7,5,2
2021,157085,42,5,44,16,28
2021,157085,43,0,13,8,5
2021,157085,43,3,1,1,0
2021,157085,43,4,3,3,0
2021,157085,43,5,9,4,5
2021,157085,44,0,161,68,93
2021,157085,44,5,161,68,93
2021,157100,0,0,28,10,18
2021,157100,10,0,27,10,17
2021,157100,10,1,3,2,1
2021,157100,10,2,9,7,2
2021,157100,10,3,14,1,13
2021,157100,10,4,1,0,1
2021,157100,40,0,27,10,17
2021,157100,40,1,3,2,1
2021,157100,40,2,9,7,2
2021,157100,40,3,14,1,13
2021,157100,40,4,1,0,1
2021,157100,42,0,27,10,17
2021,157100,42,1,3,2,1
2021,157100,42,2,9,7,2
2021,157100,42,3,14,1,13
2021,157100,42,4,1,0,1
2021,157100,50,0,1,0,1
2021,157207,0,0,3,1,2
2021,157207,10,0,3,1,2
2021,157207,10,1,1,1,0
2021,157207,10,2,2,0,2
2021,157207,40,0,3,1,2
2021,157207,40,1,1,1,0
2021,157207,40,2,2,0,2
2021,157207,41,0,3,1,2
2021,157207,41,1,1,1,0
2021,157207,41,2,2,0,2
2021,157207,44,0,3,1,2
2021,157207,44,1,1,1,0
2021,157207,44,2,2,0,2
2021,157216,0,0,105,44,61
2021,157216,10,0,105,44,61
2021,157216,10,1,10,6,4
2021,157216,10,2,29,14,15
2021,157216,10,3,57,20,37
2021,157216,10,4,9,4,5
2021,157216,40,0,105,44,61
2021,157216,40,1,10,6,4
2021,157216,40,2,29,14,15
2021,157216,40,3,57,20,37
2021,157216,40,4,9,4,5
2021,157216,41,0,77,33,44
2021,157216,41,1,10,6,4
2021,157216,41,2,28,13,15
2021,157216,41,3,34,12,22
2021,157216,41,4,5,2,3
2021,157216,42,0,28,11,17
2021,157216,42,2,1,1,0
2021,157216,42,3,23,8,15
2021,157216,42,4,4,2,2
2021,157216,44,0,77,33,44
2021,157216,44,1,10,6,4
2021,157216,44,2,28,13,15
2021,157216,44,3,34,12,22
2021,157216,44,4,5,2,3
2021,157289,0,0,1151,581,570
2021,157289,10,0,1151,581,570
2021,157289,10,1,277,184,93
2021,157289,10,2,327,160,167
2021,157289,10,3,420,190,230
2021,157289,10,4,107,39,68
2021,157289,10,5,1,1,0
2021,157289,10,6,19,7,12
2021,157289,20,0,390,246,144
2021,157289,20,1,213,149,64
2021,157289,20,2,173,94,79
2021,157289,20,3,4,3,1
2021,157289,30,0,95,41,54
2021,157289,30,2,5,2,3
2021,157289,30,3,83,37,46
2021,157289,30,4,7,2,5
2021,157289,40,0,666,294,372
2021,157289,40,1,64,35,29
2021,157289,40,2,149,64,85
2021,157289,40,3,333,150,183
2021,157289,40,4,100,37,63
2021,157289,40,5,1,1,0
2021,157289,40,6,19,7,12
2021,157289,41,0,237,99,138
2021,157289,41,1,20,7,13
2021,157289,41,2,45,21,24
2021,157289,41,3,131,54,77
2021,157289,41,4,40,16,24
2021,157289,41,5,1,1,0
2021,157289,42,0,413,189,224
2021,157289,42,1,44,28,16
2021,157289,42,2,103,43,60
2021,157289,42,3,193,92,101
2021,157289,42,4,54,19,35
2021,157289,42,6,19,7,12
2021,157289,43,0,16,6,10
2021,157289,43,2,1,0,1
2021,157289,43,3,9,4,5
2021,157289,43,4,6,2,4
2021,157289,44,0,237,99,138
2021,157289,44,1,20,7,13
2021,157289,44,2,45,21,24
2021,157289,44,3,131,54,77
2021,157289,44,4,40,16,24
2021,157289,44,5,1,1,0
2021,157298,0,0,12,7,5
2021,157298,10,0,12,7,5
2021,157298,10,1,8,5,3
2021,157298,10,3,4,2,2
2021,157298,20,0,7,4,3
2021,157298,20,1,7,4,3
2021,157298,30,0,3,2,1
2021,157298,30,1,1,1,0
2021,157298,30,3,2,1,1
2021,157298,40,0,2,1,1
2021,157298,40,3,2,1,1
2021,157298,42,0,2,1,1
2021,157298,42,3,2,1,1
2021,157304,0,0,83,29,54
2021,157304,10,0,83,29,54
2021,157304,10,1,45,13,32
2021,157304,10,2,15,3,12
2021,157304,10,3,4,3,1
2021,157304,10,4,16,7,9
2021,157304,10,5,3,3,0
2021,157304,20,0,28,8,20
2021,157304,20,1,26,8,18
2021,157304,20,2,2,0,2
2021,157304,30,0,7,4,3
2021,157304,30,2,4,1,3
2021,157304,30,3,1,1,0
2021,157304,30,4,1,1,0
2021,157304,30,5,1,1,0
2021,157304,40,0,48,17,31
2021,157304,40,1,19,5,14
2021,157304,40,2,9,2,7
2021,157304,40,3,3,2,1
2021,157304,40,4,15,6,9
2021,157304,40,5,2,2,0
2021,157304,42,0,5,3,2
2021,157304,42,1,2,1,1
2021,157304,42,2,1,0,1
2021,157304,42,3,1,1,0
2021,157304,42,4,1,1,0
2021,157304,43,0,43,14,29
2021,157304,43,1,17,4,13
2021,157304,43,2,8,2,6
2021,157304,43,3,2,1,1
2021,157304,43,4,14,5,9
2021,157304,43,5,2,2,0
2021,157331,0,0,83,34,49
2021,157331,10,0,83,34,49
2021,157331,10,1,27,11,16
2021,157331,10,2,20,7,13
2021,157331,10,3,10,4,6
2021,157331,10,4,26,12,14
2021,157331,20,0,18,8,10
2021,157331,20,1,16,7,9
2021,157331,20,2,2,1,1
2021,157331,30,0,6,1,5
2021,157331,30,1,1,0,1
2021,157331,30,2,5,1,4
2021,157331,40,0,59,25,34
2021,157331,40,1,10,4,6
2021,157331,40,2,13,5,8
2021,157331,40,3,10,4,6
2021,157331,40,4,26,12,14
2021,157331,42,0,4,3,1
2021,157331,42,1,2,1,1
2021,157331,42,4,2,2,0
2021,157331,43,0,55,22,33
2021,157331,43,1,8,3,5
2021,157331,43,2,13,5,8
2021,157331,43,3,10,4,6
2021,157331,43,4,24,10,14
2021,157377,0,0,35,14,21
2021,157377,10,0,35,14,21
2021,157377,10,1,4,2,2
2021,157377,10,2,6,2,4
2021,157377,10,3,18,8,10
2021,157377,10,4,7,2,5
2021,157377,40,0,35,14,21
2021,157377,40,1,4,2,2
2021,157377,40,2,6,2,4
2021,157377,40,3,18,8,10
2021,157377,40,4,7,2,5
2021,157377,41,0,19,7,12
2021,157377,41,1,1,1,0
2021,157377,41,2,5,1,4
2021,157377,41,3,10,4,6
2021,157377,41,4,3,1,2
2021,157377,42,0,16,7,9
2021,157377,42,1,3,1,2
2021,157377,42,2,1,1,0
2021,157377,42,3,8,4,4
2021,157377,42,4,4,1,3
2021,157377,44,0,19,7,12
2021,157377,44,1,1,1,0
2021,157377,44,2,5,1,4
2021,157377,44,3,10,4,6
2021,157377,44,4,3,1,2
2021,157386,0,0,307,159,148
2021,157386,10,0,306,159,147
2021,157386,10,1,76,44,32
2021,157386,10,2,84,48,36
2021,157386,10,3,64,32,32
2021,157386,10,4,82,35,47
2021,157386,20,0,154,89,65
2021,157386,20,1,76,44,32
2021,157386,20,2,78,45,33
2021,157386,30,0,56,28,28
2021,157386,30,2,6,3,3
2021,157386,30,3,50,25,25
2021,157386,40,0,96,42,54
2021,157386,40,3,14,7,7
2021,157386,40,4,82,35,47
2021,157386,42,0,96,42,54
2021,157386,42,3,14,7,7
2021,157386,42,4,82,35,47
2021,157386,50,0,1,0,1
2021,157401,0,0,445,223,222
2021,157401,10,0,445,223,222
2021,157401,10,1,72,44,28
2021,157401,10,2,120,64,56
2021,157401,10,3,160,80,80
2021,157401,10,4,93,35,58
2021,157401,20,0,221,131,90
2021,157401,20,1,65,40,25
2021,157401,20,2,113,62,51
2021,157401,20,3,34,26,8
2021,157401,20,4,9,3,6
2021,157401,30,0,116,51,65
2021,157401,30,1,2,1,1
2021,157401,30,2,5,2,3
2021,157401,30,3,109,48,61
2021,157401,40,0,108,41,67
2021,157401,40,1,5,3,2
2021,157401,40,2,2,0,2
2021,157401,40,3,17,6,11
2021,157401,40,4,84,32,52
2021,157401,41,0,4,2,2
2021,157401,41,1,3,2,1
2021,157401,41,2,1,0,1
2021,157401,42,0,104,39,65
2021,157401,42,1,2,1,1
2021,157401,42,2,1,0,1
2021,157401,42,3,17,6,11
2021,157401,42,4,84,32,52
2021,157401,44,0,4,2,2
2021,157401,44,1,3,2,1
2021,157401,44,2,1,0,1
2021,157438,0,0,79,42,37
2021,157438,10,0,79,42,37
2021,157438,10,1,12,8,4
2021,157438,10,2,18,7,11
2021,157438,10,3,15,9,6
2021,157438,10,4,32,16,16
2021,157438,10,5,2,2,0
2021,157438,40,0,79,42,37
2021,157438,40,1,12,8,4
2021,157438,40,2,18,7,11
2021,157438,40,3,15,9,6
2021,157438,40,4,32,16,16
2021,157438,40,5,2,2,0
2021,157438,42,0,16,7,9
2021,157438,42,1,3,2,1
2021,157438,42,2,3,1,2
2021,157438,42,3,3,1,2
2021,157438,42,4,7,3,4
2021,157438,43,0,63,35,28
2021,157438,43,1,9,6,3
2021,157438,43,2,15,6,9
2021,157438,43,3,12,8,4
2021,157438,43,4,25,13,12
2021,157438,43,5,2,2,0
2021,157447,0,0,610,269,341
2021,157447,10,0,609,269,340
2021,157447,10,1,133,79,54
2021,157447,10,2,133,55,78
2021,157447,10,3,90,41,49
2021,157447,10,5,253,94,159
2021,157447,20,0,263,132,131
2021,157447,20,1,132,79,53
2021,157447,20,2,131,53,78
2021,157447,30,0,92,43,49
2021,157447,30,2,2,2,0
2021,157447,30,3,90,41,49
2021,157447,40,0,254,94,160
2021,157447,40,1,1,0,1
2021,157447,40,5,253,94,159
2021,157447,42,0,254,94,160
2021,157447,42,1,1,0,1
2021,157447,42,5,253,94,159
2021,157447,50,0,1,0,1
2021,157483,0,0,117,40,77
2021,157483,10,0,117,40,77
2021,157483,10,1,36,12,24
2021,157483,10,2,20,13,7
2021,157483,10,3,25,9,16
2021,157483,10,4,35,6,29
2021,157483,10,5,1,0,1
2021,157483,20,0,18,5,13
2021,157483,20,1,17,5,12
2021,157483,20,2,1,0,1
2021,157483,40,0,99,35,64
2021,157483,40,1,19,7,12
2021,157483,40,2,19,13,6
2021,157483,40,3,25,9,16
2021,157483,40,4,35,6,29
2021,157483,40,5,1,0,1
2021,157483,42,0,25,14,11
2021,157483,42,1,2,1,1
2021,157483,42,2,12,8,4
2021,157483,42,3,9,4,5
2021,157483,42,4,2,1,1
2021,157483,43,0,74,21,53
2021,157483,43,1,17,6,11
2021,157483,43,2,7,5,2
2021,157483,43,3,16,5,11
2021,157483,43,4,33,5,28
2021,157483,43,5,1,0,1
2021,157535,0,0,107,47,60
2021,157535,10,0,107,47,60
2021,157535,10,1,30,15,15
2021,157535,10,2,33,13,20
2021,157535,10,3,40,16,24
2021,157535,10,4,4,3,1
2021,157535,40,0,107,47,60
2021,157535,40,1,30,15,15
2021,157535,40,2,33,13,20
2021,157535,40,3,40,16,24
2021,157535,40,4,4,3,1
2021,157535,41,0,32,15,17
2021,157535,41,1,20,10,10
2021,157535,41,2,12,5,7
2021,157535,42,0,75,32,43
2021,157535,42,1,10,5,5
2021,157535,42,2,21,8,13
2021,157535,42,3,40,16,24
2021,157535,42,4,4,3,1
2021,157535,44,0,32,15,17
2021,157535,44,1,20,10,10
2021,157535,44,2,12,5,7
2021,157553,0,0,83,38,45
2021,157553,10,0,83,38,45
2021,157553,10,1,42,18,24
2021,157553,10,2,18,9,9
2021,157553,10,3,6,2,4
2021,157553,10,4,16,8,8
2021,157553,10,5,1,1,0
2021,157553,20,0,17,8,9
2021,157553,20,1,16,7,9
2021,157553,20,2,1,1,0
2021,157553,40,0,66,30,36
2021,157553,40,1,26,11,15
2021,157553,40,2,17,8,9
2021,157553,40,3,6,2,4
2021,157553,40,4,16,8,8
2021,157553,40,5,1,1,0
2021,157553,42,0,6,1,5
2021,157553,42,1,5,1,4
2021,157553,42,3,1,0,1
2021,157553,43,0,60,29,31
2021,157553,43,1,21,10,11
2021,157553,43,2,17,8,9
2021,157553,43,3,5,2,3
2021,157553,43,4,16,8,8
2021,157553,43,5,1,1,0
2021,157711,0,0,136,54,82
2021,157711,10,0,136,54,82
2021,157711,10,1,41,12,29
2021,157711,10,2,45,21,24
2021,157711,10,3,13,3,10
2021,157711,10,4,37,18,19
2021,157711,20,0,32,13,19
2021,157711,20,1,23,8,15
2021,157711,20,2,9,5,4
2021,157711,30,0,2,0,2
2021,157711,30,1,1,0,1
2021,157711,30,2,1,0,1
2021,157711,40,0,102,41,61
2021,157711,40,1,17,4,13
2021,157711,40,2,35,16,19
2021,157711,40,3,13,3,10
2021,157711,40,4,37,18,19
2021,157711,42,0,8,3,5
2021,157711,42,1,1,0,1
2021,157711,42,2,3,1,2
2021,157711,42,4,4,2,2
2021,157711,43,0,94,38,56
2021,157711,43,1,16,4,12
2021,157711,43,2,32,15,17
2021,157711,43,3,13,3,10
2021,157711,43,4,33,16,17
2021,157739,0,0,64,31,33
2021,157739,10,0,64,31,33
2021,157739,10,1,29,20,9
2021,157739,10,2,15,6,9
2021,157739,10,3,8,1,7
2021,157739,10,4,12,4,8
2021,157739,20,0,23,17,6
2021,157739,20,1,18,15,3
2021,157739,20,2,5,2,3
2021,157739,30,0,2,1,1
2021,157739,30,2,2,1,1
2021,157739,40,0,39,13,26
2021,157739,40,1,11,5,6
2021,157739,40,2,8,3,5
2021,157739,40,3,8,1,7
2021,157739,40,4,12,4,8
2021,157739,42,0,9,6,3
2021,157739,42,1,2,2,0
2021,157739,42,3,3,1,2
2021,157739,42,4,4,3,1
2021,157739,43,0,30,7,23
2021,157739,43,1,9,3,6
2021,157739,43,2,8,3,5
2021,157739,43,3,5,0,5
2021,157739,43,4,8,1,7
2021,157748,0,0,42,40,2
2021,157748,10,0,42,40,2
2021,157748,10,1,23,22,1
2021,157748,10,2,15,14,1
2021,157748,10,3,4,4,0
2021,157748,40,0,42,40,2
2021,157748,40,1,23,22,1
2021,157748,40,2,15,14,1
2021,157748,40,3,4,4,0
2021,157748,41,0,42,40,2
2021,157748,41,1,23,22,1
2021,157748,41,2,15,14,1
2021,157748,41,3,4,4,0
2021,157748,44,0,42,40,2
2021,157748,44,1,23,22,1
2021,157748,44,2,15,14,1
2021,157748,44,3,4,4,0
2021,157757,0,0,95,34,61
2021,157757,10,0,95,34,61
2021,157757,10,1,25,8,17
2021,157757,10,2,25,7,18
2021,157757,10,3,42,18,24
2021,157757,10,5,1,1,0
2021,157757,10,6,2,0,2
2021,157757,20,0,38,14,24
2021,157757,20,1,22,8,14
2021,157757,20,2,14,4,10
2021,157757,20,3,2,2,0
2021,157757,30,0,30,12,18
2021,157757,30,1,3,0,3
2021,157757,30,2,8,2,6
2021,157757,30,3,19,10,9
2021,157757,40,0,27,8,19
2021,157757,40,2,3,1,2
2021,157757,40,3,21,6,15
2021,157757,40,5,1,1,0
2021,157757,40,6,2,0,2
2021,157757,42,0,7,1,6
2021,157757,42,3,6,1,5
2021,157757,42,6,1,0,1
2021,157757,43,0,20,7,13
2021,157757,43,2,3,1,2
2021,157757,43,3,15,5,10
2021,157757,43,5,1,1,0
2021,157757,43,6,1,0,1
2021,157793,0,0,126,50,76
2021,157793,10,0,126,50,76
2021,157793,10,1,30,18,12
2021,157793,10,2,30,13,17
2021,157793,10,3,16,5,11
2021,157793,10,4,49,13,36
2021,157793,10,5,1,1,0
2021,157793,40,0,126,50,76
2021,157793,40,1,30,18,12
2021,157793,40,2,30,13,17
2021,157793,40,3,16,5,11
2021,157793,40,4,49,13,36
2021,157793,40,5,1,1,0
2021,157793,42,0,126,50,76
2021,157793,42,1,30,18,12
2021,157793,42,2,30,13,17
2021,157793,42,3,16,5,11
2021,157793,42,4,49,13,36
2021,157793,42,5,1,1,0
2021,157809,0,0,83,43,40
2021,157809,10,0,83,43,40
2021,157809,10,1,28,18,10
2021,157809,10,2,25,11,14
2021,157809,10,3,29,14,15
2021,157809,10,4,1,0,1
2021,157809,20,0,43,25,18
2021,157809,20,1,27,17,10
2021,157809,20,2,15,7,8
2021,157809,20,3,1,1,0
2021,157809,30,0,9,3,6
2021,157809,30,2,5,1,4
2021,157809,30,3,4,2,2
2021,157809,40,0,31,15,16
2021,157809,40,1,1,1,0
2021,157809,40,2,5,3,2
2021,157809,40,3,24,11,13
2021,157809,40,4,1,0,1
2021,157809,42,0,31,15,16
2021,157809,42,1,1,1,0
2021,157809,42,2,5,3,2
2021,157809,42,3,24,11,13
2021,157809,42,4,1,0,1
2021,157818,0,0,87,46,41
2021,157818,10,0,87,46,41
2021,157818,10,1,37,25,12
2021,157818,10,2,30,12,18
2021,157818,10,3,13,4,9
2021,157818,10,4,7,5,2
2021,157818,20,0,66,37,29
2021,157818,20,1,37,25,12
2021,157818,20,2,29,12,17
2021,157818,30,0,8,3,5
2021,157818,30,2,1,0,1
2021,157818,30,3,7,3,4
2021,157818,40,0,13,6,7
2021,157818,40,3,6,1,5
2021,157818,40,4,7,5,2
2021,157818,41,0,11,5,6
2021,157818,41,3,5,1,4
2021,157818,41,4,6,4,2
2021,157818,42,0,2,1,1
2021,157818,42,3,1,0,1
2021,157818,42,4,1,1,0
2021,157818,44,0,9,3,6
2021,157818,44,3,5,1,4
2021,157818,44,4,4,2,2
2021,157818,45,0,2,2,0
2021,157818,45,4,2,2,0
2021,157863,0,0,49,25,24
2021,157863,10,0,49,25,24
2021,157863,10,1,13,9,4
2021,157863,10,2,17,10,7
2021,157863,10,3,16,5,11
2021,157863,10,4,3,1,2
2021,157863,20,0,19,14,5
2021,157863,20,1,11,8,3
2021,157863,20,2,8,6,2
2021,157863,30,0,18,7,11
2021,157863,30,1,2,1,1
2021,157863,30,2,6,3,3
2021,157863,30,3,10,3,7
2021,157863,40,0,12,4,8
2021,157863,40,2,3,1,2
2021,157863,40,3,6,2,4
2021,157863,40,4,3,1,2
2021,157863,42,0,2,0,2
2021,157863,42,2,1,0,1
2021,157863,42,3,1,0,1
2021,157863,43,0,10,4,6
2021,157863,43,2,2,1,1
2021,157863,43,3,5,2,3
2021,157863,43,4,3,1,2
2021,157951,0,0,647,311,336
2021,157951,10,0,647,311,336
2021,157951,10,1,173,112,61
2021,157951,10,2,207,90,117
2021,157951,10,3,131,60,71
2021,157951,10,4,127,44,83
2021,157951,10,6,9,5,4
2021,157951,20,0,368,196,172
2021,157951,20,1,173,112,61
2021,157951,20,2,192,83,109
2021,157951,20,3,3,1,2
2021,157951,30,0,131,61,70
2021,157951,30,2,7,4,3
2021,157951,30,3,124,57,67
2021,157951,40,0,148,54,94
2021,157951,40,2,8,3,5
2021,157951,40,3,4,2,2
2021,157951,40,4,127,44,83
2021,157951,40,6,9,5,4
2021,157951,41,0,113,39,74
2021,157951,41,2,8,3,5
2021,157951,41,3,4,2,2
2021,157951,41,4,99,32,67
2021,157951,41,6,2,2,0
2021,157951,42,0,35,15,20
2021,157951,42,4,28,12,16
2021,157951,42,6,7,3,4
2021,157951,44,0,113,39,74
2021,157951,44,2,8,3,5
2021,157951,44,3,4,2,2
2021,157951,44,4,99,32,67
2021,157951,44,6,2,2,0
2021,158088,0,0,66,29,37
2021,158088,10,0,66,29,37
2021,158088,10,1,1,1,0
2021,158088,10,4,64,28,36
2021,158088,10,6,1,0,1
2021,158088,20,0,1,1,0
2021,158088,20,1,1,1,0
2021,158088,40,0,65,28,37
2021,158088,40,4,64,28,36
2021,158088,40,6,1,0,1
2021,158088,42,0,58,27,31
2021,158088,42,4,58,27,31
2021,158088,43,0,7,1,6
2021,158088,43,4,6,1,5
2021,158088,43,6,1,0,1
2021,158431,0,0,115,34,81
2021,158431,10,0,115,34,81
2021,158431,10,1,29,6,23
2021,158431,10,2,15,7,8
2021,158431,10,3,22,3,19
2021,158431,10,4,43,17,26
2021,158431,10,6,6,1,5
2021,158431,20,0,13,4,9
2021,158431,20,1,13,4,9
2021,158431,30,0,1,0,1
2021,158431,30,2,1,0,1
2021,158431,40,0,101,30,71
2021,158431,40,1,16,2,14
2021,158431,40,2,14,7,7
2021,158431,40,3,22,3,19
2021,158431,40,4,43,17,26
2021,158431,40,6,6,1,5
2021,158431,42,0,101,30,71
2021,158431,42,1,16,2,14
2021,158431,42,2,14,7,7
2021,158431,42,3,22,3,19
2021,158431,42,4,43,17,26
2021,158431,42,6,6,1,5
2021,158477,0,0,54,28,26
2021,158477,10,0,54,28,26
2021,158477,10,1,18,12,6
2021,158477,10,2,9,2,7
2021,158477,10,3,22,12,10
2021,158477,10,6,5,2,3
2021,158477,20,0,27,14,13
2021,158477,20,1,18,12,6
2021,158477,20,2,9,2,7
2021,158477,30,0,22,12,10
2021,158477,30,3,22,12,10
2021,158477,40,0,5,2,3
2021,158477,40,6,5,2,3
2021,158477,42,0,5,2,3
2021,158477,42,6,5,2,3
2021,158662,0,0,301,104,197
2021,158662,10,0,301,104,197
2021,158662,10,1,92,29,63
2021,158662,10,2,68,25,43
2021,158662,10,3,51,21,30
2021,158662,10,4,87,29,58
2021,158662,10,6,3,0,3
2021,158662,20,0,14,3,11
2021,158662,20,1,12,2,10
2021,158662,20,2,1,1,0
2021,158662,20,3,1,0,1
2021,158662,30,0,9,3,6
2021,158662,30,1,9,3,6
2021,158662,40,0,278,98,180
2021,158662,40,1,71,24,47
2021,158662,40,2,67,24,43
2021,158662,40,3,50,21,29
2021,158662,40,4,87,29,58
2021,158662,40,6,3,0,3
2021,158662,42,0,269,96,173
2021,158662,42,1,71,24,47
2021,158662,42,2,67,24,43
2021,158662,42,3,50,21,29
2021,158662,42,4,78,27,51
2021,158662,42,6,3,0,3
2021,158662,43,0,9,2,7
2021,158662,43,4,9,2,7
2021,158802,0,0,68,34,34
2021,158802,10,0,68,34,34
2021,158802,10,1,9,6,3
2021,158802,10,2,17,11,6
2021,158802,10,3,32,14,18
2021,158802,10,4,10,3,7
2021,158802,20,0,26,17,9
2021,158802,20,1,8,5,3
2021,158802,20,2,17,11,6
2021,158802,20,3,1,1,0
2021,158802,30,0,7,2,5
2021,158802,30,3,7,2,5
2021,158802,40,0,35,15,20
2021,158802,40,1,1,1,0
2021,158802,40,3,24,11,13
2021,158802,40,4,10,3,7
2021,158802,42,0,35,15,20
2021,158802,42,1,1,1,0
2021,158802,42,3,24,11,13
2021,158802,42,4,10,3,7
2021,158884,0,0,36,21,15
2021,158884,10,0,36,21,15
2021,158884,10,1,5,3,2
2021,158884,10,2,4,2,2
2021,158884,10,3,6,4,2
2021,158884,10,4,18,10,8
2021,158884,10,6,3,2,1
2021,158884,40,0,36,21,15
2021,158884,40,1,5,3,2
2021,158884,40,2,4,2,2
2021,158884,40,3,6,4,2
2021,158884,40,4,18,10,8
2021,158884,40,6,3,2,1
2021,158884,42,0,33,20,13
2021,158884,42,1,5,3,2
2021,158884,42,2,4,2,2
2021,158884,42,3,6,4,2
2021,158884,42,4,17,10,7
2021,158884,42,6,1,1,0
2021,158884,43,0,3,1,2
2021,158884,43,4,1,0,1
2021,158884,43,6,2,1,1
2021,159009,0,0,156,83,73
2021,159009,10,0,105,60,45
2021,159009,10,1,31,22,9
2021,159009,10,2,29,15,14
2021,159009,10,3,32,16,16
2021,159009,10,4,3,2,1
2021,159009,10,5,7,4,3
2021,159009,10,6,3,1,2
2021,159009,20,0,74,46,28
2021,159009,20,1,31,22,9
2021,159009,20,2,26,14,12
2021,159009,20,3,16,10,6
2021,159009,20,6,1,0,1
2021,159009,30,0,16,5,11
2021,159009,30,2,2,1,1
2021,159009,30,3,14,4,10
2021,159009,40,0,15,9,6
2021,159009,40,2,1,0,1
2021,159009,40,3,2,2,0
2021,159009,40,4,3,2,1
2021,159009,40,5,7,4,3
2021,159009,40,6,2,1,1
2021,159009,41,0,13,8,5
2021,159009,41,2,1,0,1
2021,159009,41,3,2,2,0
2021,159009,41,4,3,2,1
2021,159009,41,5,7,4,3
2021,159009,42,0,2,1,1
2021,159009,42,6,2,1,1
2021,159009,45,0,13,8,5
2021,159009,45,2,1,0,1
2021,159009,45,3,2,2,0
2021,159009,45,4,3,2,1
2021,159009,45,5,7,4,3
2021,159009,50,0,51,23,28
2021,159197,0,0,24,20,4
2021,159197,10,0,24,20,4
2021,159197,10,4,24,20,4
2021,159197,40,0,24,20,4
2021,159197,40,4,24,20,4
2021,159197,41,0,24,20,4
2021,159197,41,4,24,20,4
2021,159197,45,0,24,20,4
2021,159197,45,4,24,20,4
2021,159373,0,0,758,389,369
2021,159373,10,0,758,389,369
2021,159373,10,1,128,95,33
2021,159373,10,2,219,119,100
2021,159373,10,3,332,153,179
2021,159373,10,4,79,22,57
2021,159373,20,0,100,71,29
2021,159373,20,1,70,51,19
2021,159373,20,2,30,20,10
2021,159373,30,0,32,22,10
2021,159373,30,1,7,6,1
2021,159373,30,2,9,6,3
2021,159373,30,3,16,10,6
2021,159373,40,0,626,296,330
2021,159373,40,1,51,38,13
2021,159373,40,2,180,93,87
2021,159373,40,3,316,143,173
2021,159373,40,4,79,22,57
2021,159373,42,0,626,296,330
2021,159373,42,1,51,38,13
2021,159373,42,2,180,93,87
2021,159373,42,3,316,143,173
2021,159373,42,4,79,22,57
2021,159382,0,0,87,39,48
2021,159382,10,0,87,39,48
2021,159382,10,1,20,14,6
2021,159382,10,2,22,5,17
2021,159382,10,3,29,11,18
2021,159382,10,4,16,9,7
2021,159382,20,0,43,20,23
2021,159382,20,1,20,14,6
2021,159382,20,2,22,5,17
2021,159382,20,4,1,1,0
2021,159382,30,0,29,11,18
2021,159382,30,3,29,11,18
2021,159382,40,0,15,8,7
2021,159382,40,4,15,8,7
2021,159382,42,0,15,8,7
2021,159382,42,4,15,8,7
2021,159391,0,0,1333,789,544
2021,159391,10,0,1333,789,544
2021,159391,10,1,403,301,102
2021,159391,10,2,316,194,122
2021,159391,10,3,290,151,139
2021,159391,10,4,289,116,173
2021,159391,10,5,35,27,8
2021,159391,20,0,685,480,205
2021,159391,20,1,393,295,98
2021,159391,20,2,292,185,107
2021,159391,30,0,251,146,105
2021,159391,30,2,7,4,3
2021,159391,30,3,244,142,102
2021,159391,40,0,397,163,234
2021,159391,40,1,10,6,4
2021,159391,40,2,17,5,12
2021,159391,40,3,46,9,37
2021,159391,40,4,289,116,173
2021,159391,40,5,35,27,8
2021,159391,42,0,397,163,234
2021,159391,42,1,10,6,4
2021,159391,42,2,17,5,12
2021,159391,42,3,46,9,37
2021,159391,42,4,289,116,173
2021,159391,42,5,35,27,8
2021,159407,0,0,69,26,43
2021,159407,10,0,69,26,43
2021,159407,10,1,14,9,5
2021,159407,10,2,4,2,2
2021,159407,10,3,18,7,11
2021,159407,10,4,33,8,25
2021,159407,20,0,18,11,7
2021,159407,20,1,13,9,4
2021,159407,20,2,4,2,2
2021,159407,20,3,1,0,1
2021,159407,30,0,15,6,9
2021,159407,30,3,15,6,9
2021,159407,40,0,36,9,27
2021,159407,40,1,1,0,1
2021,159407,40,3,2,1,1
2021,159407,40,4,33,8,25
2021,159407,42,0,36,9,27
2021,159407,42,1,1,0,1
2021,159407,42,3,2,1,1
2021,159407,42,4,33,8,25
2021,159416,0,0,160,91,69
2021,159416,10,0,160,91,69
2021,159416,10,1,41,26,15
2021,159416,10,2,25,13,12
2021,159416,10,3,51,31,20
2021,159416,10,4,27,9,18
2021,159416,10,5,16,12,4
2021,159416,20,0,55,36,19
2021,159416,20,1,40,26,14
2021,159416,20,2,15,10,5
2021,159416,30,0,58,33,25
2021,159416,30,2,9,3,6
2021,159416,30,3,49,30,19
2021,159416,40,0,47,22,25
2021,159416,40,1,1,0,1
2021,159416,40,2,1,0,1
2021,159416,40,3,2,1,1
2021,159416,40,4,27,9,18
2021,159416,40,5,16,12,4
2021,159416,42,0,47,22,25
2021,159416,42,1,1,0,1
2021,159416,42,2,1,0,1
2021,159416,42,3,2,1,1
2021,159416,42,4,27,9,18
2021,159416,42,5,16,12,4
2021,159568,0,0,68,30,38
2021,159568,10,0,68,30,38
2021,159568,10,1,19,10,9
2021,159568,10,2,20,9,11
2021,159568,10,3,26,11,15
2021,159568,10,5,1,0,1
2021,159568,10,6,2,0,2
2021,159568,20,0,32,13,19
2021,159568,20,1,16,7,9
2021,159568,20,2,15,6,9
2021,159568,20,3,1,0,1
2021,159568,30,0,31,17,14
2021,159568,30,1,3,3,0
2021,159568,30,2,5,3,2
2021,159568,30,3,23,11,12
2021,159568,40,0,5,0,5
2021,159568,40,3,2,0,2
2021,159568,40,5,1,0,1
2021,159568,40,6,2,0,2
2021,159568,42,0,5,0,5
2021,159568,42,3,2,0,2
2021,159568,42,5,1,0,1
2021,159568,42,6,2,0,2
2021,159647,0,0,380,236,144
2021,159647,10,0,371,230,141
2021,159647,10,1,71,49,22
2021,159647,10,2,102,67,35
2021,159647,10,3,92,50,42
2021,159647,10,4,60,26,34
2021,159647,10,5,46,38,8
2021,159647,20,0,171,113,58
2021,159647,20,1,70,48,22
2021,159647,20,2,96,62,34
2021,159647,20,3,5,3,2
2021,159647,30,0,92,51,41
2021,159647,30,1,1,1,0
2021,159647,30,2,6,5,1
2021,159647,30,3,85,45,40
2021,159647,40,0,108,66,42
2021,159647,40,3,2,2,0
2021,159647,40,4,60,26,34
2021,159647,40,5,46,38,8
2021,159647,42,0,108,66,42
2021,159647,42,3,2,2,0
2021,159647,42,4,60,26,34
2021,159647,42,5,46,38,8
2021,159647,50,0,9,6,3
2021,159656,0,0,225,121,104
2021,159656,10,0,225,121,104
2021,159656,10,1,60,38,22
2021,159656,10,2,54,36,18
2021,159656,10,3,31,10,21
2021,159656,10,5,80,37,43
2021,159656,20,0,114,73,41
2021,159656,20,1,60,38,22
2021,159656,20,2,53,35,18
2021,159656,20,3,1,0,1
2021,159656,30,0,31,11,20
2021,159656,30,2,1,1,0
2021,159656,30,3,30,10,20
2021,159656,40,0,80,37,43
2021,159656,40,5,80,37,43
2021,159656,41,0,13,6,7
2021,159656,41,5,13,6,7
2021,159656,42,0,67,31,36
2021,159656,42,5,67,31,36
2021,159656,44,0,13,6,7
2021,159656,44,5,13,6,7
2021,159717,0,0,246,117,129
2021,159717,10,0,246,117,129
2021,159717,10,1,48,35,13
2021,159717,10,2,45,23,22
2021,159717,10,3,111,46,65
2021,159717,10,4,42,13,29
2021,159717,20,0,117,68,49
2021,159717,20,1,48,35,13
2021,159717,20,2,41,20,21
2021,159717,20,3,28,13,15
2021,159717,30,0,74,32,42
2021,159717,30,2,4,3,1
2021,159717,30,3,70,29,41
2021,159717,40,0,55,17,38
2021,159717,40,3,13,4,9
2021,159717,40,4,42,13,29
2021,159717,42,0,55,17,38
2021,159717,42,3,13,4,9
2021,159717,42,4,42,13,29
2021,159939,0,0,271,166,105
2021,159939,10,0,271,166,105
2021,159939,10,1,86,66,20
2021,159939,10,2,57,38,19
2021,159939,10,3,58,37,21
2021,159939,10,6,70,25,45
2021,159939,20,0,140,102,38
2021,159939,20,1,84,64,20
2021,159939,20,2,56,38,18
2021,159939,30,0,55,36,19
2021,159939,30,1,1,1,0
2021,159939,30,2,1,0,1
2021,159939,30,3,53,35,18
2021,159939,40,0,76,28,48
2021,159939,40,1,1,1,0
2021,159939,40,3,5,2,3
2021,159939,40,6,70,25,45
2021,159939,42,0,76,28,48
2021,159939,42,1,1,1,0
2021,159939,42,3,5,2,3
2021,159939,42,6,70,25,45
2021,159948,0,0,57,49,8
2021,159948,10,0,57,49,8
2021,159948,10,1,37,32,5
2021,159948,10,2,12,11,1
2021,159948,10,3,8,6,2
2021,159948,20,0,39,33,6
2021,159948,20,1,35,30,5
2021,159948,20,2,4,3,1
2021,159948,30,0,18,16,2
2021,159948,30,1,2,2,0
2021,159948,30,2,8,8,0
2021,159948,30,3,8,6,2
2021,159966,0,0,267,111,156
2021,159966,10,0,267,111,156
2021,159966,10,1,39,22,17
2021,159966,10,2,47,30,17
2021,159966,10,3,97,37,60
2021,159966,10,4,83,21,62
2021,159966,10,5,1,1,0
2021,159966,20,0,100,56,44
2021,159966,20,1,38,21,17
2021,159966,20,2,47,30,17
2021,159966,20,3,15,5,10
2021,159966,30,0,81,33,48
2021,159966,30,1,1,1,0
2021,159966,30,3,80,32,48
2021,159966,40,0,86,22,64
2021,159966,40,3,2,0,2
2021,159966,40,4,83,21,62
2021,159966,40,5,1,1,0
2021,159966,42,0,86,22,64
2021,159966,42,3,2,0,2
2021,159966,42,4,83,21,62
2021,159966,42,5,1,1,0
2021,159993,0,0,328,140,188
2021,159993,10,0,325,138,187
2021,159993,10,1,67,38,29
2021,159993,10,2,71,37,34
2021,159993,10,3,120,39,81
2021,159993,10,4,67,24,43
2021,159993,20,0,115,61,54
2021,159993,20,1,57,36,21
2021,159993,20,2,48,25,23
2021,159993,20,3,10,0,10
2021,159993,30,0,106,45,61
2021,159993,30,1,1,0,1
2021,159993,30,2,18,9,9
2021,159993,30,3,86,36,50
2021,159993,30,4,1,0,1
2021,159993,40,0,104,32,72
2021,159993,40,1,9,2,7
2021,159993,40,2,5,3,2
2021,159993,40,3,24,3,21
2021,159993,40,4,66,24,42
2021,159993,42,0,27,9,18
2021,159993,42,1,9,2,7
2021,159993,42,2,4,2,2
2021,159993,42,3,8,1,7
2021,159993,42,4,6,4,2
2021,159993,43,0,77,23,54
2021,159993,43,2,1,1,0
2021,159993,43,3,16,2,14
2021,159993,43,4,60,20,40
2021,159993,50,0,3,2,1
2021,160010,0,0,30,20,10
2021,160010,10,0,30,20,10
2021,160010,10,2,1,1,0
2021,160010,10,4,29,19,10
2021,160010,40,0,30,20,10
2021,160010,40,2,1,1,0
2021,160010,40,4,29,19,10
2021,160010,42,0,30,20,10
2021,160010,42,2,1,1,0
2021,160010,42,4,29,19,10
2021,160038,0,0,321,120,201
2021,160038,10,0,321,120,201
2021,160038,10,1,61,30,31
2021,160038,10,2,74,38,36
2021,160038,10,3,140,44,96
2021,160038,10,4,46,8,38
2021,160038,20,0,153,73,80
2021,160038,20,1,59,29,30
2021,160038,20,2,67,37,30
2021,160038,20,3,27,7,20
2021,160038,30,0,101,34,67
2021,160038,30,1,1,0,1
2021,160038,30,2,5,1,4
2021,160038,30,3,94,33,61
2021,160038,30,4,1,0,1
2021,160038,40,0,67,13,54
2021,160038,40,1,1,1,0
2021,160038,40,2,2,0,2
2021,160038,40,3,19,4,15
2021,160038,40,4,45,8,37
2021,160038,42,0,12,1,11
2021,160038,42,2,1,0,1
2021,160038,42,3,2,0,2
2021,160038,42,4,9,1,8
2021,160038,43,0,55,12,43
2021,160038,43,1,1,1,0
2021,160038,43,2,1,0,1
2021,160038,43,3,17,4,13
2021,160038,43,4,36,7,29
2021,160065,0,0,69,25,44
2021,160065,10,0,69,25,44
2021,160065,10,1,15,7,8
2021,160065,10,2,20,7,13
2021,160065,10,3,31,9,22
2021,160065,10,4,3,2,1
2021,160065,40,0,69,25,44
2021,160065,40,1,15,7,8
2021,160065,40,2,20,7,13
2021,160065,40,3,31,9,22
2021,160065,40,4,3,2,1
2021,160065,41,0,60,22,38
2021,160065,41,1,14,7,7
2021,160065,41,2,17,6,11
2021,160065,41,3,29,9,20
2021,160065,42,0,9,3,6
2021,160065,42,1,1,0,1
2021,160065,42,2,3,1,2
2021,160065,42,3,2,0,2
2021,160065,42,4,3,2,1
2021,160065,44,0,60,22,38
2021,160065,44,1,14,7,7
2021,160065,44,2,17,6,11
2021,160065,44,3,29,9,20
2021,160074,0,0,89,26,63
2021,160074,10,0,89,26,63
2021,160074,10,1,4,2,2
2021,160074,10,2,19,10,9
2021,160074,10,3,50,11,39
2021,160074,10,4,16,3,13
2021,160074,40,0,89,26,63
2021,160074,40,1,4,2,2
2021,160074,40,2,19,10,9
2021,160074,40,3,50,11,39
2021,160074,40,4,16,3,13
2021,160074,42,0,89,26,63
2021,160074,42,1,4,2,2
2021,160074,42,2,19,10,9
2021,160074,42,3,50,11,39
2021,160074,42,4,16,3,13
2021,160409,0,0,19,17,2
2021,160409,10,0,17,15,2
2021,160409,10,1,17,15,2
2021,160409,40,0,17,15,2
2021,160409,40,1,17,15,2
2021,160409,42,0,17,15,2
2021,160409,42,1,17,15,2
2021,160409,50,0,2,2,0
2021,160481,0,0,60,24,36
2021,160481,10,0,60,24,36
2021,160481,10,1,1,0,1
2021,160481,10,2,3,0,3
2021,160481,10,3,7,3,4
2021,160481,10,4,48,21,27
2021,160481,10,5,1,0,1
2021,160481,20,0,2,2,0
2021,160481,20,4,2,2,0
2021,160481,40,0,58,22,36
2021,160481,40,1,1,0,1
2021,160481,40,2,3,0,3
2021,160481,40,3,7,3,4
2021,160481,40,4,46,19,27
2021,160481,40,5,1,0,1
2021,160481,41,0,1,0,1
2021,160481,41,4,1,0,1
2021,160481,42,0,57,22,35
2021,160481,42,1,1,0,1
2021,160481,42,2,3,0,3
2021,160481,42,3,7,3,4
2021,160481,42,4,45,19,26
2021,160481,42,5,1,0,1
2021,160481,44,0,1,0,1
2021,160481,44,4,1,0,1
2021,160524,0,0,5,2,3
2021,160524,50,0,5,2,3
2021,160579,0,0,95,42,53
2021,160579,10,0,95,42,53
2021,160579,10,1,5,2,3
2021,160579,10,2,4,2,2
2021,160579,10,3,16,3,13
2021,160579,10,4,66,33,33
2021,160579,10,6,4,2,2
2021,160579,20,0,4,2,2
2021,160579,20,1,1,0,1
2021,160579,20,4,3,2,1
2021,160579,40,0,91,40,51
2021,160579,40,1,4,2,2
2021,160579,40,2,4,2,2
2021,160579,40,3,16,3,13
2021,160579,40,4,63,31,32
2021,160579,40,6,4,2,2
2021,160579,42,0,91,40,51
2021,160579,42,1,4,2,2
2021,160579,42,2,4,2,2
2021,160579,42,3,16,3,13
2021,160579,42,4,63,31,32
2021,160579,42,6,4,2,2
2021,160612,0,0,505,224,281
2021,160612,10,0,505,224,281
2021,160612,10,1,93,68,25
2021,160612,10,2,80,41,39
2021,160612,10,3,83,37,46
2021,160612,10,4,249,78,171
2021,160612,20,0,170,106,64
2021,160612,20,1,93,68,25
2021,160612,20,2,72,36,36
2021,160612,20,3,5,2,3
2021,160612,30,0,82,37,45
2021,160612,30,2,8,5,3
2021,160612,30,3,74,32,42
2021,160612,40,0,253,81,172
2021,160612,40,3,4,3,1
2021,160612,40,4,249,78,171
2021,160612,42,0,252,81,171
2021,160612,42,3,4,3,1
2021,160612,42,4,248,78,170
2021,160612,43,0,1,0,1
2021,160612,43,4,1,0,1
2021,160621,0,0,316,149,167
2021,160621,10,0,213,110,103
2021,160621,10,1,59,44,15
2021,160621,10,2,50,28,22
2021,160621,10,3,102,37,65
2021,160621,10,4,2,1,1
2021,160621,20,0,83,58,25
2021,160621,20,1,55,42,13
2021,160621,20,2,21,14,7
2021,160621,20,3,7,2,5
2021,160621,30,0,82,32,50
2021,160621,30,1,3,2,1
2021,160621,30,2,16,5,11
2021,160621,30,3,63,25,38
2021,160621,40,0,48,20,28
2021,160621,40,1,1,0,1
2021,160621,40,2,13,9,4
2021,160621,40,3,32,10,22
2021,160621,40,4,2,1,1
2021,160621,42,0,48,20,28
2021,160621,42,1,1,0,1
2021,160621,42,2,13,9,4
2021,160621,42,3,32,10,22
2021,160621,42,4,2,1,1
2021,160621,50,0,103,39,64
2021,160630,0,0,80,51,29
2021,160630,10,0,80,51,29
2021,160630,10,1,21,17,4
2021,160630,10,2,26,19,7
2021,160630,10,3,33,15,18
2021,160630,20,0,49,36,13
2021,160630,20,1,21,17,4
2021,160630,20,2,20,14,6
2021,160630,20,3,8,5,3
2021,160630,30,0,30,15,15
2021,160630,30,2,6,5,1
2021,160630,30,3,24,10,14
2021,160630,40,0,1,0,1
2021,160630,40,3,1,0,1
2021,160630,41,0,1,0,1
2021,160630,41,3,1,0,1
2021,160630,45,0,1,0,1
2021,160630,45,3,1,0,1
2021,160649,0,0,79,31,48
2021,160649,10,0,75,28,47
2021,160649,10,1,4,2,2
2021,160649,10,2,11,5,6
2021,160649,10,3,19,6,13
2021,160649,10,4,41,15,26
2021,160649,20,0,14,6,8
2021,160649,20,1,4,2,2
2021,160649,20,2,8,4,4
2021,160649,20,3,2,0,2
2021,160649,30,0,34,13,21
2021,160649,30,2,1,0,1
2021,160649,30,3,9,3,6
2021,160649,30,4,24,10,14
2021,160649,40,0,27,9,18
2021,160649,40,2,2,1,1
2021,160649,40,3,8,3,5
2021,160649,40,4,17,5,12
2021,160649,42,0,5,1,4
2021,160649,42,2,1,0,1
2021,160649,42,4,4,1,3
2021,160649,43,0,22,8,14
2021,160649,43,2,1,1,0
2021,160649,43,3,8,3,5
2021,160649,43,4,13,4,9
2021,160649,50,0,4,3,1
2021,160658,0,0,613,330,283
2021,160658,10,0,549,305,244
2021,160658,10,1,145,109,36
2021,160658,10,2,129,77,52
2021,160658,10,3,118,62,56
2021,160658,10,4,156,56,100
2021,160658,10,5,1,1,0
2021,160658,20,0,272,184,88
2021,160658,20,1,143,108,35
2021,160658,20,2,121,72,49
2021,160658,20,3,8,4,4
2021,160658,30,0,114,63,51
2021,160658,30,1,2,1,1
2021,160658,30,2,8,5,3
2021,160658,30,3,104,57,47
2021,160658,40,0,163,58,105
2021,160658,40,3,6,1,5
2021,160658,40,4,156,56,100
2021,160658,40,5,1,1,0
2021,160658,41,0,163,58,105
2021,160658,41,3,6,1,5
2021,160658,41,4,156,56,100
2021,160658,41,5,1,1,0
2021,160658,44,0,163,58,105
2021,160658,44,3,6,1,5
2021,160658,44,4,156,56,100
2021,160658,44,5,1,1,0
2021,160658,50,0,64,25,39
2021,160667,0,0,91,40,51
2021,160667,10,0,91,40,51
2021,160667,10,2,5,1,4
2021,160667,10,3,6,1,5
2021,160667,10,4,80,38,42
2021,160667,40,0,91,40,51
2021,160667,40,2,5,1,4
2021,160667,40,3,6,1,5
2021,160667,40,4,80,38,42
2021,160667,42,0,89,38,51
2021,160667,42,2,5,1,4
2021,160667,42,3,6,1,5
2021,160667,42,4,78,36,42
2021,160667,43,0,2,2,0
2021,160667,43,4,2,2,0
2021,160755,0,0,1508,838,670
2021,160755,10,0,1508,838,670
2021,160755,10,1,342,261,81
2021,160755,10,2,317,171,146
2021,160755,10,3,545,275,270
2021,160755,10,4,86,28,58
2021,160755,10,5,218,103,115
2021,160755,20,0,492,334,158
2021,160755,20,1,281,215,66
2021,160755,20,2,211,119,92
2021,160755,30,0,177,95,82
2021,160755,30,1,8,6,2
2021,160755,30,2,9,6,3
2021,160755,30,3,160,83,77
2021,160755,40,0,839,409,430
2021,160755,40,1,53,40,13
2021,160755,40,2,97,46,51
2021,160755,40,3,385,192,193
2021,160755,40,4,86,28,58
2021,160755,40,5,218,103,115
2021,160755,42,0,839,409,430
2021,160755,42,1,53,40,13
2021,160755,42,2,97,46,51
2021,160755,42,3,385,192,193
2021,160755,42,4,86,28,58
2021,160755,42,5,218,103,115
2021,160904,0,0,245,132,113
2021,160904,10,0,245,132,113
2021,160904,10,1,54,32,22
2021,160904,10,2,71,41,30
2021,160904,10,3,104,51,53
2021,160904,10,4,5,2,3
2021,160904,10,5,11,6,5
2021,160904,20,0,122,78,44
2021,160904,20,1,46,28,18
2021,160904,20,2,58,37,21
2021,160904,20,3,18,13,5
2021,160904,30,0,52,25,27
2021,160904,30,1,1,0,1
2021,160904,30,2,3,1,2
2021,160904,30,3,48,24,24
2021,160904,40,0,71,29,42
2021,160904,40,1,7,4,3
2021,160904,40,2,10,3,7
2021,160904,40,3,38,14,24
2021,160904,40,4,5,2,3
2021,160904,40,5,11,6,5
2021,160904,42,0,71,29,42
2021,160904,42,1,7,4,3
2021,160904,42,2,10,3,7
2021,160904,42,3,38,14,24
2021,160904,42,4,5,2,3
2021,160904,42,5,11,6,5
2021,160959,0,0,26,13,13
2021,160959,10,0,26,13,13
2021,160959,10,1,26,13,13
2021,160959,40,0,26,13,13
2021,160959,40,1,26,13,13
2021,160959,41,0,26,13,13
2021,160959,41,1,26,13,13
2021,160959,44,0,26,13,13
2021,160959,44,1,26,13,13
2021,160977,0,0,184,78,106
2021,160977,10,0,184,78,106
2021,160977,10,1,49,22,27
2021,160977,10,2,44,21,23
2021,160977,10,3,76,31,45
2021,160977,10,4,3,1,2
2021,160977,10,5,12,3,9
2021,160977,20,0,92,43,49
2021,160977,20,1,49,22,27
2021,160977,20,2,43,21,22
2021,160977,30,0,37,18,19
2021,160977,30,3,37,18,19
2021,160977,40,0,55,17,38
2021,160977,40,2,1,0,1
2021,160977,40,3,39,13,26
2021,160977,40,4,3,1,2
2021,160977,40,5,12,3,9
2021,160977,41,0,28,5,23
2021,160977,41,2,1,0,1
2021,160977,41,3,14,3,11
2021,160977,41,4,2,0,2
2021,160977,41,5,11,2,9
2021,160977,42,0,27,12,15
2021,160977,42,3,25,10,15
2021,160977,42,4,1,1,0
2021,160977,42,5,1,1,0
2021,160977,44,0,28,5,23
2021,160977,44,2,1,0,1
2021,160977,44,3,14,3,11
2021,160977,44,4,2,0,2
2021,160977,44,5,11,2,9
2021,160995,0,0,13,5,8
2021,160995,50,0,13,5,8
2021,161004,0,0,223,105,118
2021,161004,10,0,223,105,118
2021,161004,10,1,68,33,35
2021,161004,10,2,57,24,33
2021,161004,10,3,70,32,38
2021,161004,10,4,1,0,1
2021,161004,10,5,27,16,11
2021,161004,20,0,124,57,67
2021,161004,20,1,67,33,34
2021,161004,20,2,57,24,33
2021,161004,30,0,47,19,28
2021,161004,30,3,47,19,28
2021,161004,40,0,52,29,23
2021,161004,40,1,1,0,1
2021,161004,40,3,23,13,10
2021,161004,40,4,1,0,1
2021,161004,40,5,27,16,11
2021,161004,41,0,30,16,14
2021,161004,41,3,7,3,4
2021,161004,41,5,23,13,10
2021,161004,42,0,21,12,9
2021,161004,42,1,1,0,1
2021,161004,42,3,16,10,6
2021,161004,42,4,1,0,1
2021,161004,42,5,3,2,1
2021,161004,43,0,1,1,0
2021,161004,43,5,1,1,0
2021,161004,44,0,30,16,14
2021,161004,44,3,7,3,4
2021,161004,44,5,23,13,10
2021,161022,0,0,12,0,12
2021,161022,10,0,10,0,10
2021,161022,10,2,4,0,4
2021,161022,10,3,2,0,2
2021,161022,10,4,4,0,4
2021,161022,40,0,10,0,10
2021,161022,40,2,4,0,4
2021,161022,40,3,2,0,2
2021,161022,40,4,4,0,4
2021,161022,41,0,7,0,7
2021,161022,41,2,4,0,4
2021,161022,41,3,1,0,1
2021,161022,41,4,2,0,2
2021,161022,42,0,1,0,1
2021,161022,42,3,1,0,1
2021,161022,43,0,2,0,2
2021,161022,43,4,2,0,2
2021,161022,44,0,7,0,7
2021,161022,44,2,4,0,4
2021,161022,44,3,1,0,1
2021,161022,44,4,2,0,2
2021,161022,50,0,2,0,2
2021,161077,0,0,53,32,21
2021,161077,10,0,53,32,21
2021,161077,10,4,53,32,21
2021,161077,40,0,53,32,21
2021,161077,40,4,53,32,21
2021,161077,42,0,53,32,21
2021,161077,42,4,53,32,21
2021,161086,0,0,251,119,132
2021,161086,10,0,251,119,132
2021,161086,10,1,62,37,25
2021,161086,10,2,66,33,33
2021,161086,10,3,71,26,45
2021,161086,10,4,48,22,26
2021,161086,10,5,4,1,3
2021,161086,20,0,121,66,55
2021,161086,20,1,61,37,24
2021,161086,20,2,60,29,31
2021,161086,30,0,62,25,37
2021,161086,30,3,62,25,37
2021,161086,40,0,68,28,40
2021,161086,40,1,1,0,1
2021,161086,40,2,6,4,2
2021,161086,40,3,9,1,8
2021,161086,40,4,48,22,26
2021,161086,40,5,4,1,3
2021,161086,41,0,37,11,26
2021,161086,41,1,1,0,1
2021,161086,41,2,6,4,2
2021,161086,41,3,9,1,8
2021,161086,41,4,18,5,13
2021,161086,41,5,3,1,2
2021,161086,42,0,30,17,13
2021,161086,42,4,30,17,13
2021,161086,43,0,1,0,1
2021,161086,43,5,1,0,1
2021,161086,44,0,37,11,26
2021,161086,44,1,1,0,1
2021,161086,44,2,6,4,2
2021,161086,44,3,9,1,8
2021,161086,44,4,18,5,13
2021,161086,44,5,3,1,2
2021,161138,0,0,61,32,29
2021,161138,10,0,61,32,29
2021,161138,10,4,61,32,29
2021,161138,40,0,61,32,29
2021,161138,40,4,61,32,29
2021,161138,42,0,61,32,29
2021,161138,42,4,61,32,29
2021,161192,0,0,47,20,27
2021,161192,10,0,47,20,27
2021,161192,10,4,47,20,27
2021,161192,40,0,47,20,27
2021,161192,40,4,47,20,27
2021,161192,42,0,47,20,27
2021,161192,42,4,47,20,27
2021,161208,0,0,8,8,0
2021,161208,10,0,8,8,0
2021,161208,10,4,8,8,0
2021,161208,40,0,8,8,0
2021,161208,40,4,8,8,0
2021,161208,42,0,8,8,0
2021,161208,42,4,8,8,0
2021,161217,0,0,97,35,62
2021,161217,10,0,97,35,62
2021,161217,10,1,23,13,10
2021,161217,10,2,24,9,15
2021,161217,10,3,31,9,22
2021,161217,10,4,1,0,1
2021,161217,10,5,18,4,14
2021,161217,20,0,47,22,25
2021,161217,20,1,23,13,10
2021,161217,20,2,24,9,15
2021,161217,30,0,31,9,22
2021,161217,30,3,31,9,22
2021,161217,40,0,19,4,15
2021,161217,40,4,1,0,1
2021,161217,40,5,18,4,14
2021,161217,41,0,7,1,6
2021,161217,41,4,1,0,1
2021,161217,41,5,6,1,5
2021,161217,42,0,11,3,8
2021,161217,42,5,11,3,8
2021,161217,43,0,1,0,1
2021,161217,43,5,1,0,1
2021,161217,44,0,7,1,6
2021,161217,44,4,1,0,1
2021,161217,44,5,6,1,5
2021,161226,0,0,110,46,64
2021,161226,10,0,110,46,64
2021,161226,10,1,35,20,15
2021,161226,10,2,43,16,27
2021,161226,10,3,23,10,13
2021,161226,10,4,1,0,1
2021,161226,10,5,8,0,8
2021,161226,20,0,77,36,41
2021,161226,20,1,35,20,15
2021,161226,20,2,42,16,26
2021,161226,30,0,20,8,12
2021,161226,30,2,1,0,1
2021,161226,30,3,19,8,11
2021,161226,40,0,13,2,11
2021,161226,40,3,4,2,2
2021,161226,40,4,1,0,1
2021,161226,40,5,8,0,8
2021,161226,41,0,9,1,8
2021,161226,41,3,2,1,1
2021,161226,41,4,1,0,1
2021,161226,41,5,6,0,6
2021,161226,42,0,2,0,2
2021,161226,42,5,2,0,2
2021,161226,43,0,2,1,1
2021,161226,43,3,2,1,1
2021,161226,44,0,9,1,8
2021,161226,44,3,2,1,1
2021,161226,44,4,1,0,1
2021,161226,44,5,6,0,6
2021,161235,0,0,28,14,14
2021,161235,10,0,28,14,14
2021,161235,10,1,6,4,2
2021,161235,10,2,4,3,1
2021,161235,10,3,13,5,8
2021,161235,10,4,1,1,0
2021,161235,10,5,4,1,3
2021,161235,20,0,10,7,3
2021,161235,20,1,6,4,2
2021,161235,20,2,4,3,1
2021,161235,30,0,11,5,6
2021,161235,30,3,11,5,6
2021,161235,40,0,7,2,5
2021,161235,40,3,2,0,2
2021,161235,40,4,1,1,0
2021,161235,40,5,4,1,3
2021,161235,41,0,1,1,0
2021,161235,41,5,1,1,0
2021,161235,42,0,6,1,5
2021,161235,42,3,2,0,2
2021,161235,42,4,1,1,0
2021,161235,42,5,3,0,3
2021,161235,44,0,1,1,0
2021,161235,44,5,1,1,0
2021,161253,0,0,547,318,229
2021,161253,10,0,547,318,229
2021,161253,10,1,178,126,52
2021,161253,10,2,146,87,59
2021,161253,10,3,128,64,64
2021,161253,10,4,4,1,3
2021,161253,10,5,91,40,51
2021,161253,20,0,312,205,107
2021,161253,20,1,175,123,52
2021,161253,20,2,137,82,55
2021,161253,30,0,130,65,65
2021,161253,30,2,9,5,4
2021,161253,30,3,120,59,61
2021,161253,30,4,1,1,0
2021,161253,40,0,105,48,57
2021,161253,40,1,3,3,0
2021,161253,40,3,8,5,3
2021,161253,40,4,3,0,3
2021,161253,40,5,91,40,51
2021,161253,41,0,46,17,29
2021,161253,41,1,3,3,0
2021,161253,41,4,3,0,3
2021,161253,41,5,40,14,26
2021,161253,42,0,59,31,28
2021,161253,42,3,8,5,3
2021,161253,42,5,51,26,25
2021,161253,44,0,43,15,28
2021,161253,44,1,1,1,0
2021,161253,44,4,3,0,3
2021,161253,44,5,39,14,25
2021,161253,45,0,3,2,1
2021,161253,45,1,2,2,0
2021,161253,45,5,1,0,1
2021,161299,0,0,75,57,18
2021,161299,10,0,75,57,18
2021,161299,10,1,18,12,6
2021,161299,10,2,15,14,1
2021,161299,10,3,30,21,9
2021,161299,10,4,8,7,1
2021,161299,10,5,1,1,0
2021,161299,10,6,3,2,1
2021,161299,40,0,75,57,18
2021,161299,40,1,18,12,6
2021,161299,40,2,15,14,1
2021,161299,40,3,30,21,9
2021,161299,40,4,8,7,1
2021,161299,40,5,1,1,0
2021,161299,40,6,3,2,1
2021,161299,41,0,72,55,17
2021,161299,41,1,18,12,6
2021,161299,41,2,15,14,1
2021,161299,41,3,30,21,9
2021,161299,41,4,8,7,1
2021,161299,41,5,1,1,0
2021,161299,42,0,3,2,1
2021,161299,42,6,3,2,1
2021,161299,45,0,72,55,17
2021,161299,45,1,18,12,6
2021,161299,45,2,15,14,1
2021,161299,45,3,30,21,9
2021,161299,45,4,8,7,1
2021,161299,45,5,1,1,0
2021,161341,0,0,35,20,15
2021,161341,10,0,35,20,15
2021,161341,10,1,12,8,4
2021,161341,10,2,14,7,7
2021,161341,10,3,7,4,3
2021,161341,10,4,1,0,1
2021,161341,10,5,1,1,0
2021,161341,20,0,25,14,11
2021,161341,20,1,12,8,4
2021,161341,20,2,13,6,7
2021,161341,30,0,9,5,4
2021,161341,30,2,1,1,0
2021,161341,30,3,7,4,3
2021,161341,30,4,1,0,1
2021,161341,40,0,1,1,0
2021,161341,40,5,1,1,0
2021,161341,41,0,1,1,0
2021,161341,41,5,1,1,0
2021,161341,44,0,1,1,0
2021,161341,44,5,1,1,0
2021,161457,0,0,285,129,156
2021,161457,10,0,285,129,156
2021,161457,10,1,53,35,18
2021,161457,10,2,94,39,55
2021,161457,10,3,85,26,59
2021,161457,10,4,1,0,1
2021,161457,10,5,52,29,23
2021,161457,20,0,90,50,40
2021,161457,20,1,41,28,13
2021,161457,20,2,49,22,27
2021,161457,30,0,21,9,12
2021,161457,30,2,6,3,3
2021,161457,30,3,15,6,9
2021,161457,40,0,174,70,104
2021,161457,40,1,12,7,5
2021,161457,40,2,39,14,25
2021,161457,40,3,70,20,50
2021,161457,40,4,1,0,1
2021,161457,40,5,52,29,23
2021,161457,42,0,174,70,104
2021,161457,42,1,12,7,5
2021,161457,42,2,39,14,25
2021,161457,42,3,70,20,50
2021,161457,42,4,1,0,1
2021,161457,42,5,52,29,23
2021,161484,0,0,38,22,16
2021,161484,10,0,37,21,16
2021,161484,10,4,37,21,16
2021,161484,40,0,37,21,16
2021,161484,40,4,37,21,16
2021,161484,42,0,37,21,16
2021,161484,42,4,37,21,16
2021,161484,50,0,1,1,0
2021,161509,0,0,29,18,11
2021,161509,10,0,29,18,11
2021,161509,10,1,13,6,7
2021,161509,10,2,5,5,0
2021,161509,10,3,11,7,4
2021,161509,40,0,29,18,11
2021,161509,40,1,13,6,7
2021,161509,40,2,5,5,0
2021,161509,40,3,11,7,4
2021,161509,41,0,25,15,10
2021,161509,41,1,13,6,7
2021,161509,41,2,5,5,0
2021,161509,41,3,7,4,3
2021,161509,42,0,4,3,1
2021,161509,42,3,4,3,1
2021,161509,44,0,25,15,10
2021,161509,44,1,13,6,7
2021,161509,44,2,5,5,0
2021,161509,44,3,7,4,3
2021,161518,0,0,62,28,34
2021,161518,10,0,62,28,34
2021,161518,10,1,8,5,3
2021,161518,10,2,17,10,7
2021,161518,10,3,30,12,18
2021,161518,10,4,7,1,6
2021,161518,20,0,18,13,5
2021,161518,20,1,7,4,3
2021,161518,20,2,10,8,2
2021,161518,20,3,1,1,0
2021,161518,30,0,19,10,9
2021,161518,30,1,1,1,0
2021,161518,30,2,5,2,3
2021,161518,30,3,13,7,6
2021,161518,40,0,25,5,20
2021,161518,40,2,2,0,2
2021,161518,40,3,16,4,12
2021,161518,40,4,7,1,6
2021,161518,42,0,11,1,10
2021,161518,42,2,2,0,2
2021,161518,42,3,6,1,5
2021,161518,42,4,3,0,3
2021,161518,43,0,14,4,10
2021,161518,43,3,10,3,7
2021,161518,43,4,4,1,3
2021,161545,0,0,100,52,48
2021,161545,10,0,100,52,48
2021,161545,10,1,42,26,16
2021,161545,10,2,21,11,10
2021,161545,10,3,13,5,8
2021,161545,10,4,24,10,14
2021,161545,40,0,100,52,48
2021,161545,40,1,42,26,16
2021,161545,40,2,21,11,10
2021,161545,40,3,13,5,8
2021,161545,40,4,24,10,14
2021,161545,42,0,100,52,48
2021,161545,42,1,42,26,16
2021,161545,42,2,21,11,10
2021,161545,42,3,13,5,8
2021,161545,42,4,24,10,14
2021,161554,0,0,286,135,151
2021,161554,10,0,286,135,151
2021,161554,10,1,82,51,31
2021,161554,10,2,65,32,33
2021,161554,10,3,89,36,53
2021,161554,10,4,1,0,1
2021,161554,10,5,49,16,33
2021,161554,20,0,134,78,56
2021,161554,20,1,73,48,25
2021,161554,20,2,60,29,31
2021,161554,20,3,1,1,0
2021,161554,30,0,91,37,54
2021,161554,30,2,3,2,1
2021,161554,30,3,88,35,53
2021,161554,40,0,61,20,41
2021,161554,40,1,9,3,6
2021,161554,40,2,2,1,1
2021,161554,40,4,1,0,1
2021,161554,40,5,49,16,33
2021,161554,41,0,23,7,16
2021,161554,41,1,6,2,4
2021,161554,41,2,2,1,1
2021,161554,41,4,1,0,1
2021,161554,41,5,14,4,10
2021,161554,42,0,38,13,25
2021,161554,42,1,3,1,2
2021,161554,42,5,35,12,23
2021,161554,44,0,21,5,16
2021,161554,44,1,5,1,4
2021,161554,44,2,1,0,1
2021,161554,44,4,1,0,1
2021,161554,44,5,14,4,10
2021,161554,45,0,2,2,0
2021,161554,45,1,1,1,0
2021,161554,45,2,1,1,0
2021,161563,0,0,33,22,11
2021,161563,10,0,33,22,11
2021,161563,10,1,12,9,3
2021,161563,10,2,10,6,4
2021,161563,10,3,10,6,4
2021,161563,10,4,1,1,0
2021,161563,40,0,33,22,11
2021,161563,40,1,12,9,3
2021,161563,40,2,10,6,4
2021,161563,40,3,10,6,4
2021,161563,40,4,1,1,0
2021,161563,41,0,27,19,8
2021,161563,41,1,12,9,3
2021,161563,41,2,7,4,3
2021,161563,41,3,7,5,2
2021,161563,41,4,1,1,0
2021,161563,42,0,6,3,3
2021,161563,42,2,3,2,1
2021,161563,42,3,3,1,2
2021,161563,44,0,27,19,8
2021,161563,44,1,12,9,3
2021,161563,44,2,7,4,3
2021,161563,44,3,7,5,2
2021,161563,44,4,1,1,0
2021,161572,0,0,20,11,9
2021,161572,10,0,14,7,7
2021,161572,10,1,4,3,1
2021,161572,10,2,1,0,1
2021,161572,10,3,7,4,3
2021,161572,10,4,2,0,2
2021,161572,40,0,14,7,7
2021,161572,40,1,4,3,1
2021,161572,40,2,1,0,1
2021,161572,40,3,7,4,3
2021,161572,40,4,2,0,2
2021,161572,41,0,14,7,7
2021,161572,41,1,4,3,1
2021,161572,41,2,1,0,1
2021,161572,41,3,7,4,3
2021,161572,41,4,2,0,2
2021,161572,45,0,14,7,7
2021,161572,45,1,4,3,1
2021,161572,45,2,1,0,1
2021,161572,45,3,7,4,3
2021,161572,45,4,2,0,2
2021,161572,50,0,6,4,2
2021,161581,0,0,22,14,8
2021,161581,10,0,22,14,8
2021,161581,10,4,22,14,8
2021,161581,40,0,22,14,8
2021,161581,40,4,22,14,8
2021,161581,42,0,22,14,8
2021,161581,42,4,22,14,8
2021,161688,0,0,98,34,64
2021,161688,10,0,98,34,64
2021,161688,10,1,22,7,15
2021,161688,10,2,34,13,21
2021,161688,10,3,22,5,17
2021,161688,10,4,20,9,11
2021,161688,20,0,57,23,34
2021,161688,20,1,22,7,15
2021,161688,20,2,22,9,13
2021,161688,20,3,10,4,6
2021,161688,20,4,3,3,0
2021,161688,30,0,33,6,27
2021,161688,30,2,12,4,8
2021,161688,30,3,12,1,11
2021,161688,30,4,9,1,8
2021,161688,40,0,8,5,3
2021,161688,40,4,8,5,3
2021,161688,42,0,8,5,3
2021,161688,42,4,8,5,3
2021,161767,0,0,240,89,151
2021,161767,10,0,240,89,151
2021,161767,10,1,65,26,39
2021,161767,10,2,87,32,55
2021,161767,10,3,70,23,47
2021,161767,10,4,9,5,4
2021,161767,10,6,9,3,6
2021,161767,20,0,112,38,74
2021,161767,20,1,61,25,36
2021,161767,20,2,43,13,30
2021,161767,20,3,7,0,7
2021,161767,20,4,1,0,1
2021,161767,30,0,23,7,16
2021,161767,30,1,1,0,1
2021,161767,30,2,14,3,11
2021,161767,30,3,6,2,4
2021,161767,30,4,2,2,0
2021,161767,40,0,105,44,61
2021,161767,40,1,3,1,2
2021,161767,40,2,30,16,14
2021,161767,40,3,57,21,36
2021,161767,40,4,6,3,3
2021,161767,40,6,9,3,6
2021,161767,41,0,50,23,27
2021,161767,41,1,2,0,2
2021,161767,41,2,29,16,13
2021,161767,41,3,17,6,11
2021,161767,41,4,2,1,1
2021,161767,43,0,55,21,34
2021,161767,43,1,1,1,0
2021,161767,43,2,1,0,1
2021,161767,43,3,40,15,25
2021,161767,43,4,4,2,2
2021,161767,43,6,9,3,6
2021,161767,44,0,50,23,27
2021,161767,44,1,2,0,2
2021,161767,44,2,29,16,13
2021,161767,44,3,17,6,11
2021,161767,44,4,2,1,1
2021,161864,0,0,93,43,50
2021,161864,10,0,93,43,50
2021,161864,10,1,23,11,12
2021,161864,10,2,26,13,13
2021,161864,10,3,43,18,25
2021,161864,10,4,1,1,0
2021,161864,40,0,93,43,50
2021,161864,40,1,23,11,12
2021,161864,40,2,26,13,13
2021,161864,40,3,43,18,25
2021,161864,40,4,1,1,0
2021,161864,43,0,93,43,50
2021,161864,43,1,23,11,12
2021,161864,43,2,26,13,13
2021,161864,43,3,43,18,25
2021,161864,43,4,1,1,0
2021,161873,0,0,176,87,89
2021,161873,10,0,176,87,89
2021,161873,10,1,55,30,25
2021,161873,10,2,60,32,28
2021,161873,10,3,24,10,14
2021,161873,10,5,37,15,22
2021,161873,20,0,111,59,52
2021,161873,20,1,53,29,24
2021,161873,20,2,57,30,27
2021,161873,20,3,1,0,1
2021,161873,30,0,28,13,15
2021,161873,30,1,2,1,1
2021,161873,30,2,3,2,1
2021,161873,30,3,23,10,13
2021,161873,40,0,37,15,22
2021,161873,40,5,37,15,22
2021,161873,41,0,20,4,16
2021,161873,41,5,20,4,16
2021,161873,42,0,17,11,6
2021,161873,42,5,17,11,6
2021,161873,44,0,20,4,16
2021,161873,44,5,20,4,16
2021,162007,0,0,228,101,127
2021,162007,10,0,228,101,127
2021,162007,10,1,43,28,15
2021,162007,10,2,54,21,33
2021,162007,10,3,86,33,53
2021,162007,10,4,45,19,26
2021,162007,20,0,102,57,45
2021,162007,20,1,43,28,15
2021,162007,20,2,34,12,22
2021,162007,20,3,25,17,8
2021,162007,30,0,81,25,56
2021,162007,30,2,20,9,11
2021,162007,30,3,61,16,45
2021,162007,40,0,45,19,26
2021,162007,40,4,45,19,26
2021,162007,41,0,16,5,11
2021,162007,41,4,16,5,11
2021,162007,42,0,29,14,15
2021,162007,42,4,29,14,15
2021,162007,44,0,16,5,11
2021,162007,44,4,16,5,11
2021,162061,0,0,13,12,1
2021,162061,10,0,13,12,1
2021,162061,10,4,13,12,1
2021,162061,40,0,13,12,1
2021,162061,40,4,13,12,1
2021,162061,42,0,5,4,1
2021,162061,42,4,5,4,1
2021,162061,43,0,8,8,0
2021,162061,43,4,8,8,0
2021,162104,0,0,51,20,31
2021,162104,10,0,51,20,31
2021,162104,10,1,15,3,12
2021,162104,10,2,14,7,7
2021,162104,10,3,20,8,12
2021,162104,10,5,2,2,0
2021,162104,40,0,51,20,31
2021,162104,40,1,15,3,12
2021,162104,40,2,14,7,7
2021,162104,40,3,20,8,12
2021,162104,40,5,2,2,0
2021,162104,41,0,34,13,21
2021,162104,41,1,14,3,11
2021,162104,41,2,5,2,3
2021,162104,41,3,15,8,7
2021,162104,42,0,17,7,10
2021,162104,42,1,1,0,1
2021,162104,42,2,9,5,4
2021,162104,42,3,5,0,5
2021,162104,42,5,2,2,0
2021,162104,44,0,34,13,21
2021,162104,44,1,14,3,11
2021,162104,44,2,5,2,3
2021,162104,44,3,15,8,7
2021,162122,0,0,95,40,55
2021,162122,10,0,95,40,55
2021,162122,10,1,38,20,18
2021,162122,10,2,20,6,14
2021,162122,10,3,33,11,22
2021,162122,10,4,4,3,1
2021,162122,20,0,48,17,31
2021,162122,20,1,28,15,13
2021,162122,20,2,9,2,7
2021,162122,20,3,11,0,11
2021,162122,30,0,3,0,3
2021,162122,30,1,3,0,3
2021,162122,40,0,44,23,21
2021,162122,40,1,7,5,2
2021,162122,40,2,11,4,7
2021,162122,40,3,22,11,11
2021,162122,40,4,4,3,1
2021,162122,42,0,44,23,21
2021,162122,42,1,7,5,2
2021,162122,42,2,11,4,7
2021,162122,42,3,22,11,11
2021,162122,42,4,4,3,1
2021,162168,0,0,52,15,37
2021,162168,10,0,52,15,37
2021,162168,10,1,14,3,11
2021,162168,10,2,13,8,5
2021,162168,10,3,13,3,10
2021,162168,10,4,12,1,11
2021,162168,40,0,52,15,37
2021,162168,40,1,14,3,11
2021,162168,40,2,13,8,5
2021,162168,40,3,13,3,10
2021,162168,40,4,12,1,11
2021,162168,41,0,45,13,32
2021,162168,41,1,14,3,11
2021,162168,41,2,12,7,5
2021,162168,41,3,10,2,8
2021,162168,41,4,9,1,8
2021,162168,42,0,2,2,0
2021,162168,42,2,1,1,0
2021,162168,42,3,1,1,0
2021,162168,43,0,5,0,5
2021,162168,43,3,2,0,2
2021,162168,43,4,3,0,3
2021,162168,44,0,45,13,32
2021,162168,44,1,14,3,11
2021,162168,44,2,12,7,5
2021,162168,44,3,10,2,8
2021,162168,44,4,9,1,8
2021,162210,0,0,32,15,17
2021,162210,10,0,32,15,17
2021,162210,10,1,15,7,8
2021,162210,10,2,8,4,4
2021,162210,10,3,8,4,4
2021,162210,10,4,1,0,1
2021,162210,40,0,32,15,17
2021,162210,40,1,15,7,8
2021,162210,40,2,8,4,4
2021,162210,40,3,8,4,4
2021,162210,40,4,1,0,1
2021,162210,42,0,32,15,17
2021,162210,42,1,15,7,8
2021,162210,42,2,8,4,4
2021,162210,42,3,8,4,4
2021,162210,42,4,1,0,1
2021,162283,0,0,126,60,66
2021,162283,10,0,126,60,66
2021,162283,10,1,24,13,11
2021,162283,10,2,37,20,17
2021,162283,10,3,57,24,33
2021,162283,10,4,5,1,4
2021,162283,10,5,3,2,1
2021,162283,20,0,84,43,41
2021,162283,20,1,23,13,10
2021,162283,20,2,35,19,16
2021,162283,20,3,26,11,15
2021,162283,30,0,36,15,21
2021,162283,30,1,1,0,1
2021,162283,30,2,2,1,1
2021,162283,30,3,31,13,18
2021,162283,30,4,1,0,1
2021,162283,30,5,1,1,0
2021,162283,40,0,6,2,4
2021,162283,40,4,4,1,3
2021,162283,40,5,2,1,1
2021,162283,42,0,6,2,4
2021,162283,42,4,4,1,3
2021,162283,42,5,2,1,1
2021,162557,0,0,98,38,60
2021,162557,10,0,98,38,60
2021,162557,10,1,36,18,18
2021,162557,10,2,25,7,18
2021,162557,10,3,37,13,24
2021,162557,40,0,98,38,60
2021,162557,40,1,36,18,18
2021,162557,40,2,25,7,18
2021,162557,40,3,37,13,24
2021,162557,43,0,98,38,60
2021,162557,43,1,36,18,18
2021,162557,43,2,25,7,18
2021,162557,43,3,37,13,24
2021,162584,0,0,232,119,113
2021,162584,10,0,232,119,113
2021,162584,10,1,66,47,19
2021,162584,10,2,68,34,34
2021,162584,10,3,53,19,34
2021,162584,10,4,3,1,2
2021,162584,10,5,42,18,24
2021,162584,20,0,126,78,48
2021,162584,20,1,65,46,19
2021,162584,20,2,57,29,28
2021,162584,20,3,4,3,1
2021,162584,30,0,63,22,41
2021,162584,30,1,1,1,0
2021,162584,30,2,11,5,6
2021,162584,30,3,48,15,33
2021,162584,30,4,3,1,2
2021,162584,40,0,43,19,24
2021,162584,40,3,1,1,0
2021,162584,40,5,42,18,24
2021,162584,42,0,41,17,24
2021,162584,42,5,41,17,24
2021,162584,43,0,2,2,0
2021,162584,43,3,1,1,0
2021,162584,43,5,1,1,0
2021,162609,0,0,23,15,8
2021,162609,10,0,23,15,8
2021,162609,10,1,10,7,3
2021,162609,10,2,6,3,3
2021,162609,10,3,7,5,2
2021,162609,40,0,23,15,8
2021,162609,40,1,10,7,3
2021,162609,40,2,6,3,3
2021,162609,40,3,7,5,2
2021,162609,42,0,23,15,8
2021,162609,42,1,10,7,3
2021,162609,42,2,6,3,3
2021,162609,42,3,7,5,2
2021,162654,0,0,106,39,67
2021,162654,10,0,104,39,65
2021,162654,10,1,24,10,14
2021,162654,10,2,35,14,21
2021,162654,10,3,37,13,24
2021,162654,10,4,6,1,5
2021,162654,10,6,2,1,1
2021,162654,20,0,58,23,35
2021,162654,20,1,24,10,14
2021,162654,20,2,33,13,20
2021,162654,20,3,1,0,1
2021,162654,30,0,18,7,11
2021,162654,30,2,1,1,0
2021,162654,30,3,17,6,11
2021,162654,40,0,28,9,19
2021,162654,40,2,1,0,1
2021,162654,40,3,19,7,12
2021,162654,40,4,6,1,5
2021,162654,40,6,2,1,1
2021,162654,41,0,15,5,10
2021,162654,41,2,1,0,1
2021,162654,41,3,9,4,5
2021,162654,41,4,5,1,4
2021,162654,42,0,13,4,9
2021,162654,42,3,10,3,7
2021,162654,42,4,1,0,1
2021,162654,42,6,2,1,1
2021,162654,44,0,15,5,10
2021,162654,44,2,1,0,1
2021,162654,44,3,9,4,5
2021,162654,44,4,5,1,4
2021,162654,50,0,2,0,2
2021,162690,0,0,75,29,46
2021,162690,10,0,75,29,46
2021,162690,10,1,10,5,5
2021,162690,10,2,12,4,8
2021,162690,10,3,38,13,25
2021,162690,10,4,15,7,8
2021,162690,20,0,40,13,27
2021,162690,20,1,10,5,5
2021,162690,20,2,10,3,7
2021,162690,20,3,20,5,15
2021,162690,30,0,35,16,19
2021,162690,30,2,2,1,1
2021,162690,30,3,18,8,10
2021,162690,30,4,15,7,8
2021,162706,0,0,104,41,63
2021,162706,10,0,104,41,63
2021,162706,10,1,16,6,10
2021,162706,10,2,17,5,12
2021,162706,10,3,71,30,41
2021,162706,20,0,37,13,24
2021,162706,20,1,14,5,9
2021,162706,20,2,15,4,11
2021,162706,20,3,8,4,4
2021,162706,30,0,22,8,14
2021,162706,30,3,22,8,14
2021,162706,40,0,45,20,25
2021,162706,40,1,2,1,1
2021,162706,40,2,2,1,1
2021,162706,40,3,41,18,23
2021,162706,41,0,45,20,25
2021,162706,41,1,2,1,1
2021,162706,41,2,2,1,1
2021,162706,41,3,41,18,23
2021,162706,44,0,45,20,25
2021,162706,44,1,2,1,1
2021,162706,44,2,2,1,1
2021,162706,44,3,41,18,23
2021,162760,0,0,98,40,58
2021,162760,10,0,98,40,58
2021,162760,10,1,20,7,13
2021,162760,10,2,33,15,18
2021,162760,10,3,44,17,27
2021,162760,10,4,1,1,0
2021,162760,20,0,51,21,30
2021,162760,20,1,20,7,13
2021,162760,20,2,31,14,17
2021,162760,30,0,40,14,26
2021,162760,30,2,2,1,1
2021,162760,30,3,38,13,25
2021,162760,40,0,7,5,2
2021,162760,40,3,6,4,2
2021,162760,40,4,1,1,0
2021,162760,42,0,7,5,2
2021,162760,42,3,6,4,2
2021,162760,42,4,1,1,0
2021,162779,0,0,196,71,125
2021,162779,10,0,196,71,125
2021,162779,10,1,68,26,42
2021,162779,10,2,73,22,51
2021,162779,10,3,40,15,25
2021,162779,10,4,15,8,7
2021,162779,40,0,196,71,125
2021,162779,40,1,68,26,42
2021,162779,40,2,73,22,51
2021,162779,40,3,40,15,25
2021,162779,40,4,15,8,7
2021,162779,41,0,196,71,125
2021,162779,41,1,68,26,42
2021,162779,41,2,73,22,51
2021,162779,41,3,40,15,25
2021,162779,41,4,15,8,7
2021,162779,44,0,165,59,106
2021,162779,44,1,67,26,41
2021,162779,44,2,64,19,45
2021,162779,44,3,30,12,18
2021,162779,44,4,4,2,2
2021,162779,45,0,31,12,19
2021,162779,45,1,1,0,1
2021,162779,45,2,9,3,6
2021,162779,45,3,10,3,7
2021,162779,45,4,11,6,5
2021,162928,0,0,3857,2212,1645
2021,162928,10,0,3857,2212,1645
2021,162928,10,1,1177,850,327
2021,162928,10,2,834,492,342
2021,162928,10,3,1366,651,715
2021,162928,10,4,202,93,109
2021,162928,10,5,246,103,143
2021,162928,10,6,32,23,9
2021,162928,20,0,1194,853,341
2021,162928,20,1,1093,792,301
2021,162928,20,2,101,61,40
2021,162928,30,0,2005,1034,971
2021,162928,30,1,8,5,3
2021,162928,30,2,674,400,274
2021,162928,30,3,1323,629,694
2021,162928,40,0,658,325,333
2021,162928,40,1,76,53,23
2021,162928,40,2,59,31,28
2021,162928,40,3,43,22,21
2021,162928,40,4,202,93,109
2021,162928,40,5,246,103,143
2021,162928,40,6,32,23,9
2021,162928,41,0,270,148,122
2021,162928,41,1,56,38,18
2021,162928,41,2,33,20,13
2021,162928,41,3,37,19,18
2021,162928,41,4,8,5,3
2021,162928,41,5,126,58,68
2021,162928,41,6,10,8,2
2021,162928,42,0,363,163,200
2021,162928,42,1,13,10,3
2021,162928,42,2,17,7,10
2021,162928,42,3,4,2,2
2021,162928,42,4,192,87,105
2021,162928,42,5,119,45,74
2021,162928,42,6,18,12,6
2021,162928,43,0,25,14,11
2021,162928,43,1,7,5,2
2021,162928,43,2,9,4,5
2021,162928,43,3,2,1,1
2021,162928,43,4,2,1,1
2021,162928,43,5,1,0,1
2021,162928,43,6,4,3,1
2021,162928,44,0,270,148,122
2021,162928,44,1,56,38,18
2021,162928,44,2,33,20,13
2021,162928,44,3,37,19,18
2021,162928,44,4,8,5,3
2021,162928,44,5,126,58,68
2021,162928,44,6,10,8,2
2021,163028,0,0,43,40,3
2021,163028,10,0,43,40,3
2021,163028,10,4,43,40,3
2021,163028,40,0,43,40,3
2021,163028,40,4,43,40,3
2021,163028,41,0,43,40,3
2021,163028,41,4,43,40,3
2021,163028,45,0,43,40,3
2021,163028,45,4,43,40,3
2021,163046,0,0,334,160,174
2021,163046,10,0,334,160,174
2021,163046,10,1,75,50,25
2021,163046,10,2,107,44,63
2021,163046,10,3,46,24,22
2021,163046,10,4,30,10,20
2021,163046,10,5,76,32,44
2021,163046,20,0,183,95,88
2021,163046,20,1,74,49,25
2021,163046,20,2,107,44,63
2021,163046,20,3,2,2,0
2021,163046,30,0,20,10,10
2021,163046,30,1,1,1,0
2021,163046,30,3,19,9,10
2021,163046,40,0,131,55,76
2021,163046,40,3,25,13,12
2021,163046,40,4,30,10,20
2021,163046,40,5,76,32,44
2021,163046,42,0,131,55,76
2021,163046,42,3,25,13,12
2021,163046,42,4,30,10,20
2021,163046,42,5,76,32,44
2021,163204,0,0,199,101,98
2021,163204,10,0,199,101,98
2021,163204,10,1,124,60,64
2021,163204,10,2,63,35,28
2021,163204,10,3,12,6,6
2021,163204,40,0,199,101,98
2021,163204,40,1,124,60,64
2021,163204,40,2,63,35,28
2021,163204,40,3,12,6,6
2021,163204,42,0,199,101,98
2021,163204,42,1,124,60,64
2021,163204,42,2,63,35,28
2021,163204,42,3,12,6,6
2021,163259,0,0,1875,977,898
2021,163259,10,0,1875,977,898
2021,163259,10,1,431,308,123
2021,163259,10,2,400,212,188
2021,163259,10,3,859,394,465
2021,163259,10,4,162,53,109
2021,163259,10,5,11,2,9
2021,163259,10,6,12,8,4
2021,163259,20,0,357,243,114
2021,163259,20,1,279,202,77
2021,163259,20,2,77,41,36
2021,163259,20,3,1,0,1
2021,163259,30,0,98,58,40
2021,163259,30,1,5,4,1
2021,163259,30,2,35,22,13
2021,163259,30,3,58,32,26
2021,163259,40,0,1420,676,744
2021,163259,40,1,147,102,45
2021,163259,40,2,288,149,139
2021,163259,40,3,800,362,438
2021,163259,40,4,162,53,109
2021,163259,40,5,11,2,9
2021,163259,40,6,12,8,4
2021,163259,42,0,1419,675,744
2021,163259,42,1,147,102,45
2021,163259,42,2,288,149,139
2021,163259,42,3,800,362,438
2021,163259,42,4,162,53,109
2021,163259,42,5,11,2,9
2021,163259,42,6,11,7,4
2021,163259,43,0,1,1,0
2021,163259,43,6,1,1,0
2021,163268,0,0,556,292,264
2021,163268,10,0,556,292,264
2021,163268,10,1,159,110,49
2021,163268,10,2,166,77,89
2021,163268,10,3,103,50,53
2021,163268,10,4,7,1,6
2021,163268,10,5,121,54,67
2021,163268,20,0,298,173,125
2021,163268,20,1,140,96,44
2021,163268,20,2,157,76,81
2021,163268,20,3,1,1,0
2021,163268,30,0,98,48,50
2021,163268,30,1,1,1,0
2021,163268,30,2,2,0,2
2021,163268,30,3,95,47,48
2021,163268,40,0,160,71,89
2021,163268,40,1,18,13,5
2021,163268,40,2,7,1,6
2021,163268,40,3,7,2,5
2021,163268,40,4,7,1,6
2021,163268,40,5,121,54,67
2021,163268,42,0,160,71,89
2021,163268,42,1,18,13,5
2021,163268,42,2,7,1,6
2021,163268,42,3,7,2,5
2021,163268,42,4,7,1,6
2021,163268,42,5,121,54,67
2021,163286,0,0,1854,1107,747
2021,163286,10,0,1854,1107,747
2021,163286,10,1,688,509,179
2021,163286,10,2,402,226,176
2021,163286,10,3,250,141,109
2021,163286,10,4,4,1,3
2021,163286,10,5,510,230,280
2021,163286,20,0,1077,722,355
2021,163286,20,1,676,497,179
2021,163286,20,2,401,225,176
2021,163286,30,0,250,141,109
2021,163286,30,2,1,1,0
2021,163286,30,3,249,140,109
2021,163286,40,0,527,244,283
2021,163286,40,1,12,12,0
2021,163286,40,3,1,1,0
2021,163286,40,4,4,1,3
2021,163286,40,5,510,230,280
2021,163286,42,0,527,244,283
2021,163286,42,1,12,12,0
2021,163286,42,3,1,1,0
2021,163286,42,4,4,1,3
2021,163286,42,5,510,230,280
2021,163295,0,0,149,67,82
2021,163295,10,0,149,67,82
2021,163295,10,6,149,67,82
2021,163295,40,0,149,67,82
2021,163295,40,6,149,67,82
2021,163295,41,0,142,62,80
2021,163295,41,6,142,62,80
2021,163295,42,0,7,5,2
2021,163295,42,6,7,5,2
2021,163295,44,0,142,62,80
2021,163295,44,6,142,62,80
2021,163338,0,0,195,111,84
2021,163338,10,0,195,111,84
2021,163338,10,1,42,25,17
2021,163338,10,2,75,49,26
2021,163338,10,3,47,23,24
2021,163338,10,4,2,1,1
2021,163338,10,5,29,13,16
2021,163338,20,0,100,62,38
2021,163338,20,1,41,24,17
2021,163338,20,2,56,36,20
2021,163338,20,3,3,2,1
2021,163338,30,0,51,27,24
2021,163338,30,2,16,11,5
2021,163338,30,3,34,16,18
2021,163338,30,4,1,0,1
2021,163338,40,0,44,22,22
2021,163338,40,1,1,1,0
2021,163338,40,2,3,2,1
2021,163338,40,3,10,5,5
2021,163338,40,4,1,1,0
2021,163338,40,5,29,13,16
2021,163338,42,0,17,7,10
2021,163338,42,2,1,0,1
2021,163338,42,3,9,4,5
2021,163338,42,4,1,1,0
2021,163338,42,5,6,2,4
2021,163338,43,0,27,15,12
2021,163338,43,1,1,1,0
2021,163338,43,2,2,2,0
2021,163338,43,3,1,1,0
2021,163338,43,5,23,11,12
2021,163426,0,0,472,189,283
2021,163426,10,0,472,189,283
2021,163426,10,1,342,154,188
2021,163426,10,2,85,25,60
2021,163426,10,3,29,5,24
2021,163426,10,6,16,5,11
2021,163426,40,0,472,189,283
2021,163426,40,1,342,154,188
2021,163426,40,2,85,25,60
2021,163426,40,3,29,5,24
2021,163426,40,6,16,5,11
2021,163426,42,0,472,189,283
2021,163426,42,1,342,154,188
2021,163426,42,2,85,25,60
2021,163426,42,3,29,5,24
2021,163426,42,6,16,5,11
2021,163453,0,0,381,205,176
2021,163453,10,0,381,205,176
2021,163453,10,1,63,44,19
2021,163453,10,2,157,86,71
2021,163453,10,3,69,32,37
2021,163453,10,4,2,1,1
2021,163453,10,5,90,42,48
2021,163453,20,0,214,124,90
2021,163453,20,1,63,44,19
2021,163453,20,2,146,77,69
2021,163453,20,3,4,2,2
2021,163453,20,4,1,1,0
2021,163453,30,0,76,39,37
2021,163453,30,2,11,9,2
2021,163453,30,3,65,30,35
2021,163453,40,0,91,42,49
2021,163453,40,4,1,0,1
2021,163453,40,5,90,42,48
2021,163453,41,0,29,12,17
2021,163453,41,4,1,0,1
2021,163453,41,5,28,12,16
2021,163453,42,0,62,30,32
2021,163453,42,5,62,30,32
2021,163453,44,0,29,12,17
2021,163453,44,4,1,0,1
2021,163453,44,5,28,12,16
2021,163462,0,0,125,77,48
2021,163462,10,0,125,77,48
2021,163462,10,1,27,13,14
2021,163462,10,2,52,38,14
2021,163462,10,3,27,16,11
2021,163462,10,5,18,10,8
2021,163462,10,6,1,0,1
2021,163462,20,0,71,43,28
2021,163462,20,1,25,11,14
2021,163462,20,2,46,32,14
2021,163462,30,0,18,9,9
2021,163462,30,3,18,9,9
2021,163462,40,0,36,25,11
2021,163462,40,1,2,2,0
2021,163462,40,2,6,6,0
2021,163462,40,3,9,7,2
2021,163462,40,5,18,10,8
2021,163462,40,6,1,0,1
2021,163462,41,0,13,10,3
2021,163462,41,1,1,1,0
2021,163462,41,2,4,4,0
2021,163462,41,3,5,3,2
2021,163462,41,5,3,2,1
2021,163462,42,0,23,15,8
2021,163462,42,1,1,1,0
2021,163462,42,2,2,2,0
2021,163462,42,3,4,4,0
2021,163462,42,5,15,8,7
2021,163462,42,6,1,0,1
2021,163462,44,0,13,10,3
2021,163462,44,1,1,1,0
2021,163462,44,2,4,4,0
2021,163462,44,3,5,3,2
2021,163462,44,5,3,2,1
2021,163532,0,0,13,13,0
2021,163532,10,0,13,13,0
2021,163532,10,1,13,13,0
2021,163532,20,0,13,13,0
2021,163532,20,1,13,13,0
2021,163578,0,0,94,25,69
2021,163578,10,0,94,25,69
2021,163578,10,1,14,7,7
2021,163578,10,2,31,9,22
2021,163578,10,3,49,9,40
2021,163578,20,0,32,13,19
2021,163578,20,1,14,7,7
2021,163578,20,2,18,6,12
2021,163578,30,0,53,10,43
2021,163578,30,2,12,3,9
2021,163578,30,3,41,7,34
2021,163578,40,0,9,2,7
2021,163578,40,2,1,0,1
2021,163578,40,3,8,2,6
2021,163578,42,0,9,2,7
2021,163578,42,2,1,0,1
2021,163578,42,3,8,2,6
2021,163657,0,0,237,87,150
2021,163657,10,0,237,87,150
2021,163657,10,1,89,35,54
2021,163657,10,2,117,35,82
2021,163657,10,3,31,17,14
2021,163657,20,0,81,30,51
2021,163657,20,1,51,19,32
2021,163657,20,2,30,11,19
2021,163657,30,0,120,45,75
2021,163657,30,1,28,11,17
2021,163657,30,2,67,19,48
2021,163657,30,3,25,15,10
2021,163657,40,0,36,12,24
2021,163657,40,1,10,5,5
2021,163657,40,2,20,5,15
2021,163657,40,3,6,2,4
2021,163657,42,0,36,12,24
2021,163657,42,1,10,5,5
2021,163657,42,2,20,5,15
2021,163657,42,3,6,2,4
2021,163851,0,0,445,213,232
2021,163851,10,0,445,213,232
2021,163851,10,1,112,74,38
2021,163851,10,2,122,62,60
2021,163851,10,3,108,54,54
2021,163851,10,4,9,2,7
2021,163851,10,5,94,21,73
2021,163851,20,0,243,141,102
2021,163851,20,1,112,74,38
2021,163851,20,2,121,62,59
2021,163851,20,3,10,5,5
2021,163851,30,0,108,51,57
2021,163851,30,2,1,0,1
2021,163851,30,3,98,49,49
2021,163851,30,4,9,2,7
2021,163851,40,0,94,21,73
2021,163851,40,5,94,21,73
2021,163851,41,0,40,7,33
2021,163851,41,5,40,7,33
2021,163851,43,0,54,14,40
2021,163851,43,5,54,14,40
2021,163851,44,0,40,7,33
2021,163851,44,5,40,7,33
2021,163912,0,0,120,59,61
2021,163912,10,0,120,59,61
2021,163912,10,1,46,24,22
2021,163912,10,2,31,20,11
2021,163912,10,3,40,14,26
2021,163912,10,4,1,0,1
2021,163912,10,5,2,1,1
2021,163912,20,0,77,44,33
2021,163912,20,1,46,24,22
2021,163912,20,2,31,20,11
2021,163912,30,0,30,9,21
2021,163912,30,3,30,9,21
2021,163912,40,0,13,6,7
2021,163912,40,3,10,5,5
2021,163912,40,4,1,0,1
2021,163912,40,5,2,1,1
2021,163912,41,0,13,6,7
2021,163912,41,3,10,5,5
2021,163912,41,4,1,0,1
2021,163912,41,5,2,1,1
2021,163912,44,0,13,6,7
2021,163912,44,3,10,5,5
2021,163912,44,4,1,0,1
2021,163912,44,5,2,1,1
2021,163976,0,0,60,45,15
2021,163976,10,0,59,44,15
2021,163976,10,1,59,44,15
2021,163976,20,0,46,35,11
2021,163976,20,1,46,35,11
2021,163976,30,0,11,7,4
2021,163976,30,1,11,7,4
2021,163976,40,0,2,2,0
2021,163976,40,1,2,2,0
2021,163976,42,0,2,2,0
2021,163976,42,1,2,2,0
2021,163976,50,0,1,1,0
2021,164076,0,0,911,391,520
2021,164076,10,0,911,391,520
2021,164076,10,1,247,133,114
2021,164076,10,2,220,94,126
2021,164076,10,3,197,66,131
2021,164076,10,4,12,1,11
2021,164076,10,5,235,97,138
2021,164076,20,0,440,226,214
2021,164076,20,1,242,132,110
2021,164076,20,2,197,93,104
2021,164076,20,3,1,1,0
2021,164076,30,0,161,54,107
2021,164076,30,1,1,0,1
2021,164076,30,2,4,0,4
2021,164076,30,3,155,54,101
2021,164076,30,4,1,0,1
2021,164076,40,0,310,111,199
2021,164076,40,1,4,1,3
2021,164076,40,2,19,1,18
2021,164076,40,3,41,11,30
2021,164076,40,4,11,1,10
2021,164076,40,5,235,97,138
2021,164076,42,0,286,94,192
2021,164076,42,1,4,1,3
2021,164076,42,2,19,1,18
2021,164076,42,3,41,11,30
2021,164076,42,4,11,1,10
2021,164076,42,5,211,80,131
2021,164076,43,0,24,17,7
2021,164076,43,5,24,17,7
2021,164085,0,0,11,4,7
2021,164085,10,0,11,4,7
2021,164085,10,1,2,0,2
2021,164085,10,2,5,2,3
2021,164085,10,3,3,1,2
2021,164085,10,4,1,1,0
2021,164085,40,0,11,4,7
2021,164085,40,1,2,0,2
2021,164085,40,2,5,2,3
2021,164085,40,3,3,1,2
2021,164085,40,4,1,1,0
2021,164085,41,0,7,1,6
2021,164085,41,1,2,0,2
2021,164085,41,2,3,1,2
2021,164085,41,3,2,0,2
2021,164085,42,0,4,3,1
2021,164085,42,2,2,1,1
2021,164085,42,3,1,1,0
2021,164085,42,4,1,1,0
2021,164085,44,0,7,1,6
2021,164085,44,1,2,0,2
2021,164085,44,2,3,1,2
2021,164085,44,3,2,0,2
2021,164155,0,0,324,219,105
2021,164155,10,0,324,219,105
2021,164155,10,1,122,85,37
2021,164155,10,2,95,72,23
2021,164155,10,3,67,32,35
2021,164155,10,4,24,18,6
2021,164155,10,6,16,12,4
2021,164155,20,0,217,157,60
2021,164155,20,1,122,85,37
2021,164155,20,2,95,72,23
2021,164155,30,0,67,32,35
2021,164155,30,3,67,32,35
2021,164155,40,0,40,30,10
2021,164155,40,4,24,18,6
2021,164155,40,6,16,12,4
2021,164155,41,0,40,30,10
2021,164155,41,4,24,18,6
2021,164155,41,6,16,12,4
2021,164155,44,0,35,27,8
2021,164155,44,4,19,15,4
2021,164155,44,6,16,12,4
2021,164155,45,0,5,3,2
2021,164155,45,4,5,3,2
2021,164173,0,0,118,48,70
2021,164173,10,0,118,48,70
2021,164173,10,1,48,21,27
2021,164173,10,2,26,15,11
2021,164173,10,3,20,6,14
2021,164173,10,4,2,1,1
2021,164173,10,5,22,5,17
2021,164173,40,0,118,48,70
2021,164173,40,1,48,21,27
2021,164173,40,2,26,15,11
2021,164173,40,3,20,6,14
2021,164173,40,4,2,1,1
2021,164173,40,5,22,5,17
2021,164173,41,0,103,41,62
2021,164173,41,1,47,21,26
2021,164173,41,2,24,14,10
2021,164173,41,3,17,3,14
2021,164173,41,4,2,1,1
2021,164173,41,5,13,2,11
2021,164173,42,0,15,7,8
2021,164173,42,1,1,0,1
2021,164173,42,2,2,1,1
2021,164173,42,3,3,3,0
2021,164173,42,5,9,3,6
2021,164173,44,0,103,41,62
2021,164173,44,1,47,21,26
2021,164173,44,2,24,14,10
2021,164173,44,3,17,3,14
2021,164173,44,4,2,1,1
2021,164173,44,5,13,2,11
2021,164216,0,0,89,38,51
2021,164216,10,0,89,38,51
2021,164216,10,1,13,5,8
2021,164216,10,2,46,21,25
2021,164216,10,3,25,10,15
2021,164216,10,4,4,2,2
2021,164216,10,5,1,0,1
2021,164216,20,0,59,26,33
2021,164216,20,1,13,5,8
2021,164216,20,2,46,21,25
2021,164216,30,0,22,10,12
2021,164216,30,3,22,10,12
2021,164216,40,0,8,2,6
2021,164216,40,3,3,0,3
2021,164216,40,4,4,2,2
2021,164216,40,5,1,0,1
2021,164216,41,0,2,0,2
2021,164216,41,4,2,0,2
2021,164216,42,0,4,1,3
2021,164216,42,3,3,0,3
2021,164216,42,4,1,1,0
2021,164216,43,0,2,1,1
2021,164216,43,4,1,1,0
2021,164216,43,5,1,0,1
2021,164216,44,0,2,0,2
2021,164216,44,4,2,0,2
2021,164270,0,0,128,55,73
2021,164270,10,0,128,55,73
2021,164270,10,1,32,15,17
2021,164270,10,2,34,21,13
2021,164270,10,3,22,7,15
2021,164270,10,4,1,1,0
2021,164270,10,5,39,11,28
2021,164270,20,0,65,35,30
2021,164270,20,1,31,14,17
2021,164270,20,2,34,21,13
2021,164270,30,0,20,5,15
2021,164270,30,3,20,5,15
2021,164270,40,0,43,15,28
2021,164270,40,1,1,1,0
2021,164270,40,3,2,2,0
2021,164270,40,4,1,1,0
2021,164270,40,5,39,11,28
2021,164270,41,0,13,5,8
2021,164270,41,1,1,1,0
2021,164270,41,5,12,4,8
2021,164270,42,0,30,10,20
2021,164270,42,3,2,2,0
2021,164270,42,4,1,1,0
2021,164270,42,5,27,7,20
2021,164270,44,0,13,5,8
2021,164270,44,1,1,1,0
2021,164270,44,5,12,4,8
2021,164313,0,0,68,24,44
2021,164313,10,0,68,24,44
2021,164313,10,1,12,2,10
2021,164313,10,2,12,6,6
2021,164313,10,3,31,10,21
2021,164313,10,4,13,6,7
2021,164313,40,0,68,24,44
2021,164313,40,1,12,2,10
2021,164313,40,2,12,6,6
2021,164313,40,3,31,10,21
2021,164313,40,4,13,6,7
2021,164313,41,0,48,16,32
2021,164313,41,1,12,2,10
2021,164313,41,2,10,5,5
2021,164313,41,3,22,6,16
2021,164313,41,4,4,3,1
2021,164313,42,0,20,8,12
2021,164313,42,2,2,1,1
2021,164313,42,3,9,4,5
2021,164313,42,4,9,3,6
2021,164313,44,0,48,16,32
2021,164313,44,1,12,2,10
2021,164313,44,2,10,5,5
2021,164313,44,3,22,6,16
2021,164313,44,4,4,3,1
2021,164368,0,0,32,23,9
2021,164368,10,0,32,23,9
2021,164368,10,1,32,23,9
2021,164368,40,0,32,23,9
2021,164368,40,1,32,23,9
2021,164368,41,0,29,21,8
2021,164368,41,1,29,21,8
2021,164368,42,0,3,2,1
2021,164368,42,1,3,2,1
2021,164368,44,0,29,21,8
2021,164368,44,1,29,21,8
2021,164447,0,0,51,19,32
2021,164447,10,0,51,19,32
2021,164447,10,1,10,3,7
2021,164447,10,2,21,11,10
2021,164447,10,3,19,4,15
2021,164447,10,4,1,1,0
2021,164447,20,0,31,14,17
2021,164447,20,1,9,3,6
2021,164447,20,2,20,11,9
2021,164447,20,3,2,0,2
2021,164447,30,0,12,2,10
2021,164447,30,1,1,0,1
2021,164447,30,2,1,0,1
2021,164447,30,3,10,2,8
2021,164447,40,0,8,3,5
2021,164447,40,3,7,2,5
2021,164447,40,4,1,1,0
2021,164447,42,0,8,3,5
2021,164447,42,3,7,2,5
2021,164447,42,4,1,1,0
2021,164465,0,0,267,131,136
2021,164465,10,0,267,131,136
2021,164465,10,1,105,57,48
2021,164465,10,2,43,21,22
2021,164465,10,3,82,38,44
2021,164465,10,4,1,0,1
2021,164465,10,5,36,15,21
2021,164465,20,0,138,76,62
2021,164465,20,1,100,57,43
2021,164465,20,2,38,19,19
2021,164465,30,0,64,29,35
2021,164465,30,2,1,1,0
2021,164465,30,3,63,28,35
2021,164465,40,0,65,26,39
2021,164465,40,1,5,0,5
2021,164465,40,2,4,1,3
2021,164465,40,3,19,10,9
2021,164465,40,4,1,0,1
2021,164465,40,5,36,15,21
2021,164465,41,0,43,14,29
2021,164465,41,1,2,0,2
2021,164465,41,2,2,0,2
2021,164465,41,3,8,3,5
2021,164465,41,5,31,11,20
2021,164465,42,0,18,10,8
2021,164465,42,1,3,0,3
2021,164465,42,2,1,1,0
2021,164465,42,3,10,6,4
2021,164465,42,4,1,0,1
2021,164465,42,5,3,3,0
2021,164465,43,0,4,2,2
2021,164465,43,2,1,0,1
2021,164465,43,3,1,1,0
2021,164465,43,5,2,1,1
2021,164465,44,0,43,14,29
2021,164465,44,1,2,0,2
2021,164465,44,2,2,0,2
2021,164465,44,3,8,3,5
2021,164465,44,5,31,11,20
2021,164492,0,0,44,18,26
2021,164492,10,0,44,18,26
2021,164492,10,1,3,1,2
2021,164492,10,2,8,4,4
2021,164492,10,3,33,13,20
2021,164492,20,0,15,7,8
2021,164492,20,1,2,1,1
2021,164492,20,2,8,4,4
2021,164492,20,3,5,2,3
2021,164492,30,0,9,4,5
2021,164492,30,3,9,4,5
2021,164492,40,0,20,7,13
2021,164492,40,1,1,0,1
2021,164492,40,3,19,7,12
2021,164492,41,0,5,1,4
2021,164492,41,3,5,1,4
2021,164492,42,0,15,6,9
2021,164492,42,1,1,0,1
2021,164492,42,3,14,6,8
2021,164492,44,0,5,1,4
2021,164492,44,3,5,1,4
2021,164562,0,0,132,68,64
2021,164562,10,0,132,68,64
2021,164562,10,1,26,18,8
2021,164562,10,2,41,18,23
2021,164562,10,3,37,21,16
2021,164562,10,4,7,2,5
2021,164562,10,6,21,9,12
2021,164562,20,0,73,39,34
2021,164562,20,1,26,18,8
2021,164562,20,2,41,18,23
2021,164562,20,3,6,3,3
2021,164562,30,0,23,14,9
2021,164562,30,3,23,14,9
2021,164562,40,0,36,15,21
2021,164562,40,3,8,4,4
2021,164562,40,4,7,2,5
2021,164562,40,6,21,9,12
2021,164562,41,0,21,9,12
2021,164562,41,6,21,9,12
2021,164562,42,0,15,6,9
2021,164562,42,3,8,4,4
2021,164562,42,4,7,2,5
2021,164562,44,0,21,9,12
2021,164562,44,6,21,9,12
2021,164580,0,0,182,111,71
2021,164580,10,0,182,111,71
2021,164580,10,1,59,37,22
2021,164580,10,2,54,33,21
2021,164580,10,3,16,7,9
2021,164580,10,5,53,34,19
2021,164580,20,0,112,70,42
2021,164580,20,1,59,37,22
2021,164580,20,2,53,33,20
2021,164580,30,0,17,7,10
2021,164580,30,2,1,0,1
2021,164580,30,3,16,7,9
2021,164580,40,0,53,34,19
2021,164580,40,5,53,34,19
2021,164580,41,0,33,19,14
2021,164580,41,5,33,19,14
2021,164580,42,0,20,15,5
2021,164580,42,5,20,15,5
2021,164580,44,0,33,19,14
2021,164580,44,5,33,19,14
2021,164632,0,0,84,14,70
2021,164632,10,0,84,14,70
2021,164632,10,1,14,5,9
2021,164632,10,2,26,4,22
2021,164632,10,3,34,4,30
2021,164632,10,4,6,1,5
2021,164632,10,6,4,0,4
2021,164632,40,0,84,14,70
2021,164632,40,1,14,5,9
2021,164632,40,2,26,4,22
2021,164632,40,3,34,4,30
2021,164632,40,4,6,1,5
2021,164632,40,6,4,0,4
2021,164632,41,0,68,12,56
2021,164632,41,1,12,4,8
2021,164632,41,2,23,4,19
2021,164632,41,3,26,3,23
2021,164632,41,4,5,1,4
2021,164632,41,6,2,0,2
2021,164632,42,0,16,2,14
2021,164632,42,1,2,1,1
2021,164632,42,2,3,0,3
2021,164632,42,3,8,1,7
2021,164632,42,4,1,0,1
2021,164632,42,6,2,0,2
2021,164632,44,0,67,12,55
2021,164632,44,1,12,4,8
2021,164632,44,2,23,4,19
2021,164632,44,3,26,3,23
2021,164632,44,4,4,1,3
2021,164632,44,6,2,0,2
2021,164632,45,0,1,0,1
2021,164632,45,4,1,0,1
2021,164641,0,0,7,3,4
2021,164641,10,0,7,3,4
2021,164641,10,1,7,3,4
2021,164641,40,0,7,3,4
2021,164641,40,1,7,3,4
2021,164641,43,0,7,3,4
2021,164641,43,1,7,3,4
2021,164739,0,0,266,148,118
2021,164739,10,0,266,148,118
2021,164739,10,1,81,45,36
2021,164739,10,2,48,26,22
2021,164739,10,3,59,29,30
2021,164739,10,5,78,48,30
2021,164739,20,0,124,68,56
2021,164739,20,1,81,45,36
2021,164739,20,2,43,23,20
2021,164739,30,0,63,32,31
2021,164739,30,2,5,3,2
2021,164739,30,3,58,29,29
2021,164739,40,0,79,48,31
2021,164739,40,3,1,0,1
2021,164739,40,5,78,48,30
2021,164739,42,0,79,48,31
2021,164739,42,3,1,0,1
2021,164739,42,5,78,48,30
2021,164748,0,0,339,225,114
2021,164748,10,0,339,225,114
2021,164748,10,1,189,126,63
2021,164748,10,2,99,64,35
2021,164748,10,3,51,35,16
2021,164748,40,0,339,225,114
2021,164748,40,1,189,126,63
2021,164748,40,2,99,64,35
2021,164748,40,3,51,35,16
2021,164748,41,0,339,225,114
2021,164748,41,1,189,126,63
2021,164748,41,2,99,64,35
2021,164748,41,3,51,35,16
2021,164748,44,0,339,225,114
2021,164748,44,1,189,126,63
2021,164748,44,2,99,64,35
2021,164748,44,3,51,35,16
2021,164775,0,0,50,15,35
2021,164775,10,0,50,15,35
2021,164775,10,1,26,10,16
2021,164775,10,2,9,2,7
2021,164775,10,3,15,3,12
2021,164775,20,0,33,12,21
2021,164775,20,1,26,10,16
2021,164775,20,2,7,2,5
2021,164775,30,0,17,3,14
2021,164775,30,2,2,0,2
2021,164775,30,3,15,3,12
2021,164872,0,0,25,16,9
2021,164872,10,0,25,16,9
2021,164872,10,1,5,1,4
2021,164872,10,2,17,12,5
2021,164872,10,3,3,3,0
2021,164872,40,0,25,16,9
2021,164872,40,1,5,1,4
2021,164872,40,2,17,12,5
2021,164872,40,3,3,3,0
2021,164872,41,0,20,11,9
2021,164872,41,1,5,1,4
2021,164872,41,2,15,10,5
2021,164872,42,0,5,5,0
2021,164872,42,2,2,2,0
2021,164872,42,3,3,3,0
2021,164872,44,0,20,11,9
2021,164872,44,1,5,1,4
2021,164872,44,2,15,10,5
2021,164924,0,0,880,510,370
2021,164924,10,0,880,510,370
2021,164924,10,1,303,203,100
2021,164924,10,2,283,154,129
2021,164924,10,3,203,103,100
2021,164924,10,4,68,36,32
2021,164924,10,5,23,14,9
2021,164924,20,0,466,294,172
2021,164924,20,1,273,183,90
2021,164924,20,2,193,111,82
2021,164924,30,0,143,79,64
2021,164924,30,2,2,2,0
2021,164924,30,3,141,77,64
2021,164924,40,0,271,137,134
2021,164924,40,1,30,20,10
2021,164924,40,2,88,41,47
2021,164924,40,3,62,26,36
2021,164924,40,4,68,36,32
2021,164924,40,5,23,14,9
2021,164924,41,0,241,120,121
2021,164924,41,1,29,19,10
2021,164924,41,2,88,41,47
2021,164924,41,3,62,26,36
2021,164924,41,4,39,20,19
2021,164924,41,5,23,14,9
2021,164924,42,0,30,17,13
2021,164924,42,1,1,1,0
2021,164924,42,4,29,16,13
2021,164924,44,0,241,120,121
2021,164924,44,1,29,19,10
2021,164924,44,2,88,41,47
2021,164924,44,3,62,26,36
2021,164924,44,4,39,20,19
2021,164924,44,5,23,14,9
2021,164988,0,0,3007,1507,1500
2021,164988,10,0,2997,1506,1491
2021,164988,10,1,624,448,176
2021,164988,10,2,499,280,219
2021,164988,10,3,920,367,553
2021,164988,10,4,144,41,103
2021,164988,10,5,377,174,203
2021,164988,10,6,433,196,237
2021,164988,20,0,678,468,210
2021,164988,20,1,411,309,102
2021,164988,20,2,267,159,108
2021,164988,30,0,182,97,85
2021,164988,30,2,4,3,1
2021,164988,30,3,178,94,84
2021,164988,40,0,2137,941,1196
2021,164988,40,1,213,139,74
2021,164988,40,2,228,118,110
2021,164988,40,3,742,273,469
2021,164988,40,4,144,41,103
2021,164988,40,5,377,174,203
2021,164988,40,6,433,196,237
2021,164988,41,0,1995,869,1126
2021,164988,41,1,205,133,72
2021,164988,41,2,210,107,103
2021,164988,41,3,704,252,452
2021,164988,41,4,140,39,101
2021,164988,41,5,352,162,190
2021,164988,41,6,384,176,208
2021,164988,42,0,138,71,67
2021,164988,42,1,8,6,2
2021,164988,42,2,18,11,7
2021,164988,42,3,38,21,17
2021,164988,42,4,4,2,2
2021,164988,42,5,23,11,12
2021,164988,42,6,47,20,27
2021,164988,43,0,4,1,3
2021,164988,43,5,2,1,1
2021,164988,43,6,2,0,2
2021,164988,44,0,914,434,480
2021,164988,44,1,94,59,35
2021,164988,44,2,104,53,51
2021,164988,44,3,122,60,62
2021,164988,44,4,5,1,4
2021,164988,44,5,352,162,190
2021,164988,44,6,237,99,138
2021,164988,45,0,1081,435,646
2021,164988,45,1,111,74,37
2021,164988,45,2,106,54,52
2021,164988,45,3,582,192,390
2021,164988,45,4,135,38,97
2021,164988,45,6,147,77,70
2021,164988,50,0,10,1,9
2021,165015,0,0,389,203,186
2021,165015,10,0,389,203,186
2021,165015,10,1,148,87,61
2021,165015,10,2,105,54,51
2021,165015,10,3,87,40,47
2021,165015,10,4,2,2,0
2021,165015,10,5,47,20,27
2021,165015,20,0,190,115,75
2021,165015,20,1,119,74,45
2021,165015,20,2,71,41,30
2021,165015,30,0,71,34,37
2021,165015,30,1,1,0,1
2021,165015,30,2,2,0,2
2021,165015,30,3,68,34,34
2021,165015,40,0,128,54,74
2021,165015,40,1,28,13,15
2021,165015,40,2,32,13,19
2021,165015,40,3,19,6,13
2021,165015,40,4,2,2,0
2021,165015,40,5,47,20,27
2021,165015,41,0,114,46,68
2021,165015,41,1,28,13,15
2021,165015,41,2,31,13,18
2021,165015,41,3,15,3,12
2021,165015,41,4,2,2,0
2021,165015,41,5,38,15,23
2021,165015,42,0,14,8,6
2021,165015,42,2,1,0,1
2021,165015,42,3,4,3,1
2021,165015,42,5,9,5,4
2021,165015,44,0,114,46,68
2021,165015,44,1,28,13,15
2021,165015,44,2,31,13,18
2021,165015,44,3,15,3,12
2021,165015,44,4,2,2,0
2021,165015,44,5,38,15,23
2021,165024,0,0,338,151,187
2021,165024,10,0,338,151,187
2021,165024,10,1,139,71,68
2021,165024,10,2,106,48,58
2021,165024,10,3,86,30,56
2021,165024,10,4,7,2,5
2021,165024,20,0,246,119,127
2021,165024,20,1,139,71,68
2021,165024,20,2,101,47,54
2021,165024,20,3,5,1,4
2021,165024,20,4,1,0,1
2021,165024,30,0,75,26,49
2021,165024,30,2,5,1,4
2021,165024,30,3,70,25,45
2021,165024,40,0,17,6,11
2021,165024,40,3,11,4,7
2021,165024,40,4,6,2,4
2021,165024,42,0,17,6,11
2021,165024,42,3,11,4,7
2021,165024,42,4,6,2,4
2021,165033,0,0,116,41,75
2021,165033,10,0,116,41,75
2021,165033,10,1,51,17,34
2021,165033,10,2,38,16,22
2021,165033,10,3,26,7,19
2021,165033,10,4,1,1,0
2021,165033,20,0,76,27,49
2021,165033,20,1,49,17,32
2021,165033,20,2,26,9,17
2021,165033,20,3,1,1,0
2021,165033,30,0,40,14,26
2021,165033,30,1,2,0,2
2021,165033,30,2,12,7,5
2021,165033,30,3,25,6,19
2021,165033,30,4,1,1,0
2021,165112,0,0,142,55,87
2021,165112,10,0,142,55,87
2021,165112,10,1,98,39,59
2021,165112,10,2,23,10,13
2021,165112,10,3,21,6,15
2021,165112,20,0,101,43,58
2021,165112,20,1,93,38,55
2021,165112,20,2,5,4,1
2021,165112,20,3,3,1,2
2021,165112,30,0,41,12,29
2021,165112,30,1,5,1,4
2021,165112,30,2,18,6,12
2021,165112,30,3,18,5,13
2021,165167,0,0,16,6,10
2021,165167,10,0,16,6,10
2021,165167,10,1,12,5,7
2021,165167,10,2,1,0,1
2021,165167,10,3,2,1,1
2021,165167,10,5,1,0,1
2021,165167,40,0,16,6,10
2021,165167,40,1,12,5,7
2021,165167,40,2,1,0,1
2021,165167,40,3,2,1,1
2021,165167,40,5,1,0,1
2021,165167,41,0,15,6,9
2021,165167,41,1,12,5,7
2021,165167,41,2,1,0,1
2021,165167,41,3,2,1,1
2021,165167,42,0,1,0,1
2021,165167,42,5,1,0,1
2021,165167,45,0,15,6,9
2021,165167,45,1,12,5,7
2021,165167,45,2,1,0,1
2021,165167,45,3,2,1,1
2021,165194,0,0,68,30,38
2021,165194,10,0,68,30,38
2021,165194,10,1,30,15,15
2021,165194,10,2,29,11,18
2021,165194,10,3,6,3,3
2021,165194,10,4,3,1,2
2021,165194,20,0,39,19,20
2021,165194,20,1,26,14,12
2021,165194,20,2,13,5,8
2021,165194,30,0,29,11,18
2021,165194,30,1,4,1,3
2021,165194,30,2,16,6,10
2021,165194,30,3,6,3,3
2021,165194,30,4,3,1,2
2021,165264,0,0,34,4,30
2021,165264,10,0,34,4,30
2021,165264,10,2,7,2,5
2021,165264,10,3,27,2,25
2021,165264,40,0,34,4,30
2021,165264,40,2,7,2,5
2021,165264,40,3,27,2,25
2021,165264,42,0,34,4,30
2021,165264,42,2,7,2,5
2021,165264,42,3,27,2,25
2021,165334,0,0,229,127,102
2021,165334,10,0,229,127,102
2021,165334,10,1,69,43,26
2021,165334,10,2,60,32,28
2021,165334,10,3,39,18,21
2021,165334,10,4,27,12,15
2021,165334,10,5,34,22,12
2021,165334,20,0,129,75,54
2021,165334,20,1,69,43,26
2021,165334,20,2,60,32,28
2021,165334,30,0,38,18,20
2021,165334,30,3,38,18,20
2021,165334,40,0,62,34,28
2021,165334,40,3,1,0,1
2021,165334,40,4,27,12,15
2021,165334,40,5,34,22,12
2021,165334,41,0,35,22,13
2021,165334,41,3,1,0,1
2021,165334,41,5,34,22,12
2021,165334,42,0,27,12,15
2021,165334,42,4,27,12,15
2021,165334,44,0,35,22,13
2021,165334,44,3,1,0,1
2021,165334,44,5,34,22,12
2021,165529,0,0,103,21,82
2021,165529,10,0,103,21,82
2021,165529,10,1,48,9,39
2021,165529,10,2,26,6,20
2021,165529,10,3,26,6,20
2021,165529,10,4,3,0,3
2021,165529,40,0,103,21,82
2021,165529,40,1,48,9,39
2021,165529,40,2,26,6,20
2021,165529,40,3,26,6,20
2021,165529,40,4,3,0,3
2021,165529,41,0,92,18,74
2021,165529,41,1,47,9,38
2021,165529,41,2,26,6,20
2021,165529,41,3,16,3,13
2021,165529,41,4,3,0,3
2021,165529,42,0,10,3,7
2021,165529,42,1,1,0,1
2021,165529,42,3,9,3,6
2021,165529,43,0,1,0,1
2021,165529,43,3,1,0,1
2021,165529,44,0,92,18,74
2021,165529,44,1,47,9,38
2021,165529,44,2,26,6,20
2021,165529,44,3,16,3,13
2021,165529,44,4,3,0,3
2021,165574,0,0,30,15,15
2021,165574,10,0,30,15,15
2021,165574,10,1,4,2,2
2021,165574,10,2,8,4,4
2021,165574,10,3,17,8,9
2021,165574,10,4,1,1,0
2021,165574,40,0,30,15,15
2021,165574,40,1,4,2,2
2021,165574,40,2,8,4,4
2021,165574,40,3,17,8,9
2021,165574,40,4,1,1,0
2021,165574,42,0,30,15,15
2021,165574,42,1,4,2,2
2021,165574,42,2,8,4,4
2021,165574,42,3,17,8,9
2021,165574,42,4,1,1,0
2021,165644,0,0,28,18,10
2021,165644,10,0,28,18,10
2021,165644,10,1,5,5,0
2021,165644,10,2,7,2,5
2021,165644,10,3,13,10,3
2021,165644,10,4,3,1,2
2021,165644,20,0,5,5,0
2021,165644,20,1,5,5,0
2021,165644,30,0,10,5,5
2021,165644,30,2,5,1,4
2021,165644,30,3,5,4,1
2021,165644,40,0,13,8,5
2021,165644,40,2,2,1,1
2021,165644,40,3,8,6,2
2021,165644,40,4,3,1,2
2021,165644,41,0,1,1,0
2021,165644,41,3,1,1,0
2021,165644,42,0,12,7,5
2021,165644,42,2,2,1,1
2021,165644,42,3,7,5,2
2021,165644,42,4,3,1,2
2021,165644,44,0,1,1,0
2021,165644,44,3,1,1,0
2021,165662,0,0,224,111,113
2021,165662,10,0,224,111,113
2021,165662,10,1,43,22,21
2021,165662,10,2,73,43,30
2021,165662,10,3,53,22,31
2021,165662,10,5,55,24,31
2021,165662,20,0,117,66,51
2021,165662,20,1,43,22,21
2021,165662,20,2,73,43,30
2021,165662,20,3,1,1,0
2021,165662,30,0,52,21,31
2021,165662,30,3,52,21,31
2021,165662,40,0,55,24,31
2021,165662,40,5,55,24,31
2021,165662,42,0,55,24,31
2021,165662,42,5,55,24,31
2021,165671,0,0,106,41,65
2021,165671,10,0,106,41,65
2021,165671,10,1,15,3,12
2021,165671,10,2,36,20,16
2021,165671,10,3,34,10,24
2021,165671,10,5,21,8,13
2021,165671,20,0,45,21,24
2021,165671,20,1,15,3,12
2021,165671,20,2,30,18,12
2021,165671,30,0,14,2,12
2021,165671,30,2,1,0,1
2021,165671,30,3,13,2,11
2021,165671,40,0,47,18,29
2021,165671,40,2,5,2,3
2021,165671,40,3,21,8,13
2021,165671,40,5,21,8,13
2021,165671,42,0,47,18,29
2021,165671,42,2,5,2,3
2021,165671,42,3,21,8,13
2021,165671,42,5,21,8,13
2021,165699,0,0,113,45,68
2021,165699,10,0,113,45,68
2021,165699,10,1,47,23,24
2021,165699,10,2,25,11,14
2021,165699,10,3,40,11,29
2021,165699,10,4,1,0,1
2021,165699,40,0,113,45,68
2021,165699,40,1,47,23,24
2021,165699,40,2,25,11,14
2021,165699,40,3,40,11,29
2021,165699,40,4,1,0,1
2021,165699,41,0,113,45,68
2021,165699,41,1,47,23,24
2021,165699,41,2,25,11,14
2021,165699,41,3,40,11,29
2021,165699,41,4,1,0,1
2021,165699,45,0,113,45,68
2021,165699,45,1,47,23,24
2021,165699,45,2,25,11,14
2021,165699,45,3,40,11,29
2021,165699,45,4,1,0,1
2021,165802,0,0,35,13,22
2021,165802,10,0,35,13,22
2021,165802,10,2,13,5,8
2021,165802,10,3,22,8,14
2021,165802,40,0,35,13,22
2021,165802,40,2,13,5,8
2021,165802,40,3,22,8,14
2021,165802,42,0,35,13,22
2021,165802,42,2,13,5,8
2021,165802,42,3,22,8,14
2021,165820,0,0,191,91,100
2021,165820,10,0,191,91,100
2021,165820,10,1,64,39,25
2021,165820,10,2,71,35,36
2021,165820,10,3,44,16,28
2021,165820,10,4,12,1,11
2021,165820,20,0,130,72,58
2021,165820,20,1,64,39,25
2021,165820,20,2,66,33,33
2021,165820,30,0,48,17,31
2021,165820,30,2,5,2,3
2021,165820,30,3,43,15,28
2021,165820,40,0,13,2,11
2021,165820,40,3,1,1,0
2021,165820,40,4,12,1,11
2021,165820,42,0,13,2,11
2021,165820,42,3,1,1,0
2021,165820,42,4,12,1,11
2021,165866,0,0,179,75,104
2021,165866,10,0,179,75,104
2021,165866,10,1,65,26,39
2021,165866,10,2,67,34,33
2021,165866,10,3,47,15,32
2021,165866,20,0,132,61,71
2021,165866,20,1,65,26,39
2021,165866,20,2,65,34,31
2021,165866,20,3,2,1,1
2021,165866,30,0,33,10,23
2021,165866,30,2,2,0,2
2021,165866,30,3,31,10,21
2021,165866,40,0,14,4,10
2021,165866,40,3,14,4,10
2021,165866,41,0,14,4,10
2021,165866,41,3,14,4,10
2021,165866,44,0,14,4,10
2021,165866,44,3,14,4,10
2021,165884,0,0,29,24,5
2021,165884,10,0,29,24,5
2021,165884,10,1,5,3,2
2021,165884,10,2,8,8,0
2021,165884,10,3,7,5,2
2021,165884,10,4,9,8,1
2021,165884,40,0,29,24,5
2021,165884,40,1,5,3,2
2021,165884,40,2,8,8,0
2021,165884,40,3,7,5,2
2021,165884,40,4,9,8,1
2021,165884,42,0,29,24,5
2021,165884,42,1,5,3,2
2021,165884,42,2,8,8,0
2021,165884,42,3,7,5,2
2021,165884,42,4,9,8,1
2021,165936,0,0,74,40,34
2021,165936,10,0,74,40,34
2021,165936,10,1,35,23,12
2021,165936,10,2,17,9,8
2021,165936,10,3,19,8,11
2021,165936,10,4,1,0,1
2021,165936,10,6,2,0,2
2021,165936,20,0,35,23,12
2021,165936,20,1,31,21,10
2021,165936,20,2,4,2,2
2021,165936,30,0,9,4,5
2021,165936,30,1,1,1,0
2021,165936,30,2,5,2,3
2021,165936,30,3,3,1,2
2021,165936,40,0,30,13,17
2021,165936,40,1,3,1,2
2021,165936,40,2,8,5,3
2021,165936,40,3,16,7,9
2021,165936,40,4,1,0,1
2021,165936,40,6,2,0,2
2021,165936,42,0,30,13,17
2021,165936,42,1,3,1,2
2021,165936,42,2,8,5,3
2021,165936,42,3,16,7,9
2021,165936,42,4,1,0,1
2021,165936,42,6,2,0,2
2021,165945,0,0,26,15,11
2021,165945,10,0,26,15,11
2021,165945,10,1,14,10,4
2021,165945,10,2,9,4,5
2021,165945,10,3,2,1,1
2021,165945,10,4,1,0,1
2021,165945,20,0,18,12,6
2021,165945,20,1,13,10,3
2021,165945,20,2,5,2,3
2021,165945,30,0,6,3,3
2021,165945,30,2,4,2,2
2021,165945,30,3,2,1,1
2021,165945,40,0,2,0,2
2021,165945,40,1,1,0,1
2021,165945,40,4,1,0,1
2021,165945,42,0,2,0,2
2021,165945,42,1,1,0,1
2021,165945,42,4,1,0,1
2021,165981,0,0,44,13,31
2021,165981,10,0,44,13,31
2021,165981,10,1,28,8,20
2021,165981,10,2,9,2,7
2021,165981,10,3,6,3,3
2021,165981,10,4,1,0,1
2021,165981,20,0,34,10,24
2021,165981,20,1,28,8,20
2021,165981,20,2,6,2,4
2021,165981,30,0,10,3,7
2021,165981,30,2,3,0,3
2021,165981,30,3,6,3,3
2021,165981,30,4,1,0,1
2021,166018,0,0,41,18,23
2021,166018,10,0,41,18,23
2021,166018,10,1,10,3,7
2021,166018,10,2,17,7,10
2021,166018,10,3,10,5,5
2021,166018,10,5,4,3,1
2021,166018,40,0,41,18,23
2021,166018,40,1,10,3,7
2021,166018,40,2,17,7,10
2021,166018,40,3,10,5,5
2021,166018,40,5,4,3,1
2021,166018,41,0,34,15,19
2021,166018,41,1,10,3,7
2021,166018,41,2,17,7,10
2021,166018,41,3,3,2,1
2021,166018,41,5,4,3,1
2021,166018,42,0,7,3,4
2021,166018,42,3,7,3,4
2021,166018,44,0,34,15,19
2021,166018,44,1,10,3,7
2021,166018,44,2,17,7,10
2021,166018,44,3,3,2,1
2021,166018,44,5,4,3,1
2021,166027,0,0,2130,1343,787
2021,166027,10,0,2130,1343,787
2021,166027,10,1,1178,847,331
2021,166027,10,2,171,96,75
2021,166027,10,3,263,145,118
2021,166027,10,4,206,95,111
2021,166027,10,5,312,160,152
2021,166027,20,0,1070,776,294
2021,166027,20,1,1070,776,294
2021,166027,30,0,396,221,175
2021,166027,30,2,159,90,69
2021,166027,30,3,237,131,106
2021,166027,40,0,664,346,318
2021,166027,40,1,108,71,37
2021,166027,40,2,12,6,6
2021,166027,40,3,26,14,12
2021,166027,40,4,206,95,111
2021,166027,40,5,312,160,152
2021,166027,41,0,301,174,127
2021,166027,41,1,96,61,35
2021,166027,41,2,7,3,4
2021,166027,41,3,20,12,8
2021,166027,41,4,69,33,36
2021,166027,41,5,109,65,44
2021,166027,42,0,363,172,191
2021,166027,42,1,12,10,2
2021,166027,42,2,5,3,2
2021,166027,42,3,6,2,4
2021,166027,42,4,137,62,75
2021,166027,42,5,203,95,108
2021,166027,44,0,295,170,125
2021,166027,44,1,90,57,33
2021,166027,44,2,7,3,4
2021,166027,44,3,20,12,8
2021,166027,44,4,69,33,36
2021,166027,44,5,109,65,44
2021,166027,45,0,6,4,2
2021,166027,45,1,6,4,2
2021,166045,0,0,9,5,4
2021,166045,10,0,9,5,4
2021,166045,10,1,2,2,0
2021,166045,10,3,2,0,2
2021,166045,10,4,5,3,2
2021,166045,20,0,3,1,2
2021,166045,20,1,1,1,0
2021,166045,20,3,2,0,2
2021,166045,40,0,6,4,2
2021,166045,40,1,1,1,0
2021,166045,40,4,5,3,2
2021,166045,41,0,6,4,2
2021,166045,41,1,1,1,0
2021,166045,41,4,5,3,2
2021,166045,45,0,6,4,2
2021,166045,45,1,1,1,0
2021,166045,45,4,5,3,2
2021,166054,0,0,12,9,3
2021,166054,10,0,12,9,3
2021,166054,10,1,12,9,3
2021,166054,20,0,4,3,1
2021,166054,20,1,4,3,1
2021,166054,30,0,7,5,2
2021,166054,30,1,7,5,2
2021,166054,40,0,1,1,0
2021,166054,40,1,1,1,0
2021,166054,41,0,1,1,0
2021,166054,41,1,1,1,0
2021,166054,44,0,1,1,0
2021,166054,44,1,1,1,0
2021,166124,0,0,306,153,153
2021,166124,10,0,306,153,153
2021,166124,10,1,97,53,44
2021,166124,10,2,88,47,41
2021,166124,10,3,89,40,49
2021,166124,10,4,6,5,1
2021,166124,10,5,26,8,18
2021,166124,20,0,182,99,83
2021,166124,20,1,94,52,42
2021,166124,20,2,88,47,41
2021,166124,30,0,40,17,23
2021,166124,30,3,40,17,23
2021,166124,40,0,84,37,47
2021,166124,40,1,3,1,2
2021,166124,40,3,49,23,26
2021,166124,40,4,6,5,1
2021,166124,40,5,26,8,18
2021,166124,41,0,28,9,19
2021,166124,41,3,2,1,1
2021,166124,41,5,26,8,18
2021,166124,42,0,56,28,28
2021,166124,42,1,3,1,2
2021,166124,42,3,47,22,25
2021,166124,42,4,6,5,1
2021,166124,44,0,2,1,1
2021,166124,44,3,2,1,1
2021,166124,45,0,26,8,18
2021,166124,45,5,26,8,18
2021,166133,0,0,107,32,75
2021,166133,10,0,107,32,75
2021,166133,10,1,69,21,48
2021,166133,10,2,14,5,9
2021,166133,10,3,17,4,13
2021,166133,10,4,7,2,5
2021,166133,20,0,81,25,56
2021,166133,20,1,69,21,48
2021,166133,20,2,11,4,7
2021,166133,20,3,1,0,1
2021,166133,30,0,25,7,18
2021,166133,30,2,3,1,2
2021,166133,30,3,16,4,12
2021,166133,30,4,6,2,4
2021,166133,40,0,1,0,1
2021,166133,40,4,1,0,1
2021,166133,42,0,1,0,1
2021,166133,42,4,1,0,1
2021,166391,0,0,74,30,44
2021,166391,10,0,74,30,44
2021,166391,10,1,16,5,11
2021,166391,10,2,31,13,18
2021,166391,10,3,25,11,14
2021,166391,10,4,2,1,1
2021,166391,40,0,74,30,44
2021,166391,40,1,16,5,11
2021,166391,40,2,31,13,18
2021,166391,40,3,25,11,14
2021,166391,40,4,2,1,1
2021,166391,41,0,66,25,41
2021,166391,41,1,16,5,11
2021,166391,41,2,30,12,18
2021,166391,41,3,20,8,12
2021,166391,42,0,8,5,3
2021,166391,42,2,1,1,0
2021,166391,42,3,5,3,2
2021,166391,42,4,2,1,1
2021,166391,44,0,66,25,41
2021,166391,44,1,16,5,11
2021,166391,44,2,30,12,18
2021,166391,44,3,20,8,12
2021,166407,0,0,35,4,31
2021,166407,10,0,35,4,31
2021,166407,10,2,1,0,1
2021,166407,10,3,31,2,29
2021,166407,10,4,3,2,1
2021,166407,40,0,35,4,31
2021,166407,40,2,1,0,1
2021,166407,40,3,31,2,29
2021,166407,40,4,3,2,1
2021,166407,41,0,35,4,31
2021,166407,41,2,1,0,1
2021,166407,41,3,31,2,29
2021,166407,41,4,3,2,1
2021,166407,44,0,35,4,31
2021,166407,44,2,1,0,1
2021,166407,44,3,31,2,29
2021,166407,44,4,3,2,1
2021,166452,0,0,140,53,87
2021,166452,10,0,140,53,87
2021,166452,10,1,42,19,23
2021,166452,10,2,41,18,23
2021,166452,10,3,42,10,32
2021,166452,10,4,15,6,9
2021,166452,40,0,140,53,87
2021,166452,40,1,42,19,23
2021,166452,40,2,41,18,23
2021,166452,40,3,42,10,32
2021,166452,40,4,15,6,9
2021,166452,41,0,127,47,80
2021,166452,41,1,42,19,23
2021,166452,41,2,41,18,23
2021,166452,41,3,38,9,29
2021,166452,41,4,6,1,5
2021,166452,42,0,13,6,7
2021,166452,42,3,4,1,3
2021,166452,42,4,9,5,4
2021,166452,44,0,127,47,80
2021,166452,44,1,42,19,23
2021,166452,44,2,41,18,23
2021,166452,44,3,38,9,29
2021,166452,44,4,6,1,5
2021,166489,0,0,11,6,5
2021,166489,10,0,11,6,5
2021,166489,10,1,11,6,5
2021,166489,40,0,11,6,5
2021,166489,40,1,11,6,5
2021,166489,41,0,11,6,5
2021,166489,41,1,11,6,5
2021,166489,44,0,11,6,5
2021,166489,44,1,11,6,5
2021,166513,0,0,627,340,287
2021,166513,10,0,624,340,284
2021,166513,10,1,148,107,41
2021,166513,10,2,172,90,82
2021,166513,10,3,132,70,62
2021,166513,10,4,10,0,10
2021,166513,10,5,127,56,71
2021,166513,10,6,35,17,18
2021,166513,20,0,290,181,109
2021,166513,20,1,138,101,37
2021,166513,20,2,152,80,72
2021,166513,30,0,148,83,65
2021,166513,30,1,5,5,0
2021,166513,30,2,13,8,5
2021,166513,30,3,130,70,60
2021,166513,40,0,186,76,110
2021,166513,40,1,5,1,4
2021,166513,40,2,7,2,5
2021,166513,40,3,2,0,2
2021,166513,40,4,10,0,10
2021,166513,40,5,127,56,71
2021,166513,40,6,35,17,18
2021,166513,41,0,11,2,9
2021,166513,41,1,5,1,4
2021,166513,41,2,6,1,5
2021,166513,42,0,175,74,101
2021,166513,42,2,1,1,0
2021,166513,42,3,2,0,2
2021,166513,42,4,10,0,10
2021,166513,42,5,127,56,71
2021,166513,42,6,35,17,18
2021,166513,45,0,11,2,9
2021,166513,45,1,5,1,4
2021,166513,45,2,6,1,5
2021,166513,50,0,3,0,3
2021,166629,0,0,1460,784,676
2021,166629,10,0,1460,784,676
2021,166629,10,1,479,328,151
2021,166629,10,2,344,170,174
2021,166629,10,3,276,132,144
2021,166629,10,4,2,0,2
2021,166629,10,5,359,154,205
2021,166629,20,0,803,491,312
2021,166629,20,1,478,327,151
2021,166629,20,2,324,163,161
2021,166629,20,3,1,1,0
2021,166629,30,0,271,135,136
2021,166629,30,2,8,4,4
2021,166629,30,3,263,131,132
2021,166629,40,0,386,158,228
2021,166629,40,1,1,1,0
2021,166629,40,2,12,3,9
2021,166629,40,3,12,0,12
2021,166629,40,4,2,0,2
2021,166629,40,5,359,154,205
2021,166629,41,0,360,147,213
2021,166629,41,1,1,1,0
2021,166629,41,2,12,3,9
2021,166629,41,3,10,0,10
2021,166629,41,4,1,0,1
2021,166629,41,5,336,143,193
2021,166629,42,0,26,11,15
2021,166629,42,3,2,0,2
2021,166629,42,4,1,0,1
2021,166629,42,5,23,11,12
2021,166629,44,0,360,147,213
2021,166629,44,1,1,1,0
2021,166629,44,2,12,3,9
2021,166629,44,3,10,0,10
2021,166629,44,4,1,0,1
2021,166629,44,5,336,143,193
2021,166638,0,0,699,328,371
2021,166638,10,0,699,328,371
2021,166638,10,1,119,72,47
2021,166638,10,2,226,114,112
2021,166638,10,3,119,51,68
2021,166638,10,5,218,86,132
2021,166638,10,6,17,5,12
2021,166638,20,0,345,185,160
2021,166638,20,1,119,72,47
2021,166638,20,2,224,113,111
2021,166638,20,3,2,0,2
2021,166638,30,0,119,52,67
2021,166638,30,2,2,1,1
2021,166638,30,3,117,51,66
2021,166638,40,0,235,91,144
2021,166638,40,5,218,86,132
2021,166638,40,6,17,5,12
2021,166638,41,0,5,1,4
2021,166638,41,5,3,1,2
2021,166638,41,6,2,0,2
2021,166638,42,0,124,50,74
2021,166638,42,5,115,46,69
2021,166638,42,6,9,4,5
2021,166638,43,0,106,40,66
2021,166638,43,5,100,39,61
2021,166638,43,6,6,1,5
2021,166638,44,0,5,1,4
2021,166638,44,5,3,1,2
2021,166638,44,6,2,0,2
2021,166647,0,0,69,32,37
2021,166647,10,0,69,32,37
2021,166647,10,1,29,13,16
2021,166647,10,2,16,8,8
2021,166647,10,3,24,11,13
2021,166647,20,0,39,19,20
2021,166647,20,1,28,13,15
2021,166647,20,2,8,5,3
2021,166647,20,3,3,1,2
2021,166647,30,0,30,13,17
2021,166647,30,1,1,0,1
2021,166647,30,2,8,3,5
2021,166647,30,3,21,10,11
2021,166656,0,0,293,98,195
2021,166656,10,0,293,98,195
2021,166656,10,1,65,26,39
2021,166656,10,2,90,32,58
2021,166656,10,3,113,30,83
2021,166656,10,4,17,6,11
2021,166656,10,6,8,4,4
2021,166656,40,0,293,98,195
2021,166656,40,1,65,26,39
2021,166656,40,2,90,32,58
2021,166656,40,3,113,30,83
2021,166656,40,4,17,6,11
2021,166656,40,6,8,4,4
2021,166656,41,0,282,97,185
2021,166656,41,1,64,26,38
2021,166656,41,2,90,32,58
2021,166656,41,3,105,29,76
2021,166656,41,4,16,6,10
2021,166656,41,6,7,4,3
2021,166656,42,0,11,1,10
2021,166656,42,1,1,0,1
2021,166656,42,3,8,1,7
2021,166656,42,4,1,0,1
2021,166656,42,6,1,0,1
2021,166656,44,0,282,97,185
2021,166656,44,1,64,26,38
2021,166656,44,2,90,32,58
2021,166656,44,3,105,29,76
2021,166656,44,4,16,6,10
2021,166656,44,6,7,4,3
2021,166674,0,0,119,57,62
2021,166674,10,0,119,57,62
2021,166674,10,1,55,30,25
2021,166674,10,2,24,12,12
2021,166674,10,3,40,15,25
2021,166674,20,0,57,31,26
2021,166674,20,1,55,30,25
2021,166674,20,2,2,1,1
2021,166674,30,0,29,12,17
2021,166674,30,2,19,9,10
2021,166674,30,3,10,3,7
2021,166674,40,0,33,14,19
2021,166674,40,2,3,2,1
2021,166674,40,3,30,12,18
2021,166674,42,0,33,14,19
2021,166674,42,2,3,2,1
2021,166674,42,3,30,12,18
2021,166683,0,0,1381,987,394
2021,166683,10,0,1043,773,270
2021,166683,10,1,669,530,139
2021,166683,10,2,206,142,64
2021,166683,10,3,167,100,67
2021,166683,10,6,1,1,0
2021,166683,20,0,794,616,178
2021,166683,20,1,669,530,139
2021,166683,20,2,125,86,39
2021,166683,30,0,238,148,90
2021,166683,30,2,76,52,24
2021,166683,30,3,162,96,66
2021,166683,40,0,11,9,2
2021,166683,40,2,5,4,1
2021,166683,40,3,5,4,1
2021,166683,40,6,1,1,0
2021,166683,41,0,11,9,2
2021,166683,41,2,5,4,1
2021,166683,41,3,5,4,1
2021,166683,41,6,1,1,0
2021,166683,44,0,11,9,2
2021,166683,44,2,5,4,1
2021,166683,44,3,5,4,1
2021,166683,44,6,1,1,0
2021,166683,50,0,338,214,124
2021,166692,0,0,90,60,30
2021,166692,10,0,84,54,30
2021,166692,10,1,34,24,10
2021,166692,10,2,25,15,10
2021,166692,10,3,21,13,8
2021,166692,10,4,4,2,2
2021,166692,20,0,54,36,18
2021,166692,20,1,33,24,9
2021,166692,20,2,20,12,8
2021,166692,20,3,1,0,1
2021,166692,30,0,30,18,12
2021,166692,30,1,1,0,1
2021,166692,30,2,5,3,2
2021,166692,30,3,20,13,7
2021,166692,30,4,4,2,2
2021,166692,50,0,6,6,0
2021,166708,0,0,1360,753,607
2021,166708,10,0,1095,612,483
2021,166708,10,1,224,149,75
2021,166708,10,2,210,129,81
2021,166708,10,3,615,315,300
2021,166708,10,4,46,19,27
2021,166708,20,0,130,93,37
2021,166708,20,1,112,80,32
2021,166708,20,2,18,13,5
2021,166708,30,0,75,44,31
2021,166708,30,1,13,8,5
2021,166708,30,2,20,15,5
2021,166708,30,3,42,21,21
2021,166708,40,0,890,475,415
2021,166708,40,1,99,61,38
2021,166708,40,2,172,101,71
2021,166708,40,3,573,294,279
2021,166708,40,4,46,19,27
2021,166708,41,0,888,473,415
2021,166708,41,1,98,60,38
2021,166708,41,2,172,101,71
2021,166708,41,3,572,293,279
2021,166708,41,4,46,19,27
2021,166708,43,0,2,2,0
2021,166708,43,1,1,1,0
2021,166708,43,3,1,1,0
2021,166708,45,0,888,473,415
2021,166708,45,1,98,60,38
2021,166708,45,2,172,101,71
2021,166708,45,3,572,293,279
2021,166708,45,4,46,19,27
2021,166708,50,0,265,141,124
2021,166717,0,0,75,20,55
2021,166717,10,0,75,20,55
2021,166717,10,1,7,3,4
2021,166717,10,2,26,7,19
2021,166717,10,3,20,5,15
2021,166717,10,4,22,5,17
2021,166717,40,0,75,20,55
2021,166717,40,1,7,3,4
2021,166717,40,2,26,7,19
2021,166717,40,3,20,5,15
2021,166717,40,4,22,5,17
2021,166717,41,0,75,20,55
2021,166717,41,1,7,3,4
2021,166717,41,2,26,7,19
2021,166717,41,3,20,5,15
2021,166717,41,4,22,5,17
2021,166717,44,0,75,20,55
2021,166717,44,1,7,3,4
2021,166717,44,2,26,7,19
2021,166717,44,3,20,5,15
2021,166717,44,4,22,5,17
2021,166823,0,0,103,46,57
2021,166823,10,0,103,46,57
2021,166823,10,1,43,25,18
2021,166823,10,2,41,16,25
2021,166823,10,3,13,3,10
2021,166823,10,4,6,2,4
2021,166823,20,0,86,42,44
2021,166823,20,1,41,23,18
2021,166823,20,2,40,16,24
2021,166823,20,3,5,3,2
2021,166823,30,0,17,4,13
2021,166823,30,1,2,2,0
2021,166823,30,2,1,0,1
2021,166823,30,3,8,0,8
2021,166823,30,4,6,2,4
2021,166850,0,0,198,90,108
2021,166850,10,0,198,90,108
2021,166850,10,1,31,19,12
2021,166850,10,2,79,36,43
2021,166850,10,3,64,27,37
2021,166850,10,5,24,8,16
2021,166850,20,0,93,50,43
2021,166850,20,1,27,17,10
2021,166850,20,2,66,33,33
2021,166850,30,0,43,19,24
2021,166850,30,3,43,19,24
2021,166850,40,0,62,21,41
2021,166850,40,1,4,2,2
2021,166850,40,2,13,3,10
2021,166850,40,3,21,8,13
2021,166850,40,5,24,8,16
2021,166850,42,0,62,21,41
2021,166850,42,1,4,2,2
2021,166850,42,2,13,3,10
2021,166850,42,3,21,8,13
2021,166850,42,5,24,8,16
2021,166869,0,0,111,17,94
2021,166869,10,0,111,17,94
2021,166869,10,1,15,1,14
2021,166869,10,2,26,6,20
2021,166869,10,3,52,8,44
2021,166869,10,4,18,2,16
2021,166869,40,0,111,17,94
2021,166869,40,1,15,1,14
2021,166869,40,2,26,6,20
2021,166869,40,3,52,8,44
2021,166869,40,4,18,2,16
2021,166869,41,0,111,17,94
2021,166869,41,1,15,1,14
2021,166869,41,2,26,6,20
2021,166869,41,3,52,8,44
2021,166869,41,4,18,2,16
2021,166869,44,0,111,17,94
2021,166869,44,1,15,1,14
2021,166869,44,2,26,6,20
2021,166869,44,3,52,8,44
2021,166869,44,4,18,2,16
2021,166887,0,0,104,32,72
2021,166887,10,0,104,32,72
2021,166887,10,1,71,23,48
2021,166887,10,2,23,7,16
2021,166887,10,3,10,2,8
2021,166887,20,0,74,24,50
2021,166887,20,1,71,23,48
2021,166887,20,2,3,1,2
2021,166887,30,0,30,8,22
2021,166887,30,2,20,6,14
2021,166887,30,3,10,2,8
2021,166911,0,0,18,8,10
2021,166911,10,0,18,8,10
2021,166911,10,1,12,6,6
2021,166911,10,2,4,2,2
2021,166911,10,3,2,0,2
2021,166911,40,0,18,8,10
2021,166911,40,1,12,6,6
2021,166911,40,2,4,2,2
2021,166911,40,3,2,0,2
2021,166911,41,0,18,8,10
2021,166911,41,1,12,6,6
2021,166911,41,2,4,2,2
2021,166911,41,3,2,0,2
2021,166911,44,0,18,8,10
2021,166911,44,1,12,6,6
2021,166911,44,2,4,2,2
2021,166911,44,3,2,0,2
2021,166939,0,0,216,84,132
2021,166939,10,0,216,84,132
2021,166939,10,1,62,27,35
2021,166939,10,2,50,22,28
2021,166939,10,3,45,15,30
2021,166939,10,4,7,1,6
2021,166939,10,5,45,17,28
2021,166939,10,6,7,2,5
2021,166939,20,0,103,47,56
2021,166939,20,1,59,27,32
2021,166939,20,2,43,20,23
2021,166939,20,6,1,0,1
2021,166939,30,0,52,17,35
2021,166939,30,2,6,2,4
2021,166939,30,3,45,15,30
2021,166939,30,5,1,0,1
2021,166939,40,0,61,20,41
2021,166939,40,1,3,0,3
2021,166939,40,2,1,0,1
2021,166939,40,4,7,1,6
2021,166939,40,5,44,17,27
2021,166939,40,6,6,2,4
2021,166939,41,0,39,11,28
2021,166939,41,1,2,0,2
2021,166939,41,4,6,1,5
2021,166939,41,5,28,8,20
2021,166939,41,6,3,2,1
2021,166939,42,0,22,9,13
2021,166939,42,1,1,0,1
2021,166939,42,2,1,0,1
2021,166939,42,4,1,0,1
2021,166939,42,5,16,9,7
2021,166939,42,6,3,0,3
2021,166939,44,0,30,9,21
2021,166939,44,1,2,0,2
2021,166939,44,4,3,0,3
2021,166939,44,5,23,8,15
2021,166939,44,6,2,1,1
2021,166939,45,0,9,2,7
2021,166939,45,4,3,1,2
2021,166939,45,5,5,0,5
2021,166939,45,6,1,1,0
2021,166957,0,0,62,22,40
2021,166957,10,0,62,22,40
2021,166957,10,1,26,9,17
2021,166957,10,2,25,10,15
2021,166957,10,3,10,3,7
2021,166957,10,4,1,0,1
2021,166957,20,0,39,11,28
2021,166957,20,1,25,8,17
2021,166957,20,2,14,3,11
2021,166957,30,0,23,11,12
2021,166957,30,1,1,1,0
2021,166957,30,2,11,7,4
2021,166957,30,3,10,3,7
2021,166957,30,4,1,0,1
2021,167057,0,0,128,83,45
2021,167057,10,0,128,83,45
2021,167057,10,6,128,83,45
2021,167057,40,0,128,83,45
2021,167057,40,6,128,83,45
2021,167057,41,0,101,68,33
2021,167057,41,6,101,68,33
2021,167057,42,0,27,15,12
2021,167057,42,6,27,15,12
2021,167057,44,0,101,68,33
2021,167057,44,6,101,68,33
2021,167093,0,0,52,18,34
2021,167093,10,0,52,18,34
2021,167093,10,1,10,4,6
2021,167093,10,2,12,3,9
2021,167093,10,3,30,11,19
2021,167093,20,0,12,3,9
2021,167093,20,1,8,3,5
2021,167093,20,2,4,0,4
2021,167093,30,0,9,2,7
2021,167093,30,2,2,1,1
2021,167093,30,3,7,1,6
2021,167093,40,0,31,13,18
2021,167093,40,1,2,1,1
2021,167093,40,2,6,2,4
2021,167093,40,3,23,10,13
2021,167093,42,0,31,13,18
2021,167093,42,1,2,1,1
2021,167093,42,2,6,2,4
2021,167093,42,3,23,10,13
2021,167215,0,0,31,17,14
2021,167215,10,0,31,17,14
2021,167215,10,1,22,16,6
2021,167215,10,2,1,0,1
2021,167215,10,3,1,0,1
2021,167215,10,4,7,1,6
2021,167215,20,0,18,14,4
2021,167215,20,1,18,14,4
2021,167215,40,0,13,3,10
2021,167215,40,1,4,2,2
2021,167215,40,2,1,0,1
2021,167215,40,3,1,0,1
2021,167215,40,4,7,1,6
2021,167215,42,0,13,3,10
2021,167215,42,1,4,2,2
2021,167215,42,2,1,0,1
2021,167215,42,3,1,0,1
2021,167215,42,4,7,1,6
2021,167260,0,0,50,25,25
2021,167260,10,0,50,25,25
2021,167260,10,1,5,5,0
2021,167260,10,2,23,11,12
2021,167260,10,3,17,5,12
2021,167260,10,4,5,4,1
2021,167260,20,0,16,12,4
2021,167260,20,1,5,5,0
2021,167260,20,2,9,7,2
2021,167260,20,3,1,0,1
2021,167260,20,4,1,0,1
2021,167260,30,0,7,1,6
2021,167260,30,2,4,0,4
2021,167260,30,3,3,1,2
2021,167260,40,0,27,12,15
2021,167260,40,2,10,4,6
2021,167260,40,3,13,4,9
2021,167260,40,4,4,4,0
2021,167260,41,0,21,9,12
2021,167260,41,2,10,4,6
2021,167260,41,3,10,4,6
2021,167260,41,4,1,1,0
2021,167260,42,0,6,3,3
2021,167260,42,3,3,0,3
2021,167260,42,4,3,3,0
2021,167260,44,0,21,9,12
2021,167260,44,2,10,4,6
2021,167260,44,3,10,4,6
2021,167260,44,4,1,1,0
2021,167288,0,0,81,37,44
2021,167288,10,0,81,37,44
2021,167288,10,1,31,16,15
2021,167288,10,2,23,9,14
2021,167288,10,3,27,12,15
2021,167288,20,0,54,25,29
2021,167288,20,1,31,16,15
2021,167288,20,2,23,9,14
2021,167288,30,0,23,10,13
2021,167288,30,3,23,10,13
2021,167288,40,0,4,2,2
2021,167288,40,3,4,2,2
2021,167288,42,0,4,2,2
2021,167288,42,3,4,2,2
2021,167312,0,0,115,36,79
2021,167312,10,0,115,36,79
2021,167312,10,1,59,20,39
2021,167312,10,2,29,10,19
2021,167312,10,3,15,5,10
2021,167312,10,4,12,1,11
2021,167312,20,0,83,27,56
2021,167312,20,1,58,20,38
2021,167312,20,2,24,7,17
2021,167312,20,3,1,0,1
2021,167312,30,0,32,9,23
2021,167312,30,1,1,0,1
2021,167312,30,2,5,3,2
2021,167312,30,3,14,5,9
2021,167312,30,4,12,1,11
2021,167358,0,0,1519,861,658
2021,167358,10,0,1519,861,658
2021,167358,10,1,449,298,151
2021,167358,10,2,454,267,187
2021,167358,10,3,346,177,169
2021,167358,10,4,133,78,55
2021,167358,10,5,19,12,7
2021,167358,10,6,118,29,89
2021,167358,20,0,578,384,194
2021,167358,20,1,347,246,101
2021,167358,20,2,225,136,89
2021,167358,20,3,6,2,4
2021,167358,30,0,214,122,92
2021,167358,30,1,7,4,3
2021,167358,30,2,27,16,11
2021,167358,30,3,180,102,78
2021,167358,40,0,727,355,372
2021,167358,40,1,95,48,47
2021,167358,40,2,202,115,87
2021,167358,40,3,160,73,87
2021,167358,40,4,133,78,55
2021,167358,40,5,19,12,7
2021,167358,40,6,118,29,89
2021,167358,41,0,128,58,70
2021,167358,41,1,44,18,26
2021,167358,41,2,36,18,18
2021,167358,41,3,5,2,3
2021,167358,41,4,20,11,9
2021,167358,41,5,3,2,1
2021,167358,41,6,20,7,13
2021,167358,42,0,599,297,302
2021,167358,42,1,51,30,21
2021,167358,42,2,166,97,69
2021,167358,42,3,155,71,84
2021,167358,42,4,113,67,46
2021,167358,42,5,16,10,6
2021,167358,42,6,98,22,76
2021,167358,44,0,128,58,70
2021,167358,44,1,44,18,26
2021,167358,44,2,36,18,18
2021,167358,44,3,5,2,3
2021,167358,44,4,20,11,9
2021,167358,44,5,3,2,1
2021,167358,44,6,20,7,13
2021,167376,0,0,81,24,57
2021,167376,10,0,81,24,57
2021,167376,10,1,49,15,34
2021,167376,10,2,13,4,9
2021,167376,10,3,13,5,8
2021,167376,10,4,6,0,6
2021,167376,20,0,53,16,37
2021,167376,20,1,47,15,32
2021,167376,20,2,6,1,5
2021,167376,30,0,28,8,20
2021,167376,30,1,2,0,2
2021,167376,30,2,7,3,4
2021,167376,30,3,13,5,8
2021,167376,30,4,6,0,6
2021,167394,0,0,52,17,35
2021,167394,10,0,52,17,35
2021,167394,10,1,7,4,3
2021,167394,10,2,19,8,11
2021,167394,10,3,23,4,19
2021,167394,10,5,3,1,2
2021,167394,20,0,23,11,12
2021,167394,20,1,7,4,3
2021,167394,20,2,16,7,9
2021,167394,30,0,14,4,10
2021,167394,30,2,3,1,2
2021,167394,30,3,11,3,8
2021,167394,40,0,15,2,13
2021,167394,40,3,12,1,11
2021,167394,40,5,3,1,2
2021,167394,42,0,15,2,13
2021,167394,42,3,12,1,11
2021,167394,42,5,3,1,2
2021,167455,0,0,20,4,16
2021,167455,10,0,12,3,9
2021,167455,10,1,5,1,4
2021,167455,10,2,2,0,2
2021,167455,10,3,5,2,3
2021,167455,20,0,12,3,9
2021,167455,20,1,5,1,4
2021,167455,20,2,2,0,2
2021,167455,20,3,5,2,3
2021,167455,50,0,8,1,7
2021,167464,0,0,12,12,0
2021,167464,10,0,9,9,0
2021,167464,10,1,9,9,0
2021,167464,40,0,9,9,0
2021,167464,40,1,9,9,0
2021,167464,41,0,9,9,0
2021,167464,41,1,9,9,0
2021,167464,45,0,9,9,0
2021,167464,45,1,9,9,0
2021,167464,50,0,3,3,0
2021,167525,0,0,37,19,18
2021,167525,10,0,37,19,18
2021,167525,10,1,25,13,12
2021,167525,10,2,2,2,0
2021,167525,10,3,6,3,3
2021,167525,10,4,4,1,3
2021,167525,20,0,30,17,13
2021,167525,20,1,25,13,12
2021,167525,20,2,2,2,0
2021,167525,20,3,3,2,1
2021,167525,30,0,7,2,5
2021,167525,30,3,3,1,2
2021,167525,30,4,4,1,3
2021,167534,0,0,134,44,90
2021,167534,10,0,134,44,90
2021,167534,10,1,86,28,58
2021,167534,10,2,25,8,17
2021,167534,10,3,21,7,14
2021,167534,10,4,2,1,1
2021,167534,20,0,90,29,61
2021,167534,20,1,85,28,57
2021,167534,20,2,3,1,2
2021,167534,20,3,2,0,2
2021,167534,30,0,44,15,29
2021,167534,30,1,1,0,1
2021,167534,30,2,22,7,15
2021,167534,30,3,19,7,12
2021,167534,30,4,2,1,1
2021,167598,0,0,129,31,98
2021,167598,10,0,129,31,98
2021,167598,10,1,10,4,6
2021,167598,10,2,44,12,32
2021,167598,10,3,67,14,53
2021,167598,10,5,8,1,7
2021,167598,20,0,15,5,10
2021,167598,20,1,6,3,3
2021,167598,20,2,9,2,7
2021,167598,30,0,2,2,0
2021,167598,30,2,2,2,0
2021,167598,40,0,112,24,88
2021,167598,40,1,4,1,3
2021,167598,40,2,33,8,25
2021,167598,40,3,67,14,53
2021,167598,40,5,8,1,7
2021,167598,41,0,77,18,59
2021,167598,41,1,4,1,3
2021,167598,41,2,32,7,25
2021,167598,41,3,37,10,27
2021,167598,41,5,4,0,4
2021,167598,42,0,34,6,28
2021,167598,42,2,1,1,0
2021,167598,42,3,29,4,25
2021,167598,42,5,4,1,3
2021,167598,43,0,1,0,1
2021,167598,43,3,1,0,1
2021,167598,44,0,77,18,59
2021,167598,44,1,4,1,3
2021,167598,44,2,32,7,25
2021,167598,44,3,37,10,27
2021,167598,44,5,4,0,4
2021,167631,0,0,34,16,18
2021,167631,10,0,34,16,18
2021,167631,10,1,16,7,9
2021,167631,10,2,4,3,1
2021,167631,10,3,12,5,7
2021,167631,10,4,2,1,1
2021,167631,20,0,20,10,10
2021,167631,20,1,16,7,9
2021,167631,20,2,4,3,1
2021,167631,30,0,14,6,8
2021,167631,30,3,12,5,7
2021,167631,30,4,2,1,1
2021,167677,0,0,16,13,3
2021,167677,10,0,16,13,3
2021,167677,10,6,16,13,3
2021,167677,40,0,16,13,3
2021,167677,40,6,16,13,3
2021,167677,41,0,11,11,0
2021,167677,41,6,11,11,0
2021,167677,42,0,5,2,3
2021,167677,42,6,5,2,3
2021,167677,44,0,1,1,0
2021,167677,44,6,1,1,0
2021,167677,45,0,10,10,0
2021,167677,45,6,10,10,0
2021,167729,0,0,294,135,159
2021,167729,10,0,294,135,159
2021,167729,10,1,138,67,71
2021,167729,10,2,84,39,45
2021,167729,10,3,59,26,33
2021,167729,10,4,13,3,10
2021,167729,20,0,221,106,115
2021,167729,20,1,136,66,70
2021,167729,20,2,84,39,45
2021,167729,20,3,1,1,0
2021,167729,30,0,47,20,27
2021,167729,30,3,46,20,26
2021,167729,30,4,1,0,1
2021,167729,40,0,26,9,17
2021,167729,40,1,2,1,1
2021,167729,40,3,12,5,7
2021,167729,40,4,12,3,9
2021,167729,42,0,26,9,17
2021,167729,42,1,2,1,1
2021,167729,42,3,12,5,7
2021,167729,42,4,12,3,9
2021,167783,0,0,232,64,168
2021,167783,10,0,232,64,168
2021,167783,10,1,59,23,36
2021,167783,10,2,99,23,76
2021,167783,10,3,71,17,54
2021,167783,10,5,3,1,2
2021,167783,20,0,89,32,57
2021,167783,20,1,45,17,28
2021,167783,20,2,44,15,29
2021,167783,30,0,40,13,27
2021,167783,30,2,4,1,3
2021,167783,30,3,36,12,24
2021,167783,40,0,103,19,84
2021,167783,40,1,14,6,8
2021,167783,40,2,51,7,44
2021,167783,40,3,35,5,30
2021,167783,40,5,3,1,2
2021,167783,41,0,9,3,6
2021,167783,41,1,2,2,0
2021,167783,41,2,4,0,4
2021,167783,41,3,3,1,2
2021,167783,42,0,94,16,78
2021,167783,42,1,12,4,8
2021,167783,42,2,47,7,40
2021,167783,42,3,32,4,28
2021,167783,42,5,3,1,2
2021,167783,44,0,9,3,6
2021,167783,44,1,2,2,0
2021,167783,44,2,4,0,4
2021,167783,44,3,3,1,2
2021,167792,0,0,44,27,17
2021,167792,10,0,44,27,17
2021,167792,10,6,44,27,17
2021,167792,40,0,44,27,17
2021,167792,40,6,44,27,17
2021,167792,41,0,42,25,17
2021,167792,41,6,42,25,17
2021,167792,42,0,2,2,0
2021,167792,42,6,2,2,0
2021,167792,44,0,42,25,17
2021,167792,44,6,42,25,17
2021,167835,0,0,315,119,196
2021,167835,10,0,315,119,196
2021,167835,10,1,127,52,75
2021,167835,10,2,51,23,28
2021,167835,10,3,64,19,45
2021,167835,10,4,10,5,5
2021,167835,10,5,63,20,43
2021,167835,20,0,178,75,103
2021,167835,20,1,127,52,75
2021,167835,20,2,51,23,28
2021,167835,30,0,64,19,45
2021,167835,30,3,64,19,45
2021,167835,40,0,73,25,48
2021,167835,40,4,10,5,5
2021,167835,40,5,63,20,43
2021,167835,41,0,49,16,33
2021,167835,41,4,10,5,5
2021,167835,41,5,39,11,28
2021,167835,42,0,23,8,15
2021,167835,42,5,23,8,15
2021,167835,43,0,1,1,0
2021,167835,43,5,1,1,0
2021,167835,44,0,49,16,33
2021,167835,44,4,10,5,5
2021,167835,44,5,39,11,28
2021,167899,0,0,193,80,113
2021,167899,10,0,193,80,113
2021,167899,10,1,42,21,21
2021,167899,10,2,53,20,33
2021,167899,10,3,93,36,57
2021,167899,10,4,5,3,2
2021,167899,20,0,75,37,38
2021,167899,20,1,39,19,20
2021,167899,20,2,33,15,18
2021,167899,20,3,3,3,0
2021,167899,30,0,55,16,39
2021,167899,30,1,1,0,1
2021,167899,30,2,4,1,3
2021,167899,30,3,50,15,35
2021,167899,40,0,63,27,36
2021,167899,40,1,2,2,0
2021,167899,40,2,16,4,12
2021,167899,40,3,40,18,22
2021,167899,40,4,5,3,2
2021,167899,41,0,53,21,32
2021,167899,41,1,2,2,0
2021,167899,41,2,15,3,12
2021,167899,41,3,31,13,18
2021,167899,41,4,5,3,2
2021,167899,42,0,10,6,4
2021,167899,42,2,1,1,0
2021,167899,42,3,9,5,4
2021,167899,44,0,53,21,32
2021,167899,44,1,2,2,0
2021,167899,44,2,15,3,12
2021,167899,44,3,31,13,18
2021,167899,44,4,5,3,2
2021,167905,0,0,123,45,78
2021,167905,10,0,123,45,78
2021,167905,10,1,65,27,38
2021,167905,10,2,26,9,17
2021,167905,10,3,26,8,18
2021,167905,10,4,6,1,5
2021,167905,20,0,86,37,49
2021,167905,20,1,64,27,37
2021,167905,20,2,16,6,10
2021,167905,20,3,6,4,2
2021,167905,30,0,37,8,29
2021,167905,30,1,1,0,1
2021,167905,30,2,10,3,7
2021,167905,30,3,20,4,16
2021,167905,30,4,6,1,5
2021,167987,0,0,385,199,186
2021,167987,10,0,385,199,186
2021,167987,10,1,121,74,47
2021,167987,10,2,110,60,50
2021,167987,10,3,58,23,35
2021,167987,10,5,96,42,54
2021,167987,20,0,223,132,91
2021,167987,20,1,120,73,47
2021,167987,20,2,103,59,44
2021,167987,30,0,57,23,34
2021,167987,30,2,3,0,3
2021,167987,30,3,54,23,31
2021,167987,40,0,105,44,61
2021,167987,40,1,1,1,0
2021,167987,40,2,4,1,3
2021,167987,40,3,4,0,4
2021,167987,40,5,96,42,54
2021,167987,41,0,9,2,7
2021,167987,41,1,1,1,0
2021,167987,41,2,4,1,3
2021,167987,41,3,4,0,4
2021,167987,42,0,96,42,54
2021,167987,42,5,96,42,54
2021,167987,44,0,9,2,7
2021,167987,44,1,1,1,0
2021,167987,44,2,4,1,3
2021,167987,44,3,4,0,4
2021,167996,0,0,175,89,86
2021,167996,10,0,175,89,86
2021,167996,10,1,48,34,14
2021,167996,10,2,56,28,28
2021,167996,10,3,59,24,35
2021,167996,10,4,6,1,5
2021,167996,10,5,6,2,4
2021,167996,20,0,89,54,35
2021,167996,20,1,47,33,14
2021,167996,20,2,42,21,21
2021,167996,30,0,39,15,24
2021,167996,30,1,1,1,0
2021,167996,30,2,5,2,3
2021,167996,30,3,33,12,21
2021,167996,40,0,47,20,27
2021,167996,40,2,9,5,4
2021,167996,40,3,26,12,14
2021,167996,40,4,6,1,5
2021,167996,40,5,6,2,4
2021,167996,41,0,37,18,19
2021,167996,41,2,8,4,4
2021,167996,41,3,23,11,12
2021,167996,41,4,3,1,2
2021,167996,41,5,3,2,1
2021,167996,42,0,9,1,8
2021,167996,42,2,1,1,0
2021,167996,42,3,2,0,2
2021,167996,42,4,3,0,3
2021,167996,42,5,3,0,3
2021,167996,43,0,1,1,0
2021,167996,43,3,1,1,0
2021,167996,44,0,37,18,19
2021,167996,44,2,8,4,4
2021,167996,44,3,23,11,12
2021,167996,44,4,3,1,2
2021,167996,44,5,3,2,1
2021,168005,0,0,340,166,174
2021,168005,10,0,340,166,174
2021,168005,10,1,93,50,43
2021,168005,10,2,102,45,57
2021,168005,10,3,85,41,44
2021,168005,10,4,60,30,30
2021,168005,20,0,186,93,93
2021,168005,20,1,93,50,43
2021,168005,20,2,93,43,50
2021,168005,30,0,76,34,42
2021,168005,30,2,6,1,5
2021,168005,30,3,70,33,37
2021,168005,40,0,78,39,39
2021,168005,40,2,3,1,2
2021,168005,40,3,15,8,7
2021,168005,40,4,60,30,30
2021,168005,41,0,7,3,4
2021,168005,41,2,3,1,2
2021,168005,41,3,2,1,1
2021,168005,41,4,2,1,1
2021,168005,42,0,71,36,35
2021,168005,42,3,13,7,6
2021,168005,42,4,58,29,29
2021,168005,44,0,7,3,4
2021,168005,44,2,3,1,2
2021,168005,44,3,2,1,1
2021,168005,44,4,2,1,1
2021,168148,0,0,940,475,465
2021,168148,10,0,940,475,465
2021,168148,10,1,290,193,97
2021,168148,10,2,224,120,104
2021,168148,10,3,258,103,155
2021,168148,10,4,1,0,1
2021,168148,10,5,167,59,108
2021,168148,20,0,365,237,128
2021,168148,20,1,225,152,73
2021,168148,20,2,140,85,55
2021,168148,30,0,88,42,46
2021,168148,30,2,3,0,3
2021,168148,30,3,85,42,43
2021,168148,40,0,487,196,291
2021,168148,40,1,65,41,24
2021,168148,40,2,81,35,46
2021,168148,40,3,173,61,112
2021,168148,40,4,1,0,1
2021,168148,40,5,167,59,108
2021,168148,41,0,421,172,249
2021,168148,41,1,61,38,23
2021,168148,41,2,74,32,42
2021,168148,41,3,124,45,79
2021,168148,41,4,1,0,1
2021,168148,41,5,161,57,104
2021,168148,42,0,62,21,41
2021,168148,42,1,4,3,1
2021,168148,42,2,7,3,4
2021,168148,42,3,47,14,33
2021,168148,42,5,4,1,3
2021,168148,43,0,4,3,1
2021,168148,43,3,2,2,0
2021,168148,43,5,2,1,1
2021,168148,44,0,385,153,232
2021,168148,44,1,39,25,14
2021,168148,44,2,60,26,34
2021,168148,44,3,124,45,79
2021,168148,44,4,1,0,1
2021,168148,44,5,161,57,104
2021,168148,45,0,36,19,17
2021,168148,45,1,22,13,9
2021,168148,45,2,14,6,8
2021,168218,0,0,323,120,203
2021,168218,10,0,323,120,203
2021,168218,10,1,101,52,49
2021,168218,10,2,75,26,49
2021,168218,10,3,32,11,21
2021,168218,10,5,71,19,52
2021,168218,10,6,44,12,32
2021,168218,20,0,176,78,98
2021,168218,20,1,101,52,49
2021,168218,20,2,75,26,49
2021,168218,30,0,32,11,21
2021,168218,30,3,32,11,21
2021,168218,40,0,115,31,84
2021,168218,40,5,71,19,52
2021,168218,40,6,44,12,32
2021,168218,41,0,97,26,71
2021,168218,41,5,68,19,49
2021,168218,41,6,29,7,22
2021,168218,42,0,18,5,13
2021,168218,42,5,3,0,3
2021,168218,42,6,15,5,10
2021,168218,44,0,96,26,70
2021,168218,44,5,68,19,49
2021,168218,44,6,28,7,21
2021,168218,45,0,1,0,1
2021,168218,45,6,1,0,1
2021,168227,0,0,159,102,57
2021,168227,10,0,159,102,57
2021,168227,10,1,30,23,7
2021,168227,10,2,54,32,22
2021,168227,10,3,75,47,28
2021,168227,40,0,159,102,57
2021,168227,40,1,30,23,7
2021,168227,40,2,54,32,22
2021,168227,40,3,75,47,28
2021,168227,41,0,130,87,43
2021,168227,41,1,30,23,7
2021,168227,41,2,47,28,19
2021,168227,41,3,53,36,17
2021,168227,42,0,18,11,7
2021,168227,42,2,3,2,1
2021,168227,42,3,15,9,6
2021,168227,43,0,11,4,7
2021,168227,43,2,4,2,2
2021,168227,43,3,7,2,5
2021,168227,45,0,130,87,43
2021,168227,45,1,30,23,7
2021,168227,45,2,47,28,19
2021,168227,45,3,53,36,17
2021,168254,0,0,213,119,94
2021,168254,10,0,213,119,94
2021,168254,10,1,86,47,39
2021,168254,10,2,61,38,23
2021,168254,10,3,43,21,22
2021,168254,10,4,23,13,10
2021,168254,20,0,113,68,45
2021,168254,20,1,77,43,34
2021,168254,20,2,35,24,11
2021,168254,20,3,1,1,0
2021,168254,30,0,52,29,23
2021,168254,30,2,18,11,7
2021,168254,30,3,34,18,16
2021,168254,40,0,48,22,26
2021,168254,40,1,9,4,5
2021,168254,40,2,8,3,5
2021,168254,40,3,8,2,6
2021,168254,40,4,23,13,10
2021,168254,41,0,6,2,4
2021,168254,41,2,5,2,3
2021,168254,41,4,1,0,1
2021,168254,42,0,40,19,21
2021,168254,42,1,9,4,5
2021,168254,42,2,3,1,2
2021,168254,42,3,7,1,6
2021,168254,42,4,21,13,8
2021,168254,43,0,2,1,1
2021,168254,43,3,1,1,0
2021,168254,43,4,1,0,1
2021,168254,44,0,6,2,4
2021,168254,44,2,5,2,3
2021,168254,44,4,1,0,1
2021,168263,0,0,207,95,112
2021,168263,10,0,207,95,112
2021,168263,10,1,103,49,54
2021,168263,10,2,54,26,28
2021,168263,10,3,44,18,26
2021,168263,10,4,6,2,4
2021,168263,20,0,153,75,78
2021,168263,20,1,103,49,54
2021,168263,20,2,49,25,24
2021,168263,20,3,1,1,0
2021,168263,30,0,45,17,28
2021,168263,30,2,5,1,4
2021,168263,30,3,40,16,24
2021,168263,40,0,9,3,6
2021,168263,40,3,3,1,2
2021,168263,40,4,6,2,4
2021,168263,42,0,9,3,6
2021,168263,42,3,3,1,2
2021,168263,42,4,6,2,4
2021,168281,0,0,130,60,70
2021,168281,10,0,130,60,70
2021,168281,10,1,50,28,22
2021,168281,10,2,34,14,20
2021,168281,10,3,37,13,24
2021,168281,10,4,9,5,4
2021,168281,20,0,82,42,40
2021,168281,20,1,48,28,20
2021,168281,20,2,34,14,20
2021,168281,30,0,22,8,14
2021,168281,30,3,22,8,14
2021,168281,40,0,26,10,16
2021,168281,40,1,2,0,2
2021,168281,40,3,15,5,10
2021,168281,40,4,9,5,4
2021,168281,41,0,16,5,11
2021,168281,41,1,2,0,2
2021,168281,41,3,8,3,5
2021,168281,41,4,6,2,4
2021,168281,42,0,10,5,5
2021,168281,42,3,7,2,5
2021,168281,42,4,3,3,0
2021,168281,44,0,16,5,11
2021,168281,44,1,2,0,2
2021,168281,44,3,8,3,5
2021,168281,44,4,6,2,4
2021,168342,0,0,310,161,149
2021,168342,10,0,309,160,149
2021,168342,10,1,145,85,60
2021,168342,10,2,38,16,22
2021,168342,10,3,78,40,38
2021,168342,10,4,4,3,1
2021,168342,10,5,9,2,7
2021,168342,10,6,35,14,21
2021,168342,20,0,182,101,81
2021,168342,20,1,145,85,60
2021,168342,20,2,37,16,21
2021,168342,30,0,75,38,37
2021,168342,30,3,75,38,37
2021,168342,40,0,52,21,31
2021,168342,40,2,1,0,1
2021,168342,40,3,3,2,1
2021,168342,40,4,4,3,1
2021,168342,40,5,9,2,7
2021,168342,40,6,35,14,21
2021,168342,41,0,32,14,18
2021,168342,41,2,1,0,1
2021,168342,41,3,3,2,1
2021,168342,41,4,4,3,1
2021,168342,41,5,9,2,7
2021,168342,41,6,15,7,8
2021,168342,42,0,20,7,13
2021,168342,42,6,20,7,13
2021,168342,44,0,32,14,18
2021,168342,44,2,1,0,1
2021,168342,44,3,3,2,1
2021,168342,44,4,4,3,1
2021,168342,44,5,9,2,7
2021,168342,44,6,15,7,8
2021,168342,50,0,1,1,0
2021,168421,0,0,421,293,128
2021,168421,10,0,419,292,127
2021,168421,10,1,121,88,33
2021,168421,10,2,78,61,17
2021,168421,10,3,69,39,30
2021,168421,10,4,151,104,47
2021,168421,20,0,190,142,48
2021,168421,20,1,118,86,32
2021,168421,20,2,72,56,16
2021,168421,30,0,90,54,36
2021,168421,30,2,6,5,1
2021,168421,30,3,69,39,30
2021,168421,30,4,15,10,5
2021,168421,40,0,139,96,43
2021,168421,40,1,3,2,1
2021,168421,40,4,136,94,42
2021,168421,42,0,8,6,2
2021,168421,42,4,8,6,2
2021,168421,43,0,131,90,41
2021,168421,43,1,3,2,1
2021,168421,43,4,128,88,40
2021,168421,50,0,2,1,1
2021,168430,0,0,208,81,127
2021,168430,10,0,208,81,127
2021,168430,10,1,74,28,46
2021,168430,10,2,49,27,22
2021,168430,10,3,61,23,38
2021,168430,10,4,24,3,21
2021,168430,20,0,117,51,66
2021,168430,20,1,74,28,46
2021,168430,20,2,43,23,20
2021,168430,30,0,56,23,33
2021,168430,30,2,4,3,1
2021,168430,30,3,47,19,28
2021,168430,30,4,5,1,4
2021,168430,40,0,35,7,28
2021,168430,40,2,2,1,1
2021,168430,40,3,14,4,10
2021,168430,40,4,19,2,17
2021,168430,42,0,35,7,28
2021,168430,42,2,2,1,1
2021,168430,42,3,14,4,10
2021,168430,42,4,19,2,17
2021,168528,0,0,85,42,43
2021,168528,10,0,85,42,43
2021,168528,10,1,34,17,17
2021,168528,10,2,19,11,8
2021,168528,10,3,28,12,16
2021,168528,10,4,4,2,2
2021,168528,20,0,50,27,23
2021,168528,20,1,34,17,17
2021,168528,20,2,16,10,6
2021,168528,30,0,12,7,5
2021,168528,30,3,12,7,5
2021,168528,40,0,23,8,15
2021,168528,40,2,3,1,2
2021,168528,40,3,16,5,11
2021,168528,40,4,4,2,2
2021,168528,41,0,2,0,2
2021,168528,41,2,1,0,1
2021,168528,41,3,1,0,1
2021,168528,42,0,21,8,13
2021,168528,42,2,2,1,1
2021,168528,42,3,15,5,10
2021,168528,42,4,4,2,2
2021,168528,44,0,2,0,2
2021,168528,44,2,1,0,1
2021,168528,44,3,1,0,1
2021,168546,0,0,124,61,63
2021,168546,10,0,124,61,63
2021,168546,10,1,42,24,18
2021,168546,10,2,26,14,12
2021,168546,10,3,46,19,27
2021,168546,10,4,7,3,4
2021,168546,10,5,3,1,2
2021,168546,20,0,68,38,30
2021,168546,20,1,42,24,18
2021,168546,20,2,26,14,12
2021,168546,30,0,29,12,17
2021,168546,30,3,29,12,17
2021,168546,40,0,27,11,16
2021,168546,40,3,17,7,10
2021,168546,40,4,7,3,4
2021,168546,40,5,3,1,2
2021,168546,42,0,27,11,16
2021,168546,42,3,17,7,10
2021,168546,42,4,7,3,4
2021,168546,42,5,3,1,2
2021,168591,0,0,91,46,45
2021,168591,10,0,91,46,45
2021,168591,10,1,27,17,10
2021,168591,10,2,27,16,11
2021,168591,10,3,20,8,12
2021,168591,10,4,9,2,7
2021,168591,10,5,8,3,5
2021,168591,20,0,51,31,20
2021,168591,20,1,25,15,10
2021,168591,20,2,26,16,10
2021,168591,30,0,22,10,12
2021,168591,30,1,2,2,0
2021,168591,30,3,20,8,12
2021,168591,40,0,18,5,13
2021,168591,40,2,1,0,1
2021,168591,40,4,9,2,7
2021,168591,40,5,8,3,5
2021,168591,42,0,17,4,13
2021,168591,42,2,1,0,1
2021,168591,42,4,9,2,7
2021,168591,42,5,7,2,5
2021,168591,43,0,1,1,0
2021,168591,43,5,1,1,0
2021,168607,0,0,45,29,16
2021,168607,10,0,45,29,16
2021,168607,10,6,45,29,16
2021,168607,40,0,45,29,16
2021,168607,40,6,45,29,16
2021,168607,41,0,45,29,16
2021,168607,41,6,45,29,16
2021,168607,44,0,45,29,16
2021,168607,44,6,45,29,16
2021,168740,0,0,199,113,86
2021,168740,10,0,199,113,86
2021,168740,10,1,64,43,21
2021,168740,10,2,63,32,31
2021,168740,10,3,68,35,33
2021,168740,10,4,4,3,1
2021,168740,20,0,59,36,23
2021,168740,20,1,45,29,16
2021,168740,20,2,13,7,6
2021,168740,20,3,1,0,1
2021,168740,30,0,123,72,51
2021,168740,30,1,17,14,3
2021,168740,30,2,41,23,18
2021,168740,30,3,64,34,30
2021,168740,30,4,1,1,0
2021,168740,40,0,17,5,12
2021,168740,40,1,2,0,2
2021,168740,40,2,9,2,7
2021,168740,40,3,3,1,2
2021,168740,40,4,3,2,1
2021,168740,42,0,17,5,12
2021,168740,42,1,2,0,2
2021,168740,42,2,9,2,7
2021,168740,42,3,3,1,2
2021,168740,42,4,3,2,1
2021,168786,0,0,82,47,35
2021,168786,10,0,82,47,35
2021,168786,10,1,29,15,14
2021,168786,10,2,28,19,9
2021,168786,10,3,23,13,10
2021,168786,10,5,2,0,2
2021,168786,20,0,57,34,23
2021,168786,20,1,28,14,14
2021,168786,20,2,23,16,7
2021,168786,20,3,6,4,2
2021,168786,30,0,18,11,7
2021,168786,30,1,1,1,0
2021,168786,30,2,4,3,1
2021,168786,30,3,13,7,6
2021,168786,40,0,7,2,5
2021,168786,40,2,1,0,1
2021,168786,40,3,4,2,2
2021,168786,40,5,2,0,2
2021,168786,41,0,7,2,5
2021,168786,41,2,1,0,1
2021,168786,41,3,4,2,2
2021,168786,41,5,2,0,2
2021,168786,45,0,7,2,5
2021,168786,45,2,1,0,1
2021,168786,45,3,4,2,2
2021,168786,45,5,2,0,2
2021,168847,0,0,113,22,91
2021,168847,10,0,113,22,91
2021,168847,10,1,15,1,14
2021,168847,10,2,19,2,17
2021,168847,10,3,18,3,15
2021,168847,10,4,61,16,45
2021,168847,40,0,113,22,91
2021,168847,40,1,15,1,14
2021,168847,40,2,19,2,17
2021,168847,40,3,18,3,15
2021,168847,40,4,61,16,45
2021,168847,42,0,113,22,91
2021,168847,42,1,15,1,14
2021,168847,42,2,19,2,17
2021,168847,42,3,18,3,15
2021,168847,42,4,61,16,45
2021,168883,0,0,37,18,19
2021,168883,10,0,37,18,19
2021,168883,10,6,37,18,19
2021,168883,20,0,32,16,16
2021,168883,20,6,32,16,16
2021,168883,30,0,5,2,3
2021,168883,30,6,5,2,3
2021,169080,0,0,191,122,69
2021,169080,10,0,179,118,61
2021,169080,10,1,111,78,33
2021,169080,10,2,42,28,14
2021,169080,10,3,26,12,14
2021,169080,20,0,144,100,44
2021,169080,20,1,110,78,32
2021,169080,20,2,34,22,12
2021,169080,30,0,25,10,15
2021,169080,30,1,1,0,1
2021,169080,30,2,5,3,2
2021,169080,30,3,19,7,12
2021,169080,40,0,10,8,2
2021,169080,40,2,3,3,0
2021,169080,40,3,7,5,2
2021,169080,41,0,10,8,2
2021,169080,41,2,3,3,0
2021,169080,41,3,7,5,2
2021,169080,44,0,10,8,2
2021,169080,44,2,3,3,0
2021,169080,44,3,7,5,2
2021,169080,50,0,12,4,8
2021,169099,0,0,12,10,2
2021,169099,10,0,12,10,2
2021,169099,10,1,9,8,1
2021,169099,10,2,3,2,1
2021,169099,20,0,9,8,1
2021,169099,20,1,9,8,1
2021,169099,30,0,3,2,1
2021,169099,30,2,3,2,1
2021,169220,0,0,15,9,6
2021,169220,10,0,15,9,6
2021,169220,10,1,14,9,5
2021,169220,10,6,1,0,1
2021,169220,40,0,15,9,6
2021,169220,40,1,14,9,5
2021,169220,40,6,1,0,1
2021,169220,41,0,13,8,5
2021,169220,41,1,12,8,4
2021,169220,41,6,1,0,1
2021,169220,42,0,2,1,1
2021,169220,42,1,2,1,1
2021,169220,44,0,13,8,5
2021,169220,44,1,12,8,4
2021,169220,44,6,1,0,1
2021,169248,0,0,681,367,314
2021,169248,10,0,681,367,314
2021,169248,10,1,325,187,138
2021,169248,10,2,127,64,63
2021,169248,10,3,76,38,38
2021,169248,10,4,2,2,0
2021,169248,10,5,142,73,69
2021,169248,10,6,9,3,6
2021,169248,20,0,435,240,195
2021,169248,20,1,320,185,135
2021,169248,20,2,112,53,59
2021,169248,20,3,3,2,1
2021,169248,30,0,80,44,36
2021,169248,30,1,1,1,0
2021,169248,30,2,11,9,2
2021,169248,30,3,68,34,34
2021,169248,40,0,166,83,83
2021,169248,40,1,4,1,3
2021,169248,40,2,4,2,2
2021,169248,40,3,5,2,3
2021,169248,40,4,2,2,0
2021,169248,40,5,142,73,69
2021,169248,40,6,9,3,6
2021,169248,41,0,122,63,59
2021,169248,41,1,4,1,3
2021,169248,41,2,4,2,2
2021,169248,41,3,5,2,3
2021,169248,41,4,2,2,0
2021,169248,41,5,107,56,51
2021,169248,42,0,44,20,24
2021,169248,42,5,35,17,18
2021,169248,42,6,9,3,6
2021,169248,44,0,122,63,59
2021,169248,44,1,4,1,3
2021,169248,44,2,4,2,2
2021,169248,44,3,5,2,3
2021,169248,44,4,2,2,0
2021,169248,44,5,107,56,51
2021,169275,0,0,119,46,73
2021,169275,10,0,119,46,73
2021,169275,10,6,119,46,73
2021,169275,40,0,119,46,73
2021,169275,40,6,119,46,73
2021,169275,42,0,114,46,68
2021,169275,42,6,114,46,68
2021,169275,43,0,5,0,5
2021,169275,43,6,5,0,5
2021,169327,0,0,7,4,3
2021,169327,10,0,7,4,3
2021,169327,10,2,7,4,3
2021,169327,40,0,7,4,3
2021,169327,40,2,7,4,3
2021,169327,42,0,7,4,3
2021,169327,42,2,7,4,3
2021,169363,0,0,57,28,29
2021,169363,10,0,56,28,28
2021,169363,10,1,10,6,4
2021,169363,10,2,16,9,7
2021,169363,10,3,30,13,17
2021,169363,40,0,56,28,28
2021,169363,40,1,10,6,4
2021,169363,40,2,16,9,7
2021,169363,40,3,30,13,17
2021,169363,41,0,50,24,26
2021,169363,41,1,10,6,4
2021,169363,41,2,16,9,7
2021,169363,41,3,24,9,15
2021,169363,42,0,6,4,2
2021,169363,42,3,6,4,2
2021,169363,44,0,40,18,22
2021,169363,44,2,16,9,7
2021,169363,44,3,24,9,15
2021,169363,45,0,10,6,4
2021,169363,45,1,10,6,4
2021,169363,50,0,1,0,1
2021,169424,0,0,10,5,5
2021,169424,10,0,10,5,5
2021,169424,10,4,10,5,5
2021,169424,40,0,10,5,5
2021,169424,40,4,10,5,5
2021,169424,42,0,10,5,5
2021,169424,42,4,10,5,5
2021,169442,0,0,46,33,13
2021,169442,10,0,46,33,13
2021,169442,10,1,9,7,2
2021,169442,10,2,23,17,6
2021,169442,10,3,14,9,5
2021,169442,40,0,46,33,13
2021,169442,40,1,9,7,2
2021,169442,40,2,23,17,6
2021,169442,40,3,14,9,5
2021,169442,41,0,46,33,13
2021,169442,41,1,9,7,2
2021,169442,41,2,23,17,6
2021,169442,41,3,14,9,5
2021,169442,44,0,46,33,13
2021,169442,44,1,9,7,2
2021,169442,44,2,23,17,6
2021,169442,44,3,14,9,5
2021,169479,0,0,113,35,78
2021,169479,10,0,113,35,78
2021,169479,10,1,4,3,1
2021,169479,10,2,22,10,12
2021,169479,10,3,44,14,30
2021,169479,10,4,43,8,35
2021,169479,40,0,113,35,78
2021,169479,40,1,4,3,1
2021,169479,40,2,22,10,12
2021,169479,40,3,44,14,30
2021,169479,40,4,43,8,35
2021,169479,41,0,113,35,78
2021,169479,41,1,4,3,1
2021,169479,41,2,22,10,12
2021,169479,41,3,44,14,30
2021,169479,41,4,43,8,35
2021,169479,45,0,113,35,78
2021,169479,45,1,4,3,1
2021,169479,45,2,22,10,12
2021,169479,45,3,44,14,30
2021,169479,45,4,43,8,35
2021,169521,0,0,172,80,92
2021,169521,10,0,172,80,92
2021,169521,10,1,61,28,33
2021,169521,10,2,74,37,37
2021,169521,10,3,17,7,10
2021,169521,10,4,20,8,12
2021,169521,20,0,142,66,76
2021,169521,20,1,61,28,33
2021,169521,20,2,74,37,37
2021,169521,20,3,7,1,6
2021,169521,30,0,24,11,13
2021,169521,30,3,9,5,4
2021,169521,30,4,15,6,9
2021,169521,40,0,6,3,3
2021,169521,40,3,1,1,0
2021,169521,40,4,5,2,3
2021,169521,42,0,6,3,3
2021,169521,42,3,1,1,0
2021,169521,42,4,5,2,3
2021,169655,0,0,89,78,11
2021,169655,10,0,89,78,11
2021,169655,10,4,89,78,11
2021,169655,40,0,89,78,11
2021,169655,40,4,89,78,11
2021,169655,41,0,89,78,11
2021,169655,41,4,89,78,11
2021,169655,45,0,89,78,11
2021,169655,45,4,89,78,11
2021,169716,0,0,311,142,169
2021,169716,10,0,311,142,169
2021,169716,10,1,63,41,22
2021,169716,10,2,116,51,65
2021,169716,10,3,103,36,67
2021,169716,10,4,21,8,13
2021,169716,10,5,8,6,2
2021,169716,20,0,149,77,72
2021,169716,20,1,63,41,22
2021,169716,20,2,85,36,49
2021,169716,20,3,1,0,1
2021,169716,30,0,66,23,43
2021,169716,30,2,11,5,6
2021,169716,30,3,55,18,37
2021,169716,40,0,96,42,54
2021,169716,40,2,20,10,10
2021,169716,40,3,47,18,29
2021,169716,40,4,21,8,13
2021,169716,40,5,8,6,2
2021,169716,41,0,19,10,9
2021,169716,41,3,4,1,3
2021,169716,41,4,9,4,5
2021,169716,41,5,6,5,1
2021,169716,42,0,77,32,45
2021,169716,42,2,20,10,10
2021,169716,42,3,43,17,26
2021,169716,42,4,12,4,8
2021,169716,42,5,2,1,1
2021,169716,44,0,19,10,9
2021,169716,44,3,4,1,3
2021,169716,44,4,9,4,5
2021,169716,44,5,6,5,1
2021,169761,0,0,13,3,10
2021,169761,10,0,13,3,10
2021,169761,10,4,13,3,10
2021,169761,40,0,13,3,10
2021,169761,40,4,13,3,10
2021,169761,41,0,13,3,10
2021,169761,41,4,13,3,10
2021,169761,45,0,13,3,10
2021,169761,45,4,13,3,10
2021,169798,0,0,616,306,310
2021,169798,10,0,616,306,310
2021,169798,10,1,303,168,135
2021,169798,10,2,171,75,96
2021,169798,10,3,73,32,41
2021,169798,10,4,2,1,1
2021,169798,10,5,67,30,37
2021,169798,20,0,474,243,231
2021,169798,20,1,303,168,135
2021,169798,20,2,167,74,93
2021,169798,20,3,2,0,2
2021,169798,20,4,2,1,1
2021,169798,30,0,75,33,42
2021,169798,30,2,4,1,3
2021,169798,30,3,71,32,39
2021,169798,40,0,67,30,37
2021,169798,40,5,67,30,37
2021,169798,41,0,67,30,37
2021,169798,41,5,67,30,37
2021,169798,44,0,67,30,37
2021,169798,44,5,67,30,37
2021,169910,0,0,480,257,223
2021,169910,10,0,480,257,223
2021,169910,10,1,176,101,75
2021,169910,10,2,153,88,65
2021,169910,10,3,67,34,33
2021,169910,10,4,3,1,2
2021,169910,10,6,81,33,48
2021,169910,20,0,330,186,144
2021,169910,20,1,175,100,75
2021,169910,20,2,137,78,59
2021,169910,20,3,17,7,10
2021,169910,20,4,1,1,0
2021,169910,30,0,66,36,30
2021,169910,30,1,1,1,0
2021,169910,30,2,16,10,6
2021,169910,30,3,48,25,23
2021,169910,30,4,1,0,1
2021,169910,40,0,84,35,49
2021,169910,40,3,2,2,0
2021,169910,40,4,1,0,1
2021,169910,40,6,81,33,48
2021,169910,41,0,3,3,0
2021,169910,41,6,3,3,0
2021,169910,42,0,63,23,40
2021,169910,42,3,2,2,0
2021,169910,42,4,1,0,1
2021,169910,42,6,60,21,39
2021,169910,43,0,18,9,9
2021,169910,43,6,18,9,9
2021,169910,44,0,3,3,0
2021,169910,44,6,3,3,0
2021,169974,0,0,24,13,11
2021,169974,10,0,24,13,11
2021,169974,10,1,16,11,5
2021,169974,10,4,8,2,6
2021,169974,20,0,16,11,5
2021,169974,20,1,16,11,5
2021,169974,30,0,4,0,4
2021,169974,30,4,4,0,4
2021,169974,40,0,4,2,2
2021,169974,40,4,4,2,2
2021,169974,42,0,4,2,2
2021,169974,42,4,4,2,2
2021,169983,0,0,105,78,27
2021,169983,10,0,105,78,27
2021,169983,10,1,31,25,6
2021,169983,10,2,30,21,9
2021,169983,10,3,21,16,5
2021,169983,10,5,23,16,7
2021,169983,20,0,62,47,15
2021,169983,20,1,31,25,6
2021,169983,20,2,30,21,9
2021,169983,20,3,1,1,0
2021,169983,30,0,20,15,5
2021,169983,30,3,20,15,5
2021,169983,40,0,23,16,7
2021,169983,40,5,23,16,7
2021,169983,41,0,1,1,0
2021,169983,41,5,1,1,0
2021,169983,42,0,22,15,7
2021,169983,42,5,22,15,7
2021,169983,44,0,1,1,0
2021,169983,44,5,1,1,0
2021,169992,0,0,29,14,15
2021,169992,10,0,29,14,15
2021,169992,10,6,29,14,15
2021,169992,40,0,29,14,15
2021,169992,40,6,29,14,15
2021,169992,42,0,29,14,15
2021,169992,42,6,29,14,15
2021,170000,0,0,20,13,7
2021,170000,10,0,19,12,7
2021,170000,10,1,7,6,1
2021,170000,10,2,5,2,3
2021,170000,10,3,7,4,3
2021,170000,40,0,19,12,7
2021,170000,40,1,7,6,1
2021,170000,40,2,5,2,3
2021,170000,40,3,7,4,3
2021,170000,41,0,19,12,7
2021,170000,41,1,7,6,1
2021,170000,41,2,5,2,3
2021,170000,41,3,7,4,3
2021,170000,44,0,19,12,7
2021,170000,44,1,7,6,1
2021,170000,44,2,5,2,3
2021,170000,44,3,7,4,3
2021,170000,50,0,1,1,0
2021,170037,0,0,62,36,26
2021,170037,10,0,62,36,26
2021,170037,10,1,21,17,4
2021,170037,10,2,8,2,6
2021,170037,10,3,32,16,16
2021,170037,10,4,1,1,0
2021,170037,20,0,28,19,9
2021,170037,20,1,21,17,4
2021,170037,20,2,7,2,5
2021,170037,30,0,29,14,15
2021,170037,30,3,29,14,15
2021,170037,40,0,5,3,2
2021,170037,40,2,1,0,1
2021,170037,40,3,3,2,1
2021,170037,40,4,1,1,0
2021,170037,42,0,5,3,2
2021,170037,42,2,1,0,1
2021,170037,42,3,3,2,1
2021,170037,42,4,1,1,0
2021,170055,0,0,213,102,111
2021,170055,10,0,213,102,111
2021,170055,10,1,96,51,45
2021,170055,10,2,19,12,7
2021,170055,10,3,82,34,48
2021,170055,10,4,16,5,11
2021,170055,20,0,171,82,89
2021,170055,20,1,96,51,45
2021,170055,20,2,19,12,7
2021,170055,20,3,44,16,28
2021,170055,20,4,12,3,9
2021,170055,30,0,37,19,18
2021,170055,30,3,35,18,17
2021,170055,30,4,2,1,1
2021,170055,40,0,5,1,4
2021,170055,40,3,3,0,3
2021,170055,40,4,2,1,1
2021,170055,42,0,5,1,4
2021,170055,42,3,3,0,3
2021,170055,42,4,2,1,1
2021,170082,0,0,1094,547,547
2021,170082,10,0,1094,547,547
2021,170082,10,1,306,193,113
2021,170082,10,2,316,158,158
2021,170082,10,3,182,80,102
2021,170082,10,4,5,2,3
2021,170082,10,6,285,114,171
2021,170082,20,0,636,352,284
2021,170082,20,1,303,190,113
2021,170082,20,2,308,152,156
2021,170082,20,3,23,9,14
2021,170082,20,4,2,1,1
2021,170082,30,0,173,81,92
2021,170082,30,1,3,3,0
2021,170082,30,2,8,6,2
2021,170082,30,3,159,71,88
2021,170082,30,4,3,1,2
2021,170082,40,0,285,114,171
2021,170082,40,6,285,114,171
2021,170082,41,0,129,44,85
2021,170082,41,6,129,44,85
2021,170082,42,0,156,70,86
2021,170082,42,6,156,70,86
2021,170082,44,0,129,44,85
2021,170082,44,6,129,44,85
2021,170091,0,0,8,6,2
2021,170091,10,0,8,6,2
2021,170091,10,1,8,6,2
2021,170091,40,0,8,6,2
2021,170091,40,1,8,6,2
2021,170091,42,0,8,6,2
2021,170091,42,1,8,6,2
2021,170240,0,0,168,77,91
2021,170240,10,0,168,77,91
2021,170240,10,4,168,77,91
2021,170240,20,0,130,60,70
2021,170240,20,4,130,60,70
2021,170240,30,0,38,17,21
2021,170240,30,4,38,17,21
2021,170286,0,0,156,125,31
2021,170286,10,0,126,105,21
2021,170286,10,1,46,41,5
2021,170286,10,2,50,43,7
2021,170286,10,3,29,20,9
2021,170286,10,5,1,1,0
2021,170286,20,0,88,76,12
2021,170286,20,1,46,41,5
2021,170286,20,2,40,33,7
2021,170286,20,3,2,2,0
2021,170286,30,0,31,23,8
2021,170286,30,2,10,10,0
2021,170286,30,3,21,13,8
2021,170286,40,0,7,6,1
2021,170286,40,3,6,5,1
2021,170286,40,5,1,1,0
2021,170286,41,0,4,3,1
2021,170286,41,3,4,3,1
2021,170286,42,0,3,3,0
2021,170286,42,3,2,2,0
2021,170286,42,5,1,1,0
2021,170286,44,0,4,3,1
2021,170286,44,3,4,3,1
2021,170286,50,0,30,20,10
2021,170301,0,0,234,112,122
2021,170301,10,0,234,112,122
2021,170301,10,1,68,43,25
2021,170301,10,2,68,36,32
2021,170301,10,3,98,33,65
2021,170301,20,0,128,74,54
2021,170301,20,1,67,43,24
2021,170301,20,2,61,31,30
2021,170301,30,0,52,26,26
2021,170301,30,2,4,3,1
2021,170301,30,3,48,23,25
2021,170301,40,0,54,12,42
2021,170301,40,1,1,0,1
2021,170301,40,2,3,2,1
2021,170301,40,3,50,10,40
2021,170301,42,0,54,12,42
2021,170301,42,1,1,0,1
2021,170301,42,2,3,2,1
2021,170301,42,3,50,10,40
2021,170444,0,0,62,28,34
2021,170444,10,0,62,28,34
2021,170444,10,1,22,10,12
2021,170444,10,2,12,4,8
2021,170444,10,3,13,8,5
2021,170444,10,4,15,6,9
2021,170444,20,0,47,22,25
2021,170444,20,1,22,10,12
2021,170444,20,2,12,4,8
2021,170444,20,3,13,8,5
2021,170444,30,0,9,3,6
2021,170444,30,4,9,3,6
2021,170444,40,0,6,3,3
2021,170444,40,4,6,3,3
2021,170444,42,0,6,3,3
2021,170444,42,4,6,3,3
2021,170532,0,0,109,51,58
2021,170532,10,0,109,51,58
2021,170532,10,1,38,20,18
2021,170532,10,2,28,14,14
2021,170532,10,3,25,9,16
2021,170532,10,4,18,8,10
2021,170532,20,0,66,34,32
2021,170532,20,1,38,20,18
2021,170532,20,2,28,14,14
2021,170532,30,0,24,9,15
2021,170532,30,3,24,9,15
2021,170532,40,0,19,8,11
2021,170532,40,3,1,0,1
2021,170532,40,4,18,8,10
2021,170532,41,0,3,1,2
2021,170532,41,4,3,1,2
2021,170532,42,0,16,7,9
2021,170532,42,3,1,0,1
2021,170532,42,4,15,7,8
2021,170532,44,0,3,1,2
2021,170532,44,4,3,1,2
2021,170541,0,0,110,61,49
2021,170541,10,0,110,61,49
2021,170541,10,4,110,61,49
2021,170541,20,0,72,42,30
2021,170541,20,4,72,42,30
2021,170541,30,0,38,19,19
2021,170541,30,4,38,19,19
2021,170550,0,0,87,39,48
2021,170550,10,0,87,39,48
2021,170550,10,1,66,29,37
2021,170550,10,4,21,10,11
2021,170550,20,0,66,29,37
2021,170550,20,1,66,29,37
2021,170550,30,0,16,7,9
2021,170550,30,4,16,7,9
2021,170550,40,0,5,3,2
2021,170550,40,4,5,3,2
2021,170550,41,0,4,2,2
2021,170550,41,4,4,2,2
2021,170550,42,0,1,1,0
2021,170550,42,4,1,1,0
2021,170550,44,0,4,2,2
2021,170550,44,4,4,2,2
2021,170587,0,0,22,11,11
2021,170587,10,0,22,11,11
2021,170587,10,4,22,11,11
2021,170587,40,0,22,11,11
2021,170587,40,4,22,11,11
2021,170587,42,0,22,11,11
2021,170587,42,4,22,11,11
2021,170620,0,0,54,28,26
2021,170620,10,0,54,28,26
2021,170620,10,4,47,25,22
2021,170620,10,5,4,1,3
2021,170620,10,6,3,2,1
2021,170620,40,0,54,28,26
2021,170620,40,4,47,25,22
2021,170620,40,5,4,1,3
2021,170620,40,6,3,2,1
2021,170620,41,0,50,27,23
2021,170620,41,4,47,25,22
2021,170620,41,6,3,2,1
2021,170620,42,0,4,1,3
2021,170620,42,5,4,1,3
2021,170620,44,0,50,27,23
2021,170620,44,4,47,25,22
2021,170620,44,6,3,2,1
2021,170639,0,0,93,59,34
2021,170639,10,0,92,58,34
2021,170639,10,1,15,13,2
2021,170639,10,2,23,17,6
2021,170639,10,3,42,20,22
2021,170639,10,4,7,6,1
2021,170639,10,6,5,2,3
2021,170639,20,0,52,33,19
2021,170639,20,1,15,13,2
2021,170639,20,2,22,16,6
2021,170639,20,3,15,4,11
2021,170639,30,0,31,18,13
2021,170639,30,2,1,1,0
2021,170639,30,3,25,15,10
2021,170639,30,6,5,2,3
2021,170639,40,0,9,7,2
2021,170639,40,3,2,1,1
2021,170639,40,4,7,6,1
2021,170639,42,0,5,5,0
2021,170639,42,4,5,5,0
2021,170639,43,0,4,2,2
2021,170639,43,3,2,1,1
2021,170639,43,4,2,1,1
2021,170639,50,0,1,1,0
2021,170657,0,0,183,94,89
2021,170657,10,0,183,94,89
2021,170657,10,1,183,94,89
2021,170657,40,0,183,94,89
2021,170657,40,1,183,94,89
2021,170657,42,0,183,94,89
2021,170657,42,1,183,94,89
2021,170675,0,0,115,81,34
2021,170675,10,0,115,81,34
2021,170675,10,1,9,6,3
2021,170675,10,2,24,19,5
2021,170675,10,3,45,31,14
2021,170675,10,5,36,25,11
2021,170675,10,6,1,0,1
2021,170675,20,0,39,34,5
2021,170675,20,1,8,6,2
2021,170675,20,2,22,19,3
2021,170675,20,3,9,9,0
2021,170675,30,0,36,20,16
2021,170675,30,2,2,0,2
2021,170675,30,3,31,18,13
2021,170675,30,5,2,2,0
2021,170675,30,6,1,0,1
2021,170675,40,0,40,27,13
2021,170675,40,1,1,0,1
2021,170675,40,3,5,4,1
2021,170675,40,5,34,23,11
2021,170675,42,0,38,25,13
2021,170675,42,1,1,0,1
2021,170675,42,3,4,3,1
2021,170675,42,5,33,22,11
2021,170675,43,0,2,2,0
2021,170675,43,3,1,1,0
2021,170675,43,5,1,1,0
2021,170790,0,0,193,95,98
2021,170790,10,0,193,95,98
2021,170790,10,1,159,82,77
2021,170790,10,4,30,12,18
2021,170790,10,6,4,1,3
2021,170790,20,0,160,82,78
2021,170790,20,1,159,82,77
2021,170790,20,6,1,0,1
2021,170790,30,0,22,7,15
2021,170790,30,4,22,7,15
2021,170790,40,0,11,6,5
2021,170790,40,4,8,5,3
2021,170790,40,6,3,1,2
2021,170790,41,0,11,6,5
2021,170790,41,4,8,5,3
2021,170790,41,6,3,1,2
2021,170790,45,0,11,6,5
2021,170790,45,4,8,5,3
2021,170790,45,6,3,1,2
2021,170806,0,0,94,24,70
2021,170806,10,0,94,24,70
2021,170806,10,1,19,10,9
2021,170806,10,2,19,6,13
2021,170806,10,3,52,8,44
2021,170806,10,4,4,0,4
2021,170806,40,0,94,24,70
2021,170806,40,1,19,10,9
2021,170806,40,2,19,6,13
2021,170806,40,3,52,8,44
2021,170806,40,4,4,0,4
2021,170806,42,0,94,24,70
2021,170806,42,1,19,10,9
2021,170806,42,2,19,6,13
2021,170806,42,3,52,8,44
2021,170806,42,4,4,0,4
2021,170967,0,0,40,18,22
2021,170967,10,0,40,18,22
2021,170967,10,1,13,8,5
2021,170967,10,2,11,5,6
2021,170967,10,3,15,4,11
2021,170967,10,4,1,1,0
2021,170967,20,0,14,8,6
2021,170967,20,1,12,7,5
2021,170967,20,2,1,0,1
2021,170967,20,3,1,1,0
2021,170967,30,0,26,10,16
2021,170967,30,1,1,1,0
2021,170967,30,2,10,5,5
2021,170967,30,3,14,3,11
2021,170967,30,4,1,1,0
2021,170976,0,0,6655,3855,2800
2021,170976,10,0,6655,3855,2800
2021,170976,10,1,1746,1213,533
2021,170976,10,2,1065,599,466
2021,170976,10,3,1464,756,708
2021,170976,10,4,277,136,141
2021,170976,10,5,602,244,358
2021,170976,10,6,1501,907,594
2021,170976,20,0,2127,1413,714
2021,170976,20,1,1449,1033,416
2021,170976,20,2,678,380,298
2021,170976,30,0,615,338,277
2021,170976,30,1,1,1,0
2021,170976,30,2,10,6,4
2021,170976,30,3,604,331,273
2021,170976,40,0,3913,2104,1809
2021,170976,40,1,296,179,117
2021,170976,40,2,377,213,164
2021,170976,40,3,860,425,435
2021,170976,40,4,277,136,141
2021,170976,40,5,602,244,358
2021,170976,40,6,1501,907,594
2021,170976,41,0,2669,1400,1269
2021,170976,41,1,288,175,113
2021,170976,41,2,369,206,163
2021,170976,41,3,853,424,429
2021,170976,41,4,277,136,141
2021,170976,41,5,445,179,266
2021,170976,41,6,437,280,157
2021,170976,42,0,1141,664,477
2021,170976,42,1,5,3,2
2021,170976,42,2,6,5,1
2021,170976,42,3,6,1,5
2021,170976,42,5,60,28,32
2021,170976,42,6,1064,627,437
2021,170976,43,0,103,40,63
2021,170976,43,1,3,1,2
2021,170976,43,2,2,2,0
2021,170976,43,3,1,0,1
2021,170976,43,5,97,37,60
2021,170976,44,0,2510,1290,1220
2021,170976,44,1,234,139,95
2021,170976,44,2,349,195,154
2021,170976,44,3,853,424,429
2021,170976,44,4,277,136,141
2021,170976,44,5,445,179,266
2021,170976,44,6,352,217,135
2021,170976,45,0,159,110,49
2021,170976,45,1,54,36,18
2021,170976,45,2,20,11,9
2021,170976,45,6,85,63,22
2021,171100,0,0,2942,1653,1289
2021,171100,10,0,2720,1556,1164
2021,171100,10,1,876,629,247
2021,171100,10,2,720,402,318
2021,171100,10,3,920,444,476
2021,171100,10,4,200,79,121
2021,171100,10,5,4,2,2
2021,171100,20,0,1388,903,485
2021,171100,20,1,812,585,227
2021,171100,20,2,576,318,258
2021,171100,30,0,412,215,197
2021,171100,30,2,7,5,2
2021,171100,30,3,405,210,195
2021,171100,40,0,920,438,482
2021,171100,40,1,64,44,20
2021,171100,40,2,137,79,58
2021,171100,40,3,515,234,281
2021,171100,40,4,200,79,121
2021,171100,40,5,4,2,2
2021,171100,41,0,361,179,182
2021,171100,41,1,39,29,10
2021,171100,41,2,68,43,25
2021,171100,41,3,226,96,130
2021,171100,41,4,27,10,17
2021,171100,41,5,1,1,0
2021,171100,42,0,520,235,285
2021,171100,42,1,23,13,10
2021,171100,42,2,59,29,30
2021,171100,42,3,271,125,146
2021,171100,42,4,164,67,97
2021,171100,42,5,3,1,2
2021,171100,43,0,39,24,15
2021,171100,43,1,2,2,0
2021,171100,43,2,10,7,3
2021,171100,43,3,18,13,5
2021,171100,43,4,9,2,7
2021,171100,44,0,361,179,182
2021,171100,44,1,39,29,10
2021,171100,44,2,68,43,25
2021,171100,44,3,226,96,130
2021,171100,44,4,27,10,17
2021,171100,44,5,1,1,0
2021,171100,50,0,222,97,125
2021,171128,0,0,390,266,124
2021,171128,10,0,390,266,124
2021,171128,10,1,113,91,22
2021,171128,10,2,114,82,32
2021,171128,10,3,85,47,38
2021,171128,10,4,17,13,4
2021,171128,10,5,61,33,28
2021,171128,20,0,221,169,52
2021,171128,20,1,113,91,22
2021,171128,20,2,108,78,30
2021,171128,30,0,89,50,39
2021,171128,30,2,6,4,2
2021,171128,30,3,83,46,37
2021,171128,40,0,80,47,33
2021,171128,40,3,2,1,1
2021,171128,40,4,17,13,4
2021,171128,40,5,61,33,28
2021,171128,41,0,72,42,30
2021,171128,41,4,11,9,2
2021,171128,41,5,61,33,28
2021,171128,42,0,8,5,3
2021,171128,42,3,2,1,1
2021,171128,42,4,6,4,2
2021,171128,44,0,23,14,9
2021,171128,44,5,23,14,9
2021,171128,45,0,49,28,21
2021,171128,45,4,11,9,2
2021,171128,45,5,38,19,19
2021,171137,0,0,345,203,142
2021,171137,10,0,345,203,142
2021,171137,10,1,79,54,25
2021,171137,10,2,116,64,52
2021,171137,10,3,59,45,14
2021,171137,10,5,91,40,51
2021,171137,20,0,192,115,77
2021,171137,20,1,77,52,25
2021,171137,20,2,115,63,52
2021,171137,30,0,60,46,14
2021,171137,30,2,1,1,0
2021,171137,30,3,59,45,14
2021,171137,40,0,93,42,51
2021,171137,40,1,2,2,0
2021,171137,40,5,91,40,51
2021,171137,41,0,71,34,37
2021,171137,41,1,1,1,0
2021,171137,41,5,70,33,37
2021,171137,42,0,11,4,7
2021,171137,42,1,1,1,0
2021,171137,42,5,10,3,7
2021,171137,43,0,11,4,7
2021,171137,43,5,11,4,7
2021,171137,44,0,71,34,37
2021,171137,44,1,1,1,0
2021,171137,44,5,70,33,37
2021,171146,0,0,259,113,146
2021,171146,10,0,259,113,146
2021,171146,10,1,40,30,10
2021,171146,10,2,98,41,57
2021,171146,10,3,60,17,43
2021,171146,10,4,4,1,3
2021,171146,10,5,57,24,33
2021,171146,20,0,134,70,64
2021,171146,20,1,40,30,10
2021,171146,20,2,94,40,54
2021,171146,30,0,40,14,26
2021,171146,30,3,40,14,26
2021,171146,40,0,85,29,56
2021,171146,40,2,4,1,3
2021,171146,40,3,20,3,17
2021,171146,40,4,4,1,3
2021,171146,40,5,57,24,33
2021,171146,41,0,75,27,48
2021,171146,41,2,4,1,3
2021,171146,41,3,20,3,17
2021,171146,41,4,1,0,1
2021,171146,41,5,50,23,27
2021,171146,42,0,2,0,2
2021,171146,42,5,2,0,2
2021,171146,43,0,8,2,6
2021,171146,43,4,3,1,2
2021,171146,43,5,5,1,4
2021,171146,44,0,75,27,48
2021,171146,44,2,4,1,3
2021,171146,44,3,20,3,17
2021,171146,44,4,1,0,1
2021,171146,44,5,50,23,27
2021,171155,0,0,52,22,30
2021,171155,10,0,52,22,30
2021,171155,10,1,21,10,11
2021,171155,10,2,8,3,5
2021,171155,10,3,9,3,6
2021,171155,10,4,14,6,8
2021,171155,40,0,52,22,30
2021,171155,40,1,21,10,11
2021,171155,40,2,8,3,5
2021,171155,40,3,9,3,6
2021,171155,40,4,14,6,8
2021,171155,42,0,52,22,30
2021,171155,42,1,21,10,11
2021,171155,42,2,8,3,5
2021,171155,42,3,9,3,6
2021,171155,42,4,14,6,8
2021,171225,0,0,49,25,24
2021,171225,10,0,49,25,24
2021,171225,10,1,8,6,2
2021,171225,10,2,9,7,2
2021,171225,10,3,22,6,16
2021,171225,10,4,10,6,4
2021,171225,20,0,45,21,24
2021,171225,20,1,7,5,2
2021,171225,20,2,9,7,2
2021,171225,20,3,20,4,16
2021,171225,20,4,9,5,4
2021,171225,30,0,4,4,0
2021,171225,30,1,1,1,0
2021,171225,30,3,2,2,0
2021,171225,30,4,1,1,0
2021,171234,0,0,31,11,20
2021,171234,10,0,31,11,20
2021,171234,10,4,31,11,20
2021,171234,20,0,22,7,15
2021,171234,20,4,22,7,15
2021,171234,30,0,9,4,5
2021,171234,30,4,9,4,5
2021,171304,0,0,77,44,33
2021,171304,10,0,77,44,33
2021,171304,10,6,77,44,33
2021,171304,40,0,77,44,33
2021,171304,40,6,77,44,33
2021,171304,42,0,77,44,33
2021,171304,42,6,77,44,33
2021,171395,0,0,30,16,14
2021,171395,10,0,28,14,14
2021,171395,10,1,26,14,12
2021,171395,10,4,2,0,2
2021,171395,40,0,28,14,14
2021,171395,40,1,26,14,12
2021,171395,40,4,2,0,2
2021,171395,43,0,28,14,14
2021,171395,43,1,26,14,12
2021,171395,43,4,2,0,2
2021,171395,50,0,2,2,0
2021,171456,0,0,293,161,132
2021,171456,10,0,293,161,132
2021,171456,10,1,103,66,37
2021,171456,10,2,63,33,30
2021,171456,10,3,72,41,31
2021,171456,10,4,40,11,29
2021,171456,10,6,15,10,5
2021,171456,20,0,155,93,62
2021,171456,20,1,100,64,36
2021,171456,20,2,55,29,26
2021,171456,30,0,49,30,19
2021,171456,30,2,1,0,1
2021,171456,30,3,47,30,17
2021,171456,30,4,1,0,1
2021,171456,40,0,89,38,51
2021,171456,40,1,3,2,1
2021,171456,40,2,7,4,3
2021,171456,40,3,25,11,14
2021,171456,40,4,39,11,28
2021,171456,40,6,15,10,5
2021,171456,41,0,49,25,24
2021,171456,41,1,3,2,1
2021,171456,41,2,7,4,3
2021,171456,41,3,15,7,8
2021,171456,41,4,15,6,9
2021,171456,41,6,9,6,3
2021,171456,42,0,34,9,25
2021,171456,42,3,10,4,6
2021,171456,42,4,23,5,18
2021,171456,42,6,1,0,1
2021,171456,43,0,6,4,2
2021,171456,43,4,1,0,1
2021,171456,43,6,5,4,1
2021,171456,44,0,24,13,11
2021,171456,44,3,11,6,5
2021,171456,44,4,9,3,6
2021,171456,44,6,4,4,0
2021,171456,45,0,25,12,13
2021,171456,45,1,3,2,1
2021,171456,45,2,7,4,3
2021,171456,45,3,4,1,3
2021,171456,45,4,6,3,3
2021,171456,45,6,5,2,3
2021,171483,0,0,80,44,36
2021,171483,10,0,80,44,36
2021,171483,10,6,80,44,36
2021,171483,40,0,80,44,36
2021,171483,40,6,80,44,36
2021,171483,42,0,80,44,36
2021,171483,42,6,80,44,36
2021,171492,0,0,48,30,18
2021,171492,10,0,48,30,18
2021,171492,10,1,3,2,1
2021,171492,10,2,16,9,7
2021,171492,10,3,29,19,10
2021,171492,40,0,48,30,18
2021,171492,40,1,3,2,1
2021,171492,40,2,16,9,7
2021,171492,40,3,29,19,10
2021,171492,42,0,48,30,18
2021,171492,42,1,3,2,1
2021,171492,42,2,16,9,7
2021,171492,42,3,29,19,10
2021,171535,0,0,236,99,137
2021,171535,10,0,236,99,137
2021,171535,10,6,236,99,137
2021,171535,40,0,236,99,137
2021,171535,40,6,236,99,137
2021,171535,41,0,226,95,131
2021,171535,41,6,226,95,131
2021,171535,42,0,2,1,1
2021,171535,42,6,2,1,1
2021,171535,43,0,8,3,5
2021,171535,43,6,8,3,5
2021,171535,44,0,22,6,16
2021,171535,44,6,22,6,16
2021,171535,45,0,204,89,115
2021,171535,45,6,204,89,115
2021,171571,0,0,652,333,319
2021,171571,10,0,652,333,319
2021,171571,10,1,143,97,46
2021,171571,10,2,257,129,128
2021,171571,10,3,176,88,88
2021,171571,10,4,76,19,57
2021,171571,20,0,405,220,185
2021,171571,20,1,143,97,46
2021,171571,20,2,242,119,123
2021,171571,20,4,20,4,16
2021,171571,30,0,188,89,99
2021,171571,30,2,10,7,3
2021,171571,30,3,146,71,75
2021,171571,30,4,32,11,21
2021,171571,40,0,59,24,35
2021,171571,40,2,5,3,2
2021,171571,40,3,30,17,13
2021,171571,40,4,24,4,20
2021,171571,41,0,26,8,18
2021,171571,41,2,5,3,2
2021,171571,41,3,3,2,1
2021,171571,41,4,18,3,15
2021,171571,42,0,33,16,17
2021,171571,42,3,27,15,12
2021,171571,42,4,6,1,5
2021,171571,44,0,26,8,18
2021,171571,44,2,5,3,2
2021,171571,44,3,3,2,1
2021,171571,44,4,18,3,15
2021,171599,0,0,47,23,24
2021,171599,10,0,47,23,24
2021,171599,10,1,10,6,4
2021,171599,10,2,16,10,6
2021,171599,10,3,21,7,14
2021,171599,20,0,32,19,13
2021,171599,20,1,10,6,4
2021,171599,20,2,16,10,6
2021,171599,20,3,6,3,3
2021,171599,30,0,12,2,10
2021,171599,30,3,12,2,10
2021,171599,40,0,3,2,1
2021,171599,40,3,3,2,1
2021,171599,42,0,3,2,1
2021,171599,42,3,3,2,1
2021,171881,0,0,7,3,4
2021,171881,10,0,7,3,4
2021,171881,10,1,3,1,2
2021,171881,10,2,1,1,0
2021,171881,10,3,3,1,2
2021,171881,20,0,4,2,2
2021,171881,20,1,3,1,2
2021,171881,20,2,1,1,0
2021,171881,30,0,3,1,2
2021,171881,30,3,3,1,2
2021,172033,0,0,15,12,3
2021,172033,10,0,15,12,3
2021,172033,10,1,9,7,2
2021,172033,10,2,3,2,1
2021,172033,10,3,3,3,0
2021,172033,40,0,15,12,3
2021,172033,40,1,9,7,2
2021,172033,40,2,3,2,1
2021,172033,40,3,3,3,0
2021,172033,41,0,15,12,3
2021,172033,41,1,9,7,2
2021,172033,41,2,3,2,1
2021,172033,41,3,3,3,0
2021,172033,44,0,15,12,3
2021,172033,44,1,9,7,2
2021,172033,44,2,3,2,1
2021,172033,44,3,3,3,0
2021,172051,0,0,273,144,129
2021,172051,10,0,273,144,129
2021,172051,10,1,113,69,44
2021,172051,10,2,87,38,49
2021,172051,10,3,51,29,22
2021,172051,10,4,4,1,3
2021,172051,10,5,18,7,11
2021,172051,20,0,206,110,96
2021,172051,20,1,112,69,43
2021,172051,20,2,87,38,49
2021,172051,20,3,7,3,4
2021,172051,30,0,49,27,22
2021,172051,30,1,1,0,1
2021,172051,30,3,44,26,18
2021,172051,30,4,4,1,3
2021,172051,40,0,18,7,11
2021,172051,40,5,18,7,11
2021,172051,42,0,18,7,11
2021,172051,42,5,18,7,11
2021,172200,0,0,85,40,45
2021,172200,10,0,85,40,45
2021,172200,10,6,85,40,45
2021,172200,40,0,85,40,45
2021,172200,40,6,85,40,45
2021,172200,42,0,85,40,45
2021,172200,42,6,85,40,45
2021,172264,0,0,86,44,42
2021,172264,10,0,86,44,42
2021,172264,10,1,24,16,8
2021,172264,10,2,32,14,18
2021,172264,10,3,28,13,15
2021,172264,10,4,2,1,1
2021,172264,40,0,86,44,42
2021,172264,40,1,24,16,8
2021,172264,40,2,32,14,18
2021,172264,40,3,28,13,15
2021,172264,40,4,2,1,1
2021,172264,42,0,86,44,42
2021,172264,42,1,24,16,8
2021,172264,42,2,32,14,18
2021,172264,42,3,28,13,15
2021,172264,42,4,2,1,1
2021,172291,0,0,65,28,37
2021,172291,10,0,65,28,37
2021,172291,10,1,56,26,30
2021,172291,10,4,9,2,7
2021,172291,20,0,56,26,30
2021,172291,20,1,56,26,30
2021,172291,30,0,8,2,6
2021,172291,30,4,8,2,6
2021,172291,40,0,1,0,1
2021,172291,40,4,1,0,1
2021,172291,42,0,1,0,1
2021,172291,42,4,1,0,1
2021,172307,0,0,47,24,23
2021,172307,10,0,47,24,23
2021,172307,10,1,20,7,13
2021,172307,10,2,12,7,5
2021,172307,10,3,15,10,5
2021,172307,40,0,47,24,23
2021,172307,40,1,20,7,13
2021,172307,40,2,12,7,5
2021,172307,40,3,15,10,5
2021,172307,41,0,42,21,21
2021,172307,41,1,20,7,13
2021,172307,41,2,12,7,5
2021,172307,41,3,10,7,3
2021,172307,42,0,5,3,2
2021,172307,42,3,5,3,2
2021,172307,44,0,42,21,21
2021,172307,44,1,20,7,13
2021,172307,44,2,12,7,5
2021,172307,44,3,10,7,3
2021,172334,0,0,77,42,35
2021,172334,10,0,77,42,35
2021,172334,10,1,27,20,7
2021,172334,10,2,22,13,9
2021,172334,10,3,28,9,19
2021,172334,20,0,33,27,6
2021,172334,20,1,25,20,5
2021,172334,20,2,8,7,1
2021,172334,30,0,35,13,22
2021,172334,30,1,2,0,2
2021,172334,30,2,14,6,8
2021,172334,30,3,19,7,12
2021,172334,40,0,9,2,7
2021,172334,40,3,9,2,7
2021,172334,42,0,9,2,7
2021,172334,42,3,9,2,7
2021,172440,0,0,31,12,19
2021,172440,10,0,31,12,19
2021,172440,10,1,3,1,2
2021,172440,10,2,12,7,5
2021,172440,10,3,14,4,10
2021,172440,10,4,2,0,2
2021,172440,20,0,15,8,7
2021,172440,20,1,3,1,2
2021,172440,20,2,12,7,5
2021,172440,30,0,13,4,9
2021,172440,30,3,13,4,9
2021,172440,40,0,3,0,3
2021,172440,40,3,1,0,1
2021,172440,40,4,2,0,2
2021,172440,42,0,2,0,2
2021,172440,42,3,1,0,1
2021,172440,42,4,1,0,1
2021,172440,43,0,1,0,1
2021,172440,43,4,1,0,1
2021,172477,0,0,38,18,20
2021,172477,10,0,36,16,20
2021,172477,10,1,30,15,15
2021,172477,10,2,2,0,2
2021,172477,10,3,4,1,3
2021,172477,20,0,30,15,15
2021,172477,20,1,30,15,15
2021,172477,30,0,3,0,3
2021,172477,30,2,2,0,2
2021,172477,30,3,1,0,1
2021,172477,40,0,3,1,2
2021,172477,40,3,3,1,2
2021,172477,42,0,3,1,2
2021,172477,42,3,3,1,2
2021,172477,50,0,2,2,0
2021,172608,0,0,14,10,4
2021,172608,10,0,14,10,4
2021,172608,10,1,7,4,3
2021,172608,10,2,7,6,1
2021,172608,40,0,14,10,4
2021,172608,40,1,7,4,3
2021,172608,40,2,7,6,1
2021,172608,41,0,14,10,4
2021,172608,41,1,7,4,3
2021,172608,41,2,7,6,1
2021,172608,44,0,14,10,4
2021,172608,44,1,7,4,3
2021,172608,44,2,7,6,1
2021,172617,0,0,155,74,81
2021,172617,10,0,155,74,81
2021,172617,10,6,155,74,81
2021,172617,40,0,155,74,81
2021,172617,40,6,155,74,81
2021,172617,41,0,155,74,81
2021,172617,41,6,155,74,81
2021,172617,44,0,155,74,81
2021,172617,44,6,155,74,81
2021,172635,0,0,69,32,37
2021,172635,10,0,69,32,37
2021,172635,10,4,69,32,37
2021,172635,40,0,69,32,37
2021,172635,40,4,69,32,37
2021,172635,41,0,69,32,37
2021,172635,41,4,69,32,37
2021,172635,45,0,69,32,37
2021,172635,45,4,69,32,37
2021,172644,0,0,1493,837,656
2021,172644,10,0,1493,837,656
2021,172644,10,1,467,339,128
2021,172644,10,2,431,227,204
2021,172644,10,3,389,191,198
2021,172644,10,4,24,2,22
2021,172644,10,5,178,76,102
2021,172644,10,6,4,2,2
2021,172644,20,0,716,458,258
2021,172644,20,1,387,283,104
2021,172644,20,2,327,173,154
2021,172644,20,3,2,2,0
2021,172644,30,0,180,102,78
2021,172644,30,2,9,6,3
2021,172644,30,3,170,96,74
2021,172644,30,6,1,0,1
2021,172644,40,0,597,277,320
2021,172644,40,1,80,56,24
2021,172644,40,2,95,48,47
2021,172644,40,3,217,93,124
2021,172644,40,4,24,2,22
2021,172644,40,5,178,76,102
2021,172644,40,6,3,2,1
2021,172644,41,0,574,275,299
2021,172644,41,1,80,56,24
2021,172644,41,2,95,48,47
2021,172644,41,3,216,93,123
2021,172644,41,4,2,0,2
2021,172644,41,5,178,76,102
2021,172644,41,6,3,2,1
2021,172644,42,0,23,2,21
2021,172644,42,3,1,0,1
2021,172644,42,4,22,2,20
2021,172644,44,0,574,275,299
2021,172644,44,1,80,56,24
2021,172644,44,2,95,48,47
2021,172644,44,3,216,93,123
2021,172644,44,4,2,0,2
2021,172644,44,5,178,76,102
2021,172644,44,6,3,2,1
2021,172671,0,0,25,16,9
2021,172671,10,0,25,16,9
2021,172671,10,1,22,14,8
2021,172671,10,2,3,2,1
2021,172671,20,0,22,14,8
2021,172671,20,1,22,14,8
2021,172671,30,0,3,2,1
2021,172671,30,2,3,2,1
2021,172699,0,0,736,383,353
2021,172699,10,0,736,383,353
2021,172699,10,1,300,197,103
2021,172699,10,2,210,107,103
2021,172699,10,3,172,61,111
2021,172699,10,4,54,18,36
2021,172699,20,0,512,298,214
2021,172699,20,1,298,195,103
2021,172699,20,2,196,99,97
2021,172699,20,3,18,4,14
2021,172699,30,0,172,65,107
2021,172699,30,1,2,2,0
2021,172699,30,2,13,8,5
2021,172699,30,3,133,48,85
2021,172699,30,4,24,7,17
2021,172699,40,0,52,20,32
2021,172699,40,2,1,0,1
2021,172699,40,3,21,9,12
2021,172699,40,4,30,11,19
2021,172699,42,0,52,20,32
2021,172699,42,2,1,0,1
2021,172699,42,3,21,9,12
2021,172699,42,4,30,11,19
2021,172705,0,0,12,9,3
2021,172705,10,0,12,9,3
2021,172705,10,1,6,5,1
2021,172705,10,2,4,3,1
2021,172705,10,3,1,1,0
2021,172705,10,4,1,0,1
2021,172705,20,0,6,5,1
2021,172705,20,1,6,5,1
2021,172705,30,0,5,4,1
2021,172705,30,2,4,3,1
2021,172705,30,3,1,1,0
2021,172705,40,0,1,0,1
2021,172705,40,4,1,0,1
2021,172705,41,0,1,0,1
2021,172705,41,4,1,0,1
2021,172705,45,0,1,0,1
2021,172705,45,4,1,0,1
2021,172918,0,0,64,33,31
2021,172918,10,0,64,33,31
2021,172918,10,4,64,33,31
2021,172918,20,0,54,27,27
2021,172918,20,4,54,27,27
2021,172918,30,0,10,6,4
2021,172918,30,4,10,6,4
2021,172954,0,0,55,22,33
2021,172954,10,0,55,22,33
2021,172954,10,4,55,22,33
2021,172954,20,0,49,18,31
2021,172954,20,4,49,18,31
2021,172954,30,0,6,4,2
2021,172954,30,4,6,4,2
2021,172963,0,0,122,46,76
2021,172963,10,0,122,46,76
2021,172963,10,4,122,46,76
2021,172963,20,0,108,42,66
2021,172963,20,4,108,42,66
2021,172963,30,0,13,4,9
2021,172963,30,4,13,4,9
2021,172963,40,0,1,0,1
2021,172963,40,4,1,0,1
2021,172963,43,0,1,0,1
2021,172963,43,4,1,0,1
2021,173045,0,0,169,71,98
2021,173045,10,0,169,71,98
2021,173045,10,1,43,20,23
2021,173045,10,2,49,28,21
2021,173045,10,3,47,16,31
2021,173045,10,4,30,7,23
2021,173045,20,0,83,45,38
2021,173045,20,1,40,18,22
2021,173045,20,2,43,27,16
2021,173045,30,0,41,14,27
2021,173045,30,2,4,1,3
2021,173045,30,3,36,13,23
2021,173045,30,4,1,0,1
2021,173045,40,0,45,12,33
2021,173045,40,1,3,2,1
2021,173045,40,2,2,0,2
2021,173045,40,3,11,3,8
2021,173045,40,4,29,7,22
2021,173045,42,0,45,12,33
2021,173045,42,1,3,2,1
2021,173045,42,2,2,0,2
2021,173045,42,3,11,3,8
2021,173045,42,4,29,7,22
2021,173063,0,0,64,29,35
2021,173063,10,0,64,29,35
2021,173063,10,4,64,29,35
2021,173063,20,0,50,22,28
2021,173063,20,4,50,22,28
2021,173063,30,0,13,6,7
2021,173063,30,4,13,6,7
2021,173063,40,0,1,1,0
2021,173063,40,4,1,1,0
2021,173063,42,0,1,1,0
2021,173063,42,4,1,1,0
2021,173115,0,0,21,8,13
2021,173115,10,0,21,8,13
2021,173115,10,4,21,8,13
2021,173115,20,0,11,3,8
2021,173115,20,4,11,3,8
2021,173115,30,0,10,5,5
2021,173115,30,4,10,5,5
2021,173124,0,0,177,93,84
2021,173124,10,0,177,93,84
2021,173124,10,1,48,31,17
2021,173124,10,2,61,32,29
2021,173124,10,3,68,30,38
2021,173124,20,0,94,58,36
2021,173124,20,1,48,31,17
2021,173124,20,2,42,24,18
2021,173124,20,3,4,3,1
2021,173124,30,0,59,23,36
2021,173124,30,2,12,6,6
2021,173124,30,3,47,17,30
2021,173124,40,0,24,12,12
2021,173124,40,2,7,2,5
2021,173124,40,3,17,10,7
2021,173124,42,0,24,12,12
2021,173124,42,2,7,2,5
2021,173124,42,3,17,10,7
2021,173142,0,0,43,29,14
2021,173142,10,0,43,29,14
2021,173142,10,1,14,10,4
2021,173142,10,2,15,12,3
2021,173142,10,3,14,7,7
2021,173142,40,0,43,29,14
2021,173142,40,1,14,10,4
2021,173142,40,2,15,12,3
2021,173142,40,3,14,7,7
2021,173142,42,0,1,0,1
2021,173142,42,3,1,0,1
2021,173142,43,0,42,29,13
2021,173142,43,1,14,10,4
2021,173142,43,2,15,12,3
2021,173142,43,3,13,7,6
2021,173160,0,0,175,73,102
2021,173160,10,0,175,73,102
2021,173160,10,1,62,34,28
2021,173160,10,2,77,30,47
2021,173160,10,3,31,9,22
2021,173160,10,4,5,0,5
2021,173160,20,0,107,53,54
2021,173160,20,1,60,32,28
2021,173160,20,2,43,19,24
2021,173160,20,3,4,2,2
2021,173160,30,0,45,13,32
2021,173160,30,1,1,1,0
2021,173160,30,2,21,6,15
2021,173160,30,3,19,6,13
2021,173160,30,4,4,0,4
2021,173160,40,0,23,7,16
2021,173160,40,1,1,1,0
2021,173160,40,2,13,5,8
2021,173160,40,3,8,1,7
2021,173160,40,4,1,0,1
2021,173160,41,0,14,3,11
2021,173160,41,2,7,2,5
2021,173160,41,3,6,1,5
2021,173160,41,4,1,0,1
2021,173160,42,0,9,4,5
2021,173160,42,1,1,1,0
2021,173160,42,2,6,3,3
2021,173160,42,3,2,0,2
2021,173160,44,0,14,3,11
2021,173160,44,2,7,2,5
2021,173160,44,3,6,1,5
2021,173160,44,4,1,0,1
2021,173203,0,0,78,44,34
2021,173203,10,0,78,44,34
2021,173203,10,4,78,44,34
2021,173203,20,0,66,38,28
2021,173203,20,4,66,38,28
2021,173203,30,0,8,3,5
2021,173203,30,4,8,3,5
2021,173203,40,0,4,3,1
2021,173203,40,4,4,3,1
2021,173203,42,0,4,3,1
2021,173203,42,4,4,3,1
2021,173258,0,0,237,119,118
2021,173258,10,0,223,112,111
2021,173258,10,1,104,57,47
2021,173258,10,2,51,27,24
2021,173258,10,3,52,23,29
2021,173258,10,4,3,1,2
2021,173258,10,5,11,4,7
2021,173258,10,6,2,0,2
2021,173258,20,0,141,74,67
2021,173258,20,1,94,50,44
2021,173258,20,2,47,24,23
2021,173258,30,0,47,23,24
2021,173258,30,2,1,1,0
2021,173258,30,3,46,22,24
2021,173258,40,0,35,15,20
2021,173258,40,1,10,7,3
2021,173258,40,2,3,2,1
2021,173258,40,3,6,1,5
2021,173258,40,4,3,1,2
2021,173258,40,5,11,4,7
2021,173258,40,6,2,0,2
2021,173258,41,0,30,14,16
2021,173258,41,1,10,7,3
2021,173258,41,2,3,2,1
2021,173258,41,3,2,0,2
2021,173258,41,4,3,1,2
2021,173258,41,5,11,4,7
2021,173258,41,6,1,0,1
2021,173258,42,0,5,1,4
2021,173258,42,3,4,1,3
2021,173258,42,6,1,0,1
2021,173258,44,0,30,14,16
2021,173258,44,1,10,7,3
2021,173258,44,2,3,2,1
2021,173258,44,3,2,0,2
2021,173258,44,4,3,1,2
2021,173258,44,5,11,4,7
2021,173258,44,6,1,0,1
2021,173258,50,0,14,7,7
2021,173300,0,0,137,71,66
2021,173300,10,0,137,71,66
2021,173300,10,1,45,28,17
2021,173300,10,2,46,21,25
2021,173300,10,3,39,20,19
2021,173300,10,4,7,2,5
2021,173300,20,0,88,50,38
2021,173300,20,1,44,28,16
2021,173300,20,2,42,20,22
2021,173300,20,3,2,2,0
2021,173300,30,0,28,13,15
2021,173300,30,1,1,0,1
2021,173300,30,3,27,13,14
2021,173300,40,0,21,8,13
2021,173300,40,2,4,1,3
2021,173300,40,3,10,5,5
2021,173300,40,4,7,2,5
2021,173300,41,0,17,6,11
2021,173300,41,2,4,1,3
2021,173300,41,3,8,4,4
2021,173300,41,4,5,1,4
2021,173300,42,0,4,2,2
2021,173300,42,3,2,1,1
2021,173300,42,4,2,1,1
2021,173300,44,0,13,5,8
2021,173300,44,3,8,4,4
2021,173300,44,4,5,1,4
2021,173300,45,0,4,1,3
2021,173300,45,2,4,1,3
2021,173328,0,0,100,38,62
2021,173328,10,0,100,38,62
2021,173328,10,1,28,14,14
2021,173328,10,2,33,14,19
2021,173328,10,3,21,7,14
2021,173328,10,4,18,3,15
2021,173328,20,0,20,10,10
2021,173328,20,1,19,10,9
2021,173328,20,2,1,0,1
2021,173328,30,0,31,13,18
2021,173328,30,1,5,2,3
2021,173328,30,2,13,6,7
2021,173328,30,3,8,4,4
2021,173328,30,4,5,1,4
2021,173328,40,0,49,15,34
2021,173328,40,1,4,2,2
2021,173328,40,2,19,8,11
2021,173328,40,3,13,3,10
2021,173328,40,4,13,2,11
2021,173328,41,0,21,10,11
2021,173328,41,1,1,1,0
2021,173328,41,2,8,4,4
2021,173328,41,3,6,3,3
2021,173328,41,4,6,2,4
2021,173328,42,0,21,4,17
2021,173328,42,1,3,1,2
2021,173328,42,2,10,3,7
2021,173328,42,3,6,0,6
2021,173328,42,4,2,0,2
2021,173328,43,0,7,1,6
2021,173328,43,2,1,1,0
2021,173328,43,3,1,0,1
2021,173328,43,4,5,0,5
2021,173328,44,0,21,10,11
2021,173328,44,1,1,1,0
2021,173328,44,2,8,4,4
2021,173328,44,3,6,3,3
2021,173328,44,4,6,2,4
2021,173416,0,0,61,38,23
2021,173416,10,0,61,38,23
2021,173416,10,4,61,38,23
2021,173416,20,0,49,31,18
2021,173416,20,4,49,31,18
2021,173416,30,0,11,6,5
2021,173416,30,4,11,6,5
2021,173416,40,0,1,1,0
2021,173416,40,4,1,1,0
2021,173416,42,0,1,1,0
2021,173416,42,4,1,1,0
2021,173452,0,0,79,59,20
2021,173452,10,0,79,59,20
2021,173452,10,1,79,59,20
2021,173452,40,0,79,59,20
2021,173452,40,1,79,59,20
2021,173452,41,0,79,59,20
2021,173452,41,1,79,59,20
2021,173452,45,0,79,59,20
2021,173452,45,1,79,59,20
2021,173461,0,0,72,38,34
2021,173461,10,0,72,38,34
2021,173461,10,4,72,38,34
2021,173461,20,0,55,30,25
2021,173461,20,4,55,30,25
2021,173461,30,0,17,8,9
2021,173461,30,4,17,8,9
2021,173559,0,0,108,55,53
2021,173559,10,0,108,55,53
2021,173559,10,4,108,55,53
2021,173559,20,0,95,49,46
2021,173559,20,4,95,49,46
2021,173559,30,0,12,6,6
2021,173559,30,4,12,6,6
2021,173559,40,0,1,0,1
2021,173559,40,4,1,0,1
2021,173559,42,0,1,0,1
2021,173559,42,4,1,0,1
2021,173638,0,0,72,42,30
2021,173638,10,0,72,42,30
2021,173638,10,4,72,42,30
2021,173638,20,0,63,37,26
2021,173638,20,4,63,37,26
2021,173638,30,0,9,5,4
2021,173638,30,4,9,5,4
2021,173647,0,0,183,78,105
2021,173647,10,0,183,78,105
2021,173647,10,1,50,26,24
2021,173647,10,2,65,28,37
2021,173647,10,3,55,17,38
2021,173647,10,4,13,7,6
2021,173647,20,0,114,54,60
2021,173647,20,1,50,26,24
2021,173647,20,2,64,28,36
2021,173647,30,0,23,5,18
2021,173647,30,3,23,5,18
2021,173647,40,0,46,19,27
2021,173647,40,2,1,0,1
2021,173647,40,3,32,12,20
2021,173647,40,4,13,7,6
2021,173647,41,0,11,5,6
2021,173647,41,3,6,3,3
2021,173647,41,4,5,2,3
2021,173647,42,0,35,14,21
2021,173647,42,2,1,0,1
2021,173647,42,3,26,9,17
2021,173647,42,4,8,5,3
2021,173647,44,0,11,5,6
2021,173647,44,3,6,3,3
2021,173647,44,4,5,2,3
2021,173665,0,0,118,54,64
2021,173665,10,0,118,54,64
2021,173665,10,1,49,20,29
2021,173665,10,2,31,14,17
2021,173665,10,3,17,7,10
2021,173665,10,4,2,1,1
2021,173665,10,5,10,5,5
2021,173665,10,6,9,7,2
2021,173665,20,0,79,33,46
2021,173665,20,1,49,20,29
2021,173665,20,2,30,13,17
2021,173665,30,0,18,8,10
2021,173665,30,2,1,1,0
2021,173665,30,3,17,7,10
2021,173665,40,0,21,13,8
2021,173665,40,4,2,1,1
2021,173665,40,5,10,5,5
2021,173665,40,6,9,7,2
2021,173665,42,0,21,13,8
2021,173665,42,4,2,1,1
2021,173665,42,5,10,5,5
2021,173665,42,6,9,7,2
2021,173708,0,0,100,63,37
2021,173708,10,0,100,63,37
2021,173708,10,4,100,63,37
2021,173708,20,0,85,52,33
2021,173708,20,4,85,52,33
2021,173708,30,0,13,10,3
2021,173708,30,4,13,10,3
2021,173708,40,0,2,1,1
2021,173708,40,4,2,1,1
2021,173708,42,0,1,1,0
2021,173708,42,4,1,1,0
2021,173708,43,0,1,0,1
2021,173708,43,4,1,0,1
2021,173735,0,0,33,19,14
2021,173735,10,0,33,19,14
2021,173735,10,4,33,19,14
2021,173735,20,0,26,17,9
2021,173735,20,4,26,17,9
2021,173735,30,0,7,2,5
2021,173735,30,4,7,2,5
2021,173799,0,0,80,34,46
2021,173799,10,0,80,34,46
2021,173799,10,4,80,34,46
2021,173799,20,0,64,29,35
2021,173799,20,4,64,29,35
2021,173799,30,0,14,4,10
2021,173799,30,4,14,4,10
2021,173799,40,0,2,1,1
2021,173799,40,4,2,1,1
2021,173799,42,0,2,1,1
2021,173799,42,4,2,1,1
2021,173805,0,0,27,13,14
2021,173805,10,0,27,13,14
2021,173805,10,4,27,13,14
2021,173805,20,0,20,10,10
2021,173805,20,4,20,10,10
2021,173805,30,0,7,3,4
2021,173805,30,4,7,3,4
2021,173896,0,0,22,11,11
2021,173896,10,0,22,11,11
2021,173896,10,1,15,8,7
2021,173896,10,2,4,2,2
2021,173896,10,3,3,1,2
2021,173896,20,0,16,9,7
2021,173896,20,1,15,8,7
2021,173896,20,2,1,1,0
2021,173896,40,0,6,2,4
2021,173896,40,2,3,1,2
2021,173896,40,3,3,1,2
2021,173896,41,0,4,1,3
2021,173896,41,2,3,1,2
2021,173896,41,3,1,0,1
2021,173896,42,0,2,1,1
2021,173896,42,3,2,1,1
2021,173896,44,0,3,1,2
2021,173896,44,2,2,1,1
2021,173896,44,3,1,0,1
2021,173896,45,0,1,0,1
2021,173896,45,2,1,0,1
2021,173902,0,0,203,87,116
2021,173902,10,0,203,87,116
2021,173902,10,1,78,40,38
2021,173902,10,2,44,23,21
2021,173902,10,3,33,10,23
2021,173902,10,4,40,12,28
2021,173902,10,5,4,0,4
2021,173902,10,6,4,2,2
2021,173902,20,0,122,63,59
2021,173902,20,1,78,40,38
2021,173902,20,2,44,23,21
2021,173902,30,0,33,10,23
2021,173902,30,3,33,10,23
2021,173902,40,0,48,14,34
2021,173902,40,4,40,12,28
2021,173902,40,5,4,0,4
2021,173902,40,6,4,2,2
2021,173902,42,0,48,14,34
2021,173902,42,4,40,12,28
2021,173902,42,5,4,0,4
2021,173902,42,6,4,2,2
2021,173911,0,0,78,42,36
2021,173911,10,0,78,42,36
2021,173911,10,4,78,42,36
2021,173911,20,0,56,33,23
2021,173911,20,4,56,33,23
2021,173911,30,0,22,9,13
2021,173911,30,4,22,9,13
2021,173920,0,0,489,247,242
2021,173920,10,0,489,247,242
2021,173920,10,1,182,101,81
2021,173920,10,2,152,75,77
2021,173920,10,3,146,63,83
2021,173920,10,4,9,8,1
2021,173920,20,0,337,176,161
2021,173920,20,1,180,100,80
2021,173920,20,2,146,72,74
2021,173920,20,3,11,4,7
2021,173920,30,0,113,53,60
2021,173920,30,1,2,1,1
2021,173920,30,2,6,3,3
2021,173920,30,3,104,49,55
2021,173920,30,4,1,0,1
2021,173920,40,0,39,18,21
2021,173920,40,3,31,10,21
2021,173920,40,4,8,8,0
2021,173920,42,0,38,18,20
2021,173920,42,3,30,10,20
2021,173920,42,4,8,8,0
2021,173920,43,0,1,0,1
2021,173920,43,3,1,0,1
2021,173993,0,0,30,17,13
2021,173993,10,0,30,17,13
2021,173993,10,4,30,17,13
2021,173993,20,0,25,15,10
2021,173993,20,4,25,15,10
2021,173993,30,0,5,2,3
2021,173993,30,4,5,2,3
2021,174020,0,0,182,71,111
2021,174020,10,0,182,71,111
2021,174020,10,1,60,22,38
2021,174020,10,2,72,30,42
2021,174020,10,3,50,19,31
2021,174020,20,0,125,50,75
2021,174020,20,1,59,22,37
2021,174020,20,2,64,27,37
2021,174020,20,3,2,1,1
2021,174020,30,0,48,16,32
2021,174020,30,2,6,2,4
2021,174020,30,3,42,14,28
2021,174020,40,0,9,5,4
2021,174020,40,1,1,0,1
2021,174020,40,2,2,1,1
2021,174020,40,3,6,4,2
2021,174020,42,0,9,5,4
2021,174020,42,1,1,0,1
2021,174020,42,2,2,1,1
2021,174020,42,3,6,4,2
2021,174066,0,0,3659,2069,1590
2021,174066,10,0,3305,1936,1369
2021,174066,10,1,1209,840,369
2021,174066,10,2,895,494,401
2021,174066,10,3,1157,575,582
2021,174066,10,4,36,22,14
2021,174066,10,6,8,5,3
2021,174066,20,0,1638,1078,560
2021,174066,20,1,1072,753,319
2021,174066,20,2,565,324,241
2021,174066,20,3,1,1,0
2021,174066,30,0,489,247,242
2021,174066,30,2,49,25,24
2021,174066,30,3,440,222,218
2021,174066,40,0,1178,611,567
2021,174066,40,1,137,87,50
2021,174066,40,2,281,145,136
2021,174066,40,3,716,352,364
2021,174066,40,4,36,22,14
2021,174066,40,6,8,5,3
2021,174066,41,0,32,12,20
2021,174066,41,1,5,5,0
2021,174066,41,2,8,1,7
2021,174066,41,3,16,4,12
2021,174066,41,4,3,2,1
2021,174066,42,0,1140,597,543
2021,174066,42,1,131,81,50
2021,174066,42,2,273,144,129
2021,174066,42,3,697,348,349
2021,174066,42,4,32,20,12
2021,174066,42,6,7,4,3
2021,174066,43,0,6,2,4
2021,174066,43,1,1,1,0
2021,174066,43,3,3,0,3
2021,174066,43,4,1,0,1
2021,174066,43,6,1,1,0
2021,174066,44,0,32,12,20
2021,174066,44,1,5,5,0
2021,174066,44,2,8,1,7
2021,174066,44,3,16,4,12
2021,174066,44,4,3,2,1
2021,174066,50,0,354,133,221
2021,174075,0,0,63,32,31
2021,174075,10,0,40,23,17
2021,174075,10,1,8,5,3
2021,174075,10,2,15,11,4
2021,174075,10,3,13,5,8
2021,174075,10,4,3,1,2
2021,174075,10,6,1,1,0
2021,174075,20,0,24,16,8
2021,174075,20,1,8,5,3
2021,174075,20,2,15,11,4
2021,174075,20,3,1,0,1
2021,174075,30,0,12,5,7
2021,174075,30,3,12,5,7
2021,174075,40,0,4,2,2
2021,174075,40,4,3,1,2
2021,174075,40,6,1,1,0
2021,174075,42,0,4,2,2
2021,174075,42,4,3,1,2
2021,174075,42,6,1,1,0
2021,174075,50,0,23,9,14
2021,174127,0,0,35,17,18
2021,174127,10,0,35,17,18
2021,174127,10,1,19,11,8
2021,174127,10,2,8,4,4
2021,174127,10,3,5,1,4
2021,174127,10,6,3,1,2
2021,174127,40,0,35,17,18
2021,174127,40,1,19,11,8
2021,174127,40,2,8,4,4
2021,174127,40,3,5,1,4
2021,174127,40,6,3,1,2
2021,174127,41,0,32,16,16
2021,174127,41,1,19,11,8
2021,174127,41,2,8,4,4
2021,174127,41,3,5,1,4
2021,174127,42,0,3,1,2
2021,174127,42,6,3,1,2
2021,174127,44,0,32,16,16
2021,174127,44,1,19,11,8
2021,174127,44,2,8,4,4
2021,174127,44,3,5,1,4
2021,174136,0,0,106,46,60
2021,174136,10,0,106,46,60
2021,174136,10,4,106,46,60
2021,174136,20,0,94,40,54
2021,174136,20,4,94,40,54
2021,174136,30,0,12,6,6
2021,174136,30,4,12,6,6
2021,174154,0,0,23,0,23
2021,174154,10,0,23,0,23
2021,174154,10,2,2,0,2
2021,174154,10,3,17,0,17
2021,174154,10,4,4,0,4
2021,174154,40,0,23,0,23
2021,174154,40,2,2,0,2
2021,174154,40,3,17,0,17
2021,174154,40,4,4,0,4
2021,174154,41,0,23,0,23
2021,174154,41,2,2,0,2
2021,174154,41,3,17,0,17
2021,174154,41,4,4,0,4
2021,174154,45,0,23,0,23
2021,174154,45,2,2,0,2
2021,174154,45,3,17,0,17
2021,174154,45,4,4,0,4
2021,174233,0,0,478,263,215
2021,174233,10,0,478,263,215
2021,174233,10,1,95,70,25
2021,174233,10,2,146,78,68
2021,174233,10,3,149,76,73
2021,174233,10,4,88,39,49
2021,174233,20,0,240,148,92
2021,174233,20,1,95,70,25
2021,174233,20,2,144,77,67
2021,174233,20,3,1,1,0
2021,174233,30,0,77,42,35
2021,174233,30,2,2,1,1
2021,174233,30,3,75,41,34
2021,174233,40,0,161,73,88
2021,174233,40,3,73,34,39
2021,174233,40,4,88,39,49
2021,174233,41,0,36,19,17
2021,174233,41,3,15,8,7
2021,174233,41,4,21,11,10
2021,174233,42,0,124,54,70
2021,174233,42,3,57,26,31
2021,174233,42,4,67,28,39
2021,174233,43,0,1,0,1
2021,174233,43,3,1,0,1
2021,174233,44,0,36,19,17
2021,174233,44,3,15,8,7
2021,174233,44,4,21,11,10
2021,174251,0,0,101,58,43
2021,174251,10,0,86,49,37
2021,174251,10,1,25,17,8
2021,174251,10,2,40,20,20
2021,174251,10,3,21,12,9
2021,174251,20,0,64,36,28
2021,174251,20,1,25,17,8
2021,174251,20,2,39,19,20
2021,174251,30,0,19,11,8
2021,174251,30,3,19,11,8
2021,174251,40,0,3,2,1
2021,174251,40,2,1,1,0
2021,174251,40,3,2,1,1
2021,174251,42,0,3,2,1
2021,174251,42,2,1,1,0
2021,174251,42,3,2,1,1
2021,174251,50,0,15,9,6
2021,174358,0,0,190,97,93
2021,174358,10,0,190,97,93
2021,174358,10,1,96,59,37
2021,174358,10,2,39,15,24
2021,174358,10,3,52,23,29
2021,174358,10,4,3,0,3
2021,174358,20,0,133,73,60
2021,174358,20,1,96,59,37
2021,174358,20,2,35,14,21
2021,174358,20,3,2,0,2
2021,174358,30,0,34,17,17
2021,174358,30,2,4,1,3
2021,174358,30,3,30,16,14
2021,174358,40,0,23,7,16
2021,174358,40,3,20,7,13
2021,174358,40,4,3,0,3
2021,174358,42,0,23,7,16
2021,174358,42,3,20,7,13
2021,174358,42,4,3,0,3
2021,174376,0,0,91,35,56
2021,174376,10,0,91,35,56
2021,174376,10,4,91,35,56
2021,174376,20,0,80,31,49
2021,174376,20,4,80,31,49
2021,174376,30,0,11,4,7
2021,174376,30,4,11,4,7
2021,174428,0,0,153,73,80
2021,174428,10,0,153,73,80
2021,174428,10,4,153,73,80
2021,174428,20,0,133,65,68
2021,174428,20,4,133,65,68
2021,174428,30,0,19,7,12
2021,174428,30,4,19,7,12
2021,174428,40,0,1,1,0
2021,174428,40,4,1,1,0
2021,174428,43,0,1,1,0
2021,174428,43,4,1,1,0
2021,174437,0,0,42,28,14
2021,174437,10,0,42,28,14
2021,174437,10,1,7,5,2
2021,174437,10,2,16,13,3
2021,174437,10,3,18,9,9
2021,174437,10,4,1,1,0
2021,174437,40,0,42,28,14
2021,174437,40,1,7,5,2
2021,174437,40,2,16,13,3
2021,174437,40,3,18,9,9
2021,174437,40,4,1,1,0
2021,174437,42,0,42,28,14
2021,174437,42,1,7,5,2
2021,174437,42,2,16,13,3
2021,174437,42,3,18,9,9
2021,174437,42,4,1,1,0
2021,174473,0,0,76,37,39
2021,174473,10,0,76,37,39
2021,174473,10,4,76,37,39
2021,174473,20,0,62,33,29
2021,174473,20,4,62,33,29
2021,174473,30,0,13,4,9
2021,174473,30,4,13,4,9
2021,174473,40,0,1,0,1
2021,174473,40,4,1,0,1
2021,174473,42,0,1,0,1
2021,174473,42,4,1,0,1
2021,174491,0,0,77,41,36
2021,174491,10,0,77,41,36
2021,174491,10,1,29,19,10
2021,174491,10,2,19,11,8
2021,174491,10,3,26,9,17
2021,174491,10,4,2,1,1
2021,174491,10,5,1,1,0
2021,174491,40,0,77,41,36
2021,174491,40,1,29,19,10
2021,174491,40,2,19,11,8
2021,174491,40,3,26,9,17
2021,174491,40,4,2,1,1
2021,174491,40,5,1,1,0
2021,174491,42,0,77,41,36
2021,174491,42,1,29,19,10
2021,174491,42,2,19,11,8
2021,174491,42,3,26,9,17
2021,174491,42,4,2,1,1
2021,174491,42,5,1,1,0
2021,174507,0,0,61,24,37
2021,174507,10,0,61,24,37
2021,174507,10,1,12,6,6
2021,174507,10,2,17,11,6
2021,174507,10,3,24,6,18
2021,174507,10,4,8,1,7
2021,174507,40,0,61,24,37
2021,174507,40,1,12,6,6
2021,174507,40,2,17,11,6
2021,174507,40,3,24,6,18
2021,174507,40,4,8,1,7
2021,174507,41,0,54,20,34
2021,174507,41,1,12,6,6
2021,174507,41,2,15,10,5
2021,174507,41,3,19,3,16
2021,174507,41,4,8,1,7
2021,174507,42,0,7,4,3
2021,174507,42,2,2,1,1
2021,174507,42,3,5,3,2
2021,174507,44,0,54,20,34
2021,174507,44,1,12,6,6
2021,174507,44,2,15,10,5
2021,174507,44,3,19,3,16
2021,174507,44,4,8,1,7
2021,174525,0,0,9,7,2
2021,174525,10,0,9,7,2
2021,174525,10,6,9,7,2
2021,174525,40,0,9,7,2
2021,174525,40,6,9,7,2
2021,174525,41,0,9,7,2
2021,174525,41,6,9,7,2
2021,174525,45,0,9,7,2
2021,174525,45,6,9,7,2
2021,174570,0,0,22,9,13
2021,174570,10,0,22,9,13
2021,174570,10,4,22,9,13
2021,174570,20,0,17,7,10
2021,174570,20,4,17,7,10
2021,174570,30,0,4,2,2
2021,174570,30,4,4,2,2
2021,174570,40,0,1,0,1
2021,174570,40,4,1,0,1
2021,174570,42,0,1,0,1
2021,174570,42,4,1,0,1
2021,174738,0,0,102,50,52
2021,174738,10,0,102,50,52
2021,174738,10,4,102,50,52
2021,174738,20,0,93,48,45
2021,174738,20,4,93,48,45
2021,174738,30,0,9,2,7
2021,174738,30,4,9,2,7
2021,174747,0,0,122,50,72
2021,174747,10,0,122,50,72
2021,174747,10,1,46,23,23
2021,174747,10,2,46,14,32
2021,174747,10,3,23,12,11
2021,174747,10,4,7,1,6
2021,174747,20,0,90,35,55
2021,174747,20,1,46,23,23
2021,174747,20,2,44,12,32
2021,174747,30,0,6,3,3
2021,174747,30,2,1,1,0
2021,174747,30,3,5,2,3
2021,174747,40,0,26,12,14
2021,174747,40,2,1,1,0
2021,174747,40,3,18,10,8
2021,174747,40,4,7,1,6
2021,174747,42,0,26,12,14
2021,174747,42,2,1,1,0
2021,174747,42,3,18,10,8
2021,174747,42,4,7,1,6
2021,174756,0,0,89,48,41
2021,174756,10,0,89,48,41
2021,174756,10,4,89,48,41
2021,174756,20,0,80,45,35
2021,174756,20,4,80,45,35
2021,174756,30,0,9,3,6
2021,174756,30,4,9,3,6
2021,174783,0,0,374,205,169
2021,174783,10,0,374,205,169
2021,174783,10,1,175,107,68
2021,174783,10,2,75,49,26
2021,174783,10,3,109,41,68
2021,174783,10,4,15,8,7
2021,174783,20,0,248,153,95
2021,174783,20,1,173,105,68
2021,174783,20,2,67,44,23
2021,174783,20,3,8,4,4
2021,174783,30,0,72,28,44
2021,174783,30,1,1,1,0
2021,174783,30,2,8,5,3
2021,174783,30,3,62,22,40
2021,174783,30,4,1,0,1
2021,174783,40,0,54,24,30
2021,174783,40,1,1,1,0
2021,174783,40,3,39,15,24
2021,174783,40,4,14,8,6
2021,174783,42,0,54,24,30
2021,174783,42,1,1,1,0
2021,174783,42,3,39,15,24
2021,174783,42,4,14,8,6
2021,174792,0,0,130,73,57
2021,174792,10,0,130,73,57
2021,174792,10,1,39,26,13
2021,174792,10,2,40,22,18
2021,174792,10,3,37,21,16
2021,174792,10,4,14,4,10
2021,174792,20,0,77,48,29
2021,174792,20,1,39,26,13
2021,174792,20,2,38,22,16
2021,174792,30,0,12,6,6
2021,174792,30,2,2,0,2
2021,174792,30,3,10,6,4
2021,174792,40,0,41,19,22
2021,174792,40,3,27,15,12
2021,174792,40,4,14,4,10
2021,174792,42,0,41,19,22
2021,174792,42,3,27,15,12
2021,174792,42,4,14,4,10
2021,174817,0,0,93,49,44
2021,174817,10,0,93,49,44
2021,174817,10,1,23,11,12
2021,174817,10,2,40,24,16
2021,174817,10,3,27,13,14
2021,174817,10,4,3,1,2
2021,174817,20,0,50,29,21
2021,174817,20,1,15,7,8
2021,174817,20,2,30,18,12
2021,174817,20,3,5,4,1
2021,174817,30,0,15,9,6
2021,174817,30,1,1,1,0
2021,174817,30,2,3,2,1
2021,174817,30,3,11,6,5
2021,174817,40,0,28,11,17
2021,174817,40,1,7,3,4
2021,174817,40,2,7,4,3
2021,174817,40,3,11,3,8
2021,174817,40,4,3,1,2
2021,174817,42,0,28,11,17
2021,174817,42,1,7,3,4
2021,174817,42,2,7,4,3
2021,174817,42,3,11,3,8
2021,174817,42,4,3,1,2
2021,174844,0,0,219,110,109
2021,174844,10,0,219,110,109
2021,174844,10,1,57,28,29
2021,174844,10,2,80,43,37
2021,174844,10,3,68,35,33
2021,174844,10,4,9,2,7
2021,174844,10,6,5,2,3
2021,174844,20,0,120,65,55
2021,174844,20,1,56,28,28
2021,174844,20,2,64,37,27
2021,174844,30,0,31,10,21
2021,174844,30,3,30,10,20
2021,174844,30,4,1,0,1
2021,174844,40,0,68,35,33
2021,174844,40,1,1,0,1
2021,174844,40,2,16,6,10
2021,174844,40,3,38,25,13
2021,174844,40,4,8,2,6
2021,174844,40,6,5,2,3
2021,174844,41,0,26,11,15
2021,174844,41,1,1,0,1
2021,174844,41,2,10,2,8
2021,174844,41,3,8,6,2
2021,174844,41,4,2,1,1
2021,174844,41,6,5,2,3
2021,174844,42,0,42,24,18
2021,174844,42,2,6,4,2
2021,174844,42,3,30,19,11
2021,174844,42,4,6,1,5
2021,174844,44,0,26,11,15
2021,174844,44,1,1,0,1
2021,174844,44,2,10,2,8
2021,174844,44,3,8,6,2
2021,174844,44,4,2,1,1
2021,174844,44,6,5,2,3
2021,174862,0,0,28,15,13
2021,174862,10,0,28,15,13
2021,174862,10,1,7,3,4
2021,174862,10,2,9,5,4
2021,174862,10,3,12,7,5
2021,174862,20,0,4,2,2
2021,174862,20,1,3,2,1
2021,174862,20,2,1,0,1
2021,174862,30,0,22,12,10
2021,174862,30,1,4,1,3
2021,174862,30,2,8,5,3
2021,174862,30,3,10,6,4
2021,174862,40,0,2,1,1
2021,174862,40,3,2,1,1
2021,174862,41,0,1,1,0
2021,174862,41,3,1,1,0
2021,174862,42,0,1,0,1
2021,174862,42,3,1,0,1
2021,174862,44,0,1,1,0
2021,174862,44,3,1,1,0
2021,174899,0,0,187,62,125
2021,174899,10,0,187,62,125
2021,174899,10,1,18,10,8
2021,174899,10,2,51,18,33
2021,174899,10,3,101,28,73
2021,174899,10,4,10,5,5
2021,174899,10,5,6,1,5
2021,174899,10,6,1,0,1
2021,174899,20,0,57,24,33
2021,174899,20,1,17,9,8
2021,174899,20,2,36,13,23
2021,174899,20,3,4,2,2
2021,174899,30,0,48,20,28
2021,174899,30,1,1,1,0
2021,174899,30,2,7,3,4
2021,174899,30,3,40,16,24
2021,174899,40,0,82,18,64
2021,174899,40,2,8,2,6
2021,174899,40,3,57,10,47
2021,174899,40,4,10,5,5
2021,174899,40,5,6,1,5
2021,174899,40,6,1,0,1
2021,174899,41,0,11,2,9
2021,174899,41,3,11,2,9
2021,174899,42,0,71,16,55
2021,174899,42,2,8,2,6
2021,174899,42,3,46,8,38
2021,174899,42,4,10,5,5
2021,174899,42,5,6,1,5
2021,174899,42,6,1,0,1
2021,174899,44,0,11,2,9
2021,174899,44,3,11,2,9
2021,174914,0,0,415,238,177
2021,174914,10,0,415,238,177
2021,174914,10,1,138,92,46
2021,174914,10,2,158,81,77
2021,174914,10,3,62,36,26
2021,174914,10,4,4,2,2
2021,174914,10,5,53,27,26
2021,174914,20,0,293,172,121
2021,174914,20,1,134,90,44
2021,174914,20,2,156,80,76
2021,174914,20,4,1,1,0
2021,174914,20,5,2,1,1
2021,174914,30,0,48,28,20
2021,174914,30,1,1,0,1
2021,174914,30,2,2,1,1
2021,174914,30,3,43,27,16
2021,174914,30,4,2,0,2
2021,174914,40,0,74,38,36
2021,174914,40,1,3,2,1
2021,174914,40,3,19,9,10
2021,174914,40,4,1,1,0
2021,174914,40,5,51,26,25
2021,174914,42,0,74,38,36
2021,174914,42,1,3,2,1
2021,174914,42,3,19,9,10
2021,174914,42,4,1,1,0
2021,174914,42,5,51,26,25
2021,175005,0,0,250,41,209
2021,175005,10,0,250,41,209
2021,175005,10,1,33,7,26
2021,175005,10,2,92,16,76
2021,175005,10,3,123,17,106
2021,175005,10,4,2,1,1
2021,175005,20,0,83,16,67
2021,175005,20,1,30,6,24
2021,175005,20,2,53,10,43
2021,175005,30,0,48,6,42
2021,175005,30,2,16,1,15
2021,175005,30,3,32,5,27
2021,175005,40,0,119,19,100
2021,175005,40,1,3,1,2
2021,175005,40,2,23,5,18
2021,175005,40,3,91,12,79
2021,175005,40,4,2,1,1
2021,175005,41,0,106,17,89
2021,175005,41,1,3,1,2
2021,175005,41,2,21,5,16
2021,175005,41,3,80,10,70
2021,175005,41,4,2,1,1
2021,175005,42,0,13,2,11
2021,175005,42,2,2,0,2
2021,175005,42,3,11,2,9
2021,175005,44,0,106,17,89
2021,175005,44,1,3,1,2
2021,175005,44,2,21,5,16
2021,175005,44,3,80,10,70
2021,175005,44,4,2,1,1
2021,175014,0,0,81,12,69
2021,175014,10,0,81,12,69
2021,175014,10,4,81,12,69
2021,175014,40,0,81,12,69
2021,175014,40,4,81,12,69
2021,175014,41,0,81,12,69
2021,175014,41,4,81,12,69
2021,175014,45,0,81,12,69
2021,175014,45,4,81,12,69
2021,175041,0,0,120,51,69
2021,175041,10,0,120,51,69
2021,175041,10,4,120,51,69
2021,175041,20,0,102,43,59
2021,175041,20,4,102,43,59
2021,175041,30,0,17,7,10
2021,175041,30,4,17,7,10
2021,175041,40,0,1,1,0
2021,175041,40,4,1,1,0
2021,175041,42,0,1,1,0
2021,175041,42,4,1,1,0
2021,175078,0,0,100,50,50
2021,175078,10,0,100,50,50
2021,175078,10,1,44,25,19
2021,175078,10,2,28,15,13
2021,175078,10,3,26,8,18
2021,175078,10,4,2,2,0
2021,175078,20,0,71,39,32
2021,175078,20,1,44,25,19
2021,175078,20,2,27,14,13
2021,175078,30,0,18,8,10
2021,175078,30,2,1,1,0
2021,175078,30,3,17,7,10
2021,175078,40,0,11,3,8
2021,175078,40,3,9,1,8
2021,175078,40,4,2,2,0
2021,175078,42,0,11,3,8
2021,175078,42,3,9,1,8
2021,175078,42,4,2,2,0
2021,175139,0,0,6,4,2
2021,175139,10,0,6,4,2
2021,175139,10,1,1,1,0
2021,175139,10,2,1,1,0
2021,175139,10,3,4,2,2
2021,175139,20,0,1,1,0
2021,175139,20,1,1,1,0
2021,175139,30,0,5,3,2
2021,175139,30,2,1,1,0
2021,175139,30,3,4,2,2
2021,175157,0,0,12,8,4
2021,175157,10,0,12,8,4
2021,175157,10,4,12,8,4
2021,175157,20,0,10,6,4
2021,175157,20,4,10,6,4
2021,175157,30,0,2,2,0
2021,175157,30,4,2,2,0
2021,175227,0,0,95,70,25
2021,175227,10,0,95,70,25
2021,175227,10,1,11,6,5
2021,175227,10,2,20,12,8
2021,175227,10,3,20,14,6
2021,175227,10,4,44,38,6
2021,175227,40,0,95,70,25
2021,175227,40,1,11,6,5
2021,175227,40,2,20,12,8
2021,175227,40,3,20,14,6
2021,175227,40,4,44,38,6
2021,175227,41,0,95,70,25
2021,175227,41,1,11,6,5
2021,175227,41,2,20,12,8
2021,175227,41,3,20,14,6
2021,175227,41,4,44,38,6
2021,175227,45,0,95,70,25
2021,175227,45,1,11,6,5
2021,175227,45,2,20,12,8
2021,175227,45,3,20,14,6
2021,175227,45,4,44,38,6
2021,175236,0,0,87,45,42
2021,175236,10,0,87,45,42
2021,175236,10,4,87,45,42
2021,175236,20,0,72,38,34
2021,175236,20,4,72,38,34
2021,175236,30,0,15,7,8
2021,175236,30,4,15,7,8
2021,175263,0,0,44,23,21
2021,175263,10,0,44,23,21
2021,175263,10,4,44,23,21
2021,175263,20,0,36,18,18
2021,175263,20,4,36,18,18
2021,175263,30,0,8,5,3
2021,175263,30,4,8,5,3
2021,175272,0,0,294,138,156
2021,175272,10,0,294,138,156
2021,175272,10,1,115,66,49
2021,175272,10,2,89,41,48
2021,175272,10,3,82,29,53
2021,175272,10,4,8,2,6
2021,175272,20,0,202,106,96
2021,175272,20,1,115,66,49
2021,175272,20,2,83,38,45
2021,175272,20,3,4,2,2
2021,175272,30,0,55,24,31
2021,175272,30,2,5,3,2
2021,175272,30,3,49,21,28
2021,175272,30,4,1,0,1
2021,175272,40,0,37,8,29
2021,175272,40,2,1,0,1
2021,175272,40,3,29,6,23
2021,175272,40,4,7,2,5
2021,175272,42,0,37,8,29
2021,175272,42,2,1,0,1
2021,175272,42,3,29,6,23
2021,175272,42,4,7,2,5
2021,175281,0,0,59,26,33
2021,175281,10,0,57,26,31
2021,175281,10,1,45,23,22
2021,175281,10,2,6,2,4
2021,175281,10,3,3,1,2
2021,175281,10,4,1,0,1
2021,175281,10,6,2,0,2
2021,175281,20,0,32,19,13
2021,175281,20,1,32,19,13
2021,175281,30,0,2,1,1
2021,175281,30,2,1,0,1
2021,175281,30,3,1,1,0
2021,175281,40,0,23,6,17
2021,175281,40,1,13,4,9
2021,175281,40,2,5,2,3
2021,175281,40,3,2,0,2
2021,175281,40,4,1,0,1
2021,175281,40,6,2,0,2
2021,175281,41,0,16,5,11
2021,175281,41,1,6,3,3
2021,175281,41,2,5,2,3
2021,175281,41,3,2,0,2
2021,175281,41,4,1,0,1
2021,175281,41,6,2,0,2
2021,175281,42,0,7,1,6
2021,175281,42,1,7,1,6
2021,175281,44,0,16,5,11
2021,175281,44,1,6,3,3
2021,175281,44,2,5,2,3
2021,175281,44,3,2,0,2
2021,175281,44,4,1,0,1
2021,175281,44,6,2,0,2
2021,175281,50,0,2,0,2
2021,175315,0,0,135,61,74
2021,175315,10,0,135,61,74
2021,175315,10,4,135,61,74
2021,175315,20,0,128,57,71
2021,175315,20,4,128,57,71
2021,175315,30,0,7,4,3
2021,175315,30,4,7,4,3
2021,175342,0,0,133,74,59
2021,175342,10,0,133,74,59
2021,175342,10,1,18,15,3
2021,175342,10,2,20,12,8
2021,175342,10,3,55,27,28
2021,175342,10,4,40,20,20
2021,175342,20,0,37,27,10
2021,175342,20,1,17,15,2
2021,175342,20,2,10,7,3
2021,175342,20,3,8,4,4
2021,175342,20,4,2,1,1
2021,175342,30,0,33,16,17
2021,175342,30,2,8,5,3
2021,175342,30,3,23,11,12
2021,175342,30,4,2,0,2
2021,175342,40,0,63,31,32
2021,175342,40,1,1,0,1
2021,175342,40,2,2,0,2
2021,175342,40,3,24,12,12
2021,175342,40,4,36,19,17
2021,175342,41,0,2,0,2
2021,175342,41,1,1,0,1
2021,175342,41,3,1,0,1
2021,175342,42,0,61,31,30
2021,175342,42,2,2,0,2
2021,175342,42,3,23,12,11
2021,175342,42,4,36,19,17
2021,175342,45,0,2,0,2
2021,175342,45,1,1,0,1
2021,175342,45,3,1,0,1
2021,175421,0,0,77,36,41
2021,175421,10,0,77,36,41
2021,175421,10,1,28,17,11
2021,175421,10,2,20,5,15
2021,175421,10,3,20,10,10
2021,175421,10,4,9,4,5
2021,175421,20,0,41,20,21
2021,175421,20,1,26,16,10
2021,175421,20,2,14,3,11
2021,175421,20,3,1,1,0
2021,175421,30,0,25,11,14
2021,175421,30,2,6,2,4
2021,175421,30,3,19,9,10
2021,175421,40,0,11,5,6
2021,175421,40,1,2,1,1
2021,175421,40,4,9,4,5
2021,175421,42,0,11,5,6
2021,175421,42,1,2,1,1
2021,175421,42,4,9,4,5
2021,175430,0,0,39,19,20
2021,175430,10,0,39,19,20
2021,175430,10,1,7,4,3
2021,175430,10,2,13,7,6
2021,175430,10,3,12,6,6
2021,175430,10,4,7,2,5
2021,175430,40,0,39,19,20
2021,175430,40,1,7,4,3
2021,175430,40,2,13,7,6
2021,175430,40,3,12,6,6
2021,175430,40,4,7,2,5
2021,175430,42,0,39,19,20
2021,175430,42,1,7,4,3
2021,175430,42,2,13,7,6
2021,175430,42,3,12,6,6
2021,175430,42,4,7,2,5
2021,175519,0,0,71,32,39
2021,175519,10,0,71,32,39
2021,175519,10,4,71,32,39
2021,175519,40,0,71,32,39
2021,175519,40,4,71,32,39
2021,175519,42,0,71,32,39
2021,175519,42,4,71,32,39
2021,175573,0,0,98,34,64
2021,175573,10,0,98,34,64
2021,175573,10,4,98,34,64
2021,175573,40,0,98,34,64
2021,175573,40,4,98,34,64
2021,175573,42,0,98,34,64
2021,175573,42,4,98,34,64
2021,175616,0,0,143,62,81
2021,175616,10,0,143,62,81
2021,175616,10,1,17,10,7
2021,175616,10,2,45,25,20
2021,175616,10,3,47,20,27
2021,175616,10,4,34,7,27
2021,175616,20,0,57,30,27
2021,175616,20,1,13,6,7
2021,175616,20,2,44,24,20
2021,175616,30,0,42,17,25
2021,175616,30,3,42,17,25
2021,175616,40,0,44,15,29
2021,175616,40,1,4,4,0
2021,175616,40,2,1,1,0
2021,175616,40,3,5,3,2
2021,175616,40,4,34,7,27
2021,175616,42,0,44,15,29
2021,175616,42,1,4,4,0
2021,175616,42,2,1,1,0
2021,175616,42,3,5,3,2
2021,175616,42,4,34,7,27
2021,175643,0,0,84,32,52
2021,175643,10,0,77,31,46
2021,175643,10,4,77,31,46
2021,175643,40,0,77,31,46
2021,175643,40,4,77,31,46
2021,175643,42,0,7,1,6
2021,175643,42,4,7,1,6
2021,175643,43,0,70,30,40
2021,175643,43,4,70,30,40
2021,175643,50,0,7,1,6
2021,175652,0,0,103,48,55
2021,175652,10,0,103,48,55
2021,175652,10,4,103,48,55
2021,175652,40,0,103,48,55
2021,175652,40,4,103,48,55
2021,175652,42,0,103,48,55
2021,175652,42,4,103,48,55
2021,175786,0,0,399,148,251
2021,175786,10,0,377,139,238
2021,175786,10,4,377,139,238
2021,175786,40,0,377,139,238
2021,175786,40,4,377,139,238
2021,175786,42,0,377,139,238
2021,175786,42,4,377,139,238
2021,175786,50,0,22,9,13
2021,175810,0,0,137,48,89
2021,175810,10,0,137,48,89
2021,175810,10,6,137,48,89
2021,175810,40,0,137,48,89
2021,175810,40,6,137,48,89
2021,175810,42,0,137,48,89
2021,175810,42,6,137,48,89
2021,175829,0,0,128,43,85
2021,175829,10,0,128,43,85
2021,175829,10,4,128,43,85
2021,175829,40,0,128,43,85
2021,175829,40,4,128,43,85
2021,175829,42,0,126,43,83
2021,175829,42,4,126,43,83
2021,175829,43,0,2,0,2
2021,175829,43,4,2,0,2
2021,175856,0,0,322,158,164
2021,175856,10,0,322,158,164
2021,175856,10,1,91,58,33
2021,175856,10,2,91,49,42
2021,175856,10,3,76,33,43
2021,175856,10,4,63,18,45
2021,175856,10,6,1,0,1
2021,175856,20,0,150,91,59
2021,175856,20,1,87,58,29
2021,175856,20,2,56,29,27
2021,175856,20,3,7,4,3
2021,175856,30,0,70,34,36
2021,175856,30,1,1,0,1
2021,175856,30,2,27,15,12
2021,175856,30,3,42,19,23
2021,175856,40,0,102,33,69
2021,175856,40,1,3,0,3
2021,175856,40,2,8,5,3
2021,175856,40,3,27,10,17
2021,175856,40,4,63,18,45
2021,175856,40,6,1,0,1
2021,175856,42,0,102,33,69
2021,175856,42,1,3,0,3
2021,175856,42,2,8,5,3
2021,175856,42,3,27,10,17
2021,175856,42,4,63,18,45
2021,175856,42,6,1,0,1
2021,175883,0,0,126,54,72
2021,175883,10,0,126,54,72
2021,175883,10,4,126,54,72
2021,175883,40,0,126,54,72
2021,175883,40,4,126,54,72
2021,175883,42,0,119,49,70
2021,175883,42,4,119,49,70
2021,175883,43,0,7,5,2
2021,175883,43,4,7,5,2
2021,175935,0,0,116,31,85
2021,175935,10,0,116,31,85
2021,175935,10,4,116,31,85
2021,175935,40,0,116,31,85
2021,175935,40,4,116,31,85
2021,175935,42,0,116,31,85
2021,175935,42,4,116,31,85
2021,175980,0,0,67,35,32
2021,175980,10,0,67,35,32
2021,175980,10,1,21,14,7
2021,175980,10,2,26,10,16
2021,175980,10,3,14,8,6
2021,175980,10,4,6,3,3
2021,175980,20,0,48,26,22
2021,175980,20,1,21,14,7
2021,175980,20,2,25,10,15
2021,175980,20,3,2,2,0
2021,175980,30,0,10,5,5
2021,175980,30,2,1,0,1
2021,175980,30,3,9,5,4
2021,175980,40,0,9,4,5
2021,175980,40,3,3,1,2
2021,175980,40,4,6,3,3
2021,175980,42,0,9,4,5
2021,175980,42,3,3,1,2
2021,175980,42,4,6,3,3
2021,176008,0,0,91,30,61
2021,176008,10,0,91,30,61
2021,176008,10,4,91,30,61
2021,176008,40,0,91,30,61
2021,176008,40,4,91,30,61
2021,176008,42,0,91,30,61
2021,176008,42,4,91,30,61
2021,176017,0,0,1832,970,862
2021,176017,10,0,1832,970,862
2021,176017,10,1,471,313,158
2021,176017,10,2,483,273,210
2021,176017,10,3,610,300,310
2021,176017,10,4,207,62,145
2021,176017,10,5,61,22,39
2021,176017,20,0,618,401,217
2021,176017,20,1,349,235,114
2021,176017,20,2,267,165,102
2021,176017,20,3,2,1,1
2021,176017,30,0,262,146,116
2021,176017,30,1,15,12,3
2021,176017,30,2,41,21,20
2021,176017,30,3,206,113,93
2021,176017,40,0,952,423,529
2021,176017,40,1,107,66,41
2021,176017,40,2,175,87,88
2021,176017,40,3,402,186,216
2021,176017,40,4,207,62,145
2021,176017,40,5,61,22,39
2021,176017,42,0,942,420,522
2021,176017,42,1,107,66,41
2021,176017,42,2,175,87,88
2021,176017,42,3,399,185,214
2021,176017,42,4,200,60,140
2021,176017,42,5,61,22,39
2021,176017,43,0,10,3,7
2021,176017,43,3,3,1,2
2021,176017,43,4,7,2,5
2021,176035,0,0,141,41,100
2021,176035,10,0,141,41,100
2021,176035,10,1,42,14,28
2021,176035,10,2,18,8,10
2021,176035,10,3,41,12,29
2021,176035,10,4,40,7,33
2021,176035,20,0,53,20,33
2021,176035,20,1,42,14,28
2021,176035,20,2,11,6,5
2021,176035,30,0,43,12,31
2021,176035,30,2,7,2,5
2021,176035,30,3,36,10,26
2021,176035,40,0,45,9,36
2021,176035,40,3,5,2,3
2021,176035,40,4,40,7,33
2021,176035,42,0,45,9,36
2021,176035,42,3,5,2,3
2021,176035,42,4,40,7,33
2021,176044,0,0,99,44,55
2021,176044,10,0,99,44,55
2021,176044,10,1,22,14,8
2021,176044,10,2,15,6,9
2021,176044,10,3,42,15,27
2021,176044,10,4,20,9,11
2021,176044,20,0,45,22,23
2021,176044,20,1,21,13,8
2021,176044,20,2,12,4,8
2021,176044,20,3,12,5,7
2021,176044,30,0,34,13,21
2021,176044,30,1,1,1,0
2021,176044,30,2,3,2,1
2021,176044,30,3,30,10,20
2021,176044,40,0,20,9,11
2021,176044,40,4,20,9,11
2021,176044,42,0,20,9,11
2021,176044,42,4,20,9,11
2021,176053,0,0,201,104,97
2021,176053,10,0,201,104,97
2021,176053,10,1,60,42,18
2021,176053,10,2,52,29,23
2021,176053,10,3,55,23,32
2021,176053,10,4,34,10,24
2021,176053,20,0,98,63,35
2021,176053,20,1,56,40,16
2021,176053,20,2,41,23,18
2021,176053,20,3,1,0,1
2021,176053,30,0,47,24,23
2021,176053,30,1,2,0,2
2021,176053,30,2,7,4,3
2021,176053,30,3,38,20,18
2021,176053,40,0,56,17,39
2021,176053,40,1,2,2,0
2021,176053,40,2,4,2,2
2021,176053,40,3,16,3,13
2021,176053,40,4,34,10,24
2021,176053,42,0,56,17,39
2021,176053,42,1,2,2,0
2021,176053,42,2,4,2,2
2021,176053,42,3,16,3,13
2021,176053,42,4,34,10,24
2021,176071,0,0,282,114,168
2021,176071,10,0,282,114,168
2021,176071,10,4,282,114,168
2021,176071,40,0,282,114,168
2021,176071,40,4,282,114,168
2021,176071,42,0,282,114,168
2021,176071,42,4,282,114,168
2021,176080,0,0,962,562,400
2021,176080,10,0,962,562,400
2021,176080,10,1,240,184,56
2021,176080,10,2,248,162,86
2021,176080,10,3,260,153,107
2021,176080,10,4,157,48,109
2021,176080,10,5,57,15,42
2021,176080,20,0,476,335,141
2021,176080,20,1,239,183,56
2021,176080,20,2,237,152,85
2021,176080,30,0,268,160,108
2021,176080,30,1,1,1,0
2021,176080,30,2,11,10,1
2021,176080,30,3,256,149,107
2021,176080,40,0,218,67,151
2021,176080,40,3,4,4,0
2021,176080,40,4,157,48,109
2021,176080,40,5,57,15,42
2021,176080,42,0,14,3,11
2021,176080,42,4,14,3,11
2021,176080,43,0,204,64,140
2021,176080,43,3,4,4,0
2021,176080,43,4,143,45,98
2021,176080,43,5,57,15,42
2021,176169,0,0,118,39,79
2021,176169,10,0,118,39,79
2021,176169,10,6,118,39,79
2021,176169,40,0,118,39,79
2021,176169,40,6,118,39,79
2021,176169,42,0,118,39,79
2021,176169,42,6,118,39,79
2021,176178,0,0,193,72,121
2021,176178,10,0,182,71,111
2021,176178,10,4,182,71,111
2021,176178,40,0,182,71,111
2021,176178,40,4,182,71,111
2021,176178,42,0,182,71,111
2021,176178,42,4,182,71,111
2021,176178,50,0,11,1,10
2021,176239,0,0,171,63,108
2021,176239,10,0,171,63,108
2021,176239,10,6,171,63,108
2021,176239,40,0,171,63,108
2021,176239,40,6,171,63,108
2021,176239,42,0,171,63,108
2021,176239,42,6,171,63,108
2021,176318,0,0,44,20,24
2021,176318,10,0,44,20,24
2021,176318,10,1,6,6,0
2021,176318,10,2,8,4,4
2021,176318,10,3,17,4,13
2021,176318,10,4,13,6,7
2021,176318,40,0,44,20,24
2021,176318,40,1,6,6,0
2021,176318,40,2,8,4,4
2021,176318,40,3,17,4,13
2021,176318,40,4,13,6,7
2021,176318,42,0,44,20,24
2021,176318,42,1,6,6,0
2021,176318,42,2,8,4,4
2021,176318,42,3,17,4,13
2021,176318,42,4,13,6,7
2021,176354,0,0,67,21,46
2021,176354,10,0,67,21,46
2021,176354,10,4,67,21,46
2021,176354,40,0,67,21,46
2021,176354,40,4,67,21,46
2021,176354,42,0,67,21,46
2021,176354,42,4,67,21,46
2021,176372,0,0,651,334,317
2021,176372,10,0,651,334,317
2021,176372,10,1,147,98,49
2021,176372,10,2,189,112,77
2021,176372,10,3,209,97,112
2021,176372,10,4,80,23,57
2021,176372,10,5,26,4,22
2021,176372,20,0,312,194,118
2021,176372,20,1,143,95,48
2021,176372,20,2,167,99,68
2021,176372,20,3,2,0,2
2021,176372,30,0,148,75,73
2021,176372,30,1,2,2,0
2021,176372,30,2,7,5,2
2021,176372,30,3,139,68,71
2021,176372,40,0,191,65,126
2021,176372,40,1,2,1,1
2021,176372,40,2,15,8,7
2021,176372,40,3,68,29,39
2021,176372,40,4,80,23,57
2021,176372,40,5,26,4,22
2021,176372,42,0,191,65,126
2021,176372,42,1,2,1,1
2021,176372,42,2,15,8,7
2021,176372,42,3,68,29,39
2021,176372,42,4,80,23,57
2021,176372,42,5,26,4,22
2021,176406,0,0,48,23,25
2021,176406,10,0,48,23,25
2021,176406,10,1,7,4,3
2021,176406,10,2,17,8,9
2021,176406,10,3,15,8,7
2021,176406,10,4,9,3,6
2021,176406,20,0,24,12,12
2021,176406,20,1,7,4,3
2021,176406,20,2,17,8,9
2021,176406,30,0,10,4,6
2021,176406,30,3,10,4,6
2021,176406,40,0,14,7,7
2021,176406,40,3,5,4,1
2021,176406,40,4,9,3,6
2021,176406,43,0,14,7,7
2021,176406,43,3,5,4,1
2021,176406,43,4,9,3,6
2021,176451,0,0,5,5,0
2021,176451,10,0,5,5,0
2021,176451,10,1,2,2,0
2021,176451,10,2,3,3,0
2021,176451,40,0,5,5,0
2021,176451,40,1,2,2,0
2021,176451,40,2,3,3,0
2021,176451,41,0,5,5,0
2021,176451,41,1,2,2,0
2021,176451,41,2,3,3,0
2021,176451,44,0,5,5,0
2021,176451,44,1,2,2,0
2021,176451,44,2,3,3,0
2021,176479,0,0,233,103,130
2021,176479,10,0,233,103,130
2021,176479,10,1,29,22,7
2021,176479,10,2,61,29,32
2021,176479,10,3,115,43,72
2021,176479,10,4,27,9,18
2021,176479,10,5,1,0,1
2021,176479,40,0,233,103,130
2021,176479,40,1,29,22,7
2021,176479,40,2,61,29,32
2021,176479,40,3,115,43,72
2021,176479,40,4,27,9,18
2021,176479,40,5,1,0,1
2021,176479,41,0,107,57,50
2021,176479,41,1,29,22,7
2021,176479,41,2,54,24,30
2021,176479,41,3,23,11,12
2021,176479,41,4,1,0,1
2021,176479,42,0,95,35,60
2021,176479,42,2,5,4,1
2021,176479,42,3,72,26,46
2021,176479,42,4,17,5,12
2021,176479,42,5,1,0,1
2021,176479,43,0,31,11,20
2021,176479,43,2,2,1,1
2021,176479,43,3,20,6,14
2021,176479,43,4,9,4,5
2021,176479,44,0,107,57,50
2021,176479,44,1,29,22,7
2021,176479,44,2,54,24,30
2021,176479,44,3,23,11,12
2021,176479,44,4,1,0,1
2021,176600,0,0,9,6,3
2021,176600,10,0,9,6,3
2021,176600,10,1,2,2,0
2021,176600,10,2,2,0,2
2021,176600,10,3,5,4,1
2021,176600,40,0,9,6,3
2021,176600,40,1,2,2,0
2021,176600,40,2,2,0,2
2021,176600,40,3,5,4,1
2021,176600,42,0,9,6,3
2021,176600,42,1,2,2,0
2021,176600,42,2,2,0,2
2021,176600,42,3,5,4,1
2021,176628,0,0,64,24,40
2021,176628,10,0,64,24,40
2021,176628,10,1,10,5,5
2021,176628,10,2,19,9,10
2021,176628,10,3,26,7,19
2021,176628,10,4,9,3,6
2021,176628,20,0,36,15,21
2021,176628,20,1,9,4,5
2021,176628,20,2,18,8,10
2021,176628,20,3,8,2,6
2021,176628,20,4,1,1,0
2021,176628,30,0,20,4,16
2021,176628,30,3,17,4,13
2021,176628,30,4,3,0,3
2021,176628,40,0,8,5,3
2021,176628,40,1,1,1,0
2021,176628,40,2,1,1,0
2021,176628,40,3,1,1,0
2021,176628,40,4,5,2,3
2021,176628,42,0,8,5,3
2021,176628,42,1,1,1,0
2021,176628,42,2,1,1,0
2021,176628,42,3,1,1,0
2021,176628,42,4,5,2,3
2021,176664,0,0,13,10,3
2021,176664,10,0,13,10,3
2021,176664,10,6,13,10,3
2021,176664,40,0,13,10,3
2021,176664,40,6,13,10,3
2021,176664,42,0,13,10,3
2021,176664,42,6,13,10,3
2021,176770,0,0,60,6,54
2021,176770,10,0,60,6,54
2021,176770,10,1,5,1,4
2021,176770,10,2,8,1,7
2021,176770,10,3,44,4,40
2021,176770,10,4,3,0,3
2021,176770,40,0,60,6,54
2021,176770,40,1,5,1,4
2021,176770,40,2,8,1,7
2021,176770,40,3,44,4,40
2021,176770,40,4,3,0,3
2021,176770,42,0,60,6,54
2021,176770,42,1,5,1,4
2021,176770,42,2,8,1,7
2021,176770,42,3,44,4,40
2021,176770,42,4,3,0,3
2021,176789,0,0,21,15,6
2021,176789,10,0,21,15,6
2021,176789,10,1,6,5,1
2021,176789,10,2,3,2,1
2021,176789,10,3,12,8,4
2021,176789,40,0,21,15,6
2021,176789,40,1,6,5,1
2021,176789,40,2,3,2,1
2021,176789,40,3,12,8,4
2021,176789,41,0,21,15,6
2021,176789,41,1,6,5,1
2021,176789,41,2,3,2,1
2021,176789,41,3,12,8,4
2021,176789,45,0,21,15,6
2021,176789,45,1,6,5,1
2021,176789,45,2,3,2,1
2021,176789,45,3,12,8,4
2021,176910,0,0,8,7,1
2021,176910,10,0,8,7,1
2021,176910,10,1,8,7,1
2021,176910,40,0,8,7,1
2021,176910,40,1,8,7,1
2021,176910,42,0,8,7,1
2021,176910,42,1,8,7,1
2021,176947,0,0,79,37,42
2021,176947,10,0,79,37,42
2021,176947,10,1,21,14,7
2021,176947,10,2,23,9,14
2021,176947,10,3,33,13,20
2021,176947,10,4,2,1,1
2021,176947,20,0,28,17,11
2021,176947,20,1,19,13,6
2021,176947,20,2,9,4,5
2021,176947,30,0,16,10,6
2021,176947,30,1,1,1,0
2021,176947,30,2,1,0,1
2021,176947,30,3,14,9,5
2021,176947,40,0,35,10,25
2021,176947,40,1,1,0,1
2021,176947,40,2,13,5,8
2021,176947,40,3,19,4,15
2021,176947,40,4,2,1,1
2021,176947,42,0,35,10,25
2021,176947,42,1,1,0,1
2021,176947,42,2,13,5,8
2021,176947,42,3,19,4,15
2021,176947,42,4,2,1,1
2021,176965,0,0,401,203,198
2021,176965,10,0,400,203,197
2021,176965,10,1,97,62,35
2021,176965,10,2,72,43,29
2021,176965,10,3,67,34,33
2021,176965,10,4,96,29,67
2021,176965,10,6,68,35,33
2021,176965,20,0,217,131,86
2021,176965,20,1,97,62,35
2021,176965,20,2,72,43,29
2021,176965,20,3,35,17,18
2021,176965,20,4,1,1,0
2021,176965,20,6,12,8,4
2021,176965,30,0,73,33,40
2021,176965,30,3,26,14,12
2021,176965,30,4,2,0,2
2021,176965,30,6,45,19,26
2021,176965,40,0,110,39,71
2021,176965,40,3,6,3,3
2021,176965,40,4,93,28,65
2021,176965,40,6,11,8,3
2021,176965,42,0,110,39,71
2021,176965,42,3,6,3,3
2021,176965,42,4,93,28,65
2021,176965,42,6,11,8,3
2021,176965,50,0,1,0,1
2021,177038,0,0,40,21,19
2021,177038,10,0,39,20,19
2021,177038,10,1,5,3,2
2021,177038,10,2,8,3,5
2021,177038,10,3,5,2,3
2021,177038,10,4,21,12,9
2021,177038,40,0,39,20,19
2021,177038,40,1,5,3,2
2021,177038,40,2,8,3,5
2021,177038,40,3,5,2,3
2021,177038,40,4,21,12,9
2021,177038,41,0,6,3,3
2021,177038,41,1,3,2,1
2021,177038,41,2,3,1,2
2021,177038,42,0,33,17,16
2021,177038,42,1,2,1,1
2021,177038,42,2,5,2,3
2021,177038,42,3,5,2,3
2021,177038,42,4,21,12,9
2021,177038,44,0,6,3,3
2021,177038,44,1,3,2,1
2021,177038,44,2,3,1,2
2021,177038,50,0,1,1,0
2021,177065,0,0,62,34,28
2021,177065,10,0,62,34,28
2021,177065,10,1,16,6,10
2021,177065,10,2,24,16,8
2021,177065,10,3,16,9,7
2021,177065,10,4,5,3,2
2021,177065,10,6,1,0,1
2021,177065,20,0,38,22,16
2021,177065,20,1,14,5,9
2021,177065,20,2,23,16,7
2021,177065,20,3,1,1,0
2021,177065,30,0,10,4,6
2021,177065,30,3,10,4,6
2021,177065,40,0,14,8,6
2021,177065,40,1,2,1,1
2021,177065,40,2,1,0,1
2021,177065,40,3,5,4,1
2021,177065,40,4,5,3,2
2021,177065,40,6,1,0,1
2021,177065,42,0,14,8,6
2021,177065,42,1,2,1,1
2021,177065,42,2,1,0,1
2021,177065,42,3,5,4,1
2021,177065,42,4,5,3,2
2021,177065,42,6,1,0,1
2021,177092,0,0,33,33,0
2021,177092,10,0,33,33,0
2021,177092,10,1,15,15,0
2021,177092,10,2,15,15,0
2021,177092,10,3,3,3,0
2021,177092,40,0,33,33,0
2021,177092,40,1,15,15,0
2021,177092,40,2,15,15,0
2021,177092,40,3,3,3,0
2021,177092,41,0,33,33,0
2021,177092,41,1,15,15,0
2021,177092,41,2,15,15,0
2021,177092,41,3,3,3,0
2021,177092,44,0,6,6,0
2021,177092,44,1,1,1,0
2021,177092,44,2,4,4,0
2021,177092,44,3,1,1,0
2021,177092,45,0,27,27,0
2021,177092,45,1,14,14,0
2021,177092,45,2,11,11,0
2021,177092,45,3,2,2,0
2021,177117,0,0,44,10,34
2021,177117,10,0,44,10,34
2021,177117,10,1,16,3,13
2021,177117,10,2,10,2,8
2021,177117,10,3,18,5,13
2021,177117,20,0,26,5,21
2021,177117,20,1,16,3,13
2021,177117,20,2,10,2,8
2021,177117,30,0,16,5,11
2021,177117,30,3,16,5,11
2021,177117,40,0,2,0,2
2021,177117,40,3,2,0,2
2021,177117,42,0,2,0,2
2021,177117,42,3,2,0,2
2021,177126,0,0,20,17,3
2021,177126,10,0,19,16,3
2021,177126,10,1,10,9,1
2021,177126,10,2,3,3,0
2021,177126,10,3,4,3,1
2021,177126,10,4,2,1,1
2021,177126,40,0,19,16,3
2021,177126,40,1,10,9,1
2021,177126,40,2,3,3,0
2021,177126,40,3,4,3,1
2021,177126,40,4,2,1,1
2021,177126,41,0,15,13,2
2021,177126,41,1,10,9,1
2021,177126,41,2,3,3,0
2021,177126,41,3,2,1,1
2021,177126,42,0,4,3,1
2021,177126,42,3,2,2,0
2021,177126,42,4,2,1,1
2021,177126,44,0,15,13,2
2021,177126,44,1,10,9,1
2021,177126,44,2,3,3,0
2021,177126,44,3,2,1,1
2021,177126,50,0,1,1,0
2021,177135,0,0,132,55,77
2021,177135,10,0,132,55,77
2021,177135,10,6,132,55,77
2021,177135,40,0,132,55,77
2021,177135,40,6,132,55,77
2021,177135,42,0,132,55,77
2021,177135,42,6,132,55,77
2021,177144,0,0,47,26,21
2021,177144,10,0,47,26,21
2021,177144,10,1,6,4,2
2021,177144,10,2,11,5,6
2021,177144,10,3,18,10,8
2021,177144,10,5,12,7,5
2021,177144,20,0,17,9,8
2021,177144,20,1,6,4,2
2021,177144,20,2,11,5,6
2021,177144,30,0,16,8,8
2021,177144,30,3,15,8,7
2021,177144,30,5,1,0,1
2021,177144,40,0,14,9,5
2021,177144,40,3,3,2,1
2021,177144,40,5,11,7,4
2021,177144,43,0,14,9,5
2021,177144,43,3,3,2,1
2021,177144,43,5,11,7,4
2021,177214,0,0,106,59,47
2021,177214,10,0,106,59,47
2021,177214,10,1,44,25,19
2021,177214,10,2,26,16,10
2021,177214,10,3,28,14,14
2021,177214,10,4,8,4,4
2021,177214,20,0,70,41,29
2021,177214,20,1,44,25,19
2021,177214,20,2,26,16,10
2021,177214,30,0,20,9,11
2021,177214,30,3,20,9,11
2021,177214,40,0,16,9,7
2021,177214,40,3,8,5,3
2021,177214,40,4,8,4,4
2021,177214,42,0,16,9,7
2021,177214,42,3,8,5,3
2021,177214,42,4,8,4,4
2021,177250,0,0,65,32,33
2021,177250,10,0,65,32,33
2021,177250,10,1,4,2,2
2021,177250,10,2,9,5,4
2021,177250,10,3,17,7,10
2021,177250,10,4,35,18,17
2021,177250,20,0,38,21,17
2021,177250,20,1,4,2,2
2021,177250,20,2,9,5,4
2021,177250,20,3,16,7,9
2021,177250,20,4,9,7,2
2021,177250,30,0,27,11,16
2021,177250,30,3,1,0,1
2021,177250,30,4,26,11,15
2021,177278,0,0,8,2,6
2021,177278,10,0,8,2,6
2021,177278,10,1,5,2,3
2021,177278,10,2,1,0,1
2021,177278,10,3,2,0,2
2021,177278,20,0,6,2,4
2021,177278,20,1,5,2,3
2021,177278,20,2,1,0,1
2021,177278,30,0,2,0,2
2021,177278,30,3,2,0,2
2021,177302,0,0,9,7,2
2021,177302,10,0,9,7,2
2021,177302,10,4,9,7,2
2021,177302,40,0,9,7,2
2021,177302,40,4,9,7,2
2021,177302,41,0,9,7,2
2021,177302,41,4,9,7,2
2021,177302,45,0,9,7,2
2021,177302,45,4,9,7,2
2021,177339,0,0,87,48,39
2021,177339,10,0,87,48,39
2021,177339,10,1,29,19,10
2021,177339,10,2,27,17,10
2021,177339,10,3,29,11,18
2021,177339,10,4,1,0,1
2021,177339,10,6,1,1,0
2021,177339,20,0,39,25,14
2021,177339,20,1,23,17,6
2021,177339,20,2,14,8,6
2021,177339,20,3,2,0,2
2021,177339,30,0,44,21,23
2021,177339,30,1,6,2,4
2021,177339,30,2,13,9,4
2021,177339,30,3,25,10,15
2021,177339,40,0,4,2,2
2021,177339,40,3,2,1,1
2021,177339,40,4,1,0,1
2021,177339,40,6,1,1,0
2021,177339,42,0,4,2,2
2021,177339,42,3,2,1,1
2021,177339,42,4,1,0,1
2021,177339,42,6,1,1,0
2021,177418,0,0,56,21,35
2021,177418,10,0,56,21,35
2021,177418,10,1,15,6,9
2021,177418,10,2,14,4,10
2021,177418,10,3,18,4,14
2021,177418,10,4,9,7,2
2021,177418,20,0,25,10,15
2021,177418,20,1,14,6,8
2021,177418,20,2,11,4,7
2021,177418,30,0,19,3,16
2021,177418,30,2,3,0,3
2021,177418,30,3,16,3,13
2021,177418,40,0,12,8,4
2021,177418,40,1,1,0,1
2021,177418,40,3,2,1,1
2021,177418,40,4,9,7,2
2021,177418,42,0,12,8,4
2021,177418,42,1,1,0,1
2021,177418,42,3,2,1,1
2021,177418,42,4,9,7,2
2021,177472,0,0,222,93,129
2021,177472,10,0,222,93,129
2021,177472,10,6,222,93,129
2021,177472,40,0,222,93,129
2021,177472,40,6,222,93,129
2021,177472,42,0,219,91,128
2021,177472,42,6,219,91,128
2021,177472,43,0,3,2,1
2021,177472,43,6,3,2,1
2021,177542,0,0,53,26,27
2021,177542,10,0,53,26,27
2021,177542,10,1,12,9,3
2021,177542,10,2,5,3,2
2021,177542,10,3,23,9,14
2021,177542,10,4,13,5,8
2021,177542,40,0,53,26,27
2021,177542,40,1,12,9,3
2021,177542,40,2,5,3,2
2021,177542,40,3,23,9,14
2021,177542,40,4,13,5,8
2021,177542,42,0,53,26,27
2021,177542,42,1,12,9,3
2021,177542,42,2,5,3,2
2021,177542,42,3,23,9,14
2021,177542,42,4,13,5,8
2021,177551,0,0,39,21,18
2021,177551,10,0,39,21,18
2021,177551,10,1,5,2,3
2021,177551,10,2,9,6,3
2021,177551,10,3,18,9,9
2021,177551,10,4,7,4,3
2021,177551,20,0,14,8,6
2021,177551,20,1,5,2,3
2021,177551,20,2,9,6,3
2021,177551,30,0,17,8,9
2021,177551,30,3,17,8,9
2021,177551,40,0,8,5,3
2021,177551,40,3,1,1,0
2021,177551,40,4,7,4,3
2021,177551,42,0,8,5,3
2021,177551,42,3,1,1,0
2021,177551,42,4,7,4,3
2021,177676,0,0,90,36,54
2021,177676,10,0,90,36,54
2021,177676,10,1,32,17,15
2021,177676,10,2,20,5,15
2021,177676,10,3,23,9,14
2021,177676,10,4,12,4,8
2021,177676,10,6,3,1,2
2021,177676,20,0,57,28,29
2021,177676,20,1,32,17,15
2021,177676,20,2,17,5,12
2021,177676,20,3,8,6,2
2021,177676,30,0,30,7,23
2021,177676,30,2,3,0,3
2021,177676,30,3,15,3,12
2021,177676,30,4,12,4,8
2021,177676,40,0,3,1,2
2021,177676,40,6,3,1,2
2021,177676,42,0,3,1,2
2021,177676,42,6,3,1,2
2021,177719,0,0,52,5,47
2021,177719,10,0,52,5,47
2021,177719,10,1,1,0,1
2021,177719,10,2,6,0,6
2021,177719,10,3,29,4,25
2021,177719,10,4,16,1,15
2021,177719,40,0,52,5,47
2021,177719,40,1,1,0,1
2021,177719,40,2,6,0,6
2021,177719,40,3,29,4,25
2021,177719,40,4,16,1,15
2021,177719,42,0,52,5,47
2021,177719,42,1,1,0,1
2021,177719,42,2,6,0,6
2021,177719,42,3,29,4,25
2021,177719,42,4,16,1,15
2021,177746,0,0,56,33,23
2021,177746,10,0,56,33,23
2021,177746,10,1,15,8,7
2021,177746,10,2,20,11,9
2021,177746,10,3,21,14,7
2021,177746,20,0,34,19,15
2021,177746,20,1,15,8,7
2021,177746,20,2,19,11,8
2021,177746,30,0,8,3,5
2021,177746,30,2,1,0,1
2021,177746,30,3,7,3,4
2021,177746,40,0,14,11,3
2021,177746,40,3,14,11,3
2021,177746,42,0,14,11,3
2021,177746,42,3,14,11,3
2021,177816,0,0,14,13,1
2021,177816,10,0,14,13,1
2021,177816,10,1,6,5,1
2021,177816,10,2,4,4,0
2021,177816,10,3,4,4,0
2021,177816,40,0,14,13,1
2021,177816,40,1,6,5,1
2021,177816,40,2,4,4,0
2021,177816,40,3,4,4,0
2021,177816,41,0,8,7,1
2021,177816,41,1,5,4,1
2021,177816,41,2,2,2,0
2021,177816,41,3,1,1,0
2021,177816,42,0,6,6,0
2021,177816,42,1,1,1,0
2021,177816,42,2,2,2,0
2021,177816,42,3,3,3,0
2021,177816,44,0,8,7,1
2021,177816,44,1,5,4,1
2021,177816,44,2,2,2,0
2021,177816,44,3,1,1,0
2021,177834,0,0,244,118,126
2021,177834,10,0,244,118,126
2021,177834,10,1,44,31,13
2021,177834,10,2,66,34,32
2021,177834,10,3,119,51,68
2021,177834,10,4,15,2,13
2021,177834,40,0,244,118,126
2021,177834,40,1,44,31,13
2021,177834,40,2,66,34,32
2021,177834,40,3,119,51,68
2021,177834,40,4,15,2,13
2021,177834,42,0,244,118,126
2021,177834,42,1,44,31,13
2021,177834,42,2,66,34,32
2021,177834,42,3,119,51,68
2021,177834,42,4,15,2,13
2021,177940,0,0,90,45,45
2021,177940,10,0,90,45,45
2021,177940,10,1,24,15,9
2021,177940,10,2,17,12,5
2021,177940,10,3,39,14,25
2021,177940,10,4,10,4,6
2021,177940,20,0,37,24,13
2021,177940,20,1,24,15,9
2021,177940,20,2,11,9,2
2021,177940,20,3,2,0,2
2021,177940,30,0,32,13,19
2021,177940,30,2,5,2,3
2021,177940,30,3,27,11,16
2021,177940,40,0,21,8,13
2021,177940,40,2,1,1,0
2021,177940,40,3,10,3,7
2021,177940,40,4,10,4,6
2021,177940,42,0,21,8,13
2021,177940,42,2,1,1,0
2021,177940,42,3,10,3,7
2021,177940,42,4,10,4,6
2021,177968,0,0,187,81,106
2021,177968,10,0,187,81,106
2021,177968,10,1,67,27,40
2021,177968,10,2,71,38,33
2021,177968,10,3,34,11,23
2021,177968,10,4,15,5,10
2021,177968,40,0,187,81,106
2021,177968,40,1,67,27,40
2021,177968,40,2,71,38,33
2021,177968,40,3,34,11,23
2021,177968,40,4,15,5,10
2021,177968,42,0,187,81,106
2021,177968,42,1,67,27,40
2021,177968,42,2,71,38,33
2021,177968,42,3,34,11,23
2021,177968,42,4,15,5,10
2021,177977,0,0,100,71,29
2021,177977,10,0,100,71,29
2021,177977,10,4,100,71,29
2021,177977,40,0,100,71,29
2021,177977,40,4,100,71,29
2021,177977,42,0,100,71,29
2021,177977,42,4,100,71,29
2021,177986,0,0,53,26,27
2021,177986,10,0,53,26,27
2021,177986,10,1,9,5,4
2021,177986,10,2,6,5,1
2021,177986,10,3,25,9,16
2021,177986,10,4,13,7,6
2021,177986,40,0,53,26,27
2021,177986,40,1,9,5,4
2021,177986,40,2,6,5,1
2021,177986,40,3,25,9,16
2021,177986,40,4,13,7,6
2021,177986,41,0,21,12,9
2021,177986,41,1,8,4,4
2021,177986,41,2,4,3,1
2021,177986,41,3,4,1,3
2021,177986,41,4,5,4,1
2021,177986,42,0,32,14,18
2021,177986,42,1,1,1,0
2021,177986,42,2,2,2,0
2021,177986,42,3,21,8,13
2021,177986,42,4,8,3,5
2021,177986,44,0,21,12,9
2021,177986,44,1,8,4,4
2021,177986,44,2,4,3,1
2021,177986,44,3,4,1,3
2021,177986,44,4,5,4,1
2021,177995,0,0,225,102,123
2021,177995,10,0,225,102,123
2021,177995,10,6,225,102,123
2021,177995,40,0,225,102,123
2021,177995,40,6,225,102,123
2021,177995,42,0,225,102,123
2021,177995,42,6,225,102,123
2021,178059,0,0,167,58,109
2021,178059,10,0,167,58,109
2021,178059,10,1,27,17,10
2021,178059,10,2,44,13,31
2021,178059,10,3,84,21,63
2021,178059,10,4,12,7,5
2021,178059,20,0,63,29,34
2021,178059,20,1,26,16,10
2021,178059,20,2,37,13,24
2021,178059,30,0,47,13,34
2021,178059,30,2,4,0,4
2021,178059,30,3,43,13,30
2021,178059,40,0,57,16,41
2021,178059,40,1,1,1,0
2021,178059,40,2,3,0,3
2021,178059,40,3,41,8,33
2021,178059,40,4,12,7,5
2021,178059,42,0,57,16,41
2021,178059,42,1,1,1,0
2021,178059,42,2,3,0,3
2021,178059,42,3,41,8,33
2021,178059,42,4,12,7,5
2021,178183,0,0,7,1,6
2021,178183,10,0,7,1,6
2021,178183,10,4,7,1,6
2021,178183,40,0,7,1,6
2021,178183,40,4,7,1,6
2021,178183,41,0,7,1,6
2021,178183,41,4,7,1,6
2021,178183,44,0,7,1,6
2021,178183,44,4,7,1,6
2021,178208,0,0,39,38,1
2021,178208,10,0,39,38,1
2021,178208,10,1,11,11,0
2021,178208,10,2,9,9,0
2021,178208,10,3,19,18,1
2021,178208,40,0,39,38,1
2021,178208,40,1,11,11,0
2021,178208,40,2,9,9,0
2021,178208,40,3,19,18,1
2021,178208,41,0,38,38,0
2021,178208,41,1,11,11,0
2021,178208,41,2,9,9,0
2021,178208,41,3,18,18,0
2021,178208,42,0,1,0,1
2021,178208,42,3,1,0,1
2021,178208,44,0,38,38,0
2021,178208,44,1,11,11,0
2021,178208,44,2,9,9,0
2021,178208,44,3,18,18,0
2021,178217,0,0,40,14,26
2021,178217,10,0,40,14,26
2021,178217,10,1,10,4,6
2021,178217,10,2,9,4,5
2021,178217,10,3,10,2,8
2021,178217,10,4,11,4,7
2021,178217,40,0,40,14,26
2021,178217,40,1,10,4,6
2021,178217,40,2,9,4,5
2021,178217,40,3,10,2,8
2021,178217,40,4,11,4,7
2021,178217,42,0,40,14,26
2021,178217,42,1,10,4,6
2021,178217,42,2,9,4,5
2021,178217,42,3,10,2,8
2021,178217,42,4,11,4,7
2021,178244,0,0,69,31,38
2021,178244,10,0,69,31,38
2021,178244,10,1,14,8,6
2021,178244,10,2,10,5,5
2021,178244,10,3,39,15,24
2021,178244,10,4,4,1,3
2021,178244,10,5,2,2,0
2021,178244,40,0,69,31,38
2021,178244,40,1,14,8,6
2021,178244,40,2,10,5,5
2021,178244,40,3,39,15,24
2021,178244,40,4,4,1,3
2021,178244,40,5,2,2,0
2021,178244,42,0,69,31,38
2021,178244,42,1,14,8,6
2021,178244,42,2,10,5,5
2021,178244,42,3,39,15,24
2021,178244,42,4,4,1,3
2021,178244,42,5,2,2,0
2021,178341,0,0,169,78,91
2021,178341,10,0,169,78,91
2021,178341,10,1,35,24,11
2021,178341,10,2,45,19,26
2021,178341,10,3,50,24,26
2021,178341,10,4,26,5,21
2021,178341,10,5,8,5,3
2021,178341,10,6,5,1,4
2021,178341,20,0,78,41,37
2021,178341,20,1,35,24,11
2021,178341,20,2,36,14,22
2021,178341,20,3,7,3,4
2021,178341,30,0,41,20,21
2021,178341,30,2,8,4,4
2021,178341,30,3,33,16,17
2021,178341,40,0,50,17,33
2021,178341,40,2,1,1,0
2021,178341,40,3,10,5,5
2021,178341,40,4,26,5,21
2021,178341,40,5,8,5,3
2021,178341,40,6,5,1,4
2021,178341,42,0,50,17,33
2021,178341,42,2,1,1,0
2021,178341,42,3,10,5,5
2021,178341,42,4,26,5,21
2021,178341,42,5,8,5,3
2021,178341,42,6,5,1,4
2021,178369,0,0,93,45,48
2021,178369,10,0,90,42,48
2021,178369,10,1,9,5,4
2021,178369,10,2,29,15,14
2021,178369,10,3,33,10,23
2021,178369,10,4,18,12,6
2021,178369,10,6,1,0,1
2021,178369,40,0,90,42,48
2021,178369,40,1,9,5,4
2021,178369,40,2,29,15,14
2021,178369,40,3,33,10,23
2021,178369,40,4,18,12,6
2021,178369,40,6,1,0,1
2021,178369,42,0,90,42,48
2021,178369,42,1,9,5,4
2021,178369,42,2,29,15,14
2021,178369,42,3,33,10,23
2021,178369,42,4,18,12,6
2021,178369,42,6,1,0,1
2021,178369,50,0,3,3,0
2021,178387,0,0,144,77,67
2021,178387,10,0,144,77,67
2021,178387,10,1,40,30,10
2021,178387,10,2,38,16,22
2021,178387,10,3,51,24,27
2021,178387,10,4,15,7,8
2021,178387,20,0,78,47,31
2021,178387,20,1,39,29,10
2021,178387,20,2,37,16,21
2021,178387,20,3,2,2,0
2021,178387,30,0,50,22,28
2021,178387,30,2,1,0,1
2021,178387,30,3,49,22,27
2021,178387,40,0,16,8,8
2021,178387,40,1,1,1,0
2021,178387,40,4,15,7,8
2021,178387,42,0,16,8,8
2021,178387,42,1,1,1,0
2021,178387,42,4,15,7,8
2021,178396,0,0,1919,1079,840
2021,178396,10,0,1919,1079,840
2021,178396,10,1,521,365,156
2021,178396,10,2,568,336,232
2021,178396,10,3,633,310,323
2021,178396,10,4,192,66,126
2021,178396,10,5,5,2,3
2021,178396,20,0,733,506,227
2021,178396,20,1,409,304,105
2021,178396,20,2,324,202,122
2021,178396,30,0,247,129,118
2021,178396,30,1,1,1,0
2021,178396,30,2,9,8,1
2021,178396,30,3,237,120,117
2021,178396,40,0,939,444,495
2021,178396,40,1,111,60,51
2021,178396,40,2,235,126,109
2021,178396,40,3,396,190,206
2021,178396,40,4,192,66,126
2021,178396,40,5,5,2,3
2021,178396,42,0,937,443,494
2021,178396,42,1,111,60,51
2021,178396,42,2,235,126,109
2021,178396,42,3,396,190,206
2021,178396,42,4,190,65,125
2021,178396,42,5,5,2,3
2021,178396,43,0,2,1,1
2021,178396,43,4,2,1,1
2021,178402,0,0,570,302,268
2021,178402,10,0,570,302,268
2021,178402,10,1,166,99,67
2021,178402,10,2,200,110,90
2021,178402,10,3,157,72,85
2021,178402,10,4,27,14,13
2021,178402,10,5,14,5,9
2021,178402,10,6,6,2,4
2021,178402,20,0,251,162,89
2021,178402,20,1,133,85,48
2021,178402,20,2,118,77,41
2021,178402,30,0,69,34,35
2021,178402,30,1,2,2,0
2021,178402,30,2,8,3,5
2021,178402,30,3,59,29,30
2021,178402,40,0,250,106,144
2021,178402,40,1,31,12,19
2021,178402,40,2,74,30,44
2021,178402,40,3,98,43,55
2021,178402,40,4,27,14,13
2021,178402,40,5,14,5,9
2021,178402,40,6,6,2,4
2021,178402,42,0,244,104,140
2021,178402,42,1,31,12,19
2021,178402,42,2,74,30,44
2021,178402,42,3,98,43,55
2021,178402,42,4,27,14,13
2021,178402,42,5,14,5,9
2021,178402,43,0,6,2,4
2021,178402,43,6,6,2,4
2021,178411,0,0,319,229,90
2021,178411,10,0,319,229,90
2021,178411,10,1,123,98,25
2021,178411,10,2,114,72,42
2021,178411,10,3,78,55,23
2021,178411,10,4,1,1,0
2021,178411,10,5,3,3,0
2021,178411,20,0,198,150,48
2021,178411,20,1,112,93,19
2021,178411,20,2,86,57,29
2021,178411,30,0,57,43,14
2021,178411,30,2,2,2,0
2021,178411,30,3,55,41,14
2021,178411,40,0,64,36,28
2021,178411,40,1,11,5,6
2021,178411,40,2,26,13,13
2021,178411,40,3,23,14,9
2021,178411,40,4,1,1,0
2021,178411,40,5,3,3,0
2021,178411,42,0,64,36,28
2021,178411,42,1,11,5,6
2021,178411,42,2,26,13,13
2021,178411,42,3,23,14,9
2021,178411,42,4,1,1,0
2021,178411,42,5,3,3,0
2021,178420,0,0,366,160,206
2021,178420,10,0,366,160,206
2021,178420,10,1,119,65,54
2021,178420,10,2,130,60,70
2021,178420,10,3,117,35,82
2021,178420,20,0,158,92,66
2021,178420,20,1,92,58,34
2021,178420,20,2,66,34,32
2021,178420,30,0,64,22,42
2021,178420,30,2,13,5,8
2021,178420,30,3,51,17,34
2021,178420,40,0,144,46,98
2021,178420,40,1,27,7,20
2021,178420,40,2,51,21,30
2021,178420,40,3,66,18,48
2021,178420,42,0,144,46,98
2021,178420,42,1,27,7,20
2021,178420,42,2,51,21,30
2021,178420,42,3,66,18,48
2021,178448,0,0,74,28,46
2021,178448,10,0,74,28,46
2021,178448,10,1,14,6,8
2021,178448,10,2,18,4,14
2021,178448,10,3,8,3,5
2021,178448,10,4,34,15,19
2021,178448,40,0,74,28,46
2021,178448,40,1,14,6,8
2021,178448,40,2,18,4,14
2021,178448,40,3,8,3,5
2021,178448,40,4,34,15,19
2021,178448,41,0,30,11,19
2021,178448,41,1,14,6,8
2021,178448,41,2,10,1,9
2021,178448,41,3,4,2,2
2021,178448,41,4,2,2,0
2021,178448,42,0,44,17,27
2021,178448,42,2,8,3,5
2021,178448,42,3,4,1,3
2021,178448,42,4,32,13,19
2021,178448,44,0,30,11,19
2021,178448,44,1,14,6,8
2021,178448,44,2,10,1,9
2021,178448,44,3,4,2,2
2021,178448,44,4,2,2,0
2021,178518,0,0,11,8,3
2021,178518,10,0,11,8,3
2021,178518,10,1,6,6,0
2021,178518,10,2,4,2,2
2021,178518,10,3,1,0,1
2021,178518,40,0,11,8,3
2021,178518,40,1,6,6,0
2021,178518,40,2,4,2,2
2021,178518,40,3,1,0,1
2021,178518,41,0,11,8,3
2021,178518,41,1,6,6,0
2021,178518,41,2,4,2,2
2021,178518,41,3,1,0,1
2021,178518,44,0,11,8,3
2021,178518,44,1,6,6,0
2021,178518,44,2,4,2,2
2021,178518,44,3,1,0,1
2021,178615,0,0,269,148,121
2021,178615,10,0,269,148,121
2021,178615,10,1,112,73,39
2021,178615,10,2,43,23,20
2021,178615,10,3,83,41,42
2021,178615,10,4,26,10,16
2021,178615,10,5,5,1,4
2021,178615,20,0,145,89,56
2021,178615,20,1,112,73,39
2021,178615,20,2,31,15,16
2021,178615,20,3,2,1,1
2021,178615,30,0,58,30,28
2021,178615,30,2,11,7,4
2021,178615,30,3,47,23,24
2021,178615,40,0,66,29,37
2021,178615,40,2,1,1,0
2021,178615,40,3,34,17,17
2021,178615,40,4,26,10,16
2021,178615,40,5,5,1,4
2021,178615,42,0,66,29,37
2021,178615,42,2,1,1,0
2021,178615,42,3,34,17,17
2021,178615,42,4,26,10,16
2021,178615,42,5,5,1,4
2021,178624,0,0,229,121,108
2021,178624,10,0,229,121,108
2021,178624,10,1,34,26,8
2021,178624,10,2,62,34,28
2021,178624,10,3,78,42,36
2021,178624,10,4,53,17,36
2021,178624,10,5,2,2,0
2021,178624,20,0,93,57,36
2021,178624,20,1,34,26,8
2021,178624,20,2,58,30,28
2021,178624,20,3,1,1,0
2021,178624,30,0,77,41,36
2021,178624,30,2,3,3,0
2021,178624,30,3,73,38,35
2021,178624,30,4,1,0,1
2021,178624,40,0,59,23,36
2021,178624,40,2,1,1,0
2021,178624,40,3,4,3,1
2021,178624,40,4,52,17,35
2021,178624,40,5,2,2,0
2021,178624,42,0,59,23,36
2021,178624,42,2,1,1,0
2021,178624,42,3,4,3,1
2021,178624,42,4,52,17,35
2021,178624,42,5,2,2,0
2021,178679,0,0,24,21,3
2021,178679,10,0,24,21,3
2021,178679,10,1,24,21,3
2021,178679,40,0,24,21,3
2021,178679,40,1,24,21,3
2021,178679,42,0,24,21,3
2021,178679,42,1,24,21,3
2021,178697,0,0,96,56,40
2021,178697,10,0,96,56,40
2021,178697,10,1,24,15,9
2021,178697,10,2,43,22,21
2021,178697,10,3,25,15,10
2021,178697,10,4,4,4,0
2021,178697,40,0,96,56,40
2021,178697,40,1,24,15,9
2021,178697,40,2,43,22,21
2021,178697,40,3,25,15,10
2021,178697,40,4,4,4,0
2021,178697,42,0,96,56,40
2021,178697,42,1,24,15,9
2021,178697,42,2,43,22,21
2021,178697,42,3,25,15,10
2021,178697,42,4,4,4,0
2021,178721,0,0,109,51,58
2021,178721,10,0,109,51,58
2021,178721,10,1,19,12,7
2021,178721,10,2,37,21,16
2021,178721,10,3,38,12,26
2021,178721,10,4,2,0,2
2021,178721,10,5,13,6,7
2021,178721,20,0,50,31,19
2021,178721,20,1,19,12,7
2021,178721,20,2,31,19,12
2021,178721,30,0,32,11,21
2021,178721,30,2,3,1,2
2021,178721,30,3,29,10,19
2021,178721,40,0,27,9,18
2021,178721,40,2,3,1,2
2021,178721,40,3,9,2,7
2021,178721,40,4,2,0,2
2021,178721,40,5,13,6,7
2021,178721,42,0,27,9,18
2021,178721,42,2,3,1,2
2021,178721,42,3,9,2,7
2021,178721,42,4,2,0,2
2021,178721,42,5,13,6,7
2021,178891,0,0,104,97,7
2021,178891,10,0,104,97,7
2021,178891,10,4,104,97,7
2021,178891,40,0,104,97,7
2021,178891,40,4,104,97,7
2021,178891,41,0,104,97,7
2021,178891,41,4,104,97,7
2021,178891,45,0,104,97,7
2021,178891,45,4,104,97,7
2021,178989,0,0,37,2,35
2021,178989,10,0,37,2,35
2021,178989,10,1,5,0,5
2021,178989,10,2,4,0,4
2021,178989,10,3,19,0,19
2021,178989,10,4,9,2,7
2021,178989,40,0,37,2,35
2021,178989,40,1,5,0,5
2021,178989,40,2,4,0,4
2021,178989,40,3,19,0,19
2021,178989,40,4,9,2,7
2021,178989,41,0,24,0,24
2021,178989,41,1,2,0,2
2021,178989,41,2,4,0,4
2021,178989,41,3,18,0,18
2021,178989,42,0,13,2,11
2021,178989,42,1,3,0,3
2021,178989,42,3,1,0,1
2021,178989,42,4,9,2,7
2021,178989,44,0,24,0,24
2021,178989,44,1,2,0,2
2021,178989,44,2,4,0,4
2021,178989,44,3,18,0,18
2021,179043,0,0,168,57,111
2021,179043,10,0,168,57,111
2021,179043,10,1,38,20,18
2021,179043,10,2,49,20,29
2021,179043,10,3,61,9,52
2021,179043,10,4,18,6,12
2021,179043,10,5,2,2,0
2021,179043,20,0,80,37,43
2021,179043,20,1,35,19,16
2021,179043,20,2,43,18,25
2021,179043,20,3,2,0,2
2021,179043,30,0,24,6,18
2021,179043,30,1,2,0,2
2021,179043,30,2,1,0,1
2021,179043,30,3,20,5,15
2021,179043,30,4,1,1,0
2021,179043,40,0,64,14,50
2021,179043,40,1,1,1,0
2021,179043,40,2,5,2,3
2021,179043,40,3,39,4,35
2021,179043,40,4,17,5,12
2021,179043,40,5,2,2,0
2021,179043,42,0,64,14,50
2021,179043,42,1,1,1,0
2021,179043,42,2,5,2,3
2021,179043,42,3,39,4,35
2021,179043,42,4,17,5,12
2021,179043,42,5,2,2,0
2021,179159,0,0,1197,632,565
2021,179159,10,0,1196,631,565
2021,179159,10,1,362,237,125
2021,179159,10,2,402,206,196
2021,179159,10,3,388,173,215
2021,179159,10,4,43,15,28
2021,179159,10,6,1,0,1
2021,179159,20,0,498,304,194
2021,179159,20,1,266,185,81
2021,179159,20,2,232,119,113
2021,179159,30,0,90,50,40
2021,179159,30,2,9,6,3
2021,179159,30,3,81,44,37
2021,179159,40,0,608,277,331
2021,179159,40,1,96,52,44
2021,179159,40,2,161,81,80
2021,179159,40,3,307,129,178
2021,179159,40,4,43,15,28
2021,179159,40,6,1,0,1
2021,179159,41,0,8,0,8
2021,179159,41,1,7,0,7
2021,179159,41,3,1,0,1
2021,179159,42,0,600,277,323
2021,179159,42,1,89,52,37
2021,179159,42,2,161,81,80
2021,179159,42,3,306,129,177
2021,179159,42,4,43,15,28
2021,179159,42,6,1,0,1
2021,179159,44,0,8,0,8
2021,179159,44,1,7,0,7
2021,179159,44,3,1,0,1
2021,179159,50,0,1,1,0
2021,179265,0,0,63,30,33
2021,179265,10,0,63,30,33
2021,179265,10,1,19,13,6
2021,179265,10,2,24,8,16
2021,179265,10,3,20,9,11
2021,179265,20,0,18,8,10
2021,179265,20,1,9,7,2
2021,179265,20,2,9,1,8
2021,179265,30,0,17,11,6
2021,179265,30,1,2,1,1
2021,179265,30,2,5,3,2
2021,179265,30,3,10,7,3
2021,179265,40,0,28,11,17
2021,179265,40,1,8,5,3
2021,179265,40,2,10,4,6
2021,179265,40,3,10,2,8
2021,179265,41,0,1,1,0
2021,179265,41,1,1,1,0
2021,179265,42,0,26,9,17
2021,179265,42,1,7,4,3
2021,179265,42,2,10,4,6
2021,179265,42,3,9,1,8
2021,179265,43,0,1,1,0
2021,179265,43,3,1,1,0
2021,179265,44,0,1,1,0
2021,179265,44,1,1,1,0
2021,179308,0,0,306,133,173
2021,179308,10,0,306,133,173
2021,179308,10,1,121,59,62
2021,179308,10,2,68,32,36
2021,179308,10,3,68,26,42
2021,179308,10,4,22,7,15
2021,179308,10,5,15,5,10
2021,179308,10,6,12,4,8
2021,179308,40,0,306,133,173
2021,179308,40,1,121,59,62
2021,179308,40,2,68,32,36
2021,179308,40,3,68,26,42
2021,179308,40,4,22,7,15
2021,179308,40,5,15,5,10
2021,179308,40,6,12,4,8
2021,179308,42,0,283,127,156
2021,179308,42,1,121,59,62
2021,179308,42,2,68,32,36
2021,179308,42,3,66,26,40
2021,179308,42,4,18,7,11
2021,179308,42,5,2,0,2
2021,179308,42,6,8,3,5
2021,179308,43,0,23,6,17
2021,179308,43,3,2,0,2
2021,179308,43,4,4,0,4
2021,179308,43,5,13,5,8
2021,179308,43,6,4,1,3
2021,179317,0,0,9,4,5
2021,179317,10,0,9,4,5
2021,179317,10,1,7,3,4
2021,179317,10,3,2,1,1
2021,179317,20,0,7,3,4
2021,179317,20,1,7,3,4
2021,179317,40,0,2,1,1
2021,179317,40,3,2,1,1
2021,179317,41,0,2,1,1
2021,179317,41,3,2,1,1
2021,179317,44,0,2,1,1
2021,179317,44,3,2,1,1
2021,179326,0,0,128,62,66
2021,179326,10,0,128,62,66
2021,179326,10,1,34,23,11
2021,179326,10,2,17,11,6
2021,179326,10,3,33,18,15
2021,179326,10,4,44,10,34
2021,179326,20,0,55,34,21
2021,179326,20,1,34,23,11
2021,179326,20,2,13,7,6
2021,179326,20,3,7,4,3
2021,179326,20,4,1,0,1
2021,179326,30,0,30,18,12
2021,179326,30,2,4,4,0
2021,179326,30,3,26,14,12
2021,179326,40,0,43,10,33
2021,179326,40,4,43,10,33
2021,179326,42,0,19,5,14
2021,179326,42,4,19,5,14
2021,179326,43,0,24,5,19
2021,179326,43,4,24,5,19
2021,179344,0,0,37,17,20
2021,179344,10,0,37,17,20
2021,179344,10,1,7,5,2
2021,179344,10,2,11,7,4
2021,179344,10,3,11,3,8
2021,179344,10,4,4,0,4
2021,179344,10,5,4,2,2
2021,179344,20,0,27,14,13
2021,179344,20,1,7,5,2
2021,179344,20,2,11,7,4
2021,179344,20,3,9,2,7
2021,179344,30,0,5,1,4
2021,179344,30,3,1,1,0
2021,179344,30,4,4,0,4
2021,179344,40,0,5,2,3
2021,179344,40,3,1,0,1
2021,179344,40,5,4,2,2
2021,179344,42,0,5,2,3
2021,179344,42,3,1,0,1
2021,179344,42,5,4,2,2
2021,179539,0,0,80,25,55
2021,179539,10,0,80,25,55
2021,179539,10,4,75,22,53
2021,179539,10,6,5,3,2
2021,179539,40,0,80,25,55
2021,179539,40,4,75,22,53
2021,179539,40,6,5,3,2
2021,179539,42,0,80,25,55
2021,179539,42,4,75,22,53
2021,179539,42,6,5,3,2
2021,179548,0,0,81,25,56
2021,179548,10,0,40,13,27
2021,179548,10,1,2,0,2
2021,179548,10,2,11,6,5
2021,179548,10,3,27,7,20
2021,179548,20,0,7,2,5
2021,179548,20,1,2,0,2
2021,179548,20,2,5,2,3
2021,179548,30,0,9,2,7
2021,179548,30,2,4,2,2
2021,179548,30,3,5,0,5
2021,179548,40,0,24,9,15
2021,179548,40,2,2,2,0
2021,179548,40,3,22,7,15
2021,179548,42,0,24,9,15
2021,179548,42,2,2,2,0
2021,179548,42,3,22,7,15
2021,179548,50,0,41,12,29
2021,179557,0,0,352,175,177
2021,179557,10,0,350,174,176
2021,179557,10,1,101,63,38
2021,179557,10,2,59,26,33
2021,179557,10,3,88,41,47
2021,179557,10,4,102,44,58
2021,179557,20,0,162,89,73
2021,179557,20,1,101,63,38
2021,179557,20,2,59,26,33
2021,179557,20,3,2,0,2
2021,179557,30,0,86,41,45
2021,179557,30,3,86,41,45
2021,179557,40,0,102,44,58
2021,179557,40,4,102,44,58
2021,179557,41,0,91,38,53
2021,179557,41,4,91,38,53
2021,179557,42,0,11,6,5
2021,179557,42,4,11,6,5
2021,179557,44,0,91,38,53
2021,179557,44,4,91,38,53
2021,179557,50,0,2,1,1
2021,179566,0,0,741,354,387
2021,179566,10,0,741,354,387
2021,179566,10,1,216,138,78
2021,179566,10,2,175,93,82
2021,179566,10,3,207,74,133
2021,179566,10,4,137,44,93
2021,179566,10,6,6,5,1
2021,179566,20,0,378,228,150
2021,179566,20,1,213,138,75
2021,179566,20,2,160,88,72
2021,179566,20,3,5,2,3
2021,179566,30,0,173,69,104
2021,179566,30,2,4,3,1
2021,179566,30,3,169,66,103
2021,179566,40,0,190,57,133
2021,179566,40,1,3,0,3
2021,179566,40,2,11,2,9
2021,179566,40,3,33,6,27
2021,179566,40,4,137,44,93
2021,179566,40,6,6,5,1
2021,179566,42,0,190,57,133
2021,179566,42,1,3,0,3
2021,179566,42,2,11,2,9
2021,179566,42,3,33,6,27
2021,179566,42,4,137,44,93
2021,179566,42,6,6,5,1
2021,179645,0,0,59,27,32
2021,179645,10,0,59,27,32
2021,179645,10,1,10,6,4
2021,179645,10,2,8,3,5
2021,179645,10,3,13,4,9
2021,179645,10,4,25,11,14
2021,179645,10,6,3,3,0
2021,179645,20,0,10,6,4
2021,179645,20,1,9,5,4
2021,179645,20,2,1,1,0
2021,179645,30,0,1,0,1
2021,179645,30,2,1,0,1
2021,179645,40,0,48,21,27
2021,179645,40,1,1,1,0
2021,179645,40,2,6,2,4
2021,179645,40,3,13,4,9
2021,179645,40,4,25,11,14
2021,179645,40,6,3,3,0
2021,179645,42,0,48,21,27
2021,179645,42,1,1,1,0
2021,179645,42,2,6,2,4
2021,179645,42,3,13,4,9
2021,179645,42,4,25,11,14
2021,179645,42,6,3,3,0
2021,179715,0,0,37,9,28
2021,179715,10,0,37,9,28
2021,179715,10,6,37,9,28
2021,179715,20,0,23,4,19
2021,179715,20,6,23,4,19
2021,179715,30,0,14,5,9
2021,179715,30,6,14,5,9
2021,179812,0,0,57,33,24
2021,179812,10,0,54,33,21
2021,179812,10,1,5,5,0
2021,179812,10,2,16,10,6
2021,179812,10,3,32,18,14
2021,179812,10,4,1,0,1
2021,179812,40,0,54,33,21
2021,179812,40,1,5,5,0
2021,179812,40,2,16,10,6
2021,179812,40,3,32,18,14
2021,179812,40,4,1,0,1
2021,179812,41,0,54,33,21
2021,179812,41,1,5,5,0
2021,179812,41,2,16,10,6
2021,179812,41,3,32,18,14
2021,179812,41,4,1,0,1
2021,179812,44,0,54,33,21
2021,179812,44,1,5,5,0
2021,179812,44,2,16,10,6
2021,179812,44,3,32,18,14
2021,179812,44,4,1,0,1
2021,179812,50,0,3,0,3
2021,179867,0,0,1765,1130,635
2021,179867,10,0,1765,1130,635
2021,179867,10,1,727,551,176
2021,179867,10,2,319,206,113
2021,179867,10,3,352,199,153
2021,179867,10,4,132,74,58
2021,179867,10,5,230,98,132
2021,179867,10,6,5,2,3
2021,179867,20,0,1021,746,275
2021,179867,20,1,725,550,175
2021,179867,20,2,296,196,100
2021,179867,30,0,377,210,167
2021,179867,30,1,2,1,1
2021,179867,30,2,23,10,13
2021,179867,30,3,352,199,153
2021,179867,40,0,367,174,193
2021,179867,40,4,132,74,58
2021,179867,40,5,230,98,132
2021,179867,40,6,5,2,3
2021,179867,42,0,367,174,193
2021,179867,42,4,132,74,58
2021,179867,42,5,230,98,132
2021,179867,42,6,5,2,3
2021,179894,0,0,188,98,90
2021,179894,10,0,184,96,88
2021,179894,10,1,64,36,28
2021,179894,10,2,67,33,34
2021,179894,10,3,43,24,19
2021,179894,10,4,9,3,6
2021,179894,10,5,1,0,1
2021,179894,20,0,123,65,58
2021,179894,20,1,64,36,28
2021,179894,20,2,58,28,30
2021,179894,20,3,1,1,0
2021,179894,30,0,37,20,17
2021,179894,30,2,9,5,4
2021,179894,30,3,28,15,13
2021,179894,40,0,24,11,13
2021,179894,40,3,14,8,6
2021,179894,40,4,9,3,6
2021,179894,40,5,1,0,1
2021,179894,42,0,24,11,13
2021,179894,42,3,14,8,6
2021,179894,42,4,9,3,6
2021,179894,42,5,1,0,1
2021,179894,50,0,4,2,2
2021,179946,0,0,45,24,21
2021,179946,10,0,45,24,21
2021,179946,10,1,11,6,5
2021,179946,10,2,16,8,8
2021,179946,10,3,14,8,6
2021,179946,10,4,4,2,2
2021,179946,20,0,26,14,12
2021,179946,20,1,11,6,5
2021,179946,20,2,15,8,7
2021,179946,30,0,9,5,4
2021,179946,30,3,9,5,4
2021,179946,40,0,10,5,5
2021,179946,40,2,1,0,1
2021,179946,40,3,5,3,2
2021,179946,40,4,4,2,2
2021,179946,42,0,10,5,5
2021,179946,42,2,1,0,1
2021,179946,42,3,5,3,2
2021,179946,42,4,4,2,2
2021,179955,0,0,68,38,30
2021,179955,10,0,68,38,30
2021,179955,10,1,25,11,14
2021,179955,10,2,24,16,8
2021,179955,10,3,16,10,6
2021,179955,10,4,3,1,2
2021,179955,20,0,48,26,22
2021,179955,20,1,25,11,14
2021,179955,20,2,22,14,8
2021,179955,20,3,1,1,0
2021,179955,30,0,7,6,1
2021,179955,30,2,2,2,0
2021,179955,30,3,5,4,1
2021,179955,40,0,13,6,7
2021,179955,40,3,10,5,5
2021,179955,40,4,3,1,2
2021,179955,41,0,13,6,7
2021,179955,41,3,10,5,5
2021,179955,41,4,3,1,2
2021,179955,44,0,13,6,7
2021,179955,44,3,10,5,5
2021,179955,44,4,3,1,2
2021,179964,0,0,56,29,27
2021,179964,10,0,56,29,27
2021,179964,10,1,5,1,4
2021,179964,10,2,12,9,3
2021,179964,10,3,36,17,19
2021,179964,10,4,3,2,1
2021,179964,20,0,6,2,4
2021,179964,20,1,5,1,4
2021,179964,20,2,1,1,0
2021,179964,30,0,50,27,23
2021,179964,30,2,11,8,3
2021,179964,30,3,36,17,19
2021,179964,30,4,3,2,1
2021,180054,0,0,28,9,19
2021,180054,10,0,28,9,19
2021,180054,10,4,28,9,19
2021,180054,40,0,28,9,19
2021,180054,40,4,28,9,19
2021,180054,41,0,28,9,19
2021,180054,41,4,28,9,19
2021,180054,45,0,28,9,19
2021,180054,45,4,28,9,19
2021,180106,0,0,91,42,49
2021,180106,10,0,91,42,49
2021,180106,10,1,24,17,7
2021,180106,10,2,41,18,23
2021,180106,10,3,21,5,16
2021,180106,10,4,5,2,3
2021,180106,20,0,49,29,20
2021,180106,20,1,22,15,7
2021,180106,20,2,26,13,13
2021,180106,20,3,1,1,0
2021,180106,30,0,25,9,16
2021,180106,30,1,1,1,0
2021,180106,30,2,11,5,6
2021,180106,30,3,13,3,10
2021,180106,40,0,17,4,13
2021,180106,40,1,1,1,0
2021,180106,40,2,4,0,4
2021,180106,40,3,7,1,6
2021,180106,40,4,5,2,3
2021,180106,42,0,17,4,13
2021,180106,42,1,1,1,0
2021,180106,42,2,4,0,4
2021,180106,42,3,7,1,6
2021,180106,42,4,5,2,3
2021,180151,0,0,12,5,7
2021,180151,10,0,12,5,7
2021,180151,10,4,12,5,7
2021,180151,20,0,6,2,4
2021,180151,20,4,6,2,4
2021,180151,30,0,6,3,3
2021,180151,30,4,6,3,3
2021,180160,0,0,12,9,3
2021,180160,10,0,12,9,3
2021,180160,10,4,12,9,3
2021,180160,40,0,12,9,3
2021,180160,40,4,12,9,3
2021,180160,43,0,12,9,3
2021,180160,43,4,12,9,3
2021,180179,0,0,141,73,68
2021,180179,10,0,141,73,68
2021,180179,10,1,24,13,11
2021,180179,10,2,28,14,14
2021,180179,10,3,38,19,19
2021,180179,10,4,7,7,0
2021,180179,10,5,44,20,24
2021,180179,20,0,63,34,29
2021,180179,20,1,24,13,11
2021,180179,20,2,27,14,13
2021,180179,20,3,3,1,2
2021,180179,20,5,9,6,3
2021,180179,30,0,39,23,16
2021,180179,30,3,26,14,12
2021,180179,30,4,2,2,0
2021,180179,30,5,11,7,4
2021,180179,40,0,39,16,23
2021,180179,40,2,1,0,1
2021,180179,40,3,9,4,5
2021,180179,40,4,5,5,0
2021,180179,40,5,24,7,17
2021,180179,42,0,39,16,23
2021,180179,42,2,1,0,1
2021,180179,42,3,9,4,5
2021,180179,42,4,5,5,0
2021,180179,42,5,24,7,17
2021,180197,0,0,70,36,34
2021,180197,10,0,49,22,27
2021,180197,10,1,11,5,6
2021,180197,10,2,26,13,13
2021,180197,10,3,12,4,8
2021,180197,20,0,40,18,22
2021,180197,20,1,11,5,6
2021,180197,20,2,26,13,13
2021,180197,20,3,3,0,3
2021,180197,30,0,8,3,5
2021,180197,30,3,8,3,5
2021,180197,40,0,1,1,0
2021,180197,40,3,1,1,0
2021,180197,42,0,1,1,0
2021,180197,42,3,1,1,0
2021,180197,50,0,21,14,7
2021,180203,0,0,12,7,5
2021,180203,10,0,12,7,5
2021,180203,10,4,12,7,5
2021,180203,40,0,12,7,5
2021,180203,40,4,12,7,5
2021,180203,42,0,7,3,4
2021,180203,42,4,7,3,4
2021,180203,43,0,5,4,1
2021,180203,43,4,5,4,1
2021,180212,0,0,20,12,8
2021,180212,10,0,20,12,8
2021,180212,10,4,20,12,8
2021,180212,40,0,20,12,8
2021,180212,40,4,20,12,8
2021,180212,42,0,20,12,8
2021,180212,42,4,20,12,8
2021,180249,0,0,38,14,24
2021,180249,10,0,38,14,24
2021,180249,10,4,38,14,24
2021,180249,20,0,22,9,13
2021,180249,20,4,22,9,13
2021,180249,30,0,11,1,10
2021,180249,30,4,11,1,10
2021,180249,40,0,5,4,1
2021,180249,40,4,5,4,1
2021,180249,42,0,5,4,1
2021,180249,42,4,5,4,1
2021,180258,0,0,45,19,26
2021,180258,10,0,45,19,26
2021,180258,10,1,11,6,5
2021,180258,10,2,10,3,7
2021,180258,10,3,9,5,4
2021,180258,10,4,4,0,4
2021,180258,10,5,1,0,1
2021,180258,10,6,10,5,5
2021,180258,20,0,14,8,6
2021,180258,20,1,10,6,4
2021,180258,20,2,2,1,1
2021,180258,20,6,2,1,1
2021,180258,30,0,18,11,7
2021,180258,30,2,4,2,2
2021,180258,30,3,7,5,2
2021,180258,30,6,7,4,3
2021,180258,40,0,13,0,13
2021,180258,40,1,1,0,1
2021,180258,40,2,4,0,4
2021,180258,40,3,2,0,2
2021,180258,40,4,4,0,4
2021,180258,40,5,1,0,1
2021,180258,40,6,1,0,1
2021,180258,42,0,13,0,13
2021,180258,42,1,1,0,1
2021,180258,42,2,4,0,4
2021,180258,42,3,2,0,2
2021,180258,42,4,4,0,4
2021,180258,42,5,1,0,1
2021,180258,42,6,1,0,1
2021,180276,0,0,28,19,9
2021,180276,10,0,28,19,9
2021,180276,10,4,28,19,9
2021,180276,20,0,12,10,2
2021,180276,20,4,12,10,2
2021,180276,30,0,14,8,6
2021,180276,30,4,14,8,6
2021,180276,40,0,2,1,1
2021,180276,40,4,2,1,1
2021,180276,42,0,2,1,1
2021,180276,42,4,2,1,1
2021,180328,0,0,12,4,8
2021,180328,10,0,12,4,8
2021,180328,10,4,12,4,8
2021,180328,40,0,12,4,8
2021,180328,40,4,12,4,8
2021,180328,42,0,12,4,8
2021,180328,42,4,12,4,8
2021,180373,0,0,23,12,11
2021,180373,10,0,23,12,11
2021,180373,10,6,23,12,11
2021,180373,40,0,23,12,11
2021,180373,40,6,23,12,11
2021,180373,42,0,23,12,11
2021,180373,42,6,23,12,11
2021,180416,0,0,122,80,42
2021,180416,10,0,122,80,42
2021,180416,10,1,36,25,11
2021,180416,10,2,32,18,14
2021,180416,10,3,22,15,7
2021,180416,10,4,32,22,10
2021,180416,20,0,55,34,21
2021,180416,20,1,35,24,11
2021,180416,20,2,14,7,7
2021,180416,20,4,6,3,3
2021,180416,30,0,52,35,17
2021,180416,30,1,1,1,0
2021,180416,30,2,17,10,7
2021,180416,30,3,20,14,6
2021,180416,30,4,14,10,4
2021,180416,40,0,15,11,4
2021,180416,40,2,1,1,0
2021,180416,40,3,2,1,1
2021,180416,40,4,12,9,3
2021,180416,42,0,15,11,4
2021,180416,42,2,1,1,0
2021,180416,42,3,2,1,1
2021,180416,42,4,12,9,3
2021,180461,0,0,613,320,293
2021,180461,10,0,613,320,293
2021,180461,10,1,203,143,60
2021,180461,10,2,176,84,92
2021,180461,10,3,112,52,60
2021,180461,10,4,30,11,19
2021,180461,10,6,92,30,62
2021,180461,20,0,382,230,152
2021,180461,20,1,202,142,60
2021,180461,20,2,174,84,90
2021,180461,20,4,6,4,2
2021,180461,30,0,123,56,67
2021,180461,30,1,1,1,0
2021,180461,30,2,2,0,2
2021,180461,30,3,112,52,60
2021,180461,30,4,8,3,5
2021,180461,40,0,108,34,74
2021,180461,40,4,16,4,12
2021,180461,40,6,92,30,62
2021,180461,42,0,7,1,6
2021,180461,42,6,7,1,6
2021,180461,43,0,101,33,68
2021,180461,43,4,16,4,12
2021,180461,43,6,85,29,56
2021,180489,0,0,426,243,183
2021,180489,10,0,426,243,183
2021,180489,10,1,200,129,71
2021,180489,10,2,107,61,46
2021,180489,10,3,87,35,52
2021,180489,10,4,21,12,9
2021,180489,10,5,11,6,5
2021,180489,20,0,290,181,109
2021,180489,20,1,195,127,68
2021,180489,20,2,95,54,41
2021,180489,30,0,72,35,37
2021,180489,30,2,10,7,3
2021,180489,30,3,62,28,34
2021,180489,40,0,64,27,37
2021,180489,40,1,5,2,3
2021,180489,40,2,2,0,2
2021,180489,40,3,25,7,18
2021,180489,40,4,21,12,9
2021,180489,40,5,11,6,5
2021,180489,42,0,61,27,34
2021,180489,42,1,5,2,3
2021,180489,42,2,2,0,2
2021,180489,42,3,25,7,18
2021,180489,42,4,18,12,6
2021,180489,42,5,11,6,5
2021,180489,43,0,3,0,3
2021,180489,43,4,3,0,3
2021,180522,0,0,48,33,15
2021,180522,10,0,48,33,15
2021,180522,10,1,15,12,3
2021,180522,10,2,8,4,4
2021,180522,10,3,21,13,8
2021,180522,10,4,4,4,0
2021,180522,20,0,16,12,4
2021,180522,20,1,15,12,3
2021,180522,20,2,1,0,1
2021,180522,30,0,25,15,10
2021,180522,30,2,6,3,3
2021,180522,30,3,19,12,7
2021,180522,40,0,7,6,1
2021,180522,40,2,1,1,0
2021,180522,40,3,2,1,1
2021,180522,40,4,4,4,0
2021,180522,42,0,7,6,1
2021,180522,42,2,1,1,0
2021,180522,42,3,2,1,1
2021,180522,42,4,4,4,0
2021,180595,0,0,64,30,34
2021,180595,10,0,64,30,34
2021,180595,10,1,19,13,6
2021,180595,10,2,17,5,12
2021,180595,10,3,20,7,13
2021,180595,10,4,8,5,3
2021,180595,20,0,36,18,18
2021,180595,20,1,19,13,6
2021,180595,20,2,17,5,12
2021,180595,30,0,9,4,5
2021,180595,30,3,9,4,5
2021,180595,40,0,19,8,11
2021,180595,40,3,11,3,8
2021,180595,40,4,8,5,3
2021,180595,42,0,19,8,11
2021,180595,42,3,11,3,8
2021,180595,42,4,8,5,3
2021,180647,0,0,69,26,43
2021,180647,10,0,69,26,43
2021,180647,10,4,69,26,43
2021,180647,40,0,69,26,43
2021,180647,40,4,69,26,43
2021,180647,41,0,69,26,43
2021,180647,41,4,69,26,43
2021,180647,44,0,69,26,43
2021,180647,44,4,69,26,43
2021,180692,0,0,68,34,34
2021,180692,10,0,68,34,34
2021,180692,10,1,29,18,11
2021,180692,10,2,9,3,6
2021,180692,10,3,14,7,7
2021,180692,10,4,16,6,10
2021,180692,20,0,35,21,14
2021,180692,20,1,29,18,11
2021,180692,20,2,6,3,3
2021,180692,30,0,18,8,10
2021,180692,30,2,3,0,3
2021,180692,30,3,14,7,7
2021,180692,30,4,1,1,0
2021,180692,40,0,15,5,10
2021,180692,40,4,15,5,10
2021,180692,42,0,15,5,10
2021,180692,42,4,15,5,10
2021,180814,0,0,105,55,50
2021,180814,10,0,105,55,50
2021,180814,10,1,20,11,9
2021,180814,10,2,36,19,17
2021,180814,10,3,31,18,13
2021,180814,10,4,18,7,11
2021,180814,40,0,105,55,50
2021,180814,40,1,20,11,9
2021,180814,40,2,36,19,17
2021,180814,40,3,31,18,13
2021,180814,40,4,18,7,11
2021,180814,41,0,87,48,39
2021,180814,41,1,20,11,9
2021,180814,41,2,36,19,17
2021,180814,41,3,31,18,13
2021,180814,42,0,18,7,11
2021,180814,42,4,18,7,11
2021,180814,44,0,87,48,39
2021,180814,44,1,20,11,9
2021,180814,44,2,36,19,17
2021,180814,44,3,31,18,13
2021,180832,0,0,65,5,60
2021,180832,10,0,65,5,60
2021,180832,10,1,1,0,1
2021,180832,10,2,24,3,21
2021,180832,10,3,15,1,14
2021,180832,10,4,25,1,24
2021,180832,40,0,65,5,60
2021,180832,40,1,1,0,1
2021,180832,40,2,24,3,21
2021,180832,40,3,15,1,14
2021,180832,40,4,25,1,24
2021,180832,41,0,33,4,29
2021,180832,41,1,1,0,1
2021,180832,41,2,20,3,17
2021,180832,41,3,8,1,7
2021,180832,41,4,4,0,4
2021,180832,42,0,32,1,31
2021,180832,42,2,4,0,4
2021,180832,42,3,7,0,7
2021,180832,42,4,21,1,20
2021,180832,44,0,33,4,29
2021,180832,44,1,1,0,1
2021,180832,44,2,20,3,17
2021,180832,44,3,8,1,7
2021,180832,44,4,4,0,4
2021,180878,0,0,42,7,35
2021,180878,10,0,42,7,35
2021,180878,10,1,4,1,3
2021,180878,10,2,18,5,13
2021,180878,10,3,19,1,18
2021,180878,10,4,1,0,1
2021,180878,40,0,42,7,35
2021,180878,40,1,4,1,3
2021,180878,40,2,18,5,13
2021,180878,40,3,19,1,18
2021,180878,40,4,1,0,1
2021,180878,42,0,42,7,35
2021,180878,42,1,4,1,3
2021,180878,42,2,18,5,13
2021,180878,42,3,19,1,18
2021,180878,42,4,1,0,1
2021,180902,0,0,156,79,77
2021,180902,10,0,156,79,77
2021,180902,10,6,156,79,77
2021,180902,40,0,156,79,77
2021,180902,40,6,156,79,77
2021,180902,43,0,156,79,77
2021,180902,43,6,156,79,77
2021,180948,0,0,87,47,40
2021,180948,10,0,87,47,40
2021,180948,10,1,36,20,16
2021,180948,10,2,16,8,8
2021,180948,10,3,28,14,14
2021,180948,10,4,7,5,2
2021,180948,20,0,36,21,15
2021,180948,20,1,32,19,13
2021,180948,20,2,4,2,2
2021,180948,30,0,37,18,19
2021,180948,30,2,11,6,5
2021,180948,30,3,24,11,13
2021,180948,30,4,2,1,1
2021,180948,40,0,14,8,6
2021,180948,40,1,4,1,3
2021,180948,40,2,1,0,1
2021,180948,40,3,4,3,1
2021,180948,40,4,5,4,1
2021,180948,42,0,14,8,6
2021,180948,42,1,4,1,3
2021,180948,42,2,1,0,1
2021,180948,42,3,4,3,1
2021,180948,42,4,5,4,1
2021,180984,0,0,65,40,25
2021,180984,10,0,65,40,25
2021,180984,10,1,28,21,7
2021,180984,10,2,16,7,9
2021,180984,10,3,20,11,9
2021,180984,10,4,1,1,0
2021,180984,40,0,65,40,25
2021,180984,40,1,28,21,7
2021,180984,40,2,16,7,9
2021,180984,40,3,20,11,9
2021,180984,40,4,1,1,0
2021,180984,41,0,64,39,25
2021,180984,41,1,28,21,7
2021,180984,41,2,16,7,9
2021,180984,41,3,20,11,9
2021,180984,42,0,1,1,0
2021,180984,42,4,1,1,0
2021,180984,44,0,36,18,18
2021,180984,44,2,16,7,9
2021,180984,44,3,20,11,9
2021,180984,45,0,28,21,7
2021,180984,45,1,28,21,7
2021,181002,0,0,646,330,316
2021,181002,10,0,646,330,316
2021,181002,10,1,186,121,65
2021,181002,10,2,183,98,85
2021,181002,10,3,224,88,136
2021,181002,10,4,53,23,30
2021,181002,20,0,339,209,130
2021,181002,20,1,175,115,60
2021,181002,20,2,145,82,63
2021,181002,20,3,19,12,7
2021,181002,30,0,115,46,69
2021,181002,30,1,3,1,2
2021,181002,30,2,10,7,3
2021,181002,30,3,102,38,64
2021,181002,40,0,192,75,117
2021,181002,40,1,8,5,3
2021,181002,40,2,28,9,19
2021,181002,40,3,103,38,65
2021,181002,40,4,53,23,30
2021,181002,42,0,192,75,117
2021,181002,42,1,8,5,3
2021,181002,42,2,28,9,19
2021,181002,42,3,103,38,65
2021,181002,42,4,53,23,30
2021,181020,0,0,99,48,51
2021,181020,10,0,99,48,51
2021,181020,10,1,24,17,7
2021,181020,10,2,25,8,17
2021,181020,10,3,46,23,23
2021,181020,10,4,3,0,3
2021,181020,10,6,1,0,1
2021,181020,20,0,35,21,14
2021,181020,20,1,22,15,7
2021,181020,20,2,13,6,7
2021,181020,30,0,27,14,13
2021,181020,30,2,2,0,2
2021,181020,30,3,25,14,11
2021,181020,40,0,37,13,24
2021,181020,40,1,2,2,0
2021,181020,40,2,10,2,8
2021,181020,40,3,21,9,12
2021,181020,40,4,3,0,3
2021,181020,40,6,1,0,1
2021,181020,42,0,37,13,24
2021,181020,42,1,2,2,0
2021,181020,42,2,10,2,8
2021,181020,42,3,21,9,12
2021,181020,42,4,3,0,3
2021,181020,42,6,1,0,1
2021,181127,0,0,63,34,29
2021,181127,10,0,63,34,29
2021,181127,10,1,25,18,7
2021,181127,10,2,7,2,5
2021,181127,10,3,21,9,12
2021,181127,10,4,10,5,5
2021,181127,20,0,30,18,12
2021,181127,20,1,23,16,7
2021,181127,20,2,7,2,5
2021,181127,30,0,16,9,7
2021,181127,30,1,2,2,0
2021,181127,30,3,14,7,7
2021,181127,40,0,17,7,10
2021,181127,40,3,7,2,5
2021,181127,40,4,10,5,5
2021,181127,42,0,17,7,10
2021,181127,42,3,7,2,5
2021,181127,42,4,10,5,5
2021,181215,0,0,330,170,160
2021,181215,10,0,330,170,160
2021,181215,10,1,105,56,49
2021,181215,10,2,89,53,36
2021,181215,10,3,72,37,35
2021,181215,10,4,3,2,1
2021,181215,10,5,61,22,39
2021,181215,20,0,179,97,82
2021,181215,20,1,105,56,49
2021,181215,20,2,73,40,33
2021,181215,20,3,1,1,0
2021,181215,30,0,81,45,36
2021,181215,30,2,16,13,3
2021,181215,30,3,65,32,33
2021,181215,40,0,70,28,42
2021,181215,40,3,6,4,2
2021,181215,40,4,3,2,1
2021,181215,40,5,61,22,39
2021,181215,42,0,70,28,42
2021,181215,42,3,6,4,2
2021,181215,42,4,3,2,1
2021,181215,42,5,61,22,39
2021,181297,0,0,65,3,62
2021,181297,10,0,65,3,62
2021,181297,10,1,9,1,8
2021,181297,10,2,12,0,12
2021,181297,10,3,40,2,38
2021,181297,10,4,4,0,4
2021,181297,40,0,65,3,62
2021,181297,40,1,9,1,8
2021,181297,40,2,12,0,12
2021,181297,40,3,40,2,38
2021,181297,40,4,4,0,4
2021,181297,42,0,65,3,62
2021,181297,42,1,9,1,8
2021,181297,42,2,12,0,12
2021,181297,42,3,40,2,38
2021,181297,42,4,4,0,4
2021,181303,0,0,235,111,124
2021,181303,10,0,235,111,124
2021,181303,10,4,235,111,124
2021,181303,40,0,235,111,124
2021,181303,40,4,235,111,124
2021,181303,42,0,87,59,28
2021,181303,42,4,87,59,28
2021,181303,43,0,148,52,96
2021,181303,43,4,148,52,96
2021,181312,0,0,69,31,38
2021,181312,10,0,69,31,38
2021,181312,10,4,69,31,38
2021,181312,40,0,69,31,38
2021,181312,40,4,69,31,38
2021,181312,42,0,69,31,38
2021,181312,42,4,69,31,38
2021,181330,0,0,37,14,23
2021,181330,10,0,37,14,23
2021,181330,10,1,10,5,5
2021,181330,10,2,20,7,13
2021,181330,10,3,7,2,5
2021,181330,20,0,12,6,6
2021,181330,20,1,9,5,4
2021,181330,20,2,3,1,2
2021,181330,30,0,25,8,17
2021,181330,30,1,1,0,1
2021,181330,30,2,17,6,11
2021,181330,30,3,7,2,5
2021,181394,0,0,596,306,290
2021,181394,10,0,596,306,290
2021,181394,10,1,123,85,38
2021,181394,10,2,139,65,74
2021,181394,10,3,168,81,87
2021,181394,10,4,111,48,63
2021,181394,10,5,55,27,28
2021,181394,20,0,262,149,113
2021,181394,20,1,123,85,38
2021,181394,20,2,138,64,74
2021,181394,20,3,1,0,1
2021,181394,30,0,165,79,86
2021,181394,30,3,165,79,86
2021,181394,40,0,169,78,91
2021,181394,40,2,1,1,0
2021,181394,40,3,2,2,0
2021,181394,40,4,111,48,63
2021,181394,40,5,55,27,28
2021,181394,42,0,166,76,90
2021,181394,42,2,1,1,0
2021,181394,42,3,2,2,0
2021,181394,42,4,108,46,62
2021,181394,42,5,55,27,28
2021,181394,43,0,3,2,1
2021,181394,43,4,3,2,1
2021,181419,0,0,15,7,8
2021,181419,10,0,15,7,8
2021,181419,10,4,15,7,8
2021,181419,40,0,15,7,8
2021,181419,40,4,15,7,8
2021,181419,42,0,15,7,8
2021,181419,42,4,15,7,8
2021,181428,0,0,629,266,363
2021,181428,10,0,615,261,354
2021,181428,10,1,105,72,33
2021,181428,10,2,129,56,73
2021,181428,10,3,282,108,174
2021,181428,10,4,94,23,71
2021,181428,10,6,5,2,3
2021,181428,20,0,99,58,41
2021,181428,20,1,69,47,22
2021,181428,20,2,30,11,19
2021,181428,30,0,262,128,134
2021,181428,30,1,30,21,9
2021,181428,30,2,76,37,39
2021,181428,30,3,156,70,86
2021,181428,40,0,254,75,179
2021,181428,40,1,6,4,2
2021,181428,40,2,23,8,15
2021,181428,40,3,126,38,88
2021,181428,40,4,94,23,71
2021,181428,40,6,5,2,3
2021,181428,42,0,253,75,178
2021,181428,42,1,6,4,2
2021,181428,42,2,23,8,15
2021,181428,42,3,125,38,87
2021,181428,42,4,94,23,71
2021,181428,42,6,5,2,3
2021,181428,43,0,1,0,1
2021,181428,43,3,1,0,1
2021,181428,50,0,14,5,9
2021,181446,0,0,113,48,65
2021,181446,10,0,113,48,65
2021,181446,10,1,39,18,21
2021,181446,10,2,26,12,14
2021,181446,10,3,40,14,26
2021,181446,10,4,8,4,4
2021,181446,20,0,60,27,33
2021,181446,20,1,38,17,21
2021,181446,20,2,22,10,12
2021,181446,30,0,34,14,20
2021,181446,30,2,2,1,1
2021,181446,30,3,32,13,19
2021,181446,40,0,19,7,12
2021,181446,40,1,1,1,0
2021,181446,40,2,2,1,1
2021,181446,40,3,8,1,7
2021,181446,40,4,8,4,4
2021,181446,41,0,15,6,9
2021,181446,41,1,1,1,0
2021,181446,41,2,2,1,1
2021,181446,41,3,7,1,6
2021,181446,41,4,5,3,2
2021,181446,42,0,4,1,3
2021,181446,42,3,1,0,1
2021,181446,42,4,3,1,2
2021,181446,44,0,15,6,9
2021,181446,44,1,1,1,0
2021,181446,44,2,2,1,1
2021,181446,44,3,7,1,6
2021,181446,44,4,5,3,2
2021,181464,0,0,1304,799,505
2021,181464,10,0,1304,799,505
2021,181464,10,1,440,334,106
2021,181464,10,2,388,231,157
2021,181464,10,3,370,192,178
2021,181464,10,5,102,38,64
2021,181464,10,6,4,4,0
2021,181464,20,0,743,522,221
2021,181464,20,1,419,324,95
2021,181464,20,2,324,198,126
2021,181464,30,0,261,150,111
2021,181464,30,2,8,8,0
2021,181464,30,3,253,142,111
2021,181464,40,0,300,127,173
2021,181464,40,1,21,10,11
2021,181464,40,2,56,25,31
2021,181464,40,3,117,50,67
2021,181464,40,5,102,38,64
2021,181464,40,6,4,4,0
2021,181464,41,0,194,85,109
2021,181464,41,1,21,10,11
2021,181464,41,2,56,25,31
2021,181464,41,3,117,50,67
2021,181464,42,0,96,34,62
2021,181464,42,5,96,34,62
2021,181464,43,0,10,8,2
2021,181464,43,5,6,4,2
2021,181464,43,6,4,4,0
2021,181464,44,0,194,85,109
2021,181464,44,1,21,10,11
2021,181464,44,2,56,25,31
2021,181464,44,3,117,50,67
2021,181491,0,0,129,75,54
2021,181491,10,0,125,71,54
2021,181491,10,4,125,71,54
2021,181491,40,0,125,71,54
2021,181491,40,4,125,71,54
2021,181491,42,0,125,71,54
2021,181491,42,4,125,71,54
2021,181491,50,0,4,4,0
2021,181534,0,0,51,27,24
2021,181534,10,0,51,27,24
2021,181534,10,1,9,5,4
2021,181534,10,2,13,5,8
2021,181534,10,3,17,11,6
2021,181534,10,4,12,6,6
2021,181534,20,0,17,9,8
2021,181534,20,1,9,5,4
2021,181534,20,2,8,4,4
2021,181534,30,0,20,10,10
2021,181534,30,2,4,0,4
2021,181534,30,3,16,10,6
2021,181534,40,0,14,8,6
2021,181534,40,2,1,1,0
2021,181534,40,3,1,1,0
2021,181534,40,4,12,6,6
2021,181534,41,0,14,8,6
2021,181534,41,2,1,1,0
2021,181534,41,3,1,1,0
2021,181534,41,4,12,6,6
2021,181534,44,0,14,8,6
2021,181534,44,2,1,1,0
2021,181534,44,3,1,1,0
2021,181534,44,4,12,6,6
2021,181604,0,0,84,12,72
2021,181604,10,0,84,12,72
2021,181604,10,1,16,3,13
2021,181604,10,2,17,3,14
2021,181604,10,3,41,6,35
2021,181604,10,4,10,0,10
2021,181604,40,0,84,12,72
2021,181604,40,1,16,3,13
2021,181604,40,2,17,3,14
2021,181604,40,3,41,6,35
2021,181604,40,4,10,0,10
2021,181604,41,0,25,5,20
2021,181604,41,1,12,2,10
2021,181604,41,2,13,3,10
2021,181604,42,0,59,7,52
2021,181604,42,1,4,1,3
2021,181604,42,2,4,0,4
2021,181604,42,3,41,6,35
2021,181604,42,4,10,0,10
2021,181604,44,0,25,5,20
2021,181604,44,1,12,2,10
2021,181604,44,2,13,3,10
2021,181640,0,0,362,188,174
2021,181640,10,0,362,188,174
2021,181640,10,6,362,188,174
2021,181640,40,0,362,188,174
2021,181640,40,6,362,188,174
2021,181640,42,0,362,188,174
2021,181640,42,6,362,188,174
2021,181738,0,0,54,20,34
2021,181738,10,0,54,20,34
2021,181738,10,1,12,6,6
2021,181738,10,2,15,5,10
2021,181738,10,3,21,8,13
2021,181738,10,4,2,0,2
2021,181738,10,5,4,1,3
2021,181738,20,0,5,2,3
2021,181738,20,1,5,2,3
2021,181738,30,0,44,17,27
2021,181738,30,1,7,4,3
2021,181738,30,2,15,5,10
2021,181738,30,3,21,8,13
2021,181738,30,5,1,0,1
2021,181738,40,0,5,1,4
2021,181738,40,4,2,0,2
2021,181738,40,5,3,1,2
2021,181738,42,0,5,1,4
2021,181738,42,4,2,0,2
2021,181738,42,5,3,1,2
2021,181765,0,0,13,7,6
2021,181765,10,0,13,7,6
2021,181765,10,2,6,4,2
2021,181765,10,3,4,1,3
2021,181765,10,5,3,2,1
2021,181765,40,0,13,7,6
2021,181765,40,2,6,4,2
2021,181765,40,3,4,1,3
2021,181765,40,5,3,2,1
2021,181765,42,0,13,7,6
2021,181765,42,2,6,4,2
2021,181765,42,3,4,1,3
2021,181765,42,5,3,2,1
2021,181783,0,0,121,63,58
2021,181783,10,0,121,63,58
2021,181783,10,1,49,27,22
2021,181783,10,2,31,13,18
2021,181783,10,3,28,15,13
2021,181783,10,4,11,7,4
2021,181783,10,5,2,1,1
2021,181783,20,0,68,34,34
2021,181783,20,1,49,27,22
2021,181783,20,2,18,6,12
2021,181783,20,3,1,1,0
2021,181783,30,0,40,21,19
2021,181783,30,2,13,7,6
2021,181783,30,3,27,14,13
2021,181783,40,0,13,8,5
2021,181783,40,4,11,7,4
2021,181783,40,5,2,1,1
2021,181783,42,0,13,8,5
2021,181783,42,4,11,7,4
2021,181783,42,5,2,1,1
2021,181817,0,0,64,29,35
2021,181817,10,0,64,29,35
2021,181817,10,6,64,29,35
2021,181817,20,0,55,25,30
2021,181817,20,6,55,25,30
2021,181817,30,0,9,4,5
2021,181817,30,6,9,4,5
2021,181853,0,0,25,19,6
2021,181853,10,0,25,19,6
2021,181853,10,1,7,7,0
2021,181853,10,2,11,9,2
2021,181853,10,3,7,3,4
2021,181853,20,0,9,8,1
2021,181853,20,1,5,5,0
2021,181853,20,2,4,3,1
2021,181853,30,0,3,3,0
2021,181853,30,2,3,3,0
2021,181853,40,0,13,8,5
2021,181853,40,1,2,2,0
2021,181853,40,2,4,3,1
2021,181853,40,3,7,3,4
2021,181853,42,0,13,8,5
2021,181853,42,1,2,2,0
2021,181853,42,2,4,3,1
2021,181853,42,3,7,3,4
2021,181941,0,0,36,26,10
2021,181941,10,0,36,26,10
2021,181941,10,4,36,26,10
2021,181941,40,0,36,26,10
2021,181941,40,4,36,26,10
2021,181941,41,0,36,26,10
2021,181941,41,4,36,26,10
2021,181941,45,0,36,26,10
2021,181941,45,4,36,26,10
2021,182005,0,0,509,262,247
2021,182005,10,0,509,262,247
2021,182005,10,1,379,198,181
2021,182005,10,4,65,37,28
2021,182005,10,5,1,0,1
2021,182005,10,6,64,27,37
2021,182005,20,0,381,199,182
2021,182005,20,1,379,198,181
2021,182005,20,6,2,1,1
2021,182005,30,0,72,34,38
2021,182005,30,4,37,21,16
2021,182005,30,5,1,0,1
2021,182005,30,6,34,13,21
2021,182005,40,0,56,29,27
2021,182005,40,4,28,16,12
2021,182005,40,6,28,13,15
2021,182005,42,0,56,29,27
2021,182005,42,4,28,16,12
2021,182005,42,6,28,13,15
2021,182148,0,0,23,3,20
2021,182148,10,0,23,3,20
2021,182148,10,6,23,3,20
2021,182148,40,0,23,3,20
2021,182148,40,6,23,3,20
2021,182148,41,0,23,3,20
2021,182148,41,6,23,3,20
2021,182148,45,0,23,3,20
2021,182148,45,6,23,3,20
2021,182281,0,0,1155,673,482
2021,182281,10,0,1155,673,482
2021,182281,10,1,313,232,81
2021,182281,10,2,230,132,98
2021,182281,10,3,164,89,75
2021,182281,10,4,12,6,6
2021,182281,10,5,113,54,59
2021,182281,10,6,323,160,163
2021,182281,20,0,533,361,172
2021,182281,20,1,313,232,81
2021,182281,20,2,217,126,91
2021,182281,20,3,3,3,0
2021,182281,30,0,174,92,82
2021,182281,30,2,13,6,7
2021,182281,30,3,161,86,75
2021,182281,40,0,448,220,228
2021,182281,40,4,12,6,6
2021,182281,40,5,113,54,59
2021,182281,40,6,323,160,163
2021,182281,42,0,448,220,228
2021,182281,42,4,12,6,6
2021,182281,42,5,113,54,59
2021,182281,42,6,323,160,163
2021,182290,0,0,941,530,411
2021,182290,10,0,941,530,411
2021,182290,10,1,201,139,62
2021,182290,10,2,231,148,83
2021,182290,10,3,232,128,104
2021,182290,10,5,188,77,111
2021,182290,10,6,89,38,51
2021,182290,20,0,419,277,142
2021,182290,20,1,200,138,62
2021,182290,20,2,218,139,79
2021,182290,20,3,1,0,1
2021,182290,30,0,245,138,107
2021,182290,30,1,1,1,0
2021,182290,30,2,13,9,4
2021,182290,30,3,231,128,103
2021,182290,40,0,277,115,162
2021,182290,40,5,188,77,111
2021,182290,40,6,89,38,51
2021,182290,42,0,277,115,162
2021,182290,42,5,188,77,111
2021,182290,42,6,89,38,51
2021,182306,0,0,70,46,24
2021,182306,10,0,70,46,24
2021,182306,10,1,38,22,16
2021,182306,10,4,32,24,8
2021,182306,20,0,38,22,16
2021,182306,20,1,38,22,16
2021,182306,30,0,17,10,7
2021,182306,30,4,17,10,7
2021,182306,40,0,15,14,1
2021,182306,40,4,15,14,1
2021,182306,42,0,15,14,1
2021,182306,42,4,15,14,1
2021,182458,0,0,22,13,9
2021,182458,10,0,22,13,9
2021,182458,10,1,5,3,2
2021,182458,10,2,3,1,2
2021,182458,10,3,13,8,5
2021,182458,10,4,1,1,0
2021,182458,40,0,22,13,9
2021,182458,40,1,5,3,2
2021,182458,40,2,3,1,2
2021,182458,40,3,13,8,5
2021,182458,40,4,1,1,0
2021,182458,42,0,22,13,9
2021,182458,42,1,5,3,2
2021,182458,42,2,3,1,2
2021,182458,42,3,13,8,5
2021,182458,42,4,1,1,0
2021,182500,0,0,146,70,76
2021,182500,10,0,146,70,76
2021,182500,10,1,91,45,46
2021,182500,10,4,55,25,30
2021,182500,20,0,91,45,46
2021,182500,20,1,91,45,46
2021,182500,30,0,28,13,15
2021,182500,30,4,28,13,15
2021,182500,40,0,27,12,15
2021,182500,40,4,27,12,15
2021,182500,42,0,27,12,15
2021,182500,42,4,27,12,15
2021,182564,0,0,54,24,30
2021,182564,10,0,54,24,30
2021,182564,10,1,29,10,19
2021,182564,10,4,25,14,11
2021,182564,20,0,29,10,19
2021,182564,20,1,29,10,19
2021,182564,30,0,13,9,4
2021,182564,30,4,13,9,4
2021,182564,40,0,12,5,7
2021,182564,40,4,12,5,7
2021,182564,42,0,12,5,7
2021,182564,42,4,12,5,7
2021,182634,0,0,50,18,32
2021,182634,10,0,50,18,32
2021,182634,10,1,14,7,7
2021,182634,10,2,10,4,6
2021,182634,10,3,26,7,19
2021,182634,20,0,24,11,13
2021,182634,20,1,14,7,7
2021,182634,20,2,10,4,6
2021,182634,30,0,10,3,7
2021,182634,30,3,10,3,7
2021,182634,40,0,16,4,12
2021,182634,40,3,16,4,12
2021,182634,41,0,16,4,12
2021,182634,41,3,16,4,12
2021,182634,44,0,16,4,12
2021,182634,44,3,16,4,12
2021,182670,0,0,712,437,275
2021,182670,10,0,712,437,275
2021,182670,10,1,317,224,93
2021,182670,10,2,180,103,77
2021,182670,10,3,139,76,63
2021,182670,10,4,10,4,6
2021,182670,10,5,61,29,32
2021,182670,10,6,5,1,4
2021,182670,20,0,439,298,141
2021,182670,20,1,291,211,80
2021,182670,20,2,148,87,61
2021,182670,30,0,164,86,78
2021,182670,30,1,2,1,1
2021,182670,30,2,29,14,15
2021,182670,30,3,133,71,62
2021,182670,40,0,109,53,56
2021,182670,40,1,24,12,12
2021,182670,40,2,3,2,1
2021,182670,40,3,6,5,1
2021,182670,40,4,10,4,6
2021,182670,40,5,61,29,32
2021,182670,40,6,5,1,4
2021,182670,41,0,109,53,56
2021,182670,41,1,24,12,12
2021,182670,41,2,3,2,1
2021,182670,41,3,6,5,1
2021,182670,41,4,10,4,6
2021,182670,41,5,61,29,32
2021,182670,41,6,5,1,4
2021,182670,44,0,109,53,56
2021,182670,44,1,24,12,12
2021,182670,44,2,3,2,1
2021,182670,44,3,6,5,1
2021,182670,44,4,10,4,6
2021,182670,44,5,61,29,32
2021,182670,44,6,5,1,4
2021,182795,0,0,88,39,49
2021,182795,10,0,88,39,49
2021,182795,10,1,16,11,5
2021,182795,10,2,32,17,15
2021,182795,10,3,37,10,27
2021,182795,10,4,3,1,2
2021,182795,40,0,88,39,49
2021,182795,40,1,16,11,5
2021,182795,40,2,32,17,15
2021,182795,40,3,37,10,27
2021,182795,40,4,3,1,2
2021,182795,42,0,88,39,49
2021,182795,42,1,16,11,5
2021,182795,42,2,32,17,15
2021,182795,42,3,37,10,27
2021,182795,42,4,3,1,2
2021,182829,0,0,22,11,11
2021,182829,10,0,22,11,11
2021,182829,10,1,15,8,7
2021,182829,10,2,1,0,1
2021,182829,10,3,3,1,2
2021,182829,10,5,3,2,1
2021,182829,20,0,12,8,4
2021,182829,20,1,12,8,4
2021,182829,30,0,2,1,1
2021,182829,30,3,2,1,1
2021,182829,40,0,8,2,6
2021,182829,40,1,3,0,3
2021,182829,40,2,1,0,1
2021,182829,40,3,1,0,1
2021,182829,40,5,3,2,1
2021,182829,41,0,8,2,6
2021,182829,41,1,3,0,3
2021,182829,41,2,1,0,1
2021,182829,41,3,1,0,1
2021,182829,41,5,3,2,1
2021,182829,44,0,8,2,6
2021,182829,44,1,3,0,3
2021,182829,44,2,1,0,1
2021,182829,44,3,1,0,1
2021,182829,44,5,3,2,1
2021,182917,0,0,8,7,1
2021,182917,10,0,8,7,1
2021,182917,10,1,8,7,1
2021,182917,40,0,8,7,1
2021,182917,40,1,8,7,1
2021,182917,42,0,8,7,1
2021,182917,42,1,8,7,1
2021,182980,0,0,70,36,34
2021,182980,10,0,70,36,34
2021,182980,10,1,24,10,14
2021,182980,10,2,18,12,6
2021,182980,10,3,24,13,11
2021,182980,10,4,4,1,3
2021,182980,40,0,70,36,34
2021,182980,40,1,24,10,14
2021,182980,40,2,18,12,6
2021,182980,40,3,24,13,11
2021,182980,40,4,4,1,3
2021,182980,41,0,59,31,28
2021,182980,41,1,23,9,14
2021,182980,41,2,17,12,5
2021,182980,41,3,16,9,7
2021,182980,41,4,3,1,2
2021,182980,42,0,11,5,6
2021,182980,42,1,1,1,0
2021,182980,42,2,1,0,1
2021,182980,42,3,8,4,4
2021,182980,42,4,1,0,1
2021,182980,44,0,59,31,28
2021,182980,44,1,23,9,14
2021,182980,44,2,17,12,5
2021,182980,44,3,16,9,7
2021,182980,44,4,3,1,2
2021,183026,0,0,131,68,63
2021,183026,10,0,131,68,63
2021,183026,10,1,35,21,14
2021,183026,10,2,50,20,30
2021,183026,10,3,34,17,17
2021,183026,10,4,6,6,0
2021,183026,10,5,6,4,2
2021,183026,40,0,131,68,63
2021,183026,40,1,35,21,14
2021,183026,40,2,50,20,30
2021,183026,40,3,34,17,17
2021,183026,40,4,6,6,0
2021,183026,40,5,6,4,2
2021,183026,41,0,107,57,50
2021,183026,41,1,35,21,14
2021,183026,41,2,48,20,28
2021,183026,41,3,19,11,8
2021,183026,41,4,5,5,0
2021,183026,42,0,24,11,13
2021,183026,42,2,2,0,2
2021,183026,42,3,15,6,9
2021,183026,42,4,1,1,0
2021,183026,42,5,6,4,2
2021,183026,44,0,107,57,50
2021,183026,44,1,35,21,14
2021,183026,44,2,48,20,28
2021,183026,44,3,19,11,8
2021,183026,44,4,5,5,0
2021,183044,0,0,697,334,363
2021,183044,10,0,697,334,363
2021,183044,10,1,170,112,58
2021,183044,10,2,197,91,106
2021,183044,10,3,178,58,120
2021,183044,10,5,152,73,79
2021,183044,20,0,338,194,144
2021,183044,20,1,166,109,57
2021,183044,20,2,172,85,87
2021,183044,30,0,131,56,75
2021,183044,30,1,1,1,0
2021,183044,30,2,5,3,2
2021,183044,30,3,125,52,73
2021,183044,40,0,228,84,144
2021,183044,40,1,3,2,1
2021,183044,40,2,20,3,17
2021,183044,40,3,53,6,47
2021,183044,40,5,152,73,79
2021,183044,41,0,228,84,144
2021,183044,41,1,3,2,1
2021,183044,41,2,20,3,17
2021,183044,41,3,53,6,47
2021,183044,41,5,152,73,79
2021,183044,44,0,228,84,144
2021,183044,44,1,3,2,1
2021,183044,44,2,20,3,17
2021,183044,44,3,53,6,47
2021,183044,44,5,152,73,79
2021,183062,0,0,125,58,67
2021,183062,10,0,125,58,67
2021,183062,10,1,46,21,25
2021,183062,10,2,41,20,21
2021,183062,10,3,37,17,20
2021,183062,10,5,1,0,1
2021,183062,20,0,79,39,40
2021,183062,20,1,46,21,25
2021,183062,20,2,32,18,14
2021,183062,20,3,1,0,1
2021,183062,30,0,34,14,20
2021,183062,30,2,5,0,5
2021,183062,30,3,29,14,15
2021,183062,40,0,12,5,7
2021,183062,40,2,4,2,2
2021,183062,40,3,7,3,4
2021,183062,40,5,1,0,1
2021,183062,41,0,12,5,7
2021,183062,41,2,4,2,2
2021,183062,41,3,7,3,4
2021,183062,41,5,1,0,1
2021,183062,44,0,12,5,7
2021,183062,44,2,4,2,2
2021,183062,44,3,7,3,4
2021,183062,44,5,1,0,1
2021,183071,0,0,41,24,17
2021,183071,10,0,41,24,17
2021,183071,10,1,3,2,1
2021,183071,10,2,17,10,7
2021,183071,10,3,10,5,5
2021,183071,10,5,11,7,4
2021,183071,20,0,19,11,8
2021,183071,20,1,3,2,1
2021,183071,20,2,16,9,7
2021,183071,30,0,11,6,5
2021,183071,30,2,1,1,0
2021,183071,30,3,10,5,5
2021,183071,40,0,11,7,4
2021,183071,40,5,11,7,4
2021,183071,41,0,11,7,4
2021,183071,41,5,11,7,4
2021,183071,44,0,11,7,4
2021,183071,44,5,11,7,4
2021,183080,0,0,161,76,85
2021,183080,10,0,161,76,85
2021,183080,10,1,53,30,23
2021,183080,10,2,44,16,28
2021,183080,10,3,33,14,19
2021,183080,10,5,31,16,15
2021,183080,20,0,90,45,45
2021,183080,20,1,53,30,23
2021,183080,20,2,37,15,22
2021,183080,30,0,28,14,14
2021,183080,30,2,2,0,2
2021,183080,30,3,26,14,12
2021,183080,40,0,43,17,26
2021,183080,40,2,5,1,4
2021,183080,40,3,7,0,7
2021,183080,40,5,31,16,15
2021,183080,41,0,43,17,26
2021,183080,41,2,5,1,4
2021,183080,41,3,7,0,7
2021,183080,41,5,31,16,15
2021,183080,44,0,43,17,26
2021,183080,44,2,5,1,4
2021,183080,44,3,7,0,7
2021,183080,44,5,31,16,15
2021,183099,0,0,68,21,47
2021,183099,10,0,68,21,47
2021,183099,10,1,58,19,39
2021,183099,10,2,8,1,7
2021,183099,10,3,2,1,1
2021,183099,40,0,68,21,47
2021,183099,40,1,58,19,39
2021,183099,40,2,8,1,7
2021,183099,40,3,2,1,1
2021,183099,42,0,68,21,47
2021,183099,42,1,58,19,39
2021,183099,42,2,8,1,7
2021,183099,42,3,2,1,1
2021,183105,0,0,22,11,11
2021,183105,10,0,22,11,11
2021,183105,10,1,12,2,10
2021,183105,10,2,6,5,1
2021,183105,10,3,3,3,0
2021,183105,10,4,1,1,0
2021,183105,40,0,22,11,11
2021,183105,40,1,12,2,10
2021,183105,40,2,6,5,1
2021,183105,40,3,3,3,0
2021,183105,40,4,1,1,0
2021,183105,42,0,22,11,11
2021,183105,42,1,12,2,10
2021,183105,42,2,6,5,1
2021,183105,42,3,3,3,0
2021,183105,42,4,1,1,0
2021,183114,0,0,27,3,24
2021,183114,10,0,27,3,24
2021,183114,10,1,15,2,13
2021,183114,10,2,10,1,9
2021,183114,10,3,2,0,2
2021,183114,40,0,27,3,24
2021,183114,40,1,15,2,13
2021,183114,40,2,10,1,9
2021,183114,40,3,2,0,2
2021,183114,42,0,27,3,24
2021,183114,42,1,15,2,13
2021,183114,42,2,10,1,9
2021,183114,42,3,2,0,2
2021,183123,0,0,23,13,10
2021,183123,10,0,23,13,10
2021,183123,10,1,7,2,5
2021,183123,10,2,10,7,3
2021,183123,10,3,4,3,1
2021,183123,10,4,2,1,1
2021,183123,40,0,23,13,10
2021,183123,40,1,7,2,5
2021,183123,40,2,10,7,3
2021,183123,40,3,4,3,1
2021,183123,40,4,2,1,1
2021,183123,42,0,23,13,10
2021,183123,42,1,7,2,5
2021,183123,42,2,10,7,3
2021,183123,42,3,4,3,1
2021,183123,42,4,2,1,1
2021,183132,0,0,48,23,25
2021,183132,10,0,48,23,25
2021,183132,10,1,32,12,20
2021,183132,10,2,14,9,5
2021,183132,10,3,1,1,0
2021,183132,10,4,1,1,0
2021,183132,40,0,48,23,25
2021,183132,40,1,32,12,20
2021,183132,40,2,14,9,5
2021,183132,40,3,1,1,0
2021,183132,40,4,1,1,0
2021,183132,42,0,48,23,25
2021,183132,42,1,32,12,20
2021,183132,42,2,14,9,5
2021,183132,42,3,1,1,0
2021,183132,42,4,1,1,0
2021,183141,0,0,29,13,16
2021,183141,10,0,29,13,16
2021,183141,10,1,25,9,16
2021,183141,10,2,4,4,0
2021,183141,40,0,29,13,16
2021,183141,40,1,25,9,16
2021,183141,40,2,4,4,0
2021,183141,42,0,29,13,16
2021,183141,42,1,25,9,16
2021,183141,42,2,4,4,0
2021,183150,0,0,35,11,24
2021,183150,10,0,35,11,24
2021,183150,10,1,27,8,19
2021,183150,10,2,6,2,4
2021,183150,10,3,2,1,1
2021,183150,40,0,35,11,24
2021,183150,40,1,27,8,19
2021,183150,40,2,6,2,4
2021,183150,40,3,2,1,1
2021,183150,42,0,35,11,24
2021,183150,42,1,27,8,19
2021,183150,42,2,6,2,4
2021,183150,42,3,2,1,1
2021,183211,0,0,59,16,43
2021,183211,10,0,59,16,43
2021,183211,10,1,9,6,3
2021,183211,10,2,11,2,9
2021,183211,10,3,33,7,26
2021,183211,10,4,6,1,5
2021,183211,20,0,13,7,6
2021,183211,20,1,9,6,3
2021,183211,20,2,4,1,3
2021,183211,30,0,1,0,1
2021,183211,30,2,1,0,1
2021,183211,40,0,45,9,36
2021,183211,40,2,6,1,5
2021,183211,40,3,33,7,26
2021,183211,40,4,6,1,5
2021,183211,41,0,2,0,2
2021,183211,41,2,1,0,1
2021,183211,41,3,1,0,1
2021,183211,42,0,43,9,34
2021,183211,42,2,5,1,4
2021,183211,42,3,32,7,25
2021,183211,42,4,6,1,5
2021,183211,44,0,2,0,2
2021,183211,44,2,1,0,1
2021,183211,44,3,1,0,1
2021,183239,0,0,153,66,87
2021,183239,10,0,151,65,86
2021,183239,10,1,48,29,19
2021,183239,10,2,45,19,26
2021,183239,10,3,37,16,21
2021,183239,10,4,6,1,5
2021,183239,10,5,1,0,1
2021,183239,10,6,14,0,14
2021,183239,20,0,88,45,43
2021,183239,20,1,48,29,19
2021,183239,20,2,40,16,24
2021,183239,30,0,26,12,14
2021,183239,30,2,4,3,1
2021,183239,30,3,21,9,12
2021,183239,30,4,1,0,1
2021,183239,40,0,37,8,29
2021,183239,40,2,1,0,1
2021,183239,40,3,16,7,9
2021,183239,40,4,5,1,4
2021,183239,40,5,1,0,1
2021,183239,40,6,14,0,14
2021,183239,42,0,37,8,29
2021,183239,42,2,1,0,1
2021,183239,42,3,16,7,9
2021,183239,42,4,5,1,4
2021,183239,42,5,1,0,1
2021,183239,42,6,14,0,14
2021,183239,50,0,2,1,1
2021,183248,0,0,17,0,17
2021,183248,10,0,17,0,17
2021,183248,10,4,17,0,17
2021,183248,40,0,17,0,17
2021,183248,40,4,17,0,17
2021,183248,41,0,17,0,17
2021,183248,41,4,17,0,17
2021,183248,45,0,17,0,17
2021,183248,45,4,17,0,17
2021,183257,0,0,20,3,17
2021,183257,10,0,20,3,17
2021,183257,10,5,20,3,17
2021,183257,40,0,20,3,17
2021,183257,40,5,20,3,17
2021,183257,41,0,20,3,17
2021,183257,41,5,20,3,17
2021,183257,44,0,20,3,17
2021,183257,44,5,20,3,17
2021,183275,0,0,5,5,0
2021,183275,10,0,5,5,0
2021,183275,10,6,5,5,0
2021,183275,40,0,5,5,0
2021,183275,40,6,5,5,0
2021,183275,41,0,5,5,0
2021,183275,41,6,5,5,0
2021,183275,45,0,5,5,0
2021,183275,45,6,5,5,0
2021,183488,0,0,6,2,4
2021,183488,10,0,6,2,4
2021,183488,10,1,3,1,2
2021,183488,10,2,1,0,1
2021,183488,10,4,2,1,1
2021,183488,40,0,6,2,4
2021,183488,40,1,3,1,2
2021,183488,40,2,1,0,1
2021,183488,40,4,2,1,1
2021,183488,41,0,6,2,4
2021,183488,41,1,3,1,2
2021,183488,41,2,1,0,1
2021,183488,41,4,2,1,1
2021,183488,45,0,6,2,4
2021,183488,45,1,3,1,2
2021,183488,45,2,1,0,1
2021,183488,45,4,2,1,1
2021,183655,0,0,73,29,44
2021,183655,10,0,70,29,41
2021,183655,10,1,27,12,15
2021,183655,10,2,14,4,10
2021,183655,10,3,25,11,14
2021,183655,10,6,4,2,2
2021,183655,20,0,49,21,28
2021,183655,20,1,27,12,15
2021,183655,20,2,14,4,10
2021,183655,20,3,8,5,3
2021,183655,30,0,17,6,11
2021,183655,30,3,17,6,11
2021,183655,40,0,4,2,2
2021,183655,40,6,4,2,2
2021,183655,42,0,4,2,2
2021,183655,42,6,4,2,2
2021,183655,50,0,3,0,3
2021,183743,0,0,210,95,115
2021,183743,10,0,210,95,115
2021,183743,10,1,61,39,22
2021,183743,10,2,56,23,33
2021,183743,10,3,53,18,35
2021,183743,10,4,17,4,13
2021,183743,10,5,23,11,12
2021,183743,20,0,164,74,90
2021,183743,20,1,61,39,22
2021,183743,20,2,55,23,32
2021,183743,20,3,43,11,32
2021,183743,20,4,5,1,4
2021,183743,30,0,19,10,9
2021,183743,30,2,1,0,1
2021,183743,30,3,10,7,3
2021,183743,30,4,8,3,5
2021,183743,40,0,27,11,16
2021,183743,40,4,4,0,4
2021,183743,40,5,23,11,12
2021,183743,42,0,4,0,4
2021,183743,42,4,4,0,4
2021,183743,43,0,23,11,12
2021,183743,43,5,23,11,12
2021,183789,0,0,66,33,33
2021,183789,10,0,66,33,33
2021,183789,10,6,66,33,33
2021,183789,40,0,66,33,33
2021,183789,40,6,66,33,33
2021,183789,42,0,66,33,33
2021,183789,42,6,66,33,33
2021,183804,0,0,18,18,0
2021,183804,10,0,18,18,0
2021,183804,10,1,15,15,0
2021,183804,10,2,2,2,0
2021,183804,10,3,1,1,0
2021,183804,40,0,18,18,0
2021,183804,40,1,15,15,0
2021,183804,40,2,2,2,0
2021,183804,40,3,1,1,0
2021,183804,41,0,18,18,0
2021,183804,41,1,15,15,0
2021,183804,41,2,2,2,0
2021,183804,41,3,1,1,0
2021,183804,45,0,18,18,0
2021,183804,45,1,15,15,0
2021,183804,45,2,2,2,0
2021,183804,45,3,1,1,0
2021,183822,0,0,49,22,27
2021,183822,10,0,49,22,27
2021,183822,10,1,19,10,9
2021,183822,10,2,17,8,9
2021,183822,10,3,9,3,6
2021,183822,10,4,4,1,3
2021,183822,20,0,33,16,17
2021,183822,20,1,19,10,9
2021,183822,20,2,14,6,8
2021,183822,30,0,11,4,7
2021,183822,30,2,3,2,1
2021,183822,30,3,8,2,6
2021,183822,40,0,5,2,3
2021,183822,40,3,1,1,0
2021,183822,40,4,4,1,3
2021,183822,41,0,1,1,0
2021,183822,41,3,1,1,0
2021,183822,42,0,4,1,3
2021,183822,42,4,4,1,3
2021,183822,45,0,1,1,0
2021,183822,45,3,1,1,0
2021,183859,0,0,191,80,111
2021,183859,10,0,191,80,111
2021,183859,10,1,79,36,43
2021,183859,10,2,42,13,29
2021,183859,10,3,41,21,20
2021,183859,10,4,29,10,19
2021,183859,20,0,158,67,91
2021,183859,20,1,79,36,43
2021,183859,20,2,42,13,29
2021,183859,20,3,37,18,19
2021,183859,30,0,29,10,19
2021,183859,30,3,3,2,1
2021,183859,30,4,26,8,18
2021,183859,40,0,4,3,1
2021,183859,40,3,1,1,0
2021,183859,40,4,3,2,1
2021,183859,42,0,2,2,0
2021,183859,42,3,1,1,0
2021,183859,42,4,1,1,0
2021,183859,43,0,2,1,1
2021,183859,43,4,2,1,1
2021,183877,0,0,65,26,39
2021,183877,10,0,65,26,39
2021,183877,10,1,2,1,1
2021,183877,10,2,3,0,3
2021,183877,10,3,34,14,20
2021,183877,10,4,26,11,15
2021,183877,20,0,41,16,25
2021,183877,20,1,2,1,1
2021,183877,20,2,3,0,3
2021,183877,20,3,34,14,20
2021,183877,20,4,2,1,1
2021,183877,30,0,24,10,14
2021,183877,30,4,24,10,14
2021,183910,0,0,76,30,46
2021,183910,10,0,76,30,46
2021,183910,10,1,36,17,19
2021,183910,10,2,16,4,12
2021,183910,10,3,19,9,10
2021,183910,10,4,5,0,5
2021,183910,20,0,46,20,26
2021,183910,20,1,36,17,19
2021,183910,20,2,8,3,5
2021,183910,20,3,2,0,2
2021,183910,30,0,26,10,16
2021,183910,30,2,8,1,7
2021,183910,30,3,17,9,8
2021,183910,30,4,1,0,1
2021,183910,40,0,4,0,4
2021,183910,40,4,4,0,4
2021,183910,42,0,4,0,4
2021,183910,42,4,4,0,4
2021,183938,0,0,113,49,64
2021,183938,10,0,97,39,58
2021,183938,10,1,26,15,11
2021,183938,10,2,14,6,8
2021,183938,10,3,57,18,39
2021,183938,20,0,87,35,52
2021,183938,20,1,26,15,11
2021,183938,20,2,13,6,7
2021,183938,20,3,48,14,34
2021,183938,30,0,10,4,6
2021,183938,30,2,1,0,1
2021,183938,30,3,9,4,5
2021,183938,50,0,16,10,6
2021,183974,0,0,64,29,35
2021,183974,10,0,64,29,35
2021,183974,10,1,9,3,6
2021,183974,10,2,18,9,9
2021,183974,10,3,35,16,19
2021,183974,10,4,2,1,1
2021,183974,20,0,14,7,7
2021,183974,20,1,5,2,3
2021,183974,20,2,9,5,4
2021,183974,30,0,8,3,5
2021,183974,30,3,8,3,5
2021,183974,40,0,42,19,23
2021,183974,40,1,4,1,3
2021,183974,40,2,9,4,5
2021,183974,40,3,27,13,14
2021,183974,40,4,2,1,1
2021,183974,41,0,32,15,17
2021,183974,41,1,4,1,3
2021,183974,41,2,8,4,4
2021,183974,41,3,20,10,10
2021,183974,42,0,10,4,6
2021,183974,42,2,1,0,1
2021,183974,42,3,7,3,4
2021,183974,42,4,2,1,1
2021,183974,44,0,32,15,17
2021,183974,44,1,4,1,3
2021,183974,44,2,8,4,4
2021,183974,44,3,20,10,10
2021,184180,0,0,142,65,77
2021,184180,10,0,142,65,77
2021,184180,10,1,36,20,16
2021,184180,10,2,44,20,24
2021,184180,10,3,52,20,32
2021,184180,10,4,10,5,5
2021,184180,20,0,102,49,53
2021,184180,20,1,36,20,16
2021,184180,20,2,42,20,22
2021,184180,20,3,24,9,15
2021,184180,30,0,39,15,24
2021,184180,30,2,2,0,2
2021,184180,30,3,27,10,17
2021,184180,30,4,10,5,5
2021,184180,40,0,1,1,0
2021,184180,40,3,1,1,0
2021,184180,43,0,1,1,0
2021,184180,43,3,1,1,0
2021,184205,0,0,39,16,23
2021,184205,10,0,39,16,23
2021,184205,10,1,4,2,2
2021,184205,10,2,11,3,8
2021,184205,10,3,6,4,2
2021,184205,10,4,14,4,10
2021,184205,10,6,4,3,1
2021,184205,20,0,23,9,14
2021,184205,20,1,4,2,2
2021,184205,20,2,11,3,8
2021,184205,20,3,5,3,2
2021,184205,20,4,3,1,2
2021,184205,30,0,12,4,8
2021,184205,30,3,1,1,0
2021,184205,30,4,11,3,8
2021,184205,40,0,4,3,1
2021,184205,40,6,4,3,1
2021,184205,42,0,4,3,1
2021,184205,42,6,4,3,1
2021,184348,0,0,131,66,65
2021,184348,10,0,131,66,65
2021,184348,10,1,64,31,33
2021,184348,10,2,39,24,15
2021,184348,10,3,27,11,16
2021,184348,10,5,1,0,1
2021,184348,20,0,94,51,43
2021,184348,20,1,56,28,28
2021,184348,20,2,37,23,14
2021,184348,20,3,1,0,1
2021,184348,30,0,14,5,9
2021,184348,30,1,1,1,0
2021,184348,30,2,1,0,1
2021,184348,30,3,12,4,8
2021,184348,40,0,23,10,13
2021,184348,40,1,7,2,5
2021,184348,40,2,1,1,0
2021,184348,40,3,14,7,7
2021,184348,40,5,1,0,1
2021,184348,41,0,15,6,9
2021,184348,41,1,7,2,5
2021,184348,41,2,1,1,0
2021,184348,41,3,7,3,4
2021,184348,42,0,8,4,4
2021,184348,42,3,7,4,3
2021,184348,42,5,1,0,1
2021,184348,44,0,15,6,9
2021,184348,44,1,7,2,5
2021,184348,44,2,1,1,0
2021,184348,44,3,7,3,4
2021,184481,0,0,88,44,44
2021,184481,10,0,88,44,44
2021,184481,10,1,17,11,6
2021,184481,10,2,23,11,12
2021,184481,10,3,29,14,15
2021,184481,10,4,17,8,9
2021,184481,10,5,2,0,2
2021,184481,20,0,75,41,34
2021,184481,20,1,17,11,6
2021,184481,20,2,23,11,12
2021,184481,20,3,24,13,11
2021,184481,20,4,11,6,5
2021,184481,30,0,11,3,8
2021,184481,30,3,5,1,4
2021,184481,30,4,6,2,4
2021,184481,40,0,2,0,2
2021,184481,40,5,2,0,2
2021,184481,42,0,2,0,2
2021,184481,42,5,2,0,2
2021,184603,0,0,139,78,61
2021,184603,10,0,139,78,61
2021,184603,10,1,43,30,13
2021,184603,10,2,32,17,15
2021,184603,10,3,35,18,17
2021,184603,10,4,4,0,4
2021,184603,10,5,25,13,12
2021,184603,20,0,68,44,24
2021,184603,20,1,42,29,13
2021,184603,20,2,23,12,11
2021,184603,20,3,3,3,0
2021,184603,30,0,34,20,14
2021,184603,30,2,8,5,3
2021,184603,30,3,26,15,11
2021,184603,40,0,37,14,23
2021,184603,40,1,1,1,0
2021,184603,40,2,1,0,1
2021,184603,40,3,6,0,6
2021,184603,40,4,4,0,4
2021,184603,40,5,25,13,12
2021,184603,42,0,37,14,23
2021,184603,42,1,1,1,0
2021,184603,42,2,1,0,1
2021,184603,42,3,6,0,6
2021,184603,42,4,4,0,4
2021,184603,42,5,25,13,12
2021,184612,0,0,87,28,59
2021,184612,10,0,87,28,59
2021,184612,10,1,19,9,10
2021,184612,10,2,23,13,10
2021,184612,10,3,27,6,21
2021,184612,10,4,18,0,18
2021,184612,40,0,87,28,59
2021,184612,40,1,19,9,10
2021,184612,40,2,23,13,10
2021,184612,40,3,27,6,21
2021,184612,40,4,18,0,18
2021,184612,42,0,87,28,59
2021,184612,42,1,19,9,10
2021,184612,42,2,23,13,10
2021,184612,42,3,27,6,21
2021,184612,42,4,18,0,18
2021,184694,0,0,164,76,88
2021,184694,10,0,164,76,88
2021,184694,10,1,46,30,16
2021,184694,10,2,43,20,23
2021,184694,10,3,53,18,35
2021,184694,10,4,1,0,1
2021,184694,10,5,21,8,13
2021,184694,20,0,78,48,30
2021,184694,20,1,45,30,15
2021,184694,20,2,31,16,15
2021,184694,20,3,2,2,0
2021,184694,30,0,43,16,27
2021,184694,30,1,1,0,1
2021,184694,30,2,9,3,6
2021,184694,30,3,33,13,20
2021,184694,40,0,43,12,31
2021,184694,40,2,3,1,2
2021,184694,40,3,18,3,15
2021,184694,40,4,1,0,1
2021,184694,40,5,21,8,13
2021,184694,42,0,43,12,31
2021,184694,42,2,3,1,2
2021,184694,42,3,18,3,15
2021,184694,42,4,1,0,1
2021,184694,42,5,21,8,13
2021,184773,0,0,92,30,62
2021,184773,10,0,92,30,62
2021,184773,10,1,24,9,15
2021,184773,10,2,27,7,20
2021,184773,10,3,35,12,23
2021,184773,10,4,1,0,1
2021,184773,10,5,5,2,3
2021,184773,20,0,51,17,34
2021,184773,20,1,24,9,15
2021,184773,20,2,26,7,19
2021,184773,20,3,1,1,0
2021,184773,30,0,34,10,24
2021,184773,30,2,1,0,1
2021,184773,30,3,33,10,23
2021,184773,40,0,7,3,4
2021,184773,40,3,1,1,0
2021,184773,40,4,1,0,1
2021,184773,40,5,5,2,3
2021,184773,42,0,7,3,4
2021,184773,42,3,1,1,0
2021,184773,42,4,1,0,1
2021,184773,42,5,5,2,3
2021,184782,0,0,831,424,407
2021,184782,10,0,831,424,407
2021,184782,10,1,146,96,50
2021,184782,10,2,194,95,99
2021,184782,10,3,245,128,117
2021,184782,10,4,60,25,35
2021,184782,10,5,132,56,76
2021,184782,10,6,54,24,30
2021,184782,20,0,320,179,141
2021,184782,20,1,131,86,45
2021,184782,20,2,149,72,77
2021,184782,20,3,28,17,11
2021,184782,20,4,12,4,8
2021,184782,30,0,165,92,73
2021,184782,30,1,3,1,2
2021,184782,30,2,20,13,7
2021,184782,30,3,132,73,59
2021,184782,30,4,4,3,1
2021,184782,30,5,1,1,0
2021,184782,30,6,5,1,4
2021,184782,40,0,346,153,193
2021,184782,40,1,12,9,3
2021,184782,40,2,25,10,15
2021,184782,40,3,85,38,47
2021,184782,40,4,44,18,26
2021,184782,40,5,131,55,76
2021,184782,40,6,49,23,26
2021,184782,41,0,142,64,78
2021,184782,41,1,2,0,2
2021,184782,41,2,3,2,1
2021,184782,41,3,4,3,1
2021,184782,41,4,2,2,0
2021,184782,41,5,128,54,74
2021,184782,41,6,3,3,0
2021,184782,42,0,194,87,107
2021,184782,42,1,8,8,0
2021,184782,42,2,20,8,12
2021,184782,42,3,76,34,42
2021,184782,42,4,42,16,26
2021,184782,42,5,3,1,2
2021,184782,42,6,45,20,25
2021,184782,43,0,10,2,8
2021,184782,43,1,2,1,1
2021,184782,43,2,2,0,2
2021,184782,43,3,5,1,4
2021,184782,43,6,1,0,1
2021,184782,44,0,142,64,78
2021,184782,44,1,2,0,2
2021,184782,44,2,3,2,1
2021,184782,44,3,4,3,1
2021,184782,44,4,2,2,0
2021,184782,44,5,128,54,74
2021,184782,44,6,3,3,0
2021,184791,0,0,75,24,51
2021,184791,10,0,73,22,51
2021,184791,10,1,6,0,6
2021,184791,10,2,17,6,11
2021,184791,10,3,29,14,15
2021,184791,10,4,21,2,19
2021,184791,20,0,50,19,31
2021,184791,20,1,6,0,6
2021,184791,20,2,17,6,11
2021,184791,20,3,27,13,14
2021,184791,30,0,23,3,20
2021,184791,30,3,2,1,1
2021,184791,30,4,21,2,19
2021,184791,50,0,2,2,0
2021,184959,0,0,13,6,7
2021,184959,10,0,13,6,7
2021,184959,10,1,3,3,0
2021,184959,10,2,2,1,1
2021,184959,10,4,8,2,6
2021,184959,40,0,13,6,7
2021,184959,40,1,3,3,0
2021,184959,40,2,2,1,1
2021,184959,40,4,8,2,6
2021,184959,41,0,13,6,7
2021,184959,41,1,3,3,0
2021,184959,41,2,2,1,1
2021,184959,41,4,8,2,6
2021,184959,45,0,13,6,7
2021,184959,45,1,3,3,0
2021,184959,45,2,2,1,1
2021,184959,45,4,8,2,6
2021,184995,0,0,95,48,47
2021,184995,10,0,95,48,47
2021,184995,10,1,15,9,6
2021,184995,10,2,9,3,6
2021,184995,10,3,35,19,16
2021,184995,10,4,26,14,12
2021,184995,10,5,10,3,7
2021,184995,20,0,59,31,28
2021,184995,20,1,15,9,6
2021,184995,20,2,9,3,6
2021,184995,20,3,35,19,16
2021,184995,30,0,15,5,10
2021,184995,30,4,15,5,10
2021,184995,40,0,21,12,9
2021,184995,40,4,11,9,2
2021,184995,40,5,10,3,7
2021,184995,42,0,21,12,9
2021,184995,42,4,11,9,2
2021,184995,42,5,10,3,7
2021,185129,0,0,237,123,114
2021,185129,10,0,237,123,114
2021,185129,10,1,80,38,42
2021,185129,10,2,88,51,37
2021,185129,10,3,69,34,35
2021,185129,20,0,176,87,89
2021,185129,20,1,78,37,41
2021,185129,20,2,80,46,34
2021,185129,20,3,18,4,14
2021,185129,30,0,56,31,25
2021,185129,30,1,2,1,1
2021,185129,30,2,7,4,3
2021,185129,30,3,47,26,21
2021,185129,40,0,5,5,0
2021,185129,40,2,1,1,0
2021,185129,40,3,4,4,0
2021,185129,41,0,5,5,0
2021,185129,41,2,1,1,0
2021,185129,41,3,4,4,0
2021,185129,45,0,5,5,0
2021,185129,45,2,1,1,0
2021,185129,45,3,4,4,0
2021,185262,0,0,353,148,205
2021,185262,10,0,353,148,205
2021,185262,10,1,44,20,24
2021,185262,10,2,64,33,31
2021,185262,10,3,126,60,66
2021,185262,10,5,118,35,83
2021,185262,10,6,1,0,1
2021,185262,20,0,156,73,83
2021,185262,20,1,44,20,24
2021,185262,20,2,63,33,30
2021,185262,20,3,49,20,29
2021,185262,30,0,78,40,38
2021,185262,30,2,1,0,1
2021,185262,30,3,77,40,37
2021,185262,40,0,119,35,84
2021,185262,40,5,118,35,83
2021,185262,40,6,1,0,1
2021,185262,41,0,25,6,19
2021,185262,41,5,25,6,19
2021,185262,42,0,94,29,65
2021,185262,42,5,93,29,64
2021,185262,42,6,1,0,1
2021,185262,44,0,25,6,19
2021,185262,44,5,25,6,19
2021,185509,0,0,103,53,50
2021,185509,10,0,103,53,50
2021,185509,10,1,54,29,25
2021,185509,10,2,22,8,14
2021,185509,10,3,25,15,10
2021,185509,10,4,2,1,1
2021,185509,20,0,92,44,48
2021,185509,20,1,54,29,25
2021,185509,20,2,22,8,14
2021,185509,20,3,15,7,8
2021,185509,20,4,1,0,1
2021,185509,30,0,11,9,2
2021,185509,30,3,10,8,2
2021,185509,30,4,1,1,0
2021,185536,0,0,134,65,69
2021,185536,10,0,134,65,69
2021,185536,10,1,40,17,23
2021,185536,10,2,28,13,15
2021,185536,10,3,38,22,16
2021,185536,10,4,28,13,15
2021,185536,20,0,106,52,54
2021,185536,20,1,40,17,23
2021,185536,20,2,28,13,15
2021,185536,20,3,38,22,16
2021,185536,30,0,27,12,15
2021,185536,30,4,27,12,15
2021,185536,40,0,1,1,0
2021,185536,40,4,1,1,0
2021,185536,43,0,1,1,0
2021,185536,43,4,1,1,0
2021,185572,0,0,297,131,166
2021,185572,10,0,297,131,166
2021,185572,10,1,43,24,19
2021,185572,10,2,101,44,57
2021,185572,10,3,53,27,26
2021,185572,10,4,10,5,5
2021,185572,10,5,90,31,59
2021,185572,20,0,144,68,76
2021,185572,20,1,43,24,19
2021,185572,20,2,101,44,57
2021,185572,30,0,53,27,26
2021,185572,30,3,53,27,26
2021,185572,40,0,100,36,64
2021,185572,40,4,10,5,5
2021,185572,40,5,90,31,59
2021,185572,41,0,90,31,59
2021,185572,41,5,90,31,59
2021,185572,42,0,10,5,5
2021,185572,42,4,10,5,5
2021,185572,44,0,90,31,59
2021,185572,44,5,90,31,59
2021,185590,0,0,614,306,308
2021,185590,10,0,614,306,308
2021,185590,10,1,200,99,101
2021,185590,10,2,217,120,97
2021,185590,10,3,111,50,61
2021,185590,10,6,86,37,49
2021,185590,20,0,425,219,206
2021,185590,20,1,198,97,101
2021,185590,20,2,210,116,94
2021,185590,20,3,17,6,11
2021,185590,30,0,103,50,53
2021,185590,30,1,2,2,0
2021,185590,30,2,7,4,3
2021,185590,30,3,94,44,50
2021,185590,40,0,86,37,49
2021,185590,40,6,86,37,49
2021,185590,41,0,60,24,36
2021,185590,41,6,60,24,36
2021,185590,42,0,26,13,13
2021,185590,42,6,26,13,13
2021,185590,44,0,60,24,36
2021,185590,44,6,60,24,36
2021,185721,0,0,8,3,5
2021,185721,10,0,8,3,5
2021,185721,10,2,1,1,0
2021,185721,10,4,7,2,5
2021,185721,40,0,8,3,5
2021,185721,40,2,1,1,0
2021,185721,40,4,7,2,5
2021,185721,41,0,8,3,5
2021,185721,41,2,1,1,0
2021,185721,41,4,7,2,5
2021,185721,45,0,8,3,5
2021,185721,45,2,1,1,0
2021,185721,45,4,7,2,5
2021,185758,0,0,8,5,3
2021,185758,10,0,8,5,3
2021,185758,10,1,1,0,1
2021,185758,10,2,4,3,1
2021,185758,10,3,3,2,1
2021,185758,20,0,4,2,2
2021,185758,20,1,1,0,1
2021,185758,20,2,3,2,1
2021,185758,30,0,3,2,1
2021,185758,30,3,3,2,1
2021,185758,40,0,1,1,0
2021,185758,40,2,1,1,0
2021,185758,42,0,1,1,0
2021,185758,42,2,1,1,0
2021,185828,0,0,468,346,122
2021,185828,10,0,454,340,114
2021,185828,10,1,135,118,17
2021,185828,10,2,102,76,26
2021,185828,10,3,87,58,29
2021,185828,10,5,130,88,42
2021,185828,20,0,227,185,42
2021,185828,20,1,134,117,17
2021,185828,20,2,93,68,25
2021,185828,30,0,96,67,29
2021,185828,30,1,1,1,0
2021,185828,30,2,9,8,1
2021,185828,30,3,86,58,28
2021,185828,40,0,131,88,43
2021,185828,40,3,1,0,1
2021,185828,40,5,130,88,42
2021,185828,41,0,44,29,15
2021,185828,41,5,44,29,15
2021,185828,42,0,86,59,27
2021,185828,42,3,1,0,1
2021,185828,42,5,85,59,26
2021,185828,43,0,1,0,1
2021,185828,43,5,1,0,1
2021,185828,44,0,44,29,15
2021,185828,44,5,44,29,15
2021,185828,50,0,14,6,8
2021,185873,0,0,112,51,61
2021,185873,10,0,36,15,21
2021,185873,10,1,9,2,7
2021,185873,10,2,10,5,5
2021,185873,10,3,10,4,6
2021,185873,10,4,7,4,3
2021,185873,20,0,35,15,20
2021,185873,20,1,9,2,7
2021,185873,20,2,10,5,5
2021,185873,20,3,10,4,6
2021,185873,20,4,6,4,2
2021,185873,30,0,1,0,1
2021,185873,30,4,1,0,1
2021,185873,50,0,76,36,40
2021,186034,0,0,82,31,51
2021,186034,10,0,82,31,51
2021,186034,10,1,14,8,6
2021,186034,10,2,22,7,15
2021,186034,10,3,31,13,18
2021,186034,10,4,15,3,12
2021,186034,20,0,69,28,41
2021,186034,20,1,14,8,6
2021,186034,20,2,22,7,15
2021,186034,20,3,31,13,18
2021,186034,20,4,2,0,2
2021,186034,30,0,13,3,10
2021,186034,30,4,13,3,10
2021,186122,0,0,37,25,12
2021,186122,10,0,37,25,12
2021,186122,10,1,18,15,3
2021,186122,10,2,14,7,7
2021,186122,10,3,2,1,1
2021,186122,10,5,3,2,1
2021,186122,20,0,32,22,10
2021,186122,20,1,18,15,3
2021,186122,20,2,14,7,7
2021,186122,30,0,2,1,1
2021,186122,30,3,2,1,1
2021,186122,40,0,3,2,1
2021,186122,40,5,3,2,1
2021,186122,42,0,3,2,1
2021,186122,42,5,3,2,1
2021,186131,0,0,1006,633,373
2021,186131,10,0,1006,633,373
2021,186131,10,1,503,363,140
2021,186131,10,2,115,69,46
2021,186131,10,3,190,108,82
2021,186131,10,4,16,12,4
2021,186131,10,5,182,81,101
2021,186131,20,0,618,432,186
2021,186131,20,1,503,363,140
2021,186131,20,2,115,69,46
2021,186131,30,0,190,108,82
2021,186131,30,3,190,108,82
2021,186131,40,0,198,93,105
2021,186131,40,4,16,12,4
2021,186131,40,5,182,81,101
2021,186131,41,0,61,26,35
2021,186131,41,4,2,1,1
2021,186131,41,5,59,25,34
2021,186131,42,0,137,67,70
2021,186131,42,4,14,11,3
2021,186131,42,5,123,56,67
2021,186131,44,0,61,26,35
2021,186131,44,4,2,1,1
2021,186131,44,5,59,25,34
2021,186186,0,0,19,19,0
2021,186186,10,0,19,19,0
2021,186186,10,4,19,19,0
2021,186186,40,0,19,19,0
2021,186186,40,4,19,19,0
2021,186186,42,0,19,19,0
2021,186186,42,4,19,19,0
2021,186201,0,0,207,96,111
2021,186201,10,0,207,96,111
2021,186201,10,1,69,35,34
2021,186201,10,2,88,39,49
2021,186201,10,3,49,22,27
2021,186201,10,4,1,0,1
2021,186201,20,0,164,79,85
2021,186201,20,1,69,35,34
2021,186201,20,2,86,38,48
2021,186201,20,3,9,6,3
2021,186201,30,0,35,14,21
2021,186201,30,2,1,1,0
2021,186201,30,3,34,13,21
2021,186201,40,0,8,3,5
2021,186201,40,2,1,0,1
2021,186201,40,3,6,3,3
2021,186201,40,4,1,0,1
2021,186201,41,0,5,2,3
2021,186201,41,3,4,2,2
2021,186201,41,4,1,0,1
2021,186201,42,0,3,1,2
2021,186201,42,2,1,0,1
2021,186201,42,3,2,1,1
2021,186201,44,0,5,2,3
2021,186201,44,3,4,2,2
2021,186201,44,4,1,0,1
2021,186283,0,0,185,93,92
2021,186283,10,0,185,93,92
2021,186283,10,1,69,41,28
2021,186283,10,2,67,31,36
2021,186283,10,3,36,16,20
2021,186283,10,5,11,4,7
2021,186283,10,6,2,1,1
2021,186283,20,0,135,72,63
2021,186283,20,1,67,41,26
2021,186283,20,2,67,31,36
2021,186283,20,3,1,0,1
2021,186283,30,0,34,15,19
2021,186283,30,1,2,0,2
2021,186283,30,3,31,14,17
2021,186283,30,6,1,1,0
2021,186283,40,0,16,6,10
2021,186283,40,3,4,2,2
2021,186283,40,5,11,4,7
2021,186283,40,6,1,0,1
2021,186283,41,0,10,3,7
2021,186283,41,5,9,3,6
2021,186283,41,6,1,0,1
2021,186283,42,0,3,1,2
2021,186283,42,3,3,1,2
2021,186283,43,0,3,2,1
2021,186283,43,3,1,1,0
2021,186283,43,5,2,1,1
2021,186283,44,0,8,2,6
2021,186283,44,5,7,2,5
2021,186283,44,6,1,0,1
2021,186283,45,0,2,1,1
2021,186283,45,5,2,1,1
2021,186371,0,0,305,161,144
2021,186371,10,0,305,161,144
2021,186371,10,1,111,66,45
2021,186371,10,2,100,52,48
2021,186371,10,3,88,38,50
2021,186371,10,4,5,4,1
2021,186371,10,5,1,1,0
2021,186371,20,0,176,106,70
2021,186371,20,1,99,64,35
2021,186371,20,2,77,42,35
2021,186371,30,0,58,22,36
2021,186371,30,1,2,0,2
2021,186371,30,2,5,4,1
2021,186371,30,3,51,18,33
2021,186371,40,0,71,33,38
2021,186371,40,1,10,2,8
2021,186371,40,2,18,6,12
2021,186371,40,3,37,20,17
2021,186371,40,4,5,4,1
2021,186371,40,5,1,1,0
2021,186371,41,0,71,33,38
2021,186371,41,1,10,2,8
2021,186371,41,2,18,6,12
2021,186371,41,3,37,20,17
2021,186371,41,4,5,4,1
2021,186371,41,5,1,1,0
2021,186371,44,0,71,33,38
2021,186371,44,1,10,2,8
2021,186371,44,2,18,6,12
2021,186371,44,3,37,20,17
2021,186371,44,4,5,4,1
2021,186371,44,5,1,1,0
2021,186380,0,0,3435,1829,1606
2021,186380,10,0,3435,1829,1606
2021,186380,10,1,1103,758,345
2021,186380,10,2,850,427,423
2021,186380,10,3,1243,563,680
2021,186380,10,4,169,64,105
2021,186380,10,5,70,17,53
2021,186380,20,0,1263,807,456
2021,186380,20,1,877,612,265
2021,186380,20,2,386,195,191
2021,186380,30,0,400,212,188
2021,186380,30,1,30,22,8
2021,186380,30,2,40,20,20
2021,186380,30,3,330,170,160
2021,186380,40,0,1772,810,962
2021,186380,40,1,196,124,72
2021,186380,40,2,424,212,212
2021,186380,40,3,913,393,520
2021,186380,40,4,169,64,105
2021,186380,40,5,70,17,53
2021,186380,41,0,1772,810,962
2021,186380,41,1,196,124,72
2021,186380,41,2,424,212,212
2021,186380,41,3,913,393,520
2021,186380,41,4,169,64,105
2021,186380,41,5,70,17,53
2021,186380,44,0,1772,810,962
2021,186380,44,1,196,124,72
2021,186380,44,2,424,212,212
2021,186380,44,3,913,393,520
2021,186380,44,4,169,64,105
2021,186380,44,5,70,17,53
2021,186399,0,0,584,350,234
2021,186399,10,0,584,350,234
2021,186399,10,1,203,134,69
2021,186399,10,2,160,94,66
2021,186399,10,3,191,112,79
2021,186399,10,4,26,8,18
2021,186399,10,5,4,2,2
2021,186399,20,0,301,194,107
2021,186399,20,1,183,125,58
2021,186399,20,2,118,69,49
2021,186399,30,0,100,55,45
2021,186399,30,1,1,0,1
2021,186399,30,2,4,1,3
2021,186399,30,3,95,54,41
2021,186399,40,0,183,101,82
2021,186399,40,1,19,9,10
2021,186399,40,2,38,24,14
2021,186399,40,3,96,58,38
2021,186399,40,4,26,8,18
2021,186399,40,5,4,2,2
2021,186399,41,0,183,101,82
2021,186399,41,1,19,9,10
2021,186399,41,2,38,24,14
2021,186399,41,3,96,58,38
2021,186399,41,4,26,8,18
2021,186399,41,5,4,2,2
2021,186399,44,0,183,101,82
2021,186399,44,1,19,9,10
2021,186399,44,2,38,24,14
2021,186399,44,3,96,58,38
2021,186399,44,4,26,8,18
2021,186399,44,5,4,2,2
2021,186432,0,0,104,49,55
2021,186432,10,0,104,49,55
2021,186432,10,1,26,15,11
2021,186432,10,2,35,16,19
2021,186432,10,3,27,10,17
2021,186432,10,4,8,4,4
2021,186432,10,5,8,4,4
2021,186432,20,0,64,33,31
2021,186432,20,1,26,15,11
2021,186432,20,2,33,15,18
2021,186432,20,3,4,3,1
2021,186432,20,5,1,0,1
2021,186432,30,0,22,8,14
2021,186432,30,2,2,1,1
2021,186432,30,3,19,7,12
2021,186432,30,4,1,0,1
2021,186432,40,0,18,8,10
2021,186432,40,3,4,0,4
2021,186432,40,4,7,4,3
2021,186432,40,5,7,4,3
2021,186432,42,0,18,8,10
2021,186432,42,3,4,0,4
2021,186432,42,4,7,4,3
2021,186432,42,5,7,4,3
2021,186469,0,0,15,5,10
2021,186469,10,0,15,5,10
2021,186469,10,2,7,3,4
2021,186469,10,3,4,1,3
2021,186469,10,4,3,0,3
2021,186469,10,6,1,1,0
2021,186469,20,0,11,4,7
2021,186469,20,2,7,3,4
2021,186469,20,3,4,1,3
2021,186469,30,0,3,0,3
2021,186469,30,4,3,0,3
2021,186469,40,0,1,1,0
2021,186469,40,6,1,1,0
2021,186469,42,0,1,1,0
2021,186469,42,6,1,1,0
2021,186584,0,0,461,231,230
2021,186584,10,0,461,231,230
2021,186584,10,1,123,70,53
2021,186584,10,2,135,72,63
2021,186584,10,3,85,28,57
2021,186584,10,4,17,2,15
2021,186584,10,5,17,9,8
2021,186584,10,6,84,50,34
2021,186584,20,0,220,121,99
2021,186584,20,1,116,66,50
2021,186584,20,2,102,54,48
2021,186584,20,3,2,1,1
2021,186584,30,0,53,25,28
2021,186584,30,1,1,0,1
2021,186584,30,2,6,3,3
2021,186584,30,3,46,22,24
2021,186584,40,0,188,85,103
2021,186584,40,1,6,4,2
2021,186584,40,2,27,15,12
2021,186584,40,3,37,5,32
2021,186584,40,4,17,2,15
2021,186584,40,5,17,9,8
2021,186584,40,6,84,50,34
2021,186584,41,0,88,41,47
2021,186584,41,1,6,4,2
2021,186584,41,2,20,13,7
2021,186584,41,3,20,4,16
2021,186584,41,4,13,2,11
2021,186584,41,6,29,18,11
2021,186584,42,0,100,44,56
2021,186584,42,2,7,2,5
2021,186584,42,3,17,1,16
2021,186584,42,4,4,0,4
2021,186584,42,5,17,9,8
2021,186584,42,6,55,32,23
2021,186584,44,0,30,19,11
2021,186584,44,1,1,1,0
2021,186584,44,6,29,18,11
2021,186584,45,0,58,22,36
2021,186584,45,1,5,3,2
2021,186584,45,2,20,13,7
2021,186584,45,3,20,4,16
2021,186584,45,4,13,2,11
2021,186618,0,0,57,12,45
2021,186618,10,0,57,12,45
2021,186618,10,1,11,5,6
2021,186618,10,2,9,2,7
2021,186618,10,3,30,5,25
2021,186618,10,4,7,0,7
2021,186618,20,0,15,5,10
2021,186618,20,1,11,5,6
2021,186618,20,2,3,0,3
2021,186618,20,3,1,0,1
2021,186618,30,0,10,2,8
2021,186618,30,2,5,1,4
2021,186618,30,3,5,1,4
2021,186618,40,0,32,5,27
2021,186618,40,2,1,1,0
2021,186618,40,3,24,4,20
2021,186618,40,4,7,0,7
2021,186618,42,0,32,5,27
2021,186618,42,2,1,1,0
2021,186618,42,3,24,4,20
2021,186618,42,4,7,0,7
2021,186645,0,0,121,54,67
2021,186645,10,0,121,54,67
2021,186645,10,1,38,15,23
2021,186645,10,2,33,15,18
2021,186645,10,3,32,15,17
2021,186645,10,4,18,9,9
2021,186645,20,0,90,41,49
2021,186645,20,1,38,15,23
2021,186645,20,2,33,15,18
2021,186645,20,3,17,10,7
2021,186645,20,4,2,1,1
2021,186645,30,0,25,9,16
2021,186645,30,3,15,5,10
2021,186645,30,4,10,4,6
2021,186645,40,0,6,4,2
2021,186645,40,4,6,4,2
2021,186645,42,0,6,4,2
2021,186645,42,4,6,4,2
2021,186867,0,0,308,220,88
2021,186867,10,0,308,220,88
2021,186867,10,1,69,61,8
2021,186867,10,2,109,78,31
2021,186867,10,3,108,67,41
2021,186867,10,5,22,14,8
2021,186867,20,0,99,77,22
2021,186867,20,1,47,42,5
2021,186867,20,2,52,35,17
2021,186867,30,0,104,66,38
2021,186867,30,1,1,1,0
2021,186867,30,2,11,8,3
2021,186867,30,3,92,57,35
2021,186867,40,0,105,77,28
2021,186867,40,1,21,18,3
2021,186867,40,2,46,35,11
2021,186867,40,3,16,10,6
2021,186867,40,5,22,14,8
2021,186867,41,0,105,77,28
2021,186867,41,1,21,18,3
2021,186867,41,2,46,35,11
2021,186867,41,3,16,10,6
2021,186867,41,5,22,14,8
2021,186867,44,0,105,77,28
2021,186867,44,1,21,18,3
2021,186867,44,2,46,35,11
2021,186867,44,3,16,10,6
2021,186867,44,5,22,14,8
2021,186876,0,0,329,148,181
2021,186876,10,0,329,148,181
2021,186876,10,1,86,41,45
2021,186876,10,2,139,59,80
2021,186876,10,3,85,41,44
2021,186876,10,4,7,3,4
2021,186876,10,6,12,4,8
2021,186876,20,0,228,103,125
2021,186876,20,1,86,41,45
2021,186876,20,2,134,56,78
2021,186876,20,3,7,5,2
2021,186876,20,4,1,1,0
2021,186876,30,0,85,40,45
2021,186876,30,2,5,3,2
2021,186876,30,3,74,35,39
2021,186876,30,4,6,2,4
2021,186876,40,0,16,5,11
2021,186876,40,3,4,1,3
2021,186876,40,6,12,4,8
2021,186876,42,0,16,5,11
2021,186876,42,3,4,1,3
2021,186876,42,6,12,4,8
2021,187134,0,0,372,171,201
2021,187134,10,0,372,171,201
2021,187134,10,1,149,68,81
2021,187134,10,2,131,61,70
2021,187134,10,3,80,38,42
2021,187134,10,4,2,0,2
2021,187134,10,5,10,4,6
2021,187134,20,0,260,119,141
2021,187134,20,1,148,68,80
2021,187134,20,2,104,48,56
2021,187134,20,3,8,3,5
2021,187134,30,0,79,35,44
2021,187134,30,1,1,0,1
2021,187134,30,2,26,12,14
2021,187134,30,3,52,23,29
2021,187134,40,0,33,17,16
2021,187134,40,2,1,1,0
2021,187134,40,3,20,12,8
2021,187134,40,4,2,0,2
2021,187134,40,5,10,4,6
2021,187134,41,0,10,4,6
2021,187134,41,5,10,4,6
2021,187134,42,0,23,13,10
2021,187134,42,2,1,1,0
2021,187134,42,3,20,12,8
2021,187134,42,4,2,0,2
2021,187134,44,0,10,4,6
2021,187134,44,5,10,4,6
2021,187198,0,0,80,31,49
2021,187198,10,0,80,31,49
2021,187198,10,1,38,18,20
2021,187198,10,2,30,8,22
2021,187198,10,3,12,5,7
2021,187198,20,0,80,31,49
2021,187198,20,1,38,18,20
2021,187198,20,2,30,8,22
2021,187198,20,3,12,5,7
2021,187444,0,0,353,164,189
2021,187444,10,0,353,164,189
2021,187444,10,1,193,104,89
2021,187444,10,2,84,32,52
2021,187444,10,3,62,22,40
2021,187444,10,4,14,6,8
2021,187444,20,0,280,136,144
2021,187444,20,1,193,104,89
2021,187444,20,2,82,31,51
2021,187444,20,3,5,1,4
2021,187444,30,0,55,21,34
2021,187444,30,2,2,1,1
2021,187444,30,3,53,20,33
2021,187444,40,0,18,7,11
2021,187444,40,3,4,1,3
2021,187444,40,4,14,6,8
2021,187444,42,0,18,7,11
2021,187444,42,3,4,1,3
2021,187444,42,4,14,6,8
2021,187532,0,0,304,122,182
2021,187532,10,0,304,122,182
2021,187532,10,4,304,122,182
2021,187532,40,0,304,122,182
2021,187532,40,4,304,122,182
2021,187532,42,0,156,59,97
2021,187532,42,4,156,59,97
2021,187532,43,0,148,63,85
2021,187532,43,4,148,63,85
2021,187596,0,0,101,64,37
2021,187596,10,0,93,59,34
2021,187596,10,1,3,1,2
2021,187596,10,2,19,13,6
2021,187596,10,3,45,25,20
2021,187596,10,4,20,15,5
2021,187596,10,5,6,5,1
2021,187596,40,0,93,59,34
2021,187596,40,1,3,1,2
2021,187596,40,2,19,13,6
2021,187596,40,3,45,25,20
2021,187596,40,4,20,15,5
2021,187596,40,5,6,5,1
2021,187596,42,0,5,2,3
2021,187596,42,1,1,0,1
2021,187596,42,2,1,0,1
2021,187596,42,3,2,1,1
2021,187596,42,4,1,1,0
2021,187596,43,0,88,57,31
2021,187596,43,1,2,1,1
2021,187596,43,2,18,13,5
2021,187596,43,3,43,24,19
2021,187596,43,4,19,14,5
2021,187596,43,5,6,5,1
2021,187596,50,0,8,5,3
2021,187620,0,0,121,56,65
2021,187620,10,0,121,56,65
2021,187620,10,1,35,15,20
2021,187620,10,2,26,12,14
2021,187620,10,3,34,14,20
2021,187620,10,4,26,15,11
2021,187620,20,0,72,33,39
2021,187620,20,1,35,15,20
2021,187620,20,2,25,11,14
2021,187620,20,3,12,7,5
2021,187620,30,0,46,21,25
2021,187620,30,3,22,7,15
2021,187620,30,4,24,14,10
2021,187620,40,0,3,2,1
2021,187620,40,2,1,1,0
2021,187620,40,4,2,1,1
2021,187620,42,0,3,2,1
2021,187620,42,2,1,1,0
2021,187620,42,4,2,1,1
2021,187639,0,0,51,16,35
2021,187639,10,0,51,16,35
2021,187639,10,4,51,16,35
2021,187639,40,0,51,16,35
2021,187639,40,4,51,16,35
2021,187639,42,0,51,16,35
2021,187639,42,4,51,16,35
2021,187648,0,0,162,83,79
2021,187648,10,0,162,83,79
2021,187648,10,1,29,19,10
2021,187648,10,2,25,14,11
2021,187648,10,3,65,36,29
2021,187648,10,4,43,14,29
2021,187648,20,0,56,35,21
2021,187648,20,1,29,19,10
2021,187648,20,2,24,14,10
2021,187648,20,4,3,2,1
2021,187648,30,0,65,36,29
2021,187648,30,2,1,0,1
2021,187648,30,3,63,36,27
2021,187648,30,4,1,0,1
2021,187648,40,0,41,12,29
2021,187648,40,3,2,0,2
2021,187648,40,4,39,12,27
2021,187648,42,0,41,12,29
2021,187648,42,3,2,0,2
2021,187648,42,4,39,12,27
2021,187666,0,0,41,19,22
2021,187666,10,0,41,19,22
2021,187666,10,4,41,19,22
2021,187666,20,0,19,11,8
2021,187666,20,4,19,11,8
2021,187666,30,0,22,8,14
2021,187666,30,4,22,8,14
2021,187745,0,0,26,12,14
2021,187745,10,0,26,12,14
2021,187745,10,1,1,0,1
2021,187745,10,2,7,5,2
2021,187745,10,3,18,7,11
2021,187745,40,0,26,12,14
2021,187745,40,1,1,0,1
2021,187745,40,2,7,5,2
2021,187745,40,3,18,7,11
2021,187745,41,0,26,12,14
2021,187745,41,1,1,0,1
2021,187745,41,2,7,5,2
2021,187745,41,3,18,7,11
2021,187745,44,0,26,12,14
2021,187745,44,1,1,0,1
2021,187745,44,2,7,5,2
2021,187745,44,3,18,7,11
2021,187897,0,0,129,62,67
2021,187897,10,0,129,62,67
2021,187897,10,1,26,12,14
2021,187897,10,2,31,16,15
2021,187897,10,3,48,24,24
2021,187897,10,4,24,10,14
2021,187897,20,0,49,24,25
2021,187897,20,1,26,12,14
2021,187897,20,2,23,12,11
2021,187897,30,0,43,20,23
2021,187897,30,2,8,4,4
2021,187897,30,3,35,16,19
2021,187897,40,0,37,18,19
2021,187897,40,3,13,8,5
2021,187897,40,4,24,10,14
2021,187897,42,0,37,18,19
2021,187897,42,3,13,8,5
2021,187897,42,4,24,10,14
2021,187903,0,0,64,27,37
2021,187903,10,0,64,27,37
2021,187903,10,1,64,27,37
2021,187903,40,0,64,27,37
2021,187903,40,1,64,27,37
2021,187903,42,0,64,27,37
2021,187903,42,1,64,27,37
2021,187912,0,0,79,46,33
2021,187912,10,0,79,46,33
2021,187912,10,1,12,7,5
2021,187912,10,2,25,13,12
2021,187912,10,3,19,10,9
2021,187912,10,4,23,16,7
2021,187912,20,0,41,19,22
2021,187912,20,1,12,7,5
2021,187912,20,2,18,9,9
2021,187912,20,3,10,3,7
2021,187912,20,4,1,0,1
2021,187912,30,0,19,12,7
2021,187912,30,2,7,4,3
2021,187912,30,3,9,7,2
2021,187912,30,4,3,1,2
2021,187912,40,0,19,15,4
2021,187912,40,4,19,15,4
2021,187912,42,0,19,15,4
2021,187912,42,4,19,15,4
2021,187958,0,0,59,30,29
2021,187958,10,0,59,30,29
2021,187958,10,1,6,4,2
2021,187958,10,2,13,7,6
2021,187958,10,3,10,6,4
2021,187958,10,5,27,12,15
2021,187958,10,6,3,1,2
2021,187958,20,0,19,11,8
2021,187958,20,1,6,4,2
2021,187958,20,2,13,7,6
2021,187958,30,0,9,5,4
2021,187958,30,3,9,5,4
2021,187958,40,0,31,14,17
2021,187958,40,3,1,1,0
2021,187958,40,5,27,12,15
2021,187958,40,6,3,1,2
2021,187958,42,0,31,14,17
2021,187958,42,3,1,1,0
2021,187958,42,5,27,12,15
2021,187958,42,6,3,1,2
2021,187967,0,0,135,99,36
2021,187967,10,0,133,98,35
2021,187967,10,1,41,33,8
2021,187967,10,2,41,33,8
2021,187967,10,3,35,26,9
2021,187967,10,4,16,6,10
2021,187967,20,0,79,64,15
2021,187967,20,1,40,33,7
2021,187967,20,2,39,31,8
2021,187967,30,0,34,25,9
2021,187967,30,2,1,1,0
2021,187967,30,3,33,24,9
2021,187967,40,0,20,9,11
2021,187967,40,1,1,0,1
2021,187967,40,2,1,1,0
2021,187967,40,3,2,2,0
2021,187967,40,4,16,6,10
2021,187967,41,0,19,9,10
2021,187967,41,1,1,0,1
2021,187967,41,2,1,1,0
2021,187967,41,3,2,2,0
2021,187967,41,4,15,6,9
2021,187967,43,0,1,0,1
2021,187967,43,4,1,0,1
2021,187967,45,0,19,9,10
2021,187967,45,1,1,0,1
2021,187967,45,2,1,1,0
2021,187967,45,3,2,2,0
2021,187967,45,4,15,6,9
2021,187967,50,0,2,1,1
2021,187976,0,0,3,1,2
2021,187976,10,0,3,1,2
2021,187976,10,5,3,1,2
2021,187976,40,0,3,1,2
2021,187976,40,5,3,1,2
2021,187976,42,0,3,1,2
2021,187976,42,5,3,1,2
2021,187985,0,0,1933,946,987
2021,187985,10,0,1933,946,987
2021,187985,10,1,494,289,205
2021,187985,10,2,528,260,268
2021,187985,10,3,616,286,330
2021,187985,10,4,55,20,35
2021,187985,10,5,208,71,137
2021,187985,10,6,32,20,12
2021,187985,20,0,650,376,274
2021,187985,20,1,359,221,138
2021,187985,20,2,289,153,136
2021,187985,20,3,2,2,0
2021,187985,30,0,255,122,133
2021,187985,30,1,4,3,1
2021,187985,30,2,14,6,8
2021,187985,30,3,235,112,123
2021,187985,30,5,1,0,1
2021,187985,30,6,1,1,0
2021,187985,40,0,1028,448,580
2021,187985,40,1,131,65,66
2021,187985,40,2,225,101,124
2021,187985,40,3,379,172,207
2021,187985,40,4,55,20,35
2021,187985,40,5,207,71,136
2021,187985,40,6,31,19,12
2021,187985,42,0,1028,448,580
2021,187985,42,1,131,65,66
2021,187985,42,2,225,101,124
2021,187985,42,3,379,172,207
2021,187985,42,4,55,20,35
2021,187985,42,5,207,71,136
2021,187985,42,6,31,19,12
2021,187994,0,0,28,13,15
2021,187994,10,0,28,13,15
2021,187994,10,1,13,5,8
2021,187994,10,2,7,3,4
2021,187994,10,3,6,4,2
2021,187994,10,4,1,1,0
2021,187994,10,6,1,0,1
2021,187994,20,0,13,6,7
2021,187994,20,1,9,4,5
2021,187994,20,2,3,2,1
2021,187994,20,3,1,0,1
2021,187994,30,0,4,3,1
2021,187994,30,2,1,0,1
2021,187994,30,3,3,3,0
2021,187994,40,0,11,4,7
2021,187994,40,1,4,1,3
2021,187994,40,2,3,1,2
2021,187994,40,3,2,1,1
2021,187994,40,4,1,1,0
2021,187994,40,6,1,0,1
2021,187994,41,0,1,0,1
2021,187994,41,6,1,0,1
2021,187994,42,0,10,4,6
2021,187994,42,1,4,1,3
2021,187994,42,2,3,1,2
2021,187994,42,3,2,1,1
2021,187994,42,4,1,1,0
2021,187994,44,0,1,0,1
2021,187994,44,6,1,0,1
2021,188003,0,0,30,16,14
2021,188003,10,0,30,16,14
2021,188003,10,1,12,9,3
2021,188003,10,2,2,2,0
2021,188003,10,3,8,3,5
2021,188003,10,4,8,2,6
2021,188003,20,0,13,10,3
2021,188003,20,1,12,9,3
2021,188003,20,2,1,1,0
2021,188003,30,0,9,2,7
2021,188003,30,2,1,1,0
2021,188003,30,3,4,1,3
2021,188003,30,4,4,0,4
2021,188003,40,0,8,4,4
2021,188003,40,3,4,2,2
2021,188003,40,4,4,2,2
2021,188003,42,0,8,4,4
2021,188003,42,3,4,2,2
2021,188003,42,4,4,2,2
2021,188021,0,0,15,7,8
2021,188021,10,0,15,7,8
2021,188021,10,1,3,1,2
2021,188021,10,2,4,3,1
2021,188021,10,3,2,0,2
2021,188021,10,4,4,2,2
2021,188021,10,6,2,1,1
2021,188021,20,0,7,4,3
2021,188021,20,1,3,1,2
2021,188021,20,2,4,3,1
2021,188021,30,0,2,0,2
2021,188021,30,3,2,0,2
2021,188021,40,0,6,3,3
2021,188021,40,4,4,2,2
2021,188021,40,6,2,1,1
2021,188021,41,0,2,1,1
2021,188021,41,6,2,1,1
2021,188021,42,0,4,2,2
2021,188021,42,4,4,2,2
2021,188021,44,0,2,1,1
2021,188021,44,6,2,1,1
2021,188030,0,0,607,329,278
2021,188030,10,0,607,329,278
2021,188030,10,1,195,133,62
2021,188030,10,2,171,90,81
2021,188030,10,3,207,93,114
2021,188030,10,4,4,2,2
2021,188030,10,6,30,11,19
2021,188030,20,0,319,207,112
2021,188030,20,1,177,123,54
2021,188030,20,2,139,83,56
2021,188030,20,3,3,1,2
2021,188030,30,0,154,79,75
2021,188030,30,2,5,2,3
2021,188030,30,3,149,77,72
2021,188030,40,0,134,43,91
2021,188030,40,1,18,10,8
2021,188030,40,2,27,5,22
2021,188030,40,3,55,15,40
2021,188030,40,4,4,2,2
2021,188030,40,6,30,11,19
2021,188030,41,0,32,11,21
2021,188030,41,3,2,0,2
2021,188030,41,6,30,11,19
2021,188030,42,0,102,32,70
2021,188030,42,1,18,10,8
2021,188030,42,2,27,5,22
2021,188030,42,3,53,15,38
2021,188030,42,4,4,2,2
2021,188030,44,0,32,11,21
2021,188030,44,3,2,0,2
2021,188030,44,6,30,11,19
2021,188049,0,0,36,15,21
2021,188049,10,0,36,15,21
2021,188049,10,1,2,0,2
2021,188049,10,2,5,1,4
2021,188049,10,3,14,8,6
2021,188049,10,5,14,6,8
2021,188049,10,6,1,0,1
2021,188049,20,0,7,1,6
2021,188049,20,1,2,0,2
2021,188049,20,2,5,1,4
2021,188049,30,0,14,8,6
2021,188049,30,3,14,8,6
2021,188049,40,0,15,6,9
2021,188049,40,5,14,6,8
2021,188049,40,6,1,0,1
2021,188049,42,0,15,6,9
2021,188049,42,5,14,6,8
2021,188049,42,6,1,0,1
2021,188058,0,0,48,19,29
2021,188058,10,0,48,19,29
2021,188058,10,2,19,7,12
2021,188058,10,3,21,8,13
2021,188058,10,4,8,4,4
2021,188058,20,0,19,7,12
2021,188058,20,2,19,7,12
2021,188058,30,0,21,8,13
2021,188058,30,3,21,8,13
2021,188058,40,0,8,4,4
2021,188058,40,4,8,4,4
2021,188058,43,0,8,4,4
2021,188058,43,4,8,4,4
2021,188100,0,0,142,73,69
2021,188100,10,0,142,73,69
2021,188100,10,1,22,13,9
2021,188100,10,2,22,8,14
2021,188100,10,3,65,38,27
2021,188100,10,4,33,14,19
2021,188100,40,0,142,73,69
2021,188100,40,1,22,13,9
2021,188100,40,2,22,8,14
2021,188100,40,3,65,38,27
2021,188100,40,4,33,14,19
2021,188100,42,0,142,73,69
2021,188100,42,1,22,13,9
2021,188100,42,2,22,8,14
2021,188100,42,3,65,38,27
2021,188100,42,4,33,14,19
2021,188137,0,0,64,34,30
2021,188137,10,0,64,34,30
2021,188137,10,1,3,2,1
2021,188137,10,2,8,4,4
2021,188137,10,3,53,28,25
2021,188137,40,0,64,34,30
2021,188137,40,1,3,2,1
2021,188137,40,2,8,4,4
2021,188137,40,3,53,28,25
2021,188137,41,0,48,27,21
2021,188137,41,1,2,1,1
2021,188137,41,2,7,4,3
2021,188137,41,3,39,22,17
2021,188137,42,0,16,7,9
2021,188137,42,1,1,1,0
2021,188137,42,2,1,0,1
2021,188137,42,3,14,6,8
2021,188137,45,0,48,27,21
2021,188137,45,1,2,1,1
2021,188137,45,2,7,4,3
2021,188137,45,3,39,22,17
2021,188182,0,0,31,13,18
2021,188182,10,0,31,13,18
2021,188182,10,1,3,2,1
2021,188182,10,2,5,2,3
2021,188182,10,3,12,5,7
2021,188182,10,4,5,2,3
2021,188182,10,5,1,1,0
2021,188182,10,6,5,1,4
2021,188182,40,0,31,13,18
2021,188182,40,1,3,2,1
2021,188182,40,2,5,2,3
2021,188182,40,3,12,5,7
2021,188182,40,4,5,2,3
2021,188182,40,5,1,1,0
2021,188182,40,6,5,1,4
2021,188182,42,0,31,13,18
2021,188182,42,1,3,2,1
2021,188182,42,2,5,2,3
2021,188182,42,3,12,5,7
2021,188182,42,4,5,2,3
2021,188182,42,5,1,1,0
2021,188182,42,6,5,1,4
2021,188207,0,0,6,0,6
2021,188207,10,0,6,0,6
2021,188207,10,4,6,0,6
2021,188207,40,0,6,0,6
2021,188207,40,4,6,0,6
2021,188207,41,0,6,0,6
2021,188207,41,4,6,0,6
2021,188207,45,0,6,0,6
2021,188207,45,4,6,0,6
2021,188216,0,0,18,12,6
2021,188216,10,0,17,11,6
2021,188216,10,4,17,11,6
2021,188216,40,0,17,11,6
2021,188216,40,4,17,11,6
2021,188216,41,0,17,11,6
2021,188216,41,4,17,11,6
2021,188216,45,0,17,11,6
2021,188216,45,4,17,11,6
2021,188216,50,0,1,1,0
2021,188225,0,0,22,8,14
2021,188225,10,0,22,8,14
2021,188225,10,2,4,3,1
2021,188225,10,3,2,0,2
2021,188225,10,4,2,2,0
2021,188225,10,5,12,2,10
2021,188225,10,6,2,1,1
2021,188225,20,0,4,3,1
2021,188225,20,2,4,3,1
2021,188225,30,0,2,0,2
2021,188225,30,3,2,0,2
2021,188225,40,0,16,5,11
2021,188225,40,4,2,2,0
2021,188225,40,5,12,2,10
2021,188225,40,6,2,1,1
2021,188225,42,0,16,5,11
2021,188225,42,4,2,2,0
2021,188225,42,5,12,2,10
2021,188225,42,6,2,1,1
2021,188261,0,0,15,11,4
2021,188261,10,0,15,11,4
2021,188261,10,4,15,11,4
2021,188261,40,0,15,11,4
2021,188261,40,4,15,11,4
2021,188261,42,0,15,11,4
2021,188261,42,4,15,11,4
2021,188304,0,0,96,42,54
2021,188304,10,0,94,40,54
2021,188304,10,1,20,10,10
2021,188304,10,2,31,15,16
2021,188304,10,3,37,12,25
2021,188304,10,4,4,2,2
2021,188304,10,6,2,1,1
2021,188304,20,0,40,21,19
2021,188304,20,1,20,10,10
2021,188304,20,2,20,11,9
2021,188304,30,0,48,18,30
2021,188304,30,2,11,4,7
2021,188304,30,3,33,12,21
2021,188304,30,4,4,2,2
2021,188304,40,0,6,1,5
2021,188304,40,3,4,0,4
2021,188304,40,6,2,1,1
2021,188304,42,0,5,1,4
2021,188304,42,3,3,0,3
2021,188304,42,6,2,1,1
2021,188304,43,0,1,0,1
2021,188304,43,3,1,0,1
2021,188304,50,0,2,2,0
2021,188340,0,0,36,26,10
2021,188340,10,0,36,26,10
2021,188340,10,1,8,5,3
2021,188340,10,2,9,7,2
2021,188340,10,3,14,9,5
2021,188340,10,4,5,5,0
2021,188340,20,0,18,11,7
2021,188340,20,1,8,5,3
2021,188340,20,2,7,5,2
2021,188340,20,3,3,1,2
2021,188340,30,0,5,4,1
2021,188340,30,3,5,4,1
2021,188340,40,0,13,11,2
2021,188340,40,2,2,2,0
2021,188340,40,3,6,4,2
2021,188340,40,4,5,5,0
2021,188340,42,0,13,11,2
2021,188340,42,2,2,2,0
2021,188340,42,3,6,4,2
2021,188340,42,4,5,5,0
2021,188429,0,0,341,154,187
2021,188429,10,0,341,154,187
2021,188429,10,1,91,47,44
2021,188429,10,2,138,60,78
2021,188429,10,3,90,39,51
2021,188429,10,5,22,8,14
2021,188429,20,0,209,103,106
2021,188429,20,1,91,47,44
2021,188429,20,2,117,55,62
2021,188429,20,3,1,1,0
2021,188429,30,0,69,29,40
2021,188429,30,2,3,1,2
2021,188429,30,3,66,28,38
2021,188429,40,0,63,22,41
2021,188429,40,2,18,4,14
2021,188429,40,3,23,10,13
2021,188429,40,5,22,8,14
2021,188429,41,0,54,19,35
2021,188429,41,2,17,4,13
2021,188429,41,3,15,7,8
2021,188429,41,5,22,8,14
2021,188429,42,0,9,3,6
2021,188429,42,2,1,0,1
2021,188429,42,3,8,3,5
2021,188429,44,0,54,19,35
2021,188429,44,2,17,4,13
2021,188429,44,3,15,7,8
2021,188429,44,5,22,8,14
2021,188438,0,0,84,41,43
2021,188438,10,0,84,41,43
2021,188438,10,1,32,16,16
2021,188438,10,2,19,13,6
2021,188438,10,3,18,6,12
2021,188438,10,4,11,6,5
2021,188438,10,6,4,0,4
2021,188438,20,0,65,36,29
2021,188438,20,1,31,15,16
2021,188438,20,2,17,12,5
2021,188438,20,3,13,6,7
2021,188438,20,4,4,3,1
2021,188438,30,0,15,5,10
2021,188438,30,1,1,1,0
2021,188438,30,2,2,1,1
2021,188438,30,3,5,0,5
2021,188438,30,4,7,3,4
2021,188438,40,0,4,0,4
2021,188438,40,6,4,0,4
2021,188438,43,0,4,0,4
2021,188438,43,6,4,0,4
2021,188517,0,0,8,5,3
2021,188517,10,0,8,5,3
2021,188517,10,4,8,5,3
2021,188517,40,0,8,5,3
2021,188517,40,4,8,5,3
2021,188517,41,0,8,5,3
2021,188517,41,4,8,5,3
2021,188517,45,0,8,5,3
2021,188517,45,4,8,5,3
2021,188526,0,0,81,44,37
2021,188526,10,0,81,44,37
2021,188526,10,1,9,4,5
2021,188526,10,2,34,24,10
2021,188526,10,3,23,8,15
2021,188526,10,4,15,8,7
2021,188526,20,0,26,19,7
2021,188526,20,1,5,3,2
2021,188526,20,2,21,16,5
2021,188526,30,0,7,5,2
2021,188526,30,2,1,0,1
2021,188526,30,3,6,5,1
2021,188526,40,0,48,20,28
2021,188526,40,1,4,1,3
2021,188526,40,2,12,8,4
2021,188526,40,3,17,3,14
2021,188526,40,4,15,8,7
2021,188526,41,0,28,10,18
2021,188526,41,1,4,1,3
2021,188526,41,2,9,5,4
2021,188526,41,3,7,0,7
2021,188526,41,4,8,4,4
2021,188526,42,0,20,10,10
2021,188526,42,2,3,3,0
2021,188526,42,3,10,3,7
2021,188526,42,4,7,4,3
2021,188526,44,0,28,10,18
2021,188526,44,1,4,1,3
2021,188526,44,2,9,5,4
2021,188526,44,3,7,0,7
2021,188526,44,4,8,4,4
2021,188535,0,0,39,19,20
2021,188535,10,0,39,19,20
2021,188535,10,1,23,12,11
2021,188535,10,2,7,5,2
2021,188535,10,3,9,2,7
2021,188535,20,0,20,12,8
2021,188535,20,1,19,11,8
2021,188535,20,2,1,1,0
2021,188535,30,0,6,3,3
2021,188535,30,2,4,2,2
2021,188535,30,3,2,1,1
2021,188535,40,0,13,4,9
2021,188535,40,1,4,1,3
2021,188535,40,2,2,2,0
2021,188535,40,3,7,1,6
2021,188535,41,0,5,2,3
2021,188535,41,1,3,1,2
2021,188535,41,2,1,1,0
2021,188535,41,3,1,0,1
2021,188535,42,0,7,2,5
2021,188535,42,1,1,0,1
2021,188535,42,2,1,1,0
2021,188535,42,3,5,1,4
2021,188535,43,0,1,0,1
2021,188535,43,3,1,0,1
2021,188535,44,0,5,2,3
2021,188535,44,1,3,1,2
2021,188535,44,2,1,1,0
2021,188535,44,3,1,0,1
2021,188580,0,0,603,358,245
2021,188580,10,0,442,258,184
2021,188580,10,1,88,67,21
2021,188580,10,2,111,60,51
2021,188580,10,3,167,89,78
2021,188580,10,4,29,19,10
2021,188580,10,6,47,23,24
2021,188580,30,0,155,98,57
2021,188580,30,1,47,37,10
2021,188580,30,2,44,26,18
2021,188580,30,3,40,20,20
2021,188580,30,6,24,15,9
2021,188580,40,0,287,160,127
2021,188580,40,1,41,30,11
2021,188580,40,2,67,34,33
2021,188580,40,3,127,69,58
2021,188580,40,4,29,19,10
2021,188580,40,6,23,8,15
2021,188580,41,0,254,142,112
2021,188580,41,1,41,30,11
2021,188580,41,2,66,33,33
2021,188580,41,3,127,69,58
2021,188580,41,4,5,4,1
2021,188580,41,6,15,6,9
2021,188580,42,0,33,18,15
2021,188580,42,2,1,1,0
2021,188580,42,4,24,15,9
2021,188580,42,6,8,2,6
2021,188580,44,0,254,142,112
2021,188580,44,1,41,30,11
2021,188580,44,2,66,33,33
2021,188580,44,3,127,69,58
2021,188580,44,4,5,4,1
2021,188580,44,6,15,6,9
2021,188580,50,0,161,100,61
2021,188641,0,0,150,78,72
2021,188641,10,0,150,78,72
2021,188641,10,1,55,33,22
2021,188641,10,2,34,16,18
2021,188641,10,3,56,27,29
2021,188641,10,4,2,1,1
2021,188641,10,5,2,0,2
2021,188641,10,6,1,1,0
2021,188641,20,0,83,48,35
2021,188641,20,1,54,33,21
2021,188641,20,2,29,15,14
2021,188641,30,0,45,24,21
2021,188641,30,1,1,0,1
2021,188641,30,2,3,0,3
2021,188641,30,3,41,24,17
2021,188641,40,0,22,6,16
2021,188641,40,2,2,1,1
2021,188641,40,3,15,3,12
2021,188641,40,4,2,1,1
2021,188641,40,5,2,0,2
2021,188641,40,6,1,1,0
2021,188641,41,0,14,4,10
2021,188641,41,2,2,1,1
2021,188641,41,3,8,2,6
2021,188641,41,4,2,1,1
2021,188641,41,5,2,0,2
2021,188641,42,0,6,1,5
2021,188641,42,3,6,1,5
2021,188641,43,0,2,1,1
2021,188641,43,3,1,0,1
2021,188641,43,6,1,1,0
2021,188641,44,0,12,2,10
2021,188641,44,2,2,1,1
2021,188641,44,3,7,1,6
2021,188641,44,4,1,0,1
2021,188641,44,5,2,0,2
2021,188641,45,0,2,2,0
2021,188641,45,3,1,1,0
2021,188641,45,4,1,1,0
2021,188678,0,0,10,3,7
2021,188678,10,0,10,3,7
2021,188678,10,6,10,3,7
2021,188678,40,0,10,3,7
2021,188678,40,6,10,3,7
2021,188678,43,0,10,3,7
2021,188678,43,6,10,3,7
2021,188854,0,0,137,87,50
2021,188854,10,0,137,87,50
2021,188854,10,4,137,87,50
2021,188854,40,0,137,87,50
2021,188854,40,4,137,87,50
2021,188854,41,0,137,87,50
2021,188854,41,4,137,87,50
2021,188854,45,0,137,87,50
2021,188854,45,4,137,87,50
2021,189015,0,0,24,5,19
2021,189015,10,0,24,5,19
2021,189015,10,6,24,5,19
2021,189015,40,0,24,5,19
2021,189015,40,6,24,5,19
2021,189015,42,0,24,5,19
2021,189015,42,6,24,5,19
2021,189088,0,0,199,110,89
2021,189088,10,0,199,110,89
2021,189088,10,1,56,40,16
2021,189088,10,2,70,37,33
2021,189088,10,3,71,33,38
2021,189088,10,4,1,0,1
2021,189088,10,5,1,0,1
2021,189088,20,0,101,60,41
2021,189088,20,1,47,32,15
2021,189088,20,2,54,28,26
2021,189088,30,0,42,22,20
2021,189088,30,2,3,1,2
2021,189088,30,3,39,21,18
2021,189088,40,0,56,28,28
2021,189088,40,1,9,8,1
2021,189088,40,2,13,8,5
2021,189088,40,3,32,12,20
2021,189088,40,4,1,0,1
2021,189088,40,5,1,0,1
2021,189088,41,0,56,28,28
2021,189088,41,1,9,8,1
2021,189088,41,2,13,8,5
2021,189088,41,3,32,12,20
2021,189088,41,4,1,0,1
2021,189088,41,5,1,0,1
2021,189088,44,0,56,28,28
2021,189088,44,1,9,8,1
2021,189088,44,2,13,8,5
2021,189088,44,3,32,12,20
2021,189088,44,4,1,0,1
2021,189088,44,5,1,0,1
2021,189097,0,0,267,94,173
2021,189097,10,0,265,94,171
2021,189097,10,1,101,44,57
2021,189097,10,2,28,9,19
2021,189097,10,3,49,22,27
2021,189097,10,4,52,12,40
2021,189097,10,5,35,7,28
2021,189097,20,0,118,51,67
2021,189097,20,1,94,42,52
2021,189097,20,2,24,9,15
2021,189097,30,0,47,21,26
2021,189097,30,3,47,21,26
2021,189097,40,0,100,22,78
2021,189097,40,1,7,2,5
2021,189097,40,2,4,0,4
2021,189097,40,3,2,1,1
2021,189097,40,4,52,12,40
2021,189097,40,5,35,7,28
2021,189097,41,0,57,13,44
2021,189097,41,1,7,2,5
2021,189097,41,2,4,0,4
2021,189097,41,3,2,1,1
2021,189097,41,4,9,3,6
2021,189097,41,5,35,7,28
2021,189097,42,0,43,9,34
2021,189097,42,4,43,9,34
2021,189097,44,0,57,13,44
2021,189097,44,1,7,2,5
2021,189097,44,2,4,0,4
2021,189097,44,3,2,1,1
2021,189097,44,4,9,3,6
2021,189097,44,5,35,7,28
2021,189097,50,0,2,0,2
2021,189228,0,0,43,20,23
2021,189228,10,0,43,20,23
2021,189228,10,6,43,20,23
2021,189228,40,0,43,20,23
2021,189228,40,6,43,20,23
2021,189228,42,0,43,20,23
2021,189228,42,6,43,20,23
2021,189282,0,0,7,1,6
2021,189282,10,0,7,1,6
2021,189282,10,1,1,0,1
2021,189282,10,2,1,0,1
2021,189282,10,3,5,1,4
2021,189282,40,0,7,1,6
2021,189282,40,1,1,0,1
2021,189282,40,2,1,0,1
2021,189282,40,3,5,1,4
2021,189282,41,0,7,1,6
2021,189282,41,1,1,0,1
2021,189282,41,2,1,0,1
2021,189282,41,3,5,1,4
2021,189282,44,0,7,1,6
2021,189282,44,1,1,0,1
2021,189282,44,2,1,0,1
2021,189282,44,3,5,1,4
2021,189413,0,0,27,11,16
2021,189413,10,0,27,11,16
2021,189413,10,1,4,2,2
2021,189413,10,2,10,6,4
2021,189413,10,3,7,2,5
2021,189413,10,4,6,1,5
2021,189413,40,0,27,11,16
2021,189413,40,1,4,2,2
2021,189413,40,2,10,6,4
2021,189413,40,3,7,2,5
2021,189413,40,4,6,1,5
2021,189413,41,0,14,8,6
2021,189413,41,1,4,2,2
2021,189413,41,2,10,6,4
2021,189413,42,0,13,3,10
2021,189413,42,3,7,2,5
2021,189413,42,4,6,1,5
2021,189413,44,0,14,8,6
2021,189413,44,1,4,2,2
2021,189413,44,2,10,6,4
2021,189501,0,0,71,28,43
2021,189501,10,0,71,28,43
2021,189501,10,1,36,21,15
2021,189501,10,2,8,1,7
2021,189501,10,3,27,6,21
2021,189501,20,0,34,19,15
2021,189501,20,1,33,19,14
2021,189501,20,2,1,0,1
2021,189501,30,0,10,5,5
2021,189501,30,1,1,1,0
2021,189501,30,2,1,0,1
2021,189501,30,3,8,4,4
2021,189501,40,0,27,4,23
2021,189501,40,1,2,1,1
2021,189501,40,2,6,1,5
2021,189501,40,3,19,2,17
2021,189501,41,0,16,1,15
2021,189501,41,1,2,1,1
2021,189501,41,2,4,0,4
2021,189501,41,3,10,0,10
2021,189501,42,0,11,3,8
2021,189501,42,2,2,1,1
2021,189501,42,3,9,2,7
2021,189501,44,0,16,1,15
2021,189501,44,1,2,1,1
2021,189501,44,2,4,0,4
2021,189501,44,3,10,0,10
2021,189547,0,0,146,60,86
2021,189547,10,0,146,60,86
2021,189547,10,1,64,33,31
2021,189547,10,2,40,13,27
2021,189547,10,3,24,8,16
2021,189547,10,4,3,0,3
2021,189547,10,6,15,6,9
2021,189547,20,0,114,50,64
2021,189547,20,1,64,33,31
2021,189547,20,2,40,13,27
2021,189547,20,3,10,4,6
2021,189547,30,0,16,4,12
2021,189547,30,3,13,4,9
2021,189547,30,4,3,0,3
2021,189547,40,0,16,6,10
2021,189547,40,3,1,0,1
2021,189547,40,6,15,6,9
2021,189547,42,0,1,0,1
2021,189547,42,3,1,0,1
2021,189547,43,0,15,6,9
2021,189547,43,6,15,6,9
2021,189565,0,0,24,9,15
2021,189565,10,0,24,9,15
2021,189565,10,4,24,9,15
2021,189565,40,0,24,9,15
2021,189565,40,4,24,9,15
2021,189565,41,0,24,9,15
2021,189565,41,4,24,9,15
2021,189565,45,0,24,9,15
2021,189565,45,4,24,9,15
2021,189583,0,0,31,12,19
2021,189583,10,0,30,12,18
2021,189583,10,4,30,12,18
2021,189583,40,0,30,12,18
2021,189583,40,4,30,12,18
2021,189583,41,0,30,12,18
2021,189583,41,4,30,12,18
2021,189583,45,0,30,12,18
2021,189583,45,4,30,12,18
2021,189583,50,0,1,0,1
2021,189592,0,0,14,7,7
2021,189592,10,0,14,7,7
2021,189592,10,4,14,7,7
2021,189592,40,0,14,7,7
2021,189592,40,4,14,7,7
2021,189592,41,0,14,7,7
2021,189592,41,4,14,7,7
2021,189592,45,0,14,7,7
2021,189592,45,4,14,7,7
2021,189705,0,0,126,71,55
2021,189705,10,0,118,68,50
2021,189705,10,1,46,30,16
2021,189705,10,2,48,27,21
2021,189705,10,3,22,9,13
2021,189705,10,4,2,2,0
2021,189705,20,0,91,57,34
2021,189705,20,1,45,30,15
2021,189705,20,2,46,27,19
2021,189705,30,0,18,8,10
2021,189705,30,2,2,0,2
2021,189705,30,3,16,8,8
2021,189705,40,0,9,3,6
2021,189705,40,1,1,0,1
2021,189705,40,3,6,1,5
2021,189705,40,4,2,2,0
2021,189705,42,0,9,3,6
2021,189705,42,1,1,0,1
2021,189705,42,3,6,1,5
2021,189705,42,4,2,2,0
2021,189705,50,0,8,3,5
2021,189811,0,0,18,2,16
2021,189811,10,0,18,2,16
2021,189811,10,4,18,2,16
2021,189811,40,0,18,2,16
2021,189811,40,4,18,2,16
2021,189811,41,0,18,2,16
2021,189811,41,4,18,2,16
2021,189811,45,0,18,2,16
2021,189811,45,4,18,2,16
2021,189839,0,0,42,20,22
2021,189839,10,0,42,20,22
2021,189839,10,1,29,16,13
2021,189839,10,2,6,1,5
2021,189839,10,3,6,3,3
2021,189839,10,4,1,0,1
2021,189839,20,0,35,19,16
2021,189839,20,1,29,16,13
2021,189839,20,2,4,1,3
2021,189839,20,3,2,2,0
2021,189839,30,0,7,1,6
2021,189839,30,2,2,0,2
2021,189839,30,3,4,1,3
2021,189839,30,4,1,0,1
2021,189848,0,0,52,17,35
2021,189848,10,0,52,17,35
2021,189848,10,1,19,6,13
2021,189848,10,2,17,4,13
2021,189848,10,3,6,2,4
2021,189848,10,4,10,5,5
2021,189848,20,0,34,10,24
2021,189848,20,1,19,6,13
2021,189848,20,2,14,4,10
2021,189848,20,3,1,0,1
2021,189848,30,0,8,2,6
2021,189848,30,2,3,0,3
2021,189848,30,3,5,2,3
2021,189848,40,0,10,5,5
2021,189848,40,4,10,5,5
2021,189848,41,0,1,1,0
2021,189848,41,4,1,1,0
2021,189848,42,0,9,4,5
2021,189848,42,4,9,4,5
2021,189848,44,0,1,1,0
2021,189848,44,4,1,1,0
2021,189857,0,0,20,20,0
2021,189857,10,0,20,20,0
2021,189857,10,4,20,20,0
2021,189857,40,0,20,20,0
2021,189857,40,4,20,20,0
2021,189857,42,0,20,20,0
2021,189857,42,4,20,20,0
2021,190044,0,0,256,160,96
2021,190044,10,0,256,160,96
2021,190044,10,1,62,49,13
2021,190044,10,2,64,43,21
2021,190044,10,3,112,58,54
2021,190044,10,4,8,4,4
2021,190044,10,6,10,6,4
2021,190044,20,0,109,84,25
2021,190044,20,1,60,48,12
2021,190044,20,2,49,36,13
2021,190044,30,0,82,42,40
2021,190044,30,2,2,1,1
2021,190044,30,3,80,41,39
2021,190044,40,0,65,34,31
2021,190044,40,1,2,1,1
2021,190044,40,2,13,6,7
2021,190044,40,3,32,17,15
2021,190044,40,4,8,4,4
2021,190044,40,6,10,6,4
2021,190044,41,0,55,27,28
2021,190044,41,1,2,1,1
2021,190044,41,2,13,6,7
2021,190044,41,3,31,16,15
2021,190044,41,4,8,4,4
2021,190044,41,6,1,0,1
2021,190044,42,0,10,7,3
2021,190044,42,3,1,1,0
2021,190044,42,6,9,6,3
2021,190044,44,0,1,0,1
2021,190044,44,6,1,0,1
2021,190044,45,0,54,27,27
2021,190044,45,1,2,1,1
2021,190044,45,2,13,6,7
2021,190044,45,3,31,16,15
2021,190044,45,4,8,4,4
2021,190053,0,0,26,10,16
2021,190053,10,0,26,10,16
2021,190053,10,1,11,3,8
2021,190053,10,2,4,1,3
2021,190053,10,3,10,5,5
2021,190053,10,4,1,1,0
2021,190053,20,0,22,9,13
2021,190053,20,1,11,3,8
2021,190053,20,2,4,1,3
2021,190053,20,3,7,5,2
2021,190053,30,0,4,1,3
2021,190053,30,3,3,0,3
2021,190053,30,4,1,1,0
2021,190071,0,0,8,1,7
2021,190071,10,0,7,1,6
2021,190071,10,4,7,1,6
2021,190071,40,0,7,1,6
2021,190071,40,4,7,1,6
2021,190071,41,0,7,1,6
2021,190071,41,4,7,1,6
2021,190071,44,0,7,1,6
2021,190071,44,4,7,1,6
2021,190071,50,0,1,0,1
2021,190080,0,0,6,2,4
2021,190080,10,0,6,2,4
2021,190080,10,1,3,1,2
2021,190080,10,2,1,1,0
2021,190080,10,3,2,0,2
2021,190080,20,0,3,1,2
2021,190080,20,1,3,1,2
2021,190080,30,0,3,1,2
2021,190080,30,2,1,1,0
2021,190080,30,3,2,0,2
2021,190099,0,0,337,181,156
2021,190099,10,0,332,179,153
2021,190099,10,1,97,60,37
2021,190099,10,2,85,44,41
2021,190099,10,3,118,62,56
2021,190099,10,4,12,6,6
2021,190099,10,5,20,7,13
2021,190099,20,0,181,104,77
2021,190099,20,1,96,60,36
2021,190099,20,2,85,44,41
2021,190099,30,0,71,37,34
2021,190099,30,3,71,37,34
2021,190099,40,0,80,38,42
2021,190099,40,1,1,0,1
2021,190099,40,3,47,25,22
2021,190099,40,4,12,6,6
2021,190099,40,5,20,7,13
2021,190099,42,0,80,38,42
2021,190099,42,1,1,0,1
2021,190099,42,3,47,25,22
2021,190099,42,4,12,6,6
2021,190099,42,5,20,7,13
2021,190099,50,0,5,2,3
2021,190114,0,0,19,11,8
2021,190114,10,0,19,11,8
2021,190114,10,1,8,5,3
2021,190114,10,2,9,5,4
2021,190114,10,3,2,1,1
2021,190114,40,0,19,11,8
2021,190114,40,1,8,5,3
2021,190114,40,2,9,5,4
2021,190114,40,3,2,1,1
2021,190114,41,0,19,11,8
2021,190114,41,1,8,5,3
2021,190114,41,2,9,5,4
2021,190114,41,3,2,1,1
2021,190114,44,0,19,11,8
2021,190114,44,1,8,5,3
2021,190114,44,2,9,5,4
2021,190114,44,3,2,1,1
2021,190150,0,0,4484,2416,2068
2021,190150,10,0,4484,2416,2068
2021,190150,10,1,1447,1002,445
2021,190150,10,2,747,410,337
2021,190150,10,3,1671,717,954
2021,190150,10,4,135,63,72
2021,190150,10,5,484,224,260
2021,190150,20,0,1201,849,352
2021,190150,20,1,986,713,273
2021,190150,20,2,215,136,79
2021,190150,30,0,559,310,249
2021,190150,30,1,30,19,11
2021,190150,30,2,94,57,37
2021,190150,30,3,434,234,200
2021,190150,30,5,1,0,1
2021,190150,40,0,2724,1257,1467
2021,190150,40,1,431,270,161
2021,190150,40,2,438,217,221
2021,190150,40,3,1237,483,754
2021,190150,40,4,135,63,72
2021,190150,40,5,483,224,259
2021,190150,41,0,19,17,2
2021,190150,41,1,19,17,2
2021,190150,42,0,2529,1155,1374
2021,190150,42,1,404,247,157
2021,190150,42,2,424,208,216
2021,190150,42,3,1155,445,710
2021,190150,42,4,114,53,61
2021,190150,42,5,432,202,230
2021,190150,43,0,176,85,91
2021,190150,43,1,8,6,2
2021,190150,43,2,14,9,5
2021,190150,43,3,82,38,44
2021,190150,43,4,21,10,11
2021,190150,43,5,51,22,29
2021,190150,44,0,19,17,2
2021,190150,44,1,19,17,2
2021,190169,0,0,35,13,22
2021,190169,10,0,35,13,22
2021,190169,10,1,10,6,4
2021,190169,10,2,13,4,9
2021,190169,10,3,10,2,8
2021,190169,10,4,2,1,1
2021,190169,20,0,29,12,17
2021,190169,20,1,10,6,4
2021,190169,20,2,13,4,9
2021,190169,20,3,5,2,3
2021,190169,20,4,1,0,1
2021,190169,30,0,5,1,4
2021,190169,30,3,4,0,4
2021,190169,30,4,1,1,0
2021,190169,40,0,1,0,1
2021,190169,40,3,1,0,1
2021,190169,42,0,1,0,1
2021,190169,42,3,1,0,1
2021,190372,0,0,59,34,25
2021,190372,10,0,59,34,25
2021,190372,10,1,30,23,7
2021,190372,10,2,7,5,2
2021,190372,10,3,20,5,15
2021,190372,10,6,2,1,1
2021,190372,20,0,32,24,8
2021,190372,20,1,28,21,7
2021,190372,20,2,4,3,1
2021,190372,30,0,23,8,15
2021,190372,30,1,2,2,0
2021,190372,30,2,3,2,1
2021,190372,30,3,18,4,14
2021,190372,40,0,4,2,2
2021,190372,40,3,2,1,1
2021,190372,40,6,2,1,1
2021,190372,41,0,2,1,1
2021,190372,41,3,2,1,1
2021,190372,42,0,2,1,1
2021,190372,42,6,2,1,1
2021,190372,44,0,2,1,1
2021,190372,44,3,2,1,1
2021,190415,0,0,1875,1126,749
2021,190415,10,0,1875,1126,749
2021,190415,10,1,749,535,214
2021,190415,10,2,403,225,178
2021,190415,10,3,365,197,168
2021,190415,10,4,61,33,28
2021,190415,10,5,297,136,161
2021,190415,20,0,1036,709,327
2021,190415,20,1,687,506,181
2021,190415,20,2,349,203,146
2021,190415,30,0,364,196,168
2021,190415,30,1,10,4,6
2021,190415,30,2,23,11,12
2021,190415,30,3,331,181,150
2021,190415,40,0,475,221,254
2021,190415,40,1,52,25,27
2021,190415,40,2,31,11,20
2021,190415,40,3,34,16,18
2021,190415,40,4,61,33,28
2021,190415,40,5,297,136,161
2021,190415,41,0,362,173,189
2021,190415,41,1,47,24,23
2021,190415,41,2,28,11,17
2021,190415,41,3,28,14,14
2021,190415,41,4,24,15,9
2021,190415,41,5,235,109,126
2021,190415,42,0,86,32,54
2021,190415,42,1,4,0,4
2021,190415,42,2,3,0,3
2021,190415,42,3,5,1,4
2021,190415,42,4,26,11,15
2021,190415,42,5,48,20,28
2021,190415,43,0,27,16,11
2021,190415,43,1,1,1,0
2021,190415,43,3,1,1,0
2021,190415,43,4,11,7,4
2021,190415,43,5,14,7,7
2021,190415,44,0,362,173,189
2021,190415,44,1,47,24,23
2021,190415,44,2,28,11,17
2021,190415,44,3,28,14,14
2021,190415,44,4,24,15,9
2021,190415,44,5,235,109,126
2021,190424,0,0,2084,1098,986
2021,190424,10,0,2084,1098,986
2021,190424,10,1,286,205,81
2021,190424,10,2,324,195,129
2021,190424,10,3,1252,591,661
2021,190424,10,4,219,107,112
2021,190424,10,5,3,0,3
2021,190424,20,0,114,86,28
2021,190424,20,1,106,81,25
2021,190424,20,2,5,4,1
2021,190424,20,3,3,1,2
2021,190424,30,0,154,87,67
2021,190424,30,1,5,3,2
2021,190424,30,2,38,22,16
2021,190424,30,3,109,60,49
2021,190424,30,4,2,2,0
2021,190424,40,0,1816,925,891
2021,190424,40,1,175,121,54
2021,190424,40,2,281,169,112
2021,190424,40,3,1140,530,610
2021,190424,40,4,217,105,112
2021,190424,40,5,3,0,3
2021,190424,42,0,1816,925,891
2021,190424,42,1,175,121,54
2021,190424,42,2,281,169,112
2021,190424,42,3,1140,530,610
2021,190424,42,4,217,105,112
2021,190424,42,5,3,0,3
2021,190442,0,0,64,37,27
2021,190442,10,0,64,37,27
2021,190442,10,1,33,16,17
2021,190442,10,2,16,13,3
2021,190442,10,3,7,3,4
2021,190442,10,4,8,5,3
2021,190442,20,0,51,30,21
2021,190442,20,1,33,16,17
2021,190442,20,2,15,12,3
2021,190442,20,3,2,1,1
2021,190442,20,4,1,1,0
2021,190442,30,0,9,4,5
2021,190442,30,2,1,1,0
2021,190442,30,3,5,2,3
2021,190442,30,4,3,1,2
2021,190442,40,0,4,3,1
2021,190442,40,4,4,3,1
2021,190442,42,0,4,3,1
2021,190442,42,4,4,3,1
2021,190451,0,0,17,0,17
2021,190451,10,0,17,0,17
2021,190451,10,2,5,0,5
2021,190451,10,3,10,0,10
2021,190451,10,4,2,0,2
2021,190451,40,0,17,0,17
2021,190451,40,2,5,0,5
2021,190451,40,3,10,0,10
2021,190451,40,4,2,0,2
2021,190451,41,0,17,0,17
2021,190451,41,2,5,0,5
2021,190451,41,3,10,0,10
2021,190451,41,4,2,0,2
2021,190451,45,0,17,0,17
2021,190451,45,2,5,0,5
2021,190451,45,3,10,0,10
2021,190451,45,4,2,0,2
2021,190503,0,0,123,83,40
2021,190503,10,0,123,83,40
2021,190503,10,1,30,21,9
2021,190503,10,2,49,32,17
2021,190503,10,3,19,13,6
2021,190503,10,4,25,17,8
2021,190503,40,0,123,83,40
2021,190503,40,1,30,21,9
2021,190503,40,2,49,32,17
2021,190503,40,3,19,13,6
2021,190503,40,4,25,17,8
2021,190503,41,0,123,83,40
2021,190503,41,1,30,21,9
2021,190503,41,2,49,32,17
2021,190503,41,3,19,13,6
2021,190503,41,4,25,17,8
2021,190503,44,0,123,83,40
2021,190503,44,1,30,21,9
2021,190503,44,2,49,32,17
2021,190503,44,3,19,13,6
2021,190503,44,4,25,17,8
2021,190512,0,0,468,290,178
2021,190512,10,0,468,290,178
2021,190512,10,1,182,119,63
2021,190512,10,2,142,85,57
2021,190512,10,3,97,59,38
2021,190512,10,5,47,27,20
2021,190512,20,0,333,211,122
2021,190512,20,1,170,111,59
2021,190512,20,2,135,80,55
2021,190512,20,3,4,4,0
2021,190512,20,5,24,16,8
2021,190512,30,0,117,68,49
2021,190512,30,2,7,5,2
2021,190512,30,3,89,53,36
2021,190512,30,5,21,10,11
2021,190512,40,0,18,11,7
2021,190512,40,1,12,8,4
2021,190512,40,3,4,2,2
2021,190512,40,5,2,1,1
2021,190512,42,0,18,11,7
2021,190512,42,1,12,8,4
2021,190512,42,3,4,2,2
2021,190512,42,5,2,1,1
2021,190521,0,0,537,247,290
2021,190521,10,0,537,247,290
2021,190521,10,1,131,70,61
2021,190521,10,2,167,64,103
2021,190521,10,3,148,65,83
2021,190521,10,4,23,12,11
2021,190521,10,5,68,36,32
2021,190521,20,0,382,175,207
2021,190521,20,1,130,70,60
2021,190521,20,2,141,56,85
2021,190521,20,3,48,17,31
2021,190521,20,5,63,32,31
2021,190521,30,0,122,56,66
2021,190521,30,2,26,8,18
2021,190521,30,3,91,44,47
2021,190521,30,5,5,4,1
2021,190521,40,0,33,16,17
2021,190521,40,1,1,0,1
2021,190521,40,3,9,4,5
2021,190521,40,4,23,12,11
2021,190521,42,0,33,16,17
2021,190521,42,1,1,0,1
2021,190521,42,3,9,4,5
2021,190521,42,4,23,12,11
2021,190530,0,0,253,137,116
2021,190530,10,0,253,137,116
2021,190530,10,1,76,43,33
2021,190530,10,2,86,42,44
2021,190530,10,3,54,29,25
2021,190530,10,5,37,23,14
2021,190530,20,0,198,105,93
2021,190530,20,1,76,43,33
2021,190530,20,2,73,35,38
2021,190530,20,3,19,10,9
2021,190530,20,5,30,17,13
2021,190530,30,0,55,32,23
2021,190530,30,2,13,7,6
2021,190530,30,3,35,19,16
2021,190530,30,5,7,6,1
2021,190549,0,0,463,242,221
2021,190549,10,0,463,242,221
2021,190549,10,1,204,124,80
2021,190549,10,2,138,72,66
2021,190549,10,3,67,26,41
2021,190549,10,5,54,20,34
2021,190549,20,0,363,202,161
2021,190549,20,1,198,121,77
2021,190549,20,2,131,67,64
2021,190549,20,3,14,6,8
2021,190549,20,5,20,8,12
2021,190549,30,0,68,27,41
2021,190549,30,1,1,0,1
2021,190549,30,2,7,5,2
2021,190549,30,3,52,19,33
2021,190549,30,5,8,3,5
2021,190549,40,0,32,13,19
2021,190549,40,1,5,3,2
2021,190549,40,3,1,1,0
2021,190549,40,5,26,9,17
2021,190549,42,0,32,13,19
2021,190549,42,1,5,3,2
2021,190549,42,3,1,1,0
2021,190549,42,5,26,9,17
2021,190558,0,0,321,169,152
2021,190558,10,0,321,169,152
2021,190558,10,1,142,88,54
2021,190558,10,2,104,51,53
2021,190558,10,3,45,21,24
2021,190558,10,5,30,9,21
2021,190558,20,0,267,149,118
2021,190558,20,1,140,88,52
2021,190558,20,2,100,50,50
2021,190558,20,3,10,6,4
2021,190558,20,5,17,5,12
2021,190558,30,0,52,20,32
2021,190558,30,2,4,1,3
2021,190558,30,3,35,15,20
2021,190558,30,5,13,4,9
2021,190558,40,0,2,0,2
2021,190558,40,1,2,0,2
2021,190558,42,0,2,0,2
2021,190558,42,1,2,0,2
2021,190567,0,0,534,330,204
2021,190567,10,0,534,330,204
2021,190567,10,1,249,169,80
2021,190567,10,2,163,100,63
2021,190567,10,3,68,36,32
2021,190567,10,5,54,25,29
2021,190567,20,0,425,274,151
2021,190567,20,1,224,158,66
2021,190567,20,2,155,95,60
2021,190567,20,3,8,3,5
2021,190567,20,5,38,18,20
2021,190567,30,0,70,39,31
2021,190567,30,1,1,0,1
2021,190567,30,2,8,5,3
2021,190567,30,3,55,30,25
2021,190567,30,5,6,4,2
2021,190567,40,0,39,17,22
2021,190567,40,1,24,11,13
2021,190567,40,3,5,3,2
2021,190567,40,5,10,3,7
2021,190567,42,0,39,17,22
2021,190567,42,1,24,11,13
2021,190567,42,3,5,3,2
2021,190567,42,5,10,3,7
2021,190576,0,0,240,121,119
2021,190576,10,0,240,121,119
2021,190576,10,1,155,83,72
2021,190576,10,2,51,21,30
2021,190576,10,3,30,15,15
2021,190576,10,5,4,2,2
2021,190576,20,0,160,85,75
2021,190576,20,1,116,67,49
2021,190576,20,2,41,16,25
2021,190576,20,3,2,1,1
2021,190576,20,5,1,1,0
2021,190576,30,0,40,19,21
2021,190576,30,1,1,1,0
2021,190576,30,2,9,4,5
2021,190576,30,3,28,14,14
2021,190576,30,5,2,0,2
2021,190576,40,0,40,17,23
2021,190576,40,1,38,15,23
2021,190576,40,2,1,1,0
2021,190576,40,5,1,1,0
2021,190576,42,0,40,17,23
2021,190576,42,1,38,15,23
2021,190576,42,2,1,1,0
2021,190576,42,5,1,1,0
2021,190585,0,0,164,78,86
2021,190585,10,0,164,78,86
2021,190585,10,1,43,21,22
2021,190585,10,2,45,19,26
2021,190585,10,3,47,23,24
2021,190585,10,4,3,2,1
2021,190585,10,5,26,13,13
2021,190585,20,0,124,60,64
2021,190585,20,1,43,21,22
2021,190585,20,2,45,19,26
2021,190585,20,3,14,8,6
2021,190585,20,5,22,12,10
2021,190585,30,0,36,15,21
2021,190585,30,3,32,14,18
2021,190585,30,5,4,1,3
2021,190585,40,0,4,3,1
2021,190585,40,3,1,1,0
2021,190585,40,4,3,2,1
2021,190585,42,0,4,3,1
2021,190585,42,3,1,1,0
2021,190585,42,4,3,2,1
2021,190594,0,0,600,280,320
2021,190594,10,0,600,280,320
2021,190594,10,1,275,141,134
2021,190594,10,2,182,88,94
2021,190594,10,3,77,28,49
2021,190594,10,5,66,23,43
2021,190594,20,0,464,238,226
2021,190594,20,1,240,132,108
2021,190594,20,2,173,85,88
2021,190594,20,3,10,4,6
2021,190594,20,5,41,17,24
2021,190594,30,0,99,32,67
2021,190594,30,1,1,0,1
2021,190594,30,2,8,3,5
2021,190594,30,3,66,23,43
2021,190594,30,5,24,6,18
2021,190594,40,0,37,10,27
2021,190594,40,1,34,9,25
2021,190594,40,2,1,0,1
2021,190594,40,3,1,1,0
2021,190594,40,5,1,0,1
2021,190594,42,0,37,10,27
2021,190594,42,1,34,9,25
2021,190594,42,2,1,0,1
2021,190594,42,3,1,1,0
2021,190594,42,5,1,0,1
2021,190600,0,0,398,202,196
2021,190600,10,0,398,202,196
2021,190600,10,1,114,66,48
2021,190600,10,2,151,78,73
2021,190600,10,3,59,21,38
2021,190600,10,5,74,37,37
2021,190600,20,0,308,166,142
2021,190600,20,1,113,65,48
2021,190600,20,2,148,77,71
2021,190600,20,3,18,9,9
2021,190600,20,5,29,15,14
2021,190600,30,0,53,22,31
2021,190600,30,2,3,1,2
2021,190600,30,3,32,12,20
2021,190600,30,5,18,9,9
2021,190600,40,0,37,14,23
2021,190600,40,1,1,1,0
2021,190600,40,3,9,0,9
2021,190600,40,5,27,13,14
2021,190600,42,0,37,14,23
2021,190600,42,1,1,1,0
2021,190600,42,3,9,0,9
2021,190600,42,5,27,13,14
2021,190619,0,0,309,144,165
2021,190619,10,0,309,144,165
2021,190619,10,1,78,41,37
2021,190619,10,2,66,22,44
2021,190619,10,3,77,39,38
2021,190619,10,4,1,0,1
2021,190619,10,5,87,42,45
2021,190619,20,0,226,108,118
2021,190619,20,1,78,41,37
2021,190619,20,2,56,19,37
2021,190619,20,3,34,20,14
2021,190619,20,5,58,28,30
2021,190619,30,0,68,31,37
2021,190619,30,2,10,3,7
2021,190619,30,3,39,17,22
2021,190619,30,5,19,11,8
2021,190619,40,0,15,5,10
2021,190619,40,3,4,2,2
2021,190619,40,4,1,0,1
2021,190619,40,5,10,3,7
2021,190619,42,0,15,5,10
2021,190619,42,3,4,2,2
2021,190619,42,4,1,0,1
2021,190619,42,5,10,3,7
2021,190628,0,0,334,144,190
2021,190628,10,0,334,144,190
2021,190628,10,1,159,71,88
2021,190628,10,2,107,41,66
2021,190628,10,3,33,16,17
2021,190628,10,5,35,16,19
2021,190628,20,0,267,120,147
2021,190628,20,1,159,71,88
2021,190628,20,2,76,34,42
2021,190628,20,3,2,1,1
2021,190628,20,5,30,14,16
2021,190628,30,0,64,22,42
2021,190628,30,2,31,7,24
2021,190628,30,3,28,13,15
2021,190628,30,5,5,2,3
2021,190628,40,0,3,2,1
2021,190628,40,3,3,2,1
2021,190628,42,0,3,2,1
2021,190628,42,3,3,2,1
2021,190637,0,0,366,161,205
2021,190637,10,0,366,161,205
2021,190637,10,1,100,58,42
2021,190637,10,2,112,43,69
2021,190637,10,3,86,38,48
2021,190637,10,4,2,1,1
2021,190637,10,5,66,21,45
2021,190637,20,0,249,114,135
2021,190637,20,1,97,57,40
2021,190637,20,2,106,41,65
2021,190637,20,3,7,4,3
2021,190637,20,5,39,12,27
2021,190637,30,0,98,39,59
2021,190637,30,2,6,2,4
2021,190637,30,3,77,33,44
2021,190637,30,5,15,4,11
2021,190637,40,0,19,8,11
2021,190637,40,1,3,1,2
2021,190637,40,3,2,1,1
2021,190637,40,4,2,1,1
2021,190637,40,5,12,5,7
2021,190637,42,0,19,8,11
2021,190637,42,1,3,1,2
2021,190637,42,3,2,1,1
2021,190637,42,4,2,1,1
2021,190637,42,5,12,5,7
2021,190646,0,0,151,79,72
2021,190646,10,0,151,79,72
2021,190646,10,1,42,25,17
2021,190646,10,2,31,15,16
2021,190646,10,3,45,20,25
2021,190646,10,4,1,1,0
2021,190646,10,5,32,18,14
2021,190646,20,0,91,54,37
2021,190646,20,1,41,24,17
2021,190646,20,2,25,12,13
2021,190646,20,3,7,4,3
2021,190646,20,5,18,14,4
2021,190646,30,0,38,14,24
2021,190646,30,1,1,1,0
2021,190646,30,2,6,3,3
2021,190646,30,3,27,10,17
2021,190646,30,5,4,0,4
2021,190646,40,0,22,11,11
2021,190646,40,3,11,6,5
2021,190646,40,4,1,1,0
2021,190646,40,5,10,4,6
2021,190646,42,0,22,11,11
2021,190646,42,3,11,6,5
2021,190646,42,4,1,1,0
2021,190646,42,5,10,4,6
2021,190655,0,0,355,182,173
2021,190655,10,0,355,182,173
2021,190655,10,1,91,46,45
2021,190655,10,2,150,79,71
2021,190655,10,3,96,47,49
2021,190655,10,5,18,10,8
2021,190655,20,0,295,157,138
2021,190655,20,1,90,45,45
2021,190655,20,2,137,72,65
2021,190655,20,3,52,32,20
2021,190655,20,5,16,8,8
2021,190655,30,0,56,23,33
2021,190655,30,2,13,7,6
2021,190655,30,3,41,14,27
2021,190655,30,5,2,2,0
2021,190655,40,0,4,2,2
2021,190655,40,1,1,1,0
2021,190655,40,3,3,1,2
2021,190655,42,0,4,2,2
2021,190655,42,1,1,1,0
2021,190655,42,3,3,1,2
2021,190664,0,0,548,284,264
2021,190664,10,0,548,284,264
2021,190664,10,1,193,124,69
2021,190664,10,2,158,69,89
2021,190664,10,3,90,45,45
2021,190664,10,4,2,2,0
2021,190664,10,5,105,44,61
2021,190664,20,0,408,213,195
2021,190664,20,1,185,120,65
2021,190664,20,2,148,64,84
2021,190664,20,3,10,4,6
2021,190664,20,5,65,25,40
2021,190664,30,0,109,56,53
2021,190664,30,1,1,0,1
2021,190664,30,2,9,5,4
2021,190664,30,3,76,39,37
2021,190664,30,5,23,12,11
2021,190664,40,0,31,15,16
2021,190664,40,1,7,4,3
2021,190664,40,2,1,0,1
2021,190664,40,3,4,2,2
2021,190664,40,4,2,2,0
2021,190664,40,5,17,7,10
2021,190664,42,0,31,15,16
2021,190664,42,1,7,4,3
2021,190664,42,2,1,0,1
2021,190664,42,3,4,2,2
2021,190664,42,4,2,2,0
2021,190664,42,5,17,7,10
2021,190673,0,0,371,179,192
2021,190673,10,0,371,179,192
2021,190673,10,1,80,33,47
2021,190673,10,2,135,72,63
2021,190673,10,3,86,39,47
2021,190673,10,5,70,35,35
2021,190673,20,0,273,138,135
2021,190673,20,1,80,33,47
2021,190673,20,2,135,72,63
2021,190673,20,3,4,3,1
2021,190673,20,5,54,30,24
2021,190673,30,0,98,41,57
2021,190673,30,3,82,36,46
2021,190673,30,5,16,5,11
2021,190682,0,0,55,19,36
2021,190682,10,0,55,19,36
2021,190682,10,1,32,13,19
2021,190682,10,2,13,3,10
2021,190682,10,3,2,1,1
2021,190682,10,4,8,2,6
2021,190682,20,0,28,11,17
2021,190682,20,1,28,11,17
2021,190682,30,0,14,3,11
2021,190682,30,1,1,0,1
2021,190682,30,2,13,3,10
2021,190682,40,0,13,5,8
2021,190682,40,1,3,2,1
2021,190682,40,3,2,1,1
2021,190682,40,4,8,2,6
2021,190682,42,0,13,5,8
2021,190682,42,1,3,2,1
2021,190682,42,3,2,1,1
2021,190682,42,4,8,2,6
2021,190691,0,0,186,92,94
2021,190691,10,0,186,92,94
2021,190691,10,1,56,29,27
2021,190691,10,2,61,31,30
2021,190691,10,3,43,19,24
2021,190691,10,5,26,13,13
2021,190691,20,0,129,71,58
2021,190691,20,1,50,28,22
2021,190691,20,2,58,30,28
2021,190691,20,3,7,6,1
2021,190691,20,5,14,7,7
2021,190691,30,0,48,18,30
2021,190691,30,2,3,1,2
2021,190691,30,3,36,13,23
2021,190691,30,5,9,4,5
2021,190691,40,0,9,3,6
2021,190691,40,1,6,1,5
2021,190691,40,5,3,2,1
2021,190691,42,0,9,3,6
2021,190691,42,1,6,1,5
2021,190691,42,5,3,2,1
2021,190716,0,0,165,59,106
2021,190716,10,0,165,59,106
2021,190716,10,1,23,11,12
2021,190716,10,2,81,29,52
2021,190716,10,3,59,18,41
2021,190716,10,4,2,1,1
2021,190716,20,0,78,32,46
2021,190716,20,1,23,11,12
2021,190716,20,2,55,21,34
2021,190716,30,0,13,8,5
2021,190716,30,3,13,8,5
2021,190716,40,0,74,19,55
2021,190716,40,2,26,8,18
2021,190716,40,3,46,10,36
2021,190716,40,4,2,1,1
2021,190716,41,0,64,16,48
2021,190716,41,2,24,7,17
2021,190716,41,3,39,9,30
2021,190716,41,4,1,0,1
2021,190716,42,0,10,3,7
2021,190716,42,2,2,1,1
2021,190716,42,3,7,1,6
2021,190716,42,4,1,1,0
2021,190716,44,0,64,16,48
2021,190716,44,2,24,7,17
2021,190716,44,3,39,9,30
2021,190716,44,4,1,0,1
2021,190725,0,0,142,49,93
2021,190725,10,0,142,49,93
2021,190725,10,1,13,6,7
2021,190725,10,2,56,20,36
2021,190725,10,3,56,17,39
2021,190725,10,4,9,4,5
2021,190725,10,6,8,2,6
2021,190725,20,0,65,26,39
2021,190725,20,1,13,6,7
2021,190725,20,2,52,20,32
2021,190725,30,0,40,13,27
2021,190725,30,2,4,0,4
2021,190725,30,3,36,13,23
2021,190725,40,0,37,10,27
2021,190725,40,3,20,4,16
2021,190725,40,4,9,4,5
2021,190725,40,6,8,2,6
2021,190725,42,0,21,6,15
2021,190725,42,3,14,3,11
2021,190725,42,4,2,1,1
2021,190725,42,6,5,2,3
2021,190725,43,0,16,4,12
2021,190725,43,3,6,1,5
2021,190725,43,4,7,3,4
2021,190725,43,6,3,0,3
2021,190761,0,0,70,26,44
2021,190761,10,0,70,26,44
2021,190761,10,1,5,1,4
2021,190761,10,2,16,6,10
2021,190761,10,3,41,17,24
2021,190761,10,4,8,2,6
2021,190761,20,0,37,12,25
2021,190761,20,1,5,1,4
2021,190761,20,2,16,6,10
2021,190761,20,3,16,5,11
2021,190761,30,0,13,7,6
2021,190761,30,3,12,6,6
2021,190761,30,4,1,1,0
2021,190761,40,0,20,7,13
2021,190761,40,3,13,6,7
2021,190761,40,4,7,1,6
2021,190761,42,0,20,7,13
2021,190761,42,3,13,6,7
2021,190761,42,4,7,1,6
2021,190840,0,0,104,46,58
2021,190840,10,0,104,46,58
2021,190840,10,1,27,13,14
2021,190840,10,2,21,6,15
2021,190840,10,3,34,16,18
2021,190840,10,4,20,10,10
2021,190840,10,5,2,1,1
2021,190840,20,0,84,40,44
2021,190840,20,1,27,13,14
2021,190840,20,2,21,6,15
2021,190840,20,3,28,15,13
2021,190840,20,4,8,6,2
2021,190840,30,0,17,4,13
2021,190840,30,3,6,1,5
2021,190840,30,4,9,2,7
2021,190840,30,5,2,1,1
2021,190840,40,0,3,2,1
2021,190840,40,4,3,2,1
2021,190840,42,0,1,1,0
2021,190840,42,4,1,1,0
2021,190840,43,0,2,1,1
2021,190840,43,4,2,1,1
2021,190956,0,0,13,0,13
2021,190956,10,0,13,0,13
2021,190956,10,4,13,0,13
2021,190956,40,0,13,0,13
2021,190956,40,4,13,0,13
2021,190956,41,0,13,0,13
2021,190956,41,4,13,0,13
2021,190956,45,0,13,0,13
2021,190956,45,4,13,0,13
2021,190983,0,0,69,31,38
2021,190983,10,0,69,31,38
2021,190983,10,1,6,3,3
2021,190983,10,2,23,12,11
2021,190983,10,3,30,12,18
2021,190983,10,4,5,1,4
2021,190983,10,5,5,3,2
2021,190983,20,0,28,14,14
2021,190983,20,1,6,3,3
2021,190983,20,2,22,11,11
2021,190983,30,0,31,13,18
2021,190983,30,2,1,1,0
2021,190983,30,3,30,12,18
2021,190983,40,0,10,4,6
2021,190983,40,4,5,1,4
2021,190983,40,5,5,3,2
2021,190983,41,0,3,2,1
2021,190983,41,5,3,2,1
2021,190983,42,0,7,2,5
2021,190983,42,4,5,1,4
2021,190983,42,5,2,1,1
2021,190983,44,0,3,2,1
2021,190983,44,5,3,2,1
2021,191083,0,0,258,126,132
2021,191083,10,0,258,126,132
2021,191083,10,1,109,51,58
2021,191083,10,2,32,17,15
2021,191083,10,3,39,20,19
2021,191083,10,4,78,38,40
2021,191083,20,0,227,110,117
2021,191083,20,1,109,51,58
2021,191083,20,2,32,17,15
2021,191083,20,3,39,20,19
2021,191083,20,4,47,22,25
2021,191083,30,0,31,16,15
2021,191083,30,4,31,16,15
2021,191126,0,0,196,83,113
2021,191126,10,0,196,83,113
2021,191126,10,1,62,29,33
2021,191126,10,2,64,31,33
2021,191126,10,3,70,23,47
2021,191126,20,0,179,78,101
2021,191126,20,1,60,29,31
2021,191126,20,2,60,28,32
2021,191126,20,3,59,21,38
2021,191126,30,0,17,5,12
2021,191126,30,1,2,0,2
2021,191126,30,2,4,3,1
2021,191126,30,3,11,2,9
2021,191199,0,0,105,55,50
2021,191199,10,0,105,55,50
2021,191199,10,1,37,22,15
2021,191199,10,2,26,11,15
2021,191199,10,3,32,19,13
2021,191199,10,4,10,3,7
2021,191199,20,0,66,37,29
2021,191199,20,1,37,22,15
2021,191199,20,2,19,9,10
2021,191199,20,3,10,6,4
2021,191199,30,0,39,18,21
2021,191199,30,2,7,2,5
2021,191199,30,3,22,13,9
2021,191199,30,4,10,3,7
2021,191205,0,0,25,11,14
2021,191205,10,0,25,11,14
2021,191205,10,1,9,4,5
2021,191205,10,2,5,3,2
2021,191205,10,3,8,3,5
2021,191205,10,4,3,1,2
2021,191205,40,0,25,11,14
2021,191205,40,1,9,4,5
2021,191205,40,2,5,3,2
2021,191205,40,3,8,3,5
2021,191205,40,4,3,1,2
2021,191205,42,0,19,8,11
2021,191205,42,1,8,4,4
2021,191205,42,2,5,3,2
2021,191205,42,3,4,1,3
2021,191205,42,4,2,0,2
2021,191205,43,0,6,3,3
2021,191205,43,1,1,0,1
2021,191205,43,3,4,2,2
2021,191205,43,4,1,1,0
2021,191241,0,0,733,388,345
2021,191241,10,0,566,314,252
2021,191241,10,1,239,153,86
2021,191241,10,2,202,109,93
2021,191241,10,3,114,45,69
2021,191241,10,4,11,7,4
2021,191241,20,0,444,265,179
2021,191241,20,1,239,153,86
2021,191241,20,2,195,107,88
2021,191241,20,3,10,5,5
2021,191241,30,0,111,42,69
2021,191241,30,2,7,2,5
2021,191241,30,3,104,40,64
2021,191241,40,0,11,7,4
2021,191241,40,4,11,7,4
2021,191241,41,0,5,4,1
2021,191241,41,4,5,4,1
2021,191241,42,0,5,3,2
2021,191241,42,4,5,3,2
2021,191241,43,0,1,0,1
2021,191241,43,4,1,0,1
2021,191241,44,0,5,4,1
2021,191241,44,4,5,4,1
2021,191241,50,0,167,74,93
2021,191302,0,0,36,20,16
2021,191302,10,0,36,20,16
2021,191302,10,1,7,6,1
2021,191302,10,2,4,3,1
2021,191302,10,3,23,11,12
2021,191302,10,4,2,0,2
2021,191302,20,0,34,20,14
2021,191302,20,1,7,6,1
2021,191302,20,2,4,3,1
2021,191302,20,3,23,11,12
2021,191302,30,0,2,0,2
2021,191302,30,4,2,0,2
2021,191320,0,0,5,3,2
2021,191320,10,0,5,3,2
2021,191320,10,1,4,2,2
2021,191320,10,2,1,1,0
2021,191320,40,0,5,3,2
2021,191320,40,1,4,2,2
2021,191320,40,2,1,1,0
2021,191320,41,0,5,3,2
2021,191320,41,1,4,2,2
2021,191320,41,2,1,1,0
2021,191320,44,0,5,3,2
2021,191320,44,1,4,2,2
2021,191320,44,2,1,1,0
2021,191339,0,0,73,26,47
2021,191339,10,0,73,26,47
2021,191339,10,1,22,6,16
2021,191339,10,2,18,7,11
2021,191339,10,3,14,6,8
2021,191339,10,4,19,7,12
2021,191339,40,0,73,26,47
2021,191339,40,1,22,6,16
2021,191339,40,2,18,7,11
2021,191339,40,3,14,6,8
2021,191339,40,4,19,7,12
2021,191339,41,0,58,21,37
2021,191339,41,1,22,6,16
2021,191339,41,2,18,7,11
2021,191339,41,3,14,6,8
2021,191339,41,4,4,2,2
2021,191339,42,0,15,5,10
2021,191339,42,4,15,5,10
2021,191339,44,0,58,21,37
2021,191339,44,1,22,6,16
2021,191339,44,2,18,7,11
2021,191339,44,3,14,6,8
2021,191339,44,4,4,2,2
2021,191515,0,0,219,104,115
2021,191515,10,0,216,102,114
2021,191515,10,1,65,36,29
2021,191515,10,2,43,19,24
2021,191515,10,3,63,26,37
2021,191515,10,4,45,21,24
2021,191515,20,0,106,55,51
2021,191515,20,1,65,36,29
2021,191515,20,2,41,19,22
2021,191515,30,0,56,20,36
2021,191515,30,3,56,20,36
2021,191515,40,0,54,27,27
2021,191515,40,2,2,0,2
2021,191515,40,3,7,6,1
2021,191515,40,4,45,21,24
2021,191515,41,0,26,13,13
2021,191515,41,2,2,0,2
2021,191515,41,3,7,6,1
2021,191515,41,4,17,7,10
2021,191515,42,0,28,14,14
2021,191515,42,4,28,14,14
2021,191515,44,0,11,6,5
2021,191515,44,4,11,6,5
2021,191515,45,0,15,7,8
2021,191515,45,2,2,0,2
2021,191515,45,3,7,6,1
2021,191515,45,4,6,1,5
2021,191515,50,0,3,2,1
2021,191533,0,0,95,48,47
2021,191533,10,0,95,48,47
2021,191533,10,1,32,21,11
2021,191533,10,2,20,9,11
2021,191533,10,3,42,18,24
2021,191533,10,4,1,0,1
2021,191533,20,0,48,30,18
2021,191533,20,1,32,21,11
2021,191533,20,2,16,9,7
2021,191533,30,0,29,12,17
2021,191533,30,2,3,0,3
2021,191533,30,3,26,12,14
2021,191533,40,0,18,6,12
2021,191533,40,2,1,0,1
2021,191533,40,3,16,6,10
2021,191533,40,4,1,0,1
2021,191533,42,0,18,6,12
2021,191533,42,2,1,0,1
2021,191533,42,3,16,6,10
2021,191533,42,4,1,0,1
2021,191597,0,0,18,4,14
2021,191597,10,0,18,4,14
2021,191597,10,2,10,2,8
2021,191597,10,3,7,2,5
2021,191597,10,4,1,0,1
2021,191597,40,0,18,4,14
2021,191597,40,2,10,2,8
2021,191597,40,3,7,2,5
2021,191597,40,4,1,0,1
2021,191597,42,0,18,4,14
2021,191597,42,2,10,2,8
2021,191597,42,3,7,2,5
2021,191597,42,4,1,0,1
2021,191612,0,0,43,23,20
2021,191612,10,0,43,23,20
2021,191612,10,1,10,5,5
2021,191612,10,2,10,3,7
2021,191612,10,3,20,13,7
2021,191612,10,4,3,2,1
2021,191612,20,0,36,20,16
2021,191612,20,1,10,5,5
2021,191612,20,2,9,3,6
2021,191612,20,3,14,10,4
2021,191612,20,4,3,2,1
2021,191612,30,0,7,3,4
2021,191612,30,2,1,0,1
2021,191612,30,3,6,3,3
2021,191621,0,0,41,22,19
2021,191621,10,0,41,22,19
2021,191621,10,1,11,8,3
2021,191621,10,2,14,7,7
2021,191621,10,3,15,7,8
2021,191621,10,4,1,0,1
2021,191621,20,0,13,9,4
2021,191621,20,1,9,6,3
2021,191621,20,2,3,2,1
2021,191621,20,3,1,1,0
2021,191621,30,0,11,6,5
2021,191621,30,2,2,2,0
2021,191621,30,3,9,4,5
2021,191621,40,0,17,7,10
2021,191621,40,1,2,2,0
2021,191621,40,2,9,3,6
2021,191621,40,3,5,2,3
2021,191621,40,4,1,0,1
2021,191621,41,0,12,5,7
2021,191621,41,1,2,2,0
2021,191621,41,2,9,3,6
2021,191621,41,3,1,0,1
2021,191621,42,0,5,2,3
2021,191621,42,3,4,2,2
2021,191621,42,4,1,0,1
2021,191621,44,0,12,5,7
2021,191621,44,1,2,2,0
2021,191621,44,2,9,3,6
2021,191621,44,3,1,0,1
2021,191630,0,0,196,98,98
2021,191630,10,0,195,98,97
2021,191630,10,1,47,29,18
2021,191630,10,2,84,39,45
2021,191630,10,3,47,22,25
2021,191630,10,4,6,1,5
2021,191630,10,6,11,7,4
2021,191630,20,0,131,68,63
2021,191630,20,1,47,29,18
2021,191630,20,2,84,39,45
2021,191630,30,0,40,17,23
2021,191630,30,3,40,17,23
2021,191630,40,0,24,13,11
2021,191630,40,3,7,5,2
2021,191630,40,4,6,1,5
2021,191630,40,6,11,7,4
2021,191630,41,0,17,10,7
2021,191630,41,3,7,5,2
2021,191630,41,4,6,1,5
2021,191630,41,6,4,4,0
2021,191630,42,0,7,3,4
2021,191630,42,6,7,3,4
2021,191630,44,0,17,10,7
2021,191630,44,3,7,5,2
2021,191630,44,4,6,1,5
2021,191630,44,6,4,4,0
2021,191630,50,0,1,0,1
2021,191649,0,0,491,266,225
2021,191649,10,0,491,266,225
2021,191649,10,1,213,126,87
2021,191649,10,2,161,92,69
2021,191649,10,3,115,47,68
2021,191649,10,4,2,1,1
2021,191649,20,0,334,195,139
2021,191649,20,1,197,119,78
2021,191649,20,2,137,76,61
2021,191649,30,0,82,43,39
2021,191649,30,1,1,1,0
2021,191649,30,2,9,7,2
2021,191649,30,3,72,35,37
2021,191649,40,0,75,28,47
2021,191649,40,1,15,6,9
2021,191649,40,2,15,9,6
2021,191649,40,3,43,12,31
2021,191649,40,4,2,1,1
2021,191649,41,0,52,18,34
2021,191649,41,1,14,6,8
2021,191649,41,2,10,7,3
2021,191649,41,3,26,4,22
2021,191649,41,4,2,1,1
2021,191649,42,0,16,7,9
2021,191649,42,2,5,2,3
2021,191649,42,3,11,5,6
2021,191649,43,0,7,3,4
2021,191649,43,1,1,0,1
2021,191649,43,3,6,3,3
2021,191649,44,0,25,7,18
2021,191649,44,1,10,4,6
2021,191649,44,3,15,3,12
2021,191649,45,0,27,11,16
2021,191649,45,1,4,2,2
2021,191649,45,2,10,7,3
2021,191649,45,3,11,1,10
2021,191649,45,4,2,1,1
2021,191676,0,0,63,38,25
2021,191676,10,0,63,38,25
2021,191676,10,1,24,19,5
2021,191676,10,2,12,6,6
2021,191676,10,3,27,13,14
2021,191676,20,0,29,21,8
2021,191676,20,1,21,16,5
2021,191676,20,2,7,4,3
2021,191676,20,3,1,1,0
2021,191676,30,0,21,12,9
2021,191676,30,1,1,1,0
2021,191676,30,2,3,2,1
2021,191676,30,3,17,9,8
2021,191676,40,0,13,5,8
2021,191676,40,1,2,2,0
2021,191676,40,2,2,0,2
2021,191676,40,3,9,3,6
2021,191676,42,0,13,5,8
2021,191676,42,1,2,2,0
2021,191676,42,2,2,0,2
2021,191676,42,3,9,3,6
2021,191719,0,0,209,97,112
2021,191719,10,0,209,97,112
2021,191719,10,1,31,15,16
2021,191719,10,2,36,10,26
2021,191719,10,3,90,48,42
2021,191719,10,4,52,24,28
2021,191719,20,0,157,73,84
2021,191719,20,1,31,15,16
2021,191719,20,2,36,10,26
2021,191719,20,3,90,48,42
2021,191719,30,0,52,24,28
2021,191719,30,4,52,24,28
2021,191931,0,0,167,88,79
2021,191931,10,0,167,88,79
2021,191931,10,1,37,28,9
2021,191931,10,2,58,28,30
2021,191931,10,3,41,15,26
2021,191931,10,4,4,2,2
2021,191931,10,5,27,15,12
2021,191931,20,0,95,55,40
2021,191931,20,1,36,27,9
2021,191931,20,2,58,28,30
2021,191931,20,3,1,0,1
2021,191931,30,0,39,15,24
2021,191931,30,3,39,15,24
2021,191931,40,0,33,18,15
2021,191931,40,1,1,1,0
2021,191931,40,3,1,0,1
2021,191931,40,4,4,2,2
2021,191931,40,5,27,15,12
2021,191931,43,0,33,18,15
2021,191931,43,1,1,1,0
2021,191931,43,3,1,0,1
2021,191931,43,4,4,2,2
2021,191931,43,5,27,15,12
2021,191968,0,0,428,210,218
2021,191968,10,0,428,210,218
2021,191968,10,1,100,54,46
2021,191968,10,2,149,75,74
2021,191968,10,3,160,68,92
2021,191968,10,4,18,13,5
2021,191968,10,5,1,0,1
2021,191968,20,0,231,120,111
2021,191968,20,1,93,49,44
2021,191968,20,2,138,71,67
2021,191968,30,0,79,36,43
2021,191968,30,3,79,36,43
2021,191968,40,0,118,54,64
2021,191968,40,1,7,5,2
2021,191968,40,2,11,4,7
2021,191968,40,3,81,32,49
2021,191968,40,4,18,13,5
2021,191968,40,5,1,0,1
2021,191968,41,0,100,44,56
2021,191968,41,1,6,4,2
2021,191968,41,2,11,4,7
2021,191968,41,3,71,29,42
2021,191968,41,4,12,7,5
2021,191968,42,0,18,10,8
2021,191968,42,1,1,1,0
2021,191968,42,3,10,3,7
2021,191968,42,4,6,6,0
2021,191968,42,5,1,0,1
2021,191968,44,0,100,44,56
2021,191968,44,1,6,4,2
2021,191968,44,2,11,4,7
2021,191968,44,3,71,29,42
2021,191968,44,4,12,7,5
2021,191986,0,0,53,26,27
2021,191986,10,0,53,26,27
2021,191986,10,1,14,6,8
2021,191986,10,2,12,5,7
2021,191986,10,3,21,12,9
2021,191986,10,4,6,3,3
2021,191986,20,0,41,20,21
2021,191986,20,1,14,6,8
2021,191986,20,2,12,5,7
2021,191986,20,3,15,9,6
2021,191986,30,0,12,6,6
2021,191986,30,3,6,3,3
2021,191986,30,4,6,3,3
2021,192022,0,0,61,31,30
2021,192022,10,0,61,31,30
2021,192022,10,1,15,8,7
2021,192022,10,2,17,8,9
2021,192022,10,3,21,11,10
2021,192022,10,4,6,2,4
2021,192022,10,6,2,2,0
2021,192022,20,0,49,27,22
2021,192022,20,1,14,8,6
2021,192022,20,2,17,8,9
2021,192022,20,3,17,10,7
2021,192022,20,4,1,1,0
2021,192022,30,0,10,3,7
2021,192022,30,3,4,1,3
2021,192022,30,4,5,1,4
2021,192022,30,6,1,1,0
2021,192022,40,0,2,1,1
2021,192022,40,1,1,0,1
2021,192022,40,6,1,1,0
2021,192022,43,0,2,1,1
2021,192022,43,1,1,0,1
2021,192022,43,6,1,1,0
2021,192040,0,0,27,18,9
2021,192040,10,0,27,18,9
2021,192040,10,1,15,12,3
2021,192040,10,2,5,4,1
2021,192040,10,3,5,2,3
2021,192040,10,5,2,0,2
2021,192040,20,0,20,16,4
2021,192040,20,1,15,12,3
2021,192040,20,2,5,4,1
2021,192040,30,0,1,0,1
2021,192040,30,3,1,0,1
2021,192040,40,0,6,2,4
2021,192040,40,3,4,2,2
2021,192040,40,5,2,0,2
2021,192040,41,0,3,1,2
2021,192040,41,3,2,1,1
2021,192040,41,5,1,0,1
2021,192040,42,0,2,0,2
2021,192040,42,3,1,0,1
2021,192040,42,5,1,0,1
2021,192040,43,0,1,1,0
2021,192040,43,3,1,1,0
2021,192040,44,0,3,1,2
2021,192040,44,3,2,1,1
2021,192040,44,5,1,0,1
2021,192110,0,0,128,75,53
2021,192110,10,0,128,75,53
2021,192110,10,6,128,75,53
2021,192110,40,0,128,75,53
2021,192110,40,6,128,75,53
2021,192110,41,0,87,53,34
2021,192110,41,6,87,53,34
2021,192110,42,0,41,22,19
2021,192110,42,6,41,22,19
2021,192110,44,0,87,53,34
2021,192110,44,6,87,53,34
2021,192192,0,0,62,21,41
2021,192192,10,0,62,21,41
2021,192192,10,1,16,7,9
2021,192192,10,2,20,7,13
2021,192192,10,3,22,6,16
2021,192192,10,4,4,1,3
2021,192192,20,0,34,14,20
2021,192192,20,1,16,7,9
2021,192192,20,2,18,7,11
2021,192192,30,0,21,5,16
2021,192192,30,2,2,0,2
2021,192192,30,3,19,5,14
2021,192192,40,0,7,2,5
2021,192192,40,3,3,1,2
2021,192192,40,4,4,1,3
2021,192192,42,0,7,2,5
2021,192192,42,3,3,1,2
2021,192192,42,4,4,1,3
2021,192271,0,0,16,6,10
2021,192271,10,0,16,6,10
2021,192271,10,2,4,1,3
2021,192271,10,3,5,2,3
2021,192271,10,4,1,1,0
2021,192271,10,5,6,2,4
2021,192271,40,0,16,6,10
2021,192271,40,2,4,1,3
2021,192271,40,3,5,2,3
2021,192271,40,4,1,1,0
2021,192271,40,5,6,2,4
2021,192271,41,0,16,6,10
2021,192271,41,2,4,1,3
2021,192271,41,3,5,2,3
2021,192271,41,4,1,1,0
2021,192271,41,5,6,2,4
2021,192271,45,0,16,6,10
2021,192271,45,2,4,1,3
2021,192271,45,3,5,2,3
2021,192271,45,4,1,1,0
2021,192271,45,5,6,2,4
2021,192323,0,0,179,96,83
2021,192323,10,0,179,96,83
2021,192323,10,1,50,31,19
2021,192323,10,2,56,29,27
2021,192323,10,3,35,17,18
2021,192323,10,4,38,19,19
2021,192323,20,0,104,58,46
2021,192323,20,1,50,31,19
2021,192323,20,2,54,27,27
2021,192323,30,0,27,13,14
2021,192323,30,2,2,2,0
2021,192323,30,3,25,11,14
2021,192323,40,0,48,25,23
2021,192323,40,3,10,6,4
2021,192323,40,4,38,19,19
2021,192323,41,0,37,18,19
2021,192323,41,4,37,18,19
2021,192323,42,0,11,7,4
2021,192323,42,3,10,6,4
2021,192323,42,4,1,1,0
2021,192323,44,0,37,18,19
2021,192323,44,4,37,18,19
2021,192448,0,0,408,188,220
2021,192448,10,0,408,188,220
2021,192448,10,1,123,70,53
2021,192448,10,2,139,68,71
2021,192448,10,3,138,47,91
2021,192448,10,4,8,3,5
2021,192448,20,0,203,114,89
2021,192448,20,1,106,61,45
2021,192448,20,2,97,53,44
2021,192448,30,0,60,25,35
2021,192448,30,1,3,2,1
2021,192448,30,2,14,7,7
2021,192448,30,3,42,15,27
2021,192448,30,4,1,1,0
2021,192448,40,0,145,49,96
2021,192448,40,1,14,7,7
2021,192448,40,2,28,8,20
2021,192448,40,3,96,32,64
2021,192448,40,4,7,2,5
2021,192448,41,0,3,0,3
2021,192448,41,2,3,0,3
2021,192448,42,0,142,49,93
2021,192448,42,1,14,7,7
2021,192448,42,2,25,8,17
2021,192448,42,3,96,32,64
2021,192448,42,4,7,2,5
2021,192448,44,0,3,0,3
2021,192448,44,2,3,0,3
2021,192509,0,0,14,3,11
2021,192509,10,0,14,3,11
2021,192509,10,4,14,3,11
2021,192509,40,0,14,3,11
2021,192509,40,4,14,3,11
2021,192509,41,0,14,3,11
2021,192509,41,4,14,3,11
2021,192509,45,0,14,3,11
2021,192509,45,4,14,3,11
2021,192688,0,0,14,8,6
2021,192688,10,0,14,8,6
2021,192688,10,1,14,8,6
2021,192688,40,0,14,8,6
2021,192688,40,1,14,8,6
2021,192688,41,0,14,8,6
2021,192688,41,1,14,8,6
2021,192688,45,0,14,8,6
2021,192688,45,1,14,8,6
2021,192703,0,0,233,126,107
2021,192703,10,0,233,126,107
2021,192703,10,1,76,45,31
2021,192703,10,2,83,49,34
2021,192703,10,3,73,32,41
2021,192703,10,4,1,0,1
2021,192703,20,0,159,91,68
2021,192703,20,1,74,44,30
2021,192703,20,2,77,44,33
2021,192703,20,3,8,3,5
2021,192703,30,0,54,23,31
2021,192703,30,1,1,0,1
2021,192703,30,2,3,3,0
2021,192703,30,3,50,20,30
2021,192703,40,0,20,12,8
2021,192703,40,1,1,1,0
2021,192703,40,2,3,2,1
2021,192703,40,3,15,9,6
2021,192703,40,4,1,0,1
2021,192703,42,0,20,12,8
2021,192703,42,1,1,1,0
2021,192703,42,2,3,2,1
2021,192703,42,3,15,9,6
2021,192703,42,4,1,0,1
2021,192712,0,0,83,55,28
2021,192712,10,0,83,55,28
2021,192712,10,4,83,55,28
2021,192712,40,0,83,55,28
2021,192712,40,4,83,55,28
2021,192712,41,0,83,55,28
2021,192712,41,4,83,55,28
2021,192712,44,0,83,55,28
2021,192712,44,4,83,55,28
2021,192749,0,0,117,51,66
2021,192749,10,0,117,51,66
2021,192749,10,1,47,27,20
2021,192749,10,2,34,11,23
2021,192749,10,3,21,5,16
2021,192749,10,4,1,0,1
2021,192749,10,5,14,8,6
2021,192749,20,0,69,32,37
2021,192749,20,1,47,27,20
2021,192749,20,2,21,5,16
2021,192749,20,3,1,0,1
2021,192749,30,0,18,7,11
2021,192749,30,2,5,3,2
2021,192749,30,3,13,4,9
2021,192749,40,0,30,12,18
2021,192749,40,2,8,3,5
2021,192749,40,3,7,1,6
2021,192749,40,4,1,0,1
2021,192749,40,5,14,8,6
2021,192749,41,0,1,1,0
2021,192749,41,5,1,1,0
2021,192749,42,0,29,11,18
2021,192749,42,2,8,3,5
2021,192749,42,3,7,1,6
2021,192749,42,4,1,0,1
2021,192749,42,5,13,7,6
2021,192749,44,0,1,1,0
2021,192749,44,5,1,1,0
2021,192785,0,0,33,9,24
2021,192785,10,0,33,9,24
2021,192785,10,1,2,1,1
2021,192785,10,2,7,3,4
2021,192785,10,3,8,5,3
2021,192785,10,4,15,0,15
2021,192785,10,6,1,0,1
2021,192785,40,0,33,9,24
2021,192785,40,1,2,1,1
2021,192785,40,2,7,3,4
2021,192785,40,3,8,5,3
2021,192785,40,4,15,0,15
2021,192785,40,6,1,0,1
2021,192785,42,0,17,5,12
2021,192785,42,1,1,0,1
2021,192785,42,2,6,3,3
2021,192785,42,3,2,2,0
2021,192785,42,4,7,0,7
2021,192785,42,6,1,0,1
2021,192785,43,0,16,4,12
2021,192785,43,1,1,1,0
2021,192785,43,2,1,0,1
2021,192785,43,3,6,3,3
2021,192785,43,4,8,0,8
2021,192819,0,0,225,104,121
2021,192819,10,0,225,104,121
2021,192819,10,1,25,16,9
2021,192819,10,2,64,35,29
2021,192819,10,3,42,17,25
2021,192819,10,4,7,3,4
2021,192819,10,5,68,26,42
2021,192819,10,6,19,7,12
2021,192819,20,0,90,50,40
2021,192819,20,1,25,16,9
2021,192819,20,2,58,30,28
2021,192819,20,3,7,4,3
2021,192819,30,0,39,17,22
2021,192819,30,2,5,4,1
2021,192819,30,3,34,13,21
2021,192819,40,0,96,37,59
2021,192819,40,2,1,1,0
2021,192819,40,3,1,0,1
2021,192819,40,4,7,3,4
2021,192819,40,5,68,26,42
2021,192819,40,6,19,7,12
2021,192819,42,0,96,37,59
2021,192819,42,2,1,1,0
2021,192819,42,3,1,0,1
2021,192819,42,4,7,3,4
2021,192819,42,5,68,26,42
2021,192819,42,6,19,7,12
2021,192864,0,0,84,29,55
2021,192864,10,0,84,29,55
2021,192864,10,1,26,9,17
2021,192864,10,2,31,11,20
2021,192864,10,3,23,5,18
2021,192864,10,4,4,4,0
2021,192864,20,0,57,20,37
2021,192864,20,1,26,9,17
2021,192864,20,2,31,11,20
2021,192864,30,0,18,3,15
2021,192864,30,3,18,3,15
2021,192864,40,0,9,6,3
2021,192864,40,3,5,2,3
2021,192864,40,4,4,4,0
2021,192864,42,0,9,6,3
2021,192864,42,3,5,2,3
2021,192864,42,4,4,4,0
2021,192925,0,0,66,26,40
2021,192925,10,0,66,26,40
2021,192925,10,1,9,8,1
2021,192925,10,2,10,5,5
2021,192925,10,3,46,13,33
2021,192925,10,4,1,0,1
2021,192925,20,0,15,10,5
2021,192925,20,1,9,8,1
2021,192925,20,2,6,2,4
2021,192925,40,0,51,16,35
2021,192925,40,2,4,3,1
2021,192925,40,3,46,13,33
2021,192925,40,4,1,0,1
2021,192925,42,0,51,16,35
2021,192925,42,2,4,3,1
2021,192925,42,3,46,13,33
2021,192925,42,4,1,0,1
2021,193016,0,0,232,84,148
2021,193016,10,0,232,84,148
2021,193016,10,1,28,12,16
2021,193016,10,2,68,30,38
2021,193016,10,3,121,36,85
2021,193016,10,4,15,6,9
2021,193016,20,0,68,27,41
2021,193016,20,1,24,11,13
2021,193016,20,2,36,14,22
2021,193016,20,3,8,2,6
2021,193016,30,0,30,14,16
2021,193016,30,1,1,0,1
2021,193016,30,2,4,2,2
2021,193016,30,3,25,12,13
2021,193016,40,0,134,43,91
2021,193016,40,1,3,1,2
2021,193016,40,2,28,14,14
2021,193016,40,3,88,22,66
2021,193016,40,4,15,6,9
2021,193016,41,0,80,32,48
2021,193016,41,1,3,1,2
2021,193016,41,2,28,14,14
2021,193016,41,3,46,14,32
2021,193016,41,4,3,3,0
2021,193016,42,0,54,11,43
2021,193016,42,3,42,8,34
2021,193016,42,4,12,3,9
2021,193016,44,0,80,32,48
2021,193016,44,1,3,1,2
2021,193016,44,2,28,14,14
2021,193016,44,3,46,14,32
2021,193016,44,4,3,3,0
2021,193052,0,0,10,10,0
2021,193052,10,0,9,9,0
2021,193052,10,1,5,5,0
2021,193052,10,2,3,3,0
2021,193052,10,4,1,1,0
2021,193052,40,0,9,9,0
2021,193052,40,1,5,5,0
2021,193052,40,2,3,3,0
2021,193052,40,4,1,1,0
2021,193052,41,0,6,6,0
2021,193052,41,1,3,3,0
2021,193052,41,2,2,2,0
2021,193052,41,4,1,1,0
2021,193052,42,0,1,1,0
2021,193052,42,1,1,1,0
2021,193052,43,0,2,2,0
2021,193052,43,1,1,1,0
2021,193052,43,2,1,1,0
2021,193052,44,0,2,2,0
2021,193052,44,1,1,1,0
2021,193052,44,2,1,1,0
2021,193052,45,0,4,4,0
2021,193052,45,1,2,2,0
2021,193052,45,2,1,1,0
2021,193052,45,4,1,1,0
2021,193052,50,0,1,1,0
2021,193201,0,0,6,1,5
2021,193201,50,0,6,1,5
2021,193247,0,0,16,16,0
2021,193247,10,0,15,15,0
2021,193247,10,1,4,4,0
2021,193247,10,2,3,3,0
2021,193247,10,3,4,4,0
2021,193247,10,5,4,4,0
2021,193247,20,0,15,15,0
2021,193247,20,1,4,4,0
2021,193247,20,2,3,3,0
2021,193247,20,3,4,4,0
2021,193247,20,5,4,4,0
2021,193247,50,0,1,1,0
2021,193283,0,0,116,67,49
2021,193283,10,0,116,67,49
2021,193283,10,1,25,15,10
2021,193283,10,2,37,20,17
2021,193283,10,3,30,19,11
2021,193283,10,4,24,13,11
2021,193283,20,0,88,50,38
2021,193283,20,1,25,15,10
2021,193283,20,2,37,20,17
2021,193283,20,3,23,13,10
2021,193283,20,4,3,2,1
2021,193283,30,0,25,16,9
2021,193283,30,3,7,6,1
2021,193283,30,4,18,10,8
2021,193283,40,0,3,1,2
2021,193283,40,4,3,1,2
2021,193283,42,0,2,1,1
2021,193283,42,4,2,1,1
2021,193283,43,0,1,0,1
2021,193283,43,4,1,0,1
2021,193292,0,0,191,50,141
2021,193292,10,0,191,50,141
2021,193292,10,1,52,13,39
2021,193292,10,2,52,14,38
2021,193292,10,3,75,18,57
2021,193292,10,4,12,5,7
2021,193292,20,0,118,29,89
2021,193292,20,1,52,13,39
2021,193292,20,2,46,12,34
2021,193292,20,3,20,4,16
2021,193292,30,0,73,21,52
2021,193292,30,2,6,2,4
2021,193292,30,3,55,14,41
2021,193292,30,4,12,5,7
2021,193308,0,0,199,76,123
2021,193308,10,0,199,76,123
2021,193308,10,4,199,76,123
2021,193308,40,0,199,76,123
2021,193308,40,4,199,76,123
2021,193308,41,0,199,76,123
2021,193308,41,4,199,76,123
2021,193308,45,0,199,76,123
2021,193308,45,4,199,76,123
2021,193326,0,0,234,100,134
2021,193326,10,0,234,100,134
2021,193326,10,1,83,27,56
2021,193326,10,2,70,34,36
2021,193326,10,3,49,23,26
2021,193326,10,4,22,8,14
2021,193326,10,5,10,8,2
2021,193326,20,0,177,72,105
2021,193326,20,1,80,27,53
2021,193326,20,2,61,29,32
2021,193326,20,3,36,16,20
2021,193326,30,0,41,17,24
2021,193326,30,1,3,0,3
2021,193326,30,2,8,5,3
2021,193326,30,3,11,6,5
2021,193326,30,4,18,5,13
2021,193326,30,5,1,1,0
2021,193326,40,0,16,11,5
2021,193326,40,2,1,0,1
2021,193326,40,3,2,1,1
2021,193326,40,4,4,3,1
2021,193326,40,5,9,7,2
2021,193326,42,0,16,11,5
2021,193326,42,2,1,0,1
2021,193326,42,3,2,1,1
2021,193326,42,4,4,3,1
2021,193326,42,5,9,7,2
2021,193353,0,0,82,36,46
2021,193353,10,0,82,36,46
2021,193353,10,1,24,13,11
2021,193353,10,2,29,12,17
2021,193353,10,3,19,10,9
2021,193353,10,4,9,1,8
2021,193353,10,5,1,0,1
2021,193353,20,0,50,25,25
2021,193353,20,1,24,13,11
2021,193353,20,2,26,12,14
2021,193353,30,0,31,11,20
2021,193353,30,2,3,0,3
2021,193353,30,3,19,10,9
2021,193353,30,4,9,1,8
2021,193353,40,0,1,0,1
2021,193353,40,5,1,0,1
2021,193353,42,0,1,0,1
2021,193353,42,5,1,0,1
2021,193399,0,0,68,31,37
2021,193399,10,0,68,31,37
2021,193399,10,1,12,6,6
2021,193399,10,2,27,12,15
2021,193399,10,3,24,12,12
2021,193399,10,4,5,1,4
2021,193399,20,0,39,19,20
2021,193399,20,1,12,6,6
2021,193399,20,2,24,12,12
2021,193399,20,3,3,1,2
2021,193399,30,0,21,9,12
2021,193399,30,2,3,0,3
2021,193399,30,3,18,9,9
2021,193399,40,0,8,3,5
2021,193399,40,3,3,2,1
2021,193399,40,4,5,1,4
2021,193399,42,0,8,3,5
2021,193399,42,3,3,2,1
2021,193399,42,4,5,1,4
2021,193405,0,0,3466,1871,1595
2021,193405,10,0,3466,1871,1595
2021,193405,10,1,563,387,176
2021,193405,10,2,654,388,266
2021,193405,10,3,1970,960,1010
2021,193405,10,4,279,136,143
2021,193405,20,0,293,195,98
2021,193405,20,1,270,179,91
2021,193405,20,2,23,16,7
2021,193405,30,0,2032,1099,933
2021,193405,30,1,230,164,66
2021,193405,30,2,411,244,167
2021,193405,30,3,1387,689,698
2021,193405,30,4,4,2,2
2021,193405,40,0,1141,577,564
2021,193405,40,1,63,44,19
2021,193405,40,2,220,128,92
2021,193405,40,3,583,271,312
2021,193405,40,4,275,134,141
2021,193405,42,0,1141,577,564
2021,193405,42,1,63,44,19
2021,193405,42,2,220,128,92
2021,193405,42,3,583,271,312
2021,193405,42,4,275,134,141
2021,193478,0,0,336,125,211
2021,193478,10,0,336,125,211
2021,193478,10,1,148,54,94
2021,193478,10,2,79,28,51
2021,193478,10,3,67,36,31
2021,193478,10,4,25,7,18
2021,193478,10,5,10,0,10
2021,193478,10,6,7,0,7
2021,193478,20,0,304,117,187
2021,193478,20,1,147,53,94
2021,193478,20,2,79,28,51
2021,193478,20,3,67,36,31
2021,193478,20,5,10,0,10
2021,193478,20,6,1,0,1
2021,193478,30,0,20,7,13
2021,193478,30,1,1,1,0
2021,193478,30,4,19,6,13
2021,193478,40,0,12,1,11
2021,193478,40,4,6,1,5
2021,193478,40,6,6,0,6
2021,193478,42,0,12,1,11
2021,193478,42,4,6,1,5
2021,193478,42,6,6,0,6
2021,193584,0,0,174,65,109
2021,193584,10,0,174,65,109
2021,193584,10,1,62,26,36
2021,193584,10,2,47,19,28
2021,193584,10,3,62,19,43
2021,193584,10,4,1,1,0
2021,193584,10,5,2,0,2
2021,193584,20,0,97,42,55
2021,193584,20,1,62,26,36
2021,193584,20,2,34,15,19
2021,193584,20,3,1,1,0
2021,193584,30,0,24,8,16
2021,193584,30,3,24,8,16
2021,193584,40,0,53,15,38
2021,193584,40,2,13,4,9
2021,193584,40,3,37,10,27
2021,193584,40,4,1,1,0
2021,193584,40,5,2,0,2
2021,193584,42,0,53,15,38
2021,193584,42,2,13,4,9
2021,193584,42,3,37,10,27
2021,193584,42,4,1,1,0
2021,193584,42,5,2,0,2
2021,193654,0,0,399,199,200
2021,193654,10,0,384,192,192
2021,193654,10,1,94,57,37
2021,193654,10,2,138,68,70
2021,193654,10,3,150,66,84
2021,193654,10,4,1,1,0
2021,193654,10,5,1,0,1
2021,193654,20,0,138,75,63
2021,193654,20,1,71,44,27
2021,193654,20,2,67,31,36
2021,193654,30,0,37,17,20
2021,193654,30,2,3,3,0
2021,193654,30,3,34,14,20
2021,193654,40,0,209,100,109
2021,193654,40,1,23,13,10
2021,193654,40,2,68,34,34
2021,193654,40,3,116,52,64
2021,193654,40,4,1,1,0
2021,193654,40,5,1,0,1
2021,193654,41,0,182,85,97
2021,193654,41,1,18,10,8
2021,193654,41,2,66,33,33
2021,193654,41,3,97,42,55
2021,193654,41,5,1,0,1
2021,193654,42,0,23,13,10
2021,193654,42,1,2,2,0
2021,193654,42,2,2,1,1
2021,193654,42,3,18,9,9
2021,193654,42,4,1,1,0
2021,193654,43,0,4,2,2
2021,193654,43,1,3,1,2
2021,193654,43,3,1,1,0
2021,193654,44,0,182,85,97
2021,193654,44,1,18,10,8
2021,193654,44,2,66,33,33
2021,193654,44,3,97,42,55
2021,193654,44,5,1,0,1
2021,193654,50,0,15,7,8
2021,193751,0,0,39,22,17
2021,193751,10,0,36,21,15
2021,193751,10,1,8,5,3
2021,193751,10,2,11,6,5
2021,193751,10,3,11,7,4
2021,193751,10,4,6,3,3
2021,193751,40,0,36,21,15
2021,193751,40,1,8,5,3
2021,193751,40,2,11,6,5
2021,193751,40,3,11,7,4
2021,193751,40,4,6,3,3
2021,193751,41,0,34,20,14
2021,193751,41,1,8,5,3
2021,193751,41,2,11,6,5
2021,193751,41,3,11,7,4
2021,193751,41,4,4,2,2
2021,193751,42,0,2,1,1
2021,193751,42,4,2,1,1
2021,193751,44,0,34,20,14
2021,193751,44,1,8,5,3
2021,193751,44,2,11,6,5
2021,193751,44,3,11,7,4
2021,193751,44,4,4,2,2
2021,193751,50,0,3,1,2
2021,193821,0,0,47,24,23
2021,193821,10,0,47,24,23
2021,193821,10,1,32,19,13
2021,193821,10,2,8,2,6
2021,193821,10,3,4,1,3
2021,193821,10,4,3,2,1
2021,193821,20,0,30,17,13
2021,193821,20,1,30,17,13
2021,193821,30,0,2,1,1
2021,193821,30,2,2,1,1
2021,193821,40,0,15,6,9
2021,193821,40,1,2,2,0
2021,193821,40,2,6,1,5
2021,193821,40,3,4,1,3
2021,193821,40,4,3,2,1
2021,193821,41,0,1,0,1
2021,193821,41,2,1,0,1
2021,193821,42,0,14,6,8
2021,193821,42,1,2,2,0
2021,193821,42,2,5,1,4
2021,193821,42,3,4,1,3
2021,193821,42,4,3,2,1
2021,193821,44,0,1,0,1
2021,193821,44,2,1,0,1
2021,193830,0,0,328,221,107
2021,193830,10,0,328,221,107
2021,193830,10,1,112,95,17
2021,193830,10,2,72,46,26
2021,193830,10,3,125,69,56
2021,193830,10,4,19,11,8
2021,193830,20,0,69,58,11
2021,193830,20,1,60,52,8
2021,193830,20,2,7,5,2
2021,193830,20,3,2,1,1
2021,193830,30,0,259,163,96
2021,193830,30,1,52,43,9
2021,193830,30,2,65,41,24
2021,193830,30,3,123,68,55
2021,193830,30,4,19,11,8
2021,193858,0,0,2,0,2
2021,193858,10,0,2,0,2
2021,193858,10,4,2,0,2
2021,193858,40,0,2,0,2
2021,193858,40,4,2,0,2
2021,193858,43,0,2,0,2
2021,193858,43,4,2,0,2
2021,193894,0,0,10,7,3
2021,193894,10,0,10,7,3
2021,193894,10,1,3,2,1
2021,193894,10,2,7,5,2
2021,193894,40,0,10,7,3
2021,193894,40,1,3,2,1
2021,193894,40,2,7,5,2
2021,193894,42,0,10,7,3
2021,193894,42,1,3,2,1
2021,193894,42,2,7,5,2
2021,193900,0,0,5968,3326,2642
2021,193900,10,0,5968,3326,2642
2021,193900,10,1,1472,1017,455
2021,193900,10,2,1032,602,430
2021,193900,10,3,1684,814,870
2021,193900,10,4,517,274,243
2021,193900,10,5,1186,589,597
2021,193900,10,6,77,30,47
2021,193900,20,0,1469,964,505
2021,193900,20,1,1015,710,305
2021,193900,20,2,424,239,185
2021,193900,20,3,1,1,0
2021,193900,20,6,29,14,15
2021,193900,30,0,413,209,204
2021,193900,30,1,10,6,4
2021,193900,30,2,67,42,25
2021,193900,30,3,312,154,158
2021,193900,30,6,24,7,17
2021,193900,40,0,4086,2153,1933
2021,193900,40,1,447,301,146
2021,193900,40,2,541,321,220
2021,193900,40,3,1371,659,712
2021,193900,40,4,517,274,243
2021,193900,40,5,1186,589,597
2021,193900,40,6,24,9,15
2021,193900,41,0,4086,2153,1933
2021,193900,41,1,447,301,146
2021,193900,41,2,541,321,220
2021,193900,41,3,1371,659,712
2021,193900,41,4,517,274,243
2021,193900,41,5,1186,589,597
2021,193900,41,6,24,9,15
2021,193900,45,0,4086,2153,1933
2021,193900,45,1,447,301,146
2021,193900,45,2,541,321,220
2021,193900,45,3,1371,659,712
2021,193900,45,4,517,274,243
2021,193900,45,5,1186,589,597
2021,193900,45,6,24,9,15
2021,193946,0,0,84,39,45
2021,193946,10,0,84,39,45
2021,193946,10,1,44,21,23
2021,193946,10,2,15,7,8
2021,193946,10,3,12,5,7
2021,193946,10,4,13,6,7
2021,193946,20,0,68,31,37
2021,193946,20,1,44,21,23
2021,193946,20,2,15,7,8
2021,193946,20,3,9,3,6
2021,193946,30,0,14,8,6
2021,193946,30,3,3,2,1
2021,193946,30,4,11,6,5
2021,193946,40,0,2,0,2
2021,193946,40,4,2,0,2
2021,193946,42,0,2,0,2
2021,193946,42,4,2,0,2
2021,193973,0,0,175,97,78
2021,193973,10,0,175,97,78
2021,193973,10,1,46,29,17
2021,193973,10,2,64,39,25
2021,193973,10,3,37,18,19
2021,193973,10,4,7,4,3
2021,193973,10,6,21,7,14
2021,193973,20,0,107,65,42
2021,193973,20,1,46,29,17
2021,193973,20,2,60,35,25
2021,193973,20,3,1,1,0
2021,193973,30,0,40,21,19
2021,193973,30,2,4,4,0
2021,193973,30,3,36,17,19
2021,193973,40,0,28,11,17
2021,193973,40,4,7,4,3
2021,193973,40,6,21,7,14
2021,193973,41,0,8,3,5
2021,193973,41,6,8,3,5
2021,193973,42,0,20,8,12
2021,193973,42,4,7,4,3
2021,193973,42,6,13,4,9
2021,193973,44,0,8,3,5
2021,193973,44,6,8,3,5
2021,194028,0,0,40,10,30
2021,194028,10,0,40,10,30
2021,194028,10,1,4,1,3
2021,194028,10,2,11,2,9
2021,194028,10,3,6,1,5
2021,194028,10,4,19,6,13
2021,194028,20,0,21,6,15
2021,194028,20,1,4,1,3
2021,194028,20,2,9,1,8
2021,194028,20,3,4,1,3
2021,194028,20,4,4,3,1
2021,194028,30,0,10,3,7
2021,194028,30,2,2,1,1
2021,194028,30,3,2,0,2
2021,194028,30,4,6,2,4
2021,194028,40,0,9,1,8
2021,194028,40,4,9,1,8
2021,194028,42,0,9,1,8
2021,194028,42,4,9,1,8
2021,194073,0,0,29,14,15
2021,194073,10,0,29,14,15
2021,194073,10,1,9,7,2
2021,194073,10,2,8,4,4
2021,194073,10,3,2,1,1
2021,194073,10,4,10,2,8
2021,194073,40,0,29,14,15
2021,194073,40,1,9,7,2
2021,194073,40,2,8,4,4
2021,194073,40,3,2,1,1
2021,194073,40,4,10,2,8
2021,194073,42,0,29,14,15
2021,194073,42,1,9,7,2
2021,194073,42,2,8,4,4
2021,194073,42,3,2,1,1
2021,194073,42,4,10,2,8
2021,194091,0,0,316,181,135
2021,194091,10,0,308,177,131
2021,194091,10,1,52,39,13
2021,194091,10,2,146,79,67
2021,194091,10,3,103,53,50
2021,194091,10,4,5,5,0
2021,194091,10,6,2,1,1
2021,194091,20,0,126,78,48
2021,194091,20,1,42,31,11
2021,194091,20,2,82,45,37
2021,194091,20,3,2,2,0
2021,194091,30,0,57,32,25
2021,194091,30,1,1,0,1
2021,194091,30,2,7,5,2
2021,194091,30,3,48,26,22
2021,194091,30,4,1,1,0
2021,194091,40,0,125,67,58
2021,194091,40,1,9,8,1
2021,194091,40,2,57,29,28
2021,194091,40,3,53,25,28
2021,194091,40,4,4,4,0
2021,194091,40,6,2,1,1
2021,194091,41,0,125,67,58
2021,194091,41,1,9,8,1
2021,194091,41,2,57,29,28
2021,194091,41,3,53,25,28
2021,194091,41,4,4,4,0
2021,194091,41,6,2,1,1
2021,194091,44,0,125,67,58
2021,194091,44,1,9,8,1
2021,194091,44,2,57,29,28
2021,194091,44,3,53,25,28
2021,194091,44,4,4,4,0
2021,194091,44,6,2,1,1
2021,194091,50,0,8,4,4
2021,194161,0,0,51,26,25
2021,194161,10,0,51,26,25
2021,194161,10,1,22,10,12
2021,194161,10,2,12,8,4
2021,194161,10,3,11,5,6
2021,194161,10,5,6,3,3
2021,194161,20,0,12,6,6
2021,194161,20,1,12,6,6
2021,194161,30,0,33,17,16
2021,194161,30,1,10,4,6
2021,194161,30,2,12,8,4
2021,194161,30,3,11,5,6
2021,194161,40,0,6,3,3
2021,194161,40,5,6,3,3
2021,194161,42,0,6,3,3
2021,194161,42,5,6,3,3
2021,194222,0,0,165,76,89
2021,194222,10,0,159,72,87
2021,194222,10,1,78,32,46
2021,194222,10,2,43,17,26
2021,194222,10,3,28,17,11
2021,194222,10,4,10,6,4
2021,194222,20,0,135,59,76
2021,194222,20,1,78,32,46
2021,194222,20,2,43,17,26
2021,194222,20,3,12,9,3
2021,194222,20,4,2,1,1
2021,194222,30,0,14,6,8
2021,194222,30,3,12,5,7
2021,194222,30,4,2,1,1
2021,194222,40,0,10,7,3
2021,194222,40,3,4,3,1
2021,194222,40,4,6,4,2
2021,194222,41,0,8,5,3
2021,194222,41,3,2,1,1
2021,194222,41,4,6,4,2
2021,194222,42,0,2,2,0
2021,194222,42,3,2,2,0
2021,194222,44,0,8,5,3
2021,194222,44,3,2,1,1
2021,194222,44,4,6,4,2
2021,194222,50,0,6,4,2
2021,194240,0,0,121,50,71
2021,194240,10,0,121,50,71
2021,194240,10,1,40,20,20
2021,194240,10,2,28,9,19
2021,194240,10,3,33,15,18
2021,194240,10,4,20,6,14
2021,194240,20,0,103,46,57
2021,194240,20,1,40,20,20
2021,194240,20,2,27,9,18
2021,194240,20,3,30,15,15
2021,194240,20,4,6,2,4
2021,194240,30,0,11,3,8
2021,194240,30,4,11,3,8
2021,194240,40,0,7,1,6
2021,194240,40,2,1,0,1
2021,194240,40,3,3,0,3
2021,194240,40,4,3,1,2
2021,194240,42,0,7,1,6
2021,194240,42,2,1,0,1
2021,194240,42,3,3,0,3
2021,194240,42,4,3,1,2
2021,194310,0,0,476,198,278
2021,194310,10,0,476,198,278
2021,194310,10,1,190,97,93
2021,194310,10,2,140,52,88
2021,194310,10,3,104,35,69
2021,194310,10,4,1,1,0
2021,194310,10,5,40,12,28
2021,194310,10,6,1,1,0
2021,194310,20,0,284,132,152
2021,194310,20,1,175,85,90
2021,194310,20,2,104,44,60
2021,194310,20,3,5,3,2
2021,194310,30,0,61,17,44
2021,194310,30,2,5,1,4
2021,194310,30,3,55,15,40
2021,194310,30,5,1,1,0
2021,194310,40,0,131,49,82
2021,194310,40,1,15,12,3
2021,194310,40,2,31,7,24
2021,194310,40,3,44,17,27
2021,194310,40,4,1,1,0
2021,194310,40,5,39,11,28
2021,194310,40,6,1,1,0
2021,194310,42,0,131,49,82
2021,194310,42,1,15,12,3
2021,194310,42,2,31,7,24
2021,194310,42,3,44,17,27
2021,194310,42,4,1,1,0
2021,194310,42,5,39,11,28
2021,194310,42,6,1,1,0
2021,194392,0,0,45,25,20
2021,194392,10,0,41,23,18
2021,194392,10,1,14,7,7
2021,194392,10,2,10,5,5
2021,194392,10,3,10,6,4
2021,194392,10,5,7,5,2
2021,194392,40,0,41,23,18
2021,194392,40,1,14,7,7
2021,194392,40,2,10,5,5
2021,194392,40,3,10,6,4
2021,194392,40,5,7,5,2
2021,194392,41,0,25,11,14
2021,194392,41,1,14,7,7
2021,194392,41,2,7,3,4
2021,194392,41,3,4,1,3
2021,194392,42,0,13,9,4
2021,194392,42,2,3,2,1
2021,194392,42,3,6,5,1
2021,194392,42,5,4,2,2
2021,194392,43,0,3,3,0
2021,194392,43,5,3,3,0
2021,194392,44,0,25,11,14
2021,194392,44,1,14,7,7
2021,194392,44,2,7,3,4
2021,194392,44,3,4,1,3
2021,194392,50,0,4,2,2
2021,194499,0,0,30,9,21
2021,194499,10,0,30,9,21
2021,194499,10,6,30,9,21
2021,194499,40,0,30,9,21
2021,194499,40,6,30,9,21
2021,194499,43,0,30,9,21
2021,194499,43,6,30,9,21
2021,194578,0,0,169,79,90
2021,194578,10,0,169,79,90
2021,194578,10,1,86,43,43
2021,194578,10,2,51,26,25
2021,194578,10,3,32,10,22
2021,194578,20,0,117,58,59
2021,194578,20,1,78,39,39
2021,194578,20,2,37,19,18
2021,194578,20,3,2,0,2
2021,194578,30,0,42,18,24
2021,194578,30,1,6,2,4
2021,194578,30,2,13,7,6
2021,194578,30,3,23,9,14
2021,194578,40,0,10,3,7
2021,194578,40,1,2,2,0
2021,194578,40,2,1,0,1
2021,194578,40,3,7,1,6
2021,194578,41,0,10,3,7
2021,194578,41,1,2,2,0
2021,194578,41,2,1,0,1
2021,194578,41,3,7,1,6
2021,194578,44,0,10,3,7
2021,194578,44,1,2,2,0
2021,194578,44,2,1,0,1
2021,194578,44,3,7,1,6
2021,194736,0,0,8,8,0
2021,194736,10,0,8,8,0
2021,194736,10,4,8,8,0
2021,194736,40,0,8,8,0
2021,194736,40,4,8,8,0
2021,194736,42,0,8,8,0
2021,194736,42,4,8,8,0
2021,194763,0,0,14,14,0
2021,194763,10,0,14,14,0
2021,194763,10,1,3,3,0
2021,194763,10,2,7,7,0
2021,194763,10,3,4,4,0
2021,194763,20,0,13,13,0
2021,194763,20,1,3,3,0
2021,194763,20,2,6,6,0
2021,194763,20,3,4,4,0
2021,194763,30,0,1,1,0
2021,194763,30,2,1,1,0
2021,194824,0,0,405,297,108
2021,194824,10,0,397,294,103
2021,194824,10,1,166,138,28
2021,194824,10,2,76,49,27
2021,194824,10,3,47,34,13
2021,194824,10,5,108,73,35
2021,194824,20,0,227,174,53
2021,194824,20,1,151,125,26
2021,194824,20,2,76,49,27
2021,194824,30,0,47,34,13
2021,194824,30,3,47,34,13
2021,194824,40,0,123,86,37
2021,194824,40,1,15,13,2
2021,194824,40,5,108,73,35
2021,194824,41,0,123,86,37
2021,194824,41,1,15,13,2
2021,194824,41,5,108,73,35
2021,194824,44,0,123,86,37
2021,194824,44,1,15,13,2
2021,194824,44,5,108,73,35
2021,194824,50,0,8,3,5
2021,194958,0,0,88,31,57
2021,194958,10,0,88,31,57
2021,194958,10,1,29,18,11
2021,194958,10,2,25,6,19
2021,194958,10,3,31,7,24
2021,194958,10,5,3,0,3
2021,194958,20,0,46,19,27
2021,194958,20,1,28,17,11
2021,194958,20,2,17,2,15
2021,194958,20,3,1,0,1
2021,194958,30,0,35,11,24
2021,194958,30,1,1,1,0
2021,194958,30,2,7,4,3
2021,194958,30,3,27,6,21
2021,194958,40,0,7,1,6
2021,194958,40,2,1,0,1
2021,194958,40,3,3,1,2
2021,194958,40,5,3,0,3
2021,194958,42,0,7,1,6
2021,194958,42,2,1,0,1
2021,194958,42,3,3,1,2
2021,194958,42,5,3,0,3
2021,195003,0,0,1033,650,383
2021,195003,10,0,1033,650,383
2021,195003,10,1,254,184,70
2021,195003,10,2,262,167,95
2021,195003,10,3,174,101,73
2021,195003,10,5,343,198,145
2021,195003,20,0,514,351,163
2021,195003,20,1,250,181,69
2021,195003,20,2,257,166,91
2021,195003,20,3,7,4,3
2021,195003,30,0,159,93,66
2021,195003,30,2,3,1,2
2021,195003,30,3,156,92,64
2021,195003,40,0,360,206,154
2021,195003,40,1,4,3,1
2021,195003,40,2,2,0,2
2021,195003,40,3,11,5,6
2021,195003,40,5,343,198,145
2021,195003,41,0,185,100,85
2021,195003,41,5,185,100,85
2021,195003,42,0,175,106,69
2021,195003,42,1,4,3,1
2021,195003,42,2,2,0,2
2021,195003,42,3,11,5,6
2021,195003,42,5,158,98,60
2021,195003,44,0,185,100,85
2021,195003,44,5,185,100,85
2021,195030,0,0,2567,1495,1072
2021,195030,10,0,2567,1495,1072
2021,195030,10,1,685,503,182
2021,195030,10,2,675,401,274
2021,195030,10,3,856,443,413
2021,195030,10,4,229,106,123
2021,195030,10,5,33,18,15
2021,195030,10,6,89,24,65
2021,195030,20,0,573,416,157
2021,195030,20,1,413,312,101
2021,195030,20,2,160,104,56
2021,195030,30,0,798,428,370
2021,195030,30,1,95,68,27
2021,195030,30,2,131,72,59
2021,195030,30,3,487,247,240
2021,195030,30,4,85,41,44
2021,195030,40,0,1196,651,545
2021,195030,40,1,177,123,54
2021,195030,40,2,384,225,159
2021,195030,40,3,369,196,173
2021,195030,40,4,144,65,79
2021,195030,40,5,33,18,15
2021,195030,40,6,89,24,65
2021,195030,41,0,1146,636,510
2021,195030,41,1,177,123,54
2021,195030,41,2,384,225,159
2021,195030,41,3,368,195,173
2021,195030,41,4,140,64,76
2021,195030,41,5,12,8,4
2021,195030,41,6,65,21,44
2021,195030,42,0,50,15,35
2021,195030,42,3,1,1,0
2021,195030,42,4,4,1,3
2021,195030,42,5,21,10,11
2021,195030,42,6,24,3,21
2021,195030,44,0,1146,636,510
2021,195030,44,1,177,123,54
2021,195030,44,2,384,225,159
2021,195030,44,3,368,195,173
2021,195030,44,4,140,64,76
2021,195030,44,5,12,8,4
2021,195030,44,6,65,21,44
2021,195049,0,0,67,49,18
2021,195049,10,0,67,49,18
2021,195049,10,1,34,31,3
2021,195049,10,2,15,6,9
2021,195049,10,3,14,8,6
2021,195049,10,6,4,4,0
2021,195049,20,0,33,31,2
2021,195049,20,1,33,31,2
2021,195049,30,0,14,8,6
2021,195049,30,2,3,2,1
2021,195049,30,3,11,6,5
2021,195049,40,0,20,10,10
2021,195049,40,1,1,0,1
2021,195049,40,2,12,4,8
2021,195049,40,3,3,2,1
2021,195049,40,6,4,4,0
2021,195049,41,0,16,6,10
2021,195049,41,1,1,0,1
2021,195049,41,2,12,4,8
2021,195049,41,3,3,2,1
2021,195049,42,0,4,4,0
2021,195049,42,6,4,4,0
2021,195049,44,0,16,6,10
2021,195049,44,1,1,0,1
2021,195049,44,2,12,4,8
2021,195049,44,3,3,2,1
2021,195058,0,0,86,35,51
2021,195058,10,0,86,35,51
2021,195058,10,1,19,5,14
2021,195058,10,2,24,10,14
2021,195058,10,3,23,8,15
2021,195058,10,4,13,6,7
2021,195058,10,5,7,6,1
2021,195058,20,0,62,22,40
2021,195058,20,1,19,5,14
2021,195058,20,2,24,10,14
2021,195058,20,3,19,7,12
2021,195058,30,0,17,7,10
2021,195058,30,3,4,1,3
2021,195058,30,4,13,6,7
2021,195058,40,0,7,6,1
2021,195058,40,5,7,6,1
2021,195058,43,0,7,6,1
2021,195058,43,5,7,6,1
2021,195128,0,0,113,21,92
2021,195128,10,0,113,21,92
2021,195128,10,1,16,7,9
2021,195128,10,2,35,5,30
2021,195128,10,3,50,8,42
2021,195128,10,4,1,0,1
2021,195128,10,5,11,1,10
2021,195128,20,0,41,12,29
2021,195128,20,1,16,7,9
2021,195128,20,2,25,5,20
2021,195128,30,0,16,4,12
2021,195128,30,3,16,4,12
2021,195128,40,0,56,5,51
2021,195128,40,2,10,0,10
2021,195128,40,3,34,4,30
2021,195128,40,4,1,0,1
2021,195128,40,5,11,1,10
2021,195128,41,0,48,4,44
2021,195128,41,2,10,0,10
2021,195128,41,3,33,3,30
2021,195128,41,5,5,1,4
2021,195128,42,0,8,1,7
2021,195128,42,3,1,1,0
2021,195128,42,4,1,0,1
2021,195128,42,5,6,0,6
2021,195128,44,0,48,4,44
2021,195128,44,2,10,0,10
2021,195128,44,3,33,3,30
2021,195128,44,5,5,1,4
2021,195164,0,0,158,79,79
2021,195164,10,0,158,79,79
2021,195164,10,1,26,18,8
2021,195164,10,2,34,21,13
2021,195164,10,3,75,27,48
2021,195164,10,5,20,12,8
2021,195164,10,6,3,1,2
2021,195164,20,0,68,40,28
2021,195164,20,1,24,17,7
2021,195164,20,2,30,18,12
2021,195164,20,3,14,5,9
2021,195164,30,0,60,25,35
2021,195164,30,1,1,0,1
2021,195164,30,2,4,3,1
2021,195164,30,3,55,22,33
2021,195164,40,0,30,14,16
2021,195164,40,1,1,1,0
2021,195164,40,3,6,0,6
2021,195164,40,5,20,12,8
2021,195164,40,6,3,1,2
2021,195164,42,0,30,14,16
2021,195164,42,1,1,1,0
2021,195164,42,3,6,0,6
2021,195164,42,5,20,12,8
2021,195164,42,6,3,1,2
2021,195173,0,0,103,48,55
2021,195173,10,0,103,48,55
2021,195173,10,1,21,12,9
2021,195173,10,2,21,10,11
2021,195173,10,3,45,15,30
2021,195173,10,5,16,11,5
2021,195173,20,0,43,23,20
2021,195173,20,1,21,12,9
2021,195173,20,2,21,10,11
2021,195173,20,3,1,1,0
2021,195173,30,0,44,14,30
2021,195173,30,3,44,14,30
2021,195173,40,0,16,11,5
2021,195173,40,5,16,11,5
2021,195173,42,0,16,11,5
2021,195173,42,5,16,11,5
2021,195191,0,0,21,5,16
2021,195191,10,0,21,5,16
2021,195191,10,1,1,0,1
2021,195191,10,2,6,1,5
2021,195191,10,3,13,4,9
2021,195191,10,6,1,0,1
2021,195191,40,0,21,5,16
2021,195191,40,1,1,0,1
2021,195191,40,2,6,1,5
2021,195191,40,3,13,4,9
2021,195191,40,6,1,0,1
2021,195191,42,0,21,5,16
2021,195191,42,1,1,0,1
2021,195191,42,2,6,1,5
2021,195191,42,3,13,4,9
2021,195191,42,6,1,0,1
2021,195216,0,0,176,77,99
2021,195216,10,0,176,77,99
2021,195216,10,1,44,20,24
2021,195216,10,2,78,38,40
2021,195216,10,3,49,18,31
2021,195216,10,4,4,1,3
2021,195216,10,5,1,0,1
2021,195216,20,0,121,58,63
2021,195216,20,1,43,20,23
2021,195216,20,2,78,38,40
2021,195216,30,0,33,11,22
2021,195216,30,3,33,11,22
2021,195216,40,0,22,8,14
2021,195216,40,1,1,0,1
2021,195216,40,3,16,7,9
2021,195216,40,4,4,1,3
2021,195216,40,5,1,0,1
2021,195216,42,0,22,8,14
2021,195216,42,1,1,0,1
2021,195216,42,3,16,7,9
2021,195216,42,4,4,1,3
2021,195216,42,5,1,0,1
2021,195234,0,0,130,54,76
2021,195234,10,0,130,54,76
2021,195234,10,1,34,11,23
2021,195234,10,2,53,26,27
2021,195234,10,3,36,15,21
2021,195234,10,4,7,2,5
2021,195234,20,0,91,39,52
2021,195234,20,1,34,11,23
2021,195234,20,2,52,25,27
2021,195234,20,3,5,3,2
2021,195234,30,0,26,10,16
2021,195234,30,2,1,1,0
2021,195234,30,3,25,9,16
2021,195234,40,0,13,5,8
2021,195234,40,3,6,3,3
2021,195234,40,4,7,2,5
2021,195234,42,0,13,5,8
2021,195234,42,3,6,3,3
2021,195234,42,4,7,2,5
2021,195243,0,0,52,18,34
2021,195243,10,0,52,18,34
2021,195243,10,1,19,6,13
2021,195243,10,2,15,7,8
2021,195243,10,3,16,4,12
2021,195243,10,4,2,1,1
2021,195243,20,0,33,12,21
2021,195243,20,1,19,6,13
2021,195243,20,2,13,6,7
2021,195243,20,3,1,0,1
2021,195243,30,0,15,5,10
2021,195243,30,2,2,1,1
2021,195243,30,3,13,4,9
2021,195243,40,0,4,1,3
2021,195243,40,3,2,0,2
2021,195243,40,4,2,1,1
2021,195243,42,0,4,1,3
2021,195243,42,3,2,0,2
2021,195243,42,4,2,1,1
2021,195304,0,0,92,50,42
2021,195304,10,0,92,50,42
2021,195304,10,6,92,50,42
2021,195304,20,0,67,40,27
2021,195304,20,6,67,40,27
2021,195304,30,0,12,7,5
2021,195304,30,6,12,7,5
2021,195304,40,0,13,3,10
2021,195304,40,6,13,3,10
2021,195304,42,0,13,3,10
2021,195304,42,6,13,3,10
2021,195322,0,0,43,17,26
2021,195322,10,0,43,17,26
2021,195322,10,1,21,8,13
2021,195322,10,2,10,5,5
2021,195322,10,3,8,2,6
2021,195322,10,4,3,1,2
2021,195322,10,5,1,1,0
2021,195322,20,0,21,7,14
2021,195322,20,1,15,4,11
2021,195322,20,2,5,2,3
2021,195322,20,3,1,1,0
2021,195322,30,0,22,10,12
2021,195322,30,1,6,4,2
2021,195322,30,2,5,3,2
2021,195322,30,3,7,1,6
2021,195322,30,4,3,1,2
2021,195322,30,5,1,1,0
2021,195438,0,0,29,29,0
2021,195438,10,0,29,29,0
2021,195438,10,4,29,29,0
2021,195438,40,0,29,29,0
2021,195438,40,4,29,29,0
2021,195438,42,0,29,29,0
2021,195438,42,4,29,29,0
2021,195474,0,0,222,108,114
2021,195474,10,0,222,108,114
2021,195474,10,1,65,34,31
2021,195474,10,2,72,42,30
2021,195474,10,3,72,28,44
2021,195474,10,4,13,4,9
2021,195474,20,0,137,77,60
2021,195474,20,1,65,34,31
2021,195474,20,2,70,41,29
2021,195474,20,3,2,2,0
2021,195474,30,0,38,16,22
2021,195474,30,2,2,1,1
2021,195474,30,3,36,15,21
2021,195474,40,0,47,15,32
2021,195474,40,3,34,11,23
2021,195474,40,4,13,4,9
2021,195474,41,0,21,3,18
2021,195474,41,3,15,2,13
2021,195474,41,4,6,1,5
2021,195474,42,0,26,12,14
2021,195474,42,3,19,9,10
2021,195474,42,4,7,3,4
2021,195474,44,0,21,3,18
2021,195474,44,3,15,2,13
2021,195474,44,4,6,1,5
2021,195526,0,0,287,132,155
2021,195526,10,0,287,132,155
2021,195526,10,1,64,41,23
2021,195526,10,2,81,31,50
2021,195526,10,3,43,22,21
2021,195526,10,4,24,6,18
2021,195526,10,5,17,6,11
2021,195526,10,6,58,26,32
2021,195526,20,0,143,70,73
2021,195526,20,1,62,39,23
2021,195526,20,2,78,30,48
2021,195526,20,3,3,1,2
2021,195526,30,0,43,22,21
2021,195526,30,2,3,1,2
2021,195526,30,3,40,21,19
2021,195526,40,0,101,40,61
2021,195526,40,1,2,2,0
2021,195526,40,4,24,6,18
2021,195526,40,5,17,6,11
2021,195526,40,6,58,26,32
2021,195526,41,0,78,27,51
2021,195526,41,1,2,2,0
2021,195526,41,4,21,3,18
2021,195526,41,5,11,3,8
2021,195526,41,6,44,19,25
2021,195526,42,0,22,13,9
2021,195526,42,4,3,3,0
2021,195526,42,5,6,3,3
2021,195526,42,6,13,7,6
2021,195526,43,0,1,0,1
2021,195526,43,6,1,0,1
2021,195526,44,0,49,16,33
2021,195526,44,1,1,1,0
2021,195526,44,4,9,2,7
2021,195526,44,5,9,2,7
2021,195526,44,6,30,11,19
2021,195526,45,0,29,11,18
2021,195526,45,1,1,1,0
2021,195526,45,4,12,1,11
2021,195526,45,5,2,1,1
2021,195526,45,6,14,8,6
2021,195544,0,0,158,68,90
2021,195544,10,0,158,68,90
2021,195544,10,1,33,14,19
2021,195544,10,2,49,21,28
2021,195544,10,3,46,21,25
2021,195544,10,4,30,12,18
2021,195544,20,0,66,29,37
2021,195544,20,1,33,14,19
2021,195544,20,2,33,15,18
2021,195544,30,0,62,27,35
2021,195544,30,2,16,6,10
2021,195544,30,3,46,21,25
2021,195544,40,0,30,12,18
2021,195544,40,4,30,12,18
2021,195544,42,0,30,12,18
2021,195544,42,4,30,12,18
2021,195580,0,0,7,7,0
2021,195580,10,0,7,7,0
2021,195580,10,1,2,2,0
2021,195580,10,2,2,2,0
2021,195580,10,4,3,3,0
2021,195580,20,0,4,4,0
2021,195580,20,1,2,2,0
2021,195580,20,2,2,2,0
2021,195580,40,0,3,3,0
2021,195580,40,4,3,3,0
2021,195580,42,0,3,3,0
2021,195580,42,4,3,3,0
2021,195702,0,0,16,2,14
2021,195702,10,0,16,2,14
2021,195702,10,2,16,2,14
2021,195702,20,0,9,1,8
2021,195702,20,2,9,1,8
2021,195702,30,0,7,1,6
2021,195702,30,2,7,1,6
2021,195720,0,0,218,92,126
2021,195720,10,0,215,91,124
2021,195720,10,1,35,24,11
2021,195720,10,2,95,39,56
2021,195720,10,3,75,26,49
2021,195720,10,4,9,2,7
2021,195720,10,6,1,0,1
2021,195720,20,0,126,61,65
2021,195720,20,1,35,24,11
2021,195720,20,2,87,36,51
2021,195720,20,3,4,1,3
2021,195720,30,0,29,10,19
2021,195720,30,2,1,0,1
2021,195720,30,3,28,10,18
2021,195720,40,0,60,20,40
2021,195720,40,2,7,3,4
2021,195720,40,3,43,15,28
2021,195720,40,4,9,2,7
2021,195720,40,6,1,0,1
2021,195720,41,0,44,15,29
2021,195720,41,2,6,3,3
2021,195720,41,3,33,11,22
2021,195720,41,4,4,1,3
2021,195720,41,6,1,0,1
2021,195720,42,0,16,5,11
2021,195720,42,2,1,0,1
2021,195720,42,3,10,4,6
2021,195720,42,4,5,1,4
2021,195720,44,0,43,14,29
2021,195720,44,2,5,2,3
2021,195720,44,3,33,11,22
2021,195720,44,4,4,1,3
2021,195720,44,6,1,0,1
2021,195720,45,0,1,1,0
2021,195720,45,2,1,1,0
2021,195720,50,0,3,1,2
2021,195784,0,0,15,6,9
2021,195784,10,0,15,6,9
2021,195784,10,4,15,6,9
2021,195784,40,0,15,6,9
2021,195784,40,4,15,6,9
2021,195784,41,0,15,6,9
2021,195784,41,4,15,6,9
2021,195784,45,0,15,6,9
2021,195784,45,4,15,6,9
2021,195809,0,0,603,320,283
2021,195809,10,0,603,320,283
2021,195809,10,1,195,108,87
2021,195809,10,2,282,154,128
2021,195809,10,3,125,58,67
2021,195809,10,4,1,0,1
2021,195809,20,0,450,251,199
2021,195809,20,1,183,105,78
2021,195809,20,2,267,146,121
2021,195809,30,0,108,49,59
2021,195809,30,2,8,4,4
2021,195809,30,3,99,45,54
2021,195809,30,4,1,0,1
2021,195809,40,0,45,20,25
2021,195809,40,1,12,3,9
2021,195809,40,2,7,4,3
2021,195809,40,3,26,13,13
2021,195809,42,0,45,20,25
2021,195809,42,1,12,3,9
2021,195809,42,2,7,4,3
2021,195809,42,3,26,13,13
2021,195988,0,0,32,16,16
2021,195988,10,0,32,16,16
2021,195988,10,1,14,7,7
2021,195988,10,2,12,5,7
2021,195988,10,3,4,3,1
2021,195988,10,4,2,1,1
2021,195988,20,0,24,12,12
2021,195988,20,1,14,7,7
2021,195988,20,2,10,5,5
2021,195988,30,0,8,4,4
2021,195988,30,2,2,0,2
2021,195988,30,3,4,3,1
2021,195988,30,4,2,1,1
2021,196006,0,0,179,127,52
2021,196006,10,0,179,127,52
2021,196006,10,1,20,14,6
2021,196006,10,2,31,17,14
2021,196006,10,3,71,46,25
2021,196006,10,4,25,23,2
2021,196006,10,5,32,27,5
2021,196006,20,0,58,41,17
2021,196006,20,1,19,13,6
2021,196006,20,2,24,16,8
2021,196006,20,3,14,11,3
2021,196006,20,4,1,1,0
2021,196006,30,0,89,59,30
2021,196006,30,1,1,1,0
2021,196006,30,2,7,1,6
2021,196006,30,3,57,35,22
2021,196006,30,4,24,22,2
2021,196006,40,0,32,27,5
2021,196006,40,5,32,27,5
2021,196006,42,0,14,12,2
2021,196006,42,5,14,12,2
2021,196006,43,0,18,15,3
2021,196006,43,5,18,15,3
2021,196015,0,0,115,64,51
2021,196015,10,0,115,64,51
2021,196015,10,1,23,13,10
2021,196015,10,2,31,19,12
2021,196015,10,3,22,10,12
2021,196015,10,4,4,2,2
2021,196015,10,5,35,20,15
2021,196015,20,0,51,31,20
2021,196015,20,1,23,13,10
2021,196015,20,2,27,18,9
2021,196015,20,3,1,0,1
2021,196015,30,0,29,13,16
2021,196015,30,2,4,1,3
2021,196015,30,3,21,10,11
2021,196015,30,4,4,2,2
2021,196015,40,0,35,20,15
2021,196015,40,5,35,20,15
2021,196015,41,0,33,19,14
2021,196015,41,5,33,19,14
2021,196015,42,0,2,1,1
2021,196015,42,5,2,1,1
2021,196015,44,0,33,19,14
2021,196015,44,5,33,19,14
2021,196024,0,0,139,68,71
2021,196024,10,0,139,68,71
2021,196024,10,1,34,17,17
2021,196024,10,2,46,17,29
2021,196024,10,3,34,16,18
2021,196024,10,4,25,18,7
2021,196024,20,0,72,35,37
2021,196024,20,1,32,17,15
2021,196024,20,2,26,7,19
2021,196024,20,3,12,9,3
2021,196024,20,4,2,2,0
2021,196024,30,0,66,32,34
2021,196024,30,1,2,0,2
2021,196024,30,2,20,10,10
2021,196024,30,3,22,7,15
2021,196024,30,4,22,15,7
2021,196024,40,0,1,1,0
2021,196024,40,4,1,1,0
2021,196024,42,0,1,1,0
2021,196024,42,4,1,1,0
2021,196033,0,0,99,57,42
2021,196033,10,0,98,57,41
2021,196033,10,1,27,16,11
2021,196033,10,2,37,22,15
2021,196033,10,3,18,8,10
2021,196033,10,4,13,9,4
2021,196033,10,5,3,2,1
2021,196033,20,0,57,34,23
2021,196033,20,1,27,16,11
2021,196033,20,2,30,18,12
2021,196033,30,0,24,11,13
2021,196033,30,2,7,4,3
2021,196033,30,3,16,6,10
2021,196033,30,4,1,1,0
2021,196033,40,0,17,12,5
2021,196033,40,3,2,2,0
2021,196033,40,4,12,8,4
2021,196033,40,5,3,2,1
2021,196033,42,0,17,12,5
2021,196033,42,3,2,2,0
2021,196033,42,4,12,8,4
2021,196033,42,5,3,2,1
2021,196033,50,0,1,0,1
2021,196042,0,0,275,143,132
2021,196042,10,0,275,143,132
2021,196042,10,1,54,28,26
2021,196042,10,2,68,37,31
2021,196042,10,3,137,69,68
2021,196042,10,5,16,9,7
2021,196042,20,0,118,64,54
2021,196042,20,1,52,27,25
2021,196042,20,2,62,35,27
2021,196042,20,3,4,2,2
2021,196042,30,0,108,52,56
2021,196042,30,1,2,1,1
2021,196042,30,2,5,1,4
2021,196042,30,3,101,50,51
2021,196042,40,0,49,27,22
2021,196042,40,2,1,1,0
2021,196042,40,3,32,17,15
2021,196042,40,5,16,9,7
2021,196042,42,0,49,27,22
2021,196042,42,2,1,1,0
2021,196042,42,3,32,17,15
2021,196042,42,5,16,9,7
2021,196051,0,0,123,64,59
2021,196051,10,0,123,64,59
2021,196051,10,1,22,17,5
2021,196051,10,2,54,25,29
2021,196051,10,3,43,21,22
2021,196051,10,4,4,1,3
2021,196051,20,0,87,49,38
2021,196051,20,1,22,17,5
2021,196051,20,2,54,25,29
2021,196051,20,3,11,7,4
2021,196051,30,0,35,15,20
2021,196051,30,3,32,14,18
2021,196051,30,4,3,1,2
2021,196051,40,0,1,0,1
2021,196051,40,4,1,0,1
2021,196051,43,0,1,0,1
2021,196051,43,4,1,0,1
2021,196060,0,0,616,356,260
2021,196060,10,0,616,356,260
2021,196060,10,1,150,101,49
2021,196060,10,2,238,136,102
2021,196060,10,3,137,77,60
2021,196060,10,5,91,42,49
2021,196060,20,0,386,235,151
2021,196060,20,1,150,101,49
2021,196060,20,2,236,134,102
2021,196060,30,0,124,70,54
2021,196060,30,2,2,2,0
2021,196060,30,3,122,68,54
2021,196060,40,0,106,51,55
2021,196060,40,3,15,9,6
2021,196060,40,5,91,42,49
2021,196060,41,0,51,23,28
2021,196060,41,3,2,1,1
2021,196060,41,5,49,22,27
2021,196060,42,0,43,21,22
2021,196060,42,3,5,4,1
2021,196060,42,5,38,17,21
2021,196060,43,0,12,7,5
2021,196060,43,3,8,4,4
2021,196060,43,5,4,3,1
2021,196060,44,0,51,23,28
2021,196060,44,3,2,1,1
2021,196060,44,5,49,22,27
2021,196079,0,0,761,429,332
2021,196079,10,0,761,429,332
2021,196079,10,1,183,128,55
2021,196079,10,2,230,137,93
2021,196079,10,3,208,108,100
2021,196079,10,4,25,11,14
2021,196079,10,5,115,45,70
2021,196079,20,0,407,262,145
2021,196079,20,1,180,127,53
2021,196079,20,2,222,134,88
2021,196079,20,3,1,0,1
2021,196079,20,4,4,1,3
2021,196079,30,0,164,91,73
2021,196079,30,1,1,1,0
2021,196079,30,2,2,1,1
2021,196079,30,3,148,81,67
2021,196079,30,4,13,8,5
2021,196079,40,0,190,76,114
2021,196079,40,1,2,0,2
2021,196079,40,2,6,2,4
2021,196079,40,3,59,27,32
2021,196079,40,4,8,2,6
2021,196079,40,5,115,45,70
2021,196079,41,0,96,28,68
2021,196079,41,2,4,0,4
2021,196079,41,3,28,9,19
2021,196079,41,4,7,2,5
2021,196079,41,5,57,17,40
2021,196079,42,0,91,47,44
2021,196079,42,1,1,0,1
2021,196079,42,2,2,2,0
2021,196079,42,3,31,18,13
2021,196079,42,4,1,0,1
2021,196079,42,5,56,27,29
2021,196079,43,0,3,1,2
2021,196079,43,1,1,0,1
2021,196079,43,5,2,1,1
2021,196079,44,0,96,28,68
2021,196079,44,2,4,0,4
2021,196079,44,3,28,9,19
2021,196079,44,4,7,2,5
2021,196079,44,5,57,17,40
2021,196088,0,0,1683,1012,671
2021,196088,10,0,1683,1012,671
2021,196088,10,1,548,395,153
2021,196088,10,2,532,306,226
2021,196088,10,3,500,263,237
2021,196088,10,4,23,9,14
2021,196088,10,5,80,39,41
2021,196088,20,0,844,566,278
2021,196088,20,1,480,349,131
2021,196088,20,2,362,216,146
2021,196088,20,3,2,1,1
2021,196088,30,0,258,146,112
2021,196088,30,1,10,7,3
2021,196088,30,2,15,7,8
2021,196088,30,3,229,128,101
2021,196088,30,4,4,4,0
2021,196088,40,0,581,300,281
2021,196088,40,1,58,39,19
2021,196088,40,2,155,83,72
2021,196088,40,3,269,134,135
2021,196088,40,4,19,5,14
2021,196088,40,5,80,39,41
2021,196088,41,0,296,124,172
2021,196088,41,1,16,6,10
2021,196088,41,2,63,25,38
2021,196088,41,3,144,63,81
2021,196088,41,4,11,3,8
2021,196088,41,5,62,27,35
2021,196088,42,0,285,176,109
2021,196088,42,1,42,33,9
2021,196088,42,2,92,58,34
2021,196088,42,3,125,71,54
2021,196088,42,4,8,2,6
2021,196088,42,5,18,12,6
2021,196088,44,0,296,124,172
2021,196088,44,1,16,6,10
2021,196088,44,2,63,25,38
2021,196088,44,3,144,63,81
2021,196088,44,4,11,3,8
2021,196088,44,5,62,27,35
2021,196097,0,0,2004,1102,902
2021,196097,10,0,2004,1102,902
2021,196097,10,1,520,386,134
2021,196097,10,2,493,303,190
2021,196097,10,3,656,314,342
2021,196097,10,4,189,35,154
2021,196097,10,5,146,64,82
2021,196097,20,0,765,546,219
2021,196097,20,1,462,350,112
2021,196097,20,2,302,196,106
2021,196097,20,3,1,0,1
2021,196097,30,0,178,110,68
2021,196097,30,1,11,9,2
2021,196097,30,2,6,4,2
2021,196097,30,3,161,97,64
2021,196097,40,0,1061,446,615
2021,196097,40,1,47,27,20
2021,196097,40,2,185,103,82
2021,196097,40,3,494,217,277
2021,196097,40,4,189,35,154
2021,196097,40,5,146,64,82
2021,196097,41,0,144,47,97
2021,196097,41,1,5,2,3
2021,196097,41,2,39,6,33
2021,196097,41,3,42,10,32
2021,196097,41,4,2,0,2
2021,196097,41,5,56,29,27
2021,196097,42,0,917,399,518
2021,196097,42,1,42,25,17
2021,196097,42,2,146,97,49
2021,196097,42,3,452,207,245
2021,196097,42,4,187,35,152
2021,196097,42,5,90,35,55
2021,196097,44,0,144,47,97
2021,196097,44,1,5,2,3
2021,196097,44,2,39,6,33
2021,196097,44,3,42,10,32
2021,196097,44,4,2,0,2
2021,196097,44,5,56,29,27
2021,196103,0,0,127,84,43
2021,196103,10,0,127,84,43
2021,196103,10,1,45,34,11
2021,196103,10,2,32,21,11
2021,196103,10,3,35,21,14
2021,196103,10,4,7,4,3
2021,196103,10,5,8,4,4
2021,196103,20,0,82,57,25
2021,196103,20,1,45,34,11
2021,196103,20,2,31,20,11
2021,196103,20,3,3,2,1
2021,196103,20,4,3,1,2
2021,196103,30,0,36,22,14
2021,196103,30,2,1,1,0
2021,196103,30,3,31,18,13
2021,196103,30,4,4,3,1
2021,196103,40,0,9,5,4
2021,196103,40,3,1,1,0
2021,196103,40,5,8,4,4
2021,196103,41,0,3,1,2
2021,196103,41,5,3,1,2
2021,196103,42,0,5,3,2
2021,196103,42,3,1,1,0
2021,196103,42,5,4,2,2
2021,196103,43,0,1,1,0
2021,196103,43,5,1,1,0
2021,196103,44,0,3,1,2
2021,196103,44,5,3,1,2
2021,196112,0,0,130,85,45
2021,196112,10,0,130,85,45
2021,196112,10,1,27,19,8
2021,196112,10,2,52,40,12
2021,196112,10,3,30,16,14
2021,196112,10,4,2,0,2
2021,196112,10,5,19,10,9
2021,196112,20,0,78,57,21
2021,196112,20,1,26,18,8
2021,196112,20,2,51,39,12
2021,196112,20,3,1,0,1
2021,196112,30,0,27,17,10
2021,196112,30,2,1,1,0
2021,196112,30,3,26,16,10
2021,196112,40,0,25,11,14
2021,196112,40,1,1,1,0
2021,196112,40,3,3,0,3
2021,196112,40,4,2,0,2
2021,196112,40,5,19,10,9
2021,196112,41,0,21,10,11
2021,196112,41,3,3,0,3
2021,196112,41,4,2,0,2
2021,196112,41,5,16,10,6
2021,196112,42,0,1,1,0
2021,196112,42,1,1,1,0
2021,196112,43,0,3,0,3
2021,196112,43,5,3,0,3
2021,196112,44,0,21,10,11
2021,196112,44,3,3,0,3
2021,196112,44,4,2,0,2
2021,196112,44,5,16,10,6
2021,196121,0,0,330,152,178
2021,196121,10,0,330,152,178
2021,196121,10,1,65,36,29
2021,196121,10,2,136,64,72
2021,196121,10,3,76,38,38
2021,196121,10,4,19,1,18
2021,196121,10,5,34,13,21
2021,196121,20,0,197,98,99
2021,196121,20,1,65,36,29
2021,196121,20,2,128,61,67
2021,196121,20,3,3,1,2
2021,196121,20,4,1,0,1
2021,196121,30,0,95,41,54
2021,196121,30,2,7,3,4
2021,196121,30,3,72,37,35
2021,196121,30,4,16,1,15
2021,196121,40,0,38,13,25
2021,196121,40,2,1,0,1
2021,196121,40,3,1,0,1
2021,196121,40,4,2,0,2
2021,196121,40,5,34,13,21
2021,196121,41,0,32,10,22
2021,196121,41,2,1,0,1
2021,196121,41,3,1,0,1
2021,196121,41,4,1,0,1
2021,196121,41,5,29,10,19
2021,196121,42,0,6,3,3
2021,196121,42,4,1,0,1
2021,196121,42,5,5,3,2
2021,196121,44,0,32,10,22
2021,196121,44,2,1,0,1
2021,196121,44,3,1,0,1
2021,196121,44,4,1,0,1
2021,196121,44,5,29,10,19
2021,196130,0,0,338,163,175
2021,196130,10,0,338,163,175
2021,196130,10,1,93,60,33
2021,196130,10,2,137,59,78
2021,196130,10,3,59,28,31
2021,196130,10,4,3,1,2
2021,196130,10,5,46,15,31
2021,196130,20,0,225,118,107
2021,196130,20,1,92,59,33
2021,196130,20,2,131,58,73
2021,196130,20,3,2,1,1
2021,196130,30,0,63,28,35
2021,196130,30,2,6,1,5
2021,196130,30,3,57,27,30
2021,196130,40,0,50,17,33
2021,196130,40,1,1,1,0
2021,196130,40,4,3,1,2
2021,196130,40,5,46,15,31
2021,196130,41,0,24,11,13
2021,196130,41,1,1,1,0
2021,196130,41,5,23,10,13
2021,196130,42,0,12,3,9
2021,196130,42,4,3,1,2
2021,196130,42,5,9,2,7
2021,196130,43,0,14,3,11
2021,196130,43,5,14,3,11
2021,196130,44,0,24,11,13
2021,196130,44,1,1,1,0
2021,196130,44,5,23,10,13
2021,196149,0,0,316,148,168
2021,196149,10,0,316,148,168
2021,196149,10,1,70,37,33
2021,196149,10,2,92,44,48
2021,196149,10,3,84,41,43
2021,196149,10,4,15,4,11
2021,196149,10,5,55,22,33
2021,196149,20,0,157,78,79
2021,196149,20,1,70,37,33
2021,196149,20,2,78,35,43
2021,196149,20,3,4,4,0
2021,196149,20,4,5,2,3
2021,196149,30,0,98,44,54
2021,196149,30,2,14,9,5
2021,196149,30,3,75,33,42
2021,196149,30,4,9,2,7
2021,196149,40,0,61,26,35
2021,196149,40,3,5,4,1
2021,196149,40,4,1,0,1
2021,196149,40,5,55,22,33
2021,196149,41,0,51,22,29
2021,196149,41,5,51,22,29
2021,196149,42,0,3,1,2
2021,196149,42,3,1,1,0
2021,196149,42,5,2,0,2
2021,196149,43,0,7,3,4
2021,196149,43,3,4,3,1
2021,196149,43,4,1,0,1
2021,196149,43,5,2,0,2
2021,196149,44,0,51,22,29
2021,196149,44,5,51,22,29
2021,196158,0,0,225,132,93
2021,196158,10,0,225,132,93
2021,196158,10,1,67,43,24
2021,196158,10,2,77,40,37
2021,196158,10,3,37,27,10
2021,196158,10,4,1,1,0
2021,196158,10,5,43,21,22
2021,196158,20,0,144,84,60
2021,196158,20,1,67,43,24
2021,196158,20,2,75,39,36
2021,196158,20,3,2,2,0
2021,196158,30,0,37,26,11
2021,196158,30,2,2,1,1
2021,196158,30,3,35,25,10
2021,196158,40,0,44,22,22
2021,196158,40,4,1,1,0
2021,196158,40,5,43,21,22
2021,196158,41,0,3,1,2
2021,196158,41,5,3,1,2
2021,196158,42,0,41,21,20
2021,196158,42,4,1,1,0
2021,196158,42,5,40,20,20
2021,196158,44,0,3,1,2
2021,196158,44,5,3,1,2
2021,196167,0,0,216,114,102
2021,196167,10,0,216,114,102
2021,196167,10,1,67,43,24
2021,196167,10,2,71,39,32
2021,196167,10,3,46,15,31
2021,196167,10,4,2,1,1
2021,196167,10,5,30,16,14
2021,196167,20,0,135,78,57
2021,196167,20,1,67,43,24
2021,196167,20,2,62,35,27
2021,196167,20,3,6,0,6
2021,196167,30,0,48,18,30
2021,196167,30,2,9,4,5
2021,196167,30,3,39,14,25
2021,196167,40,0,33,18,15
2021,196167,40,3,1,1,0
2021,196167,40,4,2,1,1
2021,196167,40,5,30,16,14
2021,196167,41,0,21,13,8
2021,196167,41,3,1,1,0
2021,196167,41,4,2,1,1
2021,196167,41,5,18,11,7
2021,196167,42,0,12,5,7
2021,196167,42,5,12,5,7
2021,196167,44,0,21,13,8
2021,196167,44,3,1,1,0
2021,196167,44,4,2,1,1
2021,196167,44,5,18,11,7
2021,196176,0,0,336,158,178
2021,196176,10,0,336,158,178
2021,196176,10,1,59,38,21
2021,196176,10,2,135,63,72
2021,196176,10,3,67,32,35
2021,196176,10,4,12,0,12
2021,196176,10,5,63,25,38
2021,196176,20,0,201,101,100
2021,196176,20,1,59,38,21
2021,196176,20,2,130,59,71
2021,196176,20,3,5,4,1
2021,196176,20,4,7,0,7
2021,196176,30,0,67,30,37
2021,196176,30,2,4,3,1
2021,196176,30,3,60,27,33
2021,196176,30,4,3,0,3
2021,196176,40,0,68,27,41
2021,196176,40,2,1,1,0
2021,196176,40,3,2,1,1
2021,196176,40,4,2,0,2
2021,196176,40,5,63,25,38
2021,196176,41,0,41,15,26
2021,196176,41,2,1,1,0
2021,196176,41,4,1,0,1
2021,196176,41,5,39,14,25
2021,196176,42,0,27,12,15
2021,196176,42,3,2,1,1
2021,196176,42,4,1,0,1
2021,196176,42,5,24,11,13
2021,196176,44,0,41,15,26
2021,196176,44,2,1,1,0
2021,196176,44,4,1,0,1
2021,196176,44,5,39,14,25
2021,196185,0,0,276,145,131
2021,196185,10,0,276,145,131
2021,196185,10,1,56,35,21
2021,196185,10,2,102,51,51
2021,196185,10,3,88,41,47
2021,196185,10,4,1,0,1
2021,196185,10,5,29,18,11
2021,196185,20,0,158,87,71
2021,196185,20,1,55,34,21
2021,196185,20,2,92,47,45
2021,196185,20,3,11,6,5
2021,196185,30,0,83,37,46
2021,196185,30,2,10,4,6
2021,196185,30,3,73,33,40
2021,196185,40,0,35,21,14
2021,196185,40,1,1,1,0
2021,196185,40,3,4,2,2
2021,196185,40,4,1,0,1
2021,196185,40,5,29,18,11
2021,196185,41,0,7,3,4
2021,196185,41,5,7,3,4
2021,196185,42,0,27,18,9
2021,196185,42,1,1,1,0
2021,196185,42,3,3,2,1
2021,196185,42,4,1,0,1
2021,196185,42,5,22,15,7
2021,196185,43,0,1,0,1
2021,196185,43,3,1,0,1
2021,196185,44,0,7,3,4
2021,196185,44,5,7,3,4
2021,196194,0,0,354,181,173
2021,196194,10,0,354,181,173
2021,196194,10,1,83,53,30
2021,196194,10,2,105,48,57
2021,196194,10,3,141,66,75
2021,196194,10,4,17,8,9
2021,196194,10,5,8,6,2
2021,196194,20,0,183,102,81
2021,196194,20,1,82,53,29
2021,196194,20,2,94,44,50
2021,196194,20,3,7,5,2
2021,196194,30,0,90,36,54
2021,196194,30,1,1,0,1
2021,196194,30,2,11,4,7
2021,196194,30,3,76,32,44
2021,196194,30,4,2,0,2
2021,196194,40,0,81,43,38
2021,196194,40,3,58,29,29
2021,196194,40,4,15,8,7
2021,196194,40,5,8,6,2
2021,196194,42,0,51,25,26
2021,196194,42,3,39,18,21
2021,196194,42,4,4,1,3
2021,196194,42,5,8,6,2
2021,196194,43,0,30,18,12
2021,196194,43,3,19,11,8
2021,196194,43,4,11,7,4
2021,196200,0,0,219,108,111
2021,196200,10,0,219,108,111
2021,196200,10,1,56,30,26
2021,196200,10,2,74,38,36
2021,196200,10,3,56,27,29
2021,196200,10,4,17,5,12
2021,196200,10,5,16,8,8
2021,196200,20,0,136,69,67
2021,196200,20,1,56,30,26
2021,196200,20,2,74,38,36
2021,196200,20,3,1,0,1
2021,196200,20,4,5,1,4
2021,196200,30,0,41,14,27
2021,196200,30,3,36,12,24
2021,196200,30,4,5,2,3
2021,196200,40,0,42,25,17
2021,196200,40,3,19,15,4
2021,196200,40,4,7,2,5
2021,196200,40,5,16,8,8
2021,196200,41,0,9,4,5
2021,196200,41,4,1,0,1
2021,196200,41,5,8,4,4
2021,196200,42,0,33,21,12
2021,196200,42,3,19,15,4
2021,196200,42,4,6,2,4
2021,196200,42,5,8,4,4
2021,196200,44,0,9,4,5
2021,196200,44,4,1,0,1
2021,196200,44,5,8,4,4
2021,196219,0,0,183,86,97
2021,196219,10,0,183,86,97
2021,196219,10,1,33,15,18
2021,196219,10,2,69,37,32
2021,196219,10,3,76,32,44
2021,196219,10,4,1,0,1
2021,196219,10,5,4,2,2
2021,196219,20,0,94,48,46
2021,196219,20,1,33,15,18
2021,196219,20,2,61,33,28
2021,196219,30,0,52,24,28
2021,196219,30,2,5,3,2
2021,196219,30,3,47,21,26
2021,196219,40,0,37,14,23
2021,196219,40,2,3,1,2
2021,196219,40,3,29,11,18
2021,196219,40,4,1,0,1
2021,196219,40,5,4,2,2
2021,196219,41,0,8,3,5
2021,196219,41,2,3,1,2
2021,196219,41,3,3,1,2
2021,196219,41,5,2,1,1
2021,196219,42,0,29,11,18
2021,196219,42,3,26,10,16
2021,196219,42,4,1,0,1
2021,196219,42,5,2,1,1
2021,196219,44,0,8,3,5
2021,196219,44,2,3,1,2
2021,196219,44,3,3,1,2
2021,196219,44,5,2,1,1
2021,196228,0,0,66,26,40
2021,196228,10,0,66,26,40
2021,196228,10,1,15,12,3
2021,196228,10,2,21,6,15
2021,196228,10,3,29,7,22
2021,196228,10,4,1,1,0
2021,196228,20,0,16,13,3
2021,196228,20,1,14,12,2
2021,196228,20,2,2,1,1
2021,196228,30,0,2,0,2
2021,196228,30,2,1,0,1
2021,196228,30,3,1,0,1
2021,196228,40,0,48,13,35
2021,196228,40,1,1,0,1
2021,196228,40,2,18,5,13
2021,196228,40,3,28,7,21
2021,196228,40,4,1,1,0
2021,196228,41,0,1,1,0
2021,196228,41,3,1,1,0
2021,196228,42,0,47,12,35
2021,196228,42,1,1,0,1
2021,196228,42,2,18,5,13
2021,196228,42,3,27,6,21
2021,196228,42,4,1,1,0
2021,196228,44,0,1,1,0
2021,196228,44,3,1,1,0
2021,196237,0,0,164,80,84
2021,196237,10,0,164,80,84
2021,196237,10,1,22,10,12
2021,196237,10,2,69,35,34
2021,196237,10,3,58,26,32
2021,196237,10,4,3,3,0
2021,196237,10,5,12,6,6
2021,196237,20,0,90,45,45
2021,196237,20,1,22,10,12
2021,196237,20,2,67,34,33
2021,196237,20,4,1,1,0
2021,196237,30,0,50,22,28
2021,196237,30,3,50,22,28
2021,196237,40,0,24,13,11
2021,196237,40,2,2,1,1
2021,196237,40,3,8,4,4
2021,196237,40,4,2,2,0
2021,196237,40,5,12,6,6
2021,196237,42,0,24,13,11
2021,196237,42,2,2,1,1
2021,196237,42,3,8,4,4
2021,196237,42,4,2,2,0
2021,196237,42,5,12,6,6
2021,196246,0,0,237,127,110
2021,196246,10,0,237,127,110
2021,196246,10,1,57,37,20
2021,196246,10,2,82,46,36
2021,196246,10,3,57,26,31
2021,196246,10,5,41,18,23
2021,196246,20,0,135,80,55
2021,196246,20,1,57,37,20
2021,196246,20,2,75,42,33
2021,196246,20,3,3,1,2
2021,196246,30,0,61,29,32
2021,196246,30,2,7,4,3
2021,196246,30,3,54,25,29
2021,196246,40,0,41,18,23
2021,196246,40,5,41,18,23
2021,196246,41,0,31,13,18
2021,196246,41,5,31,13,18
2021,196246,42,0,10,5,5
2021,196246,42,5,10,5,5
2021,196246,44,0,31,13,18
2021,196246,44,5,31,13,18
2021,196255,0,0,450,256,194
2021,196255,10,0,450,256,194
2021,196255,10,1,119,87,32
2021,196255,10,2,104,54,50
2021,196255,10,3,217,113,104
2021,196255,10,4,9,2,7
2021,196255,10,5,1,0,1
2021,196255,20,0,150,100,50
2021,196255,20,1,95,69,26
2021,196255,20,2,55,31,24
2021,196255,30,0,107,50,57
2021,196255,30,1,11,7,4
2021,196255,30,2,9,3,6
2021,196255,30,3,87,40,47
2021,196255,40,0,193,106,87
2021,196255,40,1,13,11,2
2021,196255,40,2,40,20,20
2021,196255,40,3,130,73,57
2021,196255,40,4,9,2,7
2021,196255,40,5,1,0,1
2021,196255,41,0,20,11,9
2021,196255,41,1,1,0,1
2021,196255,41,2,4,2,2
2021,196255,41,3,15,9,6
2021,196255,42,0,173,95,78
2021,196255,42,1,12,11,1
2021,196255,42,2,36,18,18
2021,196255,42,3,115,64,51
2021,196255,42,4,9,2,7
2021,196255,42,5,1,0,1
2021,196255,44,0,20,11,9
2021,196255,44,1,1,0,1
2021,196255,44,2,4,2,2
2021,196255,44,3,15,9,6
2021,196264,0,0,161,53,108
2021,196264,10,0,161,53,108
2021,196264,10,1,41,13,28
2021,196264,10,2,84,34,50
2021,196264,10,3,29,6,23
2021,196264,10,4,2,0,2
2021,196264,10,5,5,0,5
2021,196264,20,0,127,46,81
2021,196264,20,1,40,12,28
2021,196264,20,2,79,32,47
2021,196264,20,3,8,2,6
2021,196264,30,0,23,5,18
2021,196264,30,2,2,1,1
2021,196264,30,3,20,4,16
2021,196264,30,4,1,0,1
2021,196264,40,0,11,2,9
2021,196264,40,1,1,1,0
2021,196264,40,2,3,1,2
2021,196264,40,3,1,0,1
2021,196264,40,4,1,0,1
2021,196264,40,5,5,0,5
2021,196264,41,0,1,0,1
2021,196264,41,5,1,0,1
2021,196264,42,0,10,2,8
2021,196264,42,1,1,1,0
2021,196264,42,2,3,1,2
2021,196264,42,3,1,0,1
2021,196264,42,4,1,0,1
2021,196264,42,5,4,0,4
2021,196264,44,0,1,0,1
2021,196264,44,5,1,0,1
2021,196291,0,0,82,63,19
2021,196291,10,0,82,63,19
2021,196291,10,1,17,13,4
2021,196291,10,2,16,10,6
2021,196291,10,3,17,12,5
2021,196291,10,4,3,3,0
2021,196291,10,5,29,25,4
2021,196291,20,0,33,22,11
2021,196291,20,1,17,13,4
2021,196291,20,2,13,7,6
2021,196291,20,3,3,2,1
2021,196291,30,0,17,13,4
2021,196291,30,2,3,3,0
2021,196291,30,3,14,10,4
2021,196291,40,0,32,28,4
2021,196291,40,4,3,3,0
2021,196291,40,5,29,25,4
2021,196291,41,0,22,20,2
2021,196291,41,5,22,20,2
2021,196291,42,0,9,7,2
2021,196291,42,4,2,2,0
2021,196291,42,5,7,5,2
2021,196291,43,0,1,1,0
2021,196291,43,4,1,1,0
2021,196291,44,0,22,20,2
2021,196291,44,5,22,20,2
2021,196307,0,0,623,387,236
2021,196307,10,0,623,387,236
2021,196307,10,1,121,98,23
2021,196307,10,2,142,84,58
2021,196307,10,3,340,195,145
2021,196307,10,4,20,10,10
2021,196307,20,0,145,106,39
2021,196307,20,1,87,70,17
2021,196307,20,2,56,35,21
2021,196307,20,3,2,1,1
2021,196307,30,0,48,32,16
2021,196307,30,1,3,2,1
2021,196307,30,2,6,5,1
2021,196307,30,3,39,25,14
2021,196307,40,0,430,249,181
2021,196307,40,1,31,26,5
2021,196307,40,2,80,44,36
2021,196307,40,3,299,169,130
2021,196307,40,4,20,10,10
2021,196307,41,0,295,175,120
2021,196307,41,1,26,22,4
2021,196307,41,2,64,37,27
2021,196307,41,3,194,113,81
2021,196307,41,4,11,3,8
2021,196307,42,0,135,74,61
2021,196307,42,1,5,4,1
2021,196307,42,2,16,7,9
2021,196307,42,3,105,56,49
2021,196307,42,4,9,7,2
2021,196307,44,0,295,175,120
2021,196307,44,1,26,22,4
2021,196307,44,2,64,37,27
2021,196307,44,3,194,113,81
2021,196307,44,4,11,3,8
2021,196389,0,0,47,21,26
2021,196389,10,0,47,21,26
2021,196389,10,4,47,21,26
2021,196389,40,0,47,21,26
2021,196389,40,4,47,21,26
2021,196389,41,0,47,21,26
2021,196389,41,4,47,21,26
2021,196389,44,0,47,21,26
2021,196389,44,4,47,21,26
2021,196413,0,0,1145,630,515
2021,196413,10,0,1145,630,515
2021,196413,10,1,420,276,144
2021,196413,10,2,354,183,171
2021,196413,10,3,371,171,200
2021,196413,20,0,637,394,243
2021,196413,20,1,328,226,102
2021,196413,20,2,305,166,139
2021,196413,20,3,4,2,2
2021,196413,30,0,248,117,131
2021,196413,30,1,1,0,1
2021,196413,30,2,4,2,2
2021,196413,30,3,243,115,128
2021,196413,40,0,260,119,141
2021,196413,40,1,91,50,41
2021,196413,40,2,45,15,30
2021,196413,40,3,124,54,70
2021,196413,41,0,196,84,112
2021,196413,41,1,63,31,32
2021,196413,41,2,35,11,24
2021,196413,41,3,98,42,56
2021,196413,42,0,4,3,1
2021,196413,42,1,2,2,0
2021,196413,42,2,2,1,1
2021,196413,43,0,60,32,28
2021,196413,43,1,26,17,9
2021,196413,43,2,8,3,5
2021,196413,43,3,26,12,14
2021,196413,44,0,196,84,112
2021,196413,44,1,63,31,32
2021,196413,44,2,35,11,24
2021,196413,44,3,98,42,56
2021,196431,0,0,21,21,0
2021,196431,10,0,21,21,0
2021,196431,10,4,21,21,0
2021,196431,40,0,21,21,0
2021,196431,40,4,21,21,0
2021,196431,42,0,21,21,0
2021,196431,42,4,21,21,0
2021,196468,0,0,220,77,143
2021,196468,10,0,220,77,143
2021,196468,10,1,88,40,48
2021,196468,10,2,56,19,37
2021,196468,10,3,6,3,3
2021,196468,10,4,5,0,5
2021,196468,10,5,64,15,49
2021,196468,10,6,1,0,1
2021,196468,20,0,123,49,74
2021,196468,20,1,76,35,41
2021,196468,20,2,45,14,31
2021,196468,20,3,1,0,1
2021,196468,20,5,1,0,1
2021,196468,30,0,9,4,5
2021,196468,30,2,4,1,3
2021,196468,30,3,5,3,2
2021,196468,40,0,88,24,64
2021,196468,40,1,12,5,7
2021,196468,40,2,7,4,3
2021,196468,40,4,5,0,5
2021,196468,40,5,63,15,48
2021,196468,40,6,1,0,1
2021,196468,41,0,64,19,45
2021,196468,41,1,11,5,6
2021,196468,41,2,6,3,3
2021,196468,41,4,1,0,1
2021,196468,41,5,45,11,34
2021,196468,41,6,1,0,1
2021,196468,42,0,20,3,17
2021,196468,42,4,4,0,4
2021,196468,42,5,16,3,13
2021,196468,43,0,4,2,2
2021,196468,43,1,1,0,1
2021,196468,43,2,1,1,0
2021,196468,43,5,2,1,1
2021,196468,44,0,64,19,45
2021,196468,44,1,11,5,6
2021,196468,44,2,6,3,3
2021,196468,44,4,1,0,1
2021,196468,44,5,45,11,34
2021,196468,44,6,1,0,1
2021,196565,0,0,50,17,33
2021,196565,10,0,50,17,33
2021,196565,10,1,36,13,23
2021,196565,10,2,5,0,5
2021,196565,10,3,6,2,4
2021,196565,10,4,3,2,1
2021,196565,20,0,43,15,28
2021,196565,20,1,36,13,23
2021,196565,20,2,5,0,5
2021,196565,20,3,2,2,0
2021,196565,30,0,7,2,5
2021,196565,30,3,4,0,4
2021,196565,30,4,3,2,1
2021,196592,0,0,479,238,241
2021,196592,10,0,479,238,241
2021,196592,10,1,58,36,22
2021,196592,10,2,117,60,57
2021,196592,10,3,198,84,114
2021,196592,10,4,98,53,45
2021,196592,10,5,8,5,3
2021,196592,20,0,27,19,8
2021,196592,20,1,20,13,7
2021,196592,20,2,6,5,1
2021,196592,20,4,1,1,0
2021,196592,30,0,4,0,4
2021,196592,30,2,1,0,1
2021,196592,30,3,3,0,3
2021,196592,40,0,448,219,229
2021,196592,40,1,38,23,15
2021,196592,40,2,110,55,55
2021,196592,40,3,195,84,111
2021,196592,40,4,97,52,45
2021,196592,40,5,8,5,3
2021,196592,41,0,118,44,74
2021,196592,41,1,20,9,11
2021,196592,41,2,38,14,24
2021,196592,41,3,49,11,38
2021,196592,41,4,11,10,1
2021,196592,42,0,330,175,155
2021,196592,42,1,18,14,4
2021,196592,42,2,72,41,31
2021,196592,42,3,146,73,73
2021,196592,42,4,86,42,44
2021,196592,42,5,8,5,3
2021,196592,44,0,107,34,73
2021,196592,44,1,18,8,10
2021,196592,44,2,38,14,24
2021,196592,44,3,49,11,38
2021,196592,44,4,2,1,1
2021,196592,45,0,11,10,1
2021,196592,45,1,2,1,1
2021,196592,45,4,9,9,0
2021,196653,0,0,27,6,21
2021,196653,10,0,27,6,21
2021,196653,10,1,7,3,4
2021,196653,10,2,4,1,3
2021,196653,10,3,10,2,8
2021,196653,10,4,6,0,6
2021,196653,40,0,27,6,21
2021,196653,40,1,7,3,4
2021,196653,40,2,4,1,3
2021,196653,40,3,10,2,8
2021,196653,40,4,6,0,6
2021,196653,41,0,18,5,13
2021,196653,41,1,7,3,4
2021,196653,41,2,4,1,3
2021,196653,41,3,6,1,5
2021,196653,41,4,1,0,1
2021,196653,42,0,9,1,8
2021,196653,42,3,4,1,3
2021,196653,42,4,5,0,5
2021,196653,44,0,9,1,8
2021,196653,44,2,3,0,3
2021,196653,44,3,5,1,4
2021,196653,44,4,1,0,1
2021,196653,45,0,9,4,5
2021,196653,45,1,7,3,4
2021,196653,45,2,1,1,0
2021,196653,45,3,1,0,1
2021,196680,0,0,3,0,3
2021,196680,10,0,3,0,3
2021,196680,10,6,3,0,3
2021,196680,40,0,3,0,3
2021,196680,40,6,3,0,3
2021,196680,41,0,1,0,1
2021,196680,41,6,1,0,1
2021,196680,42,0,2,0,2
2021,196680,42,6,2,0,2
2021,196680,45,0,1,0,1
2021,196680,45,6,1,0,1
2021,196699,0,0,55,23,32
2021,196699,10,0,55,23,32
2021,196699,10,1,19,11,8
2021,196699,10,2,19,6,13
2021,196699,10,3,16,6,10
2021,196699,10,4,1,0,1
2021,196699,20,0,42,19,23
2021,196699,20,1,19,11,8
2021,196699,20,2,18,5,13
2021,196699,20,3,5,3,2
2021,196699,30,0,12,4,8
2021,196699,30,2,1,1,0
2021,196699,30,3,11,3,8
2021,196699,40,0,1,0,1
2021,196699,40,4,1,0,1
2021,196699,42,0,1,0,1
2021,196699,42,4,1,0,1
2021,196866,0,0,210,119,91
2021,196866,10,0,210,119,91
2021,196866,10,1,82,51,31
2021,196866,10,2,61,33,28
2021,196866,10,3,29,14,15
2021,196866,10,4,21,11,10
2021,196866,10,5,17,10,7
2021,196866,20,0,143,84,59
2021,196866,20,1,82,51,31
2021,196866,20,2,61,33,28
2021,196866,30,0,29,14,15
2021,196866,30,3,29,14,15
2021,196866,40,0,38,21,17
2021,196866,40,4,21,11,10
2021,196866,40,5,17,10,7
2021,196866,41,0,36,20,16
2021,196866,41,4,19,10,9
2021,196866,41,5,17,10,7
2021,196866,42,0,2,1,1
2021,196866,42,4,2,1,1
2021,196866,44,0,36,20,16
2021,196866,44,4,19,10,9
2021,196866,44,5,17,10,7
2021,196884,0,0,21,10,11
2021,196884,10,0,21,10,11
2021,196884,10,1,9,4,5
2021,196884,10,2,10,5,5
2021,196884,10,3,2,1,1
2021,196884,20,0,17,7,10
2021,196884,20,1,9,4,5
2021,196884,20,2,8,3,5
2021,196884,30,0,2,1,1
2021,196884,30,3,2,1,1
2021,196884,40,0,2,2,0
2021,196884,40,2,2,2,0
2021,196884,41,0,2,2,0
2021,196884,41,2,2,2,0
2021,196884,44,0,2,2,0
2021,196884,44,2,2,2,0
2021,197018,0,0,106,106,0
2021,197018,10,0,64,64,0
2021,197018,10,1,15,15,0
2021,197018,10,2,9,9,0
2021,197018,10,3,14,14,0
2021,197018,10,4,15,15,0
2021,197018,10,5,11,11,0
2021,197018,40,0,64,64,0
2021,197018,40,1,15,15,0
2021,197018,40,2,9,9,0
2021,197018,40,3,14,14,0
2021,197018,40,4,15,15,0
2021,197018,40,5,11,11,0
2021,197018,43,0,64,64,0
2021,197018,43,1,15,15,0
2021,197018,43,2,9,9,0
2021,197018,43,3,14,14,0
2021,197018,43,4,15,15,0
2021,197018,43,5,11,11,0
2021,197018,50,0,42,42,0
2021,197027,0,0,108,91,17
2021,197027,10,0,104,87,17
2021,197027,10,1,26,21,5
2021,197027,10,2,29,26,3
2021,197027,10,3,19,15,4
2021,197027,10,4,30,25,5
2021,197027,20,0,58,48,10
2021,197027,20,1,26,21,5
2021,197027,20,2,26,23,3
2021,197027,20,3,6,4,2
2021,197027,30,0,16,14,2
2021,197027,30,2,3,3,0
2021,197027,30,3,13,11,2
2021,197027,40,0,30,25,5
2021,197027,40,4,30,25,5
2021,197027,41,0,1,0,1
2021,197027,41,4,1,0,1
2021,197027,42,0,29,25,4
2021,197027,42,4,29,25,4
2021,197027,45,0,1,0,1
2021,197027,45,4,1,0,1
2021,197027,50,0,4,4,0
2021,197036,0,0,278,188,90
2021,197036,10,0,278,188,90
2021,197036,10,1,54,39,15
2021,197036,10,2,55,41,14
2021,197036,10,3,112,75,37
2021,197036,10,4,39,26,13
2021,197036,10,5,13,4,9
2021,197036,10,6,5,3,2
2021,197036,20,0,95,69,26
2021,197036,20,1,50,36,14
2021,197036,20,2,44,32,12
2021,197036,20,3,1,1,0
2021,197036,30,0,24,17,7
2021,197036,30,1,1,1,0
2021,197036,30,2,1,1,0
2021,197036,30,3,22,15,7
2021,197036,40,0,159,102,57
2021,197036,40,1,3,2,1
2021,197036,40,2,10,8,2
2021,197036,40,3,89,59,30
2021,197036,40,4,39,26,13
2021,197036,40,5,13,4,9
2021,197036,40,6,5,3,2
2021,197036,41,0,83,54,29
2021,197036,41,1,1,1,0
2021,197036,41,2,4,2,2
2021,197036,41,3,34,27,7
2021,197036,41,4,27,18,9
2021,197036,41,5,12,3,9
2021,197036,41,6,5,3,2
2021,197036,42,0,76,48,28
2021,197036,42,1,2,1,1
2021,197036,42,2,6,6,0
2021,197036,42,3,55,32,23
2021,197036,42,4,12,8,4
2021,197036,42,5,1,1,0
2021,197036,44,0,66,48,18
2021,197036,44,1,1,1,0
2021,197036,44,2,4,2,2
2021,197036,44,3,34,27,7
2021,197036,44,4,27,18,9
2021,197036,45,0,17,6,11
2021,197036,45,5,12,3,9
2021,197036,45,6,5,3,2
2021,197045,0,0,171,78,93
2021,197045,10,0,171,78,93
2021,197045,10,1,33,24,9
2021,197045,10,2,46,25,21
2021,197045,10,3,54,18,36
2021,197045,10,6,38,11,27
2021,197045,20,0,73,44,29
2021,197045,20,1,33,24,9
2021,197045,20,2,39,20,19
2021,197045,20,3,1,0,1
2021,197045,30,0,54,20,34
2021,197045,30,2,7,5,2
2021,197045,30,3,47,15,32
2021,197045,40,0,44,14,30
2021,197045,40,3,6,3,3
2021,197045,40,6,38,11,27
2021,197045,41,0,43,13,30
2021,197045,41,3,6,3,3
2021,197045,41,6,37,10,27
2021,197045,42,0,1,1,0
2021,197045,42,6,1,1,0
2021,197045,44,0,43,13,30
2021,197045,44,3,6,3,3
2021,197045,44,6,37,10,27
2021,197133,0,0,297,157,140
2021,197133,10,0,297,157,140
2021,197133,10,1,96,49,47
2021,197133,10,2,67,35,32
2021,197133,10,3,55,24,31
2021,197133,10,5,13,6,7
2021,197133,10,6,66,43,23
2021,197133,20,0,167,86,81
2021,197133,20,1,96,49,47
2021,197133,20,2,67,35,32
2021,197133,20,6,4,2,2
2021,197133,30,0,55,24,31
2021,197133,30,3,55,24,31
2021,197133,40,0,75,47,28
2021,197133,40,5,13,6,7
2021,197133,40,6,62,41,21
2021,197133,41,0,42,30,12
2021,197133,41,5,13,6,7
2021,197133,41,6,29,24,5
2021,197133,42,0,33,17,16
2021,197133,42,6,33,17,16
2021,197133,44,0,42,30,12
2021,197133,44,5,13,6,7
2021,197133,44,6,29,24,5
2021,197142,0,0,27,12,15
2021,197142,10,0,27,12,15
2021,197142,10,1,7,2,5
2021,197142,10,2,9,6,3
2021,197142,10,3,7,3,4
2021,197142,10,4,4,1,3
2021,197142,40,0,27,12,15
2021,197142,40,1,7,2,5
2021,197142,40,2,9,6,3
2021,197142,40,3,7,3,4
2021,197142,40,4,4,1,3
2021,197142,42,0,27,12,15
2021,197142,42,1,7,2,5
2021,197142,42,2,9,6,3
2021,197142,42,3,7,3,4
2021,197142,42,4,4,1,3
2021,197151,0,0,241,139,102
2021,197151,10,0,241,139,102
2021,197151,10,6,241,139,102
2021,197151,40,0,241,139,102
2021,197151,40,6,241,139,102
2021,197151,42,0,241,139,102
2021,197151,42,6,241,139,102
2021,197197,0,0,115,47,68
2021,197197,10,0,109,43,66
2021,197197,10,1,29,14,15
2021,197197,10,2,30,12,18
2021,197197,10,3,21,9,12
2021,197197,10,6,29,8,21
2021,197197,20,0,63,26,37
2021,197197,20,1,29,14,15
2021,197197,20,2,29,11,18
2021,197197,20,3,5,1,4
2021,197197,30,0,8,5,3
2021,197197,30,2,1,1,0
2021,197197,30,3,7,4,3
2021,197197,40,0,38,12,26
2021,197197,40,3,9,4,5
2021,197197,40,6,29,8,21
2021,197197,41,0,31,11,20
2021,197197,41,3,9,4,5
2021,197197,41,6,22,7,15
2021,197197,43,0,7,1,6
2021,197197,43,6,7,1,6
2021,197197,44,0,25,9,16
2021,197197,44,3,9,4,5
2021,197197,44,6,16,5,11
2021,197197,45,0,6,2,4
2021,197197,45,6,6,2,4
2021,197197,50,0,6,4,2
2021,197221,0,0,9,8,1
2021,197221,10,0,9,8,1
2021,197221,10,1,6,5,1
2021,197221,10,2,2,2,0
2021,197221,10,3,1,1,0
2021,197221,40,0,9,8,1
2021,197221,40,1,6,5,1
2021,197221,40,2,2,2,0
2021,197221,40,3,1,1,0
2021,197221,41,0,9,8,1
2021,197221,41,1,6,5,1
2021,197221,41,2,2,2,0
2021,197221,41,3,1,1,0
2021,197221,44,0,9,8,1
2021,197221,44,1,6,5,1
2021,197221,44,2,2,2,0
2021,197221,44,3,1,1,0
2021,197230,0,0,29,15,14
2021,197230,10,0,29,15,14
2021,197230,10,1,10,6,4
2021,197230,10,2,6,4,2
2021,197230,10,3,12,5,7
2021,197230,10,4,1,0,1
2021,197230,20,0,16,10,6
2021,197230,20,1,10,6,4
2021,197230,20,2,6,4,2
2021,197230,30,0,8,4,4
2021,197230,30,3,8,4,4
2021,197230,40,0,5,1,4
2021,197230,40,3,4,1,3
2021,197230,40,4,1,0,1
2021,197230,41,0,4,1,3
2021,197230,41,3,4,1,3
2021,197230,42,0,1,0,1
2021,197230,42,4,1,0,1
2021,197230,44,0,4,1,3
2021,197230,44,3,4,1,3
2021,197285,0,0,20,9,11
2021,197285,10,0,20,9,11
2021,197285,10,1,4,1,3
2021,197285,10,2,3,3,0
2021,197285,10,3,13,5,8
2021,197285,40,0,20,9,11
2021,197285,40,1,4,1,3
2021,197285,40,2,3,3,0
2021,197285,40,3,13,5,8
2021,197285,41,0,20,9,11
2021,197285,41,1,4,1,3
2021,197285,41,2,3,3,0
2021,197285,41,3,13,5,8
2021,197285,45,0,20,9,11
2021,197285,45,1,4,1,3
2021,197285,45,2,3,3,0
2021,197285,45,3,13,5,8
2021,197294,0,0,164,76,88
2021,197294,10,0,164,76,88
2021,197294,10,1,45,18,27
2021,197294,10,2,29,16,13
2021,197294,10,3,57,25,32
2021,197294,10,4,33,17,16
2021,197294,20,0,126,58,68
2021,197294,20,1,45,18,27
2021,197294,20,2,29,16,13
2021,197294,20,3,52,24,28
2021,197294,30,0,38,18,20
2021,197294,30,3,5,1,4
2021,197294,30,4,33,17,16
2021,197647,0,0,11,11,0
2021,197647,10,0,11,11,0
2021,197647,10,4,11,11,0
2021,197647,40,0,11,11,0
2021,197647,40,4,11,11,0
2021,197647,42,0,11,11,0
2021,197647,42,4,11,11,0
2021,197674,0,0,10,10,0
2021,197674,10,0,10,10,0
2021,197674,10,1,4,4,0
2021,197674,10,4,6,6,0
2021,197674,20,0,7,7,0
2021,197674,20,1,4,4,0
2021,197674,20,4,3,3,0
2021,197674,40,0,3,3,0
2021,197674,40,4,3,3,0
2021,197674,42,0,3,3,0
2021,197674,42,4,3,3,0
2021,197708,0,0,364,222,142
2021,197708,10,0,364,222,142
2021,197708,10,1,95,71,24
2021,197708,10,2,64,33,31
2021,197708,10,3,46,21,25
2021,197708,10,4,159,97,62
2021,197708,20,0,144,97,47
2021,197708,20,1,90,67,23
2021,197708,20,2,51,27,24
2021,197708,20,3,3,3,0
2021,197708,30,0,34,13,21
2021,197708,30,2,3,1,2
2021,197708,30,3,31,12,19
2021,197708,40,0,186,112,74
2021,197708,40,1,5,4,1
2021,197708,40,2,10,5,5
2021,197708,40,3,12,6,6
2021,197708,40,4,159,97,62
2021,197708,42,0,186,112,74
2021,197708,42,1,5,4,1
2021,197708,42,2,10,5,5
2021,197708,42,3,12,6,6
2021,197708,42,4,159,97,62
2021,197735,0,0,77,77,0
2021,197735,10,0,77,77,0
2021,197735,10,4,77,77,0
2021,197735,40,0,77,77,0
2021,197735,40,4,77,77,0
2021,197735,42,0,77,77,0
2021,197735,42,4,77,77,0
2021,197814,0,0,79,31,48
2021,197814,10,0,79,31,48
2021,197814,10,6,79,31,48
2021,197814,40,0,79,31,48
2021,197814,40,6,79,31,48
2021,197814,42,0,79,31,48
2021,197814,42,6,79,31,48
2021,197850,0,0,82,41,41
2021,197850,10,0,67,28,39
2021,197850,10,6,67,28,39
2021,197850,40,0,67,28,39
2021,197850,40,6,67,28,39
2021,197850,42,0,67,28,39
2021,197850,42,6,67,28,39
2021,197850,50,0,15,13,2
2021,197869,0,0,1033,514,519
2021,197869,10,0,1033,514,519
2021,197869,10,1,321,184,137
2021,197869,10,2,212,110,102
2021,197869,10,3,245,113,132
2021,197869,10,4,15,1,14
2021,197869,10,5,222,96,126
2021,197869,10,6,18,10,8
2021,197869,20,0,524,291,233
2021,197869,20,1,318,182,136
2021,197869,20,2,206,109,97
2021,197869,30,0,221,102,119
2021,197869,30,2,5,0,5
2021,197869,30,3,216,102,114
2021,197869,40,0,288,121,167
2021,197869,40,1,3,2,1
2021,197869,40,2,1,1,0
2021,197869,40,3,29,11,18
2021,197869,40,4,15,1,14
2021,197869,40,5,222,96,126
2021,197869,40,6,18,10,8
2021,197869,41,0,133,57,76
2021,197869,41,1,1,1,0
2021,197869,41,3,11,4,7
2021,197869,41,4,7,0,7
2021,197869,41,5,106,46,60
2021,197869,41,6,8,6,2
2021,197869,42,0,150,63,87
2021,197869,42,1,2,1,1
2021,197869,42,2,1,1,0
2021,197869,42,3,18,7,11
2021,197869,42,4,8,1,7
2021,197869,42,5,113,49,64
2021,197869,42,6,8,4,4
2021,197869,43,0,5,1,4
2021,197869,43,5,3,1,2
2021,197869,43,6,2,0,2
2021,197869,44,0,133,57,76
2021,197869,44,1,1,1,0
2021,197869,44,3,11,4,7
2021,197869,44,4,7,0,7
2021,197869,44,5,106,46,60
2021,197869,44,6,8,6,2
2021,197887,0,0,176,66,110
2021,197887,10,0,176,66,110
2021,197887,10,6,176,66,110
2021,197887,40,0,176,66,110
2021,197887,40,6,176,66,110
2021,197887,42,0,176,66,110
2021,197887,42,6,176,66,110
2021,197911,0,0,63,31,32
2021,197911,10,0,58,30,28
2021,197911,10,1,13,6,7
2021,197911,10,2,11,8,3
2021,197911,10,3,33,16,17
2021,197911,10,4,1,0,1
2021,197911,20,0,23,14,9
2021,197911,20,1,13,6,7
2021,197911,20,2,10,8,2
2021,197911,30,0,26,15,11
2021,197911,30,2,1,0,1
2021,197911,30,3,25,15,10
2021,197911,40,0,9,1,8
2021,197911,40,3,8,1,7
2021,197911,40,4,1,0,1
2021,197911,42,0,9,1,8
2021,197911,42,3,8,1,7
2021,197911,42,4,1,0,1
2021,197911,50,0,5,1,4
2021,197966,0,0,44,16,28
2021,197966,10,0,44,16,28
2021,197966,10,6,44,16,28
2021,197966,40,0,44,16,28
2021,197966,40,6,44,16,28
2021,197966,42,0,44,16,28
2021,197966,42,6,44,16,28
2021,197984,0,0,84,42,42
2021,197984,10,0,84,42,42
2021,197984,10,1,7,4,3
2021,197984,10,2,34,19,15
2021,197984,10,3,31,15,16
2021,197984,10,4,3,1,2
2021,197984,10,5,9,3,6
2021,197984,20,0,26,16,10
2021,197984,20,1,7,4,3
2021,197984,20,2,19,12,7
2021,197984,30,0,35,15,20
2021,197984,30,2,11,4,7
2021,197984,30,3,24,11,13
2021,197984,40,0,23,11,12
2021,197984,40,2,4,3,1
2021,197984,40,3,7,4,3
2021,197984,40,4,3,1,2
2021,197984,40,5,9,3,6
2021,197984,42,0,23,11,12
2021,197984,42,2,4,3,1
2021,197984,42,3,7,4,3
2021,197984,42,4,3,1,2
2021,197984,42,5,9,3,6
2021,197993,0,0,14,2,12
2021,197993,10,0,14,2,12
2021,197993,10,2,4,0,4
2021,197993,10,3,9,2,7
2021,197993,10,4,1,0,1
2021,197993,20,0,6,0,6
2021,197993,20,2,4,0,4
2021,197993,20,3,2,0,2
2021,197993,30,0,2,0,2
2021,197993,30,3,2,0,2
2021,197993,40,0,6,2,4
2021,197993,40,3,5,2,3
2021,197993,40,4,1,0,1
2021,197993,42,0,6,2,4
2021,197993,42,3,5,2,3
2021,197993,42,4,1,0,1
2021,198011,0,0,44,21,23
2021,198011,10,0,44,21,23
2021,198011,10,6,44,21,23
2021,198011,40,0,44,21,23
2021,198011,40,6,44,21,23
2021,198011,42,0,44,21,23
2021,198011,42,6,44,21,23
2021,198039,0,0,68,28,40
2021,198039,10,0,68,28,40
2021,198039,10,6,68,28,40
2021,198039,40,0,68,28,40
2021,198039,40,6,68,28,40
2021,198039,42,0,68,28,40
2021,198039,42,6,68,28,40
2021,198066,0,0,51,27,24
2021,198066,10,0,51,27,24
2021,198066,10,1,10,3,7
2021,198066,10,2,12,8,4
2021,198066,10,3,29,16,13
2021,198066,20,0,19,8,11
2021,198066,20,1,10,3,7
2021,198066,20,2,9,5,4
2021,198066,30,0,20,10,10
2021,198066,30,2,1,1,0
2021,198066,30,3,19,9,10
2021,198066,40,0,12,9,3
2021,198066,40,2,2,2,0
2021,198066,40,3,10,7,3
2021,198066,42,0,12,9,3
2021,198066,42,2,2,2,0
2021,198066,42,3,10,7,3
2021,198084,0,0,43,16,27
2021,198084,10,0,43,16,27
2021,198084,10,6,43,16,27
2021,198084,40,0,43,16,27
2021,198084,40,6,43,16,27
2021,198084,42,0,38,15,23
2021,198084,42,6,38,15,23
2021,198084,43,0,5,1,4
2021,198084,43,6,5,1,4
2021,198109,0,0,33,5,28
2021,198109,10,0,33,5,28
2021,198109,10,2,13,2,11
2021,198109,10,3,9,2,7
2021,198109,10,4,10,1,9
2021,198109,10,6,1,0,1
2021,198109,40,0,33,5,28
2021,198109,40,2,13,2,11
2021,198109,40,3,9,2,7
2021,198109,40,4,10,1,9
2021,198109,40,6,1,0,1
2021,198109,41,0,33,5,28
2021,198109,41,2,13,2,11
2021,198109,41,3,9,2,7
2021,198109,41,4,10,1,9
2021,198109,41,6,1,0,1
2021,198109,45,0,33,5,28
2021,198109,45,2,13,2,11
2021,198109,45,3,9,2,7
2021,198109,45,4,10,1,9
2021,198109,45,6,1,0,1
2021,198118,0,0,93,41,52
2021,198118,10,0,93,41,52
2021,198118,10,6,93,41,52
2021,198118,40,0,93,41,52
2021,198118,40,6,93,41,52
2021,198118,42,0,93,41,52
2021,198118,42,6,93,41,52
2021,198136,0,0,256,144,112
2021,198136,10,0,254,142,112
2021,198136,10,1,42,28,14
2021,198136,10,2,103,56,47
2021,198136,10,3,77,45,32
2021,198136,10,4,26,11,15
2021,198136,10,5,1,0,1
2021,198136,10,6,5,2,3
2021,198136,20,0,54,32,22
2021,198136,20,1,29,20,9
2021,198136,20,2,25,12,13
2021,198136,30,0,161,88,73
2021,198136,30,1,12,8,4
2021,198136,30,2,76,44,32
2021,198136,30,3,61,34,27
2021,198136,30,4,11,2,9
2021,198136,30,6,1,0,1
2021,198136,40,0,39,22,17
2021,198136,40,1,1,0,1
2021,198136,40,2,2,0,2
2021,198136,40,3,16,11,5
2021,198136,40,4,15,9,6
2021,198136,40,5,1,0,1
2021,198136,40,6,4,2,2
2021,198136,42,0,39,22,17
2021,198136,42,1,1,0,1
2021,198136,42,2,2,0,2
2021,198136,42,3,16,11,5
2021,198136,42,4,15,9,6
2021,198136,42,5,1,0,1
2021,198136,42,6,4,2,2
2021,198136,50,0,2,2,0
2021,198154,0,0,265,123,142
2021,198154,10,0,264,123,141
2021,198154,10,6,264,123,141
2021,198154,40,0,264,123,141
2021,198154,40,6,264,123,141
2021,198154,42,0,260,122,138
2021,198154,42,6,260,122,138
2021,198154,43,0,4,1,3
2021,198154,43,6,4,1,3
2021,198154,50,0,1,0,1
2021,198206,0,0,62,28,34
2021,198206,10,0,62,28,34
2021,198206,10,6,62,28,34
2021,198206,40,0,62,28,34
2021,198206,40,6,62,28,34
2021,198206,42,0,62,28,34
2021,198206,42,6,62,28,34
2021,198215,0,0,82,34,48
2021,198215,10,0,81,33,48
2021,198215,10,1,16,10,6
2021,198215,10,2,25,13,12
2021,198215,10,3,37,10,27
2021,198215,10,4,3,0,3
2021,198215,20,0,32,21,11
2021,198215,20,1,16,10,6
2021,198215,20,2,16,11,5
2021,198215,30,0,33,10,23
2021,198215,30,2,9,2,7
2021,198215,30,3,24,8,16
2021,198215,40,0,16,2,14
2021,198215,40,3,13,2,11
2021,198215,40,4,3,0,3
2021,198215,41,0,4,1,3
2021,198215,41,3,4,1,3
2021,198215,43,0,12,1,11
2021,198215,43,3,9,1,8
2021,198215,43,4,3,0,3
2021,198215,44,0,4,1,3
2021,198215,44,3,4,1,3
2021,198215,50,0,1,1,0
2021,198233,0,0,140,66,74
2021,198233,10,0,140,66,74
2021,198233,10,6,140,66,74
2021,198233,40,0,140,66,74
2021,198233,40,6,140,66,74
2021,198233,42,0,140,66,74
2021,198233,42,6,140,66,74
2021,198251,0,0,167,70,97
2021,198251,10,0,167,70,97
2021,198251,10,6,167,70,97
2021,198251,40,0,167,70,97
2021,198251,40,6,167,70,97
2021,198251,42,0,167,70,97
2021,198251,42,6,167,70,97
2021,198260,0,0,344,150,194
2021,198260,10,0,344,150,194
2021,198260,10,6,344,150,194
2021,198260,40,0,344,150,194
2021,198260,40,6,344,150,194
2021,198260,42,0,344,150,194
2021,198260,42,6,344,150,194
2021,198303,0,0,48,26,22
2021,198303,10,0,48,26,22
2021,198303,10,1,14,8,6
2021,198303,10,2,19,11,8
2021,198303,10,3,13,7,6
2021,198303,10,4,2,0,2
2021,198303,20,0,29,17,12
2021,198303,20,1,14,8,6
2021,198303,20,2,15,9,6
2021,198303,30,0,12,8,4
2021,198303,30,2,3,2,1
2021,198303,30,3,9,6,3
2021,198303,40,0,7,1,6
2021,198303,40,2,1,0,1
2021,198303,40,3,4,1,3
2021,198303,40,4,2,0,2
2021,198303,42,0,7,1,6
2021,198303,42,2,1,0,1
2021,198303,42,3,4,1,3
2021,198303,42,4,2,0,2
2021,198321,0,0,67,26,41
2021,198321,10,0,67,26,41
2021,198321,10,6,67,26,41
2021,198321,40,0,67,26,41
2021,198321,40,6,67,26,41
2021,198321,42,0,8,5,3
2021,198321,42,6,8,5,3
2021,198321,43,0,59,21,38
2021,198321,43,6,59,21,38
2021,198330,0,0,135,59,76
2021,198330,10,0,135,59,76
2021,198330,10,6,135,59,76
2021,198330,40,0,135,59,76
2021,198330,40,6,135,59,76
2021,198330,42,0,135,59,76
2021,198330,42,6,135,59,76
2021,198367,0,0,68,32,36
2021,198367,10,0,68,32,36
2021,198367,10,6,68,32,36
2021,198367,40,0,68,32,36
2021,198367,40,6,68,32,36
2021,198367,42,0,68,32,36
2021,198367,42,6,68,32,36
2021,198376,0,0,84,40,44
2021,198376,10,0,84,40,44
2021,198376,10,6,84,40,44
2021,198376,40,0,84,40,44
2021,198376,40,6,84,40,44
2021,198376,42,0,84,40,44
2021,198376,42,6,84,40,44
2021,198385,0,0,212,107,105
2021,198385,10,0,209,105,104
2021,198385,10,1,85,49,36
2021,198385,10,2,43,24,19
2021,198385,10,3,75,32,43
2021,198385,10,4,1,0,1
2021,198385,10,5,5,0,5
2021,198385,20,0,122,70,52
2021,198385,20,1,83,48,35
2021,198385,20,2,39,22,17
2021,198385,30,0,45,14,31
2021,198385,30,1,1,0,1
2021,198385,30,2,2,1,1
2021,198385,30,3,41,13,28
2021,198385,30,4,1,0,1
2021,198385,40,0,42,21,21
2021,198385,40,1,1,1,0
2021,198385,40,2,2,1,1
2021,198385,40,3,34,19,15
2021,198385,40,5,5,0,5
2021,198385,41,0,38,19,19
2021,198385,41,1,1,1,0
2021,198385,41,2,2,1,1
2021,198385,41,3,30,17,13
2021,198385,41,5,5,0,5
2021,198385,42,0,4,2,2
2021,198385,42,3,4,2,2
2021,198385,44,0,35,18,17
2021,198385,44,1,1,1,0
2021,198385,44,2,1,1,0
2021,198385,44,3,28,16,12
2021,198385,44,5,5,0,5
2021,198385,45,0,3,1,2
2021,198385,45,2,1,0,1
2021,198385,45,3,2,1,1
2021,198385,50,0,3,2,1
2021,198419,0,0,4076,2377,1699
2021,198419,10,0,4076,2377,1699
2021,198419,10,1,1394,993,401
2021,198419,10,2,937,529,408
2021,198419,10,3,1284,644,640
2021,198419,10,4,322,162,160
2021,198419,10,5,139,49,90
2021,198419,20,0,1361,983,378
2021,198419,20,1,1008,762,246
2021,198419,20,2,353,221,132
2021,198419,30,0,266,154,112
2021,198419,30,2,95,55,40
2021,198419,30,3,171,99,72
2021,198419,40,0,2449,1240,1209
2021,198419,40,1,386,231,155
2021,198419,40,2,489,253,236
2021,198419,40,3,1113,545,568
2021,198419,40,4,322,162,160
2021,198419,40,5,139,49,90
2021,198419,41,0,2089,1068,1021
2021,198419,41,1,371,218,153
2021,198419,41,2,476,247,229
2021,198419,41,3,1101,536,565
2021,198419,41,4,105,55,50
2021,198419,41,5,36,12,24
2021,198419,42,0,360,172,188
2021,198419,42,1,15,13,2
2021,198419,42,2,13,6,7
2021,198419,42,3,12,9,3
2021,198419,42,4,217,107,110
2021,198419,42,5,103,37,66
2021,198419,44,0,2089,1068,1021
2021,198419,44,1,371,218,153
2021,198419,44,2,476,247,229
2021,198419,44,3,1101,536,565
2021,198419,44,4,105,55,50
2021,198419,44,5,36,12,24
2021,198455,0,0,152,48,104
2021,198455,10,0,152,48,104
2021,198455,10,4,152,48,104
2021,198455,40,0,152,48,104
2021,198455,40,4,152,48,104
2021,198455,42,0,150,48,102
2021,198455,42,4,150,48,102
2021,198455,43,0,2,0,2
2021,198455,43,4,2,0,2
2021,198464,0,0,1328,681,647
2021,198464,10,0,1306,668,638
2021,198464,10,1,307,202,105
2021,198464,10,2,481,249,232
2021,198464,10,3,358,154,204
2021,198464,10,4,160,63,97
2021,198464,20,0,675,402,273
2021,198464,20,1,287,196,91
2021,198464,20,2,385,204,181
2021,198464,20,3,3,2,1
2021,198464,30,0,194,94,100
2021,198464,30,2,8,6,2
2021,198464,30,3,186,88,98
2021,198464,40,0,437,172,265
2021,198464,40,1,20,6,14
2021,198464,40,2,88,39,49
2021,198464,40,3,169,64,105
2021,198464,40,4,160,63,97
2021,198464,41,0,138,63,75
2021,198464,41,1,9,3,6
2021,198464,41,2,45,22,23
2021,198464,41,3,74,33,41
2021,198464,41,4,10,5,5
2021,198464,42,0,24,9,15
2021,198464,42,1,1,1,0
2021,198464,42,2,3,1,2
2021,198464,42,3,10,5,5
2021,198464,42,4,10,2,8
2021,198464,43,0,275,100,175
2021,198464,43,1,10,2,8
2021,198464,43,2,40,16,24
2021,198464,43,3,85,26,59
2021,198464,43,4,140,56,84
2021,198464,44,0,138,63,75
2021,198464,44,1,9,3,6
2021,198464,44,2,45,22,23
2021,198464,44,3,74,33,41
2021,198464,44,4,10,5,5
2021,198464,50,0,22,13,9
2021,198491,0,0,67,18,49
2021,198491,10,0,67,18,49
2021,198491,10,6,67,18,49
2021,198491,40,0,67,18,49
2021,198491,40,6,67,18,49
2021,198491,42,0,67,18,49
2021,198491,42,6,67,18,49
2021,198507,0,0,84,52,32
2021,198507,10,0,84,52,32
2021,198507,10,1,17,14,3
2021,198507,10,2,26,17,9
2021,198507,10,3,28,15,13
2021,198507,10,5,13,6,7
2021,198507,20,0,37,26,11
2021,198507,20,1,15,13,2
2021,198507,20,2,22,13,9
2021,198507,30,0,26,15,11
2021,198507,30,1,2,1,1
2021,198507,30,2,3,3,0
2021,198507,30,3,19,11,8
2021,198507,30,5,2,0,2
2021,198507,40,0,21,11,10
2021,198507,40,2,1,1,0
2021,198507,40,3,9,4,5
2021,198507,40,5,11,6,5
2021,198507,41,0,6,4,2
2021,198507,41,2,1,1,0
2021,198507,41,3,5,3,2
2021,198507,42,0,14,6,8
2021,198507,42,3,4,1,3
2021,198507,42,5,10,5,5
2021,198507,43,0,1,1,0
2021,198507,43,5,1,1,0
2021,198507,44,0,6,4,2
2021,198507,44,2,1,1,0
2021,198507,44,3,5,3,2
2021,198516,0,0,456,222,234
2021,198516,10,0,456,222,234
2021,198516,10,1,92,50,42
2021,198516,10,2,160,82,78
2021,198516,10,3,134,58,76
2021,198516,10,4,5,1,4
2021,198516,10,5,65,31,34
2021,198516,20,0,226,123,103
2021,198516,20,1,88,48,40
2021,198516,20,2,138,75,63
2021,198516,30,0,103,42,61
2021,198516,30,1,2,2,0
2021,198516,30,2,4,0,4
2021,198516,30,3,97,40,57
2021,198516,40,0,127,57,70
2021,198516,40,1,2,0,2
2021,198516,40,2,18,7,11
2021,198516,40,3,37,18,19
2021,198516,40,4,5,1,4
2021,198516,40,5,65,31,34
2021,198516,42,0,127,57,70
2021,198516,42,1,2,0,2
2021,198516,42,2,18,7,11
2021,198516,42,3,37,18,19
2021,198516,42,4,5,1,4
2021,198516,42,5,65,31,34
2021,198534,0,0,320,144,176
2021,198534,10,0,320,144,176
2021,198534,10,6,320,144,176
2021,198534,40,0,320,144,176
2021,198534,40,6,320,144,176
2021,198534,42,0,314,142,172
2021,198534,42,6,314,142,172
2021,198534,43,0,6,2,4
2021,198534,43,6,6,2,4
2021,198543,0,0,250,134,116
2021,198543,10,0,247,132,115
2021,198543,10,1,83,59,24
2021,198543,10,2,68,29,39
2021,198543,10,3,35,15,20
2021,198543,10,4,2,1,1
2021,198543,10,5,40,18,22
2021,198543,10,6,19,10,9
2021,198543,20,0,148,83,65
2021,198543,20,1,78,55,23
2021,198543,20,2,65,27,38
2021,198543,20,3,5,1,4
2021,198543,30,0,30,17,13
2021,198543,30,1,4,3,1
2021,198543,30,2,2,2,0
2021,198543,30,3,24,12,12
2021,198543,40,0,69,32,37
2021,198543,40,1,1,1,0
2021,198543,40,2,1,0,1
2021,198543,40,3,6,2,4
2021,198543,40,4,2,1,1
2021,198543,40,5,40,18,22
2021,198543,40,6,19,10,9
2021,198543,41,0,4,2,2
2021,198543,41,4,1,0,1
2021,198543,41,5,3,2,1
2021,198543,42,0,64,29,35
2021,198543,42,1,1,1,0
2021,198543,42,2,1,0,1
2021,198543,42,3,6,2,4
2021,198543,42,4,1,1,0
2021,198543,42,5,37,16,21
2021,198543,42,6,18,9,9
2021,198543,43,0,1,1,0
2021,198543,43,6,1,1,0
2021,198543,44,0,4,2,2
2021,198543,44,4,1,0,1
2021,198543,44,5,3,2,1
2021,198543,50,0,3,2,1
2021,198552,0,0,216,86,130
2021,198552,10,0,216,86,130
2021,198552,10,1,24,6,18
2021,198552,10,2,11,2,9
2021,198552,10,3,6,2,4
2021,198552,10,4,175,76,99
2021,198552,40,0,216,86,130
2021,198552,40,1,24,6,18
2021,198552,40,2,11,2,9
2021,198552,40,3,6,2,4
2021,198552,40,4,175,76,99
2021,198552,41,0,216,86,130
2021,198552,41,1,24,6,18
2021,198552,41,2,11,2,9
2021,198552,41,3,6,2,4
2021,198552,41,4,175,76,99
2021,198552,45,0,216,86,130
2021,198552,45,1,24,6,18
2021,198552,45,2,11,2,9
2021,198552,45,3,6,2,4
2021,198552,45,4,175,76,99
2021,198561,0,0,148,69,79
2021,198561,10,0,148,69,79
2021,198561,10,1,56,37,19
2021,198561,10,2,33,13,20
2021,198561,10,3,41,13,28
2021,198561,10,4,17,6,11
2021,198561,10,5,1,0,1
2021,198561,20,0,69,39,30
2021,198561,20,1,49,31,18
2021,198561,20,2,20,8,12
2021,198561,30,0,20,6,14
2021,198561,30,2,4,2,2
2021,198561,30,3,16,4,12
2021,198561,40,0,59,24,35
2021,198561,40,1,7,6,1
2021,198561,40,2,9,3,6
2021,198561,40,3,25,9,16
2021,198561,40,4,17,6,11
2021,198561,40,5,1,0,1
2021,198561,42,0,59,24,35
2021,198561,42,1,7,6,1
2021,198561,42,2,9,3,6
2021,198561,42,3,25,9,16
2021,198561,42,4,17,6,11
2021,198561,42,5,1,0,1
2021,198570,0,0,136,48,88
2021,198570,10,0,136,48,88
2021,198570,10,6,136,48,88
2021,198570,40,0,136,48,88
2021,198570,40,6,136,48,88
2021,198570,42,0,27,16,11
2021,198570,42,6,27,16,11
2021,198570,43,0,109,32,77
2021,198570,43,6,109,32,77
2021,198598,0,0,45,22,23
2021,198598,10,0,44,21,23
2021,198598,10,1,22,13,9
2021,198598,10,2,7,3,4
2021,198598,10,3,12,4,8
2021,198598,10,4,3,1,2
2021,198598,20,0,10,6,4
2021,198598,20,1,9,5,4
2021,198598,20,2,1,1,0
2021,198598,30,0,2,1,1
2021,198598,30,2,2,1,1
2021,198598,40,0,32,14,18
2021,198598,40,1,13,8,5
2021,198598,40,2,4,1,3
2021,198598,40,3,12,4,8
2021,198598,40,4,3,1,2
2021,198598,41,0,12,8,4
2021,198598,41,1,12,8,4
2021,198598,42,0,19,6,13
2021,198598,42,1,1,0,1
2021,198598,42,2,4,1,3
2021,198598,42,3,12,4,8
2021,198598,42,4,2,1,1
2021,198598,43,0,1,0,1
2021,198598,43,4,1,0,1
2021,198598,44,0,12,8,4
2021,198598,44,1,12,8,4
2021,198598,50,0,1,1,0
2021,198613,0,0,75,39,36
2021,198613,10,0,75,39,36
2021,198613,10,1,29,16,13
2021,198613,10,2,22,11,11
2021,198613,10,3,4,1,3
2021,198613,10,4,20,11,9
2021,198613,20,0,50,26,24
2021,198613,20,1,29,16,13
2021,198613,20,2,20,10,10
2021,198613,20,3,1,0,1
2021,198613,30,0,5,2,3
2021,198613,30,2,2,1,1
2021,198613,30,3,3,1,2
2021,198613,40,0,20,11,9
2021,198613,40,4,20,11,9
2021,198613,42,0,20,11,9
2021,198613,42,4,20,11,9
2021,198622,0,0,271,144,127
2021,198622,10,0,271,144,127
2021,198622,10,6,271,144,127
2021,198622,40,0,271,144,127
2021,198622,40,6,271,144,127
2021,198622,42,0,271,144,127
2021,198622,42,6,271,144,127
2021,198640,0,0,32,18,14
2021,198640,10,0,32,18,14
2021,198640,10,6,32,18,14
2021,198640,40,0,32,18,14
2021,198640,40,6,32,18,14
2021,198640,42,0,32,18,14
2021,198640,42,6,32,18,14
2021,198668,0,0,57,27,30
2021,198668,10,0,56,27,29
2021,198668,10,6,56,27,29
2021,198668,40,0,56,27,29
2021,198668,40,6,56,27,29
2021,198668,42,0,56,27,29
2021,198668,42,6,56,27,29
2021,198668,50,0,1,0,1
2021,198695,0,0,320,168,152
2021,198695,10,0,320,168,152
2021,198695,10,1,31,22,9
2021,198695,10,2,100,57,43
2021,198695,10,3,150,72,78
2021,198695,10,4,39,17,22
2021,198695,20,0,100,59,41
2021,198695,20,1,25,19,6
2021,198695,20,2,75,40,35
2021,198695,30,0,97,50,47
2021,198695,30,1,1,0,1
2021,198695,30,2,10,6,4
2021,198695,30,3,86,44,42
2021,198695,40,0,123,59,64
2021,198695,40,1,5,3,2
2021,198695,40,2,15,11,4
2021,198695,40,3,64,28,36
2021,198695,40,4,39,17,22
2021,198695,42,0,123,59,64
2021,198695,42,1,5,3,2
2021,198695,42,2,15,11,4
2021,198695,42,3,64,28,36
2021,198695,42,4,39,17,22
2021,198710,0,0,56,21,35
2021,198710,10,0,56,21,35
2021,198710,10,6,56,21,35
2021,198710,40,0,56,21,35
2021,198710,40,6,56,21,35
2021,198710,42,0,56,21,35
2021,198710,42,6,56,21,35
2021,198729,0,0,37,12,25
2021,198729,10,0,37,12,25
2021,198729,10,6,37,12,25
2021,198729,40,0,37,12,25
2021,198729,40,6,37,12,25
2021,198729,42,0,37,12,25
2021,198729,42,6,37,12,25
2021,198756,0,0,83,37,46
2021,198756,10,0,83,37,46
2021,198756,10,1,10,3,7
2021,198756,10,2,24,11,13
2021,198756,10,3,39,17,22
2021,198756,10,4,10,6,4
2021,198756,20,0,37,17,20
2021,198756,20,1,10,3,7
2021,198756,20,2,23,10,13
2021,198756,20,3,4,4,0
2021,198756,30,0,14,3,11
2021,198756,30,3,14,3,11
2021,198756,40,0,32,17,15
2021,198756,40,2,1,1,0
2021,198756,40,3,21,10,11
2021,198756,40,4,10,6,4
2021,198756,42,0,32,17,15
2021,198756,42,2,1,1,0
2021,198756,42,3,21,10,11
2021,198756,42,4,10,6,4
2021,198774,0,0,114,49,65
2021,198774,10,0,114,49,65
2021,198774,10,6,114,49,65
2021,198774,40,0,114,49,65
2021,198774,40,6,114,49,65
2021,198774,42,0,114,49,65
2021,198774,42,6,114,49,65
2021,198808,0,0,62,25,37
2021,198808,10,0,62,25,37
2021,198808,10,1,8,4,4
2021,198808,10,2,15,8,7
2021,198808,10,3,20,8,12
2021,198808,10,4,19,5,14
2021,198808,40,0,62,25,37
2021,198808,40,1,8,4,4
2021,198808,40,2,15,8,7
2021,198808,40,3,20,8,12
2021,198808,40,4,19,5,14
2021,198808,41,0,36,15,21
2021,198808,41,1,8,4,4
2021,198808,41,2,14,7,7
2021,198808,41,3,9,3,6
2021,198808,41,4,5,1,4
2021,198808,42,0,21,9,12
2021,198808,42,2,1,1,0
2021,198808,42,3,11,5,6
2021,198808,42,4,9,3,6
2021,198808,43,0,5,1,4
2021,198808,43,4,5,1,4
2021,198808,44,0,36,15,21
2021,198808,44,1,8,4,4
2021,198808,44,2,14,7,7
2021,198808,44,3,9,3,6
2021,198808,44,4,5,1,4
2021,198817,0,0,98,34,64
2021,198817,10,0,98,34,64
2021,198817,10,6,98,34,64
2021,198817,40,0,98,34,64
2021,198817,40,6,98,34,64
2021,198817,42,0,98,34,64
2021,198817,42,6,98,34,64
2021,198835,0,0,139,59,80
2021,198835,10,0,139,59,80
2021,198835,10,1,41,24,17
2021,198835,10,2,30,17,13
2021,198835,10,3,47,13,34
2021,198835,10,4,21,5,16
2021,198835,20,0,62,38,24
2021,198835,20,1,41,24,17
2021,198835,20,2,21,14,7
2021,198835,30,0,29,6,23
2021,198835,30,2,4,1,3
2021,198835,30,3,25,5,20
2021,198835,40,0,48,15,33
2021,198835,40,2,5,2,3
2021,198835,40,3,22,8,14
2021,198835,40,4,21,5,16
2021,198835,42,0,48,15,33
2021,198835,42,2,5,2,3
2021,198835,42,3,22,8,14
2021,198835,42,4,21,5,16
2021,198862,0,0,59,30,29
2021,198862,10,0,59,30,29
2021,198862,10,1,6,3,3
2021,198862,10,2,12,6,6
2021,198862,10,3,20,9,11
2021,198862,10,4,21,12,9
2021,198862,20,0,9,6,3
2021,198862,20,1,6,3,3
2021,198862,20,2,2,2,0
2021,198862,20,3,1,1,0
2021,198862,30,0,13,5,8
2021,198862,30,2,8,2,6
2021,198862,30,3,4,2,2
2021,198862,30,4,1,1,0
2021,198862,40,0,37,19,18
2021,198862,40,2,2,2,0
2021,198862,40,3,15,6,9
2021,198862,40,4,20,11,9
2021,198862,42,0,37,19,18
2021,198862,42,2,2,2,0
2021,198862,42,3,15,6,9
2021,198862,42,4,20,11,9
2021,198871,0,0,23,8,15
2021,198871,10,0,23,8,15
2021,198871,10,1,2,1,1
2021,198871,10,2,2,1,1
2021,198871,10,3,10,6,4
2021,198871,10,4,9,0,9
2021,198871,40,0,23,8,15
2021,198871,40,1,2,1,1
2021,198871,40,2,2,1,1
2021,198871,40,3,10,6,4
2021,198871,40,4,9,0,9
2021,198871,42,0,23,8,15
2021,198871,42,1,2,1,1
2021,198871,42,2,2,1,1
2021,198871,42,3,10,6,4
2021,198871,42,4,9,0,9
2021,198899,0,0,71,31,40
2021,198899,10,0,71,31,40
2021,198899,10,1,19,10,9
2021,198899,10,2,27,9,18
2021,198899,10,3,23,12,11
2021,198899,10,4,2,0,2
2021,198899,20,0,45,19,26
2021,198899,20,1,19,10,9
2021,198899,20,2,23,8,15
2021,198899,20,3,3,1,2
2021,198899,30,0,18,11,7
2021,198899,30,2,3,1,2
2021,198899,30,3,15,10,5
2021,198899,40,0,8,1,7
2021,198899,40,2,1,0,1
2021,198899,40,3,5,1,4
2021,198899,40,4,2,0,2
2021,198899,42,0,8,1,7
2021,198899,42,2,1,0,1
2021,198899,42,3,5,1,4
2021,198899,42,4,2,0,2
2021,198905,0,0,26,12,14
2021,198905,10,0,26,12,14
2021,198905,10,6,26,12,14
2021,198905,40,0,26,12,14
2021,198905,40,6,26,12,14
2021,198905,42,0,26,12,14
2021,198905,42,6,26,12,14
2021,198914,0,0,25,9,16
2021,198914,10,0,25,9,16
2021,198914,10,6,25,9,16
2021,198914,40,0,25,9,16
2021,198914,40,6,25,9,16
2021,198914,42,0,25,9,16
2021,198914,42,6,25,9,16
2021,198923,0,0,38,19,19
2021,198923,10,0,38,19,19
2021,198923,10,4,38,19,19
2021,198923,40,0,38,19,19
2021,198923,40,4,38,19,19
2021,198923,42,0,38,19,19
2021,198923,42,4,38,19,19
2021,198950,0,0,126,39,87
2021,198950,10,0,126,39,87
2021,198950,10,1,48,17,31
2021,198950,10,2,31,9,22
2021,198950,10,3,39,10,29
2021,198950,10,4,6,2,4
2021,198950,10,6,2,1,1
2021,198950,20,0,69,22,47
2021,198950,20,1,44,14,30
2021,198950,20,2,25,8,17
2021,198950,30,0,26,6,20
2021,198950,30,2,4,0,4
2021,198950,30,3,22,6,16
2021,198950,40,0,31,11,20
2021,198950,40,1,4,3,1
2021,198950,40,2,2,1,1
2021,198950,40,3,17,4,13
2021,198950,40,4,6,2,4
2021,198950,40,6,2,1,1
2021,198950,41,0,8,2,6
2021,198950,41,1,1,0,1
2021,198950,41,2,1,1,0
2021,198950,41,3,5,1,4
2021,198950,41,4,1,0,1
2021,198950,42,0,23,9,14
2021,198950,42,1,3,3,0
2021,198950,42,2,1,0,1
2021,198950,42,3,12,3,9
2021,198950,42,4,5,2,3
2021,198950,42,6,2,1,1
2021,198950,44,0,8,2,6
2021,198950,44,1,1,0,1
2021,198950,44,2,1,1,0
2021,198950,44,3,5,1,4
2021,198950,44,4,1,0,1
2021,198969,0,0,142,77,65
2021,198969,10,0,142,77,65
2021,198969,10,1,40,25,15
2021,198969,10,2,42,29,13
2021,198969,10,3,52,20,32
2021,198969,10,4,8,3,5
2021,198969,20,0,70,44,26
2021,198969,20,1,40,25,15
2021,198969,20,2,27,17,10
2021,198969,20,3,3,2,1
2021,198969,30,0,45,19,26
2021,198969,30,2,5,5,0
2021,198969,30,3,40,14,26
2021,198969,40,0,27,14,13
2021,198969,40,2,10,7,3
2021,198969,40,3,9,4,5
2021,198969,40,4,8,3,5
2021,198969,42,0,27,14,13
2021,198969,42,2,10,7,3
2021,198969,42,3,9,4,5
2021,198969,42,4,8,3,5
2021,198978,0,0,5,1,4
2021,198978,10,0,5,1,4
2021,198978,10,4,5,1,4
2021,198978,40,0,5,1,4
2021,198978,40,4,5,1,4
2021,198978,41,0,5,1,4
2021,198978,41,4,5,1,4
2021,198978,45,0,5,1,4
2021,198978,45,4,5,1,4
2021,198987,0,0,75,27,48
2021,198987,10,0,75,27,48
2021,198987,10,6,75,27,48
2021,198987,40,0,75,27,48
2021,198987,40,6,75,27,48
2021,198987,42,0,75,27,48
2021,198987,42,6,75,27,48
2021,199023,0,0,36,18,18
2021,199023,10,0,36,18,18
2021,199023,10,6,36,18,18
2021,199023,40,0,36,18,18
2021,199023,40,6,36,18,18
2021,199023,42,0,36,18,18
2021,199023,42,6,36,18,18
2021,199032,0,0,41,28,13
2021,199032,10,0,41,28,13
2021,199032,10,1,11,8,3
2021,199032,10,2,7,4,3
2021,199032,10,3,23,16,7
2021,199032,20,0,12,10,2
2021,199032,20,1,7,6,1
2021,199032,20,2,3,2,1
2021,199032,20,3,2,2,0
2021,199032,30,0,1,1,0
2021,199032,30,2,1,1,0
2021,199032,40,0,28,17,11
2021,199032,40,1,4,2,2
2021,199032,40,2,3,1,2
2021,199032,40,3,21,14,7
2021,199032,42,0,28,17,11
2021,199032,42,1,4,2,2
2021,199032,42,2,3,1,2
2021,199032,42,3,21,14,7
2021,199069,0,0,61,33,28
2021,199069,10,0,61,33,28
2021,199069,10,1,16,12,4
2021,199069,10,2,21,9,12
2021,199069,10,3,23,11,12
2021,199069,10,4,1,1,0
2021,199069,40,0,61,33,28
2021,199069,40,1,16,12,4
2021,199069,40,2,21,9,12
2021,199069,40,3,23,11,12
2021,199069,40,4,1,1,0
2021,199069,41,0,44,23,21
2021,199069,41,1,12,9,3
2021,199069,41,2,20,9,11
2021,199069,41,3,11,4,7
2021,199069,41,4,1,1,0
2021,199069,42,0,17,10,7
2021,199069,42,1,4,3,1
2021,199069,42,2,1,0,1
2021,199069,42,3,12,7,5
2021,199069,44,0,44,23,21
2021,199069,44,1,12,9,3
2021,199069,44,2,20,9,11
2021,199069,44,3,11,4,7
2021,199069,44,4,1,1,0
2021,199087,0,0,107,41,66
2021,199087,10,0,107,41,66
2021,199087,10,6,107,41,66
2021,199087,40,0,107,41,66
2021,199087,40,6,107,41,66
2021,199087,42,0,107,41,66
2021,199087,42,6,107,41,66
2021,199102,0,0,462,272,190
2021,199102,10,0,462,272,190
2021,199102,10,1,109,86,23
2021,199102,10,2,164,87,77
2021,199102,10,3,129,63,66
2021,199102,10,4,2,1,1
2021,199102,10,5,25,15,10
2021,199102,10,6,33,20,13
2021,199102,20,0,223,147,76
2021,199102,20,1,97,75,22
2021,199102,20,2,125,72,53
2021,199102,20,3,1,0,1
2021,199102,30,0,171,86,85
2021,199102,30,1,11,10,1
2021,199102,30,2,37,14,23
2021,199102,30,3,120,60,60
2021,199102,30,5,3,2,1
2021,199102,40,0,68,39,29
2021,199102,40,1,1,1,0
2021,199102,40,2,2,1,1
2021,199102,40,3,8,3,5
2021,199102,40,4,2,1,1
2021,199102,40,5,22,13,9
2021,199102,40,6,33,20,13
2021,199102,41,0,3,3,0
2021,199102,41,5,3,3,0
2021,199102,42,0,47,26,21
2021,199102,42,1,1,1,0
2021,199102,42,2,2,1,1
2021,199102,42,3,6,2,4
2021,199102,42,4,2,1,1
2021,199102,42,5,11,6,5
2021,199102,42,6,25,15,10
2021,199102,43,0,18,10,8
2021,199102,43,3,2,1,1
2021,199102,43,5,8,4,4
2021,199102,43,6,8,5,3
2021,199102,44,0,3,3,0
2021,199102,44,5,3,3,0
2021,199111,0,0,211,104,107
2021,199111,10,0,211,104,107
2021,199111,10,1,66,36,30
2021,199111,10,2,55,29,26
2021,199111,10,3,31,14,17
2021,199111,10,4,1,0,1
2021,199111,10,5,58,25,33
2021,199111,20,0,118,63,55
2021,199111,20,1,64,35,29
2021,199111,20,2,54,28,26
2021,199111,30,0,29,14,15
2021,199111,30,2,1,1,0
2021,199111,30,3,28,13,15
2021,199111,40,0,64,27,37
2021,199111,40,1,2,1,1
2021,199111,40,3,3,1,2
2021,199111,40,4,1,0,1
2021,199111,40,5,58,25,33
2021,199111,41,0,27,14,13
2021,199111,41,4,1,0,1
2021,199111,41,5,26,14,12
2021,199111,42,0,35,11,24
2021,199111,42,1,2,1,1
2021,199111,42,3,3,1,2
2021,199111,42,5,30,9,21
2021,199111,43,0,2,2,0
2021,199111,43,5,2,2,0
2021,199111,44,0,27,14,13
2021,199111,44,4,1,0,1
2021,199111,44,5,26,14,12
2021,199120,0,0,1872,958,914
2021,199120,10,0,1872,958,914
2021,199120,10,1,707,451,256
2021,199120,10,2,497,242,255
2021,199120,10,3,391,152,239
2021,199120,10,4,49,12,37
2021,199120,10,5,221,98,123
2021,199120,10,6,7,3,4
2021,199120,20,0,982,607,375
2021,199120,20,1,618,411,207
2021,199120,20,2,364,196,168
2021,199120,30,0,244,124,120
2021,199120,30,2,15,8,7
2021,199120,30,3,228,116,112
2021,199120,30,4,1,0,1
2021,199120,40,0,646,227,419
2021,199120,40,1,89,40,49
2021,199120,40,2,118,38,80
2021,199120,40,3,163,36,127
2021,199120,40,4,48,12,36
2021,199120,40,5,221,98,123
2021,199120,40,6,7,3,4
2021,199120,41,0,398,130,268
2021,199120,41,1,58,21,37
2021,199120,41,2,98,28,70
2021,199120,41,3,88,19,69
2021,199120,41,4,5,2,3
2021,199120,41,5,146,60,86
2021,199120,41,6,3,0,3
2021,199120,42,0,209,81,128
2021,199120,42,1,29,18,11
2021,199120,42,2,18,8,10
2021,199120,42,3,71,17,54
2021,199120,42,4,42,10,32
2021,199120,42,5,47,26,21
2021,199120,42,6,2,2,0
2021,199120,43,0,39,16,23
2021,199120,43,1,2,1,1
2021,199120,43,2,2,2,0
2021,199120,43,3,4,0,4
2021,199120,43,4,1,0,1
2021,199120,43,5,28,12,16
2021,199120,43,6,2,1,1
2021,199120,44,0,398,130,268
2021,199120,44,1,58,21,37
2021,199120,44,2,98,28,70
2021,199120,44,3,88,19,69
2021,199120,44,4,5,2,3
2021,199120,44,5,146,60,86
2021,199120,44,6,3,0,3
2021,199139,0,0,1065,528,537
2021,199139,10,0,1065,528,537
2021,199139,10,1,293,186,107
2021,199139,10,2,289,148,141
2021,199139,10,3,252,110,142
2021,199139,10,5,231,84,147
2021,199139,20,0,532,314,218
2021,199139,20,1,260,173,87
2021,199139,20,2,272,141,131
2021,199139,30,0,184,80,104
2021,199139,30,3,184,80,104
2021,199139,40,0,349,134,215
2021,199139,40,1,33,13,20
2021,199139,40,2,17,7,10
2021,199139,40,3,68,30,38
2021,199139,40,5,231,84,147
2021,199139,41,0,333,125,208
2021,199139,41,1,33,13,20
2021,199139,41,2,17,7,10
2021,199139,41,3,62,27,35
2021,199139,41,5,221,78,143
2021,199139,42,0,15,9,6
2021,199139,42,3,5,3,2
2021,199139,42,5,10,6,4
2021,199139,43,0,1,0,1
2021,199139,43,3,1,0,1
2021,199139,44,0,333,125,208
2021,199139,44,1,33,13,20
2021,199139,44,2,17,7,10
2021,199139,44,3,62,27,35
2021,199139,44,5,221,78,143
2021,199148,0,0,874,388,486
2021,199148,10,0,870,385,485
2021,199148,10,1,212,113,99
2021,199148,10,2,207,92,115
2021,199148,10,3,259,96,163
2021,199148,10,4,9,3,6
2021,199148,10,5,181,79,102
2021,199148,10,6,2,2,0
2021,199148,20,0,378,194,184
2021,199148,20,1,197,107,90
2021,199148,20,2,180,86,94
2021,199148,20,3,1,1,0
2021,199148,30,0,183,76,107
2021,199148,30,3,183,76,107
2021,199148,40,0,309,115,194
2021,199148,40,1,15,6,9
2021,199148,40,2,27,6,21
2021,199148,40,3,75,19,56
2021,199148,40,4,9,3,6
2021,199148,40,5,181,79,102
2021,199148,40,6,2,2,0
2021,199148,41,0,262,96,166
2021,199148,41,1,13,5,8
2021,199148,41,2,26,6,20
2021,199148,41,3,62,15,47
2021,199148,41,4,7,2,5
2021,199148,41,5,152,66,86
2021,199148,41,6,2,2,0
2021,199148,42,0,44,18,26
2021,199148,42,1,1,1,0
2021,199148,42,2,1,0,1
2021,199148,42,3,12,4,8
2021,199148,42,4,2,1,1
2021,199148,42,5,28,12,16
2021,199148,43,0,3,1,2
2021,199148,43,1,1,0,1
2021,199148,43,3,1,0,1
2021,199148,43,5,1,1,0
2021,199148,44,0,262,96,166
2021,199148,44,1,13,5,8
2021,199148,44,2,26,6,20
2021,199148,44,3,62,15,47
2021,199148,44,4,7,2,5
2021,199148,44,5,152,66,86
2021,199148,44,6,2,2,0
2021,199148,50,0,4,3,1
2021,199157,0,0,368,168,200
2021,199157,10,0,367,168,199
2021,199157,10,1,85,49,36
2021,199157,10,2,103,50,53
2021,199157,10,3,92,37,55
2021,199157,10,4,15,5,10
2021,199157,10,5,51,18,33
2021,199157,10,6,21,9,12
2021,199157,20,0,163,91,72
2021,199157,20,1,76,46,30
2021,199157,20,2,79,42,37
2021,199157,20,3,8,3,5
2021,199157,30,0,77,33,44
2021,199157,30,1,4,1,3
2021,199157,30,2,15,6,9
2021,199157,30,3,58,26,32
2021,199157,40,0,127,44,83
2021,199157,40,1,5,2,3
2021,199157,40,2,9,2,7
2021,199157,40,3,26,8,18
2021,199157,40,4,15,5,10
2021,199157,40,5,51,18,33
2021,199157,40,6,21,9,12
2021,199157,41,0,22,6,16
2021,199157,41,2,2,0,2
2021,199157,41,3,6,1,5
2021,199157,41,4,3,0,3
2021,199157,41,5,10,5,5
2021,199157,41,6,1,0,1
2021,199157,42,0,98,34,64
2021,199157,42,1,5,2,3
2021,199157,42,2,7,2,5
2021,199157,42,3,20,7,13
2021,199157,42,4,12,5,7
2021,199157,42,5,39,12,27
2021,199157,42,6,15,6,9
2021,199157,43,0,7,4,3
2021,199157,43,5,2,1,1
2021,199157,43,6,5,3,2
2021,199157,44,0,22,6,16
2021,199157,44,2,2,0,2
2021,199157,44,3,6,1,5
2021,199157,44,4,3,0,3
2021,199157,44,5,10,5,5
2021,199157,44,6,1,0,1
2021,199157,50,0,1,0,1
2021,199184,0,0,152,96,56
2021,199184,10,0,152,96,56
2021,199184,10,1,35,28,7
2021,199184,10,2,52,28,24
2021,199184,10,3,32,23,9
2021,199184,10,6,33,17,16
2021,199184,40,0,152,96,56
2021,199184,40,1,35,28,7
2021,199184,40,2,52,28,24
2021,199184,40,3,32,23,9
2021,199184,40,6,33,17,16
2021,199184,41,0,138,85,53
2021,199184,41,1,35,28,7
2021,199184,41,2,52,28,24
2021,199184,41,3,32,23,9
2021,199184,41,6,19,6,13
2021,199184,42,0,14,11,3
2021,199184,42,6,14,11,3
2021,199184,44,0,138,85,53
2021,199184,44,1,35,28,7
2021,199184,44,2,52,28,24
2021,199184,44,3,32,23,9
2021,199184,44,6,19,6,13
2021,199193,0,0,1829,1102,727
2021,199193,10,0,1804,1088,716
2021,199193,10,1,749,547,202
2021,199193,10,2,459,262,197
2021,199193,10,3,429,215,214
2021,199193,10,4,1,0,1
2021,199193,10,5,166,64,102
2021,199193,20,0,1076,751,325
2021,199193,20,1,702,529,173
2021,199193,20,2,374,222,152
2021,199193,30,0,332,179,153
2021,199193,30,2,15,9,6
2021,199193,30,3,317,170,147
2021,199193,40,0,396,158,238
2021,199193,40,1,47,18,29
2021,199193,40,2,70,31,39
2021,199193,40,3,112,45,67
2021,199193,40,4,1,0,1
2021,199193,40,5,166,64,102
2021,199193,41,0,319,129,190
2021,199193,41,1,39,16,23
2021,199193,41,2,67,28,39
2021,199193,41,3,100,41,59
2021,199193,41,5,113,44,69
2021,199193,42,0,22,8,14
2021,199193,42,1,4,1,3
2021,199193,42,2,2,2,0
2021,199193,42,3,6,1,5
2021,199193,42,4,1,0,1
2021,199193,42,5,9,4,5
2021,199193,43,0,55,21,34
2021,199193,43,1,4,1,3
2021,199193,43,2,1,1,0
2021,199193,43,3,6,3,3
2021,199193,43,5,44,16,28
2021,199193,44,0,319,129,190
2021,199193,44,1,39,16,23
2021,199193,44,2,67,28,39
2021,199193,44,3,100,41,59
2021,199193,44,5,113,44,69
2021,199193,50,0,25,14,11
2021,199209,0,0,62,31,31
2021,199209,10,0,62,31,31
2021,199209,10,1,10,7,3
2021,199209,10,2,21,12,9
2021,199209,10,3,25,11,14
2021,199209,10,4,6,1,5
2021,199209,20,0,31,18,13
2021,199209,20,1,10,7,3
2021,199209,20,2,18,9,9
2021,199209,20,3,3,2,1
2021,199209,30,0,22,11,11
2021,199209,30,2,3,3,0
2021,199209,30,3,19,8,11
2021,199209,40,0,9,2,7
2021,199209,40,3,3,1,2
2021,199209,40,4,6,1,5
2021,199209,42,0,9,2,7
2021,199209,42,3,3,1,2
2021,199209,42,4,6,1,5
2021,199218,0,0,753,349,404
2021,199218,10,0,753,349,404
2021,199218,10,1,191,119,72
2021,199218,10,2,188,100,88
2021,199218,10,3,224,92,132
2021,199218,10,4,3,0,3
2021,199218,10,5,147,38,109
2021,199218,20,0,366,212,154
2021,199218,20,1,191,119,72
2021,199218,20,2,175,93,82
2021,199218,30,0,211,90,121
2021,199218,30,2,8,4,4
2021,199218,30,3,203,86,117
2021,199218,40,0,176,47,129
2021,199218,40,2,5,3,2
2021,199218,40,3,21,6,15
2021,199218,40,4,3,0,3
2021,199218,40,5,147,38,109
2021,199218,42,0,176,47,129
2021,199218,42,2,5,3,2
2021,199218,42,3,21,6,15
2021,199218,42,4,3,0,3
2021,199218,42,5,147,38,109
2021,199263,0,0,29,18,11
2021,199263,10,0,29,18,11
2021,199263,10,4,29,18,11
2021,199263,40,0,29,18,11
2021,199263,40,4,29,18,11
2021,199263,42,0,29,18,11
2021,199263,42,4,29,18,11
2021,199272,0,0,33,11,22
2021,199272,10,0,33,11,22
2021,199272,10,1,5,2,3
2021,199272,10,2,12,4,8
2021,199272,10,3,16,5,11
2021,199272,20,0,8,3,5
2021,199272,20,1,5,2,3
2021,199272,20,2,3,1,2
2021,199272,40,0,25,8,17
2021,199272,40,2,9,3,6
2021,199272,40,3,16,5,11
2021,199272,41,0,24,7,17
2021,199272,41,2,9,3,6
2021,199272,41,3,15,4,11
2021,199272,42,0,1,1,0
2021,199272,42,3,1,1,0
2021,199272,44,0,24,7,17
2021,199272,44,2,9,3,6
2021,199272,44,3,15,4,11
2021,199281,0,0,318,141,177
2021,199281,10,0,318,141,177
2021,199281,10,1,74,44,30
2021,199281,10,2,65,28,37
2021,199281,10,3,103,41,62
2021,199281,10,4,1,0,1
2021,199281,10,5,75,28,47
2021,199281,20,0,130,66,64
2021,199281,20,1,71,41,30
2021,199281,20,2,57,23,34
2021,199281,20,3,2,2,0
2021,199281,30,0,95,40,55
2021,199281,30,1,1,1,0
2021,199281,30,2,8,5,3
2021,199281,30,3,86,34,52
2021,199281,40,0,93,35,58
2021,199281,40,1,2,2,0
2021,199281,40,3,15,5,10
2021,199281,40,4,1,0,1
2021,199281,40,5,75,28,47
2021,199281,41,0,16,9,7
2021,199281,41,1,2,2,0
2021,199281,41,3,5,3,2
2021,199281,41,5,9,4,5
2021,199281,42,0,77,26,51
2021,199281,42,3,10,2,8
2021,199281,42,4,1,0,1
2021,199281,42,5,66,24,42
2021,199281,44,0,16,9,7
2021,199281,44,1,2,2,0
2021,199281,44,3,5,3,2
2021,199281,44,5,9,4,5
2021,199306,0,0,76,34,42
2021,199306,10,0,76,34,42
2021,199306,10,1,12,9,3
2021,199306,10,2,27,10,17
2021,199306,10,3,37,15,22
2021,199306,40,0,76,34,42
2021,199306,40,1,12,9,3
2021,199306,40,2,27,10,17
2021,199306,40,3,37,15,22
2021,199306,41,0,31,15,16
2021,199306,41,1,10,7,3
2021,199306,41,2,19,7,12
2021,199306,41,3,2,1,1
2021,199306,42,0,18,7,11
2021,199306,42,1,1,1,0
2021,199306,42,2,2,1,1
2021,199306,42,3,15,5,10
2021,199306,43,0,27,12,15
2021,199306,43,1,1,1,0
2021,199306,43,2,6,2,4
2021,199306,43,3,20,9,11
2021,199306,44,0,31,15,16
2021,199306,44,1,10,7,3
2021,199306,44,2,19,7,12
2021,199306,44,3,2,1,1
2021,199324,0,0,57,25,32
2021,199324,10,0,51,24,27
2021,199324,10,6,51,24,27
2021,199324,40,0,51,24,27
2021,199324,40,6,51,24,27
2021,199324,42,0,51,24,27
2021,199324,42,6,51,24,27
2021,199324,50,0,6,1,5
2021,199333,0,0,188,71,117
2021,199333,10,0,188,71,117
2021,199333,10,6,188,71,117
2021,199333,40,0,188,71,117
2021,199333,40,6,188,71,117
2021,199333,42,0,188,71,117
2021,199333,42,6,188,71,117
2021,199412,0,0,127,48,79
2021,199412,10,0,127,48,79
2021,199412,10,1,37,21,16
2021,199412,10,2,34,13,21
2021,199412,10,3,38,8,30
2021,199412,10,4,15,4,11
2021,199412,10,5,3,2,1
2021,199412,20,0,64,32,32
2021,199412,20,1,34,19,15
2021,199412,20,2,30,13,17
2021,199412,30,0,26,7,19
2021,199412,30,2,1,0,1
2021,199412,30,3,25,7,18
2021,199412,40,0,37,9,28
2021,199412,40,1,3,2,1
2021,199412,40,2,3,0,3
2021,199412,40,3,13,1,12
2021,199412,40,4,15,4,11
2021,199412,40,5,3,2,1
2021,199412,42,0,37,9,28
2021,199412,42,1,3,2,1
2021,199412,42,2,3,0,3
2021,199412,42,3,13,1,12
2021,199412,42,4,15,4,11
2021,199412,42,5,3,2,1
2021,199421,0,0,86,39,47
2021,199421,10,0,85,39,46
2021,199421,10,6,85,39,46
2021,199421,40,0,85,39,46
2021,199421,40,6,85,39,46
2021,199421,42,0,83,37,46
2021,199421,42,6,83,37,46
2021,199421,43,0,2,2,0
2021,199421,43,6,2,2,0
2021,199421,50,0,1,0,1
2021,199449,0,0,99,44,55
2021,199449,10,0,99,44,55
2021,199449,10,6,99,44,55
2021,199449,40,0,99,44,55
2021,199449,40,6,99,44,55
2021,199449,42,0,99,44,55
2021,199449,42,6,99,44,55
2021,199458,0,0,14,11,3
2021,199458,10,0,14,11,3
2021,199458,10,1,4,4,0
2021,199458,10,2,7,6,1
2021,199458,10,3,3,1,2
2021,199458,40,0,14,11,3
2021,199458,40,1,4,4,0
2021,199458,40,2,7,6,1
2021,199458,40,3,3,1,2
2021,199458,42,0,14,11,3
2021,199458,42,1,4,4,0
2021,199458,42,2,7,6,1
2021,199458,42,3,3,1,2
2021,199467,0,0,21,8,13
2021,199467,10,0,21,8,13
2021,199467,10,6,21,8,13
2021,199467,40,0,21,8,13
2021,199467,40,6,21,8,13
2021,199467,42,0,21,8,13
2021,199467,42,6,21,8,13
2021,199476,0,0,73,26,47
2021,199476,10,0,73,26,47
2021,199476,10,6,73,26,47
2021,199476,40,0,73,26,47
2021,199476,40,6,73,26,47
2021,199476,42,0,30,17,13
2021,199476,42,6,30,17,13
2021,199476,43,0,43,9,34
2021,199476,43,6,43,9,34
2021,199485,0,0,55,21,34
2021,199485,10,0,55,21,34
2021,199485,10,6,55,21,34
2021,199485,40,0,55,21,34
2021,199485,40,6,55,21,34
2021,199485,42,0,55,21,34
2021,199485,42,6,55,21,34
2021,199494,0,0,169,60,109
2021,199494,10,0,167,59,108
2021,199494,10,6,167,59,108
2021,199494,40,0,167,59,108
2021,199494,40,6,167,59,108
2021,199494,42,0,167,59,108
2021,199494,42,6,167,59,108
2021,199494,50,0,2,1,1
2021,199582,0,0,54,28,26
2021,199582,10,0,52,28,24
2021,199582,10,1,5,4,1
2021,199582,10,2,10,5,5
2021,199582,10,3,37,19,18
2021,199582,20,0,6,3,3
2021,199582,20,1,2,2,0
2021,199582,20,3,4,1,3
2021,199582,40,0,46,25,21
2021,199582,40,1,3,2,1
2021,199582,40,2,10,5,5
2021,199582,40,3,33,18,15
2021,199582,42,0,46,25,21
2021,199582,42,1,3,2,1
2021,199582,42,2,10,5,5
2021,199582,42,3,33,18,15
2021,199582,50,0,2,0,2
2021,199607,0,0,36,5,31
2021,199607,10,0,34,4,30
2021,199607,10,1,5,1,4
2021,199607,10,2,17,3,14
2021,199607,10,3,11,0,11
2021,199607,10,6,1,0,1
2021,199607,20,0,19,4,15
2021,199607,20,1,5,1,4
2021,199607,20,2,13,3,10
2021,199607,20,3,1,0,1
2021,199607,30,0,1,0,1
2021,199607,30,3,1,0,1
2021,199607,40,0,14,0,14
2021,199607,40,2,4,0,4
2021,199607,40,3,9,0,9
2021,199607,40,6,1,0,1
2021,199607,41,0,2,0,2
2021,199607,41,2,1,0,1
2021,199607,41,3,1,0,1
2021,199607,42,0,12,0,12
2021,199607,42,2,3,0,3
2021,199607,42,3,8,0,8
2021,199607,42,6,1,0,1
2021,199607,44,0,2,0,2
2021,199607,44,2,1,0,1
2021,199607,44,3,1,0,1
2021,199607,50,0,2,1,1
2021,199625,0,0,70,24,46
2021,199625,10,0,70,24,46
2021,199625,10,4,70,24,46
2021,199625,40,0,70,24,46
2021,199625,40,4,70,24,46
2021,199625,42,0,59,23,36
2021,199625,42,4,59,23,36
2021,199625,43,0,11,1,10
2021,199625,43,4,11,1,10
2021,199634,0,0,121,39,82
2021,199634,10,0,121,39,82
2021,199634,10,6,121,39,82
2021,199634,40,0,121,39,82
2021,199634,40,6,121,39,82
2021,199634,42,0,121,39,82
2021,199634,42,6,121,39,82
2021,199643,0,0,59,29,30
2021,199643,10,0,59,29,30
2021,199643,10,1,1,1,0
2021,199643,10,2,11,7,4
2021,199643,10,3,35,14,21
2021,199643,10,4,12,7,5
2021,199643,40,0,59,29,30
2021,199643,40,1,1,1,0
2021,199643,40,2,11,7,4
2021,199643,40,3,35,14,21
2021,199643,40,4,12,7,5
2021,199643,42,0,59,29,30
2021,199643,42,1,1,1,0
2021,199643,42,2,11,7,4
2021,199643,42,3,35,14,21
2021,199643,42,4,12,7,5
2021,199698,0,0,84,32,52
2021,199698,10,0,84,32,52
2021,199698,10,1,4,1,3
2021,199698,10,2,18,10,8
2021,199698,10,3,31,10,21
2021,199698,10,4,31,11,20
2021,199698,20,0,6,3,3
2021,199698,20,1,4,1,3
2021,199698,20,2,2,2,0
2021,199698,40,0,78,29,49
2021,199698,40,2,16,8,8
2021,199698,40,3,31,10,21
2021,199698,40,4,31,11,20
2021,199698,41,0,47,18,29
2021,199698,41,2,16,8,8
2021,199698,41,3,31,10,21
2021,199698,42,0,31,11,20
2021,199698,42,4,31,11,20
2021,199698,44,0,47,18,29
2021,199698,44,2,16,8,8
2021,199698,44,3,31,10,21
2021,199722,0,0,51,21,30
2021,199722,10,0,51,21,30
2021,199722,10,6,51,21,30
2021,199722,40,0,51,21,30
2021,199722,40,6,51,21,30
2021,199722,42,0,51,21,30
2021,199722,42,6,51,21,30
2021,199731,0,0,81,34,47
2021,199731,10,0,81,34,47
2021,199731,10,6,81,34,47
2021,199731,40,0,81,34,47
2021,199731,40,6,81,34,47
2021,199731,42,0,81,34,47
2021,199731,42,6,81,34,47
2021,199740,0,0,76,31,45
2021,199740,10,0,76,31,45
2021,199740,10,6,76,31,45
2021,199740,40,0,76,31,45
2021,199740,40,6,76,31,45
2021,199740,42,0,76,31,45
2021,199740,42,6,76,31,45
2021,199759,0,0,46,42,4
2021,199759,10,0,46,42,4
2021,199759,10,1,26,25,1
2021,199759,10,2,9,9,0
2021,199759,10,3,10,7,3
2021,199759,10,4,1,1,0
2021,199759,40,0,46,42,4
2021,199759,40,1,26,25,1
2021,199759,40,2,9,9,0
2021,199759,40,3,10,7,3
2021,199759,40,4,1,1,0
2021,199759,41,0,46,42,4
2021,199759,41,1,26,25,1
2021,199759,41,2,9,9,0
2021,199759,41,3,10,7,3
2021,199759,41,4,1,1,0
2021,199759,44,0,46,42,4
2021,199759,44,1,26,25,1
2021,199759,44,2,9,9,0
2021,199759,44,3,10,7,3
2021,199759,44,4,1,1,0
2021,199768,0,0,92,30,62
2021,199768,10,0,92,30,62
2021,199768,10,6,92,30,62
2021,199768,40,0,92,30,62
2021,199768,40,6,92,30,62
2021,199768,42,0,92,30,62
2021,199768,42,6,92,30,62
2021,199786,0,0,111,46,65
2021,199786,10,0,111,46,65
2021,199786,10,6,111,46,65
2021,199786,40,0,111,46,65
2021,199786,40,6,111,46,65
2021,199786,42,0,109,46,63
2021,199786,42,6,109,46,63
2021,199786,43,0,2,0,2
2021,199786,43,6,2,0,2
2021,199795,0,0,42,15,27
2021,199795,10,0,42,15,27
2021,199795,10,6,42,15,27
2021,199795,40,0,42,15,27
2021,199795,40,6,42,15,27
2021,199795,42,0,42,15,27
2021,199795,42,6,42,15,27
2021,199838,0,0,92,42,50
2021,199838,10,0,92,42,50
2021,199838,10,4,92,42,50
2021,199838,40,0,92,42,50
2021,199838,40,4,92,42,50
2021,199838,42,0,92,42,50
2021,199838,42,4,92,42,50
2021,199847,0,0,1910,1107,803
2021,199847,10,0,1910,1107,803
2021,199847,10,1,501,347,154
2021,199847,10,2,496,293,203
2021,199847,10,3,724,364,360
2021,199847,10,4,121,64,57
2021,199847,10,5,32,15,17
2021,199847,10,6,36,24,12
2021,199847,20,0,515,327,188
2021,199847,20,1,314,210,104
2021,199847,20,2,193,111,82
2021,199847,20,3,5,3,2
2021,199847,20,6,3,3,0
2021,199847,30,0,178,83,95
2021,199847,30,1,1,1,0
2021,199847,30,2,19,12,7
2021,199847,30,3,153,70,83
2021,199847,30,4,5,0,5
2021,199847,40,0,1217,697,520
2021,199847,40,1,186,136,50
2021,199847,40,2,284,170,114
2021,199847,40,3,566,291,275
2021,199847,40,4,116,64,52
2021,199847,40,5,32,15,17
2021,199847,40,6,33,21,12
2021,199847,41,0,145,76,69
2021,199847,41,1,36,22,14
2021,199847,41,2,41,21,20
2021,199847,41,3,51,25,26
2021,199847,41,4,9,4,5
2021,199847,41,5,4,2,2
2021,199847,41,6,4,2,2
2021,199847,42,0,1072,621,451
2021,199847,42,1,150,114,36
2021,199847,42,2,243,149,94
2021,199847,42,3,515,266,249
2021,199847,42,4,107,60,47
2021,199847,42,5,28,13,15
2021,199847,42,6,29,19,10
2021,199847,44,0,138,73,65
2021,199847,44,1,36,22,14
2021,199847,44,2,41,21,20
2021,199847,44,3,51,25,26
2021,199847,44,4,4,3,1
2021,199847,44,5,4,2,2
2021,199847,44,6,2,0,2
2021,199847,45,0,7,3,4
2021,199847,45,4,5,1,4
2021,199847,45,6,2,2,0
2021,199856,0,0,592,238,354
2021,199856,10,0,592,238,354
2021,199856,10,6,592,238,354
2021,199856,40,0,592,238,354
2021,199856,40,6,592,238,354
2021,199856,42,0,576,233,343
2021,199856,42,6,576,233,343
2021,199856,43,0,16,5,11
2021,199856,43,6,16,5,11
2021,199865,0,0,54,21,33
2021,199865,10,0,54,21,33
2021,199865,10,6,54,21,33
2021,199865,40,0,54,21,33
2021,199865,40,6,54,21,33
2021,199865,41,0,38,14,24
2021,199865,41,6,38,14,24
2021,199865,42,0,16,7,9
2021,199865,42,6,16,7,9
2021,199865,44,0,38,14,24
2021,199865,44,6,38,14,24
2021,199883,0,0,15,0,15
2021,199883,10,0,15,0,15
2021,199883,10,4,15,0,15
2021,199883,40,0,15,0,15
2021,199883,40,4,15,0,15
2021,199883,41,0,15,0,15
2021,199883,41,4,15,0,15
2021,199883,45,0,15,0,15
2021,199883,45,4,15,0,15
2021,199892,0,0,121,50,71
2021,199892,10,0,121,50,71
2021,199892,10,6,121,50,71
2021,199892,40,0,121,50,71
2021,199892,40,6,121,50,71
2021,199892,42,0,121,50,71
2021,199892,42,6,121,50,71
2021,199908,0,0,67,28,39
2021,199908,10,0,67,28,39
2021,199908,10,6,67,28,39
2021,199908,40,0,67,28,39
2021,199908,40,6,67,28,39
2021,199908,42,0,67,28,39
2021,199908,42,6,67,28,39
2021,199926,0,0,100,50,50
2021,199926,10,0,97,48,49
2021,199926,10,6,97,48,49
2021,199926,40,0,97,48,49
2021,199926,40,6,97,48,49
2021,199926,42,0,97,48,49
2021,199926,42,6,97,48,49
2021,199926,50,0,3,2,1
2021,199953,0,0,44,17,27
2021,199953,10,0,44,17,27
2021,199953,10,6,44,17,27
2021,199953,40,0,44,17,27
2021,199953,40,6,44,17,27
2021,199953,42,0,33,12,21
2021,199953,42,6,33,12,21
2021,199953,43,0,11,5,6
2021,199953,43,6,11,5,6
2021,199962,0,0,177,73,104
2021,199962,10,0,177,73,104
2021,199962,10,1,31,14,17
2021,199962,10,2,81,39,42
2021,199962,10,3,49,16,33
2021,199962,10,4,16,4,12
2021,199962,40,0,177,73,104
2021,199962,40,1,31,14,17
2021,199962,40,2,81,39,42
2021,199962,40,3,49,16,33
2021,199962,40,4,16,4,12
2021,199962,42,0,177,73,104
2021,199962,42,1,31,14,17
2021,199962,42,2,81,39,42
2021,199962,42,3,49,16,33
2021,199962,42,4,16,4,12
2021,199999,0,0,238,106,132
2021,199999,10,0,238,106,132
2021,199999,10,1,50,31,19
2021,199999,10,2,101,50,51
2021,199999,10,3,51,16,35
2021,199999,10,4,26,3,23
2021,199999,10,5,10,6,4
2021,199999,20,0,147,80,67
2021,199999,20,1,50,31,19
2021,199999,20,2,97,49,48
2021,199999,30,0,36,13,23
2021,199999,30,2,4,1,3
2021,199999,30,3,32,12,20
2021,199999,40,0,55,13,42
2021,199999,40,3,19,4,15
2021,199999,40,4,26,3,23
2021,199999,40,5,10,6,4
2021,199999,41,0,37,7,30
2021,199999,41,3,14,3,11
2021,199999,41,4,20,3,17
2021,199999,41,5,3,1,2
2021,199999,42,0,9,5,4
2021,199999,42,3,2,1,1
2021,199999,42,4,1,0,1
2021,199999,42,5,6,4,2
2021,199999,43,0,9,1,8
2021,199999,43,3,3,0,3
2021,199999,43,4,5,0,5
2021,199999,43,5,1,1,0
2021,199999,44,0,37,7,30
2021,199999,44,3,14,3,11
2021,199999,44,4,20,3,17
2021,199999,44,5,3,1,2
2021,200004,0,0,548,276,272
2021,200004,10,0,548,276,272
2021,200004,10,1,115,75,40
2021,200004,10,2,133,70,63
2021,200004,10,3,208,88,120
2021,200004,10,4,92,43,49
2021,200004,20,0,233,135,98
2021,200004,20,1,106,69,37
2021,200004,20,2,125,66,59
2021,200004,20,3,2,0,2
2021,200004,30,0,138,68,70
2021,200004,30,1,6,3,3
2021,200004,30,2,5,4,1
2021,200004,30,3,127,61,66
2021,200004,40,0,177,73,104
2021,200004,40,1,3,3,0
2021,200004,40,2,3,0,3
2021,200004,40,3,79,27,52
2021,200004,40,4,92,43,49
2021,200004,41,0,19,11,8
2021,200004,41,1,3,3,0
2021,200004,41,2,1,0,1
2021,200004,41,3,7,5,2
2021,200004,41,4,8,3,5
2021,200004,42,0,145,58,87
2021,200004,42,2,2,0,2
2021,200004,42,3,66,21,45
2021,200004,42,4,77,37,40
2021,200004,43,0,13,4,9
2021,200004,43,3,6,1,5
2021,200004,43,4,7,3,4
2021,200004,44,0,19,11,8
2021,200004,44,1,3,3,0
2021,200004,44,2,1,0,1
2021,200004,44,3,7,5,2
2021,200004,44,4,8,3,5
2021,200013,0,0,14,1,13
2021,200013,10,0,14,1,13
2021,200013,10,4,14,1,13
2021,200013,40,0,14,1,13
2021,200013,40,4,14,1,13
2021,200013,41,0,14,1,13
2021,200013,41,4,14,1,13
2021,200013,45,0,14,1,13
2021,200013,45,4,14,1,13
2021,200022,0,0,112,62,50
2021,200022,10,0,108,60,48
2021,200022,10,1,7,3,4
2021,200022,10,2,61,32,29
2021,200022,10,3,39,25,14
2021,200022,10,4,1,0,1
2021,200022,20,0,68,35,33
2021,200022,20,1,7,3,4
2021,200022,20,2,61,32,29
2021,200022,30,0,30,19,11
2021,200022,30,3,30,19,11
2021,200022,40,0,10,6,4
2021,200022,40,3,9,6,3
2021,200022,40,4,1,0,1
2021,200022,42,0,10,6,4
2021,200022,42,3,9,6,3
2021,200022,42,4,1,0,1
2021,200022,50,0,4,2,2
2021,200059,0,0,61,34,27
2021,200059,10,0,61,34,27
2021,200059,10,1,9,7,2
2021,200059,10,2,15,8,7
2021,200059,10,3,31,17,14
2021,200059,10,4,6,2,4
2021,200059,20,0,34,21,13
2021,200059,20,1,9,7,2
2021,200059,20,2,12,6,6
2021,200059,20,3,13,8,5
2021,200059,30,0,14,6,8
2021,200059,30,2,3,2,1
2021,200059,30,3,11,4,7
2021,200059,40,0,13,7,6
2021,200059,40,3,7,5,2
2021,200059,40,4,6,2,4
2021,200059,42,0,13,7,6
2021,200059,42,3,7,5,2
2021,200059,42,4,6,2,4
2021,200086,0,0,25,8,17
2021,200086,10,0,25,8,17
2021,200086,10,6,25,8,17
2021,200086,40,0,25,8,17
2021,200086,40,6,25,8,17
2021,200086,42,0,25,8,17
2021,200086,42,6,25,8,17
2021,200156,0,0,78,36,42
2021,200156,10,0,78,36,42
2021,200156,10,1,18,13,5
2021,200156,10,2,18,3,15
2021,200156,10,3,35,18,17
2021,200156,10,4,7,2,5
2021,200156,40,0,78,36,42
2021,200156,40,1,18,13,5
2021,200156,40,2,18,3,15
2021,200156,40,3,35,18,17
2021,200156,40,4,7,2,5
2021,200156,41,0,78,36,42
2021,200156,41,1,18,13,5
2021,200156,41,2,18,3,15
2021,200156,41,3,35,18,17
2021,200156,41,4,7,2,5
2021,200156,44,0,78,36,42
2021,200156,44,1,18,13,5
2021,200156,44,2,18,3,15
2021,200156,44,3,35,18,17
2021,200156,44,4,7,2,5
2021,200192,0,0,40,15,25
2021,200192,10,0,40,15,25
2021,200192,10,1,5,3,2
2021,200192,10,2,12,3,9
2021,200192,10,3,8,5,3
2021,200192,10,4,15,4,11
2021,200192,20,0,14,7,7
2021,200192,20,1,5,3,2
2021,200192,20,2,7,3,4
2021,200192,20,3,2,1,1
2021,200192,30,0,11,6,5
2021,200192,30,2,2,0,2
2021,200192,30,3,3,3,0
2021,200192,30,4,6,3,3
2021,200192,40,0,15,2,13
2021,200192,40,2,3,0,3
2021,200192,40,3,3,1,2
2021,200192,40,4,9,1,8
2021,200192,42,0,15,2,13
2021,200192,42,2,3,0,3
2021,200192,42,3,3,1,2
2021,200192,42,4,9,1,8
2021,200208,0,0,17,11,6
2021,200208,10,0,17,11,6
2021,200208,10,4,17,11,6
2021,200208,40,0,17,11,6
2021,200208,40,4,17,11,6
2021,200208,42,0,17,11,6
2021,200208,42,4,17,11,6
2021,200217,0,0,159,76,83
2021,200217,10,0,159,76,83
2021,200217,10,1,15,9,6
2021,200217,10,2,38,17,21
2021,200217,10,3,98,45,53
2021,200217,10,4,7,4,3
2021,200217,10,6,1,1,0
2021,200217,40,0,159,76,83
2021,200217,40,1,15,9,6
2021,200217,40,2,38,17,21
2021,200217,40,3,98,45,53
2021,200217,40,4,7,4,3
2021,200217,40,6,1,1,0
2021,200217,41,0,159,76,83
2021,200217,41,1,15,9,6
2021,200217,41,2,38,17,21
2021,200217,41,3,98,45,53
2021,200217,41,4,7,4,3
2021,200217,41,6,1,1,0
2021,200217,45,0,159,76,83
2021,200217,45,1,15,9,6
2021,200217,45,2,38,17,21
2021,200217,45,3,98,45,53
2021,200217,45,4,7,4,3
2021,200217,45,6,1,1,0
2021,200226,0,0,42,20,22
2021,200226,10,0,35,18,17
2021,200226,10,1,4,4,0
2021,200226,10,2,12,8,4
2021,200226,10,3,10,4,6
2021,200226,10,4,9,2,7
2021,200226,20,0,16,13,3
2021,200226,20,1,4,4,0
2021,200226,20,2,11,8,3
2021,200226,20,3,1,1,0
2021,200226,30,0,10,3,7
2021,200226,30,2,1,0,1
2021,200226,30,3,7,2,5
2021,200226,30,4,2,1,1
2021,200226,40,0,9,2,7
2021,200226,40,3,2,1,1
2021,200226,40,4,7,1,6
2021,200226,42,0,9,2,7
2021,200226,42,3,2,1,1
2021,200226,42,4,7,1,6
2021,200226,50,0,7,2,5
2021,200253,0,0,151,61,90
2021,200253,10,0,151,61,90
2021,200253,10,1,33,19,14
2021,200253,10,2,27,14,13
2021,200253,10,3,67,23,44
2021,200253,10,4,24,5,19
2021,200253,20,0,71,37,34
2021,200253,20,1,33,19,14
2021,200253,20,2,25,13,12
2021,200253,20,3,13,5,8
2021,200253,30,0,59,15,44
2021,200253,30,2,1,0,1
2021,200253,30,3,49,15,34
2021,200253,30,4,9,0,9
2021,200253,40,0,21,9,12
2021,200253,40,2,1,1,0
2021,200253,40,3,5,3,2
2021,200253,40,4,15,5,10
2021,200253,42,0,21,9,12
2021,200253,42,2,1,1,0
2021,200253,42,3,5,3,2
2021,200253,42,4,15,5,10
2021,200280,0,0,707,397,310
2021,200280,10,0,617,351,266
2021,200280,10,1,159,105,54
2021,200280,10,2,177,111,66
2021,200280,10,3,177,86,91
2021,200280,10,4,72,30,42
2021,200280,10,5,20,14,6
2021,200280,10,6,12,5,7
2021,200280,20,0,300,199,101
2021,200280,20,1,147,98,49
2021,200280,20,2,146,99,47
2021,200280,20,3,7,2,5
2021,200280,30,0,63,42,21
2021,200280,30,2,1,1,0
2021,200280,30,3,62,41,21
2021,200280,40,0,254,110,144
2021,200280,40,1,12,7,5
2021,200280,40,2,30,11,19
2021,200280,40,3,108,43,65
2021,200280,40,4,72,30,42
2021,200280,40,5,20,14,6
2021,200280,40,6,12,5,7
2021,200280,42,0,254,110,144
2021,200280,42,1,12,7,5
2021,200280,42,2,30,11,19
2021,200280,42,3,108,43,65
2021,200280,42,4,72,30,42
2021,200280,42,5,20,14,6
2021,200280,42,6,12,5,7
2021,200280,50,0,90,46,44
2021,200305,0,0,107,59,48
2021,200305,10,0,99,56,43
2021,200305,10,1,2,1,1
2021,200305,10,2,66,42,24
2021,200305,10,3,23,9,14
2021,200305,10,4,8,4,4
2021,200305,20,0,66,42,24
2021,200305,20,1,2,1,1
2021,200305,20,2,64,41,23
2021,200305,30,0,32,14,18
2021,200305,30,2,2,1,1
2021,200305,30,3,22,9,13
2021,200305,30,4,8,4,4
2021,200305,40,0,1,0,1
2021,200305,40,3,1,0,1
2021,200305,42,0,1,0,1
2021,200305,42,3,1,0,1
2021,200305,50,0,8,3,5
2021,200314,0,0,29,8,21
2021,200314,10,0,29,8,21
2021,200314,10,1,3,1,2
2021,200314,10,2,6,3,3
2021,200314,10,3,2,1,1
2021,200314,10,4,18,3,15
2021,200314,20,0,6,2,4
2021,200314,20,1,3,1,2
2021,200314,20,2,3,1,2
2021,200314,30,0,4,1,3
2021,200314,30,2,1,1,0
2021,200314,30,4,3,0,3
2021,200314,40,0,19,5,14
2021,200314,40,2,2,1,1
2021,200314,40,3,2,1,1
2021,200314,40,4,15,3,12
2021,200314,42,0,8,3,5
2021,200314,42,2,1,0,1
2021,200314,42,3,1,1,0
2021,200314,42,4,6,2,4
2021,200314,43,0,11,2,9
2021,200314,43,2,1,1,0
2021,200314,43,3,1,0,1
2021,200314,43,4,9,1,8
2021,200332,0,0,533,291,242
2021,200332,10,0,533,291,242
2021,200332,10,1,140,99,41
2021,200332,10,2,162,90,72
2021,200332,10,3,170,78,92
2021,200332,10,4,1,1,0
2021,200332,10,5,60,23,37
2021,200332,20,0,275,177,98
2021,200332,20,1,136,97,39
2021,200332,20,2,139,80,59
2021,200332,30,0,110,66,44
2021,200332,30,1,2,0,2
2021,200332,30,2,6,3,3
2021,200332,30,3,102,63,39
2021,200332,40,0,148,48,100
2021,200332,40,1,2,2,0
2021,200332,40,2,17,7,10
2021,200332,40,3,68,15,53
2021,200332,40,4,1,1,0
2021,200332,40,5,60,23,37
2021,200332,42,0,148,48,100
2021,200332,42,1,2,2,0
2021,200332,42,2,17,7,10
2021,200332,42,3,68,15,53
2021,200332,42,4,1,1,0
2021,200332,42,5,60,23,37
2021,200341,0,0,32,15,17
2021,200341,10,0,24,12,12
2021,200341,10,1,3,1,2
2021,200341,10,2,14,7,7
2021,200341,10,3,3,1,2
2021,200341,10,4,4,3,1
2021,200341,20,0,17,8,9
2021,200341,20,1,3,1,2
2021,200341,20,2,14,7,7
2021,200341,30,0,3,1,2
2021,200341,30,3,3,1,2
2021,200341,40,0,4,3,1
2021,200341,40,4,4,3,1
2021,200341,42,0,4,3,1
2021,200341,42,4,4,3,1
2021,200341,50,0,8,3,5
2021,200466,0,0,27,15,12
2021,200466,10,0,27,15,12
2021,200466,10,6,27,15,12
2021,200466,40,0,27,15,12
2021,200466,40,6,27,15,12
2021,200466,43,0,27,15,12
2021,200466,43,6,27,15,12
2021,200484,0,0,14,11,3
2021,200484,10,0,14,11,3
2021,200484,10,1,1,1,0
2021,200484,10,2,5,4,1
2021,200484,10,3,7,5,2
2021,200484,10,4,1,1,0
2021,200484,40,0,14,11,3
2021,200484,40,1,1,1,0
2021,200484,40,2,5,4,1
2021,200484,40,3,7,5,2
2021,200484,40,4,1,1,0
2021,200484,42,0,14,11,3
2021,200484,42,1,1,1,0
2021,200484,42,2,5,4,1
2021,200484,42,3,7,5,2
2021,200484,42,4,1,1,0
2021,200527,0,0,47,24,23
2021,200527,10,0,47,24,23
2021,200527,10,4,47,24,23
2021,200527,40,0,47,24,23
2021,200527,40,4,47,24,23
2021,200527,43,0,47,24,23
2021,200527,43,4,47,24,23
2021,200554,0,0,36,23,13
2021,200554,10,0,36,23,13
2021,200554,10,4,36,23,13
2021,200554,40,0,36,23,13
2021,200554,40,4,36,23,13
2021,200554,42,0,1,1,0
2021,200554,42,4,1,1,0
2021,200554,43,0,35,22,13
2021,200554,43,4,35,22,13
2021,200572,0,0,69,33,36
2021,200572,10,0,69,33,36
2021,200572,10,1,15,10,5
2021,200572,10,2,17,4,13
2021,200572,10,3,37,19,18
2021,200572,20,0,32,14,18
2021,200572,20,1,14,9,5
2021,200572,20,2,15,4,11
2021,200572,20,3,3,1,2
2021,200572,30,0,22,12,10
2021,200572,30,2,2,0,2
2021,200572,30,3,20,12,8
2021,200572,40,0,15,7,8
2021,200572,40,1,1,1,0
2021,200572,40,3,14,6,8
2021,200572,41,0,11,5,6
2021,200572,41,1,1,1,0
2021,200572,41,3,10,4,6
2021,200572,42,0,4,2,2
2021,200572,42,3,4,2,2
2021,200572,44,0,11,5,6
2021,200572,44,1,1,1,0
2021,200572,44,3,10,4,6
2021,200590,0,0,18,3,15
2021,200590,10,0,18,3,15
2021,200590,10,4,18,3,15
2021,200590,40,0,18,3,15
2021,200590,40,4,18,3,15
2021,200590,41,0,18,3,15
2021,200590,41,4,18,3,15
2021,200590,45,0,18,3,15
2021,200590,45,4,18,3,15
2021,200785,0,0,8,1,7
2021,200785,10,0,8,1,7
2021,200785,10,2,3,0,3
2021,200785,10,3,4,1,3
2021,200785,10,4,1,0,1
2021,200785,40,0,8,1,7
2021,200785,40,2,3,0,3
2021,200785,40,3,4,1,3
2021,200785,40,4,1,0,1
2021,200785,41,0,8,1,7
2021,200785,41,2,3,0,3
2021,200785,41,3,4,1,3
2021,200785,41,4,1,0,1
2021,200785,45,0,8,1,7
2021,200785,45,2,3,0,3
2021,200785,45,3,4,1,3
2021,200785,45,4,1,0,1
2021,200800,0,0,470,288,182
2021,200800,10,0,470,288,182
2021,200800,10,1,175,129,46
2021,200800,10,2,122,68,54
2021,200800,10,3,52,30,22
2021,200800,10,4,82,32,50
2021,200800,10,5,39,29,10
2021,200800,20,0,289,193,96
2021,200800,20,1,173,128,45
2021,200800,20,2,116,65,51
2021,200800,30,0,48,29,19
2021,200800,30,2,4,2,2
2021,200800,30,3,44,27,17
2021,200800,40,0,133,66,67
2021,200800,40,1,2,1,1
2021,200800,40,2,2,1,1
2021,200800,40,3,8,3,5
2021,200800,40,4,82,32,50
2021,200800,40,5,39,29,10
2021,200800,42,0,133,66,67
2021,200800,42,1,2,1,1
2021,200800,42,2,2,1,1
2021,200800,42,3,8,3,5
2021,200800,42,4,82,32,50
2021,200800,42,5,39,29,10
2021,200873,0,0,4,3,1
2021,200873,10,0,4,3,1
2021,200873,10,1,4,3,1
2021,200873,40,0,4,3,1
2021,200873,40,1,4,3,1
2021,200873,41,0,4,3,1
2021,200873,41,1,4,3,1
2021,200873,44,0,4,3,1
2021,200873,44,1,4,3,1
2021,201061,0,0,10,7,3
2021,201061,10,0,10,7,3
2021,201061,10,1,2,2,0
2021,201061,10,2,4,3,1
2021,201061,10,3,4,2,2
2021,201061,40,0,10,7,3
2021,201061,40,1,2,2,0
2021,201061,40,2,4,3,1
2021,201061,40,3,4,2,2
2021,201061,41,0,10,7,3
2021,201061,41,1,2,2,0
2021,201061,41,2,4,3,1
2021,201061,41,3,4,2,2
2021,201061,44,0,10,7,3
2021,201061,44,1,2,2,0
2021,201061,44,2,4,3,1
2021,201061,44,3,4,2,2
2021,201104,0,0,166,89,77
2021,201104,10,0,166,89,77
2021,201104,10,1,46,35,11
2021,201104,10,2,41,25,16
2021,201104,10,3,41,19,22
2021,201104,10,4,38,10,28
2021,201104,20,0,87,59,28
2021,201104,20,1,45,35,10
2021,201104,20,2,38,23,15
2021,201104,20,3,4,1,3
2021,201104,30,0,34,18,16
2021,201104,30,1,1,0,1
2021,201104,30,2,3,2,1
2021,201104,30,3,30,16,14
2021,201104,40,0,45,12,33
2021,201104,40,3,7,2,5
2021,201104,40,4,38,10,28
2021,201104,41,0,1,1,0
2021,201104,41,4,1,1,0
2021,201104,42,0,44,11,33
2021,201104,42,3,7,2,5
2021,201104,42,4,37,9,28
2021,201104,44,0,1,1,0
2021,201104,44,4,1,1,0
2021,201140,0,0,7,7,0
2021,201140,10,0,7,7,0
2021,201140,10,1,2,2,0
2021,201140,10,2,2,2,0
2021,201140,10,3,3,3,0
2021,201140,40,0,7,7,0
2021,201140,40,1,2,2,0
2021,201140,40,2,2,2,0
2021,201140,40,3,3,3,0
2021,201140,41,0,5,5,0
2021,201140,41,1,2,2,0
2021,201140,41,2,1,1,0
2021,201140,41,3,2,2,0
2021,201140,42,0,2,2,0
2021,201140,42,2,1,1,0
2021,201140,42,3,1,1,0
2021,201140,44,0,5,5,0
2021,201140,44,1,2,2,0
2021,201140,44,2,1,1,0
2021,201140,44,3,2,2,0
2021,201177,0,0,12,2,10
2021,201177,10,0,12,2,10
2021,201177,10,2,3,1,2
2021,201177,10,3,7,1,6
2021,201177,10,4,2,0,2
2021,201177,40,0,12,2,10
2021,201177,40,2,3,1,2
2021,201177,40,3,7,1,6
2021,201177,40,4,2,0,2
2021,201177,41,0,12,2,10
2021,201177,41,2,3,1,2
2021,201177,41,3,7,1,6
2021,201177,41,4,2,0,2
2021,201177,44,0,12,2,10
2021,201177,44,2,3,1,2
2021,201177,44,3,7,1,6
2021,201177,44,4,2,0,2
2021,201195,0,0,223,104,119
2021,201195,10,0,221,104,117
2021,201195,10,1,85,46,39
2021,201195,10,2,75,30,45
2021,201195,10,3,59,28,31
2021,201195,10,4,2,0,2
2021,201195,20,0,126,65,61
2021,201195,20,1,77,42,35
2021,201195,20,2,49,23,26
2021,201195,30,0,64,27,37
2021,201195,30,1,6,2,4
2021,201195,30,2,18,3,15
2021,201195,30,3,40,22,18
2021,201195,40,0,31,12,19
2021,201195,40,1,2,2,0
2021,201195,40,2,8,4,4
2021,201195,40,3,19,6,13
2021,201195,40,4,2,0,2
2021,201195,41,0,15,5,10
2021,201195,41,1,2,2,0
2021,201195,41,2,2,1,1
2021,201195,41,3,10,2,8
2021,201195,41,4,1,0,1
2021,201195,42,0,16,7,9
2021,201195,42,2,6,3,3
2021,201195,42,3,9,4,5
2021,201195,42,4,1,0,1
2021,201195,44,0,15,5,10
2021,201195,44,1,2,2,0
2021,201195,44,2,2,1,1
2021,201195,44,3,10,2,8
2021,201195,44,4,1,0,1
2021,201195,50,0,2,0,2
2021,201283,0,0,26,10,16
2021,201283,10,0,26,10,16
2021,201283,10,1,12,5,7
2021,201283,10,2,6,1,5
2021,201283,10,3,5,4,1
2021,201283,10,4,3,0,3
2021,201283,40,0,26,10,16
2021,201283,40,1,12,5,7
2021,201283,40,2,6,1,5
2021,201283,40,3,5,4,1
2021,201283,40,4,3,0,3
2021,201283,41,0,25,9,16
2021,201283,41,1,12,5,7
2021,201283,41,2,6,1,5
2021,201283,41,3,4,3,1
2021,201283,41,4,3,0,3
2021,201283,42,0,1,1,0
2021,201283,42,3,1,1,0
2021,201283,44,0,25,9,16
2021,201283,44,1,12,5,7
2021,201283,44,2,6,1,5
2021,201283,44,3,4,3,1
2021,201283,44,4,3,0,3
2021,201371,0,0,45,23,22
2021,201371,10,0,45,23,22
2021,201371,10,1,16,11,5
2021,201371,10,2,12,6,6
2021,201371,10,3,17,6,11
2021,201371,20,0,23,16,7
2021,201371,20,1,16,11,5
2021,201371,20,2,5,4,1
2021,201371,20,3,2,1,1
2021,201371,30,0,8,2,6
2021,201371,30,2,6,2,4
2021,201371,30,3,2,0,2
2021,201371,40,0,14,5,9
2021,201371,40,2,1,0,1
2021,201371,40,3,13,5,8
2021,201371,41,0,14,5,9
2021,201371,41,2,1,0,1
2021,201371,41,3,13,5,8
2021,201371,44,0,14,5,9
2021,201371,44,2,1,0,1
2021,201371,44,3,13,5,8
2021,201432,0,0,46,20,26
2021,201432,10,0,46,20,26
2021,201432,10,1,13,6,7
2021,201432,10,2,18,7,11
2021,201432,10,3,15,7,8
2021,201432,20,0,17,9,8
2021,201432,20,1,6,3,3
2021,201432,20,2,11,6,5
2021,201432,30,0,1,0,1
2021,201432,30,3,1,0,1
2021,201432,40,0,28,11,17
2021,201432,40,1,7,3,4
2021,201432,40,2,7,1,6
2021,201432,40,3,14,7,7
2021,201432,42,0,28,11,17
2021,201432,42,1,7,3,4
2021,201432,42,2,7,1,6
2021,201432,42,3,14,7,7
2021,201441,0,0,726,358,368
2021,201441,10,0,726,358,368
2021,201441,10,1,280,148,132
2021,201441,10,2,264,131,133
2021,201441,10,3,182,79,103
2021,201441,20,0,387,211,176
2021,201441,20,1,196,116,80
2021,201441,20,2,191,95,96
2021,201441,30,0,89,46,43
2021,201441,30,2,4,2,2
2021,201441,30,3,85,44,41
2021,201441,40,0,250,101,149
2021,201441,40,1,84,32,52
2021,201441,40,2,69,34,35
2021,201441,40,3,97,35,62
2021,201441,42,0,250,101,149
2021,201441,42,1,84,32,52
2021,201441,42,2,69,34,35
2021,201441,42,3,97,35,62
2021,201469,0,0,32,9,23
2021,201469,10,0,32,9,23
2021,201469,10,4,32,9,23
2021,201469,40,0,32,9,23
2021,201469,40,4,32,9,23
2021,201469,41,0,32,9,23
2021,201469,41,4,32,9,23
2021,201469,45,0,32,9,23
2021,201469,45,4,32,9,23
2021,201548,0,0,157,71,86
2021,201548,10,0,157,71,86
2021,201548,10,1,56,28,28
2021,201548,10,2,30,15,15
2021,201548,10,3,28,11,17
2021,201548,10,4,43,17,26
2021,201548,20,0,83,42,41
2021,201548,20,1,53,27,26
2021,201548,20,2,29,15,14
2021,201548,20,3,1,0,1
2021,201548,30,0,22,8,14
2021,201548,30,1,1,1,0
2021,201548,30,3,21,7,14
2021,201548,40,0,52,21,31
2021,201548,40,1,2,0,2
2021,201548,40,2,1,0,1
2021,201548,40,3,6,4,2
2021,201548,40,4,43,17,26
2021,201548,41,0,8,2,6
2021,201548,41,4,8,2,6
2021,201548,42,0,41,17,24
2021,201548,42,1,2,0,2
2021,201548,42,2,1,0,1
2021,201548,42,3,6,4,2
2021,201548,42,4,32,13,19
2021,201548,43,0,3,2,1
2021,201548,43,4,3,2,1
2021,201548,44,0,8,2,6
2021,201548,44,4,8,2,6
2021,201645,0,0,1177,688,489
2021,201645,10,0,1177,688,489
2021,201645,10,1,459,342,117
2021,201645,10,2,264,148,116
2021,201645,10,3,235,112,123
2021,201645,10,4,109,37,72
2021,201645,10,5,85,35,50
2021,201645,10,6,25,14,11
2021,201645,20,0,559,402,157
2021,201645,20,1,385,293,92
2021,201645,20,2,174,109,65
2021,201645,30,0,133,66,67
2021,201645,30,2,17,8,9
2021,201645,30,3,116,58,58
2021,201645,40,0,485,220,265
2021,201645,40,1,74,49,25
2021,201645,40,2,73,31,42
2021,201645,40,3,119,54,65
2021,201645,40,4,109,37,72
2021,201645,40,5,85,35,50
2021,201645,40,6,25,14,11
2021,201645,41,0,375,171,204
2021,201645,41,1,74,49,25
2021,201645,41,2,73,31,42
2021,201645,41,3,119,54,65
2021,201645,41,4,109,37,72
2021,201645,42,0,109,49,60
2021,201645,42,5,84,35,49
2021,201645,42,6,25,14,11
2021,201645,43,0,1,0,1
2021,201645,43,5,1,0,1
2021,201645,45,0,375,171,204
2021,201645,45,1,74,49,25
2021,201645,45,2,73,31,42
2021,201645,45,3,119,54,65
2021,201645,45,4,109,37,72
2021,201654,0,0,232,145,87
2021,201654,10,0,232,145,87
2021,201654,10,1,72,59,13
2021,201654,10,2,75,53,22
2021,201654,10,3,82,32,50
2021,201654,10,4,3,1,2
2021,201654,20,0,102,76,26
2021,201654,20,1,62,50,12
2021,201654,20,2,40,26,14
2021,201654,30,0,51,34,17
2021,201654,30,1,7,7,0
2021,201654,30,2,12,12,0
2021,201654,30,3,32,15,17
2021,201654,40,0,79,35,44
2021,201654,40,1,3,2,1
2021,201654,40,2,23,15,8
2021,201654,40,3,50,17,33
2021,201654,40,4,3,1,2
2021,201654,42,0,79,35,44
2021,201654,42,1,3,2,1
2021,201654,42,2,23,15,8
2021,201654,42,3,50,17,33
2021,201654,42,4,3,1,2
2021,201672,0,0,55,21,34
2021,201672,10,0,55,21,34
2021,201672,10,1,11,3,8
2021,201672,10,2,12,4,8
2021,201672,10,3,14,7,7
2021,201672,10,4,18,7,11
2021,201672,20,0,2,1,1
2021,201672,20,1,2,1,1
2021,201672,40,0,53,20,33
2021,201672,40,1,9,2,7
2021,201672,40,2,12,4,8
2021,201672,40,3,14,7,7
2021,201672,40,4,18,7,11
2021,201672,41,0,46,19,27
2021,201672,41,1,9,2,7
2021,201672,41,2,12,4,8
2021,201672,41,3,13,7,6
2021,201672,41,4,12,6,6
2021,201672,42,0,7,1,6
2021,201672,42,3,1,0,1
2021,201672,42,4,6,1,5
2021,201672,44,0,46,19,27
2021,201672,44,1,9,2,7
2021,201672,44,2,12,4,8
2021,201672,44,3,13,7,6
2021,201672,44,4,12,6,6
2021,201690,0,0,104,68,36
2021,201690,10,0,104,68,36
2021,201690,10,1,23,16,7
2021,201690,10,2,37,27,10
2021,201690,10,3,42,24,18
2021,201690,10,4,2,1,1
2021,201690,20,0,60,40,20
2021,201690,20,1,23,16,7
2021,201690,20,2,30,22,8
2021,201690,20,3,7,2,5
2021,201690,30,0,34,21,13
2021,201690,30,2,6,4,2
2021,201690,30,3,28,17,11
2021,201690,40,0,10,7,3
2021,201690,40,2,1,1,0
2021,201690,40,3,7,5,2
2021,201690,40,4,2,1,1
2021,201690,41,0,10,7,3
2021,201690,41,2,1,1,0
2021,201690,41,3,7,5,2
2021,201690,41,4,2,1,1
2021,201690,44,0,10,7,3
2021,201690,44,2,1,1,0
2021,201690,44,3,7,5,2
2021,201690,44,4,2,1,1
2021,201751,0,0,4,1,3
2021,201751,10,0,4,1,3
2021,201751,10,4,4,1,3
2021,201751,40,0,4,1,3
2021,201751,40,4,4,1,3
2021,201751,41,0,4,1,3
2021,201751,41,4,4,1,3
2021,201751,45,0,4,1,3
2021,201751,45,4,4,1,3
2021,201821,0,0,46,7,39
2021,201821,10,0,45,7,38
2021,201821,10,2,3,1,2
2021,201821,10,3,29,5,24
2021,201821,10,4,13,1,12
2021,201821,40,0,45,7,38
2021,201821,40,2,3,1,2
2021,201821,40,3,29,5,24
2021,201821,40,4,13,1,12
2021,201821,41,0,45,7,38
2021,201821,41,2,3,1,2
2021,201821,41,3,29,5,24
2021,201821,41,4,13,1,12
2021,201821,45,0,45,7,38
2021,201821,45,2,3,1,2
2021,201821,45,3,29,5,24
2021,201821,45,4,13,1,12
2021,201821,50,0,1,0,1
2021,201885,0,0,2211,1222,989
2021,201885,10,0,2211,1222,989
2021,201885,10,1,576,384,192
2021,201885,10,2,673,369,304
2021,201885,10,3,817,401,416
2021,201885,10,4,144,67,77
2021,201885,10,6,1,1,0
2021,201885,20,0,718,455,263
2021,201885,20,1,410,285,125
2021,201885,20,2,306,169,137
2021,201885,20,3,2,1,1
2021,201885,30,0,205,114,91
2021,201885,30,1,3,2,1
2021,201885,30,2,18,9,9
2021,201885,30,3,184,103,81
2021,201885,40,0,1288,653,635
2021,201885,40,1,163,97,66
2021,201885,40,2,349,191,158
2021,201885,40,3,631,297,334
2021,201885,40,4,144,67,77
2021,201885,40,6,1,1,0
2021,201885,41,0,1265,637,628
2021,201885,41,1,162,96,66
2021,201885,41,2,348,191,157
2021,201885,41,3,612,284,328
2021,201885,41,4,142,65,77
2021,201885,41,6,1,1,0
2021,201885,42,0,23,16,7
2021,201885,42,1,1,1,0
2021,201885,42,2,1,0,1
2021,201885,42,3,19,13,6
2021,201885,42,4,2,2,0
2021,201885,44,0,1265,637,628
2021,201885,44,1,162,96,66
2021,201885,44,2,348,191,157
2021,201885,44,3,612,284,328
2021,201885,44,4,142,65,77
2021,201885,44,6,1,1,0
2021,201928,0,0,140,51,89
2021,201928,10,0,140,51,89
2021,201928,10,6,140,51,89
2021,201928,20,0,105,41,64
2021,201928,20,6,105,41,64
2021,201928,30,0,32,9,23
2021,201928,30,6,32,9,23
2021,201928,40,0,3,1,2
2021,201928,40,6,3,1,2
2021,201928,42,0,3,1,2
2021,201928,42,6,3,1,2
2021,201946,0,0,80,30,50
2021,201946,10,0,80,30,50
2021,201946,10,1,30,13,17
2021,201946,10,2,30,13,17
2021,201946,10,3,18,4,14
2021,201946,10,4,2,0,2
2021,201946,20,0,55,24,31
2021,201946,20,1,30,13,17
2021,201946,20,2,25,11,14
2021,201946,30,0,9,3,6
2021,201946,30,3,9,3,6
2021,201946,40,0,16,3,13
2021,201946,40,2,5,2,3
2021,201946,40,3,9,1,8
2021,201946,40,4,2,0,2
2021,201946,41,0,13,3,10
2021,201946,41,2,4,2,2
2021,201946,41,3,7,1,6
2021,201946,41,4,2,0,2
2021,201946,42,0,3,0,3
2021,201946,42,2,1,0,1
2021,201946,42,3,2,0,2
2021,201946,44,0,13,3,10
2021,201946,44,2,4,2,2
2021,201946,44,3,7,1,6
2021,201946,44,4,2,0,2
2021,201955,0,0,168,68,100
2021,201955,10,0,168,68,100
2021,201955,10,1,38,9,29
2021,201955,10,2,82,35,47
2021,201955,10,3,41,21,20
2021,201955,10,4,7,3,4
2021,201955,20,0,114,42,72
2021,201955,20,1,37,9,28
2021,201955,20,2,76,33,43
2021,201955,20,3,1,0,1
2021,201955,30,0,33,16,17
2021,201955,30,3,33,16,17
2021,201955,40,0,21,10,11
2021,201955,40,1,1,0,1
2021,201955,40,2,6,2,4
2021,201955,40,3,7,5,2
2021,201955,40,4,7,3,4
2021,201955,41,0,18,8,10
2021,201955,41,1,1,0,1
2021,201955,41,2,5,1,4
2021,201955,41,3,5,4,1
2021,201955,41,4,7,3,4
2021,201955,42,0,3,2,1
2021,201955,42,2,1,1,0
2021,201955,42,3,2,1,1
2021,201955,44,0,18,8,10
2021,201955,44,1,1,0,1
2021,201955,44,2,5,1,4
2021,201955,44,3,5,4,1
2021,201955,44,4,7,3,4
2021,201964,0,0,85,50,35
2021,201964,10,0,85,50,35
2021,201964,10,1,4,2,2
2021,201964,10,2,6,4,2
2021,201964,10,3,7,6,1
2021,201964,10,6,68,38,30
2021,201964,40,0,85,50,35
2021,201964,40,1,4,2,2
2021,201964,40,2,6,4,2
2021,201964,40,3,7,6,1
2021,201964,40,6,68,38,30
2021,201964,42,0,85,50,35
2021,201964,42,1,4,2,2
2021,201964,42,2,6,4,2
2021,201964,42,3,7,6,1
2021,201964,42,6,68,38,30
2021,201973,0,0,91,24,67
2021,201973,10,0,86,22,64
2021,201973,10,1,19,7,12
2021,201973,10,2,12,2,10
2021,201973,10,3,22,5,17
2021,201973,10,4,33,8,25
2021,201973,40,0,86,22,64
2021,201973,40,1,19,7,12
2021,201973,40,2,12,2,10
2021,201973,40,3,22,5,17
2021,201973,40,4,33,8,25
2021,201973,41,0,52,13,39
2021,201973,41,1,19,7,12
2021,201973,41,2,8,1,7
2021,201973,41,3,18,4,14
2021,201973,41,4,7,1,6
2021,201973,42,0,34,9,25
2021,201973,42,2,4,1,3
2021,201973,42,3,4,1,3
2021,201973,42,4,26,7,19
2021,201973,44,0,52,13,39
2021,201973,44,1,19,7,12
2021,201973,44,2,8,1,7
2021,201973,44,3,18,4,14
2021,201973,44,4,7,1,6
2021,201973,50,0,5,2,3
2021,202046,0,0,49,32,17
2021,202046,10,0,49,32,17
2021,202046,10,1,8,5,3
2021,202046,10,2,19,14,5
2021,202046,10,3,8,5,3
2021,202046,10,5,14,8,6
2021,202046,40,0,49,32,17
2021,202046,40,1,8,5,3
2021,202046,40,2,19,14,5
2021,202046,40,3,8,5,3
2021,202046,40,5,14,8,6
2021,202046,41,0,35,24,11
2021,202046,41,1,8,5,3
2021,202046,41,2,19,14,5
2021,202046,41,3,8,5,3
2021,202046,42,0,14,8,6
2021,202046,42,5,14,8,6
2021,202046,44,0,35,24,11
2021,202046,44,1,8,5,3
2021,202046,44,2,19,14,5
2021,202046,44,3,8,5,3
2021,202073,0,0,31,17,14
2021,202073,10,0,31,17,14
2021,202073,10,6,31,17,14
2021,202073,40,0,31,17,14
2021,202073,40,6,31,17,14
2021,202073,42,0,31,17,14
2021,202073,42,6,31,17,14
2021,202134,0,0,557,285,272
2021,202134,10,0,557,285,272
2021,202134,10,1,128,85,43
2021,202134,10,2,183,98,85
2021,202134,10,3,125,53,72
2021,202134,10,4,3,1,2
2021,202134,10,5,118,48,70
2021,202134,20,0,280,170,110
2021,202134,20,1,127,85,42
2021,202134,20,2,153,85,68
2021,202134,30,0,120,50,70
2021,202134,30,2,27,12,15
2021,202134,30,3,91,38,53
2021,202134,30,4,2,0,2
2021,202134,40,0,157,65,92
2021,202134,40,1,1,0,1
2021,202134,40,2,3,1,2
2021,202134,40,3,34,15,19
2021,202134,40,4,1,1,0
2021,202134,40,5,118,48,70
2021,202134,42,0,157,65,92
2021,202134,42,1,1,0,1
2021,202134,42,2,3,1,2
2021,202134,42,3,34,15,19
2021,202134,42,4,1,1,0
2021,202134,42,5,118,48,70
2021,202170,0,0,58,34,24
2021,202170,10,0,58,34,24
2021,202170,10,1,21,10,11
2021,202170,10,2,20,13,7
2021,202170,10,3,17,11,6
2021,202170,40,0,58,34,24
2021,202170,40,1,21,10,11
2021,202170,40,2,20,13,7
2021,202170,40,3,17,11,6
2021,202170,41,0,58,34,24
2021,202170,41,1,21,10,11
2021,202170,41,2,20,13,7
2021,202170,41,3,17,11,6
2021,202170,44,0,55,32,23
2021,202170,44,1,18,8,10
2021,202170,44,2,20,13,7
2021,202170,44,3,17,11,6
2021,202170,45,0,3,2,1
2021,202170,45,1,3,2,1
2021,202222,0,0,349,161,188
2021,202222,10,0,349,161,188
2021,202222,10,1,117,54,63
2021,202222,10,2,72,40,32
2021,202222,10,3,58,25,33
2021,202222,10,4,44,21,23
2021,202222,10,6,58,21,37
2021,202222,20,0,247,119,128
2021,202222,20,1,117,54,63
2021,202222,20,2,72,40,32
2021,202222,20,3,58,25,33
2021,202222,30,0,44,21,23
2021,202222,30,4,44,21,23
2021,202222,40,0,58,21,37
2021,202222,40,6,58,21,37
2021,202222,42,0,58,21,37
2021,202222,42,6,58,21,37
2021,202356,0,0,398,158,240
2021,202356,10,0,398,158,240
2021,202356,10,1,42,16,26
2021,202356,10,2,88,30,58
2021,202356,10,3,230,101,129
2021,202356,10,5,38,11,27
2021,202356,20,0,319,135,184
2021,202356,20,1,42,16,26
2021,202356,20,2,86,30,56
2021,202356,20,3,191,89,102
2021,202356,30,0,41,12,29
2021,202356,30,2,2,0,2
2021,202356,30,3,39,12,27
2021,202356,40,0,38,11,27
2021,202356,40,5,38,11,27
2021,202356,43,0,38,11,27
2021,202356,43,5,38,11,27
2021,202480,0,0,670,376,294
2021,202480,10,0,667,375,292
2021,202480,10,1,138,100,38
2021,202480,10,2,182,102,80
2021,202480,10,3,117,69,48
2021,202480,10,5,202,91,111
2021,202480,10,6,28,13,15
2021,202480,20,0,310,193,117
2021,202480,20,1,137,99,38
2021,202480,20,2,171,93,78
2021,202480,20,3,2,1,1
2021,202480,30,0,127,78,49
2021,202480,30,1,1,1,0
2021,202480,30,2,11,9,2
2021,202480,30,3,115,68,47
2021,202480,40,0,230,104,126
2021,202480,40,5,202,91,111
2021,202480,40,6,28,13,15
2021,202480,42,0,230,104,126
2021,202480,42,5,202,91,111
2021,202480,42,6,28,13,15
2021,202480,50,0,3,1,2
2021,202514,0,0,36,20,16
2021,202514,10,0,36,20,16
2021,202514,10,1,5,4,1
2021,202514,10,2,8,5,3
2021,202514,10,3,20,9,11
2021,202514,10,4,3,2,1
2021,202514,20,0,12,9,3
2021,202514,20,1,5,4,1
2021,202514,20,2,6,4,2
2021,202514,20,3,1,1,0
2021,202514,30,0,16,7,9
2021,202514,30,3,16,7,9
2021,202514,40,0,8,4,4
2021,202514,40,2,2,1,1
2021,202514,40,3,3,1,2
2021,202514,40,4,3,2,1
2021,202514,42,0,8,4,4
2021,202514,42,2,2,1,1
2021,202514,42,3,3,1,2
2021,202514,42,4,3,2,1
2021,202523,0,0,238,122,116
2021,202523,10,0,238,122,116
2021,202523,10,1,46,33,13
2021,202523,10,2,92,42,50
2021,202523,10,3,89,40,49
2021,202523,10,4,11,7,4
2021,202523,20,0,130,70,60
2021,202523,20,1,46,33,13
2021,202523,20,2,84,37,47
2021,202523,30,0,47,21,26
2021,202523,30,2,4,2,2
2021,202523,30,3,42,19,23
2021,202523,30,4,1,0,1
2021,202523,40,0,61,31,30
2021,202523,40,2,4,3,1
2021,202523,40,3,47,21,26
2021,202523,40,4,10,7,3
2021,202523,42,0,61,31,30
2021,202523,42,2,4,3,1
2021,202523,42,3,47,21,26
2021,202523,42,4,10,7,3
2021,202648,0,0,48,20,28
2021,202648,10,0,48,20,28
2021,202648,10,1,10,6,4
2021,202648,10,2,14,4,10
2021,202648,10,3,18,8,10
2021,202648,10,4,6,2,4
2021,202648,40,0,48,20,28
2021,202648,40,1,10,6,4
2021,202648,40,2,14,4,10
2021,202648,40,3,18,8,10
2021,202648,40,4,6,2,4
2021,202648,41,0,48,20,28
2021,202648,41,1,10,6,4
2021,202648,41,2,14,4,10
2021,202648,41,3,18,8,10
2021,202648,41,4,6,2,4
2021,202648,44,0,48,20,28
2021,202648,44,1,10,6,4
2021,202648,44,2,14,4,10
2021,202648,44,3,18,8,10
2021,202648,44,4,6,2,4
2021,202763,0,0,215,106,109
2021,202763,10,0,215,106,109
2021,202763,10,1,25,12,13
2021,202763,10,2,48,26,22
2021,202763,10,3,94,43,51
2021,202763,10,4,48,25,23
2021,202763,20,0,85,49,36
2021,202763,20,1,25,12,13
2021,202763,20,2,42,24,18
2021,202763,20,3,18,13,5
2021,202763,30,0,53,20,33
2021,202763,30,2,2,0,2
2021,202763,30,3,51,20,31
2021,202763,40,0,77,37,40
2021,202763,40,2,4,2,2
2021,202763,40,3,25,10,15
2021,202763,40,4,48,25,23
2021,202763,42,0,77,37,40
2021,202763,42,2,4,2,2
2021,202763,42,3,25,10,15
2021,202763,42,4,48,25,23
2021,202806,0,0,63,32,31
2021,202806,10,0,63,32,31
2021,202806,10,6,63,32,31
2021,202806,40,0,63,32,31
2021,202806,40,6,63,32,31
2021,202806,41,0,63,32,31
2021,202806,41,6,63,32,31
2021,202806,45,0,63,32,31
2021,202806,45,6,63,32,31
2021,202903,0,0,19,13,6
2021,202903,10,0,18,12,6
2021,202903,10,1,4,3,1
2021,202903,10,2,4,3,1
2021,202903,10,3,7,4,3
2021,202903,10,4,3,2,1
2021,202903,40,0,18,12,6
2021,202903,40,1,4,3,1
2021,202903,40,2,4,3,1
2021,202903,40,3,7,4,3
2021,202903,40,4,3,2,1
2021,202903,41,0,18,12,6
2021,202903,41,1,4,3,1
2021,202903,41,2,4,3,1
2021,202903,41,3,7,4,3
2021,202903,41,4,3,2,1
2021,202903,44,0,18,12,6
2021,202903,44,1,4,3,1
2021,202903,44,2,4,3,1
2021,202903,44,3,7,4,3
2021,202903,44,4,3,2,1
2021,202903,50,0,1,1,0
2021,202912,0,0,28,4,24
2021,202912,10,0,28,4,24
2021,202912,10,1,4,2,2
2021,202912,10,2,6,0,6
2021,202912,10,3,12,2,10
2021,202912,10,4,6,0,6
2021,202912,40,0,28,4,24
2021,202912,40,1,4,2,2
2021,202912,40,2,6,0,6
2021,202912,40,3,12,2,10
2021,202912,40,4,6,0,6
2021,202912,41,0,19,4,15
2021,202912,41,1,4,2,2
2021,202912,41,2,4,0,4
2021,202912,41,3,9,2,7
2021,202912,41,4,2,0,2
2021,202912,43,0,9,0,9
2021,202912,43,2,2,0,2
2021,202912,43,3,3,0,3
2021,202912,43,4,4,0,4
2021,202912,45,0,19,4,15
2021,202912,45,1,4,2,2
2021,202912,45,2,4,0,4
2021,202912,45,3,9,2,7
2021,202912,45,4,2,0,2
2021,203067,0,0,32,14,18
2021,203067,10,0,32,14,18
2021,203067,10,1,13,6,7
2021,203067,10,2,3,0,3
2021,203067,10,3,8,6,2
2021,203067,10,4,8,2,6
2021,203067,20,0,25,9,16
2021,203067,20,1,13,6,7
2021,203067,20,2,2,0,2
2021,203067,20,3,2,1,1
2021,203067,20,4,8,2,6
2021,203067,30,0,4,2,2
2021,203067,30,2,1,0,1
2021,203067,30,3,3,2,1
2021,203067,40,0,3,3,0
2021,203067,40,3,3,3,0
2021,203067,41,0,3,3,0
2021,203067,41,3,3,3,0
2021,203067,44,0,3,3,0
2021,203067,44,3,3,3,0
2021,203085,0,0,55,27,28
2021,203085,10,0,55,27,28
2021,203085,10,1,11,4,7
2021,203085,10,2,13,5,8
2021,203085,10,3,27,16,11
2021,203085,10,4,4,2,2
2021,203085,20,0,19,7,12
2021,203085,20,1,11,4,7
2021,203085,20,2,8,3,5
2021,203085,30,0,11,7,4
2021,203085,30,2,3,1,2
2021,203085,30,3,8,6,2
2021,203085,40,0,25,13,12
2021,203085,40,2,2,1,1
2021,203085,40,3,19,10,9
2021,203085,40,4,4,2,2
2021,203085,41,0,22,11,11
2021,203085,41,2,2,1,1
2021,203085,41,3,17,8,9
2021,203085,41,4,3,2,1
2021,203085,42,0,3,2,1
2021,203085,42,3,2,2,0
2021,203085,42,4,1,0,1
2021,203085,44,0,22,11,11
2021,203085,44,2,2,1,1
2021,203085,44,3,17,8,9
2021,203085,44,4,3,2,1
2021,203128,0,0,64,30,34
2021,203128,10,0,64,30,34
2021,203128,10,1,12,5,7
2021,203128,10,2,28,14,14
2021,203128,10,3,17,8,9
2021,203128,10,4,7,3,4
2021,203128,20,0,38,18,20
2021,203128,20,1,12,5,7
2021,203128,20,2,26,13,13
2021,203128,30,0,14,5,9
2021,203128,30,2,2,1,1
2021,203128,30,3,12,4,8
2021,203128,40,0,12,7,5
2021,203128,40,3,5,4,1
2021,203128,40,4,7,3,4
2021,203128,41,0,2,2,0
2021,203128,41,3,1,1,0
2021,203128,41,4,1,1,0
2021,203128,42,0,10,5,5
2021,203128,42,3,4,3,1
2021,203128,42,4,6,2,4
2021,203128,44,0,2,2,0
2021,203128,44,3,1,1,0
2021,203128,44,4,1,1,0
2021,203155,0,0,64,33,31
2021,203155,10,0,64,33,31
2021,203155,10,6,64,33,31
2021,203155,40,0,64,33,31
2021,203155,40,6,64,33,31
2021,203155,41,0,64,33,31
2021,203155,41,6,64,33,31
2021,203155,45,0,64,33,31
2021,203155,45,6,64,33,31
2021,203331,0,0,76,32,44
2021,203331,10,0,76,32,44
2021,203331,10,1,4,1,3
2021,203331,10,2,8,2,6
2021,203331,10,3,15,9,6
2021,203331,10,4,49,20,29
2021,203331,40,0,76,32,44
2021,203331,40,1,4,1,3
2021,203331,40,2,8,2,6
2021,203331,40,3,15,9,6
2021,203331,40,4,49,20,29
2021,203331,41,0,76,32,44
2021,203331,41,1,4,1,3
2021,203331,41,2,8,2,6
2021,203331,41,3,15,9,6
2021,203331,41,4,49,20,29
2021,203331,44,0,76,32,44
2021,203331,44,1,4,1,3
2021,203331,44,2,8,2,6
2021,203331,44,3,15,9,6
2021,203331,44,4,49,20,29
2021,203368,0,0,159,88,71
2021,203368,10,0,159,88,71
2021,203368,10,1,53,29,24
2021,203368,10,2,67,35,32
2021,203368,10,3,34,21,13
2021,203368,10,4,5,3,2
2021,203368,20,0,124,67,57
2021,203368,20,1,53,29,24
2021,203368,20,2,65,35,30
2021,203368,20,3,6,3,3
2021,203368,30,0,21,11,10
2021,203368,30,2,2,0,2
2021,203368,30,3,19,11,8
2021,203368,40,0,14,10,4
2021,203368,40,3,9,7,2
2021,203368,40,4,5,3,2
2021,203368,42,0,14,10,4
2021,203368,42,3,9,7,2
2021,203368,42,4,5,3,2
2021,203386,0,0,125,28,97
2021,203386,10,0,125,28,97
2021,203386,10,1,4,4,0
2021,203386,10,2,14,2,12
2021,203386,10,3,4,0,4
2021,203386,10,4,103,22,81
2021,203386,40,0,125,28,97
2021,203386,40,1,4,4,0
2021,203386,40,2,14,2,12
2021,203386,40,3,4,0,4
2021,203386,40,4,103,22,81
2021,203386,41,0,125,28,97
2021,203386,41,1,4,4,0
2021,203386,41,2,14,2,12
2021,203386,41,3,4,0,4
2021,203386,41,4,103,22,81
2021,203386,45,0,125,28,97
2021,203386,45,1,4,4,0
2021,203386,45,2,14,2,12
2021,203386,45,3,4,0,4
2021,203386,45,4,103,22,81
2021,203447,0,0,40,13,27
2021,203447,10,0,40,13,27
2021,203447,10,1,2,2,0
2021,203447,10,2,14,6,8
2021,203447,10,3,1,0,1
2021,203447,10,5,23,5,18
2021,203447,20,0,14,7,7
2021,203447,20,1,1,1,0
2021,203447,20,2,12,6,6
2021,203447,20,3,1,0,1
2021,203447,40,0,26,6,20
2021,203447,40,1,1,1,0
2021,203447,40,2,2,0,2
2021,203447,40,5,23,5,18
2021,203447,42,0,26,6,20
2021,203447,42,1,1,1,0
2021,203447,42,2,2,0,2
2021,203447,42,5,23,5,18
2021,203456,0,0,17,8,9
2021,203456,10,0,17,8,9
2021,203456,10,2,9,7,2
2021,203456,10,5,8,1,7
2021,203456,20,0,6,4,2
2021,203456,20,2,6,4,2
2021,203456,40,0,11,4,7
2021,203456,40,2,3,3,0
2021,203456,40,5,8,1,7
2021,203456,42,0,11,4,7
2021,203456,42,2,3,3,0
2021,203456,42,5,8,1,7
2021,203465,0,0,95,47,48
2021,203465,10,0,95,47,48
2021,203465,10,1,14,9,5
2021,203465,10,2,46,25,21
2021,203465,10,3,16,9,7
2021,203465,10,5,19,4,15
2021,203465,20,0,55,34,21
2021,203465,20,1,11,8,3
2021,203465,20,2,37,22,15
2021,203465,20,3,7,4,3
2021,203465,30,0,5,3,2
2021,203465,30,3,5,3,2
2021,203465,40,0,35,10,25
2021,203465,40,1,3,1,2
2021,203465,40,2,9,3,6
2021,203465,40,3,4,2,2
2021,203465,40,5,19,4,15
2021,203465,42,0,35,10,25
2021,203465,42,1,3,1,2
2021,203465,42,2,9,3,6
2021,203465,42,3,4,2,2
2021,203465,42,5,19,4,15
2021,203474,0,0,41,16,25
2021,203474,10,0,41,16,25
2021,203474,10,1,10,3,7
2021,203474,10,2,15,7,8
2021,203474,10,3,5,3,2
2021,203474,10,5,11,3,8
2021,203474,20,0,18,9,9
2021,203474,20,1,6,3,3
2021,203474,20,2,11,6,5
2021,203474,20,3,1,0,1
2021,203474,30,0,3,3,0
2021,203474,30,3,3,3,0
2021,203474,40,0,20,4,16
2021,203474,40,1,4,0,4
2021,203474,40,2,4,1,3
2021,203474,40,3,1,0,1
2021,203474,40,5,11,3,8
2021,203474,42,0,20,4,16
2021,203474,42,1,4,0,4
2021,203474,42,2,4,1,3
2021,203474,42,3,1,0,1
2021,203474,42,5,11,3,8
2021,203483,0,0,49,25,24
2021,203483,10,0,49,25,24
2021,203483,10,1,6,2,4
2021,203483,10,2,14,7,7
2021,203483,10,3,10,8,2
2021,203483,10,5,19,8,11
2021,203483,20,0,19,9,10
2021,203483,20,1,5,2,3
2021,203483,20,2,13,7,6
2021,203483,20,3,1,0,1
2021,203483,30,0,5,4,1
2021,203483,30,3,5,4,1
2021,203483,40,0,25,12,13
2021,203483,40,1,1,0,1
2021,203483,40,2,1,0,1
2021,203483,40,3,4,4,0
2021,203483,40,5,19,8,11
2021,203483,42,0,25,12,13
2021,203483,42,1,1,0,1
2021,203483,42,2,1,0,1
2021,203483,42,3,4,4,0
2021,203483,42,5,19,8,11
2021,203492,0,0,37,13,24
2021,203492,10,0,37,13,24
2021,203492,10,1,3,1,2
2021,203492,10,2,6,3,3
2021,203492,10,3,11,4,7
2021,203492,10,5,17,5,12
2021,203492,20,0,7,3,4
2021,203492,20,1,2,1,1
2021,203492,20,2,4,2,2
2021,203492,20,3,1,0,1
2021,203492,30,0,5,1,4
2021,203492,30,3,5,1,4
2021,203492,40,0,25,9,16
2021,203492,40,1,1,0,1
2021,203492,40,2,2,1,1
2021,203492,40,3,5,3,2
2021,203492,40,5,17,5,12
2021,203492,42,0,25,9,16
2021,203492,42,1,1,0,1
2021,203492,42,2,2,1,1
2021,203492,42,3,5,3,2
2021,203492,42,5,17,5,12
2021,203517,0,0,927,423,504
2021,203517,10,0,927,423,504
2021,203517,10,1,255,143,112
2021,203517,10,2,316,142,174
2021,203517,10,3,214,103,111
2021,203517,10,4,142,35,107
2021,203517,20,0,419,230,189
2021,203517,20,1,191,119,72
2021,203517,20,2,221,105,116
2021,203517,20,3,7,6,1
2021,203517,30,0,148,75,73
2021,203517,30,1,1,0,1
2021,203517,30,2,6,4,2
2021,203517,30,3,141,71,70
2021,203517,40,0,360,118,242
2021,203517,40,1,63,24,39
2021,203517,40,2,89,33,56
2021,203517,40,3,66,26,40
2021,203517,40,4,142,35,107
2021,203517,42,0,360,118,242
2021,203517,42,1,63,24,39
2021,203517,42,2,89,33,56
2021,203517,42,3,66,26,40
2021,203517,42,4,142,35,107
2021,203526,0,0,37,9,28
2021,203526,10,0,37,9,28
2021,203526,10,1,5,2,3
2021,203526,10,2,13,2,11
2021,203526,10,3,4,0,4
2021,203526,10,5,15,5,10
2021,203526,20,0,7,3,4
2021,203526,20,1,3,2,1
2021,203526,20,2,4,1,3
2021,203526,30,0,2,1,1
2021,203526,30,2,1,1,0
2021,203526,30,3,1,0,1
2021,203526,40,0,28,5,23
2021,203526,40,1,2,0,2
2021,203526,40,2,8,0,8
2021,203526,40,3,3,0,3
2021,203526,40,5,15,5,10
2021,203526,42,0,28,5,23
2021,203526,42,1,2,0,2
2021,203526,42,2,8,0,8
2021,203526,42,3,3,0,3
2021,203526,42,5,15,5,10
2021,203535,0,0,212,99,113
2021,203535,10,0,212,99,113
2021,203535,10,1,63,40,23
2021,203535,10,2,51,28,23
2021,203535,10,3,82,28,54
2021,203535,10,4,12,2,10
2021,203535,10,6,4,1,3
2021,203535,20,0,90,49,41
2021,203535,20,1,60,37,23
2021,203535,20,2,30,12,18
2021,203535,30,0,60,34,26
2021,203535,30,1,1,1,0
2021,203535,30,2,21,16,5
2021,203535,30,3,37,16,21
2021,203535,30,6,1,1,0
2021,203535,40,0,62,16,46
2021,203535,40,1,2,2,0
2021,203535,40,3,45,12,33
2021,203535,40,4,12,2,10
2021,203535,40,6,3,0,3
2021,203535,41,0,8,2,6
2021,203535,41,3,7,2,5
2021,203535,41,4,1,0,1
2021,203535,42,0,54,14,40
2021,203535,42,1,2,2,0
2021,203535,42,3,38,10,28
2021,203535,42,4,11,2,9
2021,203535,42,6,3,0,3
2021,203535,44,0,8,2,6
2021,203535,44,3,7,2,5
2021,203535,44,4,1,0,1
2021,203544,0,0,65,13,52
2021,203544,10,0,65,13,52
2021,203544,10,1,15,5,10
2021,203544,10,2,30,7,23
2021,203544,10,3,20,1,19
2021,203544,40,0,65,13,52
2021,203544,40,1,15,5,10
2021,203544,40,2,30,7,23
2021,203544,40,3,20,1,19
2021,203544,42,0,65,13,52
2021,203544,42,1,15,5,10
2021,203544,42,2,30,7,23
2021,203544,42,3,20,1,19
2021,203580,0,0,46,17,29
2021,203580,10,0,46,17,29
2021,203580,10,1,8,4,4
2021,203580,10,2,17,8,9
2021,203580,10,3,15,5,10
2021,203580,10,4,6,0,6
2021,203580,20,0,19,9,10
2021,203580,20,1,8,4,4
2021,203580,20,2,11,5,6
2021,203580,30,0,11,5,6
2021,203580,30,2,3,2,1
2021,203580,30,3,8,3,5
2021,203580,40,0,16,3,13
2021,203580,40,2,3,1,2
2021,203580,40,3,7,2,5
2021,203580,40,4,6,0,6
2021,203580,42,0,16,3,13
2021,203580,42,2,3,1,2
2021,203580,42,3,7,2,5
2021,203580,42,4,6,0,6
2021,203599,0,0,124,60,64
2021,203599,10,0,124,60,64
2021,203599,10,1,78,40,38
2021,203599,10,2,26,12,14
2021,203599,10,3,10,2,8
2021,203599,10,4,10,6,4
2021,203599,20,0,112,56,56
2021,203599,20,1,78,40,38
2021,203599,20,2,25,11,14
2021,203599,20,3,5,1,4
2021,203599,20,4,4,4,0
2021,203599,30,0,12,4,8
2021,203599,30,2,1,1,0
2021,203599,30,3,5,1,4
2021,203599,30,4,6,2,4
2021,203678,0,0,56,18,38
2021,203678,10,0,56,18,38
2021,203678,10,1,4,1,3
2021,203678,10,2,10,3,7
2021,203678,10,3,14,6,8
2021,203678,10,4,28,8,20
2021,203678,40,0,56,18,38
2021,203678,40,1,4,1,3
2021,203678,40,2,10,3,7
2021,203678,40,3,14,6,8
2021,203678,40,4,28,8,20
2021,203678,42,0,56,18,38
2021,203678,42,1,4,1,3
2021,203678,42,2,10,3,7
2021,203678,42,3,14,6,8
2021,203678,42,4,28,8,20
2021,203720,0,0,13,12,1
2021,203720,10,0,13,12,1
2021,203720,10,4,13,12,1
2021,203720,40,0,13,12,1
2021,203720,40,4,13,12,1
2021,203720,41,0,13,12,1
2021,203720,41,4,13,12,1
2021,203720,45,0,13,12,1
2021,203720,45,4,13,12,1
2021,203748,0,0,133,62,71
2021,203748,10,0,114,52,62
2021,203748,10,1,52,25,27
2021,203748,10,2,20,9,11
2021,203748,10,3,30,13,17
2021,203748,10,4,12,5,7
2021,203748,20,0,76,35,41
2021,203748,20,1,52,25,27
2021,203748,20,2,15,7,8
2021,203748,20,3,9,3,6
2021,203748,30,0,27,15,12
2021,203748,30,2,4,2,2
2021,203748,30,3,15,10,5
2021,203748,30,4,8,3,5
2021,203748,40,0,11,2,9
2021,203748,40,2,1,0,1
2021,203748,40,3,6,0,6
2021,203748,40,4,4,2,2
2021,203748,42,0,11,2,9
2021,203748,42,2,1,0,1
2021,203748,42,3,6,0,6
2021,203748,42,4,4,2,2
2021,203748,50,0,19,10,9
2021,203757,0,0,60,17,43
2021,203757,10,0,60,17,43
2021,203757,10,1,2,1,1
2021,203757,10,2,16,5,11
2021,203757,10,3,28,8,20
2021,203757,10,4,14,3,11
2021,203757,40,0,60,17,43
2021,203757,40,1,2,1,1
2021,203757,40,2,16,5,11
2021,203757,40,3,28,8,20
2021,203757,40,4,14,3,11
2021,203757,41,0,39,15,24
2021,203757,41,1,2,1,1
2021,203757,41,2,13,5,8
2021,203757,41,3,15,6,9
2021,203757,41,4,9,3,6
2021,203757,42,0,20,2,18
2021,203757,42,2,3,0,3
2021,203757,42,3,12,2,10
2021,203757,42,4,5,0,5
2021,203757,43,0,1,0,1
2021,203757,43,3,1,0,1
2021,203757,44,0,39,15,24
2021,203757,44,1,2,1,1
2021,203757,44,2,13,5,8
2021,203757,44,3,15,6,9
2021,203757,44,4,9,3,6
2021,203775,0,0,51,25,26
2021,203775,10,0,51,25,26
2021,203775,10,1,24,16,8
2021,203775,10,2,11,4,7
2021,203775,10,3,11,3,8
2021,203775,10,4,5,2,3
2021,203775,20,0,33,20,13
2021,203775,20,1,24,16,8
2021,203775,20,2,9,4,5
2021,203775,30,0,3,1,2
2021,203775,30,2,1,0,1
2021,203775,30,3,2,1,1
2021,203775,40,0,15,4,11
2021,203775,40,2,1,0,1
2021,203775,40,3,9,2,7
2021,203775,40,4,5,2,3
2021,203775,42,0,15,4,11
2021,203775,42,2,1,0,1
2021,203775,42,3,9,2,7
2021,203775,42,4,5,2,3
2021,203845,0,0,121,67,54
2021,203845,10,0,121,67,54
2021,203845,10,1,37,22,15
2021,203845,10,2,26,17,9
2021,203845,10,3,49,25,24
2021,203845,10,4,9,3,6
2021,203845,20,0,54,35,19
2021,203845,20,1,34,21,13
2021,203845,20,2,20,14,6
2021,203845,30,0,21,11,10
2021,203845,30,2,2,0,2
2021,203845,30,3,19,11,8
2021,203845,40,0,46,21,25
2021,203845,40,1,3,1,2
2021,203845,40,2,4,3,1
2021,203845,40,3,30,14,16
2021,203845,40,4,9,3,6
2021,203845,42,0,46,21,25
2021,203845,42,1,3,1,2
2021,203845,42,2,4,3,1
2021,203845,42,3,30,14,16
2021,203845,42,4,9,3,6
2021,203881,0,0,52,19,33
2021,203881,10,0,52,19,33
2021,203881,10,1,20,6,14
2021,203881,10,2,9,3,6
2021,203881,10,3,18,9,9
2021,203881,10,4,5,1,4
2021,203881,40,0,52,19,33
2021,203881,40,1,20,6,14
2021,203881,40,2,9,3,6
2021,203881,40,3,18,9,9
2021,203881,40,4,5,1,4
2021,203881,42,0,52,19,33
2021,203881,42,1,20,6,14
2021,203881,42,2,9,3,6
2021,203881,42,3,18,9,9
2021,203881,42,4,5,1,4
2021,203960,0,0,69,8,61
2021,203960,10,0,69,8,61
2021,203960,10,1,5,1,4
2021,203960,10,2,13,3,10
2021,203960,10,3,49,4,45
2021,203960,10,4,2,0,2
2021,203960,40,0,69,8,61
2021,203960,40,1,5,1,4
2021,203960,40,2,13,3,10
2021,203960,40,3,49,4,45
2021,203960,40,4,2,0,2
2021,203960,41,0,24,5,19
2021,203960,41,1,5,1,4
2021,203960,41,2,11,3,8
2021,203960,41,3,8,1,7
2021,203960,42,0,45,3,42
2021,203960,42,2,2,0,2
2021,203960,42,3,41,3,38
2021,203960,42,4,2,0,2
2021,203960,44,0,24,5,19
2021,203960,44,1,5,1,4
2021,203960,44,2,11,3,8
2021,203960,44,3,8,1,7
2021,203997,0,0,11,7,4
2021,203997,10,0,11,7,4
2021,203997,10,1,4,4,0
2021,203997,10,2,3,2,1
2021,203997,10,3,3,1,2
2021,203997,10,6,1,0,1
2021,203997,20,0,7,6,1
2021,203997,20,1,4,4,0
2021,203997,20,2,3,2,1
2021,203997,30,0,3,1,2
2021,203997,30,3,3,1,2
2021,203997,40,0,1,0,1
2021,203997,40,6,1,0,1
2021,203997,41,0,1,0,1
2021,203997,41,6,1,0,1
2021,203997,44,0,1,0,1
2021,203997,44,6,1,0,1
2021,204006,0,0,98,41,57
2021,204006,10,0,98,41,57
2021,204006,10,1,14,8,6
2021,204006,10,2,36,17,19
2021,204006,10,3,19,4,15
2021,204006,10,4,11,6,5
2021,204006,10,5,18,6,12
2021,204006,20,0,48,24,24
2021,204006,20,1,14,8,6
2021,204006,20,2,34,16,18
2021,204006,30,0,21,5,16
2021,204006,30,2,2,1,1
2021,204006,30,3,19,4,15
2021,204006,40,0,29,12,17
2021,204006,40,4,11,6,5
2021,204006,40,5,18,6,12
2021,204006,41,0,18,6,12
2021,204006,41,5,18,6,12
2021,204006,42,0,11,6,5
2021,204006,42,4,11,6,5
2021,204006,44,0,18,6,12
2021,204006,44,5,18,6,12
2021,204015,0,0,42,25,17
2021,204015,10,0,42,25,17
2021,204015,10,1,9,4,5
2021,204015,10,2,11,7,4
2021,204015,10,3,9,7,2
2021,204015,10,4,4,3,1
2021,204015,10,5,9,4,5
2021,204015,20,0,20,11,9
2021,204015,20,1,9,4,5
2021,204015,20,2,11,7,4
2021,204015,30,0,9,7,2
2021,204015,30,3,9,7,2
2021,204015,40,0,13,7,6
2021,204015,40,4,4,3,1
2021,204015,40,5,9,4,5
2021,204015,41,0,9,4,5
2021,204015,41,5,9,4,5
2021,204015,42,0,4,3,1
2021,204015,42,4,4,3,1
2021,204015,44,0,9,4,5
2021,204015,44,5,9,4,5
2021,204024,0,0,888,504,384
2021,204024,10,0,888,504,384
2021,204024,10,1,238,147,91
2021,204024,10,2,215,132,83
2021,204024,10,3,144,94,50
2021,204024,10,4,136,64,72
2021,204024,10,5,155,67,88
2021,204024,20,0,448,277,171
2021,204024,20,1,238,147,91
2021,204024,20,2,208,128,80
2021,204024,20,3,2,2,0
2021,204024,30,0,147,95,52
2021,204024,30,2,6,4,2
2021,204024,30,3,141,91,50
2021,204024,40,0,293,132,161
2021,204024,40,2,1,0,1
2021,204024,40,3,1,1,0
2021,204024,40,4,136,64,72
2021,204024,40,5,155,67,88
2021,204024,41,0,157,68,89
2021,204024,41,2,1,0,1
2021,204024,41,3,1,1,0
2021,204024,41,5,155,67,88
2021,204024,42,0,136,64,72
2021,204024,42,4,136,64,72
2021,204024,44,0,157,68,89
2021,204024,44,2,1,0,1
2021,204024,44,3,1,1,0
2021,204024,44,5,155,67,88
2021,204176,0,0,56,2,54
2021,204176,10,0,56,2,54
2021,204176,10,1,1,0,1
2021,204176,10,2,13,0,13
2021,204176,10,3,32,1,31
2021,204176,10,4,10,1,9
2021,204176,40,0,56,2,54
2021,204176,40,1,1,0,1
2021,204176,40,2,13,0,13
2021,204176,40,3,32,1,31
2021,204176,40,4,10,1,9
2021,204176,42,0,48,2,46
2021,204176,42,1,1,0,1
2021,204176,42,2,12,0,12
2021,204176,42,3,26,1,25
2021,204176,42,4,9,1,8
2021,204176,43,0,8,0,8
2021,204176,43,2,1,0,1
2021,204176,43,3,6,0,6
2021,204176,43,4,1,0,1
2021,204185,0,0,141,65,76
2021,204185,10,0,141,65,76
2021,204185,10,1,45,22,23
2021,204185,10,2,49,25,24
2021,204185,10,3,44,17,27
2021,204185,10,4,3,1,2
2021,204185,20,0,79,42,37
2021,204185,20,1,41,19,22
2021,204185,20,2,38,23,15
2021,204185,30,0,36,16,20
2021,204185,30,1,3,2,1
2021,204185,30,2,6,1,5
2021,204185,30,3,27,13,14
2021,204185,40,0,26,7,19
2021,204185,40,1,1,1,0
2021,204185,40,2,5,1,4
2021,204185,40,3,17,4,13
2021,204185,40,4,3,1,2
2021,204185,41,0,22,4,18
2021,204185,41,1,1,1,0
2021,204185,41,2,5,1,4
2021,204185,41,3,14,2,12
2021,204185,41,4,2,0,2
2021,204185,42,0,4,3,1
2021,204185,42,3,3,2,1
2021,204185,42,4,1,1,0
2021,204185,45,0,22,4,18
2021,204185,45,1,1,1,0
2021,204185,45,2,5,1,4
2021,204185,45,3,14,2,12
2021,204185,45,4,2,0,2
2021,204194,0,0,66,39,27
2021,204194,10,0,66,39,27
2021,204194,10,1,24,18,6
2021,204194,10,2,13,9,4
2021,204194,10,3,27,11,16
2021,204194,10,4,2,1,1
2021,204194,40,0,66,39,27
2021,204194,40,1,24,18,6
2021,204194,40,2,13,9,4
2021,204194,40,3,27,11,16
2021,204194,40,4,2,1,1
2021,204194,41,0,18,14,4
2021,204194,41,1,16,12,4
2021,204194,41,2,2,2,0
2021,204194,42,0,48,25,23
2021,204194,42,1,8,6,2
2021,204194,42,2,11,7,4
2021,204194,42,3,27,11,16
2021,204194,42,4,2,1,1
2021,204194,44,0,18,14,4
2021,204194,44,1,16,12,4
2021,204194,44,2,2,2,0
2021,204200,0,0,104,40,64
2021,204200,10,0,104,40,64
2021,204200,10,1,13,8,5
2021,204200,10,2,23,10,13
2021,204200,10,3,43,13,30
2021,204200,10,4,25,9,16
2021,204200,20,0,31,16,15
2021,204200,20,1,13,8,5
2021,204200,20,2,17,8,9
2021,204200,20,3,1,0,1
2021,204200,30,0,24,9,15
2021,204200,30,2,1,0,1
2021,204200,30,3,23,9,14
2021,204200,40,0,49,15,34
2021,204200,40,2,5,2,3
2021,204200,40,3,19,4,15
2021,204200,40,4,25,9,16
2021,204200,42,0,49,15,34
2021,204200,42,2,5,2,3
2021,204200,42,3,19,4,15
2021,204200,42,4,25,9,16
2021,204255,0,0,38,17,21
2021,204255,10,0,38,17,21
2021,204255,10,1,13,7,6
2021,204255,10,2,10,5,5
2021,204255,10,3,7,2,5
2021,204255,10,4,8,3,5
2021,204255,40,0,38,17,21
2021,204255,40,1,13,7,6
2021,204255,40,2,10,5,5
2021,204255,40,3,7,2,5
2021,204255,40,4,8,3,5
2021,204255,42,0,38,17,21
2021,204255,42,1,13,7,6
2021,204255,42,2,10,5,5
2021,204255,42,3,7,2,5
2021,204255,42,4,8,3,5
2021,204264,0,0,87,41,46
2021,204264,10,0,87,41,46
2021,204264,10,1,26,13,13
2021,204264,10,2,30,18,12
2021,204264,10,3,30,10,20
2021,204264,10,4,1,0,1
2021,204264,20,0,42,26,16
2021,204264,20,1,22,13,9
2021,204264,20,2,20,13,7
2021,204264,30,0,16,6,10
2021,204264,30,2,1,0,1
2021,204264,30,3,15,6,9
2021,204264,40,0,29,9,20
2021,204264,40,1,4,0,4
2021,204264,40,2,9,5,4
2021,204264,40,3,15,4,11
2021,204264,40,4,1,0,1
2021,204264,41,0,26,8,18
2021,204264,41,1,4,0,4
2021,204264,41,2,9,5,4
2021,204264,41,3,13,3,10
2021,204264,42,0,3,1,2
2021,204264,42,3,2,1,1
2021,204264,42,4,1,0,1
2021,204264,44,0,26,8,18
2021,204264,44,1,4,0,4
2021,204264,44,2,9,5,4
2021,204264,44,3,13,3,10
2021,204422,0,0,43,16,27
2021,204422,10,0,43,16,27
2021,204422,10,2,11,3,8
2021,204422,10,3,27,11,16
2021,204422,10,4,5,2,3
2021,204422,40,0,43,16,27
2021,204422,40,2,11,3,8
2021,204422,40,3,27,11,16
2021,204422,40,4,5,2,3
2021,204422,41,0,27,9,18
2021,204422,41,2,11,3,8
2021,204422,41,3,14,5,9
2021,204422,41,4,2,1,1
2021,204422,42,0,16,7,9
2021,204422,42,3,13,6,7
2021,204422,42,4,3,1,2
2021,204422,44,0,27,9,18
2021,204422,44,2,11,3,8
2021,204422,44,3,14,5,9
2021,204422,44,4,2,1,1
2021,204440,0,0,43,19,24
2021,204440,50,0,43,19,24
2021,204468,0,0,54,20,34
2021,204468,10,0,54,20,34
2021,204468,10,1,4,1,3
2021,204468,10,2,16,5,11
2021,204468,10,3,26,9,17
2021,204468,10,4,8,5,3
2021,204468,40,0,54,20,34
2021,204468,40,1,4,1,3
2021,204468,40,2,16,5,11
2021,204468,40,3,26,9,17
2021,204468,40,4,8,5,3
2021,204468,42,0,54,20,34
2021,204468,42,1,4,1,3
2021,204468,42,2,16,5,11
2021,204468,42,3,26,9,17
2021,204468,42,4,8,5,3
2021,204477,0,0,82,52,30
2021,204477,10,0,82,52,30
2021,204477,10,1,25,22,3
2021,204477,10,2,27,14,13
2021,204477,10,3,19,8,11
2021,204477,10,4,1,1,0
2021,204477,10,6,10,7,3
2021,204477,20,0,36,26,10
2021,204477,20,1,21,19,2
2021,204477,20,2,15,7,8
2021,204477,30,0,13,6,7
2021,204477,30,2,1,1,0
2021,204477,30,3,9,3,6
2021,204477,30,6,3,2,1
2021,204477,40,0,33,20,13
2021,204477,40,1,4,3,1
2021,204477,40,2,11,6,5
2021,204477,40,3,10,5,5
2021,204477,40,4,1,1,0
2021,204477,40,6,7,5,2
2021,204477,41,0,2,1,1
2021,204477,41,3,2,1,1
2021,204477,42,0,31,19,12
2021,204477,42,1,4,3,1
2021,204477,42,2,11,6,5
2021,204477,42,3,8,4,4
2021,204477,42,4,1,1,0
2021,204477,42,6,7,5,2
2021,204477,44,0,2,1,1
2021,204477,44,3,2,1,1
2021,204486,0,0,93,76,17
2021,204486,10,0,93,76,17
2021,204486,10,1,9,4,5
2021,204486,10,2,3,2,1
2021,204486,10,3,12,6,6
2021,204486,10,4,69,64,5
2021,204486,40,0,93,76,17
2021,204486,40,1,9,4,5
2021,204486,40,2,3,2,1
2021,204486,40,3,12,6,6
2021,204486,40,4,69,64,5
2021,204486,41,0,93,76,17
2021,204486,41,1,9,4,5
2021,204486,41,2,3,2,1
2021,204486,41,3,12,6,6
2021,204486,41,4,69,64,5
2021,204486,45,0,93,76,17
2021,204486,45,1,9,4,5
2021,204486,45,2,3,2,1
2021,204486,45,3,12,6,6
2021,204486,45,4,69,64,5
2021,204501,0,0,308,166,142
2021,204501,10,0,308,166,142
2021,204501,10,1,100,62,38
2021,204501,10,2,84,43,41
2021,204501,10,3,93,44,49
2021,204501,10,4,4,1,3
2021,204501,10,5,3,1,2
2021,204501,10,6,24,15,9
2021,204501,20,0,177,99,78
2021,204501,20,1,98,60,38
2021,204501,20,2,79,39,40
2021,204501,30,0,47,23,24
2021,204501,30,1,1,1,0
2021,204501,30,2,2,2,0
2021,204501,30,3,44,20,24
2021,204501,40,0,84,44,40
2021,204501,40,1,1,1,0
2021,204501,40,2,3,2,1
2021,204501,40,3,49,24,25
2021,204501,40,4,4,1,3
2021,204501,40,5,3,1,2
2021,204501,40,6,24,15,9
2021,204501,41,0,34,19,15
2021,204501,41,1,1,1,0
2021,204501,41,2,1,1,0
2021,204501,41,3,20,12,8
2021,204501,41,4,2,0,2
2021,204501,41,5,1,0,1
2021,204501,41,6,9,5,4
2021,204501,42,0,31,14,17
2021,204501,42,3,20,8,12
2021,204501,42,5,2,1,1
2021,204501,42,6,9,5,4
2021,204501,43,0,19,11,8
2021,204501,43,2,2,1,1
2021,204501,43,3,9,4,5
2021,204501,43,4,2,1,1
2021,204501,43,6,6,5,1
2021,204501,44,0,23,12,11
2021,204501,44,2,1,1,0
2021,204501,44,3,15,8,7
2021,204501,44,4,1,0,1
2021,204501,44,6,6,3,3
2021,204501,45,0,11,7,4
2021,204501,45,1,1,1,0
2021,204501,45,3,5,4,1
2021,204501,45,4,1,0,1
2021,204501,45,5,1,0,1
2021,204501,45,6,3,2,1
2021,204608,0,0,36,34,2
2021,204608,50,0,36,34,2
2021,204617,0,0,60,34,26
2021,204617,10,0,60,34,26
2021,204617,10,1,9,5,4
2021,204617,10,2,21,12,9
2021,204617,10,3,25,13,12
2021,204617,10,4,2,2,0
2021,204617,10,5,3,2,1
2021,204617,20,0,30,17,13
2021,204617,20,1,8,4,4
2021,204617,20,2,20,12,8
2021,204617,20,3,2,1,1
2021,204617,30,0,13,5,8
2021,204617,30,2,1,0,1
2021,204617,30,3,12,5,7
2021,204617,40,0,17,12,5
2021,204617,40,1,1,1,0
2021,204617,40,3,11,7,4
2021,204617,40,4,2,2,0
2021,204617,40,5,3,2,1
2021,204617,41,0,9,5,4
2021,204617,41,3,9,5,4
2021,204617,42,0,8,7,1
2021,204617,42,1,1,1,0
2021,204617,42,3,2,2,0
2021,204617,42,4,2,2,0
2021,204617,42,5,3,2,1
2021,204617,44,0,9,5,4
2021,204617,44,3,9,5,4
2021,204635,0,0,205,130,75
2021,204635,10,0,205,130,75
2021,204635,10,1,63,51,12
2021,204635,10,2,69,40,29
2021,204635,10,3,63,34,29
2021,204635,10,4,10,5,5
2021,204635,20,0,136,92,44
2021,204635,20,1,62,50,12
2021,204635,20,2,67,38,29
2021,204635,20,3,7,4,3
2021,204635,30,0,42,21,21
2021,204635,30,2,1,1,0
2021,204635,30,3,41,20,21
2021,204635,40,0,27,17,10
2021,204635,40,1,1,1,0
2021,204635,40,2,1,1,0
2021,204635,40,3,15,10,5
2021,204635,40,4,10,5,5
2021,204635,41,0,6,5,1
2021,204635,41,2,1,1,0
2021,204635,41,3,3,3,0
2021,204635,41,4,2,1,1
2021,204635,42,0,21,12,9
2021,204635,42,1,1,1,0
2021,204635,42,3,12,7,5
2021,204635,42,4,8,4,4
2021,204635,44,0,6,5,1
2021,204635,44,2,1,1,0
2021,204635,44,3,3,3,0
2021,204635,44,4,2,1,1
2021,204662,0,0,23,15,8
2021,204662,10,0,23,15,8
2021,204662,10,1,2,1,1
2021,204662,10,2,14,9,5
2021,204662,10,3,7,5,2
2021,204662,20,0,17,11,6
2021,204662,20,1,2,1,1
2021,204662,20,2,14,9,5
2021,204662,20,3,1,1,0
2021,204662,30,0,5,3,2
2021,204662,30,3,5,3,2
2021,204662,40,0,1,1,0
2021,204662,40,3,1,1,0
2021,204662,41,0,1,1,0
2021,204662,41,3,1,1,0
2021,204662,44,0,1,1,0
2021,204662,44,3,1,1,0
2021,204671,0,0,27,16,11
2021,204671,10,0,27,16,11
2021,204671,10,1,10,6,4
2021,204671,10,2,15,9,6
2021,204671,10,3,2,1,1
2021,204671,20,0,25,15,10
2021,204671,20,1,10,6,4
2021,204671,20,2,15,9,6
2021,204671,30,0,2,1,1
2021,204671,30,3,2,1,1
2021,204680,0,0,32,18,14
2021,204680,10,0,32,18,14
2021,204680,10,1,7,6,1
2021,204680,10,2,23,11,12
2021,204680,10,3,2,1,1
2021,204680,20,0,30,17,13
2021,204680,20,1,7,6,1
2021,204680,20,2,23,11,12
2021,204680,30,0,2,1,1
2021,204680,30,3,2,1,1
2021,204699,0,0,37,17,20
2021,204699,10,0,37,17,20
2021,204699,10,1,9,6,3
2021,204699,10,2,16,6,10
2021,204699,10,3,12,5,7
2021,204699,20,0,25,12,13
2021,204699,20,1,9,6,3
2021,204699,20,2,16,6,10
2021,204699,30,0,10,4,6
2021,204699,30,3,10,4,6
2021,204699,40,0,2,1,1
2021,204699,40,3,2,1,1
2021,204699,41,0,2,1,1
2021,204699,41,3,2,1,1
2021,204699,44,0,2,1,1
2021,204699,44,3,2,1,1
2021,204705,0,0,48,28,20
2021,204705,10,0,48,28,20
2021,204705,10,1,8,5,3
2021,204705,10,2,31,20,11
2021,204705,10,3,9,3,6
2021,204705,20,0,39,25,14
2021,204705,20,1,8,5,3
2021,204705,20,2,31,20,11
2021,204705,30,0,8,2,6
2021,204705,30,3,8,2,6
2021,204705,40,0,1,1,0
2021,204705,40,3,1,1,0
2021,204705,41,0,1,1,0
2021,204705,41,3,1,1,0
2021,204705,44,0,1,1,0
2021,204705,44,3,1,1,0
2021,204796,0,0,4654,2543,2111
2021,204796,10,0,4622,2528,2094
2021,204796,10,1,1370,926,444
2021,204796,10,2,1286,712,574
2021,204796,10,3,1959,887,1072
2021,204796,10,4,7,3,4
2021,204796,20,0,1854,1193,661
2021,204796,20,1,1086,758,328
2021,204796,20,2,756,430,326
2021,204796,20,3,12,5,7
2021,204796,30,0,606,320,286
2021,204796,30,1,6,5,1
2021,204796,30,2,34,26,8
2021,204796,30,3,563,289,274
2021,204796,30,4,3,0,3
2021,204796,40,0,2162,1015,1147
2021,204796,40,1,278,163,115
2021,204796,40,2,496,256,240
2021,204796,40,3,1384,593,791
2021,204796,40,4,4,3,1
2021,204796,41,0,2162,1015,1147
2021,204796,41,1,278,163,115
2021,204796,41,2,496,256,240
2021,204796,41,3,1384,593,791
2021,204796,41,4,4,3,1
2021,204796,44,0,2162,1015,1147
2021,204796,44,1,278,163,115
2021,204796,44,2,496,256,240
2021,204796,44,3,1384,593,791
2021,204796,44,4,4,3,1
2021,204796,50,0,32,15,17
2021,204802,0,0,19,10,9
2021,204802,10,0,19,10,9
2021,204802,10,2,13,7,6
2021,204802,10,3,2,0,2
2021,204802,10,5,4,3,1
2021,204802,20,0,13,7,6
2021,204802,20,2,13,7,6
2021,204802,30,0,2,0,2
2021,204802,30,3,2,0,2
2021,204802,40,0,4,3,1
2021,204802,40,5,4,3,1
2021,204802,42,0,4,3,1
2021,204802,42,5,4,3,1
2021,204820,0,0,37,15,22
2021,204820,10,0,37,15,22
2021,204820,10,2,13,9,4
2021,204820,10,3,3,1,2
2021,204820,10,5,21,5,16
2021,204820,20,0,11,7,4
2021,204820,20,2,11,7,4
2021,204820,30,0,5,3,2
2021,204820,30,2,2,2,0
2021,204820,30,3,3,1,2
2021,204820,40,0,21,5,16
2021,204820,40,5,21,5,16
2021,204820,42,0,21,5,16
2021,204820,42,5,21,5,16
2021,204839,0,0,29,6,23
2021,204839,10,0,29,6,23
2021,204839,10,1,2,0,2
2021,204839,10,2,6,0,6
2021,204839,10,3,4,1,3
2021,204839,10,5,17,5,12
2021,204839,20,0,8,0,8
2021,204839,20,1,2,0,2
2021,204839,20,2,6,0,6
2021,204839,30,0,4,1,3
2021,204839,30,3,4,1,3
2021,204839,40,0,17,5,12
2021,204839,40,5,17,5,12
2021,204839,42,0,17,5,12
2021,204839,42,5,17,5,12
2021,204848,0,0,26,15,11
2021,204848,10,0,26,15,11
2021,204848,10,1,2,1,1
2021,204848,10,2,17,11,6
2021,204848,10,3,1,1,0
2021,204848,10,5,6,2,4
2021,204848,20,0,18,12,6
2021,204848,20,1,2,1,1
2021,204848,20,2,16,11,5
2021,204848,30,0,2,1,1
2021,204848,30,2,1,0,1
2021,204848,30,3,1,1,0
2021,204848,40,0,6,2,4
2021,204848,40,5,6,2,4
2021,204848,42,0,6,2,4
2021,204848,42,5,6,2,4
2021,204857,0,0,931,522,409
2021,204857,10,0,931,522,409
2021,204857,10,1,241,165,76
2021,204857,10,2,279,182,97
2021,204857,10,3,107,56,51
2021,204857,10,5,304,119,185
2021,204857,20,0,514,343,171
2021,204857,20,1,241,165,76
2021,204857,20,2,272,177,95
2021,204857,20,3,1,1,0
2021,204857,30,0,113,60,53
2021,204857,30,2,7,5,2
2021,204857,30,3,106,55,51
2021,204857,40,0,304,119,185
2021,204857,40,5,304,119,185
2021,204857,42,0,304,119,185
2021,204857,42,5,304,119,185
2021,204866,0,0,28,11,17
2021,204866,10,0,28,11,17
2021,204866,10,1,6,5,1
2021,204866,10,2,16,5,11
2021,204866,10,3,1,1,0
2021,204866,10,5,5,0,5
2021,204866,20,0,22,10,12
2021,204866,20,1,6,5,1
2021,204866,20,2,16,5,11
2021,204866,30,0,1,1,0
2021,204866,30,3,1,1,0
2021,204866,40,0,5,0,5
2021,204866,40,5,5,0,5
2021,204866,42,0,5,0,5
2021,204866,42,5,5,0,5
2021,204884,0,0,7,0,7
2021,204884,50,0,7,0,7
2021,204909,0,0,97,54,43
2021,204909,10,0,97,54,43
2021,204909,10,1,32,24,8
2021,204909,10,2,34,17,17
2021,204909,10,3,31,13,18
2021,204909,20,0,66,41,25
2021,204909,20,1,32,24,8
2021,204909,20,2,34,17,17
2021,204909,30,0,22,9,13
2021,204909,30,3,22,9,13
2021,204909,40,0,9,4,5
2021,204909,40,3,9,4,5
2021,204909,42,0,9,4,5
2021,204909,42,3,9,4,5
2021,204936,0,0,137,64,73
2021,204936,10,0,137,64,73
2021,204936,10,1,60,30,30
2021,204936,10,2,48,18,30
2021,204936,10,3,21,9,12
2021,204936,10,4,3,3,0
2021,204936,10,5,5,4,1
2021,204936,20,0,101,45,56
2021,204936,20,1,57,28,29
2021,204936,20,2,44,17,27
2021,204936,30,0,19,8,11
2021,204936,30,2,1,1,0
2021,204936,30,3,18,7,11
2021,204936,40,0,17,11,6
2021,204936,40,1,3,2,1
2021,204936,40,2,3,0,3
2021,204936,40,3,3,2,1
2021,204936,40,4,3,3,0
2021,204936,40,5,5,4,1
2021,204936,42,0,17,11,6
2021,204936,42,1,3,2,1
2021,204936,42,2,3,0,3
2021,204936,42,3,3,2,1
2021,204936,42,4,3,3,0
2021,204936,42,5,5,4,1
2021,204945,0,0,111,55,56
2021,204945,10,0,111,55,56
2021,204945,10,1,65,28,37
2021,204945,10,2,11,8,3
2021,204945,10,3,14,8,6
2021,204945,10,4,18,11,7
2021,204945,10,6,3,0,3
2021,204945,20,0,96,48,48
2021,204945,20,1,65,28,37
2021,204945,20,2,11,8,3
2021,204945,20,3,12,7,5
2021,204945,20,4,8,5,3
2021,204945,30,0,11,6,5
2021,204945,30,3,1,0,1
2021,204945,30,4,10,6,4
2021,204945,40,0,4,1,3
2021,204945,40,3,1,1,0
2021,204945,40,6,3,0,3
2021,204945,42,0,1,1,0
2021,204945,42,3,1,1,0
2021,204945,43,0,3,0,3
2021,204945,43,6,3,0,3
2021,204990,0,0,5,3,2
2021,204990,10,0,5,3,2
2021,204990,10,1,2,1,1
2021,204990,10,2,1,1,0
2021,204990,10,3,1,1,0
2021,204990,10,5,1,0,1
2021,204990,20,0,2,1,1
2021,204990,20,1,2,1,1
2021,204990,40,0,3,2,1
2021,204990,40,2,1,1,0
2021,204990,40,3,1,1,0
2021,204990,40,5,1,0,1
2021,204990,41,0,3,2,1
2021,204990,41,2,1,1,0
2021,204990,41,3,1,1,0
2021,204990,41,5,1,0,1
2021,204990,44,0,1,0,1
2021,204990,44,5,1,0,1
2021,204990,45,0,2,2,0
2021,204990,45,2,1,1,0
2021,204990,45,3,1,1,0
2021,205027,0,0,15,12,3
2021,205027,10,0,15,12,3
2021,205027,10,1,2,2,0
2021,205027,10,2,5,5,0
2021,205027,10,3,7,5,2
2021,205027,10,4,1,0,1
2021,205027,40,0,15,12,3
2021,205027,40,1,2,2,0
2021,205027,40,2,5,5,0
2021,205027,40,3,7,5,2
2021,205027,40,4,1,0,1
2021,205027,41,0,15,12,3
2021,205027,41,1,2,2,0
2021,205027,41,2,5,5,0
2021,205027,41,3,7,5,2
2021,205027,41,4,1,0,1
2021,205027,44,0,15,12,3
2021,205027,44,1,2,2,0
2021,205027,44,2,5,5,0
2021,205027,44,3,7,5,2
2021,205027,44,4,1,0,1
2021,205054,0,0,13,2,11
2021,205054,10,0,13,2,11
2021,205054,10,4,13,2,11
2021,205054,40,0,13,2,11
2021,205054,40,4,13,2,11
2021,205054,41,0,13,2,11
2021,205054,41,4,13,2,11
2021,205054,45,0,13,2,11
2021,205054,45,4,13,2,11
2021,205179,0,0,36,7,29
2021,205179,10,0,36,7,29
2021,205179,10,4,36,7,29
2021,205179,40,0,36,7,29
2021,205179,40,4,36,7,29
2021,205179,41,0,36,7,29
2021,205179,41,4,36,7,29
2021,205179,45,0,36,7,29
2021,205179,45,4,36,7,29
2021,205203,0,0,56,26,30
2021,205203,10,0,56,26,30
2021,205203,10,1,13,7,6
2021,205203,10,2,4,2,2
2021,205203,10,3,27,10,17
2021,205203,10,4,12,7,5
2021,205203,20,0,20,10,10
2021,205203,20,1,11,6,5
2021,205203,20,2,4,2,2
2021,205203,20,3,5,2,3
2021,205203,30,0,17,4,13
2021,205203,30,3,17,4,13
2021,205203,40,0,19,12,7
2021,205203,40,1,2,1,1
2021,205203,40,3,5,4,1
2021,205203,40,4,12,7,5
2021,205203,42,0,19,12,7
2021,205203,42,1,2,1,1
2021,205203,42,3,5,4,1
2021,205203,42,4,12,7,5
2021,205391,0,0,10,5,5
2021,205391,10,0,10,5,5
2021,205391,10,4,10,5,5
2021,205391,40,0,10,5,5
2021,205391,40,4,10,5,5
2021,205391,42,0,10,5,5
2021,205391,42,4,10,5,5
2021,205443,0,0,124,65,59
2021,205443,10,0,124,65,59
2021,205443,10,1,34,26,8
2021,205443,10,2,53,26,27
2021,205443,10,3,30,11,19
2021,205443,10,4,7,2,5
2021,205443,20,0,58,40,18
2021,205443,20,1,34,26,8
2021,205443,20,2,24,14,10
2021,205443,30,0,54,22,32
2021,205443,30,2,29,12,17
2021,205443,30,3,25,10,15
2021,205443,40,0,12,3,9
2021,205443,40,3,5,1,4
2021,205443,40,4,7,2,5
2021,205443,41,0,5,0,5
2021,205443,41,3,3,0,3
2021,205443,41,4,2,0,2
2021,205443,42,0,6,2,4
2021,205443,42,3,2,1,1
2021,205443,42,4,4,1,3
2021,205443,43,0,1,1,0
2021,205443,43,4,1,1,0
2021,205443,44,0,5,0,5
2021,205443,44,3,3,0,3
2021,205443,44,4,2,0,2
2021,205470,0,0,311,125,186
2021,205470,10,0,311,125,186
2021,205470,10,1,152,67,85
2021,205470,10,2,78,25,53
2021,205470,10,3,35,14,21
2021,205470,10,4,44,19,25
2021,205470,10,6,2,0,2
2021,205470,20,0,155,67,88
2021,205470,20,1,147,65,82
2021,205470,20,2,8,2,6
2021,205470,30,0,118,43,75
2021,205470,30,1,5,2,3
2021,205470,30,2,70,23,47
2021,205470,30,3,35,14,21
2021,205470,30,4,8,4,4
2021,205470,40,0,38,15,23
2021,205470,40,4,36,15,21
2021,205470,40,6,2,0,2
2021,205470,41,0,2,0,2
2021,205470,41,6,2,0,2
2021,205470,42,0,36,15,21
2021,205470,42,4,36,15,21
2021,205470,44,0,2,0,2
2021,205470,44,6,2,0,2
2021,205841,0,0,169,72,97
2021,205841,10,0,169,72,97
2021,205841,10,1,5,3,2
2021,205841,10,2,58,25,33
2021,205841,10,3,50,19,31
2021,205841,10,4,49,23,26
2021,205841,10,5,7,2,5
2021,205841,40,0,169,72,97
2021,205841,40,1,5,3,2
2021,205841,40,2,58,25,33
2021,205841,40,3,50,19,31
2021,205841,40,4,49,23,26
2021,205841,40,5,7,2,5
2021,205841,42,0,155,66,89
2021,205841,42,1,5,3,2
2021,205841,42,2,58,25,33
2021,205841,42,3,50,19,31
2021,205841,42,4,42,19,23
2021,205841,43,0,14,6,8
2021,205841,43,4,7,4,3
2021,205841,43,5,7,2,5
2021,205887,0,0,19,1,18
2021,205887,10,0,19,1,18
2021,205887,10,6,19,1,18
2021,205887,40,0,19,1,18
2021,205887,40,6,19,1,18
2021,205887,41,0,19,1,18
2021,205887,41,6,19,1,18
2021,205887,45,0,19,1,18
2021,205887,45,6,19,1,18
2021,205957,0,0,127,94,33
2021,205957,10,0,127,94,33
2021,205957,10,1,61,49,12
2021,205957,10,2,31,22,9
2021,205957,10,3,29,21,8
2021,205957,10,4,6,2,4
2021,205957,20,0,83,65,18
2021,205957,20,1,54,44,10
2021,205957,20,2,26,18,8
2021,205957,20,3,3,3,0
2021,205957,30,0,20,13,7
2021,205957,30,1,4,3,1
2021,205957,30,2,1,1,0
2021,205957,30,3,15,9,6
2021,205957,40,0,24,16,8
2021,205957,40,1,3,2,1
2021,205957,40,2,4,3,1
2021,205957,40,3,11,9,2
2021,205957,40,4,6,2,4
2021,205957,42,0,24,16,8
2021,205957,42,1,3,2,1
2021,205957,42,2,4,3,1
2021,205957,42,3,11,9,2
2021,205957,42,4,6,2,4
2021,205966,0,0,43,26,17
2021,205966,10,0,38,21,17
2021,205966,10,1,2,1,1
2021,205966,10,2,17,10,7
2021,205966,10,3,14,7,7
2021,205966,10,4,5,3,2
2021,205966,40,0,38,21,17
2021,205966,40,1,2,1,1
2021,205966,40,2,17,10,7
2021,205966,40,3,14,7,7
2021,205966,40,4,5,3,2
2021,205966,43,0,38,21,17
2021,205966,43,1,2,1,1
2021,205966,43,2,17,10,7
2021,205966,43,3,14,7,7
2021,205966,43,4,5,3,2
2021,205966,50,0,5,5,0
2021,206011,0,0,32,16,16
2021,206011,10,0,31,16,15
2021,206011,10,1,6,2,4
2021,206011,10,2,12,7,5
2021,206011,10,3,9,5,4
2021,206011,10,4,4,2,2
2021,206011,20,0,20,12,8
2021,206011,20,1,6,2,4
2021,206011,20,2,11,7,4
2021,206011,20,3,3,3,0
2021,206011,30,0,11,4,7
2021,206011,30,2,1,0,1
2021,206011,30,3,6,2,4
2021,206011,30,4,4,2,2
2021,206011,50,0,1,0,1
2021,206048,0,0,68,41,27
2021,206048,10,0,68,41,27
2021,206048,10,1,14,8,6
2021,206048,10,2,20,11,9
2021,206048,10,3,27,17,10
2021,206048,10,4,7,5,2
2021,206048,40,0,68,41,27
2021,206048,40,1,14,8,6
2021,206048,40,2,20,11,9
2021,206048,40,3,27,17,10
2021,206048,40,4,7,5,2
2021,206048,41,0,54,30,24
2021,206048,41,1,14,8,6
2021,206048,41,2,16,8,8
2021,206048,41,3,24,14,10
2021,206048,42,0,14,11,3
2021,206048,42,2,4,3,1
2021,206048,42,3,3,3,0
2021,206048,42,4,7,5,2
2021,206048,44,0,54,30,24
2021,206048,44,1,14,8,6
2021,206048,44,2,16,8,8
2021,206048,44,3,24,14,10
2021,206084,0,0,708,390,318
2021,206084,10,0,708,390,318
2021,206084,10,1,212,147,65
2021,206084,10,2,174,105,69
2021,206084,10,3,127,60,67
2021,206084,10,4,23,8,15
2021,206084,10,5,147,54,93
2021,206084,10,6,25,16,9
2021,206084,20,0,356,234,122
2021,206084,20,1,206,141,65
2021,206084,20,2,143,88,55
2021,206084,20,3,4,3,1
2021,206084,20,4,1,0,1
2021,206084,20,6,2,2,0
2021,206084,30,0,144,72,72
2021,206084,30,1,2,2,0
2021,206084,30,2,24,12,12
2021,206084,30,3,116,57,59
2021,206084,30,4,2,1,1
2021,206084,40,0,208,84,124
2021,206084,40,1,4,4,0
2021,206084,40,2,7,5,2
2021,206084,40,3,7,0,7
2021,206084,40,4,20,7,13
2021,206084,40,5,147,54,93
2021,206084,40,6,23,14,9
2021,206084,42,0,35,15,20
2021,206084,42,1,4,4,0
2021,206084,42,2,2,2,0
2021,206084,42,3,5,0,5
2021,206084,42,4,10,4,6
2021,206084,42,5,12,5,7
2021,206084,42,6,2,0,2
2021,206084,43,0,173,69,104
2021,206084,43,2,5,3,2
2021,206084,43,3,2,0,2
2021,206084,43,4,10,3,7
2021,206084,43,5,135,49,86
2021,206084,43,6,21,14,7
2021,206279,0,0,17,7,10
2021,206279,10,0,17,7,10
2021,206279,10,6,17,7,10
2021,206279,40,0,17,7,10
2021,206279,40,6,17,7,10
2021,206279,42,0,17,7,10
2021,206279,42,6,17,7,10
2021,206288,0,0,12,7,5
2021,206288,10,0,12,7,5
2021,206288,10,1,9,5,4
2021,206288,10,2,1,1,0
2021,206288,10,3,1,0,1
2021,206288,10,4,1,1,0
2021,206288,20,0,10,6,4
2021,206288,20,1,9,5,4
2021,206288,20,2,1,1,0
2021,206288,40,0,2,1,1
2021,206288,40,3,1,0,1
2021,206288,40,4,1,1,0
2021,206288,41,0,2,1,1
2021,206288,41,3,1,0,1
2021,206288,41,4,1,1,0
2021,206288,44,0,1,1,0
2021,206288,44,4,1,1,0
2021,206288,45,0,1,0,1
2021,206288,45,3,1,0,1
2021,206349,0,0,65,14,51
2021,206349,10,0,65,14,51
2021,206349,10,1,10,4,6
2021,206349,10,2,12,4,8
2021,206349,10,3,27,6,21
2021,206349,10,4,16,0,16
2021,206349,20,0,17,5,12
2021,206349,20,1,10,4,6
2021,206349,20,2,7,1,6
2021,206349,30,0,10,5,5
2021,206349,30,2,2,1,1
2021,206349,30,3,8,4,4
2021,206349,40,0,38,4,34
2021,206349,40,2,3,2,1
2021,206349,40,3,19,2,17
2021,206349,40,4,16,0,16
2021,206349,42,0,38,4,34
2021,206349,42,2,3,2,1
2021,206349,42,3,19,2,17
2021,206349,42,4,16,0,16
2021,206437,0,0,96,42,54
2021,206437,10,0,96,42,54
2021,206437,10,1,25,12,13
2021,206437,10,2,28,14,14
2021,206437,10,3,39,13,26
2021,206437,10,4,4,3,1
2021,206437,20,0,44,24,20
2021,206437,20,1,24,11,13
2021,206437,20,2,20,13,7
2021,206437,30,0,19,10,9
2021,206437,30,2,1,1,0
2021,206437,30,3,18,9,9
2021,206437,40,0,33,8,25
2021,206437,40,1,1,1,0
2021,206437,40,2,7,0,7
2021,206437,40,3,21,4,17
2021,206437,40,4,4,3,1
2021,206437,42,0,33,8,25
2021,206437,42,1,1,1,0
2021,206437,42,2,7,0,7
2021,206437,42,3,21,4,17
2021,206437,42,4,4,3,1
2021,206446,0,0,46,14,32
2021,206446,10,0,46,14,32
2021,206446,10,1,11,3,8
2021,206446,10,2,11,2,9
2021,206446,10,3,12,3,9
2021,206446,10,4,11,6,5
2021,206446,10,5,1,0,1
2021,206446,40,0,46,14,32
2021,206446,40,1,11,3,8
2021,206446,40,2,11,2,9
2021,206446,40,3,12,3,9
2021,206446,40,4,11,6,5
2021,206446,40,5,1,0,1
2021,206446,42,0,46,14,32
2021,206446,42,1,11,3,8
2021,206446,42,2,11,2,9
2021,206446,42,3,12,3,9
2021,206446,42,4,11,6,5
2021,206446,42,5,1,0,1
2021,206491,0,0,14,11,3
2021,206491,10,0,13,10,3
2021,206491,10,1,2,2,0
2021,206491,10,2,6,4,2
2021,206491,10,3,4,3,1
2021,206491,10,4,1,1,0
2021,206491,20,0,6,5,1
2021,206491,20,1,2,2,0
2021,206491,20,2,4,3,1
2021,206491,30,0,4,2,2
2021,206491,30,2,1,0,1
2021,206491,30,3,3,2,1
2021,206491,40,0,3,3,0
2021,206491,40,2,1,1,0
2021,206491,40,3,1,1,0
2021,206491,40,4,1,1,0
2021,206491,42,0,3,3,0
2021,206491,42,2,1,1,0
2021,206491,42,3,1,1,0
2021,206491,42,4,1,1,0
2021,206491,50,0,1,1,0
2021,206507,0,0,60,27,33
2021,206507,10,0,60,27,33
2021,206507,10,1,18,10,8
2021,206507,10,2,11,2,9
2021,206507,10,3,31,15,16
2021,206507,20,0,26,11,15
2021,206507,20,1,18,10,8
2021,206507,20,2,8,1,7
2021,206507,30,0,19,10,9
2021,206507,30,3,19,10,9
2021,206507,40,0,15,6,9
2021,206507,40,2,3,1,2
2021,206507,40,3,12,5,7
2021,206507,42,0,15,6,9
2021,206507,42,2,3,1,2
2021,206507,42,3,12,5,7
2021,206525,0,0,95,46,49
2021,206525,10,0,95,46,49
2021,206525,10,1,37,21,16
2021,206525,10,2,28,11,17
2021,206525,10,3,30,14,16
2021,206525,20,0,63,31,32
2021,206525,20,1,35,21,14
2021,206525,20,2,27,10,17
2021,206525,20,3,1,0,1
2021,206525,30,0,18,11,7
2021,206525,30,2,1,1,0
2021,206525,30,3,17,10,7
2021,206525,40,0,14,4,10
2021,206525,40,1,2,0,2
2021,206525,40,3,12,4,8
2021,206525,41,0,8,1,7
2021,206525,41,1,2,0,2
2021,206525,41,3,6,1,5
2021,206525,42,0,6,3,3
2021,206525,42,3,6,3,3
2021,206525,44,0,8,1,7
2021,206525,44,1,2,0,2
2021,206525,44,3,6,1,5
2021,206589,0,0,176,83,93
2021,206589,10,0,176,83,93
2021,206589,10,1,52,30,22
2021,206589,10,2,48,21,27
2021,206589,10,3,71,31,40
2021,206589,10,4,5,1,4
2021,206589,20,0,100,51,49
2021,206589,20,1,52,30,22
2021,206589,20,2,48,21,27
2021,206589,30,0,37,14,23
2021,206589,30,3,37,14,23
2021,206589,40,0,39,18,21
2021,206589,40,3,34,17,17
2021,206589,40,4,5,1,4
2021,206589,41,0,6,3,3
2021,206589,41,3,4,3,1
2021,206589,41,4,2,0,2
2021,206589,42,0,32,15,17
2021,206589,42,3,29,14,15
2021,206589,42,4,3,1,2
2021,206589,43,0,1,0,1
2021,206589,43,3,1,0,1
2021,206589,44,0,6,3,3
2021,206589,44,3,4,3,1
2021,206589,44,4,2,0,2
2021,206604,0,0,569,312,257
2021,206604,10,0,569,312,257
2021,206604,10,1,177,120,57
2021,206604,10,2,174,91,83
2021,206604,10,3,77,38,39
2021,206604,10,4,30,16,14
2021,206604,10,5,106,44,62
2021,206604,10,6,5,3,2
2021,206604,20,0,293,179,114
2021,206604,20,1,154,104,50
2021,206604,20,2,139,75,64
2021,206604,30,0,29,19,10
2021,206604,30,2,5,3,2
2021,206604,30,3,24,16,8
2021,206604,40,0,247,114,133
2021,206604,40,1,23,16,7
2021,206604,40,2,30,13,17
2021,206604,40,3,53,22,31
2021,206604,40,4,30,16,14
2021,206604,40,5,106,44,62
2021,206604,40,6,5,3,2
2021,206604,41,0,209,95,114
2021,206604,41,1,22,16,6
2021,206604,41,2,29,13,16
2021,206604,41,3,47,19,28
2021,206604,41,5,106,44,62
2021,206604,41,6,5,3,2
2021,206604,42,0,32,16,16
2021,206604,42,2,1,0,1
2021,206604,42,3,1,0,1
2021,206604,42,4,30,16,14
2021,206604,43,0,6,3,3
2021,206604,43,1,1,0,1
2021,206604,43,3,5,3,2
2021,206604,44,0,110,58,52
2021,206604,44,1,18,14,4
2021,206604,44,2,21,11,10
2021,206604,44,3,42,17,25
2021,206604,44,5,24,13,11
2021,206604,44,6,5,3,2
2021,206604,45,0,99,37,62
2021,206604,45,1,4,2,2
2021,206604,45,2,8,2,6
2021,206604,45,3,5,2,3
2021,206604,45,5,82,31,51
2021,206622,0,0,402,176,226
2021,206622,10,0,402,176,226
2021,206622,10,1,76,46,30
2021,206622,10,2,114,59,55
2021,206622,10,3,65,27,38
2021,206622,10,4,119,31,88
2021,206622,10,5,28,13,15
2021,206622,20,0,187,102,85
2021,206622,20,1,76,46,30
2021,206622,20,2,111,56,55
2021,206622,30,0,68,30,38
2021,206622,30,2,3,3,0
2021,206622,30,3,65,27,38
2021,206622,40,0,147,44,103
2021,206622,40,4,119,31,88
2021,206622,40,5,28,13,15
2021,206622,42,0,140,41,99
2021,206622,42,4,116,29,87
2021,206622,42,5,24,12,12
2021,206622,43,0,7,3,4
2021,206622,43,4,3,2,1
2021,206622,43,5,4,1,3
2021,206695,0,0,365,196,169
2021,206695,10,0,365,196,169
2021,206695,10,1,128,83,45
2021,206695,10,2,98,55,43
2021,206695,10,3,63,29,34
2021,206695,10,5,76,29,47
2021,206695,20,0,232,140,92
2021,206695,20,1,128,83,45
2021,206695,20,2,97,54,43
2021,206695,20,3,7,3,4
2021,206695,30,0,53,24,29
2021,206695,30,2,1,1,0
2021,206695,30,3,49,23,26
2021,206695,30,5,3,0,3
2021,206695,40,0,80,32,48
2021,206695,40,3,7,3,4
2021,206695,40,5,73,29,44
2021,206695,41,0,16,3,13
2021,206695,41,3,3,1,2
2021,206695,41,5,13,2,11
2021,206695,42,0,64,29,35
2021,206695,42,3,4,2,2
2021,206695,42,5,60,27,33
2021,206695,44,0,16,3,13
2021,206695,44,3,3,1,2
2021,206695,44,5,13,2,11
2021,206817,0,0,14,6,8
2021,206817,10,0,14,6,8
2021,206817,10,1,1,0,1
2021,206817,10,2,2,2,0
2021,206817,10,3,11,4,7
2021,206817,40,0,14,6,8
2021,206817,40,1,1,0,1
2021,206817,40,2,2,2,0
2021,206817,40,3,11,4,7
2021,206817,42,0,14,6,8
2021,206817,42,1,1,0,1
2021,206817,42,2,2,2,0
2021,206817,42,3,11,4,7
2021,206835,0,0,30,16,14
2021,206835,10,0,30,16,14
2021,206835,10,1,3,2,1
2021,206835,10,2,3,2,1
2021,206835,10,3,20,11,9
2021,206835,10,4,4,1,3
2021,206835,40,0,30,16,14
2021,206835,40,1,3,2,1
2021,206835,40,2,3,2,1
2021,206835,40,3,20,11,9
2021,206835,40,4,4,1,3
2021,206835,42,0,30,16,14
2021,206835,42,1,3,2,1
2021,206835,42,2,3,2,1
2021,206835,42,3,20,11,9
2021,206835,42,4,4,1,3
2021,206862,0,0,71,34,37
2021,206862,10,0,71,34,37
2021,206862,10,1,25,10,15
2021,206862,10,2,18,11,7
2021,206862,10,3,28,13,15
2021,206862,40,0,71,34,37
2021,206862,40,1,25,10,15
2021,206862,40,2,18,11,7
2021,206862,40,3,28,13,15
2021,206862,41,0,36,18,18
2021,206862,41,1,23,9,14
2021,206862,41,2,11,8,3
2021,206862,41,3,2,1,1
2021,206862,42,0,35,16,19
2021,206862,42,1,2,1,1
2021,206862,42,2,7,3,4
2021,206862,42,3,26,12,14
2021,206862,44,0,36,18,18
2021,206862,44,1,23,9,14
2021,206862,44,2,11,8,3
2021,206862,44,3,2,1,1
2021,206914,0,0,119,70,49
2021,206914,10,0,119,70,49
2021,206914,10,1,31,22,9
2021,206914,10,2,24,14,10
2021,206914,10,3,33,19,14
2021,206914,10,4,31,15,16
2021,206914,20,0,58,37,21
2021,206914,20,1,31,22,9
2021,206914,20,2,24,14,10
2021,206914,20,3,3,1,2
2021,206914,30,0,30,18,12
2021,206914,30,3,30,18,12
2021,206914,40,0,31,15,16
2021,206914,40,4,31,15,16
2021,206914,42,0,31,15,16
2021,206914,42,4,31,15,16
2021,206923,0,0,43,13,30
2021,206923,10,0,43,13,30
2021,206923,10,4,43,13,30
2021,206923,40,0,43,13,30
2021,206923,40,4,43,13,30
2021,206923,41,0,43,13,30
2021,206923,41,4,43,13,30
2021,206923,45,0,43,13,30
2021,206923,45,4,43,13,30
2021,206932,0,0,18,4,14
2021,206932,10,0,18,4,14
2021,206932,10,4,18,4,14
2021,206932,40,0,18,4,14
2021,206932,40,4,18,4,14
2021,206932,41,0,18,4,14
2021,206932,41,4,18,4,14
2021,206932,45,0,18,4,14
2021,206932,45,4,18,4,14
2021,206941,0,0,527,240,287
2021,206941,10,0,527,240,287
2021,206941,10,1,185,98,87
2021,206941,10,2,97,41,56
2021,206941,10,3,117,49,68
2021,206941,10,4,35,16,19
2021,206941,10,5,93,36,57
2021,206941,20,0,286,135,151
2021,206941,20,1,185,98,87
2021,206941,20,2,88,35,53
2021,206941,20,3,13,2,11
2021,206941,30,0,115,49,66
2021,206941,30,2,9,6,3
2021,206941,30,3,90,39,51
2021,206941,30,4,16,4,12
2021,206941,40,0,126,56,70
2021,206941,40,3,14,8,6
2021,206941,40,4,19,12,7
2021,206941,40,5,93,36,57
2021,206941,42,0,126,56,70
2021,206941,42,3,14,8,6
2021,206941,42,4,19,12,7
2021,206941,42,5,93,36,57
2021,206996,0,0,43,17,26
2021,206996,10,0,43,17,26
2021,206996,10,6,43,17,26
2021,206996,40,0,43,17,26
2021,206996,40,6,43,17,26
2021,206996,42,0,43,17,26
2021,206996,42,6,43,17,26
2021,207041,0,0,141,69,72
2021,207041,10,0,141,69,72
2021,207041,10,1,21,15,6
2021,207041,10,2,15,10,5
2021,207041,10,3,62,33,29
2021,207041,10,4,39,11,28
2021,207041,10,5,4,0,4
2021,207041,20,0,38,27,11
2021,207041,20,1,21,15,6
2021,207041,20,2,15,10,5
2021,207041,20,3,2,2,0
2021,207041,30,0,47,22,25
2021,207041,30,3,47,22,25
2021,207041,40,0,56,20,36
2021,207041,40,3,13,9,4
2021,207041,40,4,39,11,28
2021,207041,40,5,4,0,4
2021,207041,42,0,56,20,36
2021,207041,42,3,13,9,4
2021,207041,42,4,39,11,28
2021,207041,42,5,4,0,4
2021,207050,0,0,35,17,18
2021,207050,10,0,35,17,18
2021,207050,10,1,17,9,8
2021,207050,10,4,18,8,10
2021,207050,20,0,17,9,8
2021,207050,20,1,17,9,8
2021,207050,30,0,15,6,9
2021,207050,30,4,15,6,9
2021,207050,40,0,3,2,1
2021,207050,40,4,3,2,1
2021,207050,42,0,3,2,1
2021,207050,42,4,3,2,1
2021,207069,0,0,29,10,19
2021,207069,10,0,29,10,19
2021,207069,10,1,28,10,18
2021,207069,10,4,1,0,1
2021,207069,20,0,8,2,6
2021,207069,20,1,8,2,6
2021,207069,30,0,15,3,12
2021,207069,30,1,14,3,11
2021,207069,30,4,1,0,1
2021,207069,40,0,6,5,1
2021,207069,40,1,6,5,1
2021,207069,42,0,6,5,1
2021,207069,42,1,6,5,1
2021,207157,0,0,13,9,4
2021,207157,10,0,13,9,4
2021,207157,10,6,13,9,4
2021,207157,40,0,13,9,4
2021,207157,40,6,13,9,4
2021,207157,42,0,13,9,4
2021,207157,42,6,13,9,4
2021,207209,0,0,103,56,47
2021,207209,10,0,103,56,47
2021,207209,10,1,2,1,1
2021,207209,10,2,26,19,7
2021,207209,10,3,44,23,21
2021,207209,10,4,31,13,18
2021,207209,20,0,18,12,6
2021,207209,20,1,2,1,1
2021,207209,20,2,15,10,5
2021,207209,20,3,1,1,0
2021,207209,30,0,31,18,13
2021,207209,30,2,7,6,1
2021,207209,30,3,20,9,11
2021,207209,30,4,4,3,1
2021,207209,40,0,54,26,28
2021,207209,40,2,4,3,1
2021,207209,40,3,23,13,10
2021,207209,40,4,27,10,17
2021,207209,42,0,54,26,28
2021,207209,42,2,4,3,1
2021,207209,42,3,23,13,10
2021,207209,42,4,27,10,17
2021,207236,0,0,53,23,30
2021,207236,10,0,53,23,30
2021,207236,10,1,4,2,2
2021,207236,10,3,8,2,6
2021,207236,10,4,41,19,22
2021,207236,20,0,16,5,11
2021,207236,20,1,4,2,2
2021,207236,20,3,8,2,6
2021,207236,20,4,4,1,3
2021,207236,30,0,37,18,19
2021,207236,30,4,37,18,19
2021,207254,0,0,108,101,7
2021,207254,50,0,108,101,7
2021,207263,0,0,279,137,142
2021,207263,10,0,279,137,142
2021,207263,10,1,79,48,31
2021,207263,10,2,70,36,34
2021,207263,10,3,96,42,54
2021,207263,10,4,31,9,22
2021,207263,10,5,3,2,1
2021,207263,20,0,145,82,63
2021,207263,20,1,77,46,31
2021,207263,20,2,67,35,32
2021,207263,20,3,1,1,0
2021,207263,30,0,65,29,36
2021,207263,30,1,1,1,0
2021,207263,30,2,2,1,1
2021,207263,30,3,62,27,35
2021,207263,40,0,69,26,43
2021,207263,40,1,1,1,0
2021,207263,40,2,1,0,1
2021,207263,40,3,33,14,19
2021,207263,40,4,31,9,22
2021,207263,40,5,3,2,1
2021,207263,41,0,23,9,14
2021,207263,41,3,8,5,3
2021,207263,41,4,13,3,10
2021,207263,41,5,2,1,1
2021,207263,42,0,33,17,16
2021,207263,42,1,1,1,0
2021,207263,42,2,1,0,1
2021,207263,42,3,18,9,9
2021,207263,42,4,12,6,6
2021,207263,42,5,1,1,0
2021,207263,43,0,13,0,13
2021,207263,43,3,7,0,7
2021,207263,43,4,6,0,6
2021,207263,45,0,23,9,14
2021,207263,45,3,8,5,3
2021,207263,45,4,13,3,10
2021,207263,45,5,2,1,1
2021,207281,0,0,92,37,55
2021,207281,10,0,92,37,55
2021,207281,10,4,92,37,55
2021,207281,20,0,62,26,36
2021,207281,20,4,62,26,36
2021,207281,30,0,26,10,16
2021,207281,30,4,26,10,16
2021,207281,40,0,4,1,3
2021,207281,40,4,4,1,3
2021,207281,42,0,4,1,3
2021,207281,42,4,4,1,3
2021,207290,0,0,48,17,31
2021,207290,10,0,48,17,31
2021,207290,10,4,48,17,31
2021,207290,40,0,48,17,31
2021,207290,40,4,48,17,31
2021,207290,42,0,48,17,31
2021,207290,42,4,48,17,31
2021,207306,0,0,82,43,39
2021,207306,10,0,82,43,39
2021,207306,10,1,21,13,8
2021,207306,10,2,15,4,11
2021,207306,10,3,19,10,9
2021,207306,10,4,25,15,10
2021,207306,10,5,1,0,1
2021,207306,10,6,1,1,0
2021,207306,20,0,38,19,19
2021,207306,20,1,21,13,8
2021,207306,20,2,13,3,10
2021,207306,20,3,3,2,1
2021,207306,20,6,1,1,0
2021,207306,30,0,17,9,8
2021,207306,30,2,2,1,1
2021,207306,30,3,15,8,7
2021,207306,40,0,27,15,12
2021,207306,40,3,1,0,1
2021,207306,40,4,25,15,10
2021,207306,40,5,1,0,1
2021,207306,42,0,27,15,12
2021,207306,42,3,1,0,1
2021,207306,42,4,25,15,10
2021,207306,42,5,1,0,1
2021,207315,0,0,188,112,76
2021,207315,10,0,188,112,76
2021,207315,10,1,53,34,19
2021,207315,10,2,39,21,18
2021,207315,10,3,93,56,37
2021,207315,10,4,1,0,1
2021,207315,10,6,2,1,1
2021,207315,20,0,43,28,15
2021,207315,20,1,36,23,13
2021,207315,20,2,7,5,2
2021,207315,30,0,18,11,7
2021,207315,30,1,1,1,0
2021,207315,30,2,6,3,3
2021,207315,30,3,11,7,4
2021,207315,40,0,127,73,54
2021,207315,40,1,16,10,6
2021,207315,40,2,26,13,13
2021,207315,40,3,82,49,33
2021,207315,40,4,1,0,1
2021,207315,40,6,2,1,1
2021,207315,42,0,127,73,54
2021,207315,42,1,16,10,6
2021,207315,42,2,26,13,13
2021,207315,42,3,82,49,33
2021,207315,42,4,1,0,1
2021,207315,42,6,2,1,1
2021,207324,0,0,90,57,33
2021,207324,10,0,90,57,33
2021,207324,10,1,39,29,10
2021,207324,10,2,21,15,6
2021,207324,10,3,25,12,13
2021,207324,10,4,5,1,4
2021,207324,20,0,48,34,14
2021,207324,20,1,38,28,10
2021,207324,20,2,8,6,2
2021,207324,20,3,2,0,2
2021,207324,30,0,34,19,15
2021,207324,30,2,13,9,4
2021,207324,30,3,18,10,8
2021,207324,30,4,3,0,3
2021,207324,40,0,8,4,4
2021,207324,40,1,1,1,0
2021,207324,40,3,5,2,3
2021,207324,40,4,2,1,1
2021,207324,42,0,8,4,4
2021,207324,42,1,1,1,0
2021,207324,42,3,5,2,3
2021,207324,42,4,2,1,1
2021,207342,0,0,810,386,424
2021,207342,10,0,810,386,424
2021,207342,10,1,167,104,63
2021,207342,10,2,152,63,89
2021,207342,10,3,284,137,147
2021,207342,10,4,202,78,124
2021,207342,10,5,5,4,1
2021,207342,20,0,122,76,46
2021,207342,20,1,93,62,31
2021,207342,20,2,29,14,15
2021,207342,30,0,78,30,48
2021,207342,30,1,9,2,7
2021,207342,30,2,17,7,10
2021,207342,30,3,52,21,31
2021,207342,40,0,610,280,330
2021,207342,40,1,65,40,25
2021,207342,40,2,106,42,64
2021,207342,40,3,232,116,116
2021,207342,40,4,202,78,124
2021,207342,40,5,5,4,1
2021,207342,42,0,610,280,330
2021,207342,42,1,65,40,25
2021,207342,42,2,106,42,64
2021,207342,42,3,232,116,116
2021,207342,42,4,202,78,124
2021,207342,42,5,5,4,1
2021,207351,0,0,48,26,22
2021,207351,10,0,48,26,22
2021,207351,10,1,8,6,2
2021,207351,10,2,3,2,1
2021,207351,10,3,19,9,10
2021,207351,10,4,17,8,9
2021,207351,10,5,1,1,0
2021,207351,20,0,9,6,3
2021,207351,20,1,8,6,2
2021,207351,20,2,1,0,1
2021,207351,30,0,20,10,10
2021,207351,30,2,2,2,0
2021,207351,30,3,18,8,10
2021,207351,40,0,19,10,9
2021,207351,40,3,1,1,0
2021,207351,40,4,17,8,9
2021,207351,40,5,1,1,0
2021,207351,42,0,19,10,9
2021,207351,42,3,1,1,0
2021,207351,42,4,17,8,9
2021,207351,42,5,1,1,0
2021,207388,0,0,1280,741,539
2021,207388,10,0,1243,722,521
2021,207388,10,1,332,235,97
2021,207388,10,2,273,180,93
2021,207388,10,3,282,148,134
2021,207388,10,4,1,0,1
2021,207388,10,5,99,49,50
2021,207388,10,6,256,110,146
2021,207388,20,0,594,405,189
2021,207388,20,1,331,234,97
2021,207388,20,2,260,169,91
2021,207388,20,3,2,2,0
2021,207388,20,4,1,0,1
2021,207388,30,0,291,155,136
2021,207388,30,2,12,10,2
2021,207388,30,3,279,145,134
2021,207388,40,0,358,162,196
2021,207388,40,1,1,1,0
2021,207388,40,2,1,1,0
2021,207388,40,3,1,1,0
2021,207388,40,5,99,49,50
2021,207388,40,6,256,110,146
2021,207388,42,0,358,162,196
2021,207388,42,1,1,1,0
2021,207388,42,2,1,1,0
2021,207388,42,3,1,1,0
2021,207388,42,5,99,49,50
2021,207388,42,6,256,110,146
2021,207388,50,0,37,19,18
2021,207397,0,0,77,27,50
2021,207397,10,0,77,27,50
2021,207397,10,1,7,6,1
2021,207397,10,2,23,6,17
2021,207397,10,3,26,9,17
2021,207397,10,4,21,6,15
2021,207397,20,0,31,12,19
2021,207397,20,1,7,6,1
2021,207397,20,2,23,6,17
2021,207397,20,4,1,0,1
2021,207397,30,0,46,15,31
2021,207397,30,3,26,9,17
2021,207397,30,4,20,6,14
2021,207403,0,0,84,50,34
2021,207403,10,0,84,50,34
2021,207403,10,1,27,20,7
2021,207403,10,2,20,14,6
2021,207403,10,3,37,16,21
2021,207403,20,0,41,27,14
2021,207403,20,1,25,18,7
2021,207403,20,2,14,9,5
2021,207403,20,3,2,0,2
2021,207403,30,0,31,18,13
2021,207403,30,1,2,2,0
2021,207403,30,2,5,4,1
2021,207403,30,3,24,12,12
2021,207403,40,0,12,5,7
2021,207403,40,2,1,1,0
2021,207403,40,3,11,4,7
2021,207403,41,0,6,3,3
2021,207403,41,3,6,3,3
2021,207403,42,0,6,2,4
2021,207403,42,2,1,1,0
2021,207403,42,3,5,1,4
2021,207403,44,0,6,3,3
2021,207403,44,3,6,3,3
2021,207449,0,0,117,61,56
2021,207449,10,0,117,61,56
2021,207449,10,1,117,61,56
2021,207449,40,0,117,61,56
2021,207449,40,1,117,61,56
2021,207449,42,0,117,61,56
2021,207449,42,1,117,61,56
2021,207458,0,0,189,98,91
2021,207458,10,0,189,98,91
2021,207458,10,1,70,44,26
2021,207458,10,2,47,25,22
2021,207458,10,3,61,25,36
2021,207458,10,4,11,4,7
2021,207458,20,0,76,49,27
2021,207458,20,1,54,38,16
2021,207458,20,2,22,11,11
2021,207458,30,0,25,8,17
2021,207458,30,2,8,4,4
2021,207458,30,3,17,4,13
2021,207458,40,0,88,41,47
2021,207458,40,1,16,6,10
2021,207458,40,2,17,10,7
2021,207458,40,3,44,21,23
2021,207458,40,4,11,4,7
2021,207458,41,0,9,6,3
2021,207458,41,1,6,5,1
2021,207458,41,3,2,0,2
2021,207458,41,4,1,1,0
2021,207458,42,0,79,35,44
2021,207458,42,1,10,1,9
2021,207458,42,2,17,10,7
2021,207458,42,3,42,21,21
2021,207458,42,4,10,3,7
2021,207458,44,0,9,6,3
2021,207458,44,1,6,5,1
2021,207458,44,3,2,0,2
2021,207458,44,4,1,1,0
2021,207500,0,0,1368,805,563
2021,207500,10,0,1368,805,563
2021,207500,10,1,396,280,116
2021,207500,10,2,379,235,144
2021,207500,10,3,297,153,144
2021,207500,10,4,143,56,87
2021,207500,10,5,153,81,72
2021,207500,20,0,729,489,240
2021,207500,20,1,379,271,108
2021,207500,20,2,350,218,132
2021,207500,30,0,241,126,115
2021,207500,30,2,8,6,2
2021,207500,30,3,233,120,113
2021,207500,40,0,398,190,208
2021,207500,40,1,17,9,8
2021,207500,40,2,21,11,10
2021,207500,40,3,64,33,31
2021,207500,40,4,143,56,87
2021,207500,40,5,153,81,72
2021,207500,41,0,234,114,120
2021,207500,41,1,14,7,7
2021,207500,41,2,18,11,7
2021,207500,41,3,57,28,29
2021,207500,41,4,62,27,35
2021,207500,41,5,83,41,42
2021,207500,42,0,138,68,70
2021,207500,42,1,3,2,1
2021,207500,42,2,3,0,3
2021,207500,42,3,7,5,2
2021,207500,42,4,61,24,37
2021,207500,42,5,64,37,27
2021,207500,43,0,26,8,18
2021,207500,43,4,20,5,15
2021,207500,43,5,6,3,3
2021,207500,44,0,234,114,120
2021,207500,44,1,14,7,7
2021,207500,44,2,18,11,7
2021,207500,44,3,57,28,29
2021,207500,44,4,62,27,35
2021,207500,44,5,83,41,42
2021,207564,0,0,86,58,28
2021,207564,10,0,86,58,28
2021,207564,10,6,86,58,28
2021,207564,40,0,86,58,28
2021,207564,40,6,86,58,28
2021,207564,41,0,86,58,28
2021,207564,41,6,86,58,28
2021,207564,45,0,86,58,28
2021,207564,45,6,86,58,28
2021,207582,0,0,149,79,70
2021,207582,10,0,149,79,70
2021,207582,10,1,59,40,19
2021,207582,10,2,32,15,17
2021,207582,10,3,40,17,23
2021,207582,10,5,18,7,11
2021,207582,40,0,149,79,70
2021,207582,40,1,59,40,19
2021,207582,40,2,32,15,17
2021,207582,40,3,40,17,23
2021,207582,40,5,18,7,11
2021,207582,41,0,79,49,30
2021,207582,41,1,56,39,17
2021,207582,41,2,23,10,13
2021,207582,42,0,70,30,40
2021,207582,42,1,3,1,2
2021,207582,42,2,9,5,4
2021,207582,42,3,40,17,23
2021,207582,42,5,18,7,11
2021,207582,44,0,79,49,30
2021,207582,44,1,56,39,17
2021,207582,44,2,23,10,13
2021,207661,0,0,98,54,44
2021,207661,10,0,98,54,44
2021,207661,10,1,29,18,11
2021,207661,10,2,19,14,5
2021,207661,10,3,29,12,17
2021,207661,10,4,21,10,11
2021,207661,20,0,43,29,14
2021,207661,20,1,27,17,10
2021,207661,20,2,15,12,3
2021,207661,20,3,1,0,1
2021,207661,30,0,21,10,11
2021,207661,30,1,1,1,0
2021,207661,30,2,4,2,2
2021,207661,30,3,15,6,9
2021,207661,30,4,1,1,0
2021,207661,40,0,34,15,19
2021,207661,40,1,1,0,1
2021,207661,40,3,13,6,7
2021,207661,40,4,20,9,11
2021,207661,41,0,34,15,19
2021,207661,41,1,1,0,1
2021,207661,41,3,13,6,7
2021,207661,41,4,20,9,11
2021,207661,45,0,34,15,19
2021,207661,45,1,1,0,1
2021,207661,45,3,13,6,7
2021,207661,45,4,20,9,11
2021,207670,0,0,127,49,78
2021,207670,10,0,113,39,74
2021,207670,10,1,113,39,74
2021,207670,20,0,48,18,30
2021,207670,20,1,48,18,30
2021,207670,30,0,52,16,36
2021,207670,30,1,52,16,36
2021,207670,40,0,13,5,8
2021,207670,40,1,13,5,8
2021,207670,42,0,13,5,8
2021,207670,42,1,13,5,8
2021,207670,50,0,14,10,4
2021,207722,0,0,50,27,23
2021,207722,10,0,50,27,23
2021,207722,10,1,17,5,12
2021,207722,10,2,14,9,5
2021,207722,10,3,9,7,2
2021,207722,10,4,10,6,4
2021,207722,20,0,31,14,17
2021,207722,20,1,17,5,12
2021,207722,20,2,14,9,5
2021,207722,30,0,7,5,2
2021,207722,30,3,7,5,2
2021,207722,40,0,12,8,4
2021,207722,40,3,2,2,0
2021,207722,40,4,10,6,4
2021,207722,42,0,11,7,4
2021,207722,42,3,2,2,0
2021,207722,42,4,9,5,4
2021,207722,43,0,1,1,0
2021,207722,43,4,1,1,0
2021,207740,0,0,39,14,25
2021,207740,10,0,39,14,25
2021,207740,10,1,5,2,3
2021,207740,10,2,4,2,2
2021,207740,10,3,22,7,15
2021,207740,10,4,8,3,5
2021,207740,20,0,9,4,5
2021,207740,20,1,5,2,3
2021,207740,20,2,4,2,2
2021,207740,30,0,22,6,16
2021,207740,30,3,21,6,15
2021,207740,30,4,1,0,1
2021,207740,40,0,8,4,4
2021,207740,40,3,1,1,0
2021,207740,40,4,7,3,4
2021,207740,42,0,8,4,4
2021,207740,42,3,1,1,0
2021,207740,42,4,7,3,4
2021,207847,0,0,134,69,65
2021,207847,10,0,134,69,65
2021,207847,10,1,42,29,13
2021,207847,10,2,26,9,17
2021,207847,10,3,38,19,19
2021,207847,10,4,28,12,16
2021,207847,20,0,65,37,28
2021,207847,20,1,42,29,13
2021,207847,20,2,22,7,15
2021,207847,20,3,1,1,0
2021,207847,30,0,42,21,21
2021,207847,30,2,4,2,2
2021,207847,30,3,36,18,18
2021,207847,30,4,2,1,1
2021,207847,40,0,27,11,16
2021,207847,40,3,1,0,1
2021,207847,40,4,26,11,15
2021,207847,42,0,27,11,16
2021,207847,42,3,1,0,1
2021,207847,42,4,26,11,15
2021,207856,0,0,23,13,10
2021,207856,10,0,23,13,10
2021,207856,10,6,23,13,10
2021,207856,40,0,23,13,10
2021,207856,40,6,23,13,10
2021,207856,42,0,4,1,3
2021,207856,42,6,4,1,3
2021,207856,43,0,19,12,7
2021,207856,43,6,19,12,7
2021,207865,0,0,198,93,105
2021,207865,10,0,198,93,105
2021,207865,10,1,50,25,25
2021,207865,10,2,46,23,23
2021,207865,10,3,42,23,19
2021,207865,10,4,60,22,38
2021,207865,20,0,98,49,49
2021,207865,20,1,50,25,25
2021,207865,20,2,42,19,23
2021,207865,20,3,6,5,1
2021,207865,30,0,26,16,10
2021,207865,30,2,3,3,0
2021,207865,30,3,23,13,10
2021,207865,40,0,74,28,46
2021,207865,40,2,1,1,0
2021,207865,40,3,13,5,8
2021,207865,40,4,60,22,38
2021,207865,42,0,74,28,46
2021,207865,42,2,1,1,0
2021,207865,42,3,13,5,8
2021,207865,42,4,60,22,38
2021,207935,0,0,273,100,173
2021,207935,10,0,273,100,173
2021,207935,10,1,20,2,18
2021,207935,10,2,105,38,67
2021,207935,10,3,148,60,88
2021,207935,40,0,273,100,173
2021,207935,40,1,20,2,18
2021,207935,40,2,105,38,67
2021,207935,40,3,148,60,88
2021,207935,42,0,273,100,173
2021,207935,42,1,20,2,18
2021,207935,42,2,105,38,67
2021,207935,42,3,148,60,88
2021,207962,0,0,16,16,0
2021,207962,10,0,16,16,0
2021,207962,10,4,16,16,0
2021,207962,40,0,16,16,0
2021,207962,40,4,16,16,0
2021,207962,41,0,16,16,0
2021,207962,41,4,16,16,0
2021,207962,45,0,16,16,0
2021,207962,45,4,16,16,0
2021,207971,0,0,298,180,118
2021,207971,10,0,298,180,118
2021,207971,10,1,85,70,15
2021,207971,10,2,104,65,39
2021,207971,10,3,90,38,52
2021,207971,10,4,19,7,12
2021,207971,20,0,158,125,33
2021,207971,20,1,80,68,12
2021,207971,20,2,78,57,21
2021,207971,30,0,44,18,26
2021,207971,30,2,3,1,2
2021,207971,30,3,41,17,24
2021,207971,40,0,96,37,59
2021,207971,40,1,5,2,3
2021,207971,40,2,23,7,16
2021,207971,40,3,49,21,28
2021,207971,40,4,19,7,12
2021,207971,41,0,85,33,52
2021,207971,41,1,5,2,3
2021,207971,41,2,19,6,13
2021,207971,41,3,42,18,24
2021,207971,41,4,19,7,12
2021,207971,42,0,11,4,7
2021,207971,42,2,4,1,3
2021,207971,42,3,7,3,4
2021,207971,44,0,85,33,52
2021,207971,44,1,5,2,3
2021,207971,44,2,19,6,13
2021,207971,44,3,42,18,24
2021,207971,44,4,19,7,12
2021,208035,0,0,25,3,22
2021,208035,10,0,25,3,22
2021,208035,10,4,25,3,22
2021,208035,20,0,10,0,10
2021,208035,20,4,10,0,10
2021,208035,30,0,15,3,12
2021,208035,30,4,15,3,12
2021,208275,0,0,44,19,25
2021,208275,10,0,44,19,25
2021,208275,10,4,44,19,25
2021,208275,20,0,35,15,20
2021,208275,20,4,35,15,20
2021,208275,30,0,9,4,5
2021,208275,30,4,9,4,5
2021,208318,0,0,123,54,69
2021,208318,10,0,123,54,69
2021,208318,10,1,38,19,19
2021,208318,10,2,37,18,19
2021,208318,10,3,43,16,27
2021,208318,10,6,5,1,4
2021,208318,20,0,86,42,44
2021,208318,20,1,38,19,19
2021,208318,20,2,36,18,18
2021,208318,20,3,12,5,7
2021,208318,30,0,32,11,21
2021,208318,30,2,1,0,1
2021,208318,30,3,31,11,20
2021,208318,40,0,5,1,4
2021,208318,40,6,5,1,4
2021,208318,42,0,5,1,4
2021,208318,42,6,5,1,4
2021,208390,0,0,189,91,98
2021,208390,10,0,189,91,98
2021,208390,10,4,189,91,98
2021,208390,40,0,189,91,98
2021,208390,40,4,189,91,98
2021,208390,42,0,189,91,98
2021,208390,42,4,189,91,98
2021,208406,0,0,124,63,61
2021,208406,10,0,124,63,61
2021,208406,10,4,124,63,61
2021,208406,40,0,124,63,61
2021,208406,40,4,124,63,61
2021,208406,42,0,124,63,61
2021,208406,42,4,124,63,61
2021,208415,0,0,28,14,14
2021,208415,10,0,28,14,14
2021,208415,10,4,28,14,14
2021,208415,40,0,28,14,14
2021,208415,40,4,28,14,14
2021,208415,42,0,28,14,14
2021,208415,42,4,28,14,14
2021,208479,0,0,17,2,15
2021,208479,10,0,17,2,15
2021,208479,10,4,17,2,15
2021,208479,40,0,17,2,15
2021,208479,40,4,17,2,15
2021,208479,41,0,17,2,15
2021,208479,41,4,17,2,15
2021,208479,45,0,17,2,15
2021,208479,45,4,17,2,15
2021,208512,0,0,10,3,7
2021,208512,10,0,10,3,7
2021,208512,10,4,10,3,7
2021,208512,40,0,10,3,7
2021,208512,40,4,10,3,7
2021,208512,43,0,10,3,7
2021,208512,43,4,10,3,7
2021,208646,0,0,111,54,57
2021,208646,10,0,111,54,57
2021,208646,10,1,27,14,13
2021,208646,10,2,40,20,20
2021,208646,10,3,18,11,7
2021,208646,10,4,26,9,17
2021,208646,20,0,55,29,26
2021,208646,20,1,26,13,13
2021,208646,20,2,29,16,13
2021,208646,30,0,25,11,14
2021,208646,30,1,1,1,0
2021,208646,30,2,11,4,7
2021,208646,30,3,12,6,6
2021,208646,30,4,1,0,1
2021,208646,40,0,31,14,17
2021,208646,40,3,6,5,1
2021,208646,40,4,25,9,16
2021,208646,42,0,31,14,17
2021,208646,42,3,6,5,1
2021,208646,42,4,25,9,16
2021,208822,0,0,197,100,97
2021,208822,10,0,197,100,97
2021,208822,10,1,54,38,16
2021,208822,10,2,39,23,16
2021,208822,10,3,85,32,53
2021,208822,10,4,1,1,0
2021,208822,10,5,1,1,0
2021,208822,10,6,17,5,12
2021,208822,20,0,61,43,18
2021,208822,20,1,51,36,15
2021,208822,20,2,9,7,2
2021,208822,20,6,1,0,1
2021,208822,30,0,86,38,48
2021,208822,30,1,3,2,1
2021,208822,30,2,26,12,14
2021,208822,30,3,57,24,33
2021,208822,40,0,50,19,31
2021,208822,40,2,4,4,0
2021,208822,40,3,28,8,20
2021,208822,40,4,1,1,0
2021,208822,40,5,1,1,0
2021,208822,40,6,16,5,11
2021,208822,42,0,34,14,20
2021,208822,42,2,4,4,0
2021,208822,42,3,28,8,20
2021,208822,42,4,1,1,0
2021,208822,42,5,1,1,0
2021,208822,43,0,16,5,11
2021,208822,43,6,16,5,11
2021,209038,0,0,186,75,111
2021,209038,10,0,186,75,111
2021,209038,10,6,186,75,111
2021,209038,40,0,186,75,111
2021,209038,40,6,186,75,111
2021,209038,42,0,186,75,111
2021,209038,42,6,186,75,111
2021,209056,0,0,200,98,102
2021,209056,10,0,183,87,96
2021,209056,10,1,58,38,20
2021,209056,10,2,79,35,44
2021,209056,10,3,34,8,26
2021,209056,10,4,11,6,5
2021,209056,10,5,1,0,1
2021,209056,20,0,125,68,57
2021,209056,20,1,50,36,14
2021,209056,20,2,75,32,43
2021,209056,30,0,22,6,16
2021,209056,30,3,22,6,16
2021,209056,40,0,36,13,23
2021,209056,40,1,8,2,6
2021,209056,40,2,4,3,1
2021,209056,40,3,12,2,10
2021,209056,40,4,11,6,5
2021,209056,40,5,1,0,1
2021,209056,41,0,7,2,5
2021,209056,41,1,7,2,5
2021,209056,42,0,29,11,18
2021,209056,42,1,1,0,1
2021,209056,42,2,4,3,1
2021,209056,42,3,12,2,10
2021,209056,42,4,11,6,5
2021,209056,42,5,1,0,1
2021,209056,45,0,7,2,5
2021,209056,45,1,7,2,5
2021,209056,50,0,17,11,6
2021,209065,0,0,135,50,85
2021,209065,10,0,135,50,85
2021,209065,10,1,45,24,21
2021,209065,10,2,43,13,30
2021,209065,10,3,47,13,34
2021,209065,20,0,79,35,44
2021,209065,20,1,41,23,18
2021,209065,20,2,36,11,25
2021,209065,20,3,2,1,1
2021,209065,30,0,27,8,19
2021,209065,30,1,2,1,1
2021,209065,30,2,4,1,3
2021,209065,30,3,21,6,15
2021,209065,40,0,29,7,22
2021,209065,40,1,2,0,2
2021,209065,40,2,3,1,2
2021,209065,40,3,24,6,18
2021,209065,41,0,13,1,12
2021,209065,41,1,1,0,1
2021,209065,41,2,1,0,1
2021,209065,41,3,11,1,10
2021,209065,42,0,16,6,10
2021,209065,42,1,1,0,1
2021,209065,42,2,2,1,1
2021,209065,42,3,13,5,8
2021,209065,44,0,13,1,12
2021,209065,44,1,1,0,1
2021,209065,44,2,1,0,1
2021,209065,44,3,11,1,10
2021,209074,0,0,122,60,62
2021,209074,10,0,122,60,62
2021,209074,10,6,122,60,62
2021,209074,40,0,122,60,62
2021,209074,40,6,122,60,62
2021,209074,42,0,122,60,62
2021,209074,42,6,122,60,62
2021,209241,0,0,11,7,4
2021,209241,10,0,11,7,4
2021,209241,10,1,2,2,0
2021,209241,10,2,8,4,4
2021,209241,10,3,1,1,0
2021,209241,40,0,11,7,4
2021,209241,40,1,2,2,0
2021,209241,40,2,8,4,4
2021,209241,40,3,1,1,0
2021,209241,42,0,11,7,4
2021,209241,42,1,2,2,0
2021,209241,42,2,8,4,4
2021,209241,42,3,1,1,0
2021,209250,0,0,135,60,75
2021,209250,10,0,135,60,75
2021,209250,10,4,135,60,75
2021,209250,20,0,111,52,59
2021,209250,20,4,111,52,59
2021,209250,30,0,23,8,15
2021,209250,30,4,23,8,15
2021,209250,40,0,1,0,1
2021,209250,40,4,1,0,1
2021,209250,42,0,1,0,1
2021,209250,42,4,1,0,1
2021,209287,0,0,21,12,9
2021,209287,10,0,21,12,9
2021,209287,10,1,7,5,2
2021,209287,10,2,6,4,2
2021,209287,10,3,7,3,4
2021,209287,10,4,1,0,1
2021,209287,20,0,3,2,1
2021,209287,20,1,3,2,1
2021,209287,40,0,18,10,8
2021,209287,40,1,4,3,1
2021,209287,40,2,6,4,2
2021,209287,40,3,7,3,4
2021,209287,40,4,1,0,1
2021,209287,41,0,16,9,7
2021,209287,41,1,4,3,1
2021,209287,41,2,6,4,2
2021,209287,41,3,6,2,4
2021,209287,42,0,2,1,1
2021,209287,42,3,1,1,0
2021,209287,42,4,1,0,1
2021,209287,45,0,16,9,7
2021,209287,45,1,4,3,1
2021,209287,45,2,6,4,2
2021,209287,45,3,6,2,4
2021,209296,0,0,22,10,12
2021,209296,10,0,22,10,12
2021,209296,10,1,6,3,3
2021,209296,10,2,9,4,5
2021,209296,10,3,7,3,4
2021,209296,40,0,22,10,12
2021,209296,40,1,6,3,3
2021,209296,40,2,9,4,5
2021,209296,40,3,7,3,4
2021,209296,42,0,22,10,12
2021,209296,42,1,6,3,3
2021,209296,42,2,9,4,5
2021,209296,42,3,7,3,4
2021,209409,0,0,26,15,11
2021,209409,10,0,26,15,11
2021,209409,10,1,7,4,3
2021,209409,10,2,10,7,3
2021,209409,10,3,8,3,5
2021,209409,10,4,1,1,0
2021,209409,40,0,26,15,11
2021,209409,40,1,7,4,3
2021,209409,40,2,10,7,3
2021,209409,40,3,8,3,5
2021,209409,40,4,1,1,0
2021,209409,42,0,26,15,11
2021,209409,42,1,7,4,3
2021,209409,42,2,10,7,3
2021,209409,42,3,8,3,5
2021,209409,42,4,1,1,0
2021,209490,0,0,1790,762,1028
2021,209490,10,0,1790,762,1028
2021,209490,10,1,222,148,74
2021,209490,10,2,346,169,177
2021,209490,10,3,732,309,423
2021,209490,10,4,485,136,349
2021,209490,10,5,5,0,5
2021,209490,20,0,81,51,30
2021,209490,20,1,65,43,22
2021,209490,20,2,16,8,8
2021,209490,30,0,40,26,14
2021,209490,30,1,4,2,2
2021,209490,30,2,16,10,6
2021,209490,30,3,20,14,6
2021,209490,40,0,1669,685,984
2021,209490,40,1,153,103,50
2021,209490,40,2,314,151,163
2021,209490,40,3,712,295,417
2021,209490,40,4,485,136,349
2021,209490,40,5,5,0,5
2021,209490,41,0,12,4,8
2021,209490,41,1,1,0,1
2021,209490,41,2,4,2,2
2021,209490,41,3,7,2,5
2021,209490,42,0,1640,679,961
2021,209490,42,1,152,103,49
2021,209490,42,2,310,149,161
2021,209490,42,3,698,293,405
2021,209490,42,4,479,134,345
2021,209490,42,5,1,0,1
2021,209490,43,0,17,2,15
2021,209490,43,3,7,0,7
2021,209490,43,4,6,2,4
2021,209490,43,5,4,0,4
2021,209490,44,0,12,4,8
2021,209490,44,1,1,0,1
2021,209490,44,2,4,2,2
2021,209490,44,3,7,2,5
2021,209506,0,0,160,94,66
2021,209506,10,0,151,87,64
2021,209506,10,1,48,33,15
2021,209506,10,2,50,30,20
2021,209506,10,3,33,18,15
2021,209506,10,4,20,6,14
2021,209506,20,0,93,62,31
2021,209506,20,1,48,33,15
2021,209506,20,2,43,27,16
2021,209506,20,3,2,2,0
2021,209506,30,0,33,16,17
2021,209506,30,2,6,3,3
2021,209506,30,3,27,13,14
2021,209506,40,0,25,9,16
2021,209506,40,2,1,0,1
2021,209506,40,3,4,3,1
2021,209506,40,4,20,6,14
2021,209506,42,0,25,9,16
2021,209506,42,2,1,0,1
2021,209506,42,3,4,3,1
2021,209506,42,4,20,6,14
2021,209506,50,0,9,7,2
2021,209542,0,0,1249,724,525
2021,209542,10,0,1249,724,525
2021,209542,10,1,318,232,86
2021,209542,10,2,325,199,126
2021,209542,10,3,209,101,108
2021,209542,10,4,397,192,205
2021,209542,20,0,609,415,194
2021,209542,20,1,317,231,86
2021,209542,20,2,290,183,107
2021,209542,20,4,2,1,1
2021,209542,30,0,180,92,88
2021,209542,30,2,14,7,7
2021,209542,30,3,166,85,81
2021,209542,40,0,460,217,243
2021,209542,40,1,1,1,0
2021,209542,40,2,21,9,12
2021,209542,40,3,43,16,27
2021,209542,40,4,395,191,204
2021,209542,42,0,460,217,243
2021,209542,42,1,1,1,0
2021,209542,42,2,21,9,12
2021,209542,42,3,43,16,27
2021,209542,42,4,395,191,204
2021,209551,0,0,946,535,411
2021,209551,10,0,946,535,411
2021,209551,10,1,287,189,98
2021,209551,10,2,273,163,110
2021,209551,10,3,173,89,84
2021,209551,10,4,194,91,103
2021,209551,10,5,19,3,16
2021,209551,20,0,546,340,206
2021,209551,20,1,274,178,96
2021,209551,20,2,269,161,108
2021,209551,20,4,3,1,2
2021,209551,30,0,178,92,86
2021,209551,30,1,3,3,0
2021,209551,30,2,4,2,2
2021,209551,30,3,171,87,84
2021,209551,40,0,222,103,119
2021,209551,40,1,10,8,2
2021,209551,40,3,2,2,0
2021,209551,40,4,191,90,101
2021,209551,40,5,19,3,16
2021,209551,41,0,189,93,96
2021,209551,41,1,9,7,2
2021,209551,41,4,161,83,78
2021,209551,41,5,19,3,16
2021,209551,42,0,20,7,13
2021,209551,42,1,1,1,0
2021,209551,42,3,2,2,0
2021,209551,42,4,17,4,13
2021,209551,43,0,13,3,10
2021,209551,43,4,13,3,10
2021,209551,44,0,48,23,25
2021,209551,44,1,4,3,1
2021,209551,44,4,34,19,15
2021,209551,44,5,10,1,9
2021,209551,45,0,141,70,71
2021,209551,45,1,5,4,1
2021,209551,45,4,127,64,63
2021,209551,45,5,9,2,7
2021,209603,0,0,24,9,15
2021,209603,10,0,24,9,15
2021,209603,10,1,1,1,0
2021,209603,10,2,21,7,14
2021,209603,10,3,2,1,1
2021,209603,40,0,24,9,15
2021,209603,40,1,1,1,0
2021,209603,40,2,21,7,14
2021,209603,40,3,2,1,1
2021,209603,41,0,24,9,15
2021,209603,41,1,1,1,0
2021,209603,41,2,21,7,14
2021,209603,41,3,2,1,1
2021,209603,44,0,24,9,15
2021,209603,44,1,1,1,0
2021,209603,44,2,21,7,14
2021,209603,44,3,2,1,1
2021,209612,0,0,280,122,158
2021,209612,10,0,277,122,155
2021,209612,10,1,75,44,31
2021,209612,10,2,87,41,46
2021,209612,10,3,105,34,71
2021,209612,10,4,10,3,7
2021,209612,20,0,129,68,61
2021,209612,20,1,67,39,28
2021,209612,20,2,60,28,32
2021,209612,20,3,2,1,1
2021,209612,30,0,46,15,31
2021,209612,30,1,1,1,0
2021,209612,30,2,3,0,3
2021,209612,30,3,42,14,28
2021,209612,40,0,102,39,63
2021,209612,40,1,7,4,3
2021,209612,40,2,24,13,11
2021,209612,40,3,61,19,42
2021,209612,40,4,10,3,7
2021,209612,41,0,42,20,22
2021,209612,41,1,4,2,2
2021,209612,41,2,23,13,10
2021,209612,41,3,12,4,8
2021,209612,41,4,3,1,2
2021,209612,42,0,60,19,41
2021,209612,42,1,3,2,1
2021,209612,42,2,1,0,1
2021,209612,42,3,49,15,34
2021,209612,42,4,7,2,5
2021,209612,44,0,42,20,22
2021,209612,44,1,4,2,2
2021,209612,44,2,23,13,10
2021,209612,44,3,12,4,8
2021,209612,44,4,3,1,2
2021,209612,50,0,3,0,3
2021,209746,0,0,386,178,208
2021,209746,10,0,386,178,208
2021,209746,10,4,386,178,208
2021,209746,20,0,319,152,167
2021,209746,20,4,319,152,167
2021,209746,30,0,43,19,24
2021,209746,30,4,43,19,24
2021,209746,40,0,24,7,17
2021,209746,40,4,24,7,17
2021,209746,42,0,24,7,17
2021,209746,42,4,24,7,17
2021,209807,0,0,725,369,356
2021,209807,10,0,725,369,356
2021,209807,10,1,212,135,77
2021,209807,10,2,206,110,96
2021,209807,10,3,166,63,103
2021,209807,10,4,141,61,80
2021,209807,20,0,382,224,158
2021,209807,20,1,201,130,71
2021,209807,20,2,180,93,87
2021,209807,20,3,1,1,0
2021,209807,30,0,107,43,64
2021,209807,30,2,1,1,0
2021,209807,30,3,106,42,64
2021,209807,40,0,236,102,134
2021,209807,40,1,11,5,6
2021,209807,40,2,25,16,9
2021,209807,40,3,59,20,39
2021,209807,40,4,141,61,80
2021,209807,41,0,200,84,116
2021,209807,41,1,10,5,5
2021,209807,41,2,24,15,9
2021,209807,41,3,51,19,32
2021,209807,41,4,115,45,70
2021,209807,42,0,36,18,18
2021,209807,42,1,1,0,1
2021,209807,42,2,1,1,0
2021,209807,42,3,8,1,7
2021,209807,42,4,26,16,10
2021,209807,44,0,74,32,42
2021,209807,44,1,3,3,0
2021,209807,44,2,5,4,1
2021,209807,44,3,19,6,13
2021,209807,44,4,47,19,28
2021,209807,45,0,126,52,74
2021,209807,45,1,7,2,5
2021,209807,45,2,19,11,8
2021,209807,45,3,32,13,19
2021,209807,45,4,68,26,42
2021,209825,0,0,277,116,161
2021,209825,10,0,277,116,161
2021,209825,10,1,44,33,11
2021,209825,10,2,86,43,43
2021,209825,10,3,57,16,41
2021,209825,10,4,65,15,50
2021,209825,10,5,12,3,9
2021,209825,10,6,13,6,7
2021,209825,20,0,125,73,52
2021,209825,20,1,43,33,10
2021,209825,20,2,81,40,41
2021,209825,20,3,1,0,1
2021,209825,30,0,59,18,41
2021,209825,30,2,4,2,2
2021,209825,30,3,55,16,39
2021,209825,40,0,93,25,68
2021,209825,40,1,1,0,1
2021,209825,40,2,1,1,0
2021,209825,40,3,1,0,1
2021,209825,40,4,65,15,50
2021,209825,40,5,12,3,9
2021,209825,40,6,13,6,7
2021,209825,42,0,79,22,57
2021,209825,42,1,1,0,1
2021,209825,42,2,1,1,0
2021,209825,42,3,1,0,1
2021,209825,42,4,56,13,43
2021,209825,42,5,10,3,7
2021,209825,42,6,10,5,5
2021,209825,43,0,14,3,11
2021,209825,43,4,9,2,7
2021,209825,43,5,2,0,2
2021,209825,43,6,3,1,2
2021,209922,0,0,192,107,85
2021,209922,10,0,192,107,85
2021,209922,10,1,66,44,22
2021,209922,10,2,42,22,20
2021,209922,10,3,45,18,27
2021,209922,10,6,39,23,16
2021,209922,20,0,126,74,52
2021,209922,20,1,64,42,22
2021,209922,20,2,37,20,17
2021,209922,20,3,23,12,11
2021,209922,20,6,2,0,2
2021,209922,30,0,24,12,12
2021,209922,30,2,2,0,2
2021,209922,30,3,5,1,4
2021,209922,30,6,17,11,6
2021,209922,40,0,42,21,21
2021,209922,40,1,2,2,0
2021,209922,40,2,3,2,1
2021,209922,40,3,17,5,12
2021,209922,40,6,20,12,8
2021,209922,41,0,16,9,7
2021,209922,41,1,1,1,0
2021,209922,41,2,1,1,0
2021,209922,41,3,4,0,4
2021,209922,41,6,10,7,3
2021,209922,42,0,23,10,13
2021,209922,42,1,1,1,0
2021,209922,42,2,1,0,1
2021,209922,42,3,12,5,7
2021,209922,42,6,9,4,5
2021,209922,43,0,3,2,1
2021,209922,43,2,1,1,0
2021,209922,43,3,1,0,1
2021,209922,43,6,1,1,0
2021,209922,44,0,16,9,7
2021,209922,44,1,1,1,0
2021,209922,44,2,1,1,0
2021,209922,44,3,4,0,4
2021,209922,44,6,10,7,3
2021,209940,0,0,64,29,35
2021,209940,10,0,64,29,35
2021,209940,10,4,64,29,35
2021,209940,20,0,45,21,24
2021,209940,20,4,45,21,24
2021,209940,30,0,15,7,8
2021,209940,30,4,15,7,8
2021,209940,40,0,4,1,3
2021,209940,40,4,4,1,3
2021,209940,42,0,2,0,2
2021,209940,42,4,2,0,2
2021,209940,43,0,2,1,1
2021,209940,43,4,2,1,1
2021,210146,0,0,137,75,62
2021,210146,10,0,137,75,62
2021,210146,10,1,54,31,23
2021,210146,10,2,27,15,12
2021,210146,10,3,36,17,19
2021,210146,10,4,20,12,8
2021,210146,20,0,74,41,33
2021,210146,20,1,54,31,23
2021,210146,20,2,20,10,10
2021,210146,30,0,39,19,20
2021,210146,30,2,7,5,2
2021,210146,30,3,32,14,18
2021,210146,40,0,24,15,9
2021,210146,40,3,4,3,1
2021,210146,40,4,20,12,8
2021,210146,41,0,17,12,5
2021,210146,41,4,17,12,5
2021,210146,42,0,7,3,4
2021,210146,42,3,4,3,1
2021,210146,42,4,3,0,3
2021,210146,44,0,17,12,5
2021,210146,44,4,17,12,5
2021,210155,0,0,46,24,22
2021,210155,10,0,46,24,22
2021,210155,10,1,16,12,4
2021,210155,10,2,16,9,7
2021,210155,10,3,14,3,11
2021,210155,20,0,32,21,11
2021,210155,20,1,16,12,4
2021,210155,20,2,16,9,7
2021,210155,30,0,12,3,9
2021,210155,30,3,12,3,9
2021,210155,40,0,2,0,2
2021,210155,40,3,2,0,2
2021,210155,41,0,1,0,1
2021,210155,41,3,1,0,1
2021,210155,42,0,1,0,1
2021,210155,42,3,1,0,1
2021,210155,44,0,1,0,1
2021,210155,44,3,1,0,1
2021,210234,0,0,39,16,23
2021,210234,10,0,38,16,22
2021,210234,10,4,38,16,22
2021,210234,20,0,20,11,9
2021,210234,20,4,20,11,9
2021,210234,30,0,10,2,8
2021,210234,30,4,10,2,8
2021,210234,40,0,8,3,5
2021,210234,40,4,8,3,5
2021,210234,41,0,8,3,5
2021,210234,41,4,8,3,5
2021,210234,44,0,8,3,5
2021,210234,44,4,8,3,5
2021,210234,50,0,1,0,1
2021,210270,0,0,63,34,29
2021,210270,10,0,63,34,29
2021,210270,10,4,63,34,29
2021,210270,40,0,63,34,29
2021,210270,40,4,63,34,29
2021,210270,41,0,47,29,18
2021,210270,41,4,47,29,18
2021,210270,42,0,16,5,11
2021,210270,42,4,16,5,11
2021,210270,45,0,47,29,18
2021,210270,45,4,47,29,18
2021,210304,0,0,29,14,15
2021,210304,10,0,29,14,15
2021,210304,10,1,6,3,3
2021,210304,10,2,11,3,8
2021,210304,10,3,10,7,3
2021,210304,10,4,1,0,1
2021,210304,10,6,1,1,0
2021,210304,40,0,29,14,15
2021,210304,40,1,6,3,3
2021,210304,40,2,11,3,8
2021,210304,40,3,10,7,3
2021,210304,40,4,1,0,1
2021,210304,40,6,1,1,0
2021,210304,42,0,28,13,15
2021,210304,42,1,6,3,3
2021,210304,42,2,11,3,8
2021,210304,42,3,10,7,3
2021,210304,42,4,1,0,1
2021,210304,43,0,1,1,0
2021,210304,43,6,1,1,0
2021,210331,0,0,48,29,19
2021,210331,10,0,48,29,19
2021,210331,10,1,18,16,2
2021,210331,10,2,13,5,8
2021,210331,10,3,17,8,9
2021,210331,40,0,48,29,19
2021,210331,40,1,18,16,2
2021,210331,40,2,13,5,8
2021,210331,40,3,17,8,9
2021,210331,42,0,48,29,19
2021,210331,42,1,18,16,2
2021,210331,42,2,13,5,8
2021,210331,42,3,17,8,9
2021,210368,0,0,20,14,6
2021,210368,10,0,20,14,6
2021,210368,10,1,9,7,2
2021,210368,10,2,2,2,0
2021,210368,10,3,8,4,4
2021,210368,10,4,1,1,0
2021,210368,40,0,20,14,6
2021,210368,40,1,9,7,2
2021,210368,40,2,2,2,0
2021,210368,40,3,8,4,4
2021,210368,40,4,1,1,0
2021,210368,42,0,20,14,6
2021,210368,42,1,9,7,2
2021,210368,42,2,2,2,0
2021,210368,42,3,8,4,4
2021,210368,42,4,1,1,0
2021,210401,0,0,158,86,72
2021,210401,10,0,158,86,72
2021,210401,10,1,76,42,34
2021,210401,10,2,47,25,22
2021,210401,10,3,24,16,8
2021,210401,10,4,11,3,8
2021,210401,20,0,121,65,56
2021,210401,20,1,76,42,34
2021,210401,20,2,45,23,22
2021,210401,30,0,16,11,5
2021,210401,30,2,1,1,0
2021,210401,30,3,15,10,5
2021,210401,40,0,21,10,11
2021,210401,40,2,1,1,0
2021,210401,40,3,9,6,3
2021,210401,40,4,11,3,8
2021,210401,41,0,7,2,5
2021,210401,41,3,1,0,1
2021,210401,41,4,6,2,4
2021,210401,42,0,14,8,6
2021,210401,42,2,1,1,0
2021,210401,42,3,8,6,2
2021,210401,42,4,5,1,4
2021,210401,44,0,7,2,5
2021,210401,44,3,1,0,1
2021,210401,44,4,6,2,4
2021,210429,0,0,243,110,133
2021,210429,10,0,243,110,133
2021,210429,10,1,77,36,41
2021,210429,10,2,36,15,21
2021,210429,10,3,77,37,40
2021,210429,10,4,50,21,29
2021,210429,10,5,3,1,2
2021,210429,20,0,112,50,62
2021,210429,20,1,77,36,41
2021,210429,20,2,35,14,21
2021,210429,30,0,32,13,19
2021,210429,30,2,1,1,0
2021,210429,30,3,31,12,19
2021,210429,40,0,99,47,52
2021,210429,40,3,46,25,21
2021,210429,40,4,50,21,29
2021,210429,40,5,3,1,2
2021,210429,42,0,99,47,52
2021,210429,42,3,46,25,21
2021,210429,42,4,50,21,29
2021,210429,42,5,3,1,2
2021,210438,0,0,34,14,20
2021,210438,10,0,34,14,20
2021,210438,10,1,4,3,1
2021,210438,10,2,14,7,7
2021,210438,10,3,10,2,8
2021,210438,10,4,3,1,2
2021,210438,10,6,3,1,2
2021,210438,20,0,16,9,7
2021,210438,20,1,4,3,1
2021,210438,20,2,11,6,5
2021,210438,20,3,1,0,1
2021,210438,30,0,10,2,8
2021,210438,30,2,3,1,2
2021,210438,30,3,7,1,6
2021,210438,40,0,8,3,5
2021,210438,40,3,2,1,1
2021,210438,40,4,3,1,2
2021,210438,40,6,3,1,2
2021,210438,41,0,5,2,3
2021,210438,41,3,2,1,1
2021,210438,41,4,3,1,2
2021,210438,43,0,3,1,2
2021,210438,43,6,3,1,2
2021,210438,45,0,5,2,3
2021,210438,45,3,2,1,1
2021,210438,45,4,3,1,2
2021,210492,0,0,32,19,13
2021,210492,10,0,32,19,13
2021,210492,10,1,3,1,2
2021,210492,10,2,8,7,1
2021,210492,10,3,21,11,10
2021,210492,20,0,7,5,2
2021,210492,20,1,3,1,2
2021,210492,20,2,4,4,0
2021,210492,30,0,4,2,2
2021,210492,30,2,1,0,1
2021,210492,30,3,3,2,1
2021,210492,40,0,21,12,9
2021,210492,40,2,3,3,0
2021,210492,40,3,18,9,9
2021,210492,41,0,15,9,6
2021,210492,41,2,2,2,0
2021,210492,41,3,13,7,6
2021,210492,42,0,6,3,3
2021,210492,42,2,1,1,0
2021,210492,42,3,5,2,3
2021,210492,44,0,15,9,6
2021,210492,44,2,2,2,0
2021,210492,44,3,13,7,6
2021,210571,0,0,117,57,60
2021,210571,10,0,117,57,60
2021,210571,10,1,21,11,10
2021,210571,10,2,43,25,18
2021,210571,10,3,32,13,19
2021,210571,10,4,18,7,11
2021,210571,10,5,3,1,2
2021,210571,20,0,53,30,23
2021,210571,20,1,21,11,10
2021,210571,20,2,32,19,13
2021,210571,30,0,31,16,15
2021,210571,30,2,8,4,4
2021,210571,30,3,23,12,11
2021,210571,40,0,33,11,22
2021,210571,40,2,3,2,1
2021,210571,40,3,9,1,8
2021,210571,40,4,18,7,11
2021,210571,40,5,3,1,2
2021,210571,41,0,15,3,12
2021,210571,41,2,2,1,1
2021,210571,41,3,4,1,3
2021,210571,41,4,9,1,8
2021,210571,42,0,18,8,10
2021,210571,42,2,1,1,0
2021,210571,42,3,5,0,5
2021,210571,42,4,9,6,3
2021,210571,42,5,3,1,2
2021,210571,44,0,15,3,12
2021,210571,44,2,2,1,1
2021,210571,44,3,4,1,3
2021,210571,44,4,9,1,8
2021,210599,0,0,23,15,8
2021,210599,10,0,23,15,8
2021,210599,10,4,23,15,8
2021,210599,40,0,23,15,8
2021,210599,40,4,23,15,8
2021,210599,41,0,23,15,8
2021,210599,41,4,23,15,8
2021,210599,45,0,23,15,8
2021,210599,45,4,23,15,8
2021,210605,0,0,222,94,128
2021,210605,10,0,222,94,128
2021,210605,10,1,116,53,63
2021,210605,10,2,63,23,40
2021,210605,10,3,34,12,22
2021,210605,10,4,9,6,3
2021,210605,20,0,147,66,81
2021,210605,20,1,111,49,62
2021,210605,20,2,32,15,17
2021,210605,20,3,4,2,2
2021,210605,30,0,60,22,38
2021,210605,30,1,3,2,1
2021,210605,30,2,27,7,20
2021,210605,30,3,26,10,16
2021,210605,30,4,4,3,1
2021,210605,40,0,15,6,9
2021,210605,40,1,2,2,0
2021,210605,40,2,4,1,3
2021,210605,40,3,4,0,4
2021,210605,40,4,5,3,2
2021,210605,41,0,15,6,9
2021,210605,41,1,2,2,0
2021,210605,41,2,4,1,3
2021,210605,41,3,4,0,4
2021,210605,41,4,5,3,2
2021,210605,45,0,15,6,9
2021,210605,45,1,2,2,0
2021,210605,45,2,4,1,3
2021,210605,45,3,4,0,4
2021,210605,45,4,5,3,2
2021,210669,0,0,158,74,84
2021,210669,10,0,158,74,84
2021,210669,10,1,44,24,20
2021,210669,10,2,47,21,26
2021,210669,10,3,60,26,34
2021,210669,10,4,7,3,4
2021,210669,20,0,88,43,45
2021,210669,20,1,44,24,20
2021,210669,20,2,44,19,25
2021,210669,30,0,37,12,25
2021,210669,30,3,37,12,25
2021,210669,40,0,33,19,14
2021,210669,40,2,3,2,1
2021,210669,40,3,23,14,9
2021,210669,40,4,7,3,4
2021,210669,41,0,28,15,13
2021,210669,41,2,3,2,1
2021,210669,41,3,18,10,8
2021,210669,41,4,7,3,4
2021,210669,42,0,5,4,1
2021,210669,42,3,5,4,1
2021,210669,44,0,28,15,13
2021,210669,44,2,3,2,1
2021,210669,44,3,18,10,8
2021,210669,44,4,7,3,4
2021,210739,0,0,134,61,73
2021,210739,10,0,134,61,73
2021,210739,10,1,15,8,7
2021,210739,10,2,48,22,26
2021,210739,10,3,63,28,35
2021,210739,10,4,8,3,5
2021,210739,20,0,50,26,24
2021,210739,20,1,13,8,5
2021,210739,20,2,37,18,19
2021,210739,30,0,56,27,29
2021,210739,30,1,2,0,2
2021,210739,30,2,8,4,4
2021,210739,30,3,45,23,22
2021,210739,30,4,1,0,1
2021,210739,40,0,28,8,20
2021,210739,40,2,3,0,3
2021,210739,40,3,18,5,13
2021,210739,40,4,7,3,4
2021,210739,41,0,3,1,2
2021,210739,41,3,2,1,1
2021,210739,41,4,1,0,1
2021,210739,42,0,25,7,18
2021,210739,42,2,3,0,3
2021,210739,42,3,16,4,12
2021,210739,42,4,6,3,3
2021,210739,44,0,3,1,2
2021,210739,44,3,2,1,1
2021,210739,44,4,1,0,1
2021,210775,0,0,111,46,65
2021,210775,10,0,111,46,65
2021,210775,10,1,9,5,4
2021,210775,10,2,35,21,14
2021,210775,10,3,45,16,29
2021,210775,10,4,22,4,18
2021,210775,20,0,49,28,21
2021,210775,20,1,9,5,4
2021,210775,20,2,34,20,14
2021,210775,20,3,6,3,3
2021,210775,30,0,28,10,18
2021,210775,30,2,1,1,0
2021,210775,30,3,27,9,18
2021,210775,40,0,34,8,26
2021,210775,40,3,12,4,8
2021,210775,40,4,22,4,18
2021,210775,41,0,13,3,10
2021,210775,41,3,7,2,5
2021,210775,41,4,6,1,5
2021,210775,42,0,21,5,16
2021,210775,42,3,5,2,3
2021,210775,42,4,16,3,13
2021,210775,44,0,13,3,10
2021,210775,44,3,7,2,5
2021,210775,44,4,6,1,5
2021,210809,0,0,19,11,8
2021,210809,10,0,19,11,8
2021,210809,10,1,2,2,0
2021,210809,10,2,3,1,2
2021,210809,10,3,11,6,5
2021,210809,10,4,3,2,1
2021,210809,40,0,19,11,8
2021,210809,40,1,2,2,0
2021,210809,40,2,3,1,2
2021,210809,40,3,11,6,5
2021,210809,40,4,3,2,1
2021,210809,41,0,19,11,8
2021,210809,41,1,2,2,0
2021,210809,41,2,3,1,2
2021,210809,41,3,11,6,5
2021,210809,41,4,3,2,1
2021,210809,44,0,19,11,8
2021,210809,44,1,2,2,0
2021,210809,44,2,3,1,2
2021,210809,44,3,11,6,5
2021,210809,44,4,3,2,1
2021,211024,0,0,22,10,12
2021,211024,10,0,22,10,12
2021,211024,10,1,12,8,4
2021,211024,10,2,7,1,6
2021,211024,10,3,2,1,1
2021,211024,10,4,1,0,1
2021,211024,40,0,22,10,12
2021,211024,40,1,12,8,4
2021,211024,40,2,7,1,6
2021,211024,40,3,2,1,1
2021,211024,40,4,1,0,1
2021,211024,42,0,22,10,12
2021,211024,42,1,12,8,4
2021,211024,42,2,7,1,6
2021,211024,42,3,2,1,1
2021,211024,42,4,1,0,1
2021,211079,0,0,42,15,27
2021,211079,10,0,41,15,26
2021,211079,10,1,8,1,7
2021,211079,10,2,9,3,6
2021,211079,10,3,19,10,9
2021,211079,10,4,1,0,1
2021,211079,10,5,4,1,3
2021,211079,20,0,22,5,17
2021,211079,20,1,8,1,7
2021,211079,20,2,9,3,6
2021,211079,20,3,5,1,4
2021,211079,30,0,15,9,6
2021,211079,30,3,14,9,5
2021,211079,30,4,1,0,1
2021,211079,40,0,4,1,3
2021,211079,40,5,4,1,3
2021,211079,43,0,4,1,3
2021,211079,43,5,4,1,3
2021,211079,50,0,1,0,1
2021,211088,0,0,152,57,95
2021,211088,10,0,152,57,95
2021,211088,10,1,27,16,11
2021,211088,10,2,52,17,35
2021,211088,10,3,67,21,46
2021,211088,10,4,6,3,3
2021,211088,20,0,77,33,44
2021,211088,20,1,26,16,10
2021,211088,20,2,45,15,30
2021,211088,20,3,6,2,4
2021,211088,30,0,24,13,11
2021,211088,30,2,3,2,1
2021,211088,30,3,21,11,10
2021,211088,40,0,51,11,40
2021,211088,40,1,1,0,1
2021,211088,40,2,4,0,4
2021,211088,40,3,40,8,32
2021,211088,40,4,6,3,3
2021,211088,42,0,51,11,40
2021,211088,42,1,1,0,1
2021,211088,42,2,4,0,4
2021,211088,42,3,40,8,32
2021,211088,42,4,6,3,3
2021,211130,0,0,7,6,1
2021,211130,10,0,7,6,1
2021,211130,10,1,3,3,0
2021,211130,10,2,3,3,0
2021,211130,10,3,1,0,1
2021,211130,40,0,7,6,1
2021,211130,40,1,3,3,0
2021,211130,40,2,3,3,0
2021,211130,40,3,1,0,1
2021,211130,41,0,7,6,1
2021,211130,41,1,3,3,0
2021,211130,41,2,3,3,0
2021,211130,41,3,1,0,1
2021,211130,44,0,7,6,1
2021,211130,44,1,3,3,0
2021,211130,44,2,3,3,0
2021,211130,44,3,1,0,1
2021,211158,0,0,335,178,157
2021,211158,10,0,335,178,157
2021,211158,10,1,111,79,32
2021,211158,10,2,107,53,54
2021,211158,10,3,85,33,52
2021,211158,10,4,32,13,19
2021,211158,20,0,228,131,97
2021,211158,20,1,111,79,32
2021,211158,20,2,95,46,49
2021,211158,20,3,21,6,15
2021,211158,20,4,1,0,1
2021,211158,30,0,78,34,44
2021,211158,30,2,12,7,5
2021,211158,30,3,62,27,35
2021,211158,30,4,4,0,4
2021,211158,40,0,29,13,16
2021,211158,40,3,2,0,2
2021,211158,40,4,27,13,14
2021,211158,42,0,29,13,16
2021,211158,42,3,2,0,2
2021,211158,42,4,27,13,14
2021,211273,0,0,175,61,114
2021,211273,10,0,175,61,114
2021,211273,10,1,43,18,25
2021,211273,10,2,45,18,27
2021,211273,10,3,37,12,25
2021,211273,10,4,6,1,5
2021,211273,10,5,44,12,32
2021,211273,20,0,88,36,52
2021,211273,20,1,43,18,25
2021,211273,20,2,45,18,27
2021,211273,30,0,37,12,25
2021,211273,30,3,37,12,25
2021,211273,40,0,50,13,37
2021,211273,40,4,6,1,5
2021,211273,40,5,44,12,32
2021,211273,41,0,21,6,15
2021,211273,41,5,21,6,15
2021,211273,43,0,29,7,22
2021,211273,43,4,6,1,5
2021,211273,43,5,23,6,17
2021,211273,45,0,21,6,15
2021,211273,45,5,21,6,15
2021,211291,0,0,386,218,168
2021,211291,10,0,386,218,168
2021,211291,10,1,127,81,46
2021,211291,10,2,131,71,60
2021,211291,10,3,101,55,46
2021,211291,10,4,27,11,16
2021,211291,20,0,250,148,102
2021,211291,20,1,124,79,45
2021,211291,20,2,126,69,57
2021,211291,30,0,99,55,44
2021,211291,30,1,1,1,0
2021,211291,30,2,3,1,2
2021,211291,30,3,95,53,42
2021,211291,40,0,37,15,22
2021,211291,40,1,2,1,1
2021,211291,40,2,2,1,1
2021,211291,40,3,6,2,4
2021,211291,40,4,27,11,16
2021,211291,41,0,11,4,7
2021,211291,41,1,2,1,1
2021,211291,41,2,1,1,0
2021,211291,41,3,4,1,3
2021,211291,41,4,4,1,3
2021,211291,42,0,26,11,15
2021,211291,42,2,1,0,1
2021,211291,42,3,2,1,1
2021,211291,42,4,23,10,13
2021,211291,44,0,11,4,7
2021,211291,44,1,2,1,1
2021,211291,44,2,1,1,0
2021,211291,44,3,4,1,3
2021,211291,44,4,4,1,3
2021,211307,0,0,128,46,82
2021,211307,10,0,124,45,79
2021,211307,10,1,59,25,34
2021,211307,10,2,41,15,26
2021,211307,10,3,16,3,13
2021,211307,10,4,5,1,4
2021,211307,10,6,3,1,2
2021,211307,20,0,89,35,54
2021,211307,20,1,58,24,34
2021,211307,20,2,29,10,19
2021,211307,20,3,2,1,1
2021,211307,30,0,28,9,19
2021,211307,30,1,1,1,0
2021,211307,30,2,11,5,6
2021,211307,30,3,11,2,9
2021,211307,30,4,4,1,3
2021,211307,30,6,1,0,1
2021,211307,40,0,7,1,6
2021,211307,40,2,1,0,1
2021,211307,40,3,3,0,3
2021,211307,40,4,1,0,1
2021,211307,40,6,2,1,1
2021,211307,42,0,6,1,5
2021,211307,42,2,1,0,1
2021,211307,42,3,2,0,2
2021,211307,42,4,1,0,1
2021,211307,42,6,2,1,1
2021,211307,43,0,1,0,1
2021,211307,43,3,1,0,1
2021,211307,50,0,4,1,3
2021,211343,0,0,60,22,38
2021,211343,10,0,60,22,38
2021,211343,10,1,14,5,9
2021,211343,10,2,15,6,9
2021,211343,10,3,7,5,2
2021,211343,10,4,23,6,17
2021,211343,10,6,1,0,1
2021,211343,20,0,46,19,27
2021,211343,20,1,14,5,9
2021,211343,20,2,15,6,9
2021,211343,20,3,7,5,2
2021,211343,20,4,10,3,7
2021,211343,30,0,13,3,10
2021,211343,30,4,13,3,10
2021,211343,40,0,1,0,1
2021,211343,40,6,1,0,1
2021,211343,43,0,1,0,1
2021,211343,43,6,1,0,1
2021,211352,0,0,64,26,38
2021,211352,10,0,64,26,38
2021,211352,10,1,13,2,11
2021,211352,10,2,17,7,10
2021,211352,10,3,32,15,17
2021,211352,10,4,2,2,0
2021,211352,20,0,30,9,21
2021,211352,20,1,13,2,11
2021,211352,20,2,17,7,10
2021,211352,30,0,27,14,13
2021,211352,30,3,26,13,13
2021,211352,30,4,1,1,0
2021,211352,40,0,7,3,4
2021,211352,40,3,6,2,4
2021,211352,40,4,1,1,0
2021,211352,41,0,4,2,2
2021,211352,41,3,3,1,2
2021,211352,41,4,1,1,0
2021,211352,42,0,3,1,2
2021,211352,42,3,3,1,2
2021,211352,44,0,4,2,2
2021,211352,44,3,3,1,2
2021,211352,44,4,1,1,0
2021,211361,0,0,227,107,120
2021,211361,10,0,227,107,120
2021,211361,10,1,83,40,43
2021,211361,10,2,67,38,29
2021,211361,10,3,52,22,30
2021,211361,10,4,25,7,18
2021,211361,20,0,156,78,78
2021,211361,20,1,83,40,43
2021,211361,20,2,55,31,24
2021,211361,20,3,17,7,10
2021,211361,20,4,1,0,1
2021,211361,30,0,44,20,24
2021,211361,30,2,11,6,5
2021,211361,30,3,32,14,18
2021,211361,30,4,1,0,1
2021,211361,40,0,27,9,18
2021,211361,40,2,1,1,0
2021,211361,40,3,3,1,2
2021,211361,40,4,23,7,16
2021,211361,42,0,27,9,18
2021,211361,42,2,1,1,0
2021,211361,42,3,3,1,2
2021,211361,42,4,23,7,16
2021,211431,0,0,105,23,82
2021,211431,10,0,105,23,82
2021,211431,10,1,25,9,16
2021,211431,10,2,24,5,19
2021,211431,10,3,37,7,30
2021,211431,10,4,19,2,17
2021,211431,20,0,35,11,24
2021,211431,20,1,23,8,15
2021,211431,20,2,12,3,9
2021,211431,30,0,37,7,30
2021,211431,30,1,2,1,1
2021,211431,30,2,9,2,7
2021,211431,30,3,25,4,21
2021,211431,30,4,1,0,1
2021,211431,40,0,33,5,28
2021,211431,40,2,3,0,3
2021,211431,40,3,12,3,9
2021,211431,40,4,18,2,16
2021,211431,42,0,33,5,28
2021,211431,42,2,3,0,3
2021,211431,42,3,12,3,9
2021,211431,42,4,18,2,16
2021,211440,0,0,1309,891,418
2021,211440,10,0,1146,783,363
2021,211440,10,1,415,319,96
2021,211440,10,2,291,199,92
2021,211440,10,3,253,145,108
2021,211440,10,6,187,120,67
2021,211440,20,0,482,376,106
2021,211440,20,1,352,283,69
2021,211440,20,2,130,93,37
2021,211440,30,0,265,163,102
2021,211440,30,1,2,1,1
2021,211440,30,2,87,59,28
2021,211440,30,3,176,103,73
2021,211440,40,0,399,244,155
2021,211440,40,1,61,35,26
2021,211440,40,2,74,47,27
2021,211440,40,3,77,42,35
2021,211440,40,6,187,120,67
2021,211440,41,0,212,124,88
2021,211440,41,1,61,35,26
2021,211440,41,2,74,47,27
2021,211440,41,3,77,42,35
2021,211440,42,0,187,120,67
2021,211440,42,6,187,120,67
2021,211440,44,0,212,124,88
2021,211440,44,1,61,35,26
2021,211440,44,2,74,47,27
2021,211440,44,3,77,42,35
2021,211440,50,0,163,108,55
2021,211468,0,0,75,21,54
2021,211468,10,0,75,21,54
2021,211468,10,1,19,7,12
2021,211468,10,2,17,7,10
2021,211468,10,3,27,7,20
2021,211468,10,4,12,0,12
2021,211468,20,0,29,11,18
2021,211468,20,1,19,7,12
2021,211468,20,2,10,4,6
2021,211468,30,0,7,3,4
2021,211468,30,2,4,2,2
2021,211468,30,3,3,1,2
2021,211468,40,0,39,7,32
2021,211468,40,2,3,1,2
2021,211468,40,3,24,6,18
2021,211468,40,4,12,0,12
2021,211468,41,0,3,2,1
2021,211468,41,2,1,1,0
2021,211468,41,3,2,1,1
2021,211468,42,0,36,5,31
2021,211468,42,2,2,0,2
2021,211468,42,3,22,5,17
2021,211468,42,4,12,0,12
2021,211468,44,0,3,2,1
2021,211468,44,2,1,1,0
2021,211468,44,3,2,1,1
2021,211477,0,0,34,17,17
2021,211477,10,0,34,17,17
2021,211477,10,1,3,1,2
2021,211477,10,2,7,4,3
2021,211477,10,3,12,7,5
2021,211477,10,4,9,4,5
2021,211477,10,5,3,1,2
2021,211477,40,0,34,17,17
2021,211477,40,1,3,1,2
2021,211477,40,2,7,4,3
2021,211477,40,3,12,7,5
2021,211477,40,4,9,4,5
2021,211477,40,5,3,1,2
2021,211477,41,0,27,15,12
2021,211477,41,1,3,1,2
2021,211477,41,2,6,4,2
2021,211477,41,3,11,6,5
2021,211477,41,4,7,4,3
2021,211477,42,0,7,2,5
2021,211477,42,2,1,0,1
2021,211477,42,3,1,1,0
2021,211477,42,4,2,0,2
2021,211477,42,5,3,1,2
2021,211477,44,0,27,15,12
2021,211477,44,1,3,1,2
2021,211477,44,2,6,4,2
2021,211477,44,3,11,6,5
2021,211477,44,4,7,4,3
2021,211556,0,0,130,44,86
2021,211556,10,0,130,44,86
2021,211556,10,1,17,5,12
2021,211556,10,2,46,15,31
2021,211556,10,3,66,23,43
2021,211556,10,4,1,1,0
2021,211556,20,0,5,1,4
2021,211556,20,1,5,1,4
2021,211556,40,0,125,43,82
2021,211556,40,1,12,4,8
2021,211556,40,2,46,15,31
2021,211556,40,3,66,23,43
2021,211556,40,4,1,1,0
2021,211556,41,0,125,43,82
2021,211556,41,1,12,4,8
2021,211556,41,2,46,15,31
2021,211556,41,3,66,23,43
2021,211556,41,4,1,1,0
2021,211556,44,0,125,43,82
2021,211556,44,1,12,4,8
2021,211556,44,2,46,15,31
2021,211556,44,3,66,23,43
2021,211556,44,4,1,1,0
2021,211583,0,0,66,25,41
2021,211583,10,0,66,25,41
2021,211583,10,1,13,5,8
2021,211583,10,2,19,6,13
2021,211583,10,3,28,12,16
2021,211583,10,4,6,2,4
2021,211583,20,0,27,10,17
2021,211583,20,1,13,5,8
2021,211583,20,2,14,5,9
2021,211583,30,0,13,6,7
2021,211583,30,2,1,0,1
2021,211583,30,3,12,6,6
2021,211583,40,0,26,9,17
2021,211583,40,2,4,1,3
2021,211583,40,3,16,6,10
2021,211583,40,4,6,2,4
2021,211583,42,0,23,7,16
2021,211583,42,2,3,1,2
2021,211583,42,3,14,4,10
2021,211583,42,4,6,2,4
2021,211583,43,0,3,2,1
2021,211583,43,2,1,0,1
2021,211583,43,3,2,2,0
2021,211608,0,0,31,16,15
2021,211608,10,0,31,16,15
2021,211608,10,1,15,8,7
2021,211608,10,2,8,5,3
2021,211608,10,3,6,2,4
2021,211608,10,4,2,1,1
2021,211608,20,0,22,11,11
2021,211608,20,1,14,7,7
2021,211608,20,2,7,4,3
2021,211608,20,3,1,0,1
2021,211608,30,0,6,3,3
2021,211608,30,2,1,1,0
2021,211608,30,3,5,2,3
2021,211608,40,0,3,2,1
2021,211608,40,1,1,1,0
2021,211608,40,4,2,1,1
2021,211608,42,0,3,2,1
2021,211608,42,1,1,1,0
2021,211608,42,4,2,1,1
2021,211644,0,0,164,72,92
2021,211644,10,0,164,72,92
2021,211644,10,1,60,38,22
2021,211644,10,2,35,11,24
2021,211644,10,3,48,18,30
2021,211644,10,4,21,5,16
2021,211644,20,0,116,58,58
2021,211644,20,1,56,35,21
2021,211644,20,2,32,9,23
2021,211644,20,3,26,14,12
2021,211644,20,4,2,0,2
2021,211644,30,0,31,11,20
2021,211644,30,1,4,3,1
2021,211644,30,2,3,2,1
2021,211644,30,3,22,4,18
2021,211644,30,4,2,2,0
2021,211644,40,0,17,3,14
2021,211644,40,4,17,3,14
2021,211644,42,0,17,3,14
2021,211644,42,4,17,3,14
2021,211893,0,0,4,2,2
2021,211893,10,0,4,2,2
2021,211893,10,6,4,2,2
2021,211893,40,0,4,2,2
2021,211893,40,6,4,2,2
2021,211893,42,0,4,2,2
2021,211893,42,6,4,2,2
2021,211927,0,0,125,55,70
2021,211927,10,0,125,55,70
2021,211927,10,1,50,23,27
2021,211927,10,2,58,20,38
2021,211927,10,3,15,10,5
2021,211927,10,4,2,2,0
2021,211927,20,0,110,45,65
2021,211927,20,1,50,23,27
2021,211927,20,2,58,20,38
2021,211927,20,3,2,2,0
2021,211927,30,0,13,8,5
2021,211927,30,3,13,8,5
2021,211927,40,0,2,2,0
2021,211927,40,4,2,2,0
2021,211927,42,0,2,2,0
2021,211927,42,4,2,2,0
2021,211981,0,0,84,44,40
2021,211981,10,0,84,44,40
2021,211981,10,1,27,16,11
2021,211981,10,2,27,19,8
2021,211981,10,3,25,8,17
2021,211981,10,4,4,1,3
2021,211981,10,5,1,0,1
2021,211981,20,0,43,29,14
2021,211981,20,1,27,16,11
2021,211981,20,2,12,11,1
2021,211981,20,3,4,2,2
2021,211981,30,0,15,7,8
2021,211981,30,2,7,4,3
2021,211981,30,3,7,3,4
2021,211981,30,4,1,0,1
2021,211981,40,0,26,8,18
2021,211981,40,2,8,4,4
2021,211981,40,3,14,3,11
2021,211981,40,4,3,1,2
2021,211981,40,5,1,0,1
2021,211981,41,0,16,7,9
2021,211981,41,2,7,4,3
2021,211981,41,3,9,3,6
2021,211981,42,0,10,1,9
2021,211981,42,2,1,0,1
2021,211981,42,3,5,0,5
2021,211981,42,4,3,1,2
2021,211981,42,5,1,0,1
2021,211981,44,0,16,7,9
2021,211981,44,2,7,4,3
2021,211981,44,3,9,3,6
2021,212009,0,0,219,103,116
2021,212009,10,0,219,103,116
2021,212009,10,1,58,35,23
2021,212009,10,2,83,39,44
2021,212009,10,3,61,23,38
2021,212009,10,4,16,6,10
2021,212009,10,6,1,0,1
2021,212009,20,0,136,72,64
2021,212009,20,1,58,35,23
2021,212009,20,2,76,36,40
2021,212009,20,3,2,1,1
2021,212009,30,0,51,21,30
2021,212009,30,2,7,3,4
2021,212009,30,3,43,17,26
2021,212009,30,4,1,1,0
2021,212009,40,0,32,10,22
2021,212009,40,3,16,5,11
2021,212009,40,4,15,5,10
2021,212009,40,6,1,0,1
2021,212009,42,0,31,10,21
2021,212009,42,3,16,5,11
2021,212009,42,4,15,5,10
2021,212009,43,0,1,0,1
2021,212009,43,6,1,0,1
2021,212045,0,0,9,4,5
2021,212045,10,0,9,4,5
2021,212045,10,4,9,4,5
2021,212045,40,0,9,4,5
2021,212045,40,4,9,4,5
2021,212045,41,0,9,4,5
2021,212045,41,4,9,4,5
2021,212045,45,0,9,4,5
2021,212045,45,4,9,4,5
2021,212054,0,0,1199,615,584
2021,212054,10,0,1199,615,584
2021,212054,10,1,264,191,73
2021,212054,10,2,222,113,109
2021,212054,10,3,111,59,52
2021,212054,10,4,602,252,350
2021,212054,20,0,468,289,179
2021,212054,20,1,256,185,71
2021,212054,20,2,209,102,107
2021,212054,20,3,3,2,1
2021,212054,30,0,129,74,55
2021,212054,30,1,8,6,2
2021,212054,30,2,13,11,2
2021,212054,30,3,108,57,51
2021,212054,40,0,602,252,350
2021,212054,40,4,602,252,350
2021,212054,41,0,571,241,330
2021,212054,41,4,571,241,330
2021,212054,42,0,31,11,20
2021,212054,42,4,31,11,20
2021,212054,44,0,571,241,330
2021,212054,44,4,571,241,330
2021,212106,0,0,452,213,239
2021,212106,10,0,452,213,239
2021,212106,10,1,85,57,28
2021,212106,10,2,192,96,96
2021,212106,10,3,145,47,98
2021,212106,10,4,22,8,14
2021,212106,10,6,8,5,3
2021,212106,20,0,255,150,105
2021,212106,20,1,85,57,28
2021,212106,20,2,170,93,77
2021,212106,30,0,65,22,43
2021,212106,30,2,5,0,5
2021,212106,30,3,60,22,38
2021,212106,40,0,132,41,91
2021,212106,40,2,17,3,14
2021,212106,40,3,85,25,60
2021,212106,40,4,22,8,14
2021,212106,40,6,8,5,3
2021,212106,42,0,132,41,91
2021,212106,42,2,17,3,14
2021,212106,42,3,85,25,60
2021,212106,42,4,22,8,14
2021,212106,42,6,8,5,3
2021,212115,0,0,219,120,99
2021,212115,10,0,219,120,99
2021,212115,10,1,90,60,30
2021,212115,10,2,59,27,32
2021,212115,10,3,39,19,20
2021,212115,10,4,31,14,17
2021,212115,20,0,130,77,53
2021,212115,20,1,87,58,29
2021,212115,20,2,36,16,20
2021,212115,20,3,6,3,3
2021,212115,20,4,1,0,1
2021,212115,30,0,65,31,34
2021,212115,30,1,3,2,1
2021,212115,30,2,23,11,12
2021,212115,30,3,32,16,16
2021,212115,30,4,7,2,5
2021,212115,40,0,24,12,12
2021,212115,40,3,1,0,1
2021,212115,40,4,23,12,11
2021,212115,41,0,5,2,3
2021,212115,41,3,1,0,1
2021,212115,41,4,4,2,2
2021,212115,42,0,19,10,9
2021,212115,42,4,19,10,9
2021,212115,44,0,5,2,3
2021,212115,44,3,1,0,1
2021,212115,44,4,4,2,2
2021,212133,0,0,106,46,60
2021,212133,10,0,106,46,60
2021,212133,10,1,27,16,11
2021,212133,10,2,23,12,11
2021,212133,10,3,28,8,20
2021,212133,10,5,19,5,14
2021,212133,10,6,9,5,4
2021,212133,20,0,33,20,13
2021,212133,20,1,23,14,9
2021,212133,20,2,10,6,4
2021,212133,30,0,39,15,24
2021,212133,30,1,4,2,2
2021,212133,30,2,11,6,5
2021,212133,30,3,24,7,17
2021,212133,40,0,34,11,23
2021,212133,40,2,2,0,2
2021,212133,40,3,4,1,3
2021,212133,40,5,19,5,14
2021,212133,40,6,9,5,4
2021,212133,42,0,34,11,23
2021,212133,42,2,2,0,2
2021,212133,42,3,4,1,3
2021,212133,42,5,19,5,14
2021,212133,42,6,9,5,4
2021,212160,0,0,209,109,100
2021,212160,10,0,209,109,100
2021,212160,10,1,82,51,31
2021,212160,10,2,55,30,25
2021,212160,10,3,52,22,30
2021,212160,10,4,20,6,14
2021,212160,20,0,160,96,64
2021,212160,20,1,82,51,31
2021,212160,20,2,53,29,24
2021,212160,20,3,24,16,8
2021,212160,20,4,1,0,1
2021,212160,30,0,31,7,24
2021,212160,30,2,2,1,1
2021,212160,30,3,26,6,20
2021,212160,30,4,3,0,3
2021,212160,40,0,18,6,12
2021,212160,40,3,2,0,2
2021,212160,40,4,16,6,10
2021,212160,41,0,3,0,3
2021,212160,41,4,3,0,3
2021,212160,42,0,15,6,9
2021,212160,42,3,2,0,2
2021,212160,42,4,13,6,7
2021,212160,44,0,3,0,3
2021,212160,44,4,3,0,3
2021,212197,0,0,104,48,56
2021,212197,10,0,104,48,56
2021,212197,10,1,33,19,14
2021,212197,10,2,40,20,20
2021,212197,10,3,13,5,8
2021,212197,10,5,18,4,14
2021,212197,20,0,69,37,32
2021,212197,20,1,33,19,14
2021,212197,20,2,36,18,18
2021,212197,30,0,17,7,10
2021,212197,30,2,4,2,2
2021,212197,30,3,13,5,8
2021,212197,40,0,18,4,14
2021,212197,40,5,18,4,14
2021,212197,42,0,18,4,14
2021,212197,42,5,18,4,14
2021,212434,0,0,27,19,8
2021,212434,50,0,27,19,8
2021,212577,0,0,233,121,112
2021,212577,10,0,215,116,99
2021,212577,10,1,81,53,28
2021,212577,10,2,71,34,37
2021,212577,10,3,58,28,30
2021,212577,10,4,5,1,4
2021,212577,20,0,152,87,65
2021,212577,20,1,81,53,28
2021,212577,20,2,71,34,37
2021,212577,30,0,39,16,23
2021,212577,30,3,39,16,23
2021,212577,40,0,24,13,11
2021,212577,40,3,19,12,7
2021,212577,40,4,5,1,4
2021,212577,41,0,8,4,4
2021,212577,41,3,6,3,3
2021,212577,41,4,2,1,1
2021,212577,42,0,16,9,7
2021,212577,42,3,13,9,4
2021,212577,42,4,3,0,3
2021,212577,44,0,8,4,4
2021,212577,44,3,6,3,3
2021,212577,44,4,2,1,1
2021,212577,50,0,18,5,13
2021,212601,0,0,244,119,125
2021,212601,10,0,244,119,125
2021,212601,10,1,36,24,12
2021,212601,10,2,80,41,39
2021,212601,10,3,113,48,65
2021,212601,10,4,15,6,9
2021,212601,20,0,90,54,36
2021,212601,20,1,33,22,11
2021,212601,20,2,46,26,20
2021,212601,20,3,11,6,5
2021,212601,30,0,83,35,48
2021,212601,30,1,2,1,1
2021,212601,30,2,22,14,8
2021,212601,30,3,59,20,39
2021,212601,40,0,71,30,41
2021,212601,40,1,1,1,0
2021,212601,40,2,12,1,11
2021,212601,40,3,43,22,21
2021,212601,40,4,15,6,9
2021,212601,42,0,71,30,41
2021,212601,42,1,1,1,0
2021,212601,42,2,12,1,11
2021,212601,42,3,43,22,21
2021,212601,42,4,15,6,9
2021,212656,0,0,62,41,21
2021,212656,10,0,62,41,21
2021,212656,10,1,26,19,7
2021,212656,10,2,27,19,8
2021,212656,10,3,9,3,6
2021,212656,20,0,35,28,7
2021,212656,20,1,24,18,6
2021,212656,20,2,11,10,1
2021,212656,30,0,11,5,6
2021,212656,30,1,2,1,1
2021,212656,30,2,6,3,3
2021,212656,30,3,3,1,2
2021,212656,40,0,16,8,8
2021,212656,40,2,10,6,4
2021,212656,40,3,6,2,4
2021,212656,42,0,16,8,8
2021,212656,42,2,10,6,4
2021,212656,42,3,6,2,4
2021,212674,0,0,226,122,104
2021,212674,10,0,226,122,104
2021,212674,10,1,61,36,25
2021,212674,10,2,86,54,32
2021,212674,10,3,62,24,38
2021,212674,10,4,2,1,1
2021,212674,10,5,15,7,8
2021,212674,20,0,147,90,57
2021,212674,20,1,61,36,25
2021,212674,20,2,86,54,32
2021,212674,30,0,43,19,24
2021,212674,30,3,43,19,24
2021,212674,40,0,36,13,23
2021,212674,40,3,19,5,14
2021,212674,40,4,2,1,1
2021,212674,40,5,15,7,8
2021,212674,41,0,15,7,8
2021,212674,41,4,1,0,1
2021,212674,41,5,14,7,7
2021,212674,42,0,21,6,15
2021,212674,42,3,19,5,14
2021,212674,42,4,1,1,0
2021,212674,42,5,1,0,1
2021,212674,44,0,5,2,3
2021,212674,44,5,5,2,3
2021,212674,45,0,10,5,5
2021,212674,45,4,1,0,1
2021,212674,45,5,9,5,4
2021,212771,0,0,2,1,1
2021,212771,10,0,2,1,1
2021,212771,10,1,2,1,1
2021,212771,40,0,2,1,1
2021,212771,40,1,2,1,1
2021,212771,41,0,2,1,1
2021,212771,41,1,2,1,1
2021,212771,44,0,2,1,1
2021,212771,44,1,2,1,1
2021,212832,0,0,87,17,70
2021,212832,10,0,87,17,70
2021,212832,10,1,9,4,5
2021,212832,10,2,12,7,5
2021,212832,10,3,43,2,41
2021,212832,10,4,23,4,19
2021,212832,20,0,15,7,8
2021,212832,20,1,7,3,4
2021,212832,20,2,7,4,3
2021,212832,20,3,1,0,1
2021,212832,30,0,10,2,8
2021,212832,30,2,1,1,0
2021,212832,30,3,9,1,8
2021,212832,40,0,62,8,54
2021,212832,40,1,2,1,1
2021,212832,40,2,4,2,2
2021,212832,40,3,33,1,32
2021,212832,40,4,23,4,19
2021,212832,41,0,31,4,27
2021,212832,41,1,1,1,0
2021,212832,41,2,3,2,1
2021,212832,41,3,20,1,19
2021,212832,41,4,7,0,7
2021,212832,42,0,31,4,27
2021,212832,42,1,1,0,1
2021,212832,42,2,1,0,1
2021,212832,42,3,13,0,13
2021,212832,42,4,16,4,12
2021,212832,44,0,31,4,27
2021,212832,44,1,1,1,0
2021,212832,44,2,3,2,1
2021,212832,44,3,20,1,19
2021,212832,44,4,7,0,7
2021,212869,0,0,58,12,46
2021,212869,10,0,58,12,46
2021,212869,10,1,6,2,4
2021,212869,10,2,21,3,18
2021,212869,10,3,15,4,11
2021,212869,10,4,16,3,13
2021,212869,20,0,3,1,2
2021,212869,20,1,3,1,2
2021,212869,40,0,55,11,44
2021,212869,40,1,3,1,2
2021,212869,40,2,21,3,18
2021,212869,40,3,15,4,11
2021,212869,40,4,16,3,13
2021,212869,42,0,55,11,44
2021,212869,42,1,3,1,2
2021,212869,42,2,21,3,18
2021,212869,42,3,15,4,11
2021,212869,42,4,16,3,13
2021,212878,0,0,275,91,184
2021,212878,10,0,275,91,184
2021,212878,10,1,116,44,72
2021,212878,10,2,83,28,55
2021,212878,10,3,50,10,40
2021,212878,10,4,23,7,16
2021,212878,10,6,3,2,1
2021,212878,20,0,216,75,141
2021,212878,20,1,116,44,72
2021,212878,20,2,69,24,45
2021,212878,20,3,31,7,24
2021,212878,30,0,56,14,42
2021,212878,30,2,14,4,10
2021,212878,30,3,19,3,16
2021,212878,30,4,23,7,16
2021,212878,40,0,3,2,1
2021,212878,40,6,3,2,1
2021,212878,42,0,3,2,1
2021,212878,42,6,3,2,1
2021,212911,0,0,168,79,89
2021,212911,10,0,168,79,89
2021,212911,10,1,52,32,20
2021,212911,10,2,40,14,26
2021,212911,10,3,71,31,40
2021,212911,10,4,1,0,1
2021,212911,10,5,4,2,2
2021,212911,20,0,85,44,41
2021,212911,20,1,49,31,18
2021,212911,20,2,36,13,23
2021,212911,30,0,26,12,14
2021,212911,30,3,26,12,14
2021,212911,40,0,57,23,34
2021,212911,40,1,3,1,2
2021,212911,40,2,4,1,3
2021,212911,40,3,45,19,26
2021,212911,40,4,1,0,1
2021,212911,40,5,4,2,2
2021,212911,41,0,57,23,34
2021,212911,41,1,3,1,2
2021,212911,41,2,4,1,3
2021,212911,41,3,45,19,26
2021,212911,41,4,1,0,1
2021,212911,41,5,4,2,2
2021,212911,44,0,57,23,34
2021,212911,44,1,3,1,2
2021,212911,44,2,4,1,3
2021,212911,44,3,45,19,26
2021,212911,44,4,1,0,1
2021,212911,44,5,4,2,2
2021,212975,0,0,26,16,10
2021,212975,50,0,26,16,10
2021,212984,0,0,77,24,53
2021,212984,10,0,77,24,53
2021,212984,10,1,18,4,14
2021,212984,10,2,14,8,6
2021,212984,10,3,32,10,22
2021,212984,10,4,13,2,11
2021,212984,40,0,77,24,53
2021,212984,40,1,18,4,14
2021,212984,40,2,14,8,6
2021,212984,40,3,32,10,22
2021,212984,40,4,13,2,11
2021,212984,41,0,23,7,16
2021,212984,41,1,16,3,13
2021,212984,41,2,6,3,3
2021,212984,41,3,1,1,0
2021,212984,42,0,54,17,37
2021,212984,42,1,2,1,1
2021,212984,42,2,8,5,3
2021,212984,42,3,31,9,22
2021,212984,42,4,13,2,11
2021,212984,44,0,23,7,16
2021,212984,44,1,16,3,13
2021,212984,44,2,6,3,3
2021,212984,44,3,1,1,0
2021,213011,0,0,78,24,54
2021,213011,10,0,78,24,54
2021,213011,10,1,23,8,15
2021,213011,10,2,12,4,8
2021,213011,10,3,28,5,23
2021,213011,10,4,7,3,4
2021,213011,10,6,8,4,4
2021,213011,20,0,22,7,15
2021,213011,20,1,21,7,14
2021,213011,20,2,1,0,1
2021,213011,30,0,48,13,35
2021,213011,30,1,2,1,1
2021,213011,30,2,11,4,7
2021,213011,30,3,28,5,23
2021,213011,30,4,7,3,4
2021,213011,40,0,8,4,4
2021,213011,40,6,8,4,4
2021,213011,42,0,8,4,4
2021,213011,42,6,8,4,4
2021,213020,0,0,351,176,175
2021,213020,10,0,351,176,175
2021,213020,10,1,163,103,60
2021,213020,10,2,129,56,73
2021,213020,10,3,41,14,27
2021,213020,10,4,18,3,15
2021,213020,20,0,310,163,147
2021,213020,20,1,162,102,60
2021,213020,20,2,128,56,72
2021,213020,20,3,19,5,14
2021,213020,20,4,1,0,1
2021,213020,30,0,19,8,11
2021,213020,30,2,1,0,1
2021,213020,30,3,17,7,10
2021,213020,30,4,1,1,0
2021,213020,40,0,22,5,17
2021,213020,40,1,1,1,0
2021,213020,40,3,5,2,3
2021,213020,40,4,16,2,14
2021,213020,42,0,22,5,17
2021,213020,42,1,1,1,0
2021,213020,42,3,5,2,3
2021,213020,42,4,16,2,14
2021,213181,0,0,25,0,25
2021,213181,50,0,25,0,25
2021,213233,0,0,29,21,8
2021,213233,10,0,29,21,8
2021,213233,10,4,29,21,8
2021,213233,40,0,29,21,8
2021,213233,40,4,29,21,8
2021,213233,41,0,29,21,8
2021,213233,41,4,29,21,8
2021,213233,44,0,29,21,8
2021,213233,44,4,29,21,8
2021,213251,0,0,97,57,40
2021,213251,10,0,97,57,40
2021,213251,10,1,50,35,15
2021,213251,10,2,19,9,10
2021,213251,10,3,23,8,15
2021,213251,10,4,5,5,0
2021,213251,20,0,65,44,21
2021,213251,20,1,50,35,15
2021,213251,20,2,15,9,6
2021,213251,30,0,13,2,11
2021,213251,30,2,4,0,4
2021,213251,30,3,9,2,7
2021,213251,40,0,19,11,8
2021,213251,40,3,14,6,8
2021,213251,40,4,5,5,0
2021,213251,41,0,13,8,5
2021,213251,41,3,8,3,5
2021,213251,41,4,5,5,0
2021,213251,42,0,6,3,3
2021,213251,42,3,6,3,3
2021,213251,44,0,13,8,5
2021,213251,44,3,8,3,5
2021,213251,44,4,5,5,0
2021,213303,0,0,41,13,28
2021,213303,10,0,41,13,28
2021,213303,10,1,10,3,7
2021,213303,10,2,12,3,9
2021,213303,10,3,15,6,9
2021,213303,10,4,4,1,3
2021,213303,20,0,19,6,13
2021,213303,20,1,10,3,7
2021,213303,20,2,7,3,4
2021,213303,20,3,2,0,2
2021,213303,30,0,17,6,11
2021,213303,30,2,5,0,5
2021,213303,30,3,12,6,6
2021,213303,40,0,5,1,4
2021,213303,40,3,1,0,1
2021,213303,40,4,4,1,3
2021,213303,42,0,5,1,4
2021,213303,42,3,1,0,1
2021,213303,42,4,4,1,3
2021,213321,0,0,138,69,69
2021,213321,10,0,138,69,69
2021,213321,10,1,53,29,24
2021,213321,10,2,48,24,24
2021,213321,10,3,32,16,16
2021,213321,10,4,5,0,5
2021,213321,20,0,75,41,34
2021,213321,20,1,39,22,17
2021,213321,20,2,36,19,17
2021,213321,30,0,19,11,8
2021,213321,30,2,1,1,0
2021,213321,30,3,18,10,8
2021,213321,40,0,44,17,27
2021,213321,40,1,14,7,7
2021,213321,40,2,11,4,7
2021,213321,40,3,14,6,8
2021,213321,40,4,5,0,5
2021,213321,42,0,12,3,9
2021,213321,42,1,3,1,2
2021,213321,42,2,4,1,3
2021,213321,42,3,5,1,4
2021,213321,43,0,32,14,18
2021,213321,43,1,11,6,5
2021,213321,43,2,7,3,4
2021,213321,43,3,9,5,4
2021,213321,43,4,5,0,5
2021,213349,0,0,323,166,157
2021,213349,10,0,323,166,157
2021,213349,10,1,120,66,54
2021,213349,10,2,112,63,49
2021,213349,10,3,75,29,46
2021,213349,10,4,16,8,8
2021,213349,20,0,254,132,122
2021,213349,20,1,119,65,54
2021,213349,20,2,110,62,48
2021,213349,20,3,25,5,20
2021,213349,30,0,37,21,16
2021,213349,30,1,1,1,0
2021,213349,30,2,1,1,0
2021,213349,30,3,31,17,14
2021,213349,30,4,4,2,2
2021,213349,40,0,32,13,19
2021,213349,40,2,1,0,1
2021,213349,40,3,19,7,12
2021,213349,40,4,12,6,6
2021,213349,42,0,32,13,19
2021,213349,42,2,1,0,1
2021,213349,42,3,19,7,12
2021,213349,42,4,12,6,6
2021,213358,0,0,60,24,36
2021,213358,10,0,60,24,36
2021,213358,10,1,24,11,13
2021,213358,10,2,12,5,7
2021,213358,10,3,24,8,16
2021,213358,40,0,60,24,36
2021,213358,40,1,24,11,13
2021,213358,40,2,12,5,7
2021,213358,40,3,24,8,16
2021,213358,42,0,60,24,36
2021,213358,42,1,24,11,13
2021,213358,42,2,12,5,7
2021,213358,42,3,24,8,16
2021,213367,0,0,179,71,108
2021,213367,10,0,179,71,108
2021,213367,10,1,34,16,18
2021,213367,10,2,72,32,40
2021,213367,10,3,63,22,41
2021,213367,10,4,10,1,9
2021,213367,20,0,103,49,54
2021,213367,20,1,34,16,18
2021,213367,20,2,67,31,36
2021,213367,20,3,2,2,0
2021,213367,30,0,33,10,23
2021,213367,30,2,3,1,2
2021,213367,30,3,30,9,21
2021,213367,40,0,43,12,31
2021,213367,40,2,2,0,2
2021,213367,40,3,31,11,20
2021,213367,40,4,10,1,9
2021,213367,41,0,2,0,2
2021,213367,41,3,1,0,1
2021,213367,41,4,1,0,1
2021,213367,42,0,41,12,29
2021,213367,42,2,2,0,2
2021,213367,42,3,30,11,19
2021,213367,42,4,9,1,8
2021,213367,44,0,2,0,2
2021,213367,44,3,1,0,1
2021,213367,44,4,1,0,1
2021,213376,0,0,28,9,19
2021,213376,10,0,28,9,19
2021,213376,10,1,3,2,1
2021,213376,10,2,3,0,3
2021,213376,10,3,9,4,5
2021,213376,10,4,13,3,10
2021,213376,20,0,12,4,8
2021,213376,20,1,3,2,1
2021,213376,20,2,3,0,3
2021,213376,20,3,6,2,4
2021,213376,30,0,16,5,11
2021,213376,30,3,3,2,1
2021,213376,30,4,13,3,10
2021,213385,0,0,255,148,107
2021,213385,10,0,255,148,107
2021,213385,10,1,76,47,29
2021,213385,10,2,79,53,26
2021,213385,10,3,92,43,49
2021,213385,10,4,8,5,3
2021,213385,20,0,152,99,53
2021,213385,20,1,74,47,27
2021,213385,20,2,78,52,26
2021,213385,30,0,68,30,38
2021,213385,30,2,1,1,0
2021,213385,30,3,67,29,38
2021,213385,40,0,35,19,16
2021,213385,40,1,2,0,2
2021,213385,40,3,25,14,11
2021,213385,40,4,8,5,3
2021,213385,41,0,12,6,6
2021,213385,41,1,1,0,1
2021,213385,41,3,4,2,2
2021,213385,41,4,7,4,3
2021,213385,42,0,23,13,10
2021,213385,42,1,1,0,1
2021,213385,42,3,21,12,9
2021,213385,42,4,1,1,0
2021,213385,44,0,12,6,6
2021,213385,44,1,1,0,1
2021,213385,44,3,4,2,2
2021,213385,44,4,7,4,3
2021,213400,0,0,62,44,18
2021,213400,10,0,62,44,18
2021,213400,10,1,24,23,1
2021,213400,10,2,8,4,4
2021,213400,10,3,28,16,12
2021,213400,10,4,2,1,1
2021,213400,40,0,62,44,18
2021,213400,40,1,24,23,1
2021,213400,40,2,8,4,4
2021,213400,40,3,28,16,12
2021,213400,40,4,2,1,1
2021,213400,42,0,62,44,18
2021,213400,42,1,24,23,1
2021,213400,42,2,8,4,4
2021,213400,42,3,28,16,12
2021,213400,42,4,2,1,1
2021,213446,0,0,7,2,5
2021,213446,10,0,7,2,5
2021,213446,10,1,4,2,2
2021,213446,10,2,2,0,2
2021,213446,10,3,1,0,1
2021,213446,20,0,4,2,2
2021,213446,20,1,4,2,2
2021,213446,30,0,1,0,1
2021,213446,30,3,1,0,1
2021,213446,40,0,2,0,2
2021,213446,40,2,2,0,2
2021,213446,41,0,2,0,2
2021,213446,41,2,2,0,2
2021,213446,45,0,2,0,2
2021,213446,45,2,2,0,2
2021,213507,0,0,121,63,58
2021,213507,10,0,121,63,58
2021,213507,10,1,30,21,9
2021,213507,10,2,42,23,19
2021,213507,10,3,49,19,30
2021,213507,20,0,64,41,23
2021,213507,20,1,30,21,9
2021,213507,20,2,34,20,14
2021,213507,30,0,35,11,24
2021,213507,30,2,6,2,4
2021,213507,30,3,29,9,20
2021,213507,40,0,22,11,11
2021,213507,40,2,2,1,1
2021,213507,40,3,20,10,10
2021,213507,41,0,18,8,10
2021,213507,41,2,2,1,1
2021,213507,41,3,16,7,9
2021,213507,42,0,1,1,0
2021,213507,42,3,1,1,0
2021,213507,43,0,3,2,1
2021,213507,43,3,3,2,1
2021,213507,44,0,18,8,10
2021,213507,44,2,2,1,1
2021,213507,44,3,16,7,9
2021,213525,0,0,80,33,47
2021,213525,10,0,80,33,47
2021,213525,10,1,20,5,15
2021,213525,10,2,26,11,15
2021,213525,10,3,29,14,15
2021,213525,10,4,5,3,2
2021,213525,40,0,80,33,47
2021,213525,40,1,20,5,15
2021,213525,40,2,26,11,15
2021,213525,40,3,29,14,15
2021,213525,40,4,5,3,2
2021,213525,42,0,80,33,47
2021,213525,42,1,20,5,15
2021,213525,42,2,26,11,15
2021,213525,42,3,29,14,15
2021,213525,42,4,5,3,2
2021,213534,0,0,17,7,10
2021,213534,10,0,17,7,10
2021,213534,10,4,17,7,10
2021,213534,40,0,17,7,10
2021,213534,40,4,17,7,10
2021,213534,41,0,17,7,10
2021,213534,41,4,17,7,10
2021,213534,45,0,17,7,10
2021,213534,45,4,17,7,10
2021,213543,0,0,555,356,199
2021,213543,10,0,555,356,199
2021,213543,10,1,193,146,47
2021,213543,10,2,159,94,65
2021,213543,10,3,103,55,48
2021,213543,10,5,77,49,28
2021,213543,10,6,23,12,11
2021,213543,20,0,348,237,111
2021,213543,20,1,193,146,47
2021,213543,20,2,155,91,64
2021,213543,30,0,107,58,49
2021,213543,30,2,4,3,1
2021,213543,30,3,103,55,48
2021,213543,40,0,100,61,39
2021,213543,40,5,77,49,28
2021,213543,40,6,23,12,11
2021,213543,41,0,88,53,35
2021,213543,41,5,75,47,28
2021,213543,41,6,13,6,7
2021,213543,42,0,12,8,4
2021,213543,42,5,2,2,0
2021,213543,42,6,10,6,4
2021,213543,44,0,88,53,35
2021,213543,44,5,75,47,28
2021,213543,44,6,13,6,7
2021,213570,0,0,21,7,14
2021,213570,10,0,21,7,14
2021,213570,10,4,21,7,14
2021,213570,40,0,21,7,14
2021,213570,40,4,21,7,14
2021,213570,41,0,21,7,14
2021,213570,41,4,21,7,14
2021,213570,45,0,21,7,14
2021,213570,45,4,21,7,14
2021,213589,0,0,10,10,0
2021,213589,10,0,10,10,0
2021,213589,10,4,10,10,0
2021,213589,40,0,10,10,0
2021,213589,40,4,10,10,0
2021,213589,41,0,10,10,0
2021,213589,41,4,10,10,0
2021,213589,45,0,10,10,0
2021,213589,45,4,10,10,0
2021,213598,0,0,105,54,51
2021,213598,10,0,105,54,51
2021,213598,10,1,21,15,6
2021,213598,10,2,27,14,13
2021,213598,10,3,46,20,26
2021,213598,10,4,2,2,0
2021,213598,10,5,9,3,6
2021,213598,20,0,46,29,17
2021,213598,20,1,21,15,6
2021,213598,20,2,22,12,10
2021,213598,20,3,3,2,1
2021,213598,30,0,48,22,26
2021,213598,30,2,5,2,3
2021,213598,30,3,41,18,23
2021,213598,30,4,2,2,0
2021,213598,40,0,11,3,8
2021,213598,40,3,2,0,2
2021,213598,40,5,9,3,6
2021,213598,42,0,11,3,8
2021,213598,42,3,2,0,2
2021,213598,42,5,9,3,6
2021,213613,0,0,162,81,81
2021,213613,10,0,162,81,81
2021,213613,10,1,76,43,33
2021,213613,10,2,43,23,20
2021,213613,10,3,36,14,22
2021,213613,10,4,7,1,6
2021,213613,20,0,133,70,63
2021,213613,20,1,76,43,33
2021,213613,20,2,43,23,20
2021,213613,20,3,14,4,10
2021,213613,30,0,20,8,12
2021,213613,30,3,18,8,10
2021,213613,30,4,2,0,2
2021,213613,40,0,9,3,6
2021,213613,40,3,4,2,2
2021,213613,40,4,5,1,4
2021,213613,42,0,9,3,6
2021,213613,42,3,4,2,2
2021,213613,42,4,5,1,4
2021,213631,0,0,21,13,8
2021,213631,10,0,21,13,8
2021,213631,10,1,7,5,2
2021,213631,10,2,7,4,3
2021,213631,10,3,4,2,2
2021,213631,10,4,2,1,1
2021,213631,10,6,1,1,0
2021,213631,20,0,13,9,4
2021,213631,20,1,7,5,2
2021,213631,20,2,6,4,2
2021,213631,30,0,4,2,2
2021,213631,30,2,1,0,1
2021,213631,30,3,3,2,1
2021,213631,40,0,4,2,2
2021,213631,40,3,1,0,1
2021,213631,40,4,2,1,1
2021,213631,40,6,1,1,0
2021,213631,41,0,3,2,1
2021,213631,41,4,2,1,1
2021,213631,41,6,1,1,0
2021,213631,42,0,1,0,1
2021,213631,42,3,1,0,1
2021,213631,44,0,1,1,0
2021,213631,44,6,1,1,0
2021,213631,45,0,2,1,1
2021,213631,45,4,2,1,1
2021,213659,0,0,99,49,50
2021,213659,10,0,99,49,50
2021,213659,10,1,27,14,13
2021,213659,10,2,23,11,12
2021,213659,10,3,35,17,18
2021,213659,10,4,13,7,6
2021,213659,10,6,1,0,1
2021,213659,40,0,99,49,50
2021,213659,40,1,27,14,13
2021,213659,40,2,23,11,12
2021,213659,40,3,35,17,18
2021,213659,40,4,13,7,6
2021,213659,40,6,1,0,1
2021,213659,42,0,99,49,50
2021,213659,42,1,27,14,13
2021,213659,42,2,23,11,12
2021,213659,42,3,35,17,18
2021,213659,42,4,13,7,6
2021,213659,42,6,1,0,1
2021,213668,0,0,91,49,42
2021,213668,10,0,91,49,42
2021,213668,10,1,18,13,5
2021,213668,10,2,26,11,15
2021,213668,10,3,39,22,17
2021,213668,10,5,8,3,5
2021,213668,20,0,58,33,25
2021,213668,20,1,18,13,5
2021,213668,20,2,26,11,15
2021,213668,20,3,14,9,5
2021,213668,30,0,20,11,9
2021,213668,30,3,20,11,9
2021,213668,40,0,13,5,8
2021,213668,40,3,5,2,3
2021,213668,40,5,8,3,5
2021,213668,41,0,13,5,8
2021,213668,41,3,5,2,3
2021,213668,41,5,8,3,5
2021,213668,44,0,4,1,3
2021,213668,44,3,4,1,3
2021,213668,45,0,9,4,5
2021,213668,45,3,1,1,0
2021,213668,45,5,8,3,5
2021,213774,0,0,22,6,16
2021,213774,10,0,22,6,16
2021,213774,10,1,8,2,6
2021,213774,10,2,1,1,0
2021,213774,10,3,9,2,7
2021,213774,10,4,4,1,3
2021,213774,40,0,22,6,16
2021,213774,40,1,8,2,6
2021,213774,40,2,1,1,0
2021,213774,40,3,9,2,7
2021,213774,40,4,4,1,3
2021,213774,42,0,22,6,16
2021,213774,42,1,8,2,6
2021,213774,42,2,1,1,0
2021,213774,42,3,9,2,7
2021,213774,42,4,4,1,3
2021,213783,0,0,81,32,49
2021,213783,10,0,81,32,49
2021,213783,10,1,29,16,13
2021,213783,10,2,31,12,19
2021,213783,10,3,17,4,13
2021,213783,10,4,4,0,4
2021,213783,20,0,67,29,38
2021,213783,20,1,29,16,13
2021,213783,20,2,29,12,17
2021,213783,20,3,9,1,8
2021,213783,30,0,12,3,9
2021,213783,30,2,2,0,2
2021,213783,30,3,8,3,5
2021,213783,30,4,2,0,2
2021,213783,40,0,2,0,2
2021,213783,40,4,2,0,2
2021,213783,42,0,2,0,2
2021,213783,42,4,2,0,2
2021,213826,0,0,151,55,96
2021,213826,10,0,151,55,96
2021,213826,10,1,19,13,6
2021,213826,10,2,55,20,35
2021,213826,10,3,52,15,37
2021,213826,10,4,25,7,18
2021,213826,20,0,63,31,32
2021,213826,20,1,19,13,6
2021,213826,20,2,43,17,26
2021,213826,20,3,1,1,0
2021,213826,30,0,29,9,20
2021,213826,30,2,3,2,1
2021,213826,30,3,26,7,19
2021,213826,40,0,59,15,44
2021,213826,40,2,9,1,8
2021,213826,40,3,25,7,18
2021,213826,40,4,25,7,18
2021,213826,42,0,59,15,44
2021,213826,42,2,9,1,8
2021,213826,42,3,25,7,18
2021,213826,42,4,25,7,18
2021,213914,0,0,13,1,12
2021,213914,50,0,13,1,12
2021,213987,0,0,150,71,79
2021,213987,10,0,150,71,79
2021,213987,10,1,23,18,5
2021,213987,10,2,34,19,15
2021,213987,10,3,68,27,41
2021,213987,10,4,16,4,12
2021,213987,10,5,9,3,6
2021,213987,20,0,57,37,20
2021,213987,20,1,23,18,5
2021,213987,20,2,34,19,15
2021,213987,30,0,28,10,18
2021,213987,30,3,28,10,18
2021,213987,40,0,65,24,41
2021,213987,40,3,40,17,23
2021,213987,40,4,16,4,12
2021,213987,40,5,9,3,6
2021,213987,42,0,65,24,41
2021,213987,42,3,40,17,23
2021,213987,42,4,16,4,12
2021,213987,42,5,9,3,6
2021,213996,0,0,172,91,81
2021,213996,10,0,172,91,81
2021,213996,10,1,63,45,18
2021,213996,10,2,55,30,25
2021,213996,10,3,41,12,29
2021,213996,10,5,13,4,9
2021,213996,20,0,108,70,38
2021,213996,20,1,62,45,17
2021,213996,20,2,46,25,21
2021,213996,30,0,35,15,20
2021,213996,30,1,1,0,1
2021,213996,30,2,6,4,2
2021,213996,30,3,28,11,17
2021,213996,40,0,29,6,23
2021,213996,40,2,3,1,2
2021,213996,40,3,13,1,12
2021,213996,40,5,13,4,9
2021,213996,41,0,14,1,13
2021,213996,41,2,3,1,2
2021,213996,41,3,11,0,11
2021,213996,42,0,15,5,10
2021,213996,42,3,2,1,1
2021,213996,42,5,13,4,9
2021,213996,45,0,14,1,13
2021,213996,45,2,3,1,2
2021,213996,45,3,11,0,11
2021,214041,0,0,267,135,132
2021,214041,10,0,267,135,132
2021,214041,10,1,80,46,34
2021,214041,10,2,108,55,53
2021,214041,10,3,79,34,45
2021,214041,20,0,213,111,102
2021,214041,20,1,80,46,34
2021,214041,20,2,107,54,53
2021,214041,20,3,26,11,15
2021,214041,30,0,54,24,30
2021,214041,30,2,1,1,0
2021,214041,30,3,53,23,30
2021,214069,0,0,124,47,77
2021,214069,10,0,124,47,77
2021,214069,10,1,24,13,11
2021,214069,10,2,36,18,18
2021,214069,10,3,64,16,48
2021,214069,20,0,54,28,26
2021,214069,20,1,24,13,11
2021,214069,20,2,30,15,15
2021,214069,30,0,20,7,13
2021,214069,30,2,4,1,3
2021,214069,30,3,16,6,10
2021,214069,40,0,50,12,38
2021,214069,40,2,2,2,0
2021,214069,40,3,48,10,38
2021,214069,42,0,50,12,38
2021,214069,42,2,2,2,0
2021,214069,42,3,48,10,38
2021,214111,0,0,149,59,90
2021,214111,10,0,149,59,90
2021,214111,10,1,18,7,11
2021,214111,10,2,30,8,22
2021,214111,10,3,77,33,44
2021,214111,10,4,24,11,13
2021,214111,20,0,116,45,71
2021,214111,20,1,18,7,11
2021,214111,20,2,30,8,22
2021,214111,20,3,68,30,38
2021,214111,30,0,32,14,18
2021,214111,30,3,9,3,6
2021,214111,30,4,23,11,12
2021,214111,40,0,1,0,1
2021,214111,40,4,1,0,1
2021,214111,43,0,1,0,1
2021,214111,43,4,1,0,1
2021,214148,0,0,24,8,16
2021,214148,10,0,24,8,16
2021,214148,10,1,6,2,4
2021,214148,10,2,8,3,5
2021,214148,10,3,9,2,7
2021,214148,10,4,1,1,0
2021,214148,20,0,1,0,1
2021,214148,20,1,1,0,1
2021,214148,40,0,23,8,15
2021,214148,40,1,5,2,3
2021,214148,40,2,8,3,5
2021,214148,40,3,9,2,7
2021,214148,40,4,1,1,0
2021,214148,41,0,20,6,14
2021,214148,41,1,5,2,3
2021,214148,41,2,8,3,5
2021,214148,41,3,7,1,6
2021,214148,42,0,2,1,1
2021,214148,42,3,2,1,1
2021,214148,43,0,1,1,0
2021,214148,43,4,1,1,0
2021,214148,44,0,20,6,14
2021,214148,44,1,5,2,3
2021,214148,44,2,8,3,5
2021,214148,44,3,7,1,6
2021,214157,0,0,159,54,105
2021,214157,10,0,159,54,105
2021,214157,10,1,35,20,15
2021,214157,10,2,51,14,37
2021,214157,10,3,58,17,41
2021,214157,10,4,10,2,8
2021,214157,10,5,5,1,4
2021,214157,20,0,75,30,45
2021,214157,20,1,33,19,14
2021,214157,20,2,42,11,31
2021,214157,30,0,53,13,40
2021,214157,30,2,6,2,4
2021,214157,30,3,42,11,31
2021,214157,30,4,5,0,5
2021,214157,40,0,31,11,20
2021,214157,40,1,2,1,1
2021,214157,40,2,3,1,2
2021,214157,40,3,16,6,10
2021,214157,40,4,5,2,3
2021,214157,40,5,5,1,4
2021,214157,41,0,26,8,18
2021,214157,41,1,2,1,1
2021,214157,41,2,3,1,2
2021,214157,41,3,13,4,9
2021,214157,41,4,3,1,2
2021,214157,41,5,5,1,4
2021,214157,42,0,5,3,2
2021,214157,42,3,3,2,1
2021,214157,42,4,2,1,1
2021,214157,45,0,26,8,18
2021,214157,45,1,2,1,1
2021,214157,45,2,3,1,2
2021,214157,45,3,13,4,9
2021,214157,45,4,3,1,2
2021,214157,45,5,5,1,4
2021,214166,0,0,57,18,39
2021,214166,10,0,57,18,39
2021,214166,10,1,8,2,6
2021,214166,10,2,17,7,10
2021,214166,10,3,17,7,10
2021,214166,10,4,13,2,11
2021,214166,10,6,2,0,2
2021,214166,40,0,57,18,39
2021,214166,40,1,8,2,6
2021,214166,40,2,17,7,10
2021,214166,40,3,17,7,10
2021,214166,40,4,13,2,11
2021,214166,40,6,2,0,2
2021,214166,42,0,57,18,39
2021,214166,42,1,8,2,6
2021,214166,42,2,17,7,10
2021,214166,42,3,17,7,10
2021,214166,42,4,13,2,11
2021,214166,42,6,2,0,2
2021,214175,0,0,186,92,94
2021,214175,10,0,186,92,94
2021,214175,10,1,53,36,17
2021,214175,10,2,41,15,26
2021,214175,10,3,61,31,30
2021,214175,10,5,31,10,21
2021,214175,20,0,94,51,43
2021,214175,20,1,53,36,17
2021,214175,20,2,41,15,26
2021,214175,30,0,43,23,20
2021,214175,30,3,43,23,20
2021,214175,40,0,49,18,31
2021,214175,40,3,18,8,10
2021,214175,40,5,31,10,21
2021,214175,41,0,14,6,8
2021,214175,41,3,4,2,2
2021,214175,41,5,10,4,6
2021,214175,42,0,34,11,23
2021,214175,42,3,13,5,8
2021,214175,42,5,21,6,15
2021,214175,43,0,1,1,0
2021,214175,43,3,1,1,0
2021,214175,44,0,14,6,8
2021,214175,44,3,4,2,2
2021,214175,44,5,10,4,6
2021,214272,0,0,88,32,56
2021,214272,10,0,88,32,56
2021,214272,10,1,20,8,12
2021,214272,10,2,26,13,13
2021,214272,10,3,39,10,29
2021,214272,10,4,3,1,2
2021,214272,40,0,88,32,56
2021,214272,40,1,20,8,12
2021,214272,40,2,26,13,13
2021,214272,40,3,39,10,29
2021,214272,40,4,3,1,2
2021,214272,41,0,73,30,43
2021,214272,41,1,20,8,12
2021,214272,41,2,24,12,12
2021,214272,41,3,26,9,17
2021,214272,41,4,3,1,2
2021,214272,42,0,15,2,13
2021,214272,42,2,2,1,1
2021,214272,42,3,13,1,12
2021,214272,44,0,73,30,43
2021,214272,44,1,20,8,12
2021,214272,44,2,24,12,12
2021,214272,44,3,26,9,17
2021,214272,44,4,3,1,2
2021,214290,0,0,31,28,3
2021,214290,10,0,31,28,3
2021,214290,10,4,31,28,3
2021,214290,40,0,31,28,3
2021,214290,40,4,31,28,3
2021,214290,41,0,31,28,3
2021,214290,41,4,31,28,3
2021,214290,45,0,31,28,3
2021,214290,45,4,31,28,3
2021,214379,0,0,119,50,69
2021,214379,10,0,119,50,69
2021,214379,10,1,62,27,35
2021,214379,10,2,21,10,11
2021,214379,10,3,31,9,22
2021,214379,10,4,5,4,1
2021,214379,20,0,88,39,49
2021,214379,20,1,62,27,35
2021,214379,20,2,20,9,11
2021,214379,20,3,6,3,3
2021,214379,30,0,29,10,19
2021,214379,30,2,1,1,0
2021,214379,30,3,23,5,18
2021,214379,30,4,5,4,1
2021,214379,40,0,2,1,1
2021,214379,40,3,2,1,1
2021,214379,43,0,2,1,1
2021,214379,43,3,2,1,1
2021,214564,0,0,100,33,67
2021,214564,10,0,87,30,57
2021,214564,10,1,7,3,4
2021,214564,10,2,25,11,14
2021,214564,10,3,48,14,34
2021,214564,10,4,7,2,5
2021,214564,20,0,18,7,11
2021,214564,20,1,7,3,4
2021,214564,20,2,11,4,7
2021,214564,30,0,13,6,7
2021,214564,30,2,4,4,0
2021,214564,30,3,9,2,7
2021,214564,40,0,56,17,39
2021,214564,40,2,10,3,7
2021,214564,40,3,39,12,27
2021,214564,40,4,7,2,5
2021,214564,42,0,56,17,39
2021,214564,42,2,10,3,7
2021,214564,42,3,39,12,27
2021,214564,42,4,7,2,5
2021,214564,50,0,13,3,10
2021,214582,0,0,15,4,11
2021,214582,10,0,15,4,11
2021,214582,10,4,15,4,11
2021,214582,40,0,15,4,11
2021,214582,40,4,15,4,11
2021,214582,41,0,15,4,11
2021,214582,41,4,15,4,11
2021,214582,45,0,15,4,11
2021,214582,45,4,15,4,11
2021,214883,0,0,22,10,12
2021,214883,10,0,22,10,12
2021,214883,10,1,11,3,8
2021,214883,10,2,9,5,4
2021,214883,10,3,2,2,0
2021,214883,40,0,22,10,12
2021,214883,40,1,11,3,8
2021,214883,40,2,9,5,4
2021,214883,40,3,2,2,0
2021,214883,41,0,22,10,12
2021,214883,41,1,11,3,8
2021,214883,41,2,9,5,4
2021,214883,41,3,2,2,0
2021,214883,45,0,22,10,12
2021,214883,45,1,11,3,8
2021,214883,45,2,9,5,4
2021,214883,45,3,2,2,0
2021,214892,0,0,27,12,15
2021,214892,10,0,27,12,15
2021,214892,10,4,27,12,15
2021,214892,40,0,27,12,15
2021,214892,40,4,27,12,15
2021,214892,43,0,27,12,15
2021,214892,43,4,27,12,15
2021,214944,0,0,37,33,4
2021,214944,10,0,37,33,4
2021,214944,10,4,37,33,4
2021,214944,40,0,37,33,4
2021,214944,40,4,37,33,4
2021,214944,41,0,37,33,4
2021,214944,41,4,37,33,4
2021,214944,45,0,37,33,4
2021,214944,45,4,37,33,4
2021,214971,0,0,21,15,6
2021,214971,10,0,21,15,6
2021,214971,10,1,16,11,5
2021,214971,10,2,2,2,0
2021,214971,10,3,3,2,1
2021,214971,40,0,21,15,6
2021,214971,40,1,16,11,5
2021,214971,40,2,2,2,0
2021,214971,40,3,3,2,1
2021,214971,42,0,21,15,6
2021,214971,42,1,16,11,5
2021,214971,42,2,2,2,0
2021,214971,42,3,3,2,1
2021,215053,0,0,16,8,8
2021,215053,10,0,16,8,8
2021,215053,10,2,3,2,1
2021,215053,10,3,13,6,7
2021,215053,40,0,16,8,8
2021,215053,40,2,3,2,1
2021,215053,40,3,13,6,7
2021,215053,41,0,15,7,8
2021,215053,41,2,3,2,1
2021,215053,41,3,12,5,7
2021,215053,42,0,1,1,0
2021,215053,42,3,1,1,0
2021,215053,44,0,15,7,8
2021,215053,44,2,3,2,1
2021,215053,44,3,12,5,7
2021,215062,0,0,2196,1298,898
2021,215062,10,0,2196,1298,898
2021,215062,10,1,898,652,246
2021,215062,10,2,356,226,130
2021,215062,10,3,415,216,199
2021,215062,10,4,173,68,105
2021,215062,10,5,354,136,218
2021,215062,20,0,1240,867,373
2021,215062,20,1,898,652,246
2021,215062,20,2,342,215,127
2021,215062,30,0,429,227,202
2021,215062,30,2,14,11,3
2021,215062,30,3,415,216,199
2021,215062,40,0,527,204,323
2021,215062,40,4,173,68,105
2021,215062,40,5,354,136,218
2021,215062,41,0,181,68,113
2021,215062,41,5,181,68,113
2021,215062,42,0,346,136,210
2021,215062,42,4,173,68,105
2021,215062,42,5,173,68,105
2021,215062,44,0,181,68,113
2021,215062,44,5,181,68,113
2021,215105,0,0,77,46,31
2021,215105,10,0,77,46,31
2021,215105,10,1,10,6,4
2021,215105,10,2,39,26,13
2021,215105,10,3,28,14,14
2021,215105,20,0,5,3,2
2021,215105,20,1,2,0,2
2021,215105,20,2,3,3,0
2021,215105,40,0,72,43,29
2021,215105,40,1,8,6,2
2021,215105,40,2,36,23,13
2021,215105,40,3,28,14,14
2021,215105,41,0,61,36,25
2021,215105,41,1,8,6,2
2021,215105,41,2,33,22,11
2021,215105,41,3,20,8,12
2021,215105,42,0,11,7,4
2021,215105,42,2,3,1,2
2021,215105,42,3,8,6,2
2021,215105,44,0,61,36,25
2021,215105,44,1,8,6,2
2021,215105,44,2,33,22,11
2021,215105,44,3,20,8,12
2021,215114,0,0,42,27,15
2021,215114,10,0,42,27,15
2021,215114,10,1,19,13,6
2021,215114,10,2,9,7,2
2021,215114,10,3,13,7,6
2021,215114,10,4,1,0,1
2021,215114,40,0,42,27,15
2021,215114,40,1,19,13,6
2021,215114,40,2,9,7,2
2021,215114,40,3,13,7,6
2021,215114,40,4,1,0,1
2021,215114,42,0,42,27,15
2021,215114,42,1,19,13,6
2021,215114,42,2,9,7,2
2021,215114,42,3,13,7,6
2021,215114,42,4,1,0,1
2021,215123,0,0,213,108,105
2021,215123,10,0,213,108,105
2021,215123,10,1,71,42,29
2021,215123,10,2,69,41,28
2021,215123,10,3,54,16,38
2021,215123,10,4,18,9,9
2021,215123,10,5,1,0,1
2021,215123,20,0,32,17,15
2021,215123,20,1,30,16,14
2021,215123,20,2,2,1,1
2021,215123,30,0,107,64,43
2021,215123,30,1,40,25,15
2021,215123,30,2,65,38,27
2021,215123,30,4,1,1,0
2021,215123,30,5,1,0,1
2021,215123,40,0,74,27,47
2021,215123,40,1,1,1,0
2021,215123,40,2,2,2,0
2021,215123,40,3,54,16,38
2021,215123,40,4,17,8,9
2021,215123,42,0,74,27,47
2021,215123,42,1,1,1,0
2021,215123,42,2,2,2,0
2021,215123,42,3,54,16,38
2021,215123,42,4,17,8,9
2021,215132,0,0,153,73,80
2021,215132,10,0,152,72,80
2021,215132,10,1,29,21,8
2021,215132,10,2,43,13,30
2021,215132,10,3,68,31,37
2021,215132,10,4,8,5,3
2021,215132,10,5,4,2,2
2021,215132,20,0,49,27,22
2021,215132,20,1,29,21,8
2021,215132,20,2,20,6,14
2021,215132,30,0,19,13,6
2021,215132,30,2,3,2,1
2021,215132,30,3,16,11,5
2021,215132,40,0,84,32,52
2021,215132,40,2,20,5,15
2021,215132,40,3,52,20,32
2021,215132,40,4,8,5,3
2021,215132,40,5,4,2,2
2021,215132,41,0,8,3,5
2021,215132,41,2,7,2,5
2021,215132,41,3,1,1,0
2021,215132,42,0,76,29,47
2021,215132,42,2,13,3,10
2021,215132,42,3,51,19,32
2021,215132,42,4,8,5,3
2021,215132,42,5,4,2,2
2021,215132,44,0,8,3,5
2021,215132,44,2,7,2,5
2021,215132,44,3,1,1,0
2021,215132,50,0,1,1,0
2021,215239,0,0,358,154,204
2021,215239,10,0,358,154,204
2021,215239,10,1,12,6,6
2021,215239,10,2,68,29,39
2021,215239,10,3,251,110,141
2021,215239,10,4,12,4,8
2021,215239,10,5,15,5,10
2021,215239,20,0,268,121,147
2021,215239,20,1,12,6,6
2021,215239,20,2,68,29,39
2021,215239,20,3,188,86,102
2021,215239,30,0,75,28,47
2021,215239,30,3,63,24,39
2021,215239,30,4,12,4,8
2021,215239,40,0,15,5,10
2021,215239,40,5,15,5,10
2021,215239,43,0,15,5,10
2021,215239,43,5,15,5,10
2021,215266,0,0,71,46,25
2021,215266,10,0,71,46,25
2021,215266,10,1,8,6,2
2021,215266,10,2,24,17,7
2021,215266,10,3,29,17,12
2021,215266,10,4,10,6,4
2021,215266,20,0,30,21,9
2021,215266,20,1,8,6,2
2021,215266,20,2,22,15,7
2021,215266,30,0,9,5,4
2021,215266,30,3,9,5,4
2021,215266,40,0,32,20,12
2021,215266,40,2,2,2,0
2021,215266,40,3,20,12,8
2021,215266,40,4,10,6,4
2021,215266,41,0,19,10,9
2021,215266,41,2,2,2,0
2021,215266,41,3,13,7,6
2021,215266,41,4,4,1,3
2021,215266,43,0,13,10,3
2021,215266,43,3,7,5,2
2021,215266,43,4,6,5,1
2021,215266,44,0,19,10,9
2021,215266,44,2,2,2,0
2021,215266,44,3,13,7,6
2021,215266,44,4,4,1,3
2021,215275,0,0,75,34,41
2021,215275,10,0,75,34,41
2021,215275,10,1,5,3,2
2021,215275,10,2,28,12,16
2021,215275,10,3,16,7,9
2021,215275,10,4,26,12,14
2021,215275,20,0,27,13,14
2021,215275,20,1,4,2,2
2021,215275,20,2,23,11,12
2021,215275,30,0,6,4,2
2021,215275,30,3,5,4,1
2021,215275,30,4,1,0,1
2021,215275,40,0,42,17,25
2021,215275,40,1,1,1,0
2021,215275,40,2,5,1,4
2021,215275,40,3,11,3,8
2021,215275,40,4,25,12,13
2021,215275,41,0,25,8,17
2021,215275,41,1,1,1,0
2021,215275,41,2,5,1,4
2021,215275,41,3,10,3,7
2021,215275,41,4,9,3,6
2021,215275,43,0,17,9,8
2021,215275,43,3,1,0,1
2021,215275,43,4,16,9,7
2021,215275,44,0,25,8,17
2021,215275,44,1,1,1,0
2021,215275,44,2,5,1,4
2021,215275,44,3,10,3,7
2021,215275,44,4,9,3,6
2021,215284,0,0,131,70,61
2021,215284,10,0,131,70,61
2021,215284,10,1,16,12,4
2021,215284,10,2,51,29,22
2021,215284,10,3,43,24,19
2021,215284,10,4,21,5,16
2021,215284,20,0,65,40,25
2021,215284,20,1,16,12,4
2021,215284,20,2,49,28,21
2021,215284,30,0,9,4,5
2021,215284,30,3,9,4,5
2021,215284,40,0,57,26,31
2021,215284,40,2,2,1,1
2021,215284,40,3,34,20,14
2021,215284,40,4,21,5,16
2021,215284,41,0,48,23,25
2021,215284,41,2,2,1,1
2021,215284,41,3,29,17,12
2021,215284,41,4,17,5,12
2021,215284,43,0,9,3,6
2021,215284,43,3,5,3,2
2021,215284,43,4,4,0,4
2021,215284,44,0,48,23,25
2021,215284,44,2,2,1,1
2021,215284,44,3,29,17,12
2021,215284,44,4,17,5,12
2021,215293,0,0,4378,2399,1979
2021,215293,10,0,4378,2399,1979
2021,215293,10,1,1079,783,296
2021,215293,10,2,1080,591,489
2021,215293,10,3,1725,828,897
2021,215293,10,4,202,78,124
2021,215293,10,5,290,119,171
2021,215293,10,6,2,0,2
2021,215293,20,0,1197,822,375
2021,215293,20,1,762,559,203
2021,215293,20,2,435,263,172
2021,215293,30,0,378,212,166
2021,215293,30,1,3,3,0
2021,215293,30,2,31,12,19
2021,215293,30,3,344,197,147
2021,215293,40,0,2803,1365,1438
2021,215293,40,1,314,221,93
2021,215293,40,2,614,316,298
2021,215293,40,3,1381,631,750
2021,215293,40,4,202,78,124
2021,215293,40,5,290,119,171
2021,215293,40,6,2,0,2
2021,215293,41,0,946,400,546
2021,215293,41,1,66,41,25
2021,215293,41,2,135,53,82
2021,215293,41,3,460,211,249
2021,215293,41,4,75,20,55
2021,215293,41,5,210,75,135
2021,215293,42,0,1663,869,794
2021,215293,42,1,235,168,67
2021,215293,42,2,457,249,208
2021,215293,42,3,870,405,465
2021,215293,42,4,100,47,53
2021,215293,42,5,1,0,1
2021,215293,43,0,194,96,98
2021,215293,43,1,13,12,1
2021,215293,43,2,22,14,8
2021,215293,43,3,51,15,36
2021,215293,43,4,27,11,16
2021,215293,43,5,79,44,35
2021,215293,43,6,2,0,2
2021,215293,44,0,946,400,546
2021,215293,44,1,66,41,25
2021,215293,44,2,135,53,82
2021,215293,44,3,460,211,249
2021,215293,44,4,75,20,55
2021,215293,44,5,210,75,135
2021,215309,0,0,8,2,6
2021,215309,10,0,8,2,6
2021,215309,10,1,1,1,0
2021,215309,10,2,2,1,1
2021,215309,10,3,1,0,1
2021,215309,10,4,4,0,4
2021,215309,20,0,3,2,1
2021,215309,20,1,1,1,0
2021,215309,20,2,2,1,1
2021,215309,40,0,5,0,5
2021,215309,40,3,1,0,1
2021,215309,40,4,4,0,4
2021,215309,41,0,4,0,4
2021,215309,41,4,4,0,4
2021,215309,43,0,1,0,1
2021,215309,43,3,1,0,1
2021,215309,44,0,4,0,4
2021,215309,44,4,4,0,4
2021,215381,0,0,41,35,6
2021,215381,50,0,41,35,6
2021,215415,0,0,61,38,23
2021,215415,10,0,61,38,23
2021,215415,10,4,61,38,23
2021,215415,40,0,61,38,23
2021,215415,40,4,61,38,23
2021,215415,41,0,61,38,23
2021,215415,41,4,61,38,23
2021,215415,45,0,61,38,23
2021,215415,45,4,61,38,23
2021,215424,0,0,13,10,3
2021,215424,10,0,13,10,3
2021,215424,10,1,6,6,0
2021,215424,10,2,6,3,3
2021,215424,10,3,1,1,0
2021,215424,20,0,9,7,2
2021,215424,20,1,6,6,0
2021,215424,20,2,3,1,2
2021,215424,30,0,3,2,1
2021,215424,30,2,3,2,1
2021,215424,40,0,1,1,0
2021,215424,40,3,1,1,0
2021,215424,42,0,1,1,0
2021,215424,42,3,1,1,0
2021,215442,0,0,131,65,66
2021,215442,10,0,129,64,65
2021,215442,10,1,56,32,24
2021,215442,10,2,33,16,17
2021,215442,10,3,28,12,16
2021,215442,10,5,12,4,8
2021,215442,20,0,88,47,41
2021,215442,20,1,56,32,24
2021,215442,20,2,32,15,17
2021,215442,30,0,25,11,14
2021,215442,30,2,1,1,0
2021,215442,30,3,24,10,14
2021,215442,40,0,16,6,10
2021,215442,40,3,4,2,2
2021,215442,40,5,12,4,8
2021,215442,43,0,16,6,10
2021,215442,43,3,4,2,2
2021,215442,43,5,12,4,8
2021,215442,50,0,2,1,1
2021,215585,0,0,52,7,45
2021,215585,10,0,49,6,43
2021,215585,10,1,12,2,10
2021,215585,10,2,12,1,11
2021,215585,10,3,15,2,13
2021,215585,10,4,10,1,9
2021,215585,40,0,49,6,43
2021,215585,40,1,12,2,10
2021,215585,40,2,12,1,11
2021,215585,40,3,15,2,13
2021,215585,40,4,10,1,9
2021,215585,41,0,49,6,43
2021,215585,41,1,12,2,10
2021,215585,41,2,12,1,11
2021,215585,41,3,15,2,13
2021,215585,41,4,10,1,9
2021,215585,44,0,49,6,43
2021,215585,44,1,12,2,10
2021,215585,44,2,12,1,11
2021,215585,44,3,15,2,13
2021,215585,44,4,10,1,9
2021,215585,50,0,3,1,2
2021,215619,0,0,5,1,4
2021,215619,10,0,5,1,4
2021,215619,10,1,2,1,1
2021,215619,10,2,2,0,2
2021,215619,10,3,1,0,1
2021,215619,20,0,4,1,3
2021,215619,20,1,2,1,1
2021,215619,20,2,2,0,2
2021,215619,40,0,1,0,1
2021,215619,40,3,1,0,1
2021,215619,41,0,1,0,1
2021,215619,41,3,1,0,1
2021,215619,44,0,1,0,1
2021,215619,44,3,1,0,1
2021,215637,0,0,15,8,7
2021,215637,10,0,15,8,7
2021,215637,10,4,15,8,7
2021,215637,40,0,15,8,7
2021,215637,40,4,15,8,7
2021,215637,41,0,15,8,7
2021,215637,41,4,15,8,7
2021,215637,45,0,15,8,7
2021,215637,45,4,15,8,7
2021,215655,0,0,179,92,87
2021,215655,10,0,179,92,87
2021,215655,10,1,86,48,38
2021,215655,10,2,57,28,29
2021,215655,10,3,28,14,14
2021,215655,10,5,8,2,6
2021,215655,20,0,155,81,74
2021,215655,20,1,86,48,38
2021,215655,20,2,57,28,29
2021,215655,20,3,12,5,7
2021,215655,30,0,16,9,7
2021,215655,30,3,16,9,7
2021,215655,40,0,8,2,6
2021,215655,40,5,8,2,6
2021,215655,41,0,6,2,4
2021,215655,41,5,6,2,4
2021,215655,42,0,2,0,2
2021,215655,42,5,2,0,2
2021,215655,44,0,6,2,4
2021,215655,44,5,6,2,4
2021,215682,0,0,29,29,0
2021,215682,10,0,29,29,0
2021,215682,10,4,29,29,0
2021,215682,40,0,29,29,0
2021,215682,40,4,29,29,0
2021,215682,41,0,29,29,0
2021,215682,41,4,29,29,0
2021,215682,45,0,29,29,0
2021,215682,45,4,29,29,0
2021,215691,0,0,26,12,14
2021,215691,10,0,26,12,14
2021,215691,10,1,2,1,1
2021,215691,10,2,13,6,7
2021,215691,10,3,11,5,6
2021,215691,20,0,11,4,7
2021,215691,20,1,2,1,1
2021,215691,20,2,9,3,6
2021,215691,30,0,4,3,1
2021,215691,30,2,1,1,0
2021,215691,30,3,3,2,1
2021,215691,40,0,11,5,6
2021,215691,40,2,3,2,1
2021,215691,40,3,8,3,5
2021,215691,41,0,11,5,6
2021,215691,41,2,3,2,1
2021,215691,41,3,8,3,5
2021,215691,44,0,11,5,6
2021,215691,44,2,3,2,1
2021,215691,44,3,8,3,5
2021,215743,0,0,118,53,65
2021,215743,10,0,115,50,65
2021,215743,10,1,32,23,9
2021,215743,10,2,36,12,24
2021,215743,10,3,29,10,19
2021,215743,10,4,18,5,13
2021,215743,20,0,56,30,26
2021,215743,20,1,28,20,8
2021,215743,20,2,27,10,17
2021,215743,20,3,1,0,1
2021,215743,30,0,16,8,8
2021,215743,30,2,5,2,3
2021,215743,30,3,10,6,4
2021,215743,30,4,1,0,1
2021,215743,40,0,43,12,31
2021,215743,40,1,4,3,1
2021,215743,40,2,4,0,4
2021,215743,40,3,18,4,14
2021,215743,40,4,17,5,12
2021,215743,41,0,39,12,27
2021,215743,41,1,4,3,1
2021,215743,41,2,4,0,4
2021,215743,41,3,16,4,12
2021,215743,41,4,15,5,10
2021,215743,42,0,4,0,4
2021,215743,42,3,2,0,2
2021,215743,42,4,2,0,2
2021,215743,45,0,39,12,27
2021,215743,45,1,4,3,1
2021,215743,45,2,4,0,4
2021,215743,45,3,16,4,12
2021,215743,45,4,15,5,10
2021,215743,50,0,3,3,0
2021,215770,0,0,261,140,121
2021,215770,10,0,261,140,121
2021,215770,10,1,84,48,36
2021,215770,10,2,78,43,35
2021,215770,10,3,57,29,28
2021,215770,10,4,42,20,22
2021,215770,20,0,178,100,78
2021,215770,20,1,84,48,36
2021,215770,20,2,78,43,35
2021,215770,20,3,16,9,7
2021,215770,30,0,41,20,21
2021,215770,30,3,41,20,21
2021,215770,40,0,42,20,22
2021,215770,40,4,42,20,22
2021,215770,42,0,41,20,21
2021,215770,42,4,41,20,21
2021,215770,43,0,1,0,1
2021,215770,43,4,1,0,1
2021,215798,0,0,95,67,28
2021,215798,10,0,95,67,28
2021,215798,10,1,26,19,7
2021,215798,10,2,38,29,9
2021,215798,10,3,27,17,10
2021,215798,10,4,4,2,2
2021,215798,20,0,58,43,15
2021,215798,20,1,23,17,6
2021,215798,20,2,35,26,9
2021,215798,30,0,20,14,6
2021,215798,30,1,1,1,0
2021,215798,30,2,1,1,0
2021,215798,30,3,18,12,6
2021,215798,40,0,17,10,7
2021,215798,40,1,2,1,1
2021,215798,40,2,2,2,0
2021,215798,40,3,9,5,4
2021,215798,40,4,4,2,2
2021,215798,41,0,7,3,4
2021,215798,41,1,2,1,1
2021,215798,41,3,4,2,2
2021,215798,41,4,1,0,1
2021,215798,42,0,10,7,3
2021,215798,42,2,2,2,0
2021,215798,42,3,5,3,2
2021,215798,42,4,3,2,1
2021,215798,44,0,7,3,4
2021,215798,44,1,2,1,1
2021,215798,44,3,4,2,2
2021,215798,44,4,1,0,1
2021,215929,0,0,281,162,119
2021,215929,10,0,281,162,119
2021,215929,10,1,97,65,32
2021,215929,10,2,72,44,28
2021,215929,10,3,66,33,33
2021,215929,10,4,2,2,0
2021,215929,10,5,3,2,1
2021,215929,10,6,41,16,25
2021,215929,20,0,175,112,63
2021,215929,20,1,95,64,31
2021,215929,20,2,68,41,27
2021,215929,20,3,12,7,5
2021,215929,30,0,62,32,30
2021,215929,30,1,2,1,1
2021,215929,30,2,4,3,1
2021,215929,30,3,54,26,28
2021,215929,30,4,2,2,0
2021,215929,40,0,44,18,26
2021,215929,40,5,3,2,1
2021,215929,40,6,41,16,25
2021,215929,41,0,14,4,10
2021,215929,41,6,14,4,10
2021,215929,42,0,30,14,16
2021,215929,42,5,3,2,1
2021,215929,42,6,27,12,15
2021,215929,44,0,14,4,10
2021,215929,44,6,14,4,10
2021,215947,0,0,103,37,66
2021,215947,10,0,103,37,66
2021,215947,10,1,12,5,7
2021,215947,10,2,45,21,24
2021,215947,10,3,38,8,30
2021,215947,10,4,8,3,5
2021,215947,20,0,47,20,27
2021,215947,20,1,10,3,7
2021,215947,20,2,37,17,20
2021,215947,30,0,30,10,20
2021,215947,30,1,1,1,0
2021,215947,30,2,8,4,4
2021,215947,30,3,21,5,16
2021,215947,40,0,26,7,19
2021,215947,40,1,1,1,0
2021,215947,40,3,17,3,14
2021,215947,40,4,8,3,5
2021,215947,41,0,2,2,0
2021,215947,41,1,1,1,0
2021,215947,41,3,1,1,0
2021,215947,42,0,24,5,19
2021,215947,42,3,16,2,14
2021,215947,42,4,8,3,5
2021,215947,44,0,2,2,0
2021,215947,44,1,1,1,0
2021,215947,44,3,1,1,0
2021,215992,0,0,7,3,4
2021,215992,10,0,7,3,4
2021,215992,10,4,7,3,4
2021,215992,40,0,7,3,4
2021,215992,40,4,7,3,4
2021,215992,41,0,7,3,4
2021,215992,41,4,7,3,4
2021,215992,45,0,7,3,4
2021,215992,45,4,7,3,4
2021,216010,0,0,250,147,103
2021,216010,10,0,250,147,103
2021,216010,10,1,96,61,35
2021,216010,10,2,109,65,44
2021,216010,10,3,40,19,21
2021,216010,10,4,5,2,3
2021,216010,20,0,203,122,81
2021,216010,20,1,95,60,35
2021,216010,20,2,99,57,42
2021,216010,20,3,9,5,4
2021,216010,30,0,44,24,20
2021,216010,30,1,1,1,0
2021,216010,30,2,10,8,2
2021,216010,30,3,31,14,17
2021,216010,30,4,2,1,1
2021,216010,40,0,3,1,2
2021,216010,40,4,3,1,2
2021,216010,42,0,3,1,2
2021,216010,42,4,3,1,2
2021,216038,0,0,366,175,191
2021,216038,10,0,366,175,191
2021,216038,10,1,88,42,46
2021,216038,10,2,135,66,69
2021,216038,10,3,110,54,56
2021,216038,10,4,33,13,20
2021,216038,20,0,231,115,116
2021,216038,20,1,87,41,46
2021,216038,20,2,112,56,56
2021,216038,20,3,32,18,14
2021,216038,30,0,102,47,55
2021,216038,30,1,1,1,0
2021,216038,30,2,22,9,13
2021,216038,30,3,77,36,41
2021,216038,30,4,2,1,1
2021,216038,40,0,33,13,20
2021,216038,40,2,1,1,0
2021,216038,40,3,1,0,1
2021,216038,40,4,31,12,19
2021,216038,41,0,2,0,2
2021,216038,41,4,2,0,2
2021,216038,42,0,31,13,18
2021,216038,42,2,1,1,0
2021,216038,42,3,1,0,1
2021,216038,42,4,29,12,17
2021,216038,44,0,2,0,2
2021,216038,44,4,2,0,2
2021,216047,0,0,18,15,3
2021,216047,10,0,18,15,3
2021,216047,10,1,6,6,0
2021,216047,10,2,1,0,1
2021,216047,10,3,7,6,1
2021,216047,10,4,4,3,1
2021,216047,40,0,18,15,3
2021,216047,40,1,6,6,0
2021,216047,40,2,1,0,1
2021,216047,40,3,7,6,1
2021,216047,40,4,4,3,1
2021,216047,41,0,18,15,3
2021,216047,41,1,6,6,0
2021,216047,41,2,1,0,1
2021,216047,41,3,7,6,1
2021,216047,41,4,4,3,1
2021,216047,44,0,18,15,3
2021,216047,44,1,6,6,0
2021,216047,44,2,1,0,1
2021,216047,44,3,7,6,1
2021,216047,44,4,4,3,1
2021,216083,0,0,27,9,18
2021,216083,10,0,27,9,18
2021,216083,10,4,27,9,18
2021,216083,40,0,27,9,18
2021,216083,40,4,27,9,18
2021,216083,42,0,27,9,18
2021,216083,42,4,27,9,18
2021,216278,0,0,144,72,72
2021,216278,10,0,143,71,72
2021,216278,10,1,25,16,9
2021,216278,10,2,54,27,27
2021,216278,10,3,56,23,33
2021,216278,10,5,6,4,2
2021,216278,10,6,2,1,1
2021,216278,20,0,78,42,36
2021,216278,20,1,25,16,9
2021,216278,20,2,53,26,27
2021,216278,30,0,44,17,27
2021,216278,30,2,1,1,0
2021,216278,30,3,43,16,27
2021,216278,40,0,21,12,9
2021,216278,40,3,13,7,6
2021,216278,40,5,6,4,2
2021,216278,40,6,2,1,1
2021,216278,42,0,21,12,9
2021,216278,42,3,13,7,6
2021,216278,42,5,6,4,2
2021,216278,42,6,2,1,1
2021,216278,50,0,1,1,0
2021,216287,0,0,239,127,112
2021,216287,10,0,239,127,112
2021,216287,10,1,83,46,37
2021,216287,10,2,54,29,25
2021,216287,10,3,99,50,49
2021,216287,10,4,3,2,1
2021,216287,20,0,124,67,57
2021,216287,20,1,81,45,36
2021,216287,20,2,43,22,21
2021,216287,30,0,51,21,30
2021,216287,30,2,9,6,3
2021,216287,30,3,42,15,27
2021,216287,40,0,64,39,25
2021,216287,40,1,2,1,1
2021,216287,40,2,2,1,1
2021,216287,40,3,57,35,22
2021,216287,40,4,3,2,1
2021,216287,41,0,47,27,20
2021,216287,41,1,1,0,1
2021,216287,41,2,2,1,1
2021,216287,41,3,43,25,18
2021,216287,41,4,1,1,0
2021,216287,42,0,17,12,5
2021,216287,42,1,1,1,0
2021,216287,42,3,14,10,4
2021,216287,42,4,2,1,1
2021,216287,44,0,47,27,20
2021,216287,44,1,1,0,1
2021,216287,44,2,2,1,1
2021,216287,44,3,43,25,18
2021,216287,44,4,1,1,0
2021,216296,0,0,75,56,19
2021,216296,10,0,75,56,19
2021,216296,10,1,9,7,2
2021,216296,10,2,9,5,4
2021,216296,10,3,15,14,1
2021,216296,10,4,42,30,12
2021,216296,20,0,43,33,10
2021,216296,20,1,9,7,2
2021,216296,20,2,9,5,4
2021,216296,20,3,13,13,0
2021,216296,20,4,12,8,4
2021,216296,30,0,32,23,9
2021,216296,30,3,2,1,1
2021,216296,30,4,30,22,8
2021,216339,0,0,2286,1260,1026
2021,216339,10,0,2286,1260,1026
2021,216339,10,1,618,425,193
2021,216339,10,2,747,397,350
2021,216339,10,3,849,413,436
2021,216339,10,4,72,25,47
2021,216339,20,0,693,449,244
2021,216339,20,1,388,282,106
2021,216339,20,2,304,166,138
2021,216339,20,3,1,1,0
2021,216339,30,0,238,118,120
2021,216339,30,2,28,13,15
2021,216339,30,3,209,105,104
2021,216339,30,4,1,0,1
2021,216339,40,0,1355,693,662
2021,216339,40,1,230,143,87
2021,216339,40,2,415,218,197
2021,216339,40,3,639,307,332
2021,216339,40,4,71,25,46
2021,216339,41,0,1355,693,662
2021,216339,41,1,230,143,87
2021,216339,41,2,415,218,197
2021,216339,41,3,639,307,332
2021,216339,41,4,71,25,46
2021,216339,44,0,768,372,396
2021,216339,44,1,86,46,40
2021,216339,44,2,253,132,121
2021,216339,44,3,370,173,197
2021,216339,44,4,59,21,38
2021,216339,45,0,587,321,266
2021,216339,45,1,144,97,47
2021,216339,45,2,162,86,76
2021,216339,45,3,269,134,135
2021,216339,45,4,12,4,8
2021,216357,0,0,62,32,30
2021,216357,10,0,62,32,30
2021,216357,10,1,24,16,8
2021,216357,10,2,17,7,10
2021,216357,10,3,18,8,10
2021,216357,10,5,3,1,2
2021,216357,20,0,34,20,14
2021,216357,20,1,21,14,7
2021,216357,20,2,13,6,7
2021,216357,30,0,24,11,13
2021,216357,30,1,3,2,1
2021,216357,30,2,4,1,3
2021,216357,30,3,17,8,9
2021,216357,40,0,4,1,3
2021,216357,40,3,1,0,1
2021,216357,40,5,3,1,2
2021,216357,42,0,4,1,3
2021,216357,42,3,1,0,1
2021,216357,42,5,3,1,2
2021,216366,0,0,303,92,211
2021,216366,10,0,303,92,211
2021,216366,10,1,40,19,21
2021,216366,10,2,93,28,65
2021,216366,10,3,140,41,99
2021,216366,10,4,29,3,26
2021,216366,10,5,1,1,0
2021,216366,20,0,38,23,15
2021,216366,20,1,18,12,6
2021,216366,20,2,20,11,9
2021,216366,30,0,26,11,15
2021,216366,30,3,26,11,15
2021,216366,40,0,239,58,181
2021,216366,40,1,22,7,15
2021,216366,40,2,73,17,56
2021,216366,40,3,114,30,84
2021,216366,40,4,29,3,26
2021,216366,40,5,1,1,0
2021,216366,41,0,146,34,112
2021,216366,41,1,11,4,7
2021,216366,41,2,47,10,37
2021,216366,41,3,74,17,57
2021,216366,41,4,14,3,11
2021,216366,42,0,93,24,69
2021,216366,42,1,11,3,8
2021,216366,42,2,26,7,19
2021,216366,42,3,40,13,27
2021,216366,42,4,15,0,15
2021,216366,42,5,1,1,0
2021,216366,44,0,146,34,112
2021,216366,44,1,11,4,7
2021,216366,44,2,47,10,37
2021,216366,44,3,74,17,57
2021,216366,44,4,14,3,11
2021,216436,0,0,15,15,0
2021,216436,10,0,15,15,0
2021,216436,10,4,15,15,0
2021,216436,40,0,15,15,0
2021,216436,40,4,15,15,0
2021,216436,41,0,15,15,0
2021,216436,41,4,15,15,0
2021,216436,45,0,15,15,0
2021,216436,45,4,15,15,0
2021,216445,0,0,13,12,1
2021,216445,10,0,13,12,1
2021,216445,10,4,13,12,1
2021,216445,40,0,13,12,1
2021,216445,40,4,13,12,1
2021,216445,41,0,13,12,1
2021,216445,41,4,13,12,1
2021,216445,45,0,13,12,1
2021,216445,45,4,13,12,1
2021,216454,0,0,12,11,1
2021,216454,10,0,12,11,1
2021,216454,10,4,12,11,1
2021,216454,40,0,12,11,1
2021,216454,40,4,12,11,1
2021,216454,41,0,12,11,1
2021,216454,41,4,12,11,1
2021,216454,45,0,12,11,1
2021,216454,45,4,12,11,1
2021,216463,0,0,12,10,2
2021,216463,10,0,12,10,2
2021,216463,10,1,5,3,2
2021,216463,10,2,6,6,0
2021,216463,10,3,1,1,0
2021,216463,40,0,12,10,2
2021,216463,40,1,5,3,2
2021,216463,40,2,6,6,0
2021,216463,40,3,1,1,0
2021,216463,41,0,11,9,2
2021,216463,41,1,5,3,2
2021,216463,41,2,6,6,0
2021,216463,42,0,1,1,0
2021,216463,42,3,1,1,0
2021,216463,44,0,10,8,2
2021,216463,44,1,5,3,2
2021,216463,44,2,5,5,0
2021,216463,45,0,1,1,0
2021,216463,45,2,1,1,0
2021,216524,0,0,132,57,75
2021,216524,10,0,132,57,75
2021,216524,10,1,29,18,11
2021,216524,10,2,39,16,23
2021,216524,10,3,41,17,24
2021,216524,10,4,23,6,17
2021,216524,20,0,68,34,34
2021,216524,20,1,29,18,11
2021,216524,20,2,39,16,23
2021,216524,30,0,33,13,20
2021,216524,30,3,33,13,20
2021,216524,40,0,31,10,21
2021,216524,40,3,8,4,4
2021,216524,40,4,23,6,17
2021,216524,41,0,18,6,12
2021,216524,41,3,8,4,4
2021,216524,41,4,10,2,8
2021,216524,42,0,13,4,9
2021,216524,42,4,13,4,9
2021,216524,44,0,18,6,12
2021,216524,44,3,8,4,4
2021,216524,44,4,10,2,8
2021,216542,0,0,22,10,12
2021,216542,10,0,22,10,12
2021,216542,10,1,5,3,2
2021,216542,10,2,6,4,2
2021,216542,10,3,11,3,8
2021,216542,40,0,22,10,12
2021,216542,40,1,5,3,2
2021,216542,40,2,6,4,2
2021,216542,40,3,11,3,8
2021,216542,42,0,22,10,12
2021,216542,42,1,5,3,2
2021,216542,42,2,6,4,2
2021,216542,42,3,11,3,8
2021,216597,0,0,730,406,324
2021,216597,10,0,730,406,324
2021,216597,10,1,227,156,71
2021,216597,10,2,212,118,94
2021,216597,10,3,229,103,126
2021,216597,10,4,62,29,33
2021,216597,20,0,357,231,126
2021,216597,20,1,175,123,52
2021,216597,20,2,172,100,72
2021,216597,20,3,10,8,2
2021,216597,30,0,108,54,54
2021,216597,30,2,4,2,2
2021,216597,30,3,104,52,52
2021,216597,40,0,265,121,144
2021,216597,40,1,52,33,19
2021,216597,40,2,36,16,20
2021,216597,40,3,115,43,72
2021,216597,40,4,62,29,33
2021,216597,41,0,187,82,105
2021,216597,41,1,48,30,18
2021,216597,41,2,31,12,19
2021,216597,41,3,73,26,47
2021,216597,41,4,35,14,21
2021,216597,42,0,74,38,36
2021,216597,42,1,4,3,1
2021,216597,42,2,5,4,1
2021,216597,42,3,41,17,24
2021,216597,42,4,24,14,10
2021,216597,43,0,4,1,3
2021,216597,43,3,1,0,1
2021,216597,43,4,3,1,2
2021,216597,44,0,187,82,105
2021,216597,44,1,48,30,18
2021,216597,44,2,31,12,19
2021,216597,44,3,73,26,47
2021,216597,44,4,35,14,21
2021,216667,0,0,104,46,58
2021,216667,10,0,104,46,58
2021,216667,10,1,36,20,16
2021,216667,10,2,34,15,19
2021,216667,10,3,29,10,19
2021,216667,10,4,4,1,3
2021,216667,10,5,1,0,1
2021,216667,20,0,70,35,35
2021,216667,20,1,36,20,16
2021,216667,20,2,34,15,19
2021,216667,30,0,17,5,12
2021,216667,30,3,16,5,11
2021,216667,30,4,1,0,1
2021,216667,40,0,17,6,11
2021,216667,40,3,13,5,8
2021,216667,40,4,3,1,2
2021,216667,40,5,1,0,1
2021,216667,41,0,17,6,11
2021,216667,41,3,13,5,8
2021,216667,41,4,3,1,2
2021,216667,41,5,1,0,1
2021,216667,44,0,17,6,11
2021,216667,44,3,13,5,8
2021,216667,44,4,3,1,2
2021,216667,44,5,1,0,1
2021,216694,0,0,81,36,45
2021,216694,10,0,81,36,45
2021,216694,10,1,24,16,8
2021,216694,10,2,16,8,8
2021,216694,10,3,24,9,15
2021,216694,10,4,17,3,14
2021,216694,20,0,36,23,13
2021,216694,20,1,22,15,7
2021,216694,20,2,12,6,6
2021,216694,20,3,2,2,0
2021,216694,30,0,22,9,13
2021,216694,30,2,4,2,2
2021,216694,30,3,17,7,10
2021,216694,30,4,1,0,1
2021,216694,40,0,23,4,19
2021,216694,40,1,2,1,1
2021,216694,40,3,5,0,5
2021,216694,40,4,16,3,13
2021,216694,42,0,23,4,19
2021,216694,42,1,2,1,1
2021,216694,42,3,5,0,5
2021,216694,42,4,16,3,13
2021,216764,0,0,660,301,359
2021,216764,10,0,660,301,359
2021,216764,10,1,215,98,117
2021,216764,10,2,227,105,122
2021,216764,10,3,139,63,76
2021,216764,10,4,79,35,44
2021,216764,20,0,452,212,240
2021,216764,20,1,212,96,116
2021,216764,20,2,215,101,114
2021,216764,20,3,23,13,10
2021,216764,20,4,2,2,0
2021,216764,30,0,132,58,74
2021,216764,30,1,3,2,1
2021,216764,30,2,12,4,8
2021,216764,30,3,110,46,64
2021,216764,30,4,7,6,1
2021,216764,40,0,76,31,45
2021,216764,40,3,6,4,2
2021,216764,40,4,70,27,43
2021,216764,41,0,2,1,1
2021,216764,41,3,2,1,1
2021,216764,42,0,74,30,44
2021,216764,42,3,4,3,1
2021,216764,42,4,70,27,43
2021,216764,44,0,2,1,1
2021,216764,44,3,2,1,1
2021,216782,0,0,18,3,15
2021,216782,50,0,18,3,15
2021,216807,0,0,72,35,37
2021,216807,10,0,72,35,37
2021,216807,10,1,20,11,9
2021,216807,10,2,22,11,11
2021,216807,10,3,18,9,9
2021,216807,10,5,12,4,8
2021,216807,20,0,42,21,21
2021,216807,20,1,20,11,9
2021,216807,20,2,20,9,11
2021,216807,20,3,2,1,1
2021,216807,30,0,17,9,8
2021,216807,30,2,2,2,0
2021,216807,30,3,15,7,8
2021,216807,40,0,13,5,8
2021,216807,40,3,1,1,0
2021,216807,40,5,12,4,8
2021,216807,42,0,13,5,8
2021,216807,42,3,1,1,0
2021,216807,42,5,12,4,8
2021,216816,0,0,17,15,2
2021,216816,10,0,14,13,1
2021,216816,10,1,7,7,0
2021,216816,10,2,5,5,0
2021,216816,10,3,1,1,0
2021,216816,10,5,1,0,1
2021,216816,20,0,3,3,0
2021,216816,20,1,3,3,0
2021,216816,40,0,11,10,1
2021,216816,40,1,4,4,0
2021,216816,40,2,5,5,0
2021,216816,40,3,1,1,0
2021,216816,40,5,1,0,1
2021,216816,41,0,11,10,1
2021,216816,41,1,4,4,0
2021,216816,41,2,5,5,0
2021,216816,41,3,1,1,0
2021,216816,41,5,1,0,1
2021,216816,44,0,11,10,1
2021,216816,44,1,4,4,0
2021,216816,44,2,5,5,0
2021,216816,44,3,1,1,0
2021,216816,44,5,1,0,1
2021,216816,50,0,3,2,1
2021,216825,0,0,74,35,39
2021,216825,10,0,74,35,39
2021,216825,10,1,8,3,5
2021,216825,10,2,11,7,4
2021,216825,10,3,48,23,25
2021,216825,10,4,7,2,5
2021,216825,40,0,74,35,39
2021,216825,40,1,8,3,5
2021,216825,40,2,11,7,4
2021,216825,40,3,48,23,25
2021,216825,40,4,7,2,5
2021,216825,42,0,74,35,39
2021,216825,42,1,8,3,5
2021,216825,42,2,11,7,4
2021,216825,42,3,48,23,25
2021,216825,42,4,7,2,5
2021,216852,0,0,275,112,163
2021,216852,10,0,275,112,163
2021,216852,10,1,73,37,36
2021,216852,10,2,94,39,55
2021,216852,10,3,90,34,56
2021,216852,10,4,6,1,5
2021,216852,10,5,12,1,11
2021,216852,20,0,149,70,79
2021,216852,20,1,73,37,36
2021,216852,20,2,76,33,43
2021,216852,30,0,64,21,43
2021,216852,30,2,5,2,3
2021,216852,30,3,58,18,40
2021,216852,30,4,1,1,0
2021,216852,40,0,62,21,41
2021,216852,40,2,13,4,9
2021,216852,40,3,32,16,16
2021,216852,40,4,5,0,5
2021,216852,40,5,12,1,11
2021,216852,41,0,20,5,15
2021,216852,41,2,11,3,8
2021,216852,41,3,5,1,4
2021,216852,41,5,4,1,3
2021,216852,42,0,42,16,26
2021,216852,42,2,2,1,1
2021,216852,42,3,27,15,12
2021,216852,42,4,5,0,5
2021,216852,42,5,8,0,8
2021,216852,44,0,20,5,15
2021,216852,44,2,11,3,8
2021,216852,44,3,5,1,4
2021,216852,44,5,4,1,3
2021,216931,0,0,170,83,87
2021,216931,10,0,170,83,87
2021,216931,10,1,28,19,9
2021,216931,10,2,74,37,37
2021,216931,10,3,46,22,24
2021,216931,10,4,1,0,1
2021,216931,10,6,21,5,16
2021,216931,20,0,102,56,46
2021,216931,20,1,28,19,9
2021,216931,20,2,74,37,37
2021,216931,30,0,43,21,22
2021,216931,30,3,43,21,22
2021,216931,40,0,25,6,19
2021,216931,40,3,3,1,2
2021,216931,40,4,1,0,1
2021,216931,40,6,21,5,16
2021,216931,42,0,25,6,19
2021,216931,42,3,3,1,2
2021,216931,42,4,1,0,1
2021,216931,42,6,21,5,16
2021,216940,0,0,19,16,3
2021,216940,10,0,19,16,3
2021,216940,10,2,7,7,0
2021,216940,10,4,12,9,3
2021,216940,40,0,19,16,3
2021,216940,40,2,7,7,0
2021,216940,40,4,12,9,3
2021,216940,41,0,4,2,2
2021,216940,41,2,2,2,0
2021,216940,41,4,2,0,2
2021,216940,42,0,15,14,1
2021,216940,42,2,5,5,0
2021,216940,42,4,10,9,1
2021,216940,44,0,4,2,2
2021,216940,44,2,2,2,0
2021,216940,44,4,2,0,2
2021,217013,0,0,43,17,26
2021,217013,10,0,43,17,26
2021,217013,10,1,10,4,6
2021,217013,10,2,17,9,8
2021,217013,10,3,9,2,7
2021,217013,10,4,5,1,4
2021,217013,10,5,2,1,1
2021,217013,20,0,25,12,13
2021,217013,20,1,10,4,6
2021,217013,20,2,15,8,7
2021,217013,30,0,4,1,3
2021,217013,30,2,1,1,0
2021,217013,30,3,3,0,3
2021,217013,40,0,14,4,10
2021,217013,40,2,1,0,1
2021,217013,40,3,6,2,4
2021,217013,40,4,5,1,4
2021,217013,40,5,2,1,1
2021,217013,42,0,14,4,10
2021,217013,42,2,1,0,1
2021,217013,42,3,6,2,4
2021,217013,42,4,5,1,4
2021,217013,42,5,2,1,1
2021,217059,0,0,168,86,82
2021,217059,10,0,168,86,82
2021,217059,10,1,24,18,6
2021,217059,10,2,76,35,41
2021,217059,10,3,44,21,23
2021,217059,10,4,24,12,12
2021,217059,20,0,108,59,49
2021,217059,20,1,23,18,5
2021,217059,20,2,73,33,40
2021,217059,20,3,12,8,4
2021,217059,30,0,35,15,20
2021,217059,30,2,3,2,1
2021,217059,30,3,32,13,19
2021,217059,40,0,25,12,13
2021,217059,40,1,1,0,1
2021,217059,40,4,24,12,12
2021,217059,42,0,25,12,13
2021,217059,42,1,1,0,1
2021,217059,42,4,24,12,12
2021,217077,0,0,36,18,18
2021,217077,50,0,36,18,18
2021,217156,0,0,926,565,361
2021,217156,10,0,920,562,358
2021,217156,10,1,418,307,111
2021,217156,10,2,169,91,78
2021,217156,10,3,157,90,67
2021,217156,10,5,86,33,53
2021,217156,10,6,90,41,49
2021,217156,20,0,566,389,177
2021,217156,20,1,409,302,107
2021,217156,20,2,157,87,70
2021,217156,30,0,150,91,59
2021,217156,30,2,4,2,2
2021,217156,30,3,146,89,57
2021,217156,40,0,204,82,122
2021,217156,40,1,9,5,4
2021,217156,40,2,8,2,6
2021,217156,40,3,11,1,10
2021,217156,40,5,86,33,53
2021,217156,40,6,90,41,49
2021,217156,41,0,164,63,101
2021,217156,41,1,9,5,4
2021,217156,41,2,8,2,6
2021,217156,41,3,10,0,10
2021,217156,41,5,86,33,53
2021,217156,41,6,51,23,28
2021,217156,42,0,33,16,17
2021,217156,42,3,1,1,0
2021,217156,42,6,32,15,17
2021,217156,43,0,7,3,4
2021,217156,43,6,7,3,4
2021,217156,44,0,164,63,101
2021,217156,44,1,9,5,4
2021,217156,44,2,8,2,6
2021,217156,44,3,10,0,10
2021,217156,44,5,86,33,53
2021,217156,44,6,51,23,28
2021,217156,50,0,6,3,3
2021,217165,0,0,159,86,73
2021,217165,10,0,159,86,73
2021,217165,10,1,65,44,21
2021,217165,10,2,19,12,7
2021,217165,10,3,21,5,16
2021,217165,10,5,54,25,29
2021,217165,20,0,84,56,28
2021,217165,20,1,65,44,21
2021,217165,20,2,19,12,7
2021,217165,30,0,21,5,16
2021,217165,30,3,21,5,16
2021,217165,40,0,54,25,29
2021,217165,40,5,54,25,29
2021,217165,41,0,4,1,3
2021,217165,41,5,4,1,3
2021,217165,42,0,49,24,25
2021,217165,42,5,49,24,25
2021,217165,43,0,1,0,1
2021,217165,43,5,1,0,1
2021,217165,44,0,4,1,3
2021,217165,44,5,4,1,3
2021,217235,0,0,250,133,117
2021,217235,10,0,250,133,117
2021,217235,10,1,61,32,29
2021,217235,10,2,130,65,65
2021,217235,10,3,40,23,17
2021,217235,10,4,11,9,2
2021,217235,10,5,8,4,4
2021,217235,40,0,250,133,117
2021,217235,40,1,61,32,29
2021,217235,40,2,130,65,65
2021,217235,40,3,40,23,17
2021,217235,40,4,11,9,2
2021,217235,40,5,8,4,4
2021,217235,41,0,242,129,113
2021,217235,41,1,61,32,29
2021,217235,41,2,130,65,65
2021,217235,41,3,40,23,17
2021,217235,41,4,11,9,2
2021,217235,42,0,8,4,4
2021,217235,42,5,8,4,4
2021,217235,45,0,242,129,113
2021,217235,45,1,61,32,29
2021,217235,45,2,130,65,65
2021,217235,45,3,40,23,17
2021,217235,45,4,11,9,2
2021,217305,0,0,115,67,48
2021,217305,10,0,115,67,48
2021,217305,10,1,17,10,7
2021,217305,10,2,31,18,13
2021,217305,10,3,42,27,15
2021,217305,10,4,25,12,13
2021,217305,40,0,115,67,48
2021,217305,40,1,17,10,7
2021,217305,40,2,31,18,13
2021,217305,40,3,42,27,15
2021,217305,40,4,25,12,13
2021,217305,42,0,115,67,48
2021,217305,42,1,17,10,7
2021,217305,42,2,31,18,13
2021,217305,42,3,42,27,15
2021,217305,42,4,25,12,13
2021,217402,0,0,313,180,133
2021,217402,10,0,313,180,133
2021,217402,10,1,68,47,21
2021,217402,10,2,109,57,52
2021,217402,10,3,121,67,54
2021,217402,10,4,15,9,6
2021,217402,20,0,198,119,79
2021,217402,20,1,67,46,21
2021,217402,20,2,105,57,48
2021,217402,20,3,26,16,10
2021,217402,30,0,60,27,33
2021,217402,30,2,4,0,4
2021,217402,30,3,56,27,29
2021,217402,40,0,55,34,21
2021,217402,40,1,1,1,0
2021,217402,40,3,39,24,15
2021,217402,40,4,15,9,6
2021,217402,42,0,52,33,19
2021,217402,42,1,1,1,0
2021,217402,42,3,38,24,14
2021,217402,42,4,13,8,5
2021,217402,43,0,3,1,2
2021,217402,43,3,1,0,1
2021,217402,43,4,2,1,1
2021,217420,0,0,297,115,182
2021,217420,10,0,297,115,182
2021,217420,10,1,115,47,68
2021,217420,10,2,115,49,66
2021,217420,10,3,67,19,48
2021,217420,20,0,236,98,138
2021,217420,20,1,115,47,68
2021,217420,20,2,115,49,66
2021,217420,20,3,6,2,4
2021,217420,30,0,41,14,27
2021,217420,30,3,41,14,27
2021,217420,40,0,20,3,17
2021,217420,40,3,20,3,17
2021,217420,41,0,16,2,14
2021,217420,41,3,16,2,14
2021,217420,42,0,4,1,3
2021,217420,42,3,4,1,3
2021,217420,44,0,16,2,14
2021,217420,44,3,16,2,14
2021,217475,0,0,290,103,187
2021,217475,10,0,290,103,187
2021,217475,10,1,113,37,76
2021,217475,10,2,61,20,41
2021,217475,10,3,114,46,68
2021,217475,10,4,2,0,2
2021,217475,20,0,197,66,131
2021,217475,20,1,113,37,76
2021,217475,20,2,61,20,41
2021,217475,20,3,23,9,14
2021,217475,30,0,91,37,54
2021,217475,30,3,91,37,54
2021,217475,40,0,2,0,2
2021,217475,40,4,2,0,2
2021,217475,41,0,2,0,2
2021,217475,41,4,2,0,2
2021,217475,44,0,2,0,2
2021,217475,44,4,2,0,2
2021,217484,0,0,764,374,390
2021,217484,10,0,764,374,390
2021,217484,10,1,248,148,100
2021,217484,10,2,161,80,81
2021,217484,10,3,179,80,99
2021,217484,10,5,176,66,110
2021,217484,20,0,380,220,160
2021,217484,20,1,236,145,91
2021,217484,20,2,144,75,69
2021,217484,30,0,158,76,82
2021,217484,30,2,2,1,1
2021,217484,30,3,156,75,81
2021,217484,40,0,226,78,148
2021,217484,40,1,12,3,9
2021,217484,40,2,15,4,11
2021,217484,40,3,23,5,18
2021,217484,40,5,176,66,110
2021,217484,41,0,159,50,109
2021,217484,41,1,11,2,9
2021,217484,41,2,15,4,11
2021,217484,41,3,23,5,18
2021,217484,41,5,110,39,71
2021,217484,42,0,64,26,38
2021,217484,42,5,64,26,38
2021,217484,43,0,3,2,1
2021,217484,43,1,1,1,0
2021,217484,43,5,2,1,1
2021,217484,44,0,159,50,109
2021,217484,44,1,11,2,9
2021,217484,44,2,15,4,11
2021,217484,44,3,23,5,18
2021,217484,44,5,110,39,71
2021,217493,0,0,200,98,102
2021,217493,10,0,200,98,102
2021,217493,10,1,69,35,34
2021,217493,10,2,63,37,26
2021,217493,10,3,68,26,42
2021,217493,40,0,200,98,102
2021,217493,40,1,69,35,34
2021,217493,40,2,63,37,26
2021,217493,40,3,68,26,42
2021,217493,41,0,161,83,78
2021,217493,41,1,69,35,34
2021,217493,41,2,62,36,26
2021,217493,41,3,30,12,18
2021,217493,42,0,39,15,24
2021,217493,42,2,1,1,0
2021,217493,42,3,38,14,24
2021,217493,44,0,161,83,78
2021,217493,44,1,69,35,34
2021,217493,44,2,62,36,26
2021,217493,44,3,30,12,18
2021,217518,0,0,195,102,93
2021,217518,10,0,195,102,93
2021,217518,10,1,101,58,43
2021,217518,10,2,54,26,28
2021,217518,10,3,34,16,18
2021,217518,10,5,6,2,4
2021,217518,20,0,152,82,70
2021,217518,20,1,101,58,43
2021,217518,20,2,51,24,27
2021,217518,30,0,33,17,16
2021,217518,30,2,3,2,1
2021,217518,30,3,30,15,15
2021,217518,40,0,10,3,7
2021,217518,40,3,4,1,3
2021,217518,40,5,6,2,4
2021,217518,41,0,10,3,7
2021,217518,41,3,4,1,3
2021,217518,41,5,6,2,4
2021,217518,44,0,10,3,7
2021,217518,44,3,4,1,3
2021,217518,44,5,6,2,4
2021,217536,0,0,120,44,76
2021,217536,10,0,120,44,76
2021,217536,10,1,27,15,12
2021,217536,10,2,33,13,20
2021,217536,10,3,37,10,27
2021,217536,10,5,23,6,17
2021,217536,20,0,60,28,32
2021,217536,20,1,27,15,12
2021,217536,20,2,33,13,20
2021,217536,30,0,32,8,24
2021,217536,30,3,32,8,24
2021,217536,40,0,28,8,20
2021,217536,40,3,5,2,3
2021,217536,40,5,23,6,17
2021,217536,41,0,4,2,2
2021,217536,41,5,4,2,2
2021,217536,42,0,24,6,18
2021,217536,42,3,5,2,3
2021,217536,42,5,19,4,15
2021,217536,44,0,4,2,2
2021,217536,44,5,4,2,2
2021,217606,0,0,6,6,0
2021,217606,10,0,6,6,0
2021,217606,10,1,4,4,0
2021,217606,10,2,1,1,0
2021,217606,10,3,1,1,0
2021,217606,40,0,6,6,0
2021,217606,40,1,4,4,0
2021,217606,40,2,1,1,0
2021,217606,40,3,1,1,0
2021,217606,42,0,6,6,0
2021,217606,42,1,4,4,0
2021,217606,42,2,1,1,0
2021,217606,42,3,1,1,0
2021,217615,0,0,52,23,29
2021,217615,10,0,52,23,29
2021,217615,10,6,52,23,29
2021,217615,40,0,52,23,29
2021,217615,40,6,52,23,29
2021,217615,41,0,52,23,29
2021,217615,41,6,52,23,29
2021,217615,45,0,52,23,29
2021,217615,45,6,52,23,29
2021,217624,0,0,41,28,13
2021,217624,10,0,41,28,13
2021,217624,10,2,6,5,1
2021,217624,10,3,28,18,10
2021,217624,10,4,7,5,2
2021,217624,20,0,4,3,1
2021,217624,20,2,3,2,1
2021,217624,20,3,1,1,0
2021,217624,30,0,8,6,2
2021,217624,30,2,3,3,0
2021,217624,30,3,5,3,2
2021,217624,40,0,29,19,10
2021,217624,40,3,22,14,8
2021,217624,40,4,7,5,2
2021,217624,42,0,29,19,10
2021,217624,42,3,22,14,8
2021,217624,42,4,7,5,2
2021,217633,0,0,176,83,93
2021,217633,10,0,176,83,93
2021,217633,10,1,26,19,7
2021,217633,10,2,43,25,18
2021,217633,10,3,69,27,42
2021,217633,10,4,27,9,18
2021,217633,10,5,11,3,8
2021,217633,20,0,39,25,14
2021,217633,20,1,20,16,4
2021,217633,20,2,17,9,8
2021,217633,20,3,2,0,2
2021,217633,30,0,43,28,15
2021,217633,30,1,3,2,1
2021,217633,30,2,15,9,6
2021,217633,30,3,25,17,8
2021,217633,40,0,94,30,64
2021,217633,40,1,3,1,2
2021,217633,40,2,11,7,4
2021,217633,40,3,42,10,32
2021,217633,40,4,27,9,18
2021,217633,40,5,11,3,8
2021,217633,42,0,94,30,64
2021,217633,42,1,3,1,2
2021,217633,42,2,11,7,4
2021,217633,42,3,42,10,32
2021,217633,42,4,27,9,18
2021,217633,42,5,11,3,8
2021,217688,0,0,236,124,112
2021,217688,10,0,203,100,103
2021,217688,10,1,45,29,16
2021,217688,10,2,56,34,22
2021,217688,10,3,79,32,47
2021,217688,10,4,23,5,18
2021,217688,20,0,31,15,16
2021,217688,20,1,28,13,15
2021,217688,20,2,2,2,0
2021,217688,20,3,1,0,1
2021,217688,30,0,104,66,38
2021,217688,30,1,15,15,0
2021,217688,30,2,50,31,19
2021,217688,30,3,39,20,19
2021,217688,40,0,68,19,49
2021,217688,40,1,2,1,1
2021,217688,40,2,4,1,3
2021,217688,40,3,39,12,27
2021,217688,40,4,23,5,18
2021,217688,41,0,24,8,16
2021,217688,41,1,1,0,1
2021,217688,41,2,3,0,3
2021,217688,41,3,20,8,12
2021,217688,42,0,44,11,33
2021,217688,42,1,1,1,0
2021,217688,42,2,1,1,0
2021,217688,42,3,19,4,15
2021,217688,42,4,23,5,18
2021,217688,44,0,24,8,16
2021,217688,44,1,1,0,1
2021,217688,44,2,3,0,3
2021,217688,44,3,20,8,12
2021,217688,50,0,33,24,9
2021,217712,0,0,46,21,25
2021,217712,10,0,46,21,25
2021,217712,10,6,46,21,25
2021,217712,40,0,46,21,25
2021,217712,40,6,46,21,25
2021,217712,41,0,46,21,25
2021,217712,41,6,46,21,25
2021,217712,45,0,46,21,25
2021,217712,45,6,46,21,25
2021,217721,0,0,91,50,41
2021,217721,10,0,91,50,41
2021,217721,10,1,14,8,6
2021,217721,10,2,31,22,9
2021,217721,10,3,18,9,9
2021,217721,10,4,28,11,17
2021,217721,20,0,37,25,12
2021,217721,20,1,13,8,5
2021,217721,20,2,24,17,7
2021,217721,30,0,24,13,11
2021,217721,30,1,1,0,1
2021,217721,30,2,6,4,2
2021,217721,30,3,17,9,8
2021,217721,40,0,30,12,18
2021,217721,40,2,1,1,0
2021,217721,40,3,1,0,1
2021,217721,40,4,28,11,17
2021,217721,42,0,30,12,18
2021,217721,42,2,1,1,0
2021,217721,42,3,1,0,1
2021,217721,42,4,28,11,17
2021,217749,0,0,168,100,68
2021,217749,10,0,168,100,68
2021,217749,10,1,53,41,12
2021,217749,10,2,59,30,29
2021,217749,10,3,49,27,22
2021,217749,10,4,7,2,5
2021,217749,40,0,168,100,68
2021,217749,40,1,53,41,12
2021,217749,40,2,59,30,29
2021,217749,40,3,49,27,22
2021,217749,40,4,7,2,5
2021,217749,42,0,168,100,68
2021,217749,42,1,53,41,12
2021,217749,42,2,59,30,29
2021,217749,42,3,49,27,22
2021,217749,42,4,7,2,5
2021,217776,0,0,52,31,21
2021,217776,10,0,52,31,21
2021,217776,10,1,14,11,3
2021,217776,10,2,17,11,6
2021,217776,10,3,19,9,10
2021,217776,10,4,2,0,2
2021,217776,20,0,16,11,5
2021,217776,20,1,11,9,2
2021,217776,20,2,5,2,3
2021,217776,30,0,34,20,14
2021,217776,30,1,3,2,1
2021,217776,30,2,12,9,3
2021,217776,30,3,19,9,10
2021,217776,40,0,2,0,2
2021,217776,40,4,2,0,2
2021,217776,42,0,2,0,2
2021,217776,42,4,2,0,2
2021,217819,0,0,509,261,248
2021,217819,10,0,509,261,248
2021,217819,10,1,148,94,54
2021,217819,10,2,188,96,92
2021,217819,10,3,115,53,62
2021,217819,10,4,58,18,40
2021,217819,20,0,330,187,143
2021,217819,20,1,147,94,53
2021,217819,20,2,182,93,89
2021,217819,20,3,1,0,1
2021,217819,30,0,99,44,55
2021,217819,30,1,1,0,1
2021,217819,30,2,2,2,0
2021,217819,30,3,96,42,54
2021,217819,40,0,80,30,50
2021,217819,40,2,4,1,3
2021,217819,40,3,18,11,7
2021,217819,40,4,58,18,40
2021,217819,41,0,53,16,37
2021,217819,41,4,53,16,37
2021,217819,42,0,27,14,13
2021,217819,42,2,4,1,3
2021,217819,42,3,18,11,7
2021,217819,42,4,5,2,3
2021,217819,44,0,53,16,37
2021,217819,44,4,53,16,37
2021,217837,0,0,26,13,13
2021,217837,10,0,26,13,13
2021,217837,10,6,26,13,13
2021,217837,40,0,26,13,13
2021,217837,40,6,26,13,13
2021,217837,41,0,26,13,13
2021,217837,41,6,26,13,13
2021,217837,45,0,26,13,13
2021,217837,45,6,26,13,13
2021,217864,0,0,217,133,84
2021,217864,10,0,217,133,84
2021,217864,10,1,67,50,17
2021,217864,10,2,65,33,32
2021,217864,10,3,58,36,22
2021,217864,10,4,27,14,13
2021,217864,20,0,115,74,41
2021,217864,20,1,64,48,16
2021,217864,20,2,50,25,25
2021,217864,20,3,1,1,0
2021,217864,30,0,71,42,29
2021,217864,30,1,1,1,0
2021,217864,30,2,15,8,7
2021,217864,30,3,55,33,22
2021,217864,40,0,31,17,14
2021,217864,40,1,2,1,1
2021,217864,40,3,2,2,0
2021,217864,40,4,27,14,13
2021,217864,41,0,15,7,8
2021,217864,41,1,2,1,1
2021,217864,41,3,1,1,0
2021,217864,41,4,12,5,7
2021,217864,42,0,16,10,6
2021,217864,42,3,1,1,0
2021,217864,42,4,15,9,6
2021,217864,44,0,15,7,8
2021,217864,44,1,2,1,1
2021,217864,44,3,1,1,0
2021,217864,44,4,12,5,7
2021,217873,0,0,118,63,55
2021,217873,10,0,118,63,55
2021,217873,10,1,18,11,7
2021,217873,10,2,39,24,15
2021,217873,10,3,46,24,22
2021,217873,10,4,13,4,9
2021,217873,10,5,1,0,1
2021,217873,10,6,1,0,1
2021,217873,20,0,47,30,17
2021,217873,20,1,17,10,7
2021,217873,20,2,28,19,9
2021,217873,20,3,2,1,1
2021,217873,30,0,35,21,14
2021,217873,30,1,1,1,0
2021,217873,30,2,5,2,3
2021,217873,30,3,27,17,10
2021,217873,30,4,1,1,0
2021,217873,30,6,1,0,1
2021,217873,40,0,36,12,24
2021,217873,40,2,6,3,3
2021,217873,40,3,17,6,11
2021,217873,40,4,12,3,9
2021,217873,40,5,1,0,1
2021,217873,42,0,36,12,24
2021,217873,42,2,6,3,3
2021,217873,42,3,17,6,11
2021,217873,42,4,12,3,9
2021,217873,42,5,1,0,1
2021,217882,0,0,1394,831,563
2021,217882,10,0,1394,831,563
2021,217882,10,1,373,285,88
2021,217882,10,2,329,200,129
2021,217882,10,3,263,148,115
2021,217882,10,4,1,1,0
2021,217882,10,5,328,144,184
2021,217882,10,6,100,53,47
2021,217882,20,0,688,476,212
2021,217882,20,1,373,285,88
2021,217882,20,2,315,191,124
2021,217882,30,0,276,156,120
2021,217882,30,2,14,9,5
2021,217882,30,3,262,147,115
2021,217882,40,0,430,199,231
2021,217882,40,3,1,1,0
2021,217882,40,4,1,1,0
2021,217882,40,5,328,144,184
2021,217882,40,6,100,53,47
2021,217882,41,0,177,80,97
2021,217882,41,5,177,80,97
2021,217882,42,0,248,116,132
2021,217882,42,3,1,1,0
2021,217882,42,4,1,1,0
2021,217882,42,5,150,63,87
2021,217882,42,6,96,51,45
2021,217882,43,0,5,3,2
2021,217882,43,5,1,1,0
2021,217882,43,6,4,2,2
2021,217882,44,0,177,80,97
2021,217882,44,5,177,80,97
2021,217891,0,0,10,8,2
2021,217891,10,0,10,8,2
2021,217891,10,1,10,8,2
2021,217891,40,0,10,8,2
2021,217891,40,1,10,8,2
2021,217891,43,0,10,8,2
2021,217891,43,1,10,8,2
2021,217907,0,0,63,30,33
2021,217907,10,0,63,30,33
2021,217907,10,1,19,9,10
2021,217907,10,2,17,7,10
2021,217907,10,3,23,11,12
2021,217907,10,5,4,3,1
2021,217907,20,0,38,16,22
2021,217907,20,1,14,8,6
2021,217907,20,2,17,7,10
2021,217907,20,3,7,1,6
2021,217907,30,0,15,9,6
2021,217907,30,1,1,0,1
2021,217907,30,3,14,9,5
2021,217907,40,0,10,5,5
2021,217907,40,1,4,1,3
2021,217907,40,3,2,1,1
2021,217907,40,5,4,3,1
2021,217907,42,0,10,5,5
2021,217907,42,1,4,1,3
2021,217907,42,3,2,1,1
2021,217907,42,5,4,3,1
2021,217925,0,0,50,33,17
2021,217925,10,0,48,33,15
2021,217925,10,1,22,17,5
2021,217925,10,2,26,16,10
2021,217925,40,0,48,33,15
2021,217925,40,1,22,17,5
2021,217925,40,2,26,16,10
2021,217925,41,0,28,21,7
2021,217925,41,1,21,16,5
2021,217925,41,2,7,5,2
2021,217925,42,0,20,12,8
2021,217925,42,1,1,1,0
2021,217925,42,2,19,11,8
2021,217925,44,0,28,21,7
2021,217925,44,1,21,16,5
2021,217925,44,2,7,5,2
2021,217925,50,0,2,0,2
2021,217934,0,0,54,16,38
2021,217934,10,0,54,16,38
2021,217934,10,1,9,2,7
2021,217934,10,2,7,3,4
2021,217934,10,3,17,4,13
2021,217934,10,5,21,7,14
2021,217934,20,0,14,3,11
2021,217934,20,1,9,2,7
2021,217934,20,2,5,1,4
2021,217934,30,0,19,6,13
2021,217934,30,2,2,2,0
2021,217934,30,3,17,4,13
2021,217934,40,0,21,7,14
2021,217934,40,5,21,7,14
2021,217934,42,0,21,7,14
2021,217934,42,5,21,7,14
2021,217961,0,0,86,30,56
2021,217961,10,0,86,30,56
2021,217961,10,1,18,11,7
2021,217961,10,2,29,7,22
2021,217961,10,3,34,11,23
2021,217961,10,4,3,1,2
2021,217961,10,5,2,0,2
2021,217961,20,0,48,19,29
2021,217961,20,1,18,11,7
2021,217961,20,2,29,7,22
2021,217961,20,3,1,1,0
2021,217961,30,0,33,10,23
2021,217961,30,3,33,10,23
2021,217961,40,0,5,1,4
2021,217961,40,4,3,1,2
2021,217961,40,5,2,0,2
2021,217961,42,0,5,1,4
2021,217961,42,4,3,1,2
2021,217961,42,5,2,0,2
2021,217989,0,0,16,8,8
2021,217989,10,0,16,8,8
2021,217989,10,6,16,8,8
2021,217989,40,0,16,8,8
2021,217989,40,6,16,8,8
2021,217989,41,0,16,8,8
2021,217989,41,6,16,8,8
2021,217989,45,0,16,8,8
2021,217989,45,6,16,8,8
2021,217998,0,0,38,18,20
2021,217998,10,0,38,18,20
2021,217998,10,1,13,11,2
2021,217998,10,2,11,4,7
2021,217998,10,3,14,3,11
2021,217998,20,0,14,10,4
2021,217998,20,1,9,9,0
2021,217998,20,2,5,1,4
2021,217998,30,0,19,7,12
2021,217998,30,1,3,2,1
2021,217998,30,2,6,3,3
2021,217998,30,3,10,2,8
2021,217998,40,0,5,1,4
2021,217998,40,1,1,0,1
2021,217998,40,3,4,1,3
2021,217998,42,0,5,1,4
2021,217998,42,1,1,0,1
2021,217998,42,3,4,1,3
2021,218025,0,0,75,33,42
2021,218025,10,0,75,33,42
2021,218025,10,6,75,33,42
2021,218025,40,0,75,33,42
2021,218025,40,6,75,33,42
2021,218025,41,0,75,33,42
2021,218025,41,6,75,33,42
2021,218025,45,0,75,33,42
2021,218025,45,6,75,33,42
2021,218061,0,0,210,102,108
2021,218061,10,0,210,102,108
2021,218061,10,1,74,48,26
2021,218061,10,2,51,21,30
2021,218061,10,3,74,31,43
2021,218061,10,4,11,2,9
2021,218061,20,0,125,69,56
2021,218061,20,1,73,47,26
2021,218061,20,2,50,21,29
2021,218061,20,3,2,1,1
2021,218061,30,0,64,28,36
2021,218061,30,2,1,0,1
2021,218061,30,3,63,28,35
2021,218061,40,0,21,5,16
2021,218061,40,1,1,1,0
2021,218061,40,3,9,2,7
2021,218061,40,4,11,2,9
2021,218061,41,0,1,0,1
2021,218061,41,4,1,0,1
2021,218061,42,0,20,5,15
2021,218061,42,1,1,1,0
2021,218061,42,3,9,2,7
2021,218061,42,4,10,2,8
2021,218061,44,0,1,0,1
2021,218061,44,4,1,0,1
2021,218070,0,0,256,138,118
2021,218070,10,0,256,138,118
2021,218070,10,1,112,77,35
2021,218070,10,2,63,27,36
2021,218070,10,3,67,29,38
2021,218070,10,4,4,1,3
2021,218070,10,5,10,4,6
2021,218070,20,0,167,102,65
2021,218070,20,1,108,76,32
2021,218070,20,2,59,26,33
2021,218070,30,0,56,22,34
2021,218070,30,1,3,0,3
2021,218070,30,2,2,1,1
2021,218070,30,3,50,21,29
2021,218070,30,4,1,0,1
2021,218070,40,0,33,14,19
2021,218070,40,1,1,1,0
2021,218070,40,2,2,0,2
2021,218070,40,3,17,8,9
2021,218070,40,4,3,1,2
2021,218070,40,5,10,4,6
2021,218070,42,0,33,14,19
2021,218070,42,1,1,1,0
2021,218070,42,2,2,0,2
2021,218070,42,3,17,8,9
2021,218070,42,4,3,1,2
2021,218070,42,5,10,4,6
2021,218113,0,0,311,128,183
2021,218113,10,0,311,128,183
2021,218113,10,6,311,128,183
2021,218113,40,0,311,128,183
2021,218113,40,6,311,128,183
2021,218113,41,0,311,128,183
2021,218113,41,6,311,128,183
2021,218113,45,0,311,128,183
2021,218113,45,6,311,128,183
2021,218140,0,0,164,77,87
2021,218140,10,0,164,77,87
2021,218140,10,6,164,77,87
2021,218140,40,0,164,77,87
2021,218140,40,6,164,77,87
2021,218140,41,0,164,77,87
2021,218140,41,6,164,77,87
2021,218140,45,0,164,77,87
2021,218140,45,6,164,77,87
2021,218229,0,0,159,65,94
2021,218229,10,0,159,65,94
2021,218229,10,1,20,12,8
2021,218229,10,2,32,19,13
2021,218229,10,3,56,25,31
2021,218229,10,4,9,0,9
2021,218229,10,5,35,8,27
2021,218229,10,6,7,1,6
2021,218229,20,0,56,32,24
2021,218229,20,1,20,12,8
2021,218229,20,2,28,16,12
2021,218229,20,3,6,4,2
2021,218229,20,5,1,0,1
2021,218229,20,6,1,0,1
2021,218229,30,0,53,22,31
2021,218229,30,2,2,2,0
2021,218229,30,3,44,17,27
2021,218229,30,5,6,2,4
2021,218229,30,6,1,1,0
2021,218229,40,0,50,11,39
2021,218229,40,2,2,1,1
2021,218229,40,3,6,4,2
2021,218229,40,4,9,0,9
2021,218229,40,5,28,6,22
2021,218229,40,6,5,0,5
2021,218229,41,0,3,1,2
2021,218229,41,5,1,1,0
2021,218229,41,6,2,0,2
2021,218229,42,0,5,3,2
2021,218229,42,3,1,1,0
2021,218229,42,4,1,0,1
2021,218229,42,5,3,2,1
2021,218229,43,0,42,7,35
2021,218229,43,2,2,1,1
2021,218229,43,3,5,3,2
2021,218229,43,4,8,0,8
2021,218229,43,5,24,3,21
2021,218229,43,6,3,0,3
2021,218229,45,0,3,1,2
2021,218229,45,5,1,1,0
2021,218229,45,6,2,0,2
2021,218238,0,0,94,41,53
2021,218238,10,0,94,41,53
2021,218238,10,1,26,14,12
2021,218238,10,2,25,13,12
2021,218238,10,3,24,7,17
2021,218238,10,4,1,0,1
2021,218238,10,5,18,7,11
2021,218238,20,0,43,22,21
2021,218238,20,1,25,13,12
2021,218238,20,2,16,9,7
2021,218238,20,3,2,0,2
2021,218238,30,0,31,11,20
2021,218238,30,2,9,4,5
2021,218238,30,3,22,7,15
2021,218238,40,0,20,8,12
2021,218238,40,1,1,1,0
2021,218238,40,4,1,0,1
2021,218238,40,5,18,7,11
2021,218238,42,0,20,8,12
2021,218238,42,1,1,1,0
2021,218238,42,4,1,0,1
2021,218238,42,5,18,7,11
2021,218335,0,0,224,80,144
2021,218335,10,0,224,80,144
2021,218335,10,1,54,30,24
2021,218335,10,2,60,20,40
2021,218335,10,3,61,20,41
2021,218335,10,4,49,10,39
2021,218335,20,0,45,24,21
2021,218335,20,1,38,23,15
2021,218335,20,2,6,1,5
2021,218335,20,3,1,0,1
2021,218335,30,0,107,32,75
2021,218335,30,1,10,6,4
2021,218335,30,2,40,13,27
2021,218335,30,3,38,10,28
2021,218335,30,4,19,3,16
2021,218335,40,0,72,24,48
2021,218335,40,1,6,1,5
2021,218335,40,2,14,6,8
2021,218335,40,3,22,10,12
2021,218335,40,4,30,7,23
2021,218335,42,0,72,24,48
2021,218335,42,1,6,1,5
2021,218335,42,2,14,6,8
2021,218335,42,3,22,10,12
2021,218335,42,4,30,7,23
2021,218353,0,0,208,95,113
2021,218353,10,0,208,95,113
2021,218353,10,6,208,95,113
2021,218353,40,0,208,95,113
2021,218353,40,6,208,95,113
2021,218353,41,0,208,95,113
2021,218353,41,6,208,95,113
2021,218353,45,0,208,95,113
2021,218353,45,6,208,95,113
2021,218399,0,0,24,13,11
2021,218399,10,0,24,13,11
2021,218399,10,1,7,5,2
2021,218399,10,2,7,3,4
2021,218399,10,3,8,4,4
2021,218399,10,4,2,1,1
2021,218399,40,0,24,13,11
2021,218399,40,1,7,5,2
2021,218399,40,2,7,3,4
2021,218399,40,3,8,4,4
2021,218399,40,4,2,1,1
2021,218399,41,0,1,1,0
2021,218399,41,1,1,1,0
2021,218399,42,0,23,12,11
2021,218399,42,1,6,4,2
2021,218399,42,2,7,3,4
2021,218399,42,3,8,4,4
2021,218399,42,4,2,1,1
2021,218399,44,0,1,1,0
2021,218399,44,1,1,1,0
2021,218414,0,0,71,35,36
2021,218414,10,0,71,35,36
2021,218414,10,1,18,14,4
2021,218414,10,2,14,6,8
2021,218414,10,3,39,15,24
2021,218414,20,0,36,20,16
2021,218414,20,1,13,11,2
2021,218414,20,2,13,6,7
2021,218414,20,3,10,3,7
2021,218414,30,0,23,11,12
2021,218414,30,1,1,1,0
2021,218414,30,3,22,10,12
2021,218414,40,0,12,4,8
2021,218414,40,1,4,2,2
2021,218414,40,2,1,0,1
2021,218414,40,3,7,2,5
2021,218414,42,0,12,4,8
2021,218414,42,1,4,2,2
2021,218414,42,2,1,0,1
2021,218414,42,3,7,2,5
2021,218441,0,0,149,86,63
2021,218441,10,0,149,86,63
2021,218441,10,1,37,25,12
2021,218441,10,2,31,21,10
2021,218441,10,3,42,22,20
2021,218441,10,4,38,17,21
2021,218441,10,6,1,1,0
2021,218441,40,0,149,86,63
2021,218441,40,1,37,25,12
2021,218441,40,2,31,21,10
2021,218441,40,3,42,22,20
2021,218441,40,4,38,17,21
2021,218441,40,6,1,1,0
2021,218441,42,0,149,86,63
2021,218441,42,1,37,25,12
2021,218441,42,2,31,21,10
2021,218441,42,3,42,22,20
2021,218441,42,4,38,17,21
2021,218441,42,6,1,1,0
2021,218487,0,0,66,20,46
2021,218487,10,0,66,20,46
2021,218487,10,6,66,20,46
2021,218487,40,0,66,20,46
2021,218487,40,6,66,20,46
2021,218487,41,0,66,20,46
2021,218487,41,6,66,20,46
2021,218487,45,0,66,20,46
2021,218487,45,6,66,20,46
2021,218520,0,0,113,50,63
2021,218520,10,0,113,50,63
2021,218520,10,6,113,50,63
2021,218520,40,0,113,50,63
2021,218520,40,6,113,50,63
2021,218520,41,0,113,50,63
2021,218520,41,6,113,50,63
2021,218520,45,0,113,50,63
2021,218520,45,6,113,50,63
2021,218539,0,0,105,60,45
2021,218539,10,0,105,60,45
2021,218539,10,1,45,34,11
2021,218539,10,2,29,13,16
2021,218539,10,3,29,12,17
2021,218539,10,4,1,1,0
2021,218539,10,6,1,0,1
2021,218539,20,0,69,44,25
2021,218539,20,1,45,34,11
2021,218539,20,2,20,9,11
2021,218539,20,3,4,1,3
2021,218539,30,0,21,10,11
2021,218539,30,2,6,2,4
2021,218539,30,3,15,8,7
2021,218539,40,0,15,6,9
2021,218539,40,2,3,2,1
2021,218539,40,3,10,3,7
2021,218539,40,4,1,1,0
2021,218539,40,6,1,0,1
2021,218539,42,0,15,6,9
2021,218539,42,2,3,2,1
2021,218539,42,3,10,3,7
2021,218539,42,4,1,1,0
2021,218539,42,6,1,0,1
2021,218645,0,0,159,77,82
2021,218645,10,0,159,77,82
2021,218645,10,1,35,27,8
2021,218645,10,2,53,21,32
2021,218645,10,3,41,15,26
2021,218645,10,4,30,14,16
2021,218645,20,0,87,47,40
2021,218645,20,1,34,26,8
2021,218645,20,2,52,20,32
2021,218645,20,3,1,1,0
2021,218645,30,0,42,16,26
2021,218645,30,1,1,1,0
2021,218645,30,2,1,1,0
2021,218645,30,3,40,14,26
2021,218645,40,0,30,14,16
2021,218645,40,4,30,14,16
2021,218645,41,0,11,7,4
2021,218645,41,4,11,7,4
2021,218645,42,0,19,7,12
2021,218645,42,4,19,7,12
2021,218645,44,0,11,7,4
2021,218645,44,4,11,7,4
2021,218654,0,0,90,38,52
2021,218654,10,0,90,38,52
2021,218654,10,1,14,8,6
2021,218654,10,2,30,14,16
2021,218654,10,3,25,10,15
2021,218654,10,4,21,6,15
2021,218654,20,0,42,21,21
2021,218654,20,1,14,8,6
2021,218654,20,2,28,13,15
2021,218654,30,0,26,11,15
2021,218654,30,2,2,1,1
2021,218654,30,3,24,10,14
2021,218654,40,0,22,6,16
2021,218654,40,3,1,0,1
2021,218654,40,4,21,6,15
2021,218654,41,0,1,0,1
2021,218654,41,4,1,0,1
2021,218654,42,0,21,6,15
2021,218654,42,3,1,0,1
2021,218654,42,4,20,6,14
2021,218654,44,0,1,0,1
2021,218654,44,4,1,0,1
2021,218663,0,0,1675,908,767
2021,218663,10,0,1675,908,767
2021,218663,10,1,492,339,153
2021,218663,10,2,524,272,252
2021,218663,10,3,399,181,218
2021,218663,10,4,230,103,127
2021,218663,10,5,26,13,13
2021,218663,10,6,4,0,4
2021,218663,20,0,840,523,317
2021,218663,20,1,458,315,143
2021,218663,20,2,382,208,174
2021,218663,30,0,262,140,122
2021,218663,30,1,1,1,0
2021,218663,30,2,18,9,9
2021,218663,30,3,243,130,113
2021,218663,40,0,573,245,328
2021,218663,40,1,33,23,10
2021,218663,40,2,124,55,69
2021,218663,40,3,156,51,105
2021,218663,40,4,230,103,127
2021,218663,40,5,26,13,13
2021,218663,40,6,4,0,4
2021,218663,41,0,194,80,114
2021,218663,41,1,14,8,6
2021,218663,41,2,30,9,21
2021,218663,41,3,29,7,22
2021,218663,41,4,112,51,61
2021,218663,41,5,7,5,2
2021,218663,41,6,2,0,2
2021,218663,42,0,374,164,210
2021,218663,42,1,18,15,3
2021,218663,42,2,92,46,46
2021,218663,42,3,125,43,82
2021,218663,42,4,118,52,66
2021,218663,42,5,19,8,11
2021,218663,42,6,2,0,2
2021,218663,43,0,5,1,4
2021,218663,43,1,1,0,1
2021,218663,43,2,2,0,2
2021,218663,43,3,2,1,1
2021,218663,44,0,194,80,114
2021,218663,44,1,14,8,6
2021,218663,44,2,30,9,21
2021,218663,44,3,29,7,22
2021,218663,44,4,112,51,61
2021,218663,44,5,7,5,2
2021,218663,44,6,2,0,2
2021,218672,0,0,50,28,22
2021,218672,10,0,50,28,22
2021,218672,10,1,10,6,4
2021,218672,10,2,18,10,8
2021,218672,10,3,5,2,3
2021,218672,10,4,17,10,7
2021,218672,20,0,28,16,12
2021,218672,20,1,10,6,4
2021,218672,20,2,18,10,8
2021,218672,30,0,5,2,3
2021,218672,30,3,5,2,3
2021,218672,40,0,17,10,7
2021,218672,40,4,17,10,7
2021,218672,41,0,11,6,5
2021,218672,41,4,11,6,5
2021,218672,42,0,6,4,2
2021,218672,42,4,6,4,2
2021,218672,44,0,11,6,5
2021,218672,44,4,11,6,5
2021,218681,0,0,22,14,8
2021,218681,10,0,22,14,8
2021,218681,10,1,4,3,1
2021,218681,10,2,5,4,1
2021,218681,10,3,8,4,4
2021,218681,10,4,5,3,2
2021,218681,20,0,9,7,2
2021,218681,20,1,4,3,1
2021,218681,20,2,5,4,1
2021,218681,30,0,8,4,4
2021,218681,30,3,8,4,4
2021,218681,40,0,5,3,2
2021,218681,40,4,5,3,2
2021,218681,41,0,2,2,0
2021,218681,41,4,2,2,0
2021,218681,42,0,3,1,2
2021,218681,42,4,3,1,2
2021,218681,44,0,2,2,0
2021,218681,44,4,2,2,0
2021,218690,0,0,42,19,23
2021,218690,10,0,42,19,23
2021,218690,10,1,12,6,6
2021,218690,10,2,2,2,0
2021,218690,10,3,9,4,5
2021,218690,10,4,19,7,12
2021,218690,20,0,15,9,6
2021,218690,20,1,12,6,6
2021,218690,20,2,2,2,0
2021,218690,20,3,1,1,0
2021,218690,30,0,8,3,5
2021,218690,30,3,8,3,5
2021,218690,40,0,19,7,12
2021,218690,40,4,19,7,12
2021,218690,41,0,3,1,2
2021,218690,41,4,3,1,2
2021,218690,42,0,16,6,10
2021,218690,42,4,16,6,10
2021,218690,44,0,3,1,2
2021,218690,44,4,3,1,2
2021,218706,0,0,15,5,10
2021,218706,10,0,15,5,10
2021,218706,10,1,1,0,1
2021,218706,10,2,3,2,1
2021,218706,10,3,5,1,4
2021,218706,10,4,6,2,4
2021,218706,20,0,4,2,2
2021,218706,20,1,1,0,1
2021,218706,20,2,3,2,1
2021,218706,30,0,5,1,4
2021,218706,30,3,5,1,4
2021,218706,40,0,6,2,4
2021,218706,40,4,6,2,4
2021,218706,41,0,1,1,0
2021,218706,41,4,1,1,0
2021,218706,42,0,5,1,4
2021,218706,42,4,5,1,4
2021,218706,44,0,1,1,0
2021,218706,44,4,1,1,0
2021,218724,0,0,476,262,214
2021,218724,10,0,476,262,214
2021,218724,10,1,109,81,28
2021,218724,10,2,117,63,54
2021,218724,10,3,114,55,59
2021,218724,10,4,6,4,2
2021,218724,10,5,129,58,71
2021,218724,10,6,1,1,0
2021,218724,20,0,220,139,81
2021,218724,20,1,109,81,28
2021,218724,20,2,110,58,52
2021,218724,20,3,1,0,1
2021,218724,30,0,112,56,56
2021,218724,30,2,7,5,2
2021,218724,30,3,105,51,54
2021,218724,40,0,144,67,77
2021,218724,40,3,8,4,4
2021,218724,40,4,6,4,2
2021,218724,40,5,129,58,71
2021,218724,40,6,1,1,0
2021,218724,42,0,144,67,77
2021,218724,42,3,8,4,4
2021,218724,42,4,6,4,2
2021,218724,42,5,129,58,71
2021,218724,42,6,1,1,0
2021,218733,0,0,124,65,59
2021,218733,10,0,124,65,59
2021,218733,10,1,33,21,12
2021,218733,10,2,25,11,14
2021,218733,10,3,41,22,19
2021,218733,10,4,25,11,14
2021,218733,20,0,57,33,24
2021,218733,20,1,33,21,12
2021,218733,20,2,23,11,12
2021,218733,20,3,1,1,0
2021,218733,30,0,35,19,16
2021,218733,30,2,2,0,2
2021,218733,30,3,31,18,13
2021,218733,30,4,2,1,1
2021,218733,40,0,32,13,19
2021,218733,40,3,9,3,6
2021,218733,40,4,23,10,13
2021,218733,42,0,32,13,19
2021,218733,42,3,9,3,6
2021,218733,42,4,23,10,13
2021,218742,0,0,223,95,128
2021,218742,10,0,223,95,128
2021,218742,10,1,41,23,18
2021,218742,10,2,57,29,28
2021,218742,10,3,54,21,33
2021,218742,10,4,71,22,49
2021,218742,20,0,97,53,44
2021,218742,20,1,41,23,18
2021,218742,20,2,55,29,26
2021,218742,20,3,1,1,0
2021,218742,30,0,55,20,35
2021,218742,30,2,2,0,2
2021,218742,30,3,53,20,33
2021,218742,40,0,71,22,49
2021,218742,40,4,71,22,49
2021,218742,41,0,22,9,13
2021,218742,41,4,22,9,13
2021,218742,42,0,49,13,36
2021,218742,42,4,49,13,36
2021,218742,44,0,22,9,13
2021,218742,44,4,22,9,13
2021,218751,0,0,35,13,22
2021,218751,10,0,35,13,22
2021,218751,10,1,8,3,5
2021,218751,10,2,9,3,6
2021,218751,10,3,14,6,8
2021,218751,10,4,4,1,3
2021,218751,40,0,35,13,22
2021,218751,40,1,8,3,5
2021,218751,40,2,9,3,6
2021,218751,40,3,14,6,8
2021,218751,40,4,4,1,3
2021,218751,43,0,35,13,22
2021,218751,43,1,8,3,5
2021,218751,43,2,9,3,6
2021,218751,43,3,14,6,8
2021,218751,43,4,4,1,3
2021,218821,0,0,41,16,25
2021,218821,10,0,41,16,25
2021,218821,10,6,41,16,25
2021,218821,20,0,13,7,6
2021,218821,20,6,13,7,6
2021,218821,30,0,13,3,10
2021,218821,30,6,13,3,10
2021,218821,40,0,15,6,9
2021,218821,40,6,15,6,9
2021,218821,42,0,15,6,9
2021,218821,42,6,15,6,9
2021,218830,0,0,125,51,74
2021,218830,10,0,125,51,74
2021,218830,10,6,125,51,74
2021,218830,40,0,125,51,74
2021,218830,40,6,125,51,74
2021,218830,41,0,125,51,74
2021,218830,41,6,125,51,74
2021,218830,45,0,125,51,74
2021,218830,45,6,125,51,74
2021,218858,0,0,80,34,46
2021,218858,10,0,80,34,46
2021,218858,10,6,80,34,46
2021,218858,40,0,80,34,46
2021,218858,40,6,80,34,46
2021,218858,41,0,80,34,46
2021,218858,41,6,80,34,46
2021,218858,45,0,80,34,46
2021,218858,45,6,80,34,46
2021,218885,0,0,140,58,82
2021,218885,10,0,140,58,82
2021,218885,10,6,140,58,82
2021,218885,40,0,140,58,82
2021,218885,40,6,140,58,82
2021,218885,41,0,140,58,82
2021,218885,41,6,140,58,82
2021,218885,45,0,140,58,82
2021,218885,45,6,140,58,82
2021,218894,0,0,234,105,129
2021,218894,10,0,234,105,129
2021,218894,10,6,234,105,129
2021,218894,40,0,234,105,129
2021,218894,40,6,234,105,129
2021,218894,41,0,234,105,129
2021,218894,41,6,234,105,129
2021,218894,45,0,234,105,129
2021,218894,45,6,234,105,129
2021,218919,0,0,29,16,13
2021,218919,10,0,29,16,13
2021,218919,10,1,1,1,0
2021,218919,10,2,5,2,3
2021,218919,10,3,19,9,10
2021,218919,10,4,4,4,0
2021,218919,20,0,5,3,2
2021,218919,20,1,1,1,0
2021,218919,20,2,4,2,2
2021,218919,30,0,24,13,11
2021,218919,30,2,1,0,1
2021,218919,30,3,19,9,10
2021,218919,30,4,4,4,0
2021,218955,0,0,25,11,14
2021,218955,10,0,25,11,14
2021,218955,10,6,25,11,14
2021,218955,40,0,25,11,14
2021,218955,40,6,25,11,14
2021,218955,41,0,25,11,14
2021,218955,41,6,25,11,14
2021,218955,45,0,25,11,14
2021,218955,45,6,25,11,14
2021,218964,0,0,276,126,150
2021,218964,10,0,276,126,150
2021,218964,10,1,87,47,40
2021,218964,10,2,77,40,37
2021,218964,10,3,81,30,51
2021,218964,10,4,28,7,21
2021,218964,10,5,3,2,1
2021,218964,20,0,150,79,71
2021,218964,20,1,84,46,38
2021,218964,20,2,62,31,31
2021,218964,20,3,4,2,2
2021,218964,30,0,79,35,44
2021,218964,30,1,1,0,1
2021,218964,30,2,13,8,5
2021,218964,30,3,65,27,38
2021,218964,40,0,47,12,35
2021,218964,40,1,2,1,1
2021,218964,40,2,2,1,1
2021,218964,40,3,12,1,11
2021,218964,40,4,28,7,21
2021,218964,40,5,3,2,1
2021,218964,41,0,41,10,31
2021,218964,41,1,2,1,1
2021,218964,41,2,2,1,1
2021,218964,41,3,12,1,11
2021,218964,41,4,22,5,17
2021,218964,41,5,3,2,1
2021,218964,42,0,6,2,4
2021,218964,42,4,6,2,4
2021,218964,44,0,41,10,31
2021,218964,44,1,2,1,1
2021,218964,44,2,2,1,1
2021,218964,44,3,12,1,11
2021,218964,44,4,22,5,17
2021,218964,44,5,3,2,1
2021,218973,0,0,141,71,70
2021,218973,10,0,141,71,70
2021,218973,10,1,47,26,21
2021,218973,10,2,43,21,22
2021,218973,10,3,39,16,23
2021,218973,10,4,12,8,4
2021,218973,20,0,99,53,46
2021,218973,20,1,47,26,21
2021,218973,20,2,43,21,22
2021,218973,20,3,9,6,3
2021,218973,30,0,30,10,20
2021,218973,30,3,30,10,20
2021,218973,40,0,12,8,4
2021,218973,40,4,12,8,4
2021,218973,41,0,4,3,1
2021,218973,41,4,4,3,1
2021,218973,42,0,8,5,3
2021,218973,42,4,8,5,3
2021,218973,44,0,2,2,0
2021,218973,44,4,2,2,0
2021,218973,45,0,2,1,1
2021,218973,45,4,2,1,1
2021,218991,0,0,113,50,63
2021,218991,10,0,113,50,63
2021,218991,10,6,113,50,63
2021,218991,40,0,113,50,63
2021,218991,40,6,113,50,63
2021,218991,41,0,113,50,63
2021,218991,41,6,113,50,63
2021,218991,45,0,113,50,63
2021,218991,45,6,113,50,63
2021,219000,0,0,136,58,78
2021,219000,10,0,136,58,78
2021,219000,10,1,30,21,9
2021,219000,10,2,33,13,20
2021,219000,10,3,66,23,43
2021,219000,10,4,7,1,6
2021,219000,20,0,62,33,29
2021,219000,20,1,29,20,9
2021,219000,20,2,33,13,20
2021,219000,30,0,36,13,23
2021,219000,30,3,36,13,23
2021,219000,40,0,38,12,26
2021,219000,40,1,1,1,0
2021,219000,40,3,30,10,20
2021,219000,40,4,7,1,6
2021,219000,41,0,10,3,7
2021,219000,41,1,1,1,0
2021,219000,41,3,8,1,7
2021,219000,41,4,1,1,0
2021,219000,42,0,28,9,19
2021,219000,42,3,22,9,13
2021,219000,42,4,6,0,6
2021,219000,44,0,10,3,7
2021,219000,44,1,1,1,0
2021,219000,44,3,8,1,7
2021,219000,44,4,1,1,0
2021,219046,0,0,109,64,45
2021,219046,10,0,109,64,45
2021,219046,10,1,30,19,11
2021,219046,10,2,26,16,10
2021,219046,10,3,30,20,10
2021,219046,10,4,17,7,10
2021,219046,10,5,6,2,4
2021,219046,20,0,55,35,20
2021,219046,20,1,30,19,11
2021,219046,20,2,25,16,9
2021,219046,30,0,29,19,10
2021,219046,30,2,1,0,1
2021,219046,30,3,28,19,9
2021,219046,40,0,25,10,15
2021,219046,40,3,2,1,1
2021,219046,40,4,17,7,10
2021,219046,40,5,6,2,4
2021,219046,42,0,25,10,15
2021,219046,42,3,2,1,1
2021,219046,42,4,17,7,10
2021,219046,42,5,6,2,4
2021,219082,0,0,100,70,30
2021,219082,10,0,100,70,30
2021,219082,10,1,18,14,4
2021,219082,10,2,25,20,5
2021,219082,10,3,31,24,7
2021,219082,10,4,21,9,12
2021,219082,10,5,4,2,2
2021,219082,10,6,1,1,0
2021,219082,20,0,41,33,8
2021,219082,20,1,17,13,4
2021,219082,20,2,24,20,4
2021,219082,30,0,31,24,7
2021,219082,30,1,1,1,0
2021,219082,30,2,1,0,1
2021,219082,30,3,29,23,6
2021,219082,40,0,28,13,15
2021,219082,40,3,2,1,1
2021,219082,40,4,21,9,12
2021,219082,40,5,4,2,2
2021,219082,40,6,1,1,0
2021,219082,42,0,28,13,15
2021,219082,42,3,2,1,1
2021,219082,42,4,21,9,12
2021,219082,42,5,4,2,2
2021,219082,42,6,1,1,0
2021,219091,0,0,46,19,27
2021,219091,10,0,46,19,27
2021,219091,10,1,11,8,3
2021,219091,10,2,14,5,9
2021,219091,10,3,18,4,14
2021,219091,10,4,3,2,1
2021,219091,20,0,19,10,9
2021,219091,20,1,11,8,3
2021,219091,20,2,8,2,6
2021,219091,30,0,14,4,10
2021,219091,30,2,2,2,0
2021,219091,30,3,11,2,9
2021,219091,30,4,1,0,1
2021,219091,40,0,13,5,8
2021,219091,40,2,4,1,3
2021,219091,40,3,7,2,5
2021,219091,40,4,2,2,0
2021,219091,42,0,13,5,8
2021,219091,42,2,4,1,3
2021,219091,42,3,7,2,5
2021,219091,42,4,2,2,0
2021,219143,0,0,116,71,45
2021,219143,10,0,110,66,44
2021,219143,10,4,110,66,44
2021,219143,40,0,110,66,44
2021,219143,40,4,110,66,44
2021,219143,42,0,110,66,44
2021,219143,42,4,110,66,44
2021,219143,50,0,6,5,1
2021,219189,0,0,69,40,29
2021,219189,10,0,69,40,29
2021,219189,10,4,69,40,29
2021,219189,40,0,69,40,29
2021,219189,40,4,69,40,29
2021,219189,42,0,69,40,29
2021,219189,42,4,69,40,29
2021,219198,0,0,44,22,22
2021,219198,10,0,44,22,22
2021,219198,10,1,9,7,2
2021,219198,10,2,11,6,5
2021,219198,10,3,21,7,14
2021,219198,10,4,3,2,1
2021,219198,20,0,22,12,10
2021,219198,20,1,9,7,2
2021,219198,20,2,9,5,4
2021,219198,20,3,4,0,4
2021,219198,30,0,16,6,10
2021,219198,30,2,1,1,0
2021,219198,30,3,15,5,10
2021,219198,40,0,6,4,2
2021,219198,40,2,1,0,1
2021,219198,40,3,2,2,0
2021,219198,40,4,3,2,1
2021,219198,42,0,6,4,2
2021,219198,42,2,1,0,1
2021,219198,42,3,2,2,0
2021,219198,42,4,3,2,1
2021,219259,0,0,94,48,46
2021,219259,10,0,94,48,46
2021,219259,10,1,22,15,7
2021,219259,10,2,20,11,9
2021,219259,10,3,34,16,18
2021,219259,10,4,17,5,12
2021,219259,10,5,1,1,0
2021,219259,20,0,42,26,16
2021,219259,20,1,22,15,7
2021,219259,20,2,20,11,9
2021,219259,30,0,34,15,19
2021,219259,30,3,33,15,18
2021,219259,30,4,1,0,1
2021,219259,40,0,18,7,11
2021,219259,40,3,1,1,0
2021,219259,40,4,16,5,11
2021,219259,40,5,1,1,0
2021,219259,42,0,18,7,11
2021,219259,42,3,1,1,0
2021,219259,42,4,16,5,11
2021,219259,42,5,1,1,0
2021,219277,0,0,61,28,33
2021,219277,10,0,60,28,32
2021,219277,10,1,1,1,0
2021,219277,10,2,9,4,5
2021,219277,10,3,50,23,27
2021,219277,40,0,60,28,32
2021,219277,40,1,1,1,0
2021,219277,40,2,9,4,5
2021,219277,40,3,50,23,27
2021,219277,41,0,2,2,0
2021,219277,41,1,1,1,0
2021,219277,41,2,1,1,0
2021,219277,42,0,58,26,32
2021,219277,42,2,8,3,5
2021,219277,42,3,50,23,27
2021,219277,44,0,2,2,0
2021,219277,44,1,1,1,0
2021,219277,44,2,1,1,0
2021,219277,50,0,1,0,1
2021,219295,0,0,32,6,26
2021,219295,10,0,32,6,26
2021,219295,10,1,3,3,0
2021,219295,10,2,4,2,2
2021,219295,10,3,5,1,4
2021,219295,10,4,20,0,20
2021,219295,20,0,3,3,0
2021,219295,20,1,3,3,0
2021,219295,30,0,6,3,3
2021,219295,30,2,2,2,0
2021,219295,30,3,3,1,2
2021,219295,30,4,1,0,1
2021,219295,40,0,23,0,23
2021,219295,40,2,2,0,2
2021,219295,40,3,2,0,2
2021,219295,40,4,19,0,19
2021,219295,42,0,2,0,2
2021,219295,42,4,2,0,2
2021,219295,43,0,21,0,21
2021,219295,43,2,2,0,2
2021,219295,43,3,2,0,2
2021,219295,43,4,17,0,17
2021,219347,0,0,159,122,37
2021,219347,10,0,159,122,37
2021,219347,10,1,35,32,3
2021,219347,10,2,45,35,10
2021,219347,10,3,46,35,11
2021,219347,10,4,8,5,3
2021,219347,10,5,25,15,10
2021,219347,20,0,75,63,12
2021,219347,20,1,33,30,3
2021,219347,20,2,42,33,9
2021,219347,30,0,44,34,10
2021,219347,30,2,2,2,0
2021,219347,30,3,42,32,10
2021,219347,40,0,40,25,15
2021,219347,40,1,2,2,0
2021,219347,40,2,1,0,1
2021,219347,40,3,4,3,1
2021,219347,40,4,8,5,3
2021,219347,40,5,25,15,10
2021,219347,42,0,40,25,15
2021,219347,42,1,2,2,0
2021,219347,42,2,1,0,1
2021,219347,42,3,4,3,1
2021,219347,42,4,8,5,3
2021,219347,42,5,25,15,10
2021,219356,0,0,481,257,224
2021,219356,10,0,481,257,224
2021,219356,10,1,117,82,35
2021,219356,10,2,95,63,32
2021,219356,10,3,105,53,52
2021,219356,10,4,83,32,51
2021,219356,10,5,81,27,54
2021,219356,20,0,193,135,58
2021,219356,20,1,106,74,32
2021,219356,20,2,87,61,26
2021,219356,30,0,91,45,46
2021,219356,30,1,1,1,0
2021,219356,30,2,1,0,1
2021,219356,30,3,89,44,45
2021,219356,40,0,197,77,120
2021,219356,40,1,10,7,3
2021,219356,40,2,7,2,5
2021,219356,40,3,16,9,7
2021,219356,40,4,83,32,51
2021,219356,40,5,81,27,54
2021,219356,42,0,197,77,120
2021,219356,42,1,10,7,3
2021,219356,42,2,7,2,5
2021,219356,42,3,16,9,7
2021,219356,42,4,83,32,51
2021,219356,42,5,81,27,54
2021,219374,0,0,17,6,11
2021,219374,10,0,17,6,11
2021,219374,10,4,17,6,11
2021,219374,40,0,17,6,11
2021,219374,40,4,17,6,11
2021,219374,42,0,17,6,11
2021,219374,42,4,17,6,11
2021,219383,0,0,57,35,22
2021,219383,10,0,57,35,22
2021,219383,10,1,11,7,4
2021,219383,10,2,22,13,9
2021,219383,10,3,22,13,9
2021,219383,10,4,2,2,0
2021,219383,20,0,34,21,13
2021,219383,20,1,11,7,4
2021,219383,20,2,22,13,9
2021,219383,20,3,1,1,0
2021,219383,30,0,7,6,1
2021,219383,30,3,7,6,1
2021,219383,40,0,16,8,8
2021,219383,40,3,14,6,8
2021,219383,40,4,2,2,0
2021,219383,42,0,16,8,8
2021,219383,42,3,14,6,8
2021,219383,42,4,2,2,0
2021,219408,0,0,12,5,7
2021,219408,10,0,12,5,7
2021,219408,10,4,12,5,7
2021,219408,40,0,12,5,7
2021,219408,40,4,12,5,7
2021,219408,41,0,1,1,0
2021,219408,41,4,1,1,0
2021,219408,42,0,11,4,7
2021,219408,42,4,11,4,7
2021,219408,45,0,1,1,0
2021,219408,45,4,1,1,0
2021,219426,0,0,95,40,55
2021,219426,10,0,80,35,45
2021,219426,10,4,80,35,45
2021,219426,40,0,80,35,45
2021,219426,40,4,80,35,45
2021,219426,41,0,80,35,45
2021,219426,41,4,80,35,45
2021,219426,45,0,80,35,45
2021,219426,45,4,80,35,45
2021,219426,50,0,15,5,10
2021,219471,0,0,429,213,216
2021,219471,10,0,407,204,203
2021,219471,10,1,80,56,24
2021,219471,10,2,92,57,35
2021,219471,10,3,108,54,54
2021,219471,10,4,92,24,68
2021,219471,10,5,34,12,22
2021,219471,10,6,1,1,0
2021,219471,20,0,156,107,49
2021,219471,20,1,77,55,22
2021,219471,20,2,79,52,27
2021,219471,30,0,89,46,43
2021,219471,30,2,2,0,2
2021,219471,30,3,87,46,41
2021,219471,40,0,162,51,111
2021,219471,40,1,3,1,2
2021,219471,40,2,11,5,6
2021,219471,40,3,21,8,13
2021,219471,40,4,92,24,68
2021,219471,40,5,34,12,22
2021,219471,40,6,1,1,0
2021,219471,42,0,162,51,111
2021,219471,42,1,3,1,2
2021,219471,42,2,11,5,6
2021,219471,42,3,21,8,13
2021,219471,42,4,92,24,68
2021,219471,42,5,34,12,22
2021,219471,42,6,1,1,0
2021,219471,50,0,22,9,13
2021,219480,0,0,50,28,22
2021,219480,10,0,50,28,22
2021,219480,10,4,50,28,22
2021,219480,40,0,50,28,22
2021,219480,40,4,50,28,22
2021,219480,42,0,50,28,22
2021,219480,42,4,50,28,22
2021,219505,0,0,4,1,3
2021,219505,10,0,4,1,3
2021,219505,10,2,3,1,2
2021,219505,10,3,1,0,1
2021,219505,40,0,4,1,3
2021,219505,40,2,3,1,2
2021,219505,40,3,1,0,1
2021,219505,41,0,4,1,3
2021,219505,41,2,3,1,2
2021,219505,41,3,1,0,1
2021,219505,45,0,4,1,3
2021,219505,45,2,3,1,2
2021,219505,45,3,1,0,1
2021,219602,0,0,386,190,196
2021,219602,10,0,386,190,196
2021,219602,10,1,147,84,63
2021,219602,10,2,86,40,46
2021,219602,10,3,113,47,66
2021,219602,10,4,39,19,20
2021,219602,10,6,1,0,1
2021,219602,20,0,234,121,113
2021,219602,20,1,146,83,63
2021,219602,20,2,73,34,39
2021,219602,20,3,7,1,6
2021,219602,20,4,8,3,5
2021,219602,30,0,105,52,53
2021,219602,30,1,1,1,0
2021,219602,30,2,13,6,7
2021,219602,30,3,90,44,46
2021,219602,30,4,1,1,0
2021,219602,40,0,47,17,30
2021,219602,40,3,16,2,14
2021,219602,40,4,30,15,15
2021,219602,40,6,1,0,1
2021,219602,41,0,5,2,3
2021,219602,41,4,5,2,3
2021,219602,42,0,41,15,26
2021,219602,42,3,16,2,14
2021,219602,42,4,25,13,12
2021,219602,43,0,1,0,1
2021,219602,43,6,1,0,1
2021,219602,44,0,5,2,3
2021,219602,44,4,5,2,3
2021,219639,0,0,69,13,56
2021,219639,10,0,69,13,56
2021,219639,10,1,5,1,4
2021,219639,10,2,13,1,12
2021,219639,10,3,41,9,32
2021,219639,10,4,3,0,3
2021,219639,10,6,7,2,5
2021,219639,40,0,69,13,56
2021,219639,40,1,5,1,4
2021,219639,40,2,13,1,12
2021,219639,40,3,41,9,32
2021,219639,40,4,3,0,3
2021,219639,40,6,7,2,5
2021,219639,41,0,69,13,56
2021,219639,41,1,5,1,4
2021,219639,41,2,13,1,12
2021,219639,41,3,41,9,32
2021,219639,41,4,3,0,3
2021,219639,41,6,7,2,5
2021,219639,45,0,69,13,56
2021,219639,45,1,5,1,4
2021,219639,45,2,13,1,12
2021,219639,45,3,41,9,32
2021,219639,45,4,3,0,3
2021,219639,45,6,7,2,5
2021,219709,0,0,488,238,250
2021,219709,10,0,488,238,250
2021,219709,10,1,112,72,40
2021,219709,10,2,134,61,73
2021,219709,10,3,101,44,57
2021,219709,10,4,72,36,36
2021,219709,10,5,60,20,40
2021,219709,10,6,9,5,4
2021,219709,20,0,228,124,104
2021,219709,20,1,105,67,38
2021,219709,20,2,121,56,65
2021,219709,20,3,2,1,1
2021,219709,30,0,109,50,59
2021,219709,30,2,11,5,6
2021,219709,30,3,91,41,50
2021,219709,30,4,7,4,3
2021,219709,40,0,151,64,87
2021,219709,40,1,7,5,2
2021,219709,40,2,2,0,2
2021,219709,40,3,8,2,6
2021,219709,40,4,65,32,33
2021,219709,40,5,60,20,40
2021,219709,40,6,9,5,4
2021,219709,41,0,9,5,4
2021,219709,41,6,9,5,4
2021,219709,42,0,82,39,43
2021,219709,42,1,7,5,2
2021,219709,42,2,2,0,2
2021,219709,42,3,8,2,6
2021,219709,42,4,65,32,33
2021,219709,43,0,60,20,40
2021,219709,43,5,60,20,40
2021,219709,44,0,9,5,4
2021,219709,44,6,9,5,4
2021,219718,0,0,154,83,71
2021,219718,10,0,154,83,71
2021,219718,10,1,24,17,7
2021,219718,10,2,34,15,19
2021,219718,10,3,30,14,16
2021,219718,10,4,5,1,4
2021,219718,10,5,61,36,25
2021,219718,20,0,41,27,14
2021,219718,20,1,23,17,6
2021,219718,20,2,17,9,8
2021,219718,20,3,1,1,0
2021,219718,40,0,113,56,57
2021,219718,40,1,1,0,1
2021,219718,40,2,17,6,11
2021,219718,40,3,29,13,16
2021,219718,40,4,5,1,4
2021,219718,40,5,61,36,25
2021,219718,42,0,113,56,57
2021,219718,42,1,1,0,1
2021,219718,42,2,17,6,11
2021,219718,42,3,29,13,16
2021,219718,42,4,5,1,4
2021,219718,42,5,61,36,25
2021,219790,0,0,41,27,14
2021,219790,10,0,41,27,14
2021,219790,10,1,18,15,3
2021,219790,10,2,9,6,3
2021,219790,10,3,9,5,4
2021,219790,10,4,5,1,4
2021,219790,40,0,41,27,14
2021,219790,40,1,18,15,3
2021,219790,40,2,9,6,3
2021,219790,40,3,9,5,4
2021,219790,40,4,5,1,4
2021,219790,42,0,40,26,14
2021,219790,42,1,17,14,3
2021,219790,42,2,9,6,3
2021,219790,42,3,9,5,4
2021,219790,42,4,5,1,4
2021,219790,43,0,1,1,0
2021,219790,43,1,1,1,0
2021,219806,0,0,123,58,65
2021,219806,10,0,123,58,65
2021,219806,10,1,31,18,13
2021,219806,10,2,43,18,25
2021,219806,10,3,47,22,25
2021,219806,10,4,2,0,2
2021,219806,20,0,62,31,31
2021,219806,20,1,31,18,13
2021,219806,20,2,31,13,18
2021,219806,30,0,46,21,25
2021,219806,30,2,10,4,6
2021,219806,30,3,36,17,19
2021,219806,40,0,15,6,9
2021,219806,40,2,2,1,1
2021,219806,40,3,11,5,6
2021,219806,40,4,2,0,2
2021,219806,42,0,15,6,9
2021,219806,42,2,2,1,1
2021,219806,42,3,11,5,6
2021,219806,42,4,2,0,2
2021,219824,0,0,235,108,127
2021,219824,10,0,235,108,127
2021,219824,10,1,28,11,17
2021,219824,10,2,43,20,23
2021,219824,10,3,46,23,23
2021,219824,10,4,118,54,64
2021,219824,20,0,88,39,49
2021,219824,20,1,27,11,16
2021,219824,20,2,38,18,20
2021,219824,20,3,19,8,11
2021,219824,20,4,4,2,2
2021,219824,30,0,76,33,43
2021,219824,30,2,5,2,3
2021,219824,30,3,20,10,10
2021,219824,30,4,51,21,30
2021,219824,40,0,71,36,35
2021,219824,40,1,1,0,1
2021,219824,40,3,7,5,2
2021,219824,40,4,63,31,32
2021,219824,42,0,71,36,35
2021,219824,42,1,1,0,1
2021,219824,42,3,7,5,2
2021,219824,42,4,63,31,32
2021,219833,0,0,115,71,44
2021,219833,10,0,115,71,44
2021,219833,10,1,36,24,12
2021,219833,10,2,43,28,15
2021,219833,10,3,29,17,12
2021,219833,10,4,7,2,5
2021,219833,20,0,57,41,16
2021,219833,20,1,35,23,12
2021,219833,20,2,21,17,4
2021,219833,20,3,1,1,0
2021,219833,30,0,14,10,4
2021,219833,30,1,1,1,0
2021,219833,30,2,6,2,4
2021,219833,30,3,7,7,0
2021,219833,40,0,44,20,24
2021,219833,40,2,16,9,7
2021,219833,40,3,21,9,12
2021,219833,40,4,7,2,5
2021,219833,41,0,16,5,11
2021,219833,41,2,4,0,4
2021,219833,41,3,9,4,5
2021,219833,41,4,3,1,2
2021,219833,42,0,27,14,13
2021,219833,42,2,12,9,3
2021,219833,42,3,12,5,7
2021,219833,42,4,3,0,3
2021,219833,43,0,1,1,0
2021,219833,43,4,1,1,0
2021,219833,44,0,10,2,8
2021,219833,44,2,4,0,4
2021,219833,44,3,6,2,4
2021,219833,45,0,6,3,3
2021,219833,45,3,3,2,1
2021,219833,45,4,3,1,2
2021,219842,0,0,10,9,1
2021,219842,10,0,10,9,1
2021,219842,10,1,5,5,0
2021,219842,10,2,2,1,1
2021,219842,10,3,3,3,0
2021,219842,20,0,4,4,0
2021,219842,20,1,4,4,0
2021,219842,40,0,6,5,1
2021,219842,40,1,1,1,0
2021,219842,40,2,2,1,1
2021,219842,40,3,3,3,0
2021,219842,42,0,3,3,0
2021,219842,42,3,3,3,0
2021,219842,43,0,3,2,1
2021,219842,43,1,1,1,0
2021,219842,43,2,2,1,1
2021,219879,0,0,79,35,44
2021,219879,10,0,79,35,44
2021,219879,10,1,9,5,4
2021,219879,10,2,34,13,21
2021,219879,10,3,17,9,8
2021,219879,10,4,19,8,11
2021,219879,20,0,42,17,25
2021,219879,20,1,8,5,3
2021,219879,20,2,33,12,21
2021,219879,20,4,1,0,1
2021,219879,30,0,31,14,17
2021,219879,30,1,1,0,1
2021,219879,30,3,17,9,8
2021,219879,30,4,13,5,8
2021,219879,40,0,6,4,2
2021,219879,40,2,1,1,0
2021,219879,40,4,5,3,2
2021,219879,41,0,5,3,2
2021,219879,41,2,1,1,0
2021,219879,41,4,4,2,2
2021,219879,42,0,1,1,0
2021,219879,42,4,1,1,0
2021,219879,44,0,5,3,2
2021,219879,44,2,1,1,0
2021,219879,44,4,4,2,2
2021,219888,0,0,116,39,77
2021,219888,10,0,112,38,74
2021,219888,10,1,13,7,6
2021,219888,10,2,44,16,28
2021,219888,10,3,28,9,19
2021,219888,10,4,27,6,21
2021,219888,20,0,56,26,30
2021,219888,20,1,13,7,6
2021,219888,20,2,35,14,21
2021,219888,20,3,8,5,3
2021,219888,30,0,16,6,10
2021,219888,30,2,4,2,2
2021,219888,30,3,11,3,8
2021,219888,30,4,1,1,0
2021,219888,40,0,40,6,34
2021,219888,40,2,5,0,5
2021,219888,40,3,9,1,8
2021,219888,40,4,26,5,21
2021,219888,42,0,37,6,31
2021,219888,42,2,5,0,5
2021,219888,42,3,7,1,6
2021,219888,42,4,25,5,20
2021,219888,43,0,3,0,3
2021,219888,43,3,2,0,2
2021,219888,43,4,1,0,1
2021,219888,50,0,4,1,3
2021,219903,0,0,31,6,25
2021,219903,10,0,31,6,25
2021,219903,10,4,31,6,25
2021,219903,40,0,31,6,25
2021,219903,40,4,31,6,25
2021,219903,41,0,31,6,25
2021,219903,41,4,31,6,25
2021,219903,45,0,31,6,25
2021,219903,45,4,31,6,25
2021,219949,0,0,85,38,47
2021,219949,10,0,85,38,47
2021,219949,10,1,15,11,4
2021,219949,10,2,8,5,3
2021,219949,10,3,36,11,25
2021,219949,10,4,26,11,15
2021,219949,40,0,85,38,47
2021,219949,40,1,15,11,4
2021,219949,40,2,8,5,3
2021,219949,40,3,36,11,25
2021,219949,40,4,26,11,15
2021,219949,41,0,8,4,4
2021,219949,41,1,1,1,0
2021,219949,41,2,1,1,0
2021,219949,41,3,4,2,2
2021,219949,41,4,2,0,2
2021,219949,42,0,77,34,43
2021,219949,42,1,14,10,4
2021,219949,42,2,7,4,3
2021,219949,42,3,32,9,23
2021,219949,42,4,24,11,13
2021,219949,44,0,8,4,4
2021,219949,44,1,1,1,0
2021,219949,44,2,1,1,0
2021,219949,44,3,4,2,2
2021,219949,44,4,2,0,2
2021,219976,0,0,247,130,117
2021,219976,10,0,247,130,117
2021,219976,10,1,59,47,12
2021,219976,10,2,74,38,36
2021,219976,10,3,97,39,58
2021,219976,10,4,12,4,8
2021,219976,10,5,5,2,3
2021,219976,20,0,59,42,17
2021,219976,20,1,43,34,9
2021,219976,20,2,16,8,8
2021,219976,30,0,110,55,55
2021,219976,30,1,11,9,2
2021,219976,30,2,41,21,20
2021,219976,30,3,57,24,33
2021,219976,30,4,1,1,0
2021,219976,40,0,78,33,45
2021,219976,40,1,5,4,1
2021,219976,40,2,17,9,8
2021,219976,40,3,40,15,25
2021,219976,40,4,11,3,8
2021,219976,40,5,5,2,3
2021,219976,42,0,78,33,45
2021,219976,42,1,5,4,1
2021,219976,42,2,17,9,8
2021,219976,42,3,40,15,25
2021,219976,42,4,11,3,8
2021,219976,42,5,5,2,3
2021,220057,0,0,50,18,32
2021,220057,10,0,50,18,32
2021,220057,10,1,4,3,1
2021,220057,10,2,23,9,14
2021,220057,10,3,13,3,10
2021,220057,10,4,10,3,7
2021,220057,20,0,25,10,15
2021,220057,20,1,4,3,1
2021,220057,20,2,21,7,14
2021,220057,30,0,21,6,15
2021,220057,30,2,2,2,0
2021,220057,30,3,13,3,10
2021,220057,30,4,6,1,5
2021,220057,40,0,4,2,2
2021,220057,40,4,4,2,2
2021,220057,42,0,4,2,2
2021,220057,42,4,4,2,2
2021,220075,0,0,754,383,371
2021,220075,10,0,754,383,371
2021,220075,10,1,214,144,70
2021,220075,10,2,194,99,95
2021,220075,10,3,237,96,141
2021,220075,10,4,38,6,32
2021,220075,10,5,64,34,30
2021,220075,10,6,7,4,3
2021,220075,20,0,343,206,137
2021,220075,20,1,182,125,57
2021,220075,20,2,147,76,71
2021,220075,20,3,12,3,9
2021,220075,20,4,1,1,0
2021,220075,20,5,1,1,0
2021,220075,30,0,129,55,74
2021,220075,30,2,8,4,4
2021,220075,30,3,121,51,70
2021,220075,40,0,282,122,160
2021,220075,40,1,32,19,13
2021,220075,40,2,39,19,20
2021,220075,40,3,104,42,62
2021,220075,40,4,37,5,32
2021,220075,40,5,63,33,30
2021,220075,40,6,7,4,3
2021,220075,42,0,282,122,160
2021,220075,42,1,32,19,13
2021,220075,42,2,39,19,20
2021,220075,42,3,104,42,62
2021,220075,42,4,37,5,32
2021,220075,42,5,63,33,30
2021,220075,42,6,7,4,3
2021,220118,0,0,17,0,17
2021,220118,10,0,17,0,17
2021,220118,10,4,17,0,17
2021,220118,40,0,17,0,17
2021,220118,40,4,17,0,17
2021,220118,41,0,17,0,17
2021,220118,41,4,17,0,17
2021,220118,45,0,17,0,17
2021,220118,45,4,17,0,17
2021,220181,0,0,52,26,26
2021,220181,10,0,52,26,26
2021,220181,10,1,8,5,3
2021,220181,10,2,22,9,13
2021,220181,10,3,14,9,5
2021,220181,10,4,8,3,5
2021,220181,20,0,26,13,13
2021,220181,20,1,8,5,3
2021,220181,20,2,17,7,10
2021,220181,20,3,1,1,0
2021,220181,30,0,11,6,5
2021,220181,30,2,2,1,1
2021,220181,30,3,9,5,4
2021,220181,40,0,15,7,8
2021,220181,40,2,3,1,2
2021,220181,40,3,4,3,1
2021,220181,40,4,8,3,5
2021,220181,42,0,15,7,8
2021,220181,42,2,3,1,2
2021,220181,42,3,4,3,1
2021,220181,42,4,8,3,5
2021,220206,0,0,16,11,5
2021,220206,10,0,16,11,5
2021,220206,10,1,4,1,3
2021,220206,10,2,2,2,0
2021,220206,10,3,3,1,2
2021,220206,10,4,7,7,0
2021,220206,40,0,16,11,5
2021,220206,40,1,4,1,3
2021,220206,40,2,2,2,0
2021,220206,40,3,3,1,2
2021,220206,40,4,7,7,0
2021,220206,41,0,1,1,0
2021,220206,41,4,1,1,0
2021,220206,43,0,15,10,5
2021,220206,43,1,4,1,3
2021,220206,43,2,2,2,0
2021,220206,43,3,3,1,2
2021,220206,43,4,6,6,0
2021,220206,45,0,1,1,0
2021,220206,45,4,1,1,0
2021,220215,0,0,99,64,35
2021,220215,10,0,99,64,35
2021,220215,10,1,17,15,2
2021,220215,10,2,29,22,7
2021,220215,10,3,35,17,18
2021,220215,10,4,17,10,7
2021,220215,10,5,1,0,1
2021,220215,20,0,48,37,11
2021,220215,20,1,16,14,2
2021,220215,20,2,25,19,6
2021,220215,20,3,7,4,3
2021,220215,30,0,25,13,12
2021,220215,30,1,1,1,0
2021,220215,30,2,4,3,1
2021,220215,30,3,18,7,11
2021,220215,30,4,2,2,0
2021,220215,40,0,26,14,12
2021,220215,40,3,10,6,4
2021,220215,40,4,15,8,7
2021,220215,40,5,1,0,1
2021,220215,42,0,26,14,12
2021,220215,42,3,10,6,4
2021,220215,42,4,15,8,7
2021,220215,42,5,1,0,1
2021,220400,0,0,94,35,59
2021,220400,10,0,94,35,59
2021,220400,10,1,11,5,6
2021,220400,10,2,60,21,39
2021,220400,10,3,20,7,13
2021,220400,10,4,3,2,1
2021,220400,20,0,54,18,36
2021,220400,20,1,11,5,6
2021,220400,20,2,42,12,30
2021,220400,20,3,1,1,0
2021,220400,30,0,21,10,11
2021,220400,30,2,16,7,9
2021,220400,30,3,5,3,2
2021,220400,40,0,19,7,12
2021,220400,40,2,2,2,0
2021,220400,40,3,14,3,11
2021,220400,40,4,3,2,1
2021,220400,42,0,19,7,12
2021,220400,42,2,2,2,0
2021,220400,42,3,14,3,11
2021,220400,42,4,3,2,1
2021,220473,0,0,38,26,12
2021,220473,10,0,38,26,12
2021,220473,10,1,27,19,8
2021,220473,10,2,7,6,1
2021,220473,10,3,4,1,3
2021,220473,40,0,38,26,12
2021,220473,40,1,27,19,8
2021,220473,40,2,7,6,1
2021,220473,40,3,4,1,3
2021,220473,42,0,38,26,12
2021,220473,42,1,27,19,8
2021,220473,42,2,7,6,1
2021,220473,42,3,4,1,3
2021,220516,0,0,82,27,55
2021,220516,10,0,82,27,55
2021,220516,10,1,15,10,5
2021,220516,10,2,27,8,19
2021,220516,10,3,36,8,28
2021,220516,10,4,4,1,3
2021,220516,40,0,82,27,55
2021,220516,40,1,15,10,5
2021,220516,40,2,27,8,19
2021,220516,40,3,36,8,28
2021,220516,40,4,4,1,3
2021,220516,41,0,43,21,22
2021,220516,41,1,14,10,4
2021,220516,41,2,20,8,12
2021,220516,41,3,9,3,6
2021,220516,42,0,38,6,32
2021,220516,42,1,1,0,1
2021,220516,42,2,7,0,7
2021,220516,42,3,26,5,21
2021,220516,42,4,4,1,3
2021,220516,43,0,1,0,1
2021,220516,43,3,1,0,1
2021,220516,44,0,43,21,22
2021,220516,44,1,14,10,4
2021,220516,44,2,20,8,12
2021,220516,44,3,9,3,6
2021,220552,0,0,271,89,182
2021,220552,10,0,271,89,182
2021,220552,10,1,15,9,6
2021,220552,10,2,43,14,29
2021,220552,10,3,108,32,76
2021,220552,10,4,102,34,68
2021,220552,10,6,3,0,3
2021,220552,40,0,271,89,182
2021,220552,40,1,15,9,6
2021,220552,40,2,43,14,29
2021,220552,40,3,108,32,76
2021,220552,40,4,102,34,68
2021,220552,40,6,3,0,3
2021,220552,41,0,271,89,182
2021,220552,41,1,15,9,6
2021,220552,41,2,43,14,29
2021,220552,41,3,108,32,76
2021,220552,41,4,102,34,68
2021,220552,41,6,3,0,3
2021,220552,45,0,271,89,182
2021,220552,45,1,15,9,6
2021,220552,45,2,43,14,29
2021,220552,45,3,108,32,76
2021,220552,45,4,102,34,68
2021,220552,45,6,3,0,3
2021,220598,0,0,64,39,25
2021,220598,10,0,64,39,25
2021,220598,10,2,11,6,5
2021,220598,10,3,48,28,20
2021,220598,10,4,5,5,0
2021,220598,20,0,7,4,3
2021,220598,20,2,7,4,3
2021,220598,30,0,18,12,6
2021,220598,30,2,2,2,0
2021,220598,30,3,16,10,6
2021,220598,40,0,39,23,16
2021,220598,40,2,2,0,2
2021,220598,40,3,32,18,14
2021,220598,40,4,5,5,0
2021,220598,42,0,39,23,16
2021,220598,42,2,2,0,2
2021,220598,42,3,32,18,14
2021,220598,42,4,5,5,0
2021,220604,0,0,44,22,22
2021,220604,10,0,44,22,22
2021,220604,10,1,8,5,3
2021,220604,10,2,9,4,5
2021,220604,10,3,20,10,10
2021,220604,10,4,7,3,4
2021,220604,20,0,21,11,10
2021,220604,20,1,8,5,3
2021,220604,20,2,7,2,5
2021,220604,20,3,6,4,2
2021,220604,30,0,9,2,7
2021,220604,30,2,1,1,0
2021,220604,30,3,8,1,7
2021,220604,40,0,14,9,5
2021,220604,40,2,1,1,0
2021,220604,40,3,6,5,1
2021,220604,40,4,7,3,4
2021,220604,42,0,13,9,4
2021,220604,42,2,1,1,0
2021,220604,42,3,6,5,1
2021,220604,42,4,6,3,3
2021,220604,43,0,1,0,1
2021,220604,43,4,1,0,1
2021,220613,0,0,186,104,82
2021,220613,10,0,186,104,82
2021,220613,10,1,50,36,14
2021,220613,10,2,52,40,12
2021,220613,10,3,60,23,37
2021,220613,10,5,24,5,19
2021,220613,20,0,96,71,25
2021,220613,20,1,49,35,14
2021,220613,20,2,44,34,10
2021,220613,20,3,3,2,1
2021,220613,30,0,61,25,36
2021,220613,30,1,1,1,0
2021,220613,30,2,7,5,2
2021,220613,30,3,53,19,34
2021,220613,40,0,29,8,21
2021,220613,40,2,1,1,0
2021,220613,40,3,4,2,2
2021,220613,40,5,24,5,19
2021,220613,42,0,29,8,21
2021,220613,42,2,1,1,0
2021,220613,42,3,4,2,2
2021,220613,42,5,24,5,19
2021,220631,0,0,310,126,184
2021,220631,10,0,303,122,181
2021,220631,10,1,23,12,11
2021,220631,10,2,87,45,42
2021,220631,10,3,128,52,76
2021,220631,10,4,47,5,42
2021,220631,10,5,18,8,10
2021,220631,20,0,4,3,1
2021,220631,20,1,4,3,1
2021,220631,30,0,1,1,0
2021,220631,30,1,1,1,0
2021,220631,40,0,298,118,180
2021,220631,40,1,18,8,10
2021,220631,40,2,87,45,42
2021,220631,40,3,128,52,76
2021,220631,40,4,47,5,42
2021,220631,40,5,18,8,10
2021,220631,42,0,297,117,180
2021,220631,42,1,17,7,10
2021,220631,42,2,87,45,42
2021,220631,42,3,128,52,76
2021,220631,42,4,47,5,42
2021,220631,42,5,18,8,10
2021,220631,43,0,1,1,0
2021,220631,43,1,1,1,0
2021,220631,50,0,7,4,3
2021,220701,0,0,50,28,22
2021,220701,10,0,50,28,22
2021,220701,10,1,9,5,4
2021,220701,10,2,14,7,7
2021,220701,10,3,17,11,6
2021,220701,10,4,10,5,5
2021,220701,20,0,18,9,9
2021,220701,20,1,8,5,3
2021,220701,20,2,10,4,6
2021,220701,30,0,22,14,8
2021,220701,30,1,1,0,1
2021,220701,30,2,4,3,1
2021,220701,30,3,17,11,6
2021,220701,40,0,10,5,5
2021,220701,40,4,10,5,5
2021,220701,42,0,1,0,1
2021,220701,42,4,1,0,1
2021,220701,43,0,9,5,4
2021,220701,43,4,9,5,4
2021,220710,0,0,74,33,41
2021,220710,10,0,74,33,41
2021,220710,10,1,24,10,14
2021,220710,10,2,24,15,9
2021,220710,10,3,14,5,9
2021,220710,10,5,12,3,9
2021,220710,20,0,50,26,24
2021,220710,20,1,24,10,14
2021,220710,20,2,24,15,9
2021,220710,20,3,2,1,1
2021,220710,30,0,12,4,8
2021,220710,30,3,12,4,8
2021,220710,40,0,12,3,9
2021,220710,40,5,12,3,9
2021,220710,41,0,10,2,8
2021,220710,41,5,10,2,8
2021,220710,42,0,2,1,1
2021,220710,42,5,2,1,1
2021,220710,44,0,10,2,8
2021,220710,44,5,10,2,8
2021,220792,0,0,204,113,91
2021,220792,10,0,204,113,91
2021,220792,10,1,57,34,23
2021,220792,10,2,58,38,20
2021,220792,10,3,80,34,46
2021,220792,10,4,9,7,2
2021,220792,20,0,32,19,13
2021,220792,20,1,12,8,4
2021,220792,20,2,8,4,4
2021,220792,20,3,11,7,4
2021,220792,20,4,1,0,1
2021,220792,30,0,21,13,8
2021,220792,30,1,7,6,1
2021,220792,30,2,8,5,3
2021,220792,30,3,6,2,4
2021,220792,40,0,151,81,70
2021,220792,40,1,38,20,18
2021,220792,40,2,42,29,13
2021,220792,40,3,63,25,38
2021,220792,40,4,8,7,1
2021,220792,42,0,151,81,70
2021,220792,42,1,38,20,18
2021,220792,42,2,42,29,13
2021,220792,42,3,63,25,38
2021,220792,42,4,8,7,1
2021,220862,0,0,888,458,430
2021,220862,10,0,888,458,430
2021,220862,10,1,196,121,75
2021,220862,10,2,253,143,110
2021,220862,10,3,241,107,134
2021,220862,10,4,198,87,111
2021,220862,20,0,412,257,155
2021,220862,20,1,183,119,64
2021,220862,20,2,226,137,89
2021,220862,20,3,3,1,2
2021,220862,30,0,168,92,76
2021,220862,30,1,2,2,0
2021,220862,30,2,2,1,1
2021,220862,30,3,164,89,75
2021,220862,40,0,308,109,199
2021,220862,40,1,11,0,11
2021,220862,40,2,25,5,20
2021,220862,40,3,74,17,57
2021,220862,40,4,198,87,111
2021,220862,41,0,106,19,87
2021,220862,41,1,11,0,11
2021,220862,41,2,24,4,20
2021,220862,41,3,39,4,35
2021,220862,41,4,32,11,21
2021,220862,42,0,200,89,111
2021,220862,42,2,1,1,0
2021,220862,42,3,35,13,22
2021,220862,42,4,164,75,89
2021,220862,43,0,2,1,1
2021,220862,43,4,2,1,1
2021,220862,45,0,106,19,87
2021,220862,45,1,11,0,11
2021,220862,45,2,24,4,20
2021,220862,45,3,39,4,35
2021,220862,45,4,32,11,21
2021,220871,0,0,10,5,5
2021,220871,10,0,10,5,5
2021,220871,10,1,5,3,2
2021,220871,10,2,3,2,1
2021,220871,10,3,2,0,2
2021,220871,20,0,5,3,2
2021,220871,20,1,5,3,2
2021,220871,30,0,3,1,2
2021,220871,30,2,2,1,1
2021,220871,30,3,1,0,1
2021,220871,40,0,2,1,1
2021,220871,40,2,1,1,0
2021,220871,40,3,1,0,1
2021,220871,42,0,2,1,1
2021,220871,42,2,1,1,0
2021,220871,42,3,1,0,1
2021,220978,0,0,933,485,448
2021,220978,10,0,933,485,448
2021,220978,10,1,329,203,126
2021,220978,10,2,218,120,98
2021,220978,10,3,171,80,91
2021,220978,10,4,49,18,31
2021,220978,10,5,166,64,102
2021,220978,20,0,528,310,218
2021,220978,20,1,325,200,125
2021,220978,20,2,202,109,93
2021,220978,20,3,1,1,0
2021,220978,30,0,164,82,82
2021,220978,30,2,9,6,3
2021,220978,30,3,155,76,79
2021,220978,40,0,241,93,148
2021,220978,40,1,4,3,1
2021,220978,40,2,7,5,2
2021,220978,40,3,15,3,12
2021,220978,40,4,49,18,31
2021,220978,40,5,166,64,102
2021,220978,41,0,72,27,45
2021,220978,41,1,4,3,1
2021,220978,41,2,6,4,2
2021,220978,41,3,14,3,11
2021,220978,41,4,47,17,30
2021,220978,41,5,1,0,1
2021,220978,42,0,165,64,101
2021,220978,42,2,1,1,0
2021,220978,42,3,1,0,1
2021,220978,42,4,2,1,1
2021,220978,42,5,161,62,99
2021,220978,43,0,4,2,2
2021,220978,43,5,4,2,2
2021,220978,44,0,1,1,0
2021,220978,44,4,1,1,0
2021,220978,45,0,71,26,45
2021,220978,45,1,4,3,1
2021,220978,45,2,6,4,2
2021,220978,45,3,14,3,11
2021,220978,45,4,46,16,30
2021,220978,45,5,1,0,1
2021,220996,0,0,7,4,3
2021,220996,10,0,7,4,3
2021,220996,10,1,7,4,3
2021,220996,40,0,7,4,3
2021,220996,40,1,7,4,3
2021,220996,41,0,7,4,3
2021,220996,41,1,7,4,3
2021,220996,44,0,1,1,0
2021,220996,44,1,1,1,0
2021,220996,45,0,6,3,3
2021,220996,45,1,6,3,3
2021,221096,0,0,122,60,62
2021,221096,10,0,122,60,62
2021,221096,10,1,8,4,4
2021,221096,10,2,40,19,21
2021,221096,10,3,36,14,22
2021,221096,10,4,38,23,15
2021,221096,20,0,48,23,25
2021,221096,20,1,8,4,4
2021,221096,20,2,39,19,20
2021,221096,20,3,1,0,1
2021,221096,30,0,63,30,33
2021,221096,30,2,1,0,1
2021,221096,30,3,35,14,21
2021,221096,30,4,27,16,11
2021,221096,40,0,11,7,4
2021,221096,40,4,11,7,4
2021,221096,43,0,11,7,4
2021,221096,43,4,11,7,4
2021,221148,0,0,62,62,0
2021,221148,10,0,62,62,0
2021,221148,10,4,62,62,0
2021,221148,40,0,62,62,0
2021,221148,40,4,62,62,0
2021,221148,41,0,62,62,0
2021,221148,41,4,62,62,0
2021,221148,45,0,62,62,0
2021,221148,45,4,62,62,0
2021,221184,0,0,140,58,82
2021,221184,10,0,140,58,82
2021,221184,10,1,8,5,3
2021,221184,10,2,53,23,30
2021,221184,10,3,39,13,26
2021,221184,10,4,40,17,23
2021,221184,20,0,30,16,14
2021,221184,20,1,5,4,1
2021,221184,20,2,24,11,13
2021,221184,20,3,1,1,0
2021,221184,30,0,5,2,3
2021,221184,30,1,1,1,0
2021,221184,30,2,4,1,3
2021,221184,40,0,105,40,65
2021,221184,40,1,2,0,2
2021,221184,40,2,25,11,14
2021,221184,40,3,38,12,26
2021,221184,40,4,40,17,23
2021,221184,41,0,32,10,22
2021,221184,41,2,6,4,2
2021,221184,41,3,13,3,10
2021,221184,41,4,13,3,10
2021,221184,42,0,55,22,33
2021,221184,42,1,2,0,2
2021,221184,42,2,19,7,12
2021,221184,42,3,22,8,14
2021,221184,42,4,12,7,5
2021,221184,43,0,18,8,10
2021,221184,43,3,3,1,2
2021,221184,43,4,15,7,8
2021,221184,44,0,32,10,22
2021,221184,44,2,6,4,2
2021,221184,44,3,13,3,10
2021,221184,44,4,13,3,10
2021,221351,0,0,187,105,82
2021,221351,10,0,187,105,82
2021,221351,10,1,37,29,8
2021,221351,10,2,76,35,41
2021,221351,10,3,69,39,30
2021,221351,10,4,5,2,3
2021,221351,20,0,110,64,46
2021,221351,20,1,37,29,8
2021,221351,20,2,73,35,38
2021,221351,30,0,41,21,20
2021,221351,30,3,41,21,20
2021,221351,40,0,36,20,16
2021,221351,40,2,3,0,3
2021,221351,40,3,28,18,10
2021,221351,40,4,5,2,3
2021,221351,42,0,36,20,16
2021,221351,42,2,3,0,3
2021,221351,42,3,28,18,10
2021,221351,42,4,5,2,3
2021,221397,0,0,114,44,70
2021,221397,10,0,114,44,70
2021,221397,10,1,18,11,7
2021,221397,10,2,51,22,29
2021,221397,10,3,41,8,33
2021,221397,10,4,4,3,1
2021,221397,20,0,64,32,32
2021,221397,20,1,16,11,5
2021,221397,20,2,46,20,26
2021,221397,20,3,1,0,1
2021,221397,20,4,1,1,0
2021,221397,30,0,40,9,31
2021,221397,30,2,1,0,1
2021,221397,30,3,38,8,30
2021,221397,30,4,1,1,0
2021,221397,40,0,10,3,7
2021,221397,40,1,2,0,2
2021,221397,40,2,4,2,2
2021,221397,40,3,2,0,2
2021,221397,40,4,2,1,1
2021,221397,41,0,1,1,0
2021,221397,41,4,1,1,0
2021,221397,43,0,9,2,7
2021,221397,43,1,2,0,2
2021,221397,43,2,4,2,2
2021,221397,43,3,2,0,2
2021,221397,43,4,1,0,1
2021,221397,45,0,1,1,0
2021,221397,45,4,1,1,0
2021,221485,0,0,176,75,101
2021,221485,10,0,176,75,101
2021,221485,10,1,22,7,15
2021,221485,10,2,60,26,34
2021,221485,10,3,62,26,36
2021,221485,10,4,32,16,16
2021,221485,20,0,74,29,45
2021,221485,20,1,21,6,15
2021,221485,20,2,39,16,23
2021,221485,20,3,11,5,6
2021,221485,20,4,3,2,1
2021,221485,30,0,26,13,13
2021,221485,30,2,8,4,4
2021,221485,30,3,17,8,9
2021,221485,30,4,1,1,0
2021,221485,40,0,76,33,43
2021,221485,40,1,1,1,0
2021,221485,40,2,13,6,7
2021,221485,40,3,34,13,21
2021,221485,40,4,28,13,15
2021,221485,42,0,76,33,43
2021,221485,42,1,1,1,0
2021,221485,42,2,13,6,7
2021,221485,42,3,34,13,21
2021,221485,42,4,28,13,15
2021,221519,0,0,173,97,76
2021,221519,10,0,173,97,76
2021,221519,10,1,62,33,29
2021,221519,10,2,44,30,14
2021,221519,10,3,63,32,31
2021,221519,10,4,4,2,2
2021,221519,20,0,98,59,39
2021,221519,20,1,57,31,26
2021,221519,20,2,41,28,13
2021,221519,30,0,36,17,19
2021,221519,30,3,36,17,19
2021,221519,40,0,39,21,18
2021,221519,40,1,5,2,3
2021,221519,40,2,3,2,1
2021,221519,40,3,27,15,12
2021,221519,40,4,4,2,2
2021,221519,41,0,5,4,1
2021,221519,41,2,2,1,1
2021,221519,41,3,2,2,0
2021,221519,41,4,1,1,0
2021,221519,42,0,34,17,17
2021,221519,42,1,5,2,3
2021,221519,42,2,1,1,0
2021,221519,42,3,25,13,12
2021,221519,42,4,3,1,2
2021,221519,44,0,5,4,1
2021,221519,44,2,2,1,1
2021,221519,44,3,2,2,0
2021,221519,44,4,1,1,0
2021,221643,0,0,221,89,132
2021,221643,10,0,221,89,132
2021,221643,10,1,35,17,18
2021,221643,10,2,128,46,82
2021,221643,10,3,27,9,18
2021,221643,10,4,31,17,14
2021,221643,20,0,163,64,99
2021,221643,20,1,35,17,18
2021,221643,20,2,123,45,78
2021,221643,20,3,5,2,3
2021,221643,30,0,51,22,29
2021,221643,30,2,5,1,4
2021,221643,30,3,22,7,15
2021,221643,30,4,24,14,10
2021,221643,40,0,7,3,4
2021,221643,40,4,7,3,4
2021,221643,42,0,7,3,4
2021,221643,42,4,7,3,4
2021,221661,0,0,139,65,74
2021,221661,10,0,138,65,73
2021,221661,10,1,60,32,28
2021,221661,10,2,56,29,27
2021,221661,10,3,22,4,18
2021,221661,40,0,138,65,73
2021,221661,40,1,60,32,28
2021,221661,40,2,56,29,27
2021,221661,40,3,22,4,18
2021,221661,42,0,138,65,73
2021,221661,42,1,60,32,28
2021,221661,42,2,56,29,27
2021,221661,42,3,22,4,18
2021,221661,50,0,1,0,1
2021,221670,0,0,54,23,31
2021,221670,10,0,54,23,31
2021,221670,10,1,13,9,4
2021,221670,10,2,26,8,18
2021,221670,10,3,12,6,6
2021,221670,10,4,3,0,3
2021,221670,40,0,54,23,31
2021,221670,40,1,13,9,4
2021,221670,40,2,26,8,18
2021,221670,40,3,12,6,6
2021,221670,40,4,3,0,3
2021,221670,41,0,54,23,31
2021,221670,41,1,13,9,4
2021,221670,41,2,26,8,18
2021,221670,41,3,12,6,6
2021,221670,41,4,3,0,3
2021,221670,45,0,54,23,31
2021,221670,45,1,13,9,4
2021,221670,45,2,26,8,18
2021,221670,45,3,12,6,6
2021,221670,45,4,3,0,3
2021,221731,0,0,73,30,43
2021,221731,10,0,73,30,43
2021,221731,10,1,15,8,7
2021,221731,10,2,18,9,9
2021,221731,10,3,40,13,27
2021,221731,20,0,27,16,11
2021,221731,20,1,15,8,7
2021,221731,20,2,10,6,4
2021,221731,20,3,2,2,0
2021,221731,30,0,20,8,12
2021,221731,30,2,3,1,2
2021,221731,30,3,17,7,10
2021,221731,40,0,26,6,20
2021,221731,40,2,5,2,3
2021,221731,40,3,21,4,17
2021,221731,42,0,26,6,20
2021,221731,42,2,5,2,3
2021,221731,42,3,21,4,17
2021,221740,0,0,502,260,242
2021,221740,10,0,502,260,242
2021,221740,10,1,135,88,47
2021,221740,10,2,101,58,43
2021,221740,10,3,132,51,81
2021,221740,10,4,2,0,2
2021,221740,10,5,130,61,69
2021,221740,10,6,2,2,0
2021,221740,20,0,221,135,86
2021,221740,20,1,132,86,46
2021,221740,20,2,89,49,40
2021,221740,30,0,124,55,69
2021,221740,30,1,1,1,0
2021,221740,30,2,9,7,2
2021,221740,30,3,112,46,66
2021,221740,30,5,2,1,1
2021,221740,40,0,157,70,87
2021,221740,40,1,2,1,1
2021,221740,40,2,3,2,1
2021,221740,40,3,20,5,15
2021,221740,40,4,2,0,2
2021,221740,40,5,128,60,68
2021,221740,40,6,2,2,0
2021,221740,42,0,157,70,87
2021,221740,42,1,2,1,1
2021,221740,42,2,3,2,1
2021,221740,42,3,20,5,15
2021,221740,42,4,2,0,2
2021,221740,42,5,128,60,68
2021,221740,42,6,2,2,0
2021,221759,0,0,1683,911,772
2021,221759,10,0,1683,911,772
2021,221759,10,1,531,362,169
2021,221759,10,2,395,220,175
2021,221759,10,3,348,167,181
2021,221759,10,4,34,4,30
2021,221759,10,5,372,155,217
2021,221759,10,6,3,3,0
2021,221759,20,0,840,554,286
2021,221759,20,1,509,355,154
2021,221759,20,2,330,198,132
2021,221759,20,3,1,1,0
2021,221759,30,0,291,158,133
2021,221759,30,1,3,2,1
2021,221759,30,2,21,12,9
2021,221759,30,3,267,144,123
2021,221759,40,0,552,199,353
2021,221759,40,1,19,5,14
2021,221759,40,2,44,10,34
2021,221759,40,3,80,22,58
2021,221759,40,4,34,4,30
2021,221759,40,5,372,155,217
2021,221759,40,6,3,3,0
2021,221759,41,0,542,195,347
2021,221759,41,1,19,5,14
2021,221759,41,2,44,10,34
2021,221759,41,3,80,22,58
2021,221759,41,4,34,4,30
2021,221759,41,5,364,153,211
2021,221759,41,6,1,1,0
2021,221759,43,0,10,4,6
2021,221759,43,5,8,2,6
2021,221759,43,6,2,2,0
2021,221759,45,0,542,195,347
2021,221759,45,1,19,5,14
2021,221759,45,2,44,10,34
2021,221759,45,3,80,22,58
2021,221759,45,4,34,4,30
2021,221759,45,5,364,153,211
2021,221759,45,6,1,1,0
2021,221768,0,0,295,165,130
2021,221768,10,0,295,165,130
2021,221768,10,1,99,67,32
2021,221768,10,2,61,36,25
2021,221768,10,3,52,26,26
2021,221768,10,4,11,7,4
2021,221768,10,5,72,29,43
2021,221768,20,0,161,102,59
2021,221768,20,1,97,65,32
2021,221768,20,2,53,31,22
2021,221768,20,3,5,1,4
2021,221768,20,4,6,5,1
2021,221768,30,0,57,33,24
2021,221768,30,1,2,2,0
2021,221768,30,2,6,5,1
2021,221768,30,3,47,25,22
2021,221768,30,4,1,1,0
2021,221768,30,5,1,0,1
2021,221768,40,0,77,30,47
2021,221768,40,2,2,0,2
2021,221768,40,4,4,1,3
2021,221768,40,5,71,29,42
2021,221768,42,0,77,30,47
2021,221768,42,2,2,0,2
2021,221768,42,4,4,1,3
2021,221768,42,5,71,29,42
2021,221838,0,0,337,176,161
2021,221838,10,0,337,176,161
2021,221838,10,1,97,60,37
2021,221838,10,2,107,62,45
2021,221838,10,3,112,44,68
2021,221838,10,4,8,3,5
2021,221838,10,6,13,7,6
2021,221838,20,0,200,120,80
2021,221838,20,1,94,58,36
2021,221838,20,2,82,48,34
2021,221838,20,3,15,7,8
2021,221838,20,4,1,1,0
2021,221838,20,6,8,6,2
2021,221838,30,0,128,53,75
2021,221838,30,1,3,2,1
2021,221838,30,2,25,14,11
2021,221838,30,3,96,36,60
2021,221838,30,4,2,1,1
2021,221838,30,6,2,0,2
2021,221838,40,0,9,3,6
2021,221838,40,3,1,1,0
2021,221838,40,4,5,1,4
2021,221838,40,6,3,1,2
2021,221838,42,0,8,2,6
2021,221838,42,3,1,1,0
2021,221838,42,4,4,0,4
2021,221838,42,6,3,1,2
2021,221838,43,0,1,1,0
2021,221838,43,4,1,1,0
2021,221847,0,0,444,256,188
2021,221847,10,0,444,256,188
2021,221847,10,1,127,95,32
2021,221847,10,2,113,61,52
2021,221847,10,3,86,48,38
2021,221847,10,4,53,25,28
2021,221847,10,5,65,27,38
2021,221847,20,0,263,167,96
2021,221847,20,1,127,95,32
2021,221847,20,2,105,55,50
2021,221847,20,3,13,7,6
2021,221847,20,4,17,9,8
2021,221847,20,5,1,1,0
2021,221847,30,0,82,47,35
2021,221847,30,2,8,6,2
2021,221847,30,3,72,41,31
2021,221847,30,4,2,0,2
2021,221847,40,0,99,42,57
2021,221847,40,3,1,0,1
2021,221847,40,4,34,16,18
2021,221847,40,5,64,26,38
2021,221847,41,0,65,26,39
2021,221847,41,3,1,0,1
2021,221847,41,5,64,26,38
2021,221847,42,0,34,16,18
2021,221847,42,4,34,16,18
2021,221847,44,0,65,26,39
2021,221847,44,3,1,0,1
2021,221847,44,5,64,26,38
2021,221892,0,0,97,58,39
2021,221892,10,0,97,58,39
2021,221892,10,1,36,26,10
2021,221892,10,2,34,21,13
2021,221892,10,3,25,9,16
2021,221892,10,4,2,2,0
2021,221892,20,0,25,19,6
2021,221892,20,1,21,16,5
2021,221892,20,2,4,3,1
2021,221892,30,0,72,39,33
2021,221892,30,1,15,10,5
2021,221892,30,2,30,18,12
2021,221892,30,3,25,9,16
2021,221892,30,4,2,2,0
2021,221908,0,0,120,56,64
2021,221908,10,0,120,56,64
2021,221908,10,1,10,5,5
2021,221908,10,2,50,24,26
2021,221908,10,3,27,11,16
2021,221908,10,4,33,16,17
2021,221908,20,0,53,26,27
2021,221908,20,1,10,5,5
2021,221908,20,2,43,21,22
2021,221908,30,0,8,0,8
2021,221908,30,2,4,0,4
2021,221908,30,3,4,0,4
2021,221908,40,0,59,30,29
2021,221908,40,2,3,3,0
2021,221908,40,3,23,11,12
2021,221908,40,4,33,16,17
2021,221908,42,0,59,30,29
2021,221908,42,2,3,3,0
2021,221908,42,3,23,11,12
2021,221908,42,4,33,16,17
2021,221953,0,0,64,34,30
2021,221953,10,0,64,34,30
2021,221953,10,1,8,4,4
2021,221953,10,2,25,13,12
2021,221953,10,3,27,16,11
2021,221953,10,4,4,1,3
2021,221953,40,0,64,34,30
2021,221953,40,1,8,4,4
2021,221953,40,2,25,13,12
2021,221953,40,3,27,16,11
2021,221953,40,4,4,1,3
2021,221953,41,0,55,30,25
2021,221953,41,1,7,4,3
2021,221953,41,2,23,12,11
2021,221953,41,3,24,14,10
2021,221953,41,4,1,0,1
2021,221953,42,0,9,4,5
2021,221953,42,1,1,0,1
2021,221953,42,2,2,1,1
2021,221953,42,3,3,2,1
2021,221953,42,4,3,1,2
2021,221953,44,0,55,30,25
2021,221953,44,1,7,4,3
2021,221953,44,2,23,12,11
2021,221953,44,3,24,14,10
2021,221953,44,4,1,0,1
2021,221971,0,0,219,115,104
2021,221971,10,0,207,112,95
2021,221971,10,1,84,61,23
2021,221971,10,2,47,18,29
2021,221971,10,3,73,30,43
2021,221971,10,6,3,3,0
2021,221971,20,0,90,65,25
2021,221971,20,1,73,54,19
2021,221971,20,2,16,10,6
2021,221971,20,6,1,1,0
2021,221971,30,0,116,47,69
2021,221971,30,1,11,7,4
2021,221971,30,2,31,8,23
2021,221971,30,3,72,30,42
2021,221971,30,6,2,2,0
2021,221971,40,0,1,0,1
2021,221971,40,3,1,0,1
2021,221971,42,0,1,0,1
2021,221971,42,3,1,0,1
2021,221971,50,0,12,3,9
2021,221999,0,0,1259,662,597
2021,221999,10,0,1259,662,597
2021,221999,10,1,472,334,138
2021,221999,10,2,275,138,137
2021,221999,10,3,294,116,178
2021,221999,10,4,33,7,26
2021,221999,10,5,172,63,109
2021,221999,10,6,13,4,9
2021,221999,20,0,612,422,190
2021,221999,20,1,413,307,106
2021,221999,20,2,199,115,84
2021,221999,30,0,180,88,92
2021,221999,30,2,3,1,2
2021,221999,30,3,177,87,90
2021,221999,40,0,467,152,315
2021,221999,40,1,59,27,32
2021,221999,40,2,73,22,51
2021,221999,40,3,117,29,88
2021,221999,40,4,33,7,26
2021,221999,40,5,172,63,109
2021,221999,40,6,13,4,9
2021,221999,41,0,375,125,250
2021,221999,41,1,55,24,31
2021,221999,41,2,68,19,49
2021,221999,41,3,105,26,79
2021,221999,41,4,5,1,4
2021,221999,41,5,130,52,78
2021,221999,41,6,12,3,9
2021,221999,42,0,68,17,51
2021,221999,42,1,1,1,0
2021,221999,42,2,3,1,2
2021,221999,42,3,8,1,7
2021,221999,42,4,21,5,16
2021,221999,42,5,35,9,26
2021,221999,43,0,24,10,14
2021,221999,43,1,3,2,1
2021,221999,43,2,2,2,0
2021,221999,43,3,4,2,2
2021,221999,43,4,7,1,6
2021,221999,43,5,7,2,5
2021,221999,43,6,1,1,0
2021,221999,44,0,375,125,250
2021,221999,44,1,55,24,31
2021,221999,44,2,68,19,49
2021,221999,44,3,105,26,79
2021,221999,44,4,5,1,4
2021,221999,44,5,130,52,78
2021,221999,44,6,12,3,9
2021,222053,0,0,190,88,102
2021,222053,10,0,190,88,102
2021,222053,10,1,21,12,9
2021,222053,10,2,83,32,51
2021,222053,10,3,34,17,17
2021,222053,10,4,52,27,25
2021,222053,20,0,89,39,50
2021,222053,20,1,20,12,8
2021,222053,20,2,66,27,39
2021,222053,20,3,2,0,2
2021,222053,20,4,1,0,1
2021,222053,30,0,47,21,26
2021,222053,30,2,8,1,7
2021,222053,30,3,15,8,7
2021,222053,30,4,24,12,12
2021,222053,40,0,54,28,26
2021,222053,40,1,1,0,1
2021,222053,40,2,9,4,5
2021,222053,40,3,17,9,8
2021,222053,40,4,27,15,12
2021,222053,42,0,19,9,10
2021,222053,42,1,1,0,1
2021,222053,42,2,2,1,1
2021,222053,42,3,4,3,1
2021,222053,42,4,12,5,7
2021,222053,43,0,35,19,16
2021,222053,43,2,7,3,4
2021,222053,43,3,13,6,7
2021,222053,43,4,15,10,5
2021,222062,0,0,155,59,96
2021,222062,10,0,155,59,96
2021,222062,10,1,22,10,12
2021,222062,10,2,59,19,40
2021,222062,10,3,43,18,25
2021,222062,10,4,31,12,19
2021,222062,20,0,40,12,28
2021,222062,20,1,17,6,11
2021,222062,20,2,22,6,16
2021,222062,20,3,1,0,1
2021,222062,30,0,40,14,26
2021,222062,30,1,4,3,1
2021,222062,30,2,18,4,14
2021,222062,30,3,8,3,5
2021,222062,30,4,10,4,6
2021,222062,40,0,75,33,42
2021,222062,40,1,1,1,0
2021,222062,40,2,19,9,10
2021,222062,40,3,34,15,19
2021,222062,40,4,21,8,13
2021,222062,42,0,75,33,42
2021,222062,42,1,1,1,0
2021,222062,42,2,19,9,10
2021,222062,42,3,34,15,19
2021,222062,42,4,21,8,13
2021,222105,0,0,22,21,1
2021,222105,10,0,22,21,1
2021,222105,10,4,22,21,1
2021,222105,40,0,22,21,1
2021,222105,40,4,22,21,1
2021,222105,41,0,22,21,1
2021,222105,41,4,22,21,1
2021,222105,45,0,22,21,1
2021,222105,45,4,22,21,1
2021,222178,0,0,268,149,119
2021,222178,10,0,268,149,119
2021,222178,10,1,68,54,14
2021,222178,10,2,75,48,27
2021,222178,10,3,56,26,30
2021,222178,10,4,26,5,21
2021,222178,10,6,43,16,27
2021,222178,20,0,135,100,35
2021,222178,20,1,66,54,12
2021,222178,20,2,63,41,22
2021,222178,20,3,5,4,1
2021,222178,20,6,1,1,0
2021,222178,30,0,54,24,30
2021,222178,30,2,7,5,2
2021,222178,30,3,44,19,25
2021,222178,30,6,3,0,3
2021,222178,40,0,79,25,54
2021,222178,40,1,2,0,2
2021,222178,40,2,5,2,3
2021,222178,40,3,7,3,4
2021,222178,40,4,26,5,21
2021,222178,40,6,39,15,24
2021,222178,41,0,1,1,0
2021,222178,41,6,1,1,0
2021,222178,42,0,78,24,54
2021,222178,42,1,2,0,2
2021,222178,42,2,5,2,3
2021,222178,42,3,7,3,4
2021,222178,42,4,26,5,21
2021,222178,42,6,38,14,24
2021,222178,44,0,1,1,0
2021,222178,44,6,1,1,0
2021,222567,0,0,112,51,61
2021,222567,10,0,108,49,59
2021,222567,10,6,108,49,59
2021,222567,20,0,55,27,28
2021,222567,20,6,55,27,28
2021,222567,30,0,50,20,30
2021,222567,30,6,50,20,30
2021,222567,40,0,3,2,1
2021,222567,40,6,3,2,1
2021,222567,42,0,3,2,1
2021,222567,42,6,3,2,1
2021,222567,50,0,4,2,2
2021,222576,0,0,174,69,105
2021,222576,10,0,174,69,105
2021,222576,10,1,22,9,13
2021,222576,10,2,13,3,10
2021,222576,10,3,32,12,20
2021,222576,10,4,107,45,62
2021,222576,20,0,45,16,29
2021,222576,20,1,22,9,13
2021,222576,20,2,9,2,7
2021,222576,20,3,10,3,7
2021,222576,20,4,4,2,2
2021,222576,30,0,127,52,75
2021,222576,30,2,4,1,3
2021,222576,30,3,22,9,13
2021,222576,30,4,101,42,59
2021,222576,40,0,2,1,1
2021,222576,40,4,2,1,1
2021,222576,42,0,2,1,1
2021,222576,42,4,2,1,1
2021,222628,0,0,16,9,7
2021,222628,10,0,16,9,7
2021,222628,10,1,13,8,5
2021,222628,10,2,3,1,2
2021,222628,40,0,16,9,7
2021,222628,40,1,13,8,5
2021,222628,40,2,3,1,2
2021,222628,42,0,16,9,7
2021,222628,42,1,13,8,5
2021,222628,42,2,3,1,2
2021,222822,0,0,90,34,56
2021,222822,10,0,90,34,56
2021,222822,10,6,90,34,56
2021,222822,40,0,90,34,56
2021,222822,40,6,90,34,56
2021,222822,42,0,90,34,56
2021,222822,42,6,90,34,56
2021,222831,0,0,312,166,146
2021,222831,10,0,312,166,146
2021,222831,10,1,83,52,31
2021,222831,10,2,54,32,22
2021,222831,10,3,73,39,34
2021,222831,10,4,71,35,36
2021,222831,10,6,31,8,23
2021,222831,20,0,138,84,54
2021,222831,20,1,83,52,31
2021,222831,20,2,54,32,22
2021,222831,20,3,1,0,1
2021,222831,30,0,72,39,33
2021,222831,30,3,72,39,33
2021,222831,40,0,102,43,59
2021,222831,40,4,71,35,36
2021,222831,40,6,31,8,23
2021,222831,41,0,96,41,55
2021,222831,41,4,65,33,32
2021,222831,41,6,31,8,23
2021,222831,42,0,6,2,4
2021,222831,42,4,6,2,4
2021,222831,45,0,96,41,55
2021,222831,45,4,65,33,32
2021,222831,45,6,31,8,23
2021,222877,0,0,6,3,3
2021,222877,10,0,6,3,3
2021,222877,10,4,6,3,3
2021,222877,40,0,6,3,3
2021,222877,40,4,6,3,3
2021,222877,41,0,6,3,3
2021,222877,41,4,6,3,3
2021,222877,45,0,6,3,3
2021,222877,45,4,6,3,3
2021,222938,0,0,5,5,0
2021,222938,10,0,5,5,0
2021,222938,10,4,5,5,0
2021,222938,40,0,5,5,0
2021,222938,40,4,5,5,0
2021,222938,41,0,5,5,0
2021,222938,41,4,5,5,0
2021,222938,45,0,5,5,0
2021,222938,45,4,5,5,0
2021,222983,0,0,102,62,40
2021,222983,10,0,102,62,40
2021,222983,10,1,28,22,6
2021,222983,10,2,42,29,13
2021,222983,10,3,27,11,16
2021,222983,10,4,5,0,5
2021,222983,20,0,70,51,19
2021,222983,20,1,28,22,6
2021,222983,20,2,42,29,13
2021,222983,30,0,22,9,13
2021,222983,30,3,22,9,13
2021,222983,40,0,10,2,8
2021,222983,40,3,5,2,3
2021,222983,40,4,5,0,5
2021,222983,42,0,10,2,8
2021,222983,42,3,5,2,3
2021,222983,42,4,5,0,5
2021,222992,0,0,632,285,347
2021,222992,10,0,632,285,347
2021,222992,10,1,342,171,171
2021,222992,10,2,186,69,117
2021,222992,10,3,75,36,39
2021,222992,10,4,3,2,1
2021,222992,10,6,26,7,19
2021,222992,40,0,632,285,347
2021,222992,40,1,342,171,171
2021,222992,40,2,186,69,117
2021,222992,40,3,75,36,39
2021,222992,40,4,3,2,1
2021,222992,40,6,26,7,19
2021,222992,42,0,632,285,347
2021,222992,42,1,342,171,171
2021,222992,42,2,186,69,117
2021,222992,42,3,75,36,39
2021,222992,42,4,3,2,1
2021,222992,42,6,26,7,19
2021,223001,0,0,20,12,8
2021,223001,10,0,20,12,8
2021,223001,10,1,9,5,4
2021,223001,10,2,6,4,2
2021,223001,10,3,2,1,1
2021,223001,10,6,3,2,1
2021,223001,20,0,10,6,4
2021,223001,20,1,8,5,3
2021,223001,20,2,2,1,1
2021,223001,30,0,5,3,2
2021,223001,30,2,3,2,1
2021,223001,30,3,2,1,1
2021,223001,40,0,5,3,2
2021,223001,40,1,1,0,1
2021,223001,40,2,1,1,0
2021,223001,40,6,3,2,1
2021,223001,41,0,1,0,1
2021,223001,41,6,1,0,1
2021,223001,42,0,4,3,1
2021,223001,42,1,1,0,1
2021,223001,42,2,1,1,0
2021,223001,42,6,2,2,0
2021,223001,45,0,1,0,1
2021,223001,45,6,1,0,1
2021,223083,0,0,31,1,30
2021,223083,10,0,31,1,30
2021,223083,10,4,31,1,30
2021,223083,40,0,31,1,30
2021,223083,40,4,31,1,30
2021,223083,41,0,31,1,30
2021,223083,41,4,31,1,30
2021,223083,45,0,31,1,30
2021,223083,45,4,31,1,30
2021,223223,0,0,3349,1524,1825
2021,223223,10,0,3349,1524,1825
2021,223223,10,1,385,269,116
2021,223223,10,2,613,366,247
2021,223223,10,3,1742,740,1002
2021,223223,10,4,609,149,460
2021,223223,20,0,439,303,136
2021,223223,20,1,260,194,66
2021,223223,20,2,179,109,70
2021,223223,30,0,462,239,223
2021,223223,30,2,32,23,9
2021,223223,30,3,430,216,214
2021,223223,40,0,2448,982,1466
2021,223223,40,1,125,75,50
2021,223223,40,2,402,234,168
2021,223223,40,3,1312,524,788
2021,223223,40,4,609,149,460
2021,223223,42,0,2448,982,1466
2021,223223,42,1,125,75,50
2021,223223,42,2,402,234,168
2021,223223,42,3,1312,524,788
2021,223223,42,4,609,149,460
2021,223232,0,0,1068,580,488
2021,223232,10,0,1068,580,488
2021,223232,10,1,291,218,73
2021,223232,10,2,299,169,130
2021,223232,10,3,232,94,138
2021,223232,10,4,13,0,13
2021,223232,10,5,233,99,134
2021,223232,20,0,513,363,150
2021,223232,20,1,277,213,64
2021,223232,20,2,236,150,86
2021,223232,30,0,155,72,83
2021,223232,30,2,12,5,7
2021,223232,30,3,143,67,76
2021,223232,40,0,400,145,255
2021,223232,40,1,14,5,9
2021,223232,40,2,51,14,37
2021,223232,40,3,89,27,62
2021,223232,40,4,13,0,13
2021,223232,40,5,233,99,134
2021,223232,42,0,400,145,255
2021,223232,42,1,14,5,9
2021,223232,42,2,51,14,37
2021,223232,42,3,89,27,62
2021,223232,42,4,13,0,13
2021,223232,42,5,233,99,134
2021,223320,0,0,45,19,26
2021,223320,10,0,45,19,26
2021,223320,10,1,9,4,5
2021,223320,10,2,17,6,11
2021,223320,10,3,8,2,6
2021,223320,10,4,8,5,3
2021,223320,10,6,3,2,1
2021,223320,40,0,45,19,26
2021,223320,40,1,9,4,5
2021,223320,40,2,17,6,11
2021,223320,40,3,8,2,6
2021,223320,40,4,8,5,3
2021,223320,40,6,3,2,1
2021,223320,42,0,45,19,26
2021,223320,42,1,9,4,5
2021,223320,42,2,17,6,11
2021,223320,42,3,8,2,6
2021,223320,42,4,8,5,3
2021,223320,42,6,3,2,1
2021,223427,0,0,369,182,187
2021,223427,10,0,369,182,187
2021,223427,10,6,369,182,187
2021,223427,40,0,369,182,187
2021,223427,40,6,369,182,187
2021,223427,41,0,267,127,140
2021,223427,41,6,267,127,140
2021,223427,43,0,102,55,47
2021,223427,43,6,102,55,47
2021,223427,44,0,267,127,140
2021,223427,44,6,267,127,140
2021,223463,0,0,10,6,4
2021,223463,50,0,10,6,4
2021,223506,0,0,101,60,41
2021,223506,10,0,101,60,41
2021,223506,10,1,14,8,6
2021,223506,10,2,19,11,8
2021,223506,10,3,40,23,17
2021,223506,10,4,28,18,10
2021,223506,20,0,32,16,16
2021,223506,20,1,13,7,6
2021,223506,20,2,11,6,5
2021,223506,20,3,8,3,5
2021,223506,40,0,69,44,25
2021,223506,40,1,1,1,0
2021,223506,40,2,8,5,3
2021,223506,40,3,32,20,12
2021,223506,40,4,28,18,10
2021,223506,41,0,26,18,8
2021,223506,41,2,6,3,3
2021,223506,41,3,12,9,3
2021,223506,41,4,8,6,2
2021,223506,42,0,40,25,15
2021,223506,42,1,1,1,0
2021,223506,42,2,2,2,0
2021,223506,42,3,20,11,9
2021,223506,42,4,17,11,6
2021,223506,43,0,3,1,2
2021,223506,43,4,3,1,2
2021,223506,44,0,26,18,8
2021,223506,44,2,6,3,3
2021,223506,44,3,12,9,3
2021,223506,44,4,8,6,2
2021,223816,0,0,170,88,82
2021,223816,10,0,136,59,77
2021,223816,10,1,136,59,77
2021,223816,40,0,136,59,77
2021,223816,40,1,136,59,77
2021,223816,42,0,136,59,77
2021,223816,42,1,136,59,77
2021,223816,50,0,34,29,5
2021,223898,0,0,75,33,42
2021,223898,10,0,75,33,42
2021,223898,10,1,67,30,37
2021,223898,10,4,8,3,5
2021,223898,20,0,17,8,9
2021,223898,20,1,17,8,9
2021,223898,30,0,3,2,1
2021,223898,30,1,2,2,0
2021,223898,30,4,1,0,1
2021,223898,40,0,55,23,32
2021,223898,40,1,48,20,28
2021,223898,40,4,7,3,4
2021,223898,42,0,55,23,32
2021,223898,42,1,48,20,28
2021,223898,42,4,7,3,4
2021,223922,0,0,39,22,17
2021,223922,10,0,39,22,17
2021,223922,10,1,2,2,0
2021,223922,10,2,3,2,1
2021,223922,10,3,4,2,2
2021,223922,10,4,30,16,14
2021,223922,40,0,39,22,17
2021,223922,40,1,2,2,0
2021,223922,40,2,3,2,1
2021,223922,40,3,4,2,2
2021,223922,40,4,30,16,14
2021,223922,42,0,39,22,17
2021,223922,42,1,2,2,0
2021,223922,42,2,3,2,1
2021,223922,42,3,4,2,2
2021,223922,42,4,30,16,14
2021,224004,0,0,54,23,31
2021,224004,10,0,54,23,31
2021,224004,10,1,11,8,3
2021,224004,10,2,19,9,10
2021,224004,10,3,13,5,8
2021,224004,10,4,11,1,10
2021,224004,40,0,54,23,31
2021,224004,40,1,11,8,3
2021,224004,40,2,19,9,10
2021,224004,40,3,13,5,8
2021,224004,40,4,11,1,10
2021,224004,41,0,43,22,21
2021,224004,41,1,11,8,3
2021,224004,41,2,19,9,10
2021,224004,41,3,13,5,8
2021,224004,42,0,11,1,10
2021,224004,42,4,11,1,10
2021,224004,44,0,43,22,21
2021,224004,44,1,11,8,3
2021,224004,44,2,19,9,10
2021,224004,44,3,13,5,8
2021,224110,0,0,146,57,89
2021,224110,10,0,146,57,89
2021,224110,10,6,146,57,89
2021,224110,40,0,146,57,89
2021,224110,40,6,146,57,89
2021,224110,42,0,3,2,1
2021,224110,42,6,3,2,1
2021,224110,43,0,143,55,88
2021,224110,43,6,143,55,88
2021,224147,0,0,410,198,212
2021,224147,10,0,410,198,212
2021,224147,10,1,84,56,28
2021,224147,10,2,117,64,53
2021,224147,10,3,192,72,120
2021,224147,10,4,8,2,6
2021,224147,10,5,9,4,5
2021,224147,20,0,180,107,73
2021,224147,20,1,80,54,26
2021,224147,20,2,98,53,45
2021,224147,20,3,2,0,2
2021,224147,30,0,119,57,62
2021,224147,30,1,1,1,0
2021,224147,30,2,6,5,1
2021,224147,30,3,112,51,61
2021,224147,40,0,111,34,77
2021,224147,40,1,3,1,2
2021,224147,40,2,13,6,7
2021,224147,40,3,78,21,57
2021,224147,40,4,8,2,6
2021,224147,40,5,9,4,5
2021,224147,42,0,105,31,74
2021,224147,42,1,3,1,2
2021,224147,42,2,13,6,7
2021,224147,42,3,78,21,57
2021,224147,42,4,8,2,6
2021,224147,42,5,3,1,2
2021,224147,43,0,6,3,3
2021,224147,43,5,6,3,3
2021,224226,0,0,113,69,44
2021,224226,10,0,113,69,44
2021,224226,10,1,48,29,19
2021,224226,10,2,16,9,7
2021,224226,10,3,49,31,18
2021,224226,40,0,113,69,44
2021,224226,40,1,48,29,19
2021,224226,40,2,16,9,7
2021,224226,40,3,49,31,18
2021,224226,42,0,113,69,44
2021,224226,42,1,48,29,19
2021,224226,42,2,16,9,7
2021,224226,42,3,49,31,18
2021,224244,0,0,8,4,4
2021,224244,10,0,8,4,4
2021,224244,10,1,6,4,2
2021,224244,10,2,1,0,1
2021,224244,10,4,1,0,1
2021,224244,40,0,8,4,4
2021,224244,40,1,6,4,2
2021,224244,40,2,1,0,1
2021,224244,40,4,1,0,1
2021,224244,42,0,8,4,4
2021,224244,42,1,6,4,2
2021,224244,42,2,1,0,1
2021,224244,42,4,1,0,1
2021,224305,0,0,73,67,6
2021,224305,10,0,66,60,6
2021,224305,10,1,36,34,2
2021,224305,10,2,13,12,1
2021,224305,10,3,16,13,3
2021,224305,10,4,1,1,0
2021,224305,20,0,30,29,1
2021,224305,20,1,25,24,1
2021,224305,20,2,5,5,0
2021,224305,30,0,21,17,4
2021,224305,30,1,3,3,0
2021,224305,30,2,6,5,1
2021,224305,30,3,11,8,3
2021,224305,30,4,1,1,0
2021,224305,40,0,15,14,1
2021,224305,40,1,8,7,1
2021,224305,40,2,2,2,0
2021,224305,40,3,5,5,0
2021,224305,42,0,11,11,0
2021,224305,42,1,5,5,0
2021,224305,42,2,2,2,0
2021,224305,42,3,4,4,0
2021,224305,43,0,4,3,1
2021,224305,43,1,3,2,1
2021,224305,43,3,1,1,0
2021,224305,50,0,7,7,0
2021,224323,0,0,139,82,57
2021,224323,10,0,139,82,57
2021,224323,10,1,15,13,2
2021,224323,10,2,67,42,25
2021,224323,10,3,23,11,12
2021,224323,10,4,34,16,18
2021,224323,20,0,73,51,22
2021,224323,20,1,15,13,2
2021,224323,20,2,54,35,19
2021,224323,20,3,4,3,1
2021,224323,30,0,31,14,17
2021,224323,30,2,13,7,6
2021,224323,30,3,18,7,11
2021,224323,40,0,35,17,18
2021,224323,40,3,1,1,0
2021,224323,40,4,34,16,18
2021,224323,42,0,35,17,18
2021,224323,42,3,1,1,0
2021,224323,42,4,34,16,18
2021,224350,0,0,340,172,168
2021,224350,10,0,309,159,150
2021,224350,10,1,99,57,42
2021,224350,10,2,55,26,29
2021,224350,10,3,51,25,26
2021,224350,10,4,104,51,53
2021,224350,20,0,191,99,92
2021,224350,20,1,99,57,42
2021,224350,20,2,54,25,29
2021,224350,20,3,38,17,21
2021,224350,30,0,56,22,34
2021,224350,30,2,1,1,0
2021,224350,30,3,13,8,5
2021,224350,30,4,42,13,29
2021,224350,40,0,62,38,24
2021,224350,40,4,62,38,24
2021,224350,42,0,19,9,10
2021,224350,42,4,19,9,10
2021,224350,43,0,43,29,14
2021,224350,43,4,43,29,14
2021,224350,50,0,31,13,18
2021,224527,0,0,74,40,34
2021,224527,10,0,74,40,34
2021,224527,10,1,20,16,4
2021,224527,10,2,20,11,9
2021,224527,10,3,34,13,21
2021,224527,20,0,1,1,0
2021,224527,20,1,1,1,0
2021,224527,40,0,73,39,34
2021,224527,40,1,19,15,4
2021,224527,40,2,20,11,9
2021,224527,40,3,34,13,21
2021,224527,41,0,24,19,5
2021,224527,41,1,17,13,4
2021,224527,41,2,7,6,1
2021,224527,42,0,49,20,29
2021,224527,42,1,2,2,0
2021,224527,42,2,13,5,8
2021,224527,42,3,34,13,21
2021,224527,44,0,24,19,5
2021,224527,44,1,17,13,4
2021,224527,44,2,7,6,1
2021,224545,0,0,96,50,46
2021,224545,10,0,96,50,46
2021,224545,10,1,18,15,3
2021,224545,10,2,23,14,9
2021,224545,10,3,34,17,17
2021,224545,10,4,20,3,17
2021,224545,10,5,1,1,0
2021,224545,20,0,31,25,6
2021,224545,20,1,18,15,3
2021,224545,20,2,13,10,3
2021,224545,30,0,32,18,14
2021,224545,30,2,9,4,5
2021,224545,30,3,23,14,9
2021,224545,40,0,33,7,26
2021,224545,40,2,1,0,1
2021,224545,40,3,11,3,8
2021,224545,40,4,20,3,17
2021,224545,40,5,1,1,0
2021,224545,42,0,33,7,26
2021,224545,42,2,1,0,1
2021,224545,42,3,11,3,8
2021,224545,42,4,20,3,17
2021,224545,42,5,1,1,0
2021,224554,0,0,376,191,185
2021,224554,10,0,376,191,185
2021,224554,10,1,66,47,19
2021,224554,10,2,130,71,59
2021,224554,10,3,120,52,68
2021,224554,10,4,52,17,35
2021,224554,10,5,8,4,4
2021,224554,20,0,178,111,67
2021,224554,20,1,66,47,19
2021,224554,20,2,110,62,48
2021,224554,20,3,2,2,0
2021,224554,30,0,99,43,56
2021,224554,30,2,5,3,2
2021,224554,30,3,94,40,54
2021,224554,40,0,99,37,62
2021,224554,40,2,15,6,9
2021,224554,40,3,24,10,14
2021,224554,40,4,52,17,35
2021,224554,40,5,8,4,4
2021,224554,42,0,99,37,62
2021,224554,42,2,15,6,9
2021,224554,42,3,24,10,14
2021,224554,42,4,52,17,35
2021,224554,42,5,8,4,4
2021,224615,0,0,891,414,477
2021,224615,10,0,891,414,477
2021,224615,10,6,891,414,477
2021,224615,40,0,891,414,477
2021,224615,40,6,891,414,477
2021,224615,42,0,891,414,477
2021,224615,42,6,891,414,477
2021,224642,0,0,393,174,219
2021,224642,10,0,393,174,219
2021,224642,10,1,142,69,73
2021,224642,10,2,40,16,24
2021,224642,10,3,135,58,77
2021,224642,10,5,64,28,36
2021,224642,10,6,12,3,9
2021,224642,20,0,183,85,98
2021,224642,20,1,142,69,73
2021,224642,20,2,40,16,24
2021,224642,20,6,1,0,1
2021,224642,30,0,146,62,84
2021,224642,30,3,135,58,77
2021,224642,30,5,9,2,7
2021,224642,30,6,2,2,0
2021,224642,40,0,64,27,37
2021,224642,40,5,55,26,29
2021,224642,40,6,9,1,8
2021,224642,42,0,5,2,3
2021,224642,42,5,5,2,3
2021,224642,43,0,59,25,34
2021,224642,43,5,50,24,26
2021,224642,43,6,9,1,8
2021,224660,0,0,42,23,19
2021,224660,10,0,42,23,19
2021,224660,10,4,42,23,19
2021,224660,40,0,42,23,19
2021,224660,40,4,42,23,19
2021,224660,41,0,42,23,19
2021,224660,41,4,42,23,19
2021,224660,45,0,42,23,19
2021,224660,45,4,42,23,19
2021,224679,0,0,80,68,12
2021,224679,10,0,80,68,12
2021,224679,10,4,80,68,12
2021,224679,40,0,80,68,12
2021,224679,40,4,80,68,12
2021,224679,41,0,80,68,12
2021,224679,41,4,80,68,12
2021,224679,45,0,80,68,12
2021,224679,45,4,80,68,12
2021,224712,0,0,18,8,10
2021,224712,10,0,16,8,8
2021,224712,10,1,4,4,0
2021,224712,10,2,5,2,3
2021,224712,10,3,6,2,4
2021,224712,10,6,1,0,1
2021,224712,20,0,7,5,2
2021,224712,20,1,4,4,0
2021,224712,20,2,3,1,2
2021,224712,30,0,6,1,5
2021,224712,30,2,1,0,1
2021,224712,30,3,5,1,4
2021,224712,40,0,3,2,1
2021,224712,40,2,1,1,0
2021,224712,40,3,1,1,0
2021,224712,40,6,1,0,1
2021,224712,41,0,1,0,1
2021,224712,41,6,1,0,1
2021,224712,42,0,1,1,0
2021,224712,42,3,1,1,0
2021,224712,43,0,1,1,0
2021,224712,43,2,1,1,0
2021,224712,45,0,1,0,1
2021,224712,45,6,1,0,1
2021,224712,50,0,2,0,2
2021,224776,0,0,3,2,1
2021,224776,10,0,3,2,1
2021,224776,10,4,3,2,1
2021,224776,40,0,3,2,1
2021,224776,40,4,3,2,1
2021,224776,41,0,3,2,1
2021,224776,41,4,3,2,1
2021,224776,45,0,3,2,1
2021,224776,45,4,3,2,1
2021,224891,0,0,36,18,18
2021,224891,10,0,30,15,15
2021,224891,10,1,9,7,2
2021,224891,10,2,3,0,3
2021,224891,10,3,10,2,8
2021,224891,10,4,8,6,2
2021,224891,40,0,30,15,15
2021,224891,40,1,9,7,2
2021,224891,40,2,3,0,3
2021,224891,40,3,10,2,8
2021,224891,40,4,8,6,2
2021,224891,41,0,7,4,3
2021,224891,41,1,6,4,2
2021,224891,41,2,1,0,1
2021,224891,42,0,23,11,12
2021,224891,42,1,3,3,0
2021,224891,42,2,2,0,2
2021,224891,42,3,10,2,8
2021,224891,42,4,8,6,2
2021,224891,44,0,7,4,3
2021,224891,44,1,6,4,2
2021,224891,44,2,1,0,1
2021,224891,50,0,6,3,3
2021,224961,0,0,59,30,29
2021,224961,10,0,58,30,28
2021,224961,10,1,2,2,0
2021,224961,10,2,5,4,1
2021,224961,10,3,5,3,2
2021,224961,10,4,46,21,25
2021,224961,20,0,18,12,6
2021,224961,20,1,2,2,0
2021,224961,20,2,5,4,1
2021,224961,20,3,3,2,1
2021,224961,20,4,8,4,4
2021,224961,30,0,40,18,22
2021,224961,30,3,2,1,1
2021,224961,30,4,38,17,21
2021,224961,50,0,1,0,1
2021,225070,0,0,114,44,70
2021,225070,10,0,111,43,68
2021,225070,10,1,111,43,68
2021,225070,40,0,111,43,68
2021,225070,40,1,111,43,68
2021,225070,42,0,111,43,68
2021,225070,42,1,111,43,68
2021,225070,50,0,3,1,2
2021,225201,0,0,34,22,12
2021,225201,10,0,33,21,12
2021,225201,10,4,33,21,12
2021,225201,40,0,33,21,12
2021,225201,40,4,33,21,12
2021,225201,41,0,33,21,12
2021,225201,41,4,33,21,12
2021,225201,45,0,33,21,12
2021,225201,45,4,33,21,12
2021,225201,50,0,1,1,0
2021,225247,0,0,91,52,39
2021,225247,10,0,91,52,39
2021,225247,10,1,40,29,11
2021,225247,10,2,20,10,10
2021,225247,10,3,28,12,16
2021,225247,10,4,2,0,2
2021,225247,10,5,1,1,0
2021,225247,20,0,51,33,18
2021,225247,20,1,37,26,11
2021,225247,20,2,14,7,7
2021,225247,40,0,40,19,21
2021,225247,40,1,3,3,0
2021,225247,40,2,6,3,3
2021,225247,40,3,28,12,16
2021,225247,40,4,2,0,2
2021,225247,40,5,1,1,0
2021,225247,41,0,24,11,13
2021,225247,41,1,2,2,0
2021,225247,41,2,3,1,2
2021,225247,41,3,18,8,10
2021,225247,41,4,1,0,1
2021,225247,42,0,16,8,8
2021,225247,42,1,1,1,0
2021,225247,42,2,3,2,1
2021,225247,42,3,10,4,6
2021,225247,42,4,1,0,1
2021,225247,42,5,1,1,0
2021,225247,44,0,24,11,13
2021,225247,44,1,2,2,0
2021,225247,44,2,3,1,2
2021,225247,44,3,18,8,10
2021,225247,44,4,1,0,1
2021,225308,0,0,160,82,78
2021,225308,10,0,160,82,78
2021,225308,10,4,157,82,75
2021,225308,10,6,3,0,3
2021,225308,40,0,160,82,78
2021,225308,40,4,157,82,75
2021,225308,40,6,3,0,3
2021,225308,42,0,44,31,13
2021,225308,42,4,44,31,13
2021,225308,43,0,116,51,65
2021,225308,43,4,113,51,62
2021,225308,43,6,3,0,3
2021,225371,0,0,88,45,43
2021,225371,10,0,88,45,43
2021,225371,10,6,88,45,43
2021,225371,40,0,88,45,43
2021,225371,40,6,88,45,43
2021,225371,42,0,88,45,43
2021,225371,42,6,88,45,43
2021,225399,0,0,137,77,60
2021,225399,10,0,137,77,60
2021,225399,10,1,32,25,7
2021,225399,10,2,42,27,15
2021,225399,10,3,61,25,36
2021,225399,10,4,2,0,2
2021,225399,40,0,137,77,60
2021,225399,40,1,32,25,7
2021,225399,40,2,42,27,15
2021,225399,40,3,61,25,36
2021,225399,40,4,2,0,2
2021,225399,41,0,80,54,26
2021,225399,41,1,27,22,5
2021,225399,41,2,33,21,12
2021,225399,41,3,20,11,9
2021,225399,42,0,57,23,34
2021,225399,42,1,5,3,2
2021,225399,42,2,9,6,3
2021,225399,42,3,41,14,27
2021,225399,42,4,2,0,2
2021,225399,44,0,80,54,26
2021,225399,44,1,27,22,5
2021,225399,44,2,33,21,12
2021,225399,44,3,20,11,9
2021,225414,0,0,278,137,141
2021,225414,10,0,269,137,132
2021,225414,10,1,62,38,24
2021,225414,10,2,107,59,48
2021,225414,10,3,58,30,28
2021,225414,10,5,28,8,20
2021,225414,10,6,14,2,12
2021,225414,20,0,169,97,72
2021,225414,20,1,62,38,24
2021,225414,20,2,107,59,48
2021,225414,30,0,58,30,28
2021,225414,30,3,58,30,28
2021,225414,40,0,42,10,32
2021,225414,40,5,28,8,20
2021,225414,40,6,14,2,12
2021,225414,42,0,40,10,30
2021,225414,42,5,28,8,20
2021,225414,42,6,12,2,10
2021,225414,43,0,2,0,2
2021,225414,43,6,2,0,2
2021,225414,50,0,9,0,9
2021,225423,0,0,915,439,476
2021,225423,10,0,915,439,476
2021,225423,10,4,915,439,476
2021,225423,40,0,915,439,476
2021,225423,40,4,915,439,476
2021,225423,42,0,915,439,476
2021,225423,42,4,915,439,476
2021,225432,0,0,366,183,183
2021,225432,10,0,366,183,183
2021,225432,10,1,69,42,27
2021,225432,10,2,103,58,45
2021,225432,10,3,77,35,42
2021,225432,10,4,1,0,1
2021,225432,10,5,102,42,60
2021,225432,10,6,14,6,8
2021,225432,20,0,169,98,71
2021,225432,20,1,68,41,27
2021,225432,20,2,101,57,44
2021,225432,30,0,81,37,44
2021,225432,30,1,1,1,0
2021,225432,30,2,2,1,1
2021,225432,30,3,77,35,42
2021,225432,30,4,1,0,1
2021,225432,40,0,116,48,68
2021,225432,40,5,102,42,60
2021,225432,40,6,14,6,8
2021,225432,42,0,106,45,61
2021,225432,42,5,99,40,59
2021,225432,42,6,7,5,2
2021,225432,43,0,10,3,7
2021,225432,43,5,3,2,1
2021,225432,43,6,7,1,6
2021,225502,0,0,132,71,61
2021,225502,10,0,123,69,54
2021,225502,10,1,35,21,14
2021,225502,10,2,39,23,16
2021,225502,10,3,34,19,15
2021,225502,10,5,11,6,5
2021,225502,10,6,4,0,4
2021,225502,20,0,71,42,29
2021,225502,20,1,35,21,14
2021,225502,20,2,36,21,15
2021,225502,30,0,37,21,16
2021,225502,30,2,3,2,1
2021,225502,30,3,34,19,15
2021,225502,40,0,15,6,9
2021,225502,40,5,11,6,5
2021,225502,40,6,4,0,4
2021,225502,42,0,15,6,9
2021,225502,42,5,11,6,5
2021,225502,42,6,4,0,4
2021,225502,50,0,9,2,7
2021,225511,0,0,1535,897,638
2021,225511,10,0,1358,839,519
2021,225511,10,1,444,336,108
2021,225511,10,2,371,214,157
2021,225511,10,3,223,128,95
2021,225511,10,4,1,1,0
2021,225511,10,5,82,38,44
2021,225511,10,6,237,122,115
2021,225511,20,0,802,541,261
2021,225511,20,1,441,334,107
2021,225511,20,2,361,207,154
2021,225511,30,0,237,138,99
2021,225511,30,1,3,2,1
2021,225511,30,2,10,7,3
2021,225511,30,3,223,128,95
2021,225511,30,4,1,1,0
2021,225511,40,0,319,160,159
2021,225511,40,5,82,38,44
2021,225511,40,6,237,122,115
2021,225511,41,0,74,41,33
2021,225511,41,5,1,0,1
2021,225511,41,6,73,41,32
2021,225511,42,0,212,101,111
2021,225511,42,5,52,22,30
2021,225511,42,6,160,79,81
2021,225511,43,0,33,18,15
2021,225511,43,5,29,16,13
2021,225511,43,6,4,2,2
2021,225511,44,0,74,41,33
2021,225511,44,5,1,0,1
2021,225511,44,6,73,41,32
2021,225511,50,0,177,58,119
2021,225520,0,0,98,45,53
2021,225520,10,0,98,45,53
2021,225520,10,1,7,5,2
2021,225520,10,2,33,16,17
2021,225520,10,3,19,8,11
2021,225520,10,4,39,16,23
2021,225520,40,0,98,45,53
2021,225520,40,1,7,5,2
2021,225520,40,2,33,16,17
2021,225520,40,3,19,8,11
2021,225520,40,4,39,16,23
2021,225520,42,0,98,45,53
2021,225520,42,1,7,5,2
2021,225520,42,2,33,16,17
2021,225520,42,3,19,8,11
2021,225520,42,4,39,16,23
2021,225548,0,0,57,36,21
2021,225548,10,0,57,36,21
2021,225548,10,1,21,16,5
2021,225548,10,2,15,10,5
2021,225548,10,3,13,6,7
2021,225548,10,4,8,4,4
2021,225548,40,0,57,36,21
2021,225548,40,1,21,16,5
2021,225548,40,2,15,10,5
2021,225548,40,3,13,6,7
2021,225548,40,4,8,4,4
2021,225548,42,0,57,36,21
2021,225548,42,1,21,16,5
2021,225548,42,2,15,10,5
2021,225548,42,3,13,6,7
2021,225548,42,4,8,4,4
2021,225575,0,0,43,21,22
2021,225575,10,0,43,21,22
2021,225575,10,1,9,4,5
2021,225575,10,2,13,5,8
2021,225575,10,3,15,10,5
2021,225575,10,4,3,0,3
2021,225575,10,5,3,2,1
2021,225575,20,0,14,7,7
2021,225575,20,1,8,3,5
2021,225575,20,2,6,4,2
2021,225575,30,0,22,11,11
2021,225575,30,2,7,1,6
2021,225575,30,3,15,10,5
2021,225575,40,0,7,3,4
2021,225575,40,1,1,1,0
2021,225575,40,4,3,0,3
2021,225575,40,5,3,2,1
2021,225575,42,0,7,3,4
2021,225575,42,1,1,1,0
2021,225575,42,4,3,0,3
2021,225575,42,5,3,2,1
2021,225627,0,0,344,155,189
2021,225627,10,0,344,155,189
2021,225627,10,1,88,45,43
2021,225627,10,2,112,53,59
2021,225627,10,3,106,44,62
2021,225627,10,4,38,13,25
2021,225627,20,0,167,82,85
2021,225627,20,1,73,36,37
2021,225627,20,2,88,41,47
2021,225627,20,3,6,5,1
2021,225627,30,0,68,30,38
2021,225627,30,1,3,3,0
2021,225627,30,2,4,2,2
2021,225627,30,3,60,25,35
2021,225627,30,4,1,0,1
2021,225627,40,0,109,43,66
2021,225627,40,1,12,6,6
2021,225627,40,2,20,10,10
2021,225627,40,3,40,14,26
2021,225627,40,4,37,13,24
2021,225627,42,0,109,43,66
2021,225627,42,1,12,6,6
2021,225627,42,2,20,10,10
2021,225627,42,3,40,14,26
2021,225627,42,4,37,13,24
2021,225876,0,0,6,2,4
2021,225876,10,0,6,2,4
2021,225876,10,4,6,2,4
2021,225876,40,0,6,2,4
2021,225876,40,4,6,2,4
2021,225876,41,0,6,2,4
2021,225876,41,4,6,2,4
2021,225876,45,0,6,2,4
2021,225876,45,4,6,2,4
2021,225885,0,0,34,20,14
2021,225885,10,0,34,20,14
2021,225885,10,1,3,2,1
2021,225885,10,2,7,7,0
2021,225885,10,3,24,11,13
2021,225885,20,0,5,4,1
2021,225885,20,1,2,1,1
2021,225885,20,2,2,2,0
2021,225885,20,3,1,1,0
2021,225885,30,0,9,4,5
2021,225885,30,2,2,2,0
2021,225885,30,3,7,2,5
2021,225885,40,0,20,12,8
2021,225885,40,1,1,1,0
2021,225885,40,2,3,3,0
2021,225885,40,3,16,8,8
2021,225885,42,0,20,12,8
2021,225885,42,1,1,1,0
2021,225885,42,2,3,3,0
2021,225885,42,3,16,8,8
2021,226019,0,0,138,61,77
2021,226019,10,0,138,61,77
2021,226019,10,4,138,61,77
2021,226019,40,0,138,61,77
2021,226019,40,4,138,61,77
2021,226019,42,0,33,17,16
2021,226019,42,4,33,17,16
2021,226019,43,0,105,44,61
2021,226019,43,4,105,44,61
2021,226091,0,0,419,212,207
2021,226091,10,0,419,212,207
2021,226091,10,1,79,55,24
2021,226091,10,2,109,62,47
2021,226091,10,3,83,43,40
2021,226091,10,4,148,52,96
2021,226091,20,0,182,113,69
2021,226091,20,1,76,53,23
2021,226091,20,2,99,57,42
2021,226091,20,3,7,3,4
2021,226091,30,0,76,39,37
2021,226091,30,1,1,1,0
2021,226091,30,2,9,4,5
2021,226091,30,3,63,33,30
2021,226091,30,4,3,1,2
2021,226091,40,0,161,60,101
2021,226091,40,1,2,1,1
2021,226091,40,2,1,1,0
2021,226091,40,3,13,7,6
2021,226091,40,4,145,51,94
2021,226091,42,0,94,35,59
2021,226091,42,1,1,1,0
2021,226091,42,2,1,1,0
2021,226091,42,3,10,6,4
2021,226091,42,4,82,27,55
2021,226091,43,0,67,25,42
2021,226091,43,1,1,0,1
2021,226091,43,3,3,1,2
2021,226091,43,4,63,24,39
2021,226107,0,0,41,15,26
2021,226107,10,0,41,15,26
2021,226107,10,1,1,1,0
2021,226107,10,2,1,0,1
2021,226107,10,3,7,4,3
2021,226107,10,4,30,9,21
2021,226107,10,5,2,1,1
2021,226107,20,0,13,6,7
2021,226107,20,1,1,1,0
2021,226107,20,2,1,0,1
2021,226107,20,3,5,3,2
2021,226107,20,4,6,2,4
2021,226107,30,0,4,2,2
2021,226107,30,3,2,1,1
2021,226107,30,4,2,1,1
2021,226107,40,0,24,7,17
2021,226107,40,4,22,6,16
2021,226107,40,5,2,1,1
2021,226107,42,0,21,6,15
2021,226107,42,4,20,6,14
2021,226107,42,5,1,0,1
2021,226107,43,0,3,1,2
2021,226107,43,4,2,0,2
2021,226107,43,5,1,1,0
2021,226116,0,0,62,25,37
2021,226116,10,0,62,25,37
2021,226116,10,1,1,0,1
2021,226116,10,2,1,1,0
2021,226116,10,3,3,1,2
2021,226116,10,4,57,23,34
2021,226116,20,0,26,8,18
2021,226116,20,1,1,0,1
2021,226116,20,2,1,1,0
2021,226116,20,3,2,0,2
2021,226116,20,4,22,7,15
2021,226116,30,0,32,13,19
2021,226116,30,3,1,1,0
2021,226116,30,4,31,12,19
2021,226116,40,0,4,4,0
2021,226116,40,4,4,4,0
2021,226116,42,0,3,3,0
2021,226116,42,4,3,3,0
2021,226116,43,0,1,1,0
2021,226116,43,4,1,1,0
2021,226134,0,0,163,86,77
2021,226134,10,0,163,86,77
2021,226134,10,1,96,52,44
2021,226134,10,2,13,7,6
2021,226134,10,3,27,14,13
2021,226134,10,4,27,13,14
2021,226134,20,0,109,59,50
2021,226134,20,1,96,52,44
2021,226134,20,2,13,7,6
2021,226134,30,0,34,17,17
2021,226134,30,3,27,14,13
2021,226134,30,4,7,3,4
2021,226134,40,0,20,10,10
2021,226134,40,4,20,10,10
2021,226134,42,0,18,8,10
2021,226134,42,4,18,8,10
2021,226134,43,0,2,2,0
2021,226134,43,4,2,2,0
2021,226152,0,0,249,130,119
2021,226152,10,0,249,130,119
2021,226152,10,1,28,24,4
2021,226152,10,2,66,38,28
2021,226152,10,3,107,43,64
2021,226152,10,4,42,22,20
2021,226152,10,5,6,3,3
2021,226152,20,0,61,44,17
2021,226152,20,1,24,20,4
2021,226152,20,2,37,24,13
2021,226152,30,0,88,46,42
2021,226152,30,1,1,1,0
2021,226152,30,2,21,11,10
2021,226152,30,3,66,34,32
2021,226152,40,0,100,40,60
2021,226152,40,1,3,3,0
2021,226152,40,2,8,3,5
2021,226152,40,3,41,9,32
2021,226152,40,4,42,22,20
2021,226152,40,5,6,3,3
2021,226152,42,0,100,40,60
2021,226152,42,1,3,3,0
2021,226152,42,2,8,3,5
2021,226152,42,3,41,9,32
2021,226152,42,4,42,22,20
2021,226152,42,5,6,3,3
2021,226204,0,0,164,83,81
2021,226204,10,0,164,83,81
2021,226204,10,6,164,83,81
2021,226204,40,0,164,83,81
2021,226204,40,6,164,83,81
2021,226204,41,0,74,39,35
2021,226204,41,6,74,39,35
2021,226204,42,0,90,44,46
2021,226204,42,6,90,44,46
2021,226204,44,0,71,39,32
2021,226204,44,6,71,39,32
2021,226204,45,0,3,0,3
2021,226204,45,6,3,0,3
2021,226231,0,0,100,79,21
2021,226231,10,0,78,61,17
2021,226231,10,1,30,25,5
2021,226231,10,2,24,19,5
2021,226231,10,3,20,14,6
2021,226231,10,4,3,2,1
2021,226231,10,5,1,1,0
2021,226231,20,0,41,34,7
2021,226231,20,1,27,23,4
2021,226231,20,2,13,10,3
2021,226231,20,3,1,1,0
2021,226231,30,0,35,25,10
2021,226231,30,1,3,2,1
2021,226231,30,2,11,9,2
2021,226231,30,3,18,12,6
2021,226231,30,4,3,2,1
2021,226231,40,0,2,2,0
2021,226231,40,3,1,1,0
2021,226231,40,5,1,1,0
2021,226231,43,0,2,2,0
2021,226231,43,3,1,1,0
2021,226231,43,5,1,1,0
2021,226231,50,0,22,18,4
2021,226277,0,0,71,66,5
2021,226277,10,0,71,66,5
2021,226277,10,4,71,66,5
2021,226277,40,0,71,66,5
2021,226277,40,4,71,66,5
2021,226277,41,0,71,66,5
2021,226277,41,4,71,66,5
2021,226277,45,0,71,66,5
2021,226277,45,4,71,66,5
2021,226383,0,0,84,43,41
2021,226383,10,0,84,43,41
2021,226383,10,1,27,15,12
2021,226383,10,2,26,17,9
2021,226383,10,3,23,8,15
2021,226383,10,4,5,2,3
2021,226383,10,5,1,0,1
2021,226383,10,6,2,1,1
2021,226383,20,0,50,25,25
2021,226383,20,1,25,14,11
2021,226383,20,2,20,11,9
2021,226383,20,3,5,0,5
2021,226383,30,0,15,8,7
2021,226383,30,2,3,3,0
2021,226383,30,3,12,5,7
2021,226383,40,0,19,10,9
2021,226383,40,1,2,1,1
2021,226383,40,2,3,3,0
2021,226383,40,3,6,3,3
2021,226383,40,4,5,2,3
2021,226383,40,5,1,0,1
2021,226383,40,6,2,1,1
2021,226383,42,0,6,4,2
2021,226383,42,1,2,1,1
2021,226383,42,2,2,2,0
2021,226383,42,3,1,0,1
2021,226383,42,6,1,1,0
2021,226383,43,0,13,6,7
2021,226383,43,2,1,1,0
2021,226383,43,3,5,3,2
2021,226383,43,4,5,2,3
2021,226383,43,5,1,0,1
2021,226383,43,6,1,0,1
2021,226408,0,0,112,50,62
2021,226408,10,0,112,50,62
2021,226408,10,1,16,11,5
2021,226408,10,2,24,13,11
2021,226408,10,3,72,26,46
2021,226408,20,0,53,25,28
2021,226408,20,1,16,11,5
2021,226408,20,2,18,9,9
2021,226408,20,3,19,5,14
2021,226408,40,0,59,25,34
2021,226408,40,2,6,4,2
2021,226408,40,3,53,21,32
2021,226408,41,0,39,17,22
2021,226408,41,2,6,4,2
2021,226408,41,3,33,13,20
2021,226408,42,0,20,8,12
2021,226408,42,3,20,8,12
2021,226408,44,0,37,17,20
2021,226408,44,2,6,4,2
2021,226408,44,3,31,13,18
2021,226408,45,0,2,0,2
2021,226408,45,3,2,0,2
2021,226471,0,0,172,74,98
2021,226471,10,0,172,74,98
2021,226471,10,1,59,30,29
2021,226471,10,2,32,17,15
2021,226471,10,3,70,24,46
2021,226471,10,4,11,3,8
2021,226471,20,0,73,40,33
2021,226471,20,1,51,26,25
2021,226471,20,2,22,14,8
2021,226471,30,0,61,25,36
2021,226471,30,1,6,3,3
2021,226471,30,2,9,3,6
2021,226471,30,3,46,19,27
2021,226471,40,0,38,9,29
2021,226471,40,1,2,1,1
2021,226471,40,2,1,0,1
2021,226471,40,3,24,5,19
2021,226471,40,4,11,3,8
2021,226471,42,0,38,9,29
2021,226471,42,1,2,1,1
2021,226471,42,2,1,0,1
2021,226471,42,3,24,5,19
2021,226471,42,4,11,3,8
2021,226578,0,0,201,69,132
2021,226578,10,0,201,69,132
2021,226578,10,1,112,37,75
2021,226578,10,2,59,21,38
2021,226578,10,3,25,9,16
2021,226578,10,4,5,2,3
2021,226578,20,0,112,37,75
2021,226578,20,1,112,37,75
2021,226578,30,0,59,21,38
2021,226578,30,2,59,21,38
2021,226578,40,0,30,11,19
2021,226578,40,3,25,9,16
2021,226578,40,4,5,2,3
2021,226578,42,0,25,9,16
2021,226578,42,3,25,9,16
2021,226578,43,0,5,2,3
2021,226578,43,4,5,2,3
2021,226587,0,0,76,45,31
2021,226587,10,0,76,45,31
2021,226587,10,1,30,23,7
2021,226587,10,2,13,7,6
2021,226587,10,3,16,10,6
2021,226587,10,4,17,5,12
2021,226587,20,0,43,30,13
2021,226587,20,1,30,23,7
2021,226587,20,2,13,7,6
2021,226587,30,0,12,8,4
2021,226587,30,3,12,8,4
2021,226587,40,0,21,7,14
2021,226587,40,3,4,2,2
2021,226587,40,4,17,5,12
2021,226587,42,0,21,7,14
2021,226587,42,3,4,2,2
2021,226587,42,4,17,5,12
2021,226806,0,0,137,64,73
2021,226806,10,0,132,61,71
2021,226806,10,1,41,20,21
2021,226806,10,2,51,24,27
2021,226806,10,3,11,5,6
2021,226806,10,4,29,12,17
2021,226806,40,0,132,61,71
2021,226806,40,1,41,20,21
2021,226806,40,2,51,24,27
2021,226806,40,3,11,5,6
2021,226806,40,4,29,12,17
2021,226806,42,0,132,61,71
2021,226806,42,1,41,20,21
2021,226806,42,2,51,24,27
2021,226806,42,3,11,5,6
2021,226806,42,4,29,12,17
2021,226806,50,0,5,3,2
2021,226833,0,0,229,106,123
2021,226833,10,0,229,106,123
2021,226833,10,1,44,30,14
2021,226833,10,2,74,36,38
2021,226833,10,3,83,29,54
2021,226833,10,4,20,8,12
2021,226833,10,5,7,3,4
2021,226833,10,6,1,0,1
2021,226833,20,0,119,67,52
2021,226833,20,1,44,30,14
2021,226833,20,2,70,34,36
2021,226833,20,3,5,3,2
2021,226833,30,0,53,24,29
2021,226833,30,2,3,1,2
2021,226833,30,3,50,23,27
2021,226833,40,0,57,15,42
2021,226833,40,2,1,1,0
2021,226833,40,3,28,3,25
2021,226833,40,4,20,8,12
2021,226833,40,5,7,3,4
2021,226833,40,6,1,0,1
2021,226833,42,0,51,14,37
2021,226833,42,2,1,1,0
2021,226833,42,3,24,3,21
2021,226833,42,4,20,8,12
2021,226833,42,5,5,2,3
2021,226833,42,6,1,0,1
2021,226833,43,0,6,1,5
2021,226833,43,3,4,0,4
2021,226833,43,5,2,1,1
2021,226879,0,0,6,5,1
2021,226879,10,0,6,5,1
2021,226879,10,1,6,5,1
2021,226879,40,0,6,5,1
2021,226879,40,1,6,5,1
2021,226879,43,0,6,5,1
2021,226879,43,1,6,5,1
2021,226903,0,0,123,64,59
2021,226903,10,0,123,64,59
2021,226903,10,4,123,64,59
2021,226903,40,0,123,64,59
2021,226903,40,4,123,64,59
2021,226903,41,0,123,64,59
2021,226903,41,4,123,64,59
2021,226903,45,0,123,64,59
2021,226903,45,4,123,64,59
2021,227146,0,0,112,31,81
2021,227146,10,0,110,29,81
2021,227146,10,1,14,6,8
2021,227146,10,2,83,20,63
2021,227146,10,3,13,3,10
2021,227146,40,0,110,29,81
2021,227146,40,1,14,6,8
2021,227146,40,2,83,20,63
2021,227146,40,3,13,3,10
2021,227146,42,0,110,29,81
2021,227146,42,1,14,6,8
2021,227146,42,2,83,20,63
2021,227146,42,3,13,3,10
2021,227146,50,0,2,2,0
2021,227182,0,0,862,382,480
2021,227182,10,0,862,382,480
2021,227182,10,1,667,291,376
2021,227182,10,2,105,33,72
2021,227182,10,3,36,14,22
2021,227182,10,4,54,44,10
2021,227182,40,0,862,382,480
2021,227182,40,1,667,291,376
2021,227182,40,2,105,33,72
2021,227182,40,3,36,14,22
2021,227182,40,4,54,44,10
2021,227182,41,0,700,303,397
2021,227182,41,1,663,291,372
2021,227182,41,2,37,12,25
2021,227182,42,0,157,75,82
2021,227182,42,1,4,0,4
2021,227182,42,2,68,21,47
2021,227182,42,3,34,12,22
2021,227182,42,4,51,42,9
2021,227182,43,0,5,4,1
2021,227182,43,3,2,2,0
2021,227182,43,4,3,2,1
2021,227182,44,0,700,303,397
2021,227182,44,1,663,291,372
2021,227182,44,2,37,12,25
2021,227216,0,0,1192,635,557
2021,227216,10,0,1171,628,543
2021,227216,10,1,328,223,105
2021,227216,10,2,240,138,102
2021,227216,10,3,219,111,108
2021,227216,10,4,50,20,30
2021,227216,10,5,319,133,186
2021,227216,10,6,15,3,12
2021,227216,20,0,562,359,203
2021,227216,20,1,328,223,105
2021,227216,20,2,233,135,98
2021,227216,20,3,1,1,0
2021,227216,30,0,225,113,112
2021,227216,30,2,7,3,4
2021,227216,30,3,218,110,108
2021,227216,40,0,384,156,228
2021,227216,40,4,50,20,30
2021,227216,40,5,319,133,186
2021,227216,40,6,15,3,12
2021,227216,41,0,271,113,158
2021,227216,41,4,2,1,1
2021,227216,41,5,269,112,157
2021,227216,42,0,53,21,32
2021,227216,42,5,50,21,29
2021,227216,42,6,3,0,3
2021,227216,43,0,60,22,38
2021,227216,43,4,48,19,29
2021,227216,43,6,12,3,9
2021,227216,44,0,271,113,158
2021,227216,44,4,2,1,1
2021,227216,44,5,269,112,157
2021,227216,50,0,21,7,14
2021,227225,0,0,69,26,43
2021,227225,10,0,69,26,43
2021,227225,10,1,39,18,21
2021,227225,10,2,5,1,4
2021,227225,10,3,4,0,4
2021,227225,10,4,21,7,14
2021,227225,40,0,69,26,43
2021,227225,40,1,39,18,21
2021,227225,40,2,5,1,4
2021,227225,40,3,4,0,4
2021,227225,40,4,21,7,14
2021,227225,42,0,69,26,43
2021,227225,42,1,39,18,21
2021,227225,42,2,5,1,4
2021,227225,42,3,4,0,4
2021,227225,42,4,21,7,14
2021,227289,0,0,21,13,8
2021,227289,10,0,18,12,6
2021,227289,10,1,10,8,2
2021,227289,10,2,3,1,2
2021,227289,10,3,4,3,1
2021,227289,10,4,1,0,1
2021,227289,40,0,18,12,6
2021,227289,40,1,10,8,2
2021,227289,40,2,3,1,2
2021,227289,40,3,4,3,1
2021,227289,40,4,1,0,1
2021,227289,41,0,17,11,6
2021,227289,41,1,9,7,2
2021,227289,41,2,3,1,2
2021,227289,41,3,4,3,1
2021,227289,41,4,1,0,1
2021,227289,42,0,1,1,0
2021,227289,42,1,1,1,0
2021,227289,44,0,17,11,6
2021,227289,44,1,9,7,2
2021,227289,44,2,3,1,2
2021,227289,44,3,4,3,1
2021,227289,44,4,1,0,1
2021,227289,50,0,3,1,2
2021,227304,0,0,108,53,55
2021,227304,10,0,108,53,55
2021,227304,10,1,15,10,5
2021,227304,10,2,40,19,21
2021,227304,10,3,14,6,8
2021,227304,10,4,39,18,21
2021,227304,20,0,6,3,3
2021,227304,20,1,3,2,1
2021,227304,20,3,1,0,1
2021,227304,20,4,2,1,1
2021,227304,40,0,102,50,52
2021,227304,40,1,12,8,4
2021,227304,40,2,40,19,21
2021,227304,40,3,13,6,7
2021,227304,40,4,37,17,20
2021,227304,42,0,102,50,52
2021,227304,42,1,12,8,4
2021,227304,42,2,40,19,21
2021,227304,42,3,13,6,7
2021,227304,42,4,37,17,20
2021,227331,0,0,101,31,70
2021,227331,10,0,101,31,70
2021,227331,10,1,26,6,20
2021,227331,10,2,25,8,17
2021,227331,10,3,43,15,28
2021,227331,10,4,6,1,5
2021,227331,10,5,1,1,0
2021,227331,20,0,40,11,29
2021,227331,20,1,24,6,18
2021,227331,20,2,16,5,11
2021,227331,30,0,30,9,21
2021,227331,30,1,1,0,1
2021,227331,30,2,5,2,3
2021,227331,30,3,23,6,17
2021,227331,30,4,1,1,0
2021,227331,40,0,31,11,20
2021,227331,40,1,1,0,1
2021,227331,40,2,4,1,3
2021,227331,40,3,20,9,11
2021,227331,40,4,5,0,5
2021,227331,40,5,1,1,0
2021,227331,41,0,1,1,0
2021,227331,41,2,1,1,0
2021,227331,42,0,30,10,20
2021,227331,42,1,1,0,1
2021,227331,42,2,3,0,3
2021,227331,42,3,20,9,11
2021,227331,42,4,5,0,5
2021,227331,42,5,1,1,0
2021,227331,44,0,1,1,0
2021,227331,44,2,1,1,0
2021,227368,0,0,1332,761,571
2021,227368,10,0,1332,761,571
2021,227368,10,1,288,213,75
2021,227368,10,2,245,150,95
2021,227368,10,3,276,156,120
2021,227368,10,4,1,0,1
2021,227368,10,5,522,242,280
2021,227368,20,0,509,346,163
2021,227368,20,1,283,208,75
2021,227368,20,2,226,138,88
2021,227368,30,0,192,110,82
2021,227368,30,2,2,2,0
2021,227368,30,3,190,108,82
2021,227368,40,0,631,305,326
2021,227368,40,1,5,5,0
2021,227368,40,2,17,10,7
2021,227368,40,3,86,48,38
2021,227368,40,4,1,0,1
2021,227368,40,5,522,242,280
2021,227368,41,0,519,245,274
2021,227368,41,1,5,5,0
2021,227368,41,2,17,10,7
2021,227368,41,3,86,48,38
2021,227368,41,4,1,0,1
2021,227368,41,5,410,182,228
2021,227368,42,0,112,60,52
2021,227368,42,5,112,60,52
2021,227368,44,0,519,245,274
2021,227368,44,1,5,5,0
2021,227368,44,2,17,10,7
2021,227368,44,3,86,48,38
2021,227368,44,4,1,0,1
2021,227368,44,5,410,182,228
2021,227377,0,0,99,48,51
2021,227377,10,0,97,47,50
2021,227377,10,6,97,47,50
2021,227377,40,0,97,47,50
2021,227377,40,6,97,47,50
2021,227377,42,0,97,47,50
2021,227377,42,6,97,47,50
2021,227377,50,0,2,1,1
2021,227386,0,0,66,24,42
2021,227386,10,0,66,24,42
2021,227386,10,1,51,18,33
2021,227386,10,4,15,6,9
2021,227386,40,0,66,24,42
2021,227386,40,1,51,18,33
2021,227386,40,4,15,6,9
2021,227386,42,0,66,24,42
2021,227386,42,1,51,18,33
2021,227386,42,4,15,6,9
2021,227401,0,0,77,42,35
2021,227401,10,0,77,42,35
2021,227401,10,6,77,42,35
2021,227401,40,0,77,42,35
2021,227401,40,6,77,42,35
2021,227401,42,0,77,42,35
2021,227401,42,6,77,42,35
2021,227429,0,0,15,7,8
2021,227429,10,0,15,7,8
2021,227429,10,2,8,4,4
2021,227429,10,3,1,1,0
2021,227429,10,4,1,0,1
2021,227429,10,5,5,2,3
2021,227429,40,0,15,7,8
2021,227429,40,2,8,4,4
2021,227429,40,3,1,1,0
2021,227429,40,4,1,0,1
2021,227429,40,5,5,2,3
2021,227429,42,0,3,0,3
2021,227429,42,2,2,0,2
2021,227429,42,4,1,0,1
2021,227429,43,0,12,7,5
2021,227429,43,2,6,4,2
2021,227429,43,3,1,1,0
2021,227429,43,5,5,2,3
2021,227526,0,0,424,248,176
2021,227526,10,0,412,241,171
2021,227526,10,1,77,58,19
2021,227526,10,2,67,43,24
2021,227526,10,3,115,61,54
2021,227526,10,4,1,1,0
2021,227526,10,5,152,78,74
2021,227526,20,0,138,97,41
2021,227526,20,1,76,57,19
2021,227526,20,2,62,40,22
2021,227526,30,0,122,66,56
2021,227526,30,1,1,1,0
2021,227526,30,2,5,3,2
2021,227526,30,3,115,61,54
2021,227526,30,4,1,1,0
2021,227526,40,0,152,78,74
2021,227526,40,5,152,78,74
2021,227526,41,0,5,5,0
2021,227526,41,5,5,5,0
2021,227526,42,0,10,5,5
2021,227526,42,5,10,5,5
2021,227526,43,0,137,68,69
2021,227526,43,5,137,68,69
2021,227526,44,0,5,5,0
2021,227526,44,5,5,5,0
2021,227526,50,0,12,7,5
2021,227687,0,0,38,14,24
2021,227687,10,0,38,14,24
2021,227687,10,1,1,1,0
2021,227687,10,2,3,1,2
2021,227687,10,3,3,2,1
2021,227687,10,4,31,10,21
2021,227687,20,0,1,1,0
2021,227687,20,1,1,1,0
2021,227687,40,0,37,13,24
2021,227687,40,2,3,1,2
2021,227687,40,3,3,2,1
2021,227687,40,4,31,10,21
2021,227687,42,0,25,9,16
2021,227687,42,2,2,1,1
2021,227687,42,3,3,2,1
2021,227687,42,4,20,6,14
2021,227687,43,0,12,4,8
2021,227687,43,2,1,0,1
2021,227687,43,4,11,4,7
2021,227757,0,0,700,451,249
2021,227757,10,0,700,451,249
2021,227757,10,1,302,227,75
2021,227757,10,2,110,71,39
2021,227757,10,3,130,75,55
2021,227757,10,4,15,11,4
2021,227757,10,5,142,66,76
2021,227757,10,6,1,1,0
2021,227757,20,0,412,298,114
2021,227757,20,1,302,227,75
2021,227757,20,2,110,71,39
2021,227757,30,0,130,75,55
2021,227757,30,3,130,75,55
2021,227757,40,0,158,78,80
2021,227757,40,4,15,11,4
2021,227757,40,5,142,66,76
2021,227757,40,6,1,1,0
2021,227757,41,0,134,63,71
2021,227757,41,4,13,10,3
2021,227757,41,5,120,52,68
2021,227757,41,6,1,1,0
2021,227757,42,0,24,15,9
2021,227757,42,4,2,1,1
2021,227757,42,5,22,14,8
2021,227757,44,0,134,63,71
2021,227757,44,4,13,10,3
2021,227757,44,5,120,52,68
2021,227757,44,6,1,1,0
2021,227845,0,0,160,73,87
2021,227845,10,0,160,73,87
2021,227845,10,1,47,21,26
2021,227845,10,2,53,20,33
2021,227845,10,3,53,30,23
2021,227845,10,4,2,1,1
2021,227845,10,5,5,1,4
2021,227845,20,0,84,35,49
2021,227845,20,1,46,21,25
2021,227845,20,2,38,14,24
2021,227845,30,0,56,28,28
2021,227845,30,2,15,6,9
2021,227845,30,3,41,22,19
2021,227845,40,0,20,10,10
2021,227845,40,1,1,0,1
2021,227845,40,3,12,8,4
2021,227845,40,4,2,1,1
2021,227845,40,5,5,1,4
2021,227845,42,0,20,10,10
2021,227845,42,1,1,0,1
2021,227845,42,3,12,8,4
2021,227845,42,4,2,1,1
2021,227845,42,5,5,1,4
2021,227854,0,0,241,128,113
2021,227854,10,0,199,104,95
2021,227854,10,1,12,6,6
2021,227854,10,2,28,14,14
2021,227854,10,3,61,31,30
2021,227854,10,4,98,53,45
2021,227854,20,0,55,29,26
2021,227854,20,1,11,5,6
2021,227854,20,2,16,10,6
2021,227854,20,3,16,11,5
2021,227854,20,4,12,3,9
2021,227854,40,0,144,75,69
2021,227854,40,1,1,1,0
2021,227854,40,2,12,4,8
2021,227854,40,3,45,20,25
2021,227854,40,4,86,50,36
2021,227854,42,0,144,75,69
2021,227854,42,1,1,1,0
2021,227854,42,2,12,4,8
2021,227854,42,3,45,20,25
2021,227854,42,4,86,50,36
2021,227854,50,0,42,24,18
2021,227863,0,0,139,75,64
2021,227863,10,0,139,75,64
2021,227863,10,1,28,16,12
2021,227863,10,2,53,33,20
2021,227863,10,3,47,23,24
2021,227863,10,4,9,3,6
2021,227863,10,5,1,0,1
2021,227863,10,6,1,0,1
2021,227863,20,0,70,44,26
2021,227863,20,1,25,16,9
2021,227863,20,2,43,27,16
2021,227863,20,3,2,1,1
2021,227863,30,0,11,6,5
2021,227863,30,2,4,1,3
2021,227863,30,3,7,5,2
2021,227863,40,0,58,25,33
2021,227863,40,1,3,0,3
2021,227863,40,2,6,5,1
2021,227863,40,3,38,17,21
2021,227863,40,4,9,3,6
2021,227863,40,5,1,0,1
2021,227863,40,6,1,0,1
2021,227863,42,0,58,25,33
2021,227863,42,1,3,0,3
2021,227863,42,2,6,5,1
2021,227863,42,3,38,17,21
2021,227863,42,4,9,3,6
2021,227863,42,5,1,0,1
2021,227863,42,6,1,0,1
2021,227881,0,0,823,396,427
2021,227881,10,0,823,396,427
2021,227881,10,1,189,123,66
2021,227881,10,2,181,104,77
2021,227881,10,3,186,79,107
2021,227881,10,4,1,0,1
2021,227881,10,5,266,90,176
2021,227881,20,0,363,219,144
2021,227881,20,1,188,122,66
2021,227881,20,2,170,96,74
2021,227881,20,3,4,1,3
2021,227881,20,4,1,0,1
2021,227881,30,0,194,87,107
2021,227881,30,1,1,1,0
2021,227881,30,2,11,8,3
2021,227881,30,3,182,78,104
2021,227881,40,0,266,90,176
2021,227881,40,5,266,90,176
2021,227881,42,0,193,68,125
2021,227881,42,5,193,68,125
2021,227881,43,0,73,22,51
2021,227881,43,5,73,22,51
2021,227924,0,0,277,123,154
2021,227924,10,0,240,110,130
2021,227924,10,1,82,35,47
2021,227924,10,2,28,14,14
2021,227924,10,3,58,24,34
2021,227924,10,4,72,37,35
2021,227924,20,0,148,65,83
2021,227924,20,1,81,35,46
2021,227924,20,2,26,14,12
2021,227924,20,3,25,10,15
2021,227924,20,4,16,6,10
2021,227924,40,0,92,45,47
2021,227924,40,1,1,0,1
2021,227924,40,2,2,0,2
2021,227924,40,3,33,14,19
2021,227924,40,4,56,31,25
2021,227924,42,0,92,45,47
2021,227924,42,1,1,0,1
2021,227924,42,2,2,0,2
2021,227924,42,3,33,14,19
2021,227924,42,4,56,31,25
2021,227924,50,0,37,13,24
2021,227979,0,0,502,221,281
2021,227979,10,0,502,221,281
2021,227979,10,6,502,221,281
2021,227979,40,0,502,221,281
2021,227979,40,6,502,221,281
2021,227979,42,0,502,221,281
2021,227979,42,6,502,221,281
2021,228042,0,0,52,29,23
2021,228042,10,0,52,29,23
2021,228042,10,1,10,5,5
2021,228042,10,2,14,8,6
2021,228042,10,3,21,13,8
2021,228042,10,4,7,3,4
2021,228042,20,0,22,13,9
2021,228042,20,1,9,5,4
2021,228042,20,2,13,8,5
2021,228042,30,0,21,12,9
2021,228042,30,1,1,0,1
2021,228042,30,2,1,0,1
2021,228042,30,3,19,12,7
2021,228042,40,0,9,4,5
2021,228042,40,3,2,1,1
2021,228042,40,4,7,3,4
2021,228042,42,0,8,4,4
2021,228042,42,3,1,1,0
2021,228042,42,4,7,3,4
2021,228042,43,0,1,0,1
2021,228042,43,3,1,0,1
2021,228149,0,0,210,129,81
2021,228149,10,0,210,129,81
2021,228149,10,1,87,61,26
2021,228149,10,2,55,33,22
2021,228149,10,3,38,21,17
2021,228149,10,4,27,14,13
2021,228149,10,5,3,0,3
2021,228149,20,0,135,93,42
2021,228149,20,1,79,59,20
2021,228149,20,2,54,32,22
2021,228149,20,3,2,2,0
2021,228149,30,0,23,11,12
2021,228149,30,3,23,11,12
2021,228149,40,0,52,25,27
2021,228149,40,1,8,2,6
2021,228149,40,2,1,1,0
2021,228149,40,3,13,8,5
2021,228149,40,4,27,14,13
2021,228149,40,5,3,0,3
2021,228149,41,0,12,5,7
2021,228149,41,1,8,2,6
2021,228149,41,3,1,1,0
2021,228149,41,4,3,2,1
2021,228149,42,0,38,18,20
2021,228149,42,2,1,1,0
2021,228149,42,3,11,6,5
2021,228149,42,4,23,11,12
2021,228149,42,5,3,0,3
2021,228149,43,0,2,2,0
2021,228149,43,3,1,1,0
2021,228149,43,4,1,1,0
2021,228149,44,0,12,5,7
2021,228149,44,1,8,2,6
2021,228149,44,3,1,1,0
2021,228149,44,4,3,2,1
2021,228158,0,0,258,124,134
2021,228158,10,0,258,124,134
2021,228158,10,1,52,30,22
2021,228158,10,2,38,19,19
2021,228158,10,3,82,38,44
2021,228158,10,4,86,37,49
2021,228158,20,0,170,89,81
2021,228158,20,1,51,30,21
2021,228158,20,2,37,18,19
2021,228158,20,3,69,34,35
2021,228158,20,4,13,7,6
2021,228158,30,0,88,35,53
2021,228158,30,1,1,0,1
2021,228158,30,2,1,1,0
2021,228158,30,3,13,4,9
2021,228158,30,4,73,30,43
2021,228194,0,0,51,30,21
2021,228194,10,0,51,30,21
2021,228194,10,1,45,28,17
2021,228194,10,2,2,0,2
2021,228194,10,3,4,2,2
2021,228194,20,0,45,28,17
2021,228194,20,1,45,28,17
2021,228194,30,0,4,2,2
2021,228194,30,3,4,2,2
2021,228194,40,0,2,0,2
2021,228194,40,2,2,0,2
2021,228194,42,0,2,0,2
2021,228194,42,2,2,0,2
2021,228246,0,0,723,421,302
2021,228246,10,0,723,421,302
2021,228246,10,1,209,159,50
2021,228246,10,2,143,93,50
2021,228246,10,3,92,47,45
2021,228246,10,4,131,69,62
2021,228246,10,5,141,48,93
2021,228246,10,6,7,5,2
2021,228246,20,0,351,250,101
2021,228246,20,1,209,159,50
2021,228246,20,2,141,91,50
2021,228246,20,3,1,0,1
2021,228246,30,0,93,49,44
2021,228246,30,2,2,2,0
2021,228246,30,3,91,47,44
2021,228246,40,0,279,122,157
2021,228246,40,4,131,69,62
2021,228246,40,5,141,48,93
2021,228246,40,6,7,5,2
2021,228246,41,0,218,89,129
2021,228246,41,4,98,48,50
2021,228246,41,5,116,38,78
2021,228246,41,6,4,3,1
2021,228246,42,0,60,33,27
2021,228246,42,4,32,21,11
2021,228246,42,5,25,10,15
2021,228246,42,6,3,2,1
2021,228246,43,0,1,0,1
2021,228246,43,4,1,0,1
2021,228246,44,0,218,89,129
2021,228246,44,4,98,48,50
2021,228246,44,5,116,38,78
2021,228246,44,6,4,3,1
2021,228316,0,0,122,59,63
2021,228316,10,0,120,57,63
2021,228316,10,1,5,2,3
2021,228316,10,2,1,1,0
2021,228316,10,3,7,3,4
2021,228316,10,4,106,50,56
2021,228316,10,6,1,1,0
2021,228316,20,0,12,6,6
2021,228316,20,1,5,2,3
2021,228316,20,2,1,1,0
2021,228316,20,3,2,0,2
2021,228316,20,4,4,3,1
2021,228316,30,0,20,10,10
2021,228316,30,3,5,3,2
2021,228316,30,4,14,6,8
2021,228316,30,6,1,1,0
2021,228316,40,0,88,41,47
2021,228316,40,4,88,41,47
2021,228316,42,0,88,41,47
2021,228316,42,4,88,41,47
2021,228316,50,0,2,2,0
2021,228325,0,0,69,44,25
2021,228325,10,0,69,44,25
2021,228325,10,1,26,17,9
2021,228325,10,2,12,8,4
2021,228325,10,3,16,9,7
2021,228325,10,4,15,10,5
2021,228325,40,0,69,44,25
2021,228325,40,1,26,17,9
2021,228325,40,2,12,8,4
2021,228325,40,3,16,9,7
2021,228325,40,4,15,10,5
2021,228325,41,0,8,7,1
2021,228325,41,1,3,2,1
2021,228325,41,2,2,2,0
2021,228325,41,3,1,1,0
2021,228325,41,4,2,2,0
2021,228325,42,0,61,37,24
2021,228325,42,1,23,15,8
2021,228325,42,2,10,6,4
2021,228325,42,3,15,8,7
2021,228325,42,4,13,8,5
2021,228325,45,0,8,7,1
2021,228325,45,1,3,2,1
2021,228325,45,2,2,2,0
2021,228325,45,3,1,1,0
2021,228325,45,4,2,2,0
2021,228343,0,0,116,49,67
2021,228343,10,0,116,49,67
2021,228343,10,1,43,19,24
2021,228343,10,2,32,18,14
2021,228343,10,3,21,6,15
2021,228343,10,4,20,6,14
2021,228343,20,0,75,37,38
2021,228343,20,1,43,19,24
2021,228343,20,2,32,18,14
2021,228343,30,0,21,6,15
2021,228343,30,3,21,6,15
2021,228343,40,0,20,6,14
2021,228343,40,4,20,6,14
2021,228343,41,0,15,5,10
2021,228343,41,4,15,5,10
2021,228343,42,0,5,1,4
2021,228343,42,4,5,1,4
2021,228343,44,0,5,2,3
2021,228343,44,4,5,2,3
2021,228343,45,0,10,3,7
2021,228343,45,4,10,3,7
2021,228431,0,0,475,236,239
2021,228431,10,0,475,236,239
2021,228431,10,1,109,75,34
2021,228431,10,2,140,77,63
2021,228431,10,3,109,52,57
2021,228431,10,4,39,6,33
2021,228431,10,5,65,23,42
2021,228431,10,6,13,3,10
2021,228431,20,0,261,160,101
2021,228431,20,1,109,75,34
2021,228431,20,2,133,75,58
2021,228431,20,3,15,9,6
2021,228431,20,4,2,1,1
2021,228431,20,5,2,0,2
2021,228431,30,0,99,45,54
2021,228431,30,2,7,2,5
2021,228431,30,3,90,41,49
2021,228431,30,4,2,2,0
2021,228431,40,0,115,31,84
2021,228431,40,3,4,2,2
2021,228431,40,4,35,3,32
2021,228431,40,5,63,23,40
2021,228431,40,6,13,3,10
2021,228431,42,0,42,10,32
2021,228431,42,3,1,0,1
2021,228431,42,4,15,1,14
2021,228431,42,5,24,9,15
2021,228431,42,6,2,0,2
2021,228431,43,0,73,21,52
2021,228431,43,3,3,2,1
2021,228431,43,4,20,2,18
2021,228431,43,5,39,14,25
2021,228431,43,6,11,3,8
2021,228459,0,0,1279,642,637
2021,228459,10,0,1260,630,630
2021,228459,10,1,278,170,108
2021,228459,10,2,263,137,126
2021,228459,10,3,238,108,130
2021,228459,10,5,480,214,266
2021,228459,10,6,1,1,0
2021,228459,20,0,510,290,220
2021,228459,20,1,267,161,106
2021,228459,20,2,239,127,112
2021,228459,20,3,4,2,2
2021,228459,30,0,204,95,109
2021,228459,30,1,1,1,0
2021,228459,30,2,3,2,1
2021,228459,30,3,200,92,108
2021,228459,40,0,546,245,301
2021,228459,40,1,10,8,2
2021,228459,40,2,21,8,13
2021,228459,40,3,34,14,20
2021,228459,40,5,480,214,266
2021,228459,40,6,1,1,0
2021,228459,41,0,280,116,164
2021,228459,41,1,8,6,2
2021,228459,41,2,21,8,13
2021,228459,41,3,17,4,13
2021,228459,41,5,234,98,136
2021,228459,42,0,266,129,137
2021,228459,42,1,2,2,0
2021,228459,42,3,17,10,7
2021,228459,42,5,246,116,130
2021,228459,42,6,1,1,0
2021,228459,44,0,280,116,164
2021,228459,44,1,8,6,2
2021,228459,44,2,21,8,13
2021,228459,44,3,17,4,13
2021,228459,44,5,234,98,136
2021,228459,50,0,19,12,7
2021,228468,0,0,46,25,21
2021,228468,10,0,46,25,21
2021,228468,10,1,12,9,3
2021,228468,10,2,14,9,5
2021,228468,10,3,19,6,13
2021,228468,10,6,1,1,0
2021,228468,20,0,17,13,4
2021,228468,20,1,11,9,2
2021,228468,20,2,4,2,2
2021,228468,20,3,1,1,0
2021,228468,20,6,1,1,0
2021,228468,30,0,29,12,17
2021,228468,30,1,1,0,1
2021,228468,30,2,10,7,3
2021,228468,30,3,18,5,13
2021,228486,0,0,9,5,4
2021,228486,10,0,9,5,4
2021,228486,10,4,9,5,4
2021,228486,40,0,9,5,4
2021,228486,40,4,9,5,4
2021,228486,42,0,9,5,4
2021,228486,42,4,9,5,4
2021,228501,0,0,84,46,38
2021,228501,10,0,84,46,38
2021,228501,10,1,25,16,9
2021,228501,10,2,14,9,5
2021,228501,10,3,29,15,14
2021,228501,10,4,4,1,3
2021,228501,10,5,9,5,4
2021,228501,10,6,3,0,3
2021,228501,20,0,49,29,20
2021,228501,20,1,25,16,9
2021,228501,20,2,11,7,4
2021,228501,20,3,12,6,6
2021,228501,20,4,1,0,1
2021,228501,30,0,25,13,12
2021,228501,30,2,3,2,1
2021,228501,30,3,16,9,7
2021,228501,30,4,3,1,2
2021,228501,30,5,1,1,0
2021,228501,30,6,2,0,2
2021,228501,40,0,10,4,6
2021,228501,40,3,1,0,1
2021,228501,40,5,8,4,4
2021,228501,40,6,1,0,1
2021,228501,42,0,6,2,4
2021,228501,42,3,1,0,1
2021,228501,42,5,5,2,3
2021,228501,43,0,4,2,2
2021,228501,43,5,3,2,1
2021,228501,43,6,1,0,1
2021,228529,0,0,434,225,209
2021,228529,10,0,428,224,204
2021,228529,10,1,78,57,21
2021,228529,10,2,124,66,58
2021,228529,10,3,126,64,62
2021,228529,10,4,100,37,63
2021,228529,20,0,186,117,69
2021,228529,20,1,73,56,17
2021,228529,20,2,112,61,51
2021,228529,20,4,1,0,1
2021,228529,30,0,93,52,41
2021,228529,30,1,2,1,1
2021,228529,30,2,4,3,1
2021,228529,30,3,85,47,38
2021,228529,30,4,2,1,1
2021,228529,40,0,149,55,94
2021,228529,40,1,3,0,3
2021,228529,40,2,8,2,6
2021,228529,40,3,41,17,24
2021,228529,40,4,97,36,61
2021,228529,41,0,53,20,33
2021,228529,41,1,3,0,3
2021,228529,41,2,8,2,6
2021,228529,41,3,41,17,24
2021,228529,41,4,1,1,0
2021,228529,42,0,96,35,61
2021,228529,42,4,96,35,61
2021,228529,45,0,53,20,33
2021,228529,45,1,3,0,3
2021,228529,45,2,8,2,6
2021,228529,45,3,41,17,24
2021,228529,45,4,1,1,0
2021,228529,50,0,6,1,5
2021,228547,0,0,616,262,354
2021,228547,10,0,616,262,354
2021,228547,10,1,114,59,55
2021,228547,10,2,111,41,70
2021,228547,10,3,107,31,76
2021,228547,10,4,284,131,153
2021,228547,20,0,240,101,139
2021,228547,20,1,108,56,52
2021,228547,20,2,65,25,40
2021,228547,20,3,66,20,46
2021,228547,20,4,1,0,1
2021,228547,30,0,362,157,205
2021,228547,30,1,6,3,3
2021,228547,30,2,46,16,30
2021,228547,30,3,41,11,30
2021,228547,30,4,269,127,142
2021,228547,40,0,14,4,10
2021,228547,40,4,14,4,10
2021,228547,42,0,14,4,10
2021,228547,42,4,14,4,10
2021,228608,0,0,133,57,76
2021,228608,10,0,132,57,75
2021,228608,10,1,45,20,25
2021,228608,10,2,30,13,17
2021,228608,10,3,57,24,33
2021,228608,20,0,70,34,36
2021,228608,20,1,42,20,22
2021,228608,20,2,22,10,12
2021,228608,20,3,6,4,2
2021,228608,30,0,62,23,39
2021,228608,30,1,3,0,3
2021,228608,30,2,8,3,5
2021,228608,30,3,51,20,31
2021,228608,50,0,1,0,1
2021,228635,0,0,1908,1063,845
2021,228635,10,0,1908,1063,845
2021,228635,10,1,412,302,110
2021,228635,10,2,444,266,178
2021,228635,10,3,1021,481,540
2021,228635,10,4,31,14,17
2021,228635,20,0,146,118,28
2021,228635,20,1,128,104,24
2021,228635,20,2,18,14,4
2021,228635,30,0,50,33,17
2021,228635,30,2,4,3,1
2021,228635,30,3,46,30,16
2021,228635,40,0,1712,912,800
2021,228635,40,1,284,198,86
2021,228635,40,2,422,249,173
2021,228635,40,3,975,451,524
2021,228635,40,4,31,14,17
2021,228635,42,0,1712,912,800
2021,228635,42,1,284,198,86
2021,228635,42,2,422,249,173
2021,228635,42,3,975,451,524
2021,228635,42,4,31,14,17
2021,228644,0,0,816,428,388
2021,228644,10,0,816,428,388
2021,228644,10,1,214,147,67
2021,228644,10,2,212,117,95
2021,228644,10,3,334,137,197
2021,228644,10,4,7,5,2
2021,228644,10,5,1,0,1
2021,228644,10,6,48,22,26
2021,228644,20,0,207,133,74
2021,228644,20,1,145,103,42
2021,228644,20,2,61,29,32
2021,228644,20,3,1,1,0
2021,228644,30,0,72,36,36
2021,228644,30,1,3,2,1
2021,228644,30,2,17,13,4
2021,228644,30,3,51,21,30
2021,228644,30,6,1,0,1
2021,228644,40,0,537,259,278
2021,228644,40,1,66,42,24
2021,228644,40,2,134,75,59
2021,228644,40,3,282,115,167
2021,228644,40,4,7,5,2
2021,228644,40,5,1,0,1
2021,228644,40,6,47,22,25
2021,228644,42,0,535,258,277
2021,228644,42,1,66,42,24
2021,228644,42,2,134,75,59
2021,228644,42,3,280,114,166
2021,228644,42,4,7,5,2
2021,228644,42,5,1,0,1
2021,228644,42,6,47,22,25
2021,228644,43,0,2,1,1
2021,228644,43,3,2,1,1
2021,228653,0,0,617,313,304
2021,228653,10,0,617,313,304
2021,228653,10,1,186,122,64
2021,228653,10,2,151,76,75
2021,228653,10,3,276,113,163
2021,228653,10,4,3,1,2
2021,228653,10,6,1,1,0
2021,228653,20,0,173,112,61
2021,228653,20,1,136,95,41
2021,228653,20,2,37,17,20
2021,228653,30,0,71,38,33
2021,228653,30,1,5,3,2
2021,228653,30,2,26,16,10
2021,228653,30,3,40,19,21
2021,228653,40,0,373,163,210
2021,228653,40,1,45,24,21
2021,228653,40,2,88,43,45
2021,228653,40,3,236,94,142
2021,228653,40,4,3,1,2
2021,228653,40,6,1,1,0
2021,228653,42,0,373,163,210
2021,228653,42,1,45,24,21
2021,228653,42,2,88,43,45
2021,228653,42,3,236,94,142
2021,228653,42,4,3,1,2
2021,228653,42,6,1,1,0
2021,228699,0,0,97,35,62
2021,228699,10,0,87,30,57
2021,228699,10,1,22,10,12
2021,228699,10,2,29,7,22
2021,228699,10,3,24,4,20
2021,228699,10,4,12,9,3
2021,228699,20,0,31,12,19
2021,228699,20,1,18,8,10
2021,228699,20,2,13,4,9
2021,228699,40,0,56,18,38
2021,228699,40,1,4,2,2
2021,228699,40,2,16,3,13
2021,228699,40,3,24,4,20
2021,228699,40,4,12,9,3
2021,228699,42,0,56,18,38
2021,228699,42,1,4,2,2
2021,228699,42,2,16,3,13
2021,228699,42,3,24,4,20
2021,228699,42,4,12,9,3
2021,228699,50,0,10,5,5
2021,228705,0,0,314,203,111
2021,228705,10,0,291,189,102
2021,228705,10,1,98,74,24
2021,228705,10,2,96,66,30
2021,228705,10,3,52,32,20
2021,228705,10,4,12,3,9
2021,228705,10,5,33,14,19
2021,228705,20,0,155,112,43
2021,228705,20,1,91,68,23
2021,228705,20,2,62,43,19
2021,228705,20,3,2,1,1
2021,228705,30,0,50,32,18
2021,228705,30,2,21,16,5
2021,228705,30,3,26,16,10
2021,228705,30,4,3,0,3
2021,228705,40,0,86,45,41
2021,228705,40,1,7,6,1
2021,228705,40,2,13,7,6
2021,228705,40,3,24,15,9
2021,228705,40,4,9,3,6
2021,228705,40,5,33,14,19
2021,228705,41,0,86,45,41
2021,228705,41,1,7,6,1
2021,228705,41,2,13,7,6
2021,228705,41,3,24,15,9
2021,228705,41,4,9,3,6
2021,228705,41,5,33,14,19
2021,228705,45,0,86,45,41
2021,228705,45,1,7,6,1
2021,228705,45,2,13,7,6
2021,228705,45,3,24,15,9
2021,228705,45,4,9,3,6
2021,228705,45,5,33,14,19
2021,228705,50,0,23,14,9
2021,228723,0,0,3229,2036,1193
2021,228723,10,0,3229,2036,1193
2021,228723,10,1,1173,911,262
2021,228723,10,2,703,432,271
2021,228723,10,3,666,335,331
2021,228723,10,4,439,246,193
2021,228723,10,5,248,112,136
2021,228723,20,0,1559,1141,418
2021,228723,20,1,1017,792,225
2021,228723,20,2,537,345,192
2021,228723,20,3,4,3,1
2021,228723,20,4,1,1,0
2021,228723,30,0,458,261,197
2021,228723,30,1,12,10,2
2021,228723,30,2,43,27,16
2021,228723,30,3,403,224,179
2021,228723,40,0,1212,634,578
2021,228723,40,1,144,109,35
2021,228723,40,2,123,60,63
2021,228723,40,3,259,108,151
2021,228723,40,4,438,245,193
2021,228723,40,5,248,112,136
2021,228723,41,0,91,53,38
2021,228723,41,1,13,10,3
2021,228723,41,2,12,5,7
2021,228723,41,3,19,13,6
2021,228723,41,4,40,25,15
2021,228723,41,5,7,0,7
2021,228723,42,0,1080,559,521
2021,228723,42,1,128,97,31
2021,228723,42,2,101,51,50
2021,228723,42,3,232,90,142
2021,228723,42,4,384,212,172
2021,228723,42,5,235,109,126
2021,228723,43,0,41,22,19
2021,228723,43,1,3,2,1
2021,228723,43,2,10,4,6
2021,228723,43,3,8,5,3
2021,228723,43,4,14,8,6
2021,228723,43,5,6,3,3
2021,228723,44,0,91,53,38
2021,228723,44,1,13,10,3
2021,228723,44,2,12,5,7
2021,228723,44,3,19,13,6
2021,228723,44,4,40,25,15
2021,228723,44,5,7,0,7
2021,228769,0,0,1061,553,508
2021,228769,10,0,1061,553,508
2021,228769,10,1,238,183,55
2021,228769,10,2,205,127,78
2021,228769,10,3,185,88,97
2021,228769,10,5,182,85,97
2021,228769,10,6,251,70,181
2021,228769,20,0,443,310,133
2021,228769,20,1,238,183,55
2021,228769,20,2,205,127,78
2021,228769,30,0,185,88,97
2021,228769,30,3,185,88,97
2021,228769,40,0,433,155,278
2021,228769,40,5,182,85,97
2021,228769,40,6,251,70,181
2021,228769,42,0,182,85,97
2021,228769,42,5,182,85,97
2021,228769,43,0,251,70,181
2021,228769,43,6,251,70,181
2021,228778,0,0,2861,1614,1247
2021,228778,10,0,2861,1614,1247
2021,228778,10,1,992,696,296
2021,228778,10,2,500,282,218
2021,228778,10,3,407,213,194
2021,228778,10,4,35,16,19
2021,228778,10,5,882,391,491
2021,228778,10,6,45,16,29
2021,228778,20,0,1483,973,510
2021,228778,20,1,990,695,295
2021,228778,20,2,493,278,215
2021,228778,30,0,416,218,198
2021,228778,30,1,2,1,1
2021,228778,30,2,7,4,3
2021,228778,30,3,407,213,194
2021,228778,40,0,962,423,539
2021,228778,40,4,35,16,19
2021,228778,40,5,882,391,491
2021,228778,40,6,45,16,29
2021,228778,41,0,373,173,200
2021,228778,41,4,15,11,4
2021,228778,41,5,358,162,196
2021,228778,42,0,568,243,325
2021,228778,42,4,20,5,15
2021,228778,42,5,504,222,282
2021,228778,42,6,44,16,28
2021,228778,43,0,21,7,14
2021,228778,43,5,20,7,13
2021,228778,43,6,1,0,1
2021,228778,44,0,373,173,200
2021,228778,44,4,15,11,4
2021,228778,44,5,358,162,196
2021,228787,0,0,903,586,317
2021,228787,10,0,903,586,317
2021,228787,10,1,260,214,46
2021,228787,10,2,148,109,39
2021,228787,10,3,135,78,57
2021,228787,10,5,360,185,175
2021,228787,20,0,404,320,84
2021,228787,20,1,259,213,46
2021,228787,20,2,145,107,38
2021,228787,30,0,139,81,58
2021,228787,30,1,1,1,0
2021,228787,30,2,3,2,1
2021,228787,30,3,135,78,57
2021,228787,40,0,360,185,175
2021,228787,40,5,360,185,175
2021,228787,42,0,358,184,174
2021,228787,42,5,358,184,174
2021,228787,43,0,2,1,1
2021,228787,43,5,2,1,1
2021,228796,0,0,745,413,332
2021,228796,10,0,745,413,332
2021,228796,10,1,155,124,31
2021,228796,10,2,174,110,64
2021,228796,10,3,132,70,62
2021,228796,10,5,284,109,175
2021,228796,20,0,326,231,95
2021,228796,20,1,155,124,31
2021,228796,20,2,171,107,64
2021,228796,30,0,135,73,62
2021,228796,30,2,3,3,0
2021,228796,30,3,132,70,62
2021,228796,40,0,284,109,175
2021,228796,40,5,284,109,175
2021,228796,42,0,280,108,172
2021,228796,42,5,280,108,172
2021,228796,43,0,4,1,3
2021,228796,43,5,4,1,3
2021,228802,0,0,413,193,220
2021,228802,10,0,413,193,220
2021,228802,10,1,79,56,23
2021,228802,10,2,113,61,52
2021,228802,10,3,79,42,37
2021,228802,10,4,83,11,72
2021,228802,10,5,59,23,36
2021,228802,20,0,166,105,61
2021,228802,20,1,74,53,21
2021,228802,20,2,92,52,40
2021,228802,30,0,85,45,40
2021,228802,30,1,5,3,2
2021,228802,30,2,13,8,5
2021,228802,30,3,67,34,33
2021,228802,40,0,162,43,119
2021,228802,40,2,8,1,7
2021,228802,40,3,12,8,4
2021,228802,40,4,83,11,72
2021,228802,40,5,59,23,36
2021,228802,42,0,159,43,116
2021,228802,42,2,8,1,7
2021,228802,42,3,12,8,4
2021,228802,42,4,81,11,70
2021,228802,42,5,58,23,35
2021,228802,43,0,3,0,3
2021,228802,43,4,2,0,2
2021,228802,43,5,1,0,1
2021,228866,0,0,21,13,8
2021,228866,10,0,21,13,8
2021,228866,10,1,9,5,4
2021,228866,10,2,4,3,1
2021,228866,10,3,6,5,1
2021,228866,10,4,2,0,2
2021,228866,40,0,21,13,8
2021,228866,40,1,9,5,4
2021,228866,40,2,4,3,1
2021,228866,40,3,6,5,1
2021,228866,40,4,2,0,2
2021,228866,42,0,21,13,8
2021,228866,42,1,9,5,4
2021,228866,42,2,4,3,1
2021,228866,42,3,6,5,1
2021,228866,42,4,2,0,2
2021,228875,0,0,702,359,343
2021,228875,10,0,699,358,341
2021,228875,10,1,215,137,78
2021,228875,10,2,221,116,105
2021,228875,10,3,147,57,90
2021,228875,10,4,73,40,33
2021,228875,10,5,43,8,35
2021,228875,20,0,359,216,143
2021,228875,20,1,185,124,61
2021,228875,20,2,172,92,80
2021,228875,20,3,2,0,2
2021,228875,30,0,90,43,47
2021,228875,30,2,4,3,1
2021,228875,30,3,86,40,46
2021,228875,40,0,250,99,151
2021,228875,40,1,30,13,17
2021,228875,40,2,45,21,24
2021,228875,40,3,59,17,42
2021,228875,40,4,73,40,33
2021,228875,40,5,43,8,35
2021,228875,41,0,80,34,46
2021,228875,41,1,16,4,12
2021,228875,41,2,20,12,8
2021,228875,41,3,6,5,1
2021,228875,41,4,16,13,3
2021,228875,41,5,22,0,22
2021,228875,42,0,170,65,105
2021,228875,42,1,14,9,5
2021,228875,42,2,25,9,16
2021,228875,42,3,53,12,41
2021,228875,42,4,57,27,30
2021,228875,42,5,21,8,13
2021,228875,44,0,80,34,46
2021,228875,44,1,16,4,12
2021,228875,44,2,20,12,8
2021,228875,44,3,6,5,1
2021,228875,44,4,16,13,3
2021,228875,44,5,22,0,22
2021,228875,50,0,3,1,2
2021,228884,0,0,29,15,14
2021,228884,10,0,29,15,14
2021,228884,10,1,2,1,1
2021,228884,10,2,9,5,4
2021,228884,10,3,8,4,4
2021,228884,10,4,10,5,5
2021,228884,30,0,29,15,14
2021,228884,30,1,2,1,1
2021,228884,30,2,9,5,4
2021,228884,30,3,8,4,4
2021,228884,30,4,10,5,5
2021,228909,0,0,238,103,135
2021,228909,10,0,238,103,135
2021,228909,10,1,49,38,11
2021,228909,10,2,64,25,39
2021,228909,10,3,112,37,75
2021,228909,10,4,13,3,10
2021,228909,20,0,64,40,24
2021,228909,20,1,39,31,8
2021,228909,20,2,25,9,16
2021,228909,30,0,30,16,14
2021,228909,30,2,6,4,2
2021,228909,30,3,24,12,12
2021,228909,40,0,144,47,97
2021,228909,40,1,10,7,3
2021,228909,40,2,33,12,21
2021,228909,40,3,88,25,63
2021,228909,40,4,13,3,10
2021,228909,42,0,144,47,97
2021,228909,42,1,10,7,3
2021,228909,42,2,33,12,21
2021,228909,42,3,88,25,63
2021,228909,42,4,13,3,10
2021,228981,0,0,89,40,49
2021,228981,10,0,84,40,44
2021,228981,10,1,27,14,13
2021,228981,10,2,29,16,13
2021,228981,10,3,21,8,13
2021,228981,10,4,1,0,1
2021,228981,10,5,6,2,4
2021,228981,20,0,53,28,25
2021,228981,20,1,27,14,13
2021,228981,20,2,26,14,12
2021,228981,30,0,23,9,14
2021,228981,30,2,3,2,1
2021,228981,30,3,19,7,12
2021,228981,30,4,1,0,1
2021,228981,40,0,8,3,5
2021,228981,40,3,2,1,1
2021,228981,40,5,6,2,4
2021,228981,42,0,8,3,5
2021,228981,42,3,2,1,1
2021,228981,42,5,6,2,4
2021,228981,50,0,5,0,5
2021,229018,0,0,184,107,77
2021,229018,10,0,170,99,71
2021,229018,10,1,29,23,6
2021,229018,10,2,37,27,10
2021,229018,10,3,60,36,24
2021,229018,10,5,38,11,27
2021,229018,10,6,6,2,4
2021,229018,20,0,59,43,16
2021,229018,20,1,25,19,6
2021,229018,20,2,34,24,10
2021,229018,30,0,55,38,17
2021,229018,30,1,1,1,0
2021,229018,30,2,3,3,0
2021,229018,30,3,51,34,17
2021,229018,40,0,56,18,38
2021,229018,40,1,3,3,0
2021,229018,40,3,9,2,7
2021,229018,40,5,38,11,27
2021,229018,40,6,6,2,4
2021,229018,42,0,56,18,38
2021,229018,42,1,3,3,0
2021,229018,42,3,9,2,7
2021,229018,42,5,38,11,27
2021,229018,42,6,6,2,4
2021,229018,50,0,14,8,6
2021,229027,0,0,998,580,418
2021,229027,10,0,998,580,418
2021,229027,10,1,275,196,79
2021,229027,10,2,277,172,105
2021,229027,10,3,289,148,141
2021,229027,10,5,133,55,78
2021,229027,10,6,24,9,15
2021,229027,20,0,457,311,146
2021,229027,20,1,258,186,72
2021,229027,20,2,198,124,74
2021,229027,20,3,1,1,0
2021,229027,30,0,182,97,85
2021,229027,30,2,7,6,1
2021,229027,30,3,175,91,84
2021,229027,40,0,359,172,187
2021,229027,40,1,17,10,7
2021,229027,40,2,72,42,30
2021,229027,40,3,113,56,57
2021,229027,40,5,133,55,78
2021,229027,40,6,24,9,15
2021,229027,41,0,135,81,54
2021,229027,41,1,8,6,2
2021,229027,41,2,46,28,18
2021,229027,41,3,46,27,19
2021,229027,41,5,22,14,8
2021,229027,41,6,13,6,7
2021,229027,42,0,224,91,133
2021,229027,42,1,9,4,5
2021,229027,42,2,26,14,12
2021,229027,42,3,67,29,38
2021,229027,42,5,111,41,70
2021,229027,42,6,11,3,8
2021,229027,44,0,135,81,54
2021,229027,44,1,8,6,2
2021,229027,44,2,46,28,18
2021,229027,44,3,46,27,19
2021,229027,44,5,22,14,8
2021,229027,44,6,13,6,7
2021,229063,0,0,407,198,209
2021,229063,10,0,407,198,209
2021,229063,10,1,128,77,51
2021,229063,10,2,95,46,49
2021,229063,10,3,56,18,38
2021,229063,10,6,128,57,71
2021,229063,20,0,227,125,102
2021,229063,20,1,128,77,51
2021,229063,20,2,94,46,48
2021,229063,20,3,5,2,3
2021,229063,30,0,52,16,36
2021,229063,30,2,1,0,1
2021,229063,30,3,51,16,35
2021,229063,40,0,128,57,71
2021,229063,40,6,128,57,71
2021,229063,42,0,128,57,71
2021,229063,42,6,128,57,71
2021,229115,0,0,1455,854,601
2021,229115,10,0,1454,853,601
2021,229115,10,1,396,287,109
2021,229115,10,2,410,267,143
2021,229115,10,3,365,190,175
2021,229115,10,4,176,63,113
2021,229115,10,5,48,16,32
2021,229115,10,6,59,30,29
2021,229115,20,0,770,527,243
2021,229115,20,1,381,279,102
2021,229115,20,2,347,227,120
2021,229115,20,3,3,3,0
2021,229115,20,4,1,1,0
2021,229115,20,6,38,17,21
2021,229115,30,0,346,187,159
2021,229115,30,1,4,3,1
2021,229115,30,2,27,20,7
2021,229115,30,3,302,159,143
2021,229115,30,6,13,5,8
2021,229115,40,0,338,139,199
2021,229115,40,1,11,5,6
2021,229115,40,2,36,20,16
2021,229115,40,3,60,28,32
2021,229115,40,4,175,62,113
2021,229115,40,5,48,16,32
2021,229115,40,6,8,8,0
2021,229115,42,0,34,9,25
2021,229115,42,2,2,0,2
2021,229115,42,3,3,0,3
2021,229115,42,4,29,9,20
2021,229115,43,0,304,130,174
2021,229115,43,1,11,5,6
2021,229115,43,2,34,20,14
2021,229115,43,3,57,28,29
2021,229115,43,4,146,53,93
2021,229115,43,5,48,16,32
2021,229115,43,6,8,8,0
2021,229115,50,0,1,1,0
2021,229160,0,0,102,47,55
2021,229160,10,0,102,47,55
2021,229160,10,1,28,16,12
2021,229160,10,2,45,17,28
2021,229160,10,3,23,12,11
2021,229160,10,4,6,2,4
2021,229160,20,0,74,35,39
2021,229160,20,1,28,16,12
2021,229160,20,2,43,17,26
2021,229160,20,3,3,2,1
2021,229160,30,0,21,9,12
2021,229160,30,2,2,0,2
2021,229160,30,3,17,8,9
2021,229160,30,4,2,1,1
2021,229160,40,0,7,3,4
2021,229160,40,3,3,2,1
2021,229160,40,4,4,1,3
2021,229160,42,0,1,0,1
2021,229160,42,3,1,0,1
2021,229160,43,0,6,3,3
2021,229160,43,3,2,2,0
2021,229160,43,4,4,1,3
2021,229179,0,0,444,104,340
2021,229179,10,0,444,104,340
2021,229179,10,1,125,31,94
2021,229179,10,2,131,35,96
2021,229179,10,3,158,32,126
2021,229179,10,4,6,1,5
2021,229179,10,5,24,5,19
2021,229179,20,0,202,59,143
2021,229179,20,1,113,30,83
2021,229179,20,2,89,29,60
2021,229179,30,0,113,31,82
2021,229179,30,1,4,1,3
2021,229179,30,2,11,3,8
2021,229179,30,3,98,27,71
2021,229179,40,0,129,14,115
2021,229179,40,1,8,0,8
2021,229179,40,2,31,3,28
2021,229179,40,3,60,5,55
2021,229179,40,4,6,1,5
2021,229179,40,5,24,5,19
2021,229179,42,0,129,14,115
2021,229179,42,1,8,0,8
2021,229179,42,2,31,3,28
2021,229179,42,3,60,5,55
2021,229179,42,4,6,1,5
2021,229179,42,5,24,5,19
2021,229267,0,0,264,148,116
2021,229267,10,0,264,148,116
2021,229267,10,1,97,54,43
2021,229267,10,2,81,48,33
2021,229267,10,3,73,42,31
2021,229267,10,5,12,4,8
2021,229267,10,6,1,0,1
2021,229267,20,0,171,96,75
2021,229267,20,1,91,49,42
2021,229267,20,2,80,47,33
2021,229267,30,0,40,20,20
2021,229267,30,3,40,20,20
2021,229267,40,0,53,32,21
2021,229267,40,1,6,5,1
2021,229267,40,2,1,1,0
2021,229267,40,3,33,22,11
2021,229267,40,5,12,4,8
2021,229267,40,6,1,0,1
2021,229267,41,0,1,0,1
2021,229267,41,1,1,0,1
2021,229267,42,0,52,32,20
2021,229267,42,1,5,5,0
2021,229267,42,2,1,1,0
2021,229267,42,3,33,22,11
2021,229267,42,5,12,4,8
2021,229267,42,6,1,0,1
2021,229267,44,0,1,0,1
2021,229267,44,1,1,0,1
2021,229300,0,0,1914,993,921
2021,229300,10,0,1901,991,910
2021,229300,10,1,350,232,118
2021,229300,10,2,458,245,213
2021,229300,10,3,1018,489,529
2021,229300,10,4,62,23,39
2021,229300,10,6,13,2,11
2021,229300,20,0,264,178,86
2021,229300,20,1,189,131,58
2021,229300,20,2,75,47,28
2021,229300,30,0,130,68,62
2021,229300,30,1,10,8,2
2021,229300,30,2,32,14,18
2021,229300,30,3,88,46,42
2021,229300,40,0,1507,745,762
2021,229300,40,1,151,93,58
2021,229300,40,2,351,184,167
2021,229300,40,3,930,443,487
2021,229300,40,4,62,23,39
2021,229300,40,6,13,2,11
2021,229300,42,0,1507,745,762
2021,229300,42,1,151,93,58
2021,229300,42,2,351,184,167
2021,229300,42,3,930,443,487
2021,229300,42,4,62,23,39
2021,229300,42,6,13,2,11
2021,229300,50,0,13,2,11
2021,229337,0,0,728,343,385
2021,229337,10,0,728,343,385
2021,229337,10,1,153,95,58
2021,229337,10,2,214,111,103
2021,229337,10,3,293,115,178
2021,229337,10,4,28,7,21
2021,229337,10,6,40,15,25
2021,229337,20,0,134,87,47
2021,229337,20,1,95,66,29
2021,229337,20,2,39,21,18
2021,229337,30,0,49,30,19
2021,229337,30,1,1,1,0
2021,229337,30,2,11,8,3
2021,229337,30,3,37,21,16
2021,229337,40,0,545,226,319
2021,229337,40,1,57,28,29
2021,229337,40,2,164,82,82
2021,229337,40,3,256,94,162
2021,229337,40,4,28,7,21
2021,229337,40,6,40,15,25
2021,229337,42,0,545,226,319
2021,229337,42,1,57,28,29
2021,229337,42,2,164,82,82
2021,229337,42,3,256,94,162
2021,229337,42,4,28,7,21
2021,229337,42,6,40,15,25
2021,229355,0,0,323,136,187
2021,229355,10,0,323,136,187
2021,229355,10,1,323,136,187
2021,229355,40,0,323,136,187
2021,229355,40,1,323,136,187
2021,229355,41,0,196,85,111
2021,229355,41,1,196,85,111
2021,229355,42,0,127,51,76
2021,229355,42,1,127,51,76
2021,229355,44,0,196,85,111
2021,229355,44,1,196,85,111
2021,229504,0,0,85,35,50
2021,229504,10,0,85,35,50
2021,229504,10,6,85,35,50
2021,229504,40,0,85,35,50
2021,229504,40,6,85,35,50
2021,229504,42,0,85,35,50
2021,229504,42,6,85,35,50
2021,229540,0,0,88,35,53
2021,229540,10,0,88,35,53
2021,229540,10,1,25,7,18
2021,229540,10,2,32,12,20
2021,229540,10,3,11,6,5
2021,229540,10,4,15,6,9
2021,229540,10,6,5,4,1
2021,229540,20,0,60,21,39
2021,229540,20,1,25,7,18
2021,229540,20,2,23,8,15
2021,229540,20,3,3,2,1
2021,229540,20,4,9,4,5
2021,229540,30,0,25,13,12
2021,229540,30,2,9,4,5
2021,229540,30,3,7,4,3
2021,229540,30,4,4,1,3
2021,229540,30,6,5,4,1
2021,229540,40,0,3,1,2
2021,229540,40,3,1,0,1
2021,229540,40,4,2,1,1
2021,229540,42,0,1,1,0
2021,229540,42,4,1,1,0
2021,229540,43,0,2,0,2
2021,229540,43,3,1,0,1
2021,229540,43,4,1,0,1
2021,229780,0,0,108,68,40
2021,229780,10,0,108,68,40
2021,229780,10,1,57,43,14
2021,229780,10,2,23,10,13
2021,229780,10,3,19,7,12
2021,229780,10,4,7,6,1
2021,229780,10,5,2,2,0
2021,229780,40,0,108,68,40
2021,229780,40,1,57,43,14
2021,229780,40,2,23,10,13
2021,229780,40,3,19,7,12
2021,229780,40,4,7,6,1
2021,229780,40,5,2,2,0
2021,229780,42,0,108,68,40
2021,229780,42,1,57,43,14
2021,229780,42,2,23,10,13
2021,229780,42,3,19,7,12
2021,229780,42,4,7,6,1
2021,229780,42,5,2,2,0
2021,229799,0,0,131,46,85
2021,229799,10,0,131,46,85
2021,229799,10,4,129,46,83
2021,229799,10,6,2,0,2
2021,229799,40,0,131,46,85
2021,229799,40,4,129,46,83
2021,229799,40,6,2,0,2
2021,229799,42,0,131,46,85
2021,229799,42,4,129,46,83
2021,229799,42,6,2,0,2
2021,229814,0,0,355,185,170
2021,229814,10,0,355,185,170
2021,229814,10,1,71,48,23
2021,229814,10,2,76,48,28
2021,229814,10,3,110,62,48
2021,229814,10,4,92,24,68
2021,229814,10,5,6,3,3
2021,229814,20,0,137,89,48
2021,229814,20,1,69,47,22
2021,229814,20,2,68,42,26
2021,229814,30,0,73,44,29
2021,229814,30,2,2,2,0
2021,229814,30,3,71,42,29
2021,229814,40,0,145,52,93
2021,229814,40,1,2,1,1
2021,229814,40,2,6,4,2
2021,229814,40,3,39,20,19
2021,229814,40,4,92,24,68
2021,229814,40,5,6,3,3
2021,229814,41,0,84,26,58
2021,229814,41,1,1,0,1
2021,229814,41,3,8,4,4
2021,229814,41,4,70,19,51
2021,229814,41,5,5,3,2
2021,229814,42,0,61,26,35
2021,229814,42,1,1,1,0
2021,229814,42,2,6,4,2
2021,229814,42,3,31,16,15
2021,229814,42,4,22,5,17
2021,229814,42,5,1,0,1
2021,229814,44,0,84,26,58
2021,229814,44,1,1,0,1
2021,229814,44,3,8,4,4
2021,229814,44,4,70,19,51
2021,229814,44,5,5,3,2
2021,229832,0,0,34,21,13
2021,229832,10,0,34,21,13
2021,229832,10,1,1,1,0
2021,229832,10,2,3,2,1
2021,229832,10,3,8,5,3
2021,229832,10,4,22,13,9
2021,229832,40,0,34,21,13
2021,229832,40,1,1,1,0
2021,229832,40,2,3,2,1
2021,229832,40,3,8,5,3
2021,229832,40,4,22,13,9
2021,229832,42,0,34,21,13
2021,229832,42,1,1,1,0
2021,229832,42,2,3,2,1
2021,229832,42,3,8,5,3
2021,229832,42,4,22,13,9
2021,229841,0,0,176,69,107
2021,229841,10,0,176,69,107
2021,229841,10,6,176,69,107
2021,229841,40,0,176,69,107
2021,229841,40,6,176,69,107
2021,229841,41,0,52,13,39
2021,229841,41,6,52,13,39
2021,229841,42,0,124,56,68
2021,229841,42,6,124,56,68
2021,229841,44,0,52,13,39
2021,229841,44,6,52,13,39
2021,229887,0,0,32,15,17
2021,229887,10,0,32,15,17
2021,229887,10,2,7,4,3
2021,229887,10,3,15,7,8
2021,229887,10,4,10,4,6
2021,229887,40,0,32,15,17
2021,229887,40,2,7,4,3
2021,229887,40,3,15,7,8
2021,229887,40,4,10,4,6
2021,229887,41,0,2,0,2
2021,229887,41,2,1,0,1
2021,229887,41,3,1,0,1
2021,229887,42,0,30,15,15
2021,229887,42,2,6,4,2
2021,229887,42,3,14,7,7
2021,229887,42,4,10,4,6
2021,229887,45,0,2,0,2
2021,229887,45,2,1,0,1
2021,229887,45,3,1,0,1
2021,230038,0,0,1290,999,291
2021,230038,10,0,1286,998,288
2021,230038,10,1,434,383,51
2021,230038,10,2,510,398,112
2021,230038,10,3,330,216,114
2021,230038,10,4,12,1,11
2021,230038,20,0,865,721,144
2021,230038,20,1,423,375,48
2021,230038,20,2,439,343,96
2021,230038,20,3,3,3,0
2021,230038,30,0,361,241,120
2021,230038,30,1,6,3,3
2021,230038,30,2,57,44,13
2021,230038,30,3,298,194,104
2021,230038,40,0,60,36,24
2021,230038,40,1,5,5,0
2021,230038,40,2,14,11,3
2021,230038,40,3,29,19,10
2021,230038,40,4,12,1,11
2021,230038,42,0,60,36,24
2021,230038,42,1,5,5,0
2021,230038,42,2,14,11,3
2021,230038,42,3,29,19,10
2021,230038,42,4,12,1,11
2021,230038,50,0,4,1,3
2021,230047,0,0,127,97,30
2021,230047,10,0,127,97,30
2021,230047,10,1,27,24,3
2021,230047,10,2,45,39,6
2021,230047,10,3,53,34,19
2021,230047,10,6,2,0,2
2021,230047,40,0,127,97,30
2021,230047,40,1,27,24,3
2021,230047,40,2,45,39,6
2021,230047,40,3,53,34,19
2021,230047,40,6,2,0,2
2021,230047,42,0,127,97,30
2021,230047,42,1,27,24,3
2021,230047,42,2,45,39,6
2021,230047,42,3,53,34,19
2021,230047,42,6,2,0,2
2021,230056,0,0,12,4,8
2021,230056,50,0,12,4,8
2021,230171,0,0,255,133,122
2021,230171,10,0,255,133,122
2021,230171,10,1,40,25,15
2021,230171,10,2,70,39,31
2021,230171,10,3,95,48,47
2021,230171,10,4,20,8,12
2021,230171,10,6,30,13,17
2021,230171,20,0,109,61,48
2021,230171,20,1,40,25,15
2021,230171,20,2,63,34,29
2021,230171,20,3,5,1,4
2021,230171,20,4,1,1,0
2021,230171,30,0,85,48,37
2021,230171,30,2,6,4,2
2021,230171,30,3,79,44,35
2021,230171,40,0,61,24,37
2021,230171,40,2,1,1,0
2021,230171,40,3,11,3,8
2021,230171,40,4,19,7,12
2021,230171,40,6,30,13,17
2021,230171,41,0,38,12,26
2021,230171,41,2,1,1,0
2021,230171,41,3,10,2,8
2021,230171,41,4,19,7,12
2021,230171,41,6,8,2,6
2021,230171,42,0,22,11,11
2021,230171,42,6,22,11,11
2021,230171,43,0,1,1,0
2021,230171,43,3,1,1,0
2021,230171,44,0,10,3,7
2021,230171,44,2,1,1,0
2021,230171,44,3,3,0,3
2021,230171,44,6,6,2,4
2021,230171,45,0,28,9,19
2021,230171,45,3,7,2,5
2021,230171,45,4,19,7,12
2021,230171,45,6,2,0,2
2021,230366,0,0,10,1,9
2021,230366,10,0,10,1,9
2021,230366,10,4,10,1,9
2021,230366,40,0,10,1,9
2021,230366,40,4,10,1,9
2021,230366,41,0,10,1,9
2021,230366,41,4,10,1,9
2021,230366,45,0,10,1,9
2021,230366,45,4,10,1,9
2021,230418,0,0,16,10,6
2021,230418,10,0,16,10,6
2021,230418,10,6,16,10,6
2021,230418,40,0,16,10,6
2021,230418,40,6,16,10,6
2021,230418,41,0,16,10,6
2021,230418,41,6,16,10,6
2021,230418,45,0,16,10,6
2021,230418,45,6,16,10,6
2021,230597,0,0,152,99,53
2021,230597,10,0,152,99,53
2021,230597,10,1,19,13,6
2021,230597,10,2,40,28,12
2021,230597,10,3,56,32,24
2021,230597,10,4,37,26,11
2021,230597,20,0,71,46,25
2021,230597,20,1,19,13,6
2021,230597,20,2,35,24,11
2021,230597,20,3,17,9,8
2021,230597,30,0,60,37,23
2021,230597,30,2,4,3,1
2021,230597,30,3,39,23,16
2021,230597,30,4,17,11,6
2021,230597,40,0,21,16,5
2021,230597,40,2,1,1,0
2021,230597,40,4,20,15,5
2021,230597,41,0,21,16,5
2021,230597,41,2,1,1,0
2021,230597,41,4,20,15,5
2021,230597,44,0,21,16,5
2021,230597,44,2,1,1,0
2021,230597,44,4,20,15,5
2021,230603,0,0,353,228,125
2021,230603,10,0,353,228,125
2021,230603,10,1,58,51,7
2021,230603,10,2,89,57,32
2021,230603,10,3,147,84,63
2021,230603,10,5,53,31,22
2021,230603,10,6,6,5,1
2021,230603,20,0,135,99,36
2021,230603,20,1,58,51,7
2021,230603,20,2,77,48,29
2021,230603,30,0,109,73,36
2021,230603,30,2,7,6,1
2021,230603,30,3,102,67,35
2021,230603,40,0,109,56,53
2021,230603,40,2,5,3,2
2021,230603,40,3,45,17,28
2021,230603,40,5,53,31,22
2021,230603,40,6,6,5,1
2021,230603,42,0,109,56,53
2021,230603,42,2,5,3,2
2021,230603,42,3,45,17,28
2021,230603,42,5,53,31,22
2021,230603,42,6,6,5,1
2021,230728,0,0,1029,604,425
2021,230728,10,0,1029,604,425
2021,230728,10,1,267,185,82
2021,230728,10,2,252,168,84
2021,230728,10,3,331,156,175
2021,230728,10,4,42,24,18
2021,230728,10,5,137,71,66
2021,230728,20,0,477,329,148
2021,230728,20,1,255,177,78
2021,230728,20,2,221,151,70
2021,230728,20,4,1,1,0
2021,230728,30,0,225,113,112
2021,230728,30,2,1,0,1
2021,230728,30,3,222,111,111
2021,230728,30,4,2,2,0
2021,230728,40,0,327,162,165
2021,230728,40,1,12,8,4
2021,230728,40,2,30,17,13
2021,230728,40,3,109,45,64
2021,230728,40,4,39,21,18
2021,230728,40,5,137,71,66
2021,230728,42,0,327,162,165
2021,230728,42,1,12,8,4
2021,230728,42,2,30,17,13
2021,230728,42,3,109,45,64
2021,230728,42,4,39,21,18
2021,230728,42,5,137,71,66
2021,230737,0,0,774,496,278
2021,230737,10,0,774,496,278
2021,230737,10,1,122,86,36
2021,230737,10,2,275,188,87
2021,230737,10,3,222,132,90
2021,230737,10,5,155,90,65
2021,230737,20,0,383,263,120
2021,230737,20,1,121,86,35
2021,230737,20,2,262,177,85
2021,230737,30,0,236,143,93
2021,230737,30,1,1,0,1
2021,230737,30,2,13,11,2
2021,230737,30,3,222,132,90
2021,230737,40,0,155,90,65
2021,230737,40,5,155,90,65
2021,230737,41,0,121,72,49
2021,230737,41,5,121,72,49
2021,230737,42,0,34,18,16
2021,230737,42,5,34,18,16
2021,230737,44,0,121,72,49
2021,230737,44,5,121,72,49
2021,230746,0,0,349,192,157
2021,230746,10,0,349,192,157
2021,230746,10,1,57,31,26
2021,230746,10,2,153,88,65
2021,230746,10,3,131,69,62
2021,230746,10,4,7,4,3
2021,230746,10,5,1,0,1
2021,230746,20,0,216,123,93
2021,230746,20,1,57,31,26
2021,230746,20,2,152,87,65
2021,230746,20,3,7,5,2
2021,230746,30,0,124,64,60
2021,230746,30,2,1,1,0
2021,230746,30,3,123,63,60
2021,230746,40,0,9,5,4
2021,230746,40,3,1,1,0
2021,230746,40,4,7,4,3
2021,230746,40,5,1,0,1
2021,230746,41,0,5,3,2
2021,230746,41,3,1,1,0
2021,230746,41,4,3,2,1
2021,230746,41,5,1,0,1
2021,230746,42,0,3,2,1
2021,230746,42,4,3,2,1
2021,230746,43,0,1,0,1
2021,230746,43,4,1,0,1
2021,230746,45,0,5,3,2
2021,230746,45,3,1,1,0
2021,230746,45,4,3,2,1
2021,230746,45,5,1,0,1
2021,230764,0,0,2361,1389,972
2021,230764,10,0,2234,1333,901
2021,230764,10,1,765,531,234
2021,230764,10,2,572,318,254
2021,230764,10,3,577,308,269
2021,230764,10,4,18,6,12
2021,230764,10,5,302,170,132
2021,230764,20,0,1104,743,361
2021,230764,20,1,686,492,194
2021,230764,20,2,417,251,166
2021,230764,20,3,1,0,1
2021,230764,30,0,502,283,219
2021,230764,30,1,25,15,10
2021,230764,30,2,42,19,23
2021,230764,30,3,428,245,183
2021,230764,30,4,7,4,3
2021,230764,40,0,628,307,321
2021,230764,40,1,54,24,30
2021,230764,40,2,113,48,65
2021,230764,40,3,148,63,85
2021,230764,40,4,11,2,9
2021,230764,40,5,302,170,132
2021,230764,42,0,520,255,265
2021,230764,42,1,48,23,25
2021,230764,42,2,106,45,61
2021,230764,42,3,125,54,71
2021,230764,42,4,10,2,8
2021,230764,42,5,231,131,100
2021,230764,43,0,108,52,56
2021,230764,43,1,6,1,5
2021,230764,43,2,7,3,4
2021,230764,43,3,23,9,14
2021,230764,43,4,1,0,1
2021,230764,43,5,71,39,32
2021,230764,50,0,127,56,71
2021,230782,0,0,586,306,280
2021,230782,10,0,586,306,280
2021,230782,10,1,170,112,58
2021,230782,10,2,122,63,59
2021,230782,10,3,159,76,83
2021,230782,10,4,128,50,78
2021,230782,10,6,7,5,2
2021,230782,20,0,294,177,117
2021,230782,20,1,169,111,58
2021,230782,20,2,119,63,56
2021,230782,20,3,6,3,3
2021,230782,30,0,143,69,74
2021,230782,30,2,3,0,3
2021,230782,30,3,135,67,68
2021,230782,30,4,5,2,3
2021,230782,40,0,149,60,89
2021,230782,40,1,1,1,0
2021,230782,40,3,18,6,12
2021,230782,40,4,123,48,75
2021,230782,40,6,7,5,2
2021,230782,42,0,149,60,89
2021,230782,42,1,1,1,0
2021,230782,42,3,18,6,12
2021,230782,42,4,123,48,75
2021,230782,42,6,7,5,2
2021,230807,0,0,121,58,63
2021,230807,10,0,121,58,63
2021,230807,10,1,39,21,18
2021,230807,10,2,45,25,20
2021,230807,10,3,37,12,25
2021,230807,40,0,121,58,63
2021,230807,40,1,39,21,18
2021,230807,40,2,45,25,20
2021,230807,40,3,37,12,25
2021,230807,41,0,120,58,62
2021,230807,41,1,39,21,18
2021,230807,41,2,45,25,20
2021,230807,41,3,36,12,24
2021,230807,42,0,1,0,1
2021,230807,42,3,1,0,1
2021,230807,44,0,120,58,62
2021,230807,44,1,39,21,18
2021,230807,44,2,45,25,20
2021,230807,44,3,36,12,24
2021,230816,0,0,60,29,31
2021,230816,10,0,60,29,31
2021,230816,10,6,60,29,31
2021,230816,40,0,60,29,31
2021,230816,40,6,60,29,31
2021,230816,41,0,60,29,31
2021,230816,41,6,60,29,31
2021,230816,44,0,60,29,31
2021,230816,44,6,60,29,31
2021,230834,0,0,81,39,42
2021,230834,10,0,81,39,42
2021,230834,10,1,34,20,14
2021,230834,10,2,26,14,12
2021,230834,10,3,21,5,16
2021,230834,20,0,60,34,26
2021,230834,20,1,34,20,14
2021,230834,20,2,26,14,12
2021,230834,30,0,21,5,16
2021,230834,30,3,21,5,16
2021,230852,0,0,107,65,42
2021,230852,10,0,107,65,42
2021,230852,10,1,32,18,14
2021,230852,10,2,41,23,18
2021,230852,10,3,30,20,10
2021,230852,10,4,4,4,0
2021,230852,40,0,107,65,42
2021,230852,40,1,32,18,14
2021,230852,40,2,41,23,18
2021,230852,40,3,30,20,10
2021,230852,40,4,4,4,0
2021,230852,41,0,102,60,42
2021,230852,41,1,32,18,14
2021,230852,41,2,41,23,18
2021,230852,41,3,29,19,10
2021,230852,42,0,5,5,0
2021,230852,42,3,1,1,0
2021,230852,42,4,4,4,0
2021,230852,44,0,102,60,42
2021,230852,44,1,32,18,14
2021,230852,44,2,41,23,18
2021,230852,44,3,29,19,10
2021,230889,0,0,10,4,6
2021,230889,10,0,10,4,6
2021,230889,10,6,10,4,6
2021,230889,40,0,10,4,6
2021,230889,40,6,10,4,6
2021,230889,41,0,10,4,6
2021,230889,41,6,10,4,6
2021,230889,44,0,10,4,6
2021,230889,44,6,10,4,6
2021,230913,0,0,64,39,25
2021,230913,10,0,64,39,25
2021,230913,10,1,26,15,11
2021,230913,10,2,23,21,2
2021,230913,10,3,15,3,12
2021,230913,20,0,49,36,13
2021,230913,20,1,26,15,11
2021,230913,20,2,23,21,2
2021,230913,30,0,12,3,9
2021,230913,30,3,12,3,9
2021,230913,40,0,3,0,3
2021,230913,40,3,3,0,3
2021,230913,42,0,3,0,3
2021,230913,42,3,3,0,3
2021,230959,0,0,332,187,145
2021,230959,10,0,332,187,145
2021,230959,10,1,125,85,40
2021,230959,10,2,68,30,38
2021,230959,10,3,92,42,50
2021,230959,10,4,3,3,0
2021,230959,10,5,5,1,4
2021,230959,10,6,39,26,13
2021,230959,20,0,185,111,74
2021,230959,20,1,125,85,40
2021,230959,20,2,60,26,34
2021,230959,30,0,79,39,40
2021,230959,30,3,79,39,40
2021,230959,40,0,68,37,31
2021,230959,40,2,8,4,4
2021,230959,40,3,13,3,10
2021,230959,40,4,3,3,0
2021,230959,40,5,5,1,4
2021,230959,40,6,39,26,13
2021,230959,41,0,56,31,25
2021,230959,41,2,6,4,2
2021,230959,41,3,6,0,6
2021,230959,41,4,2,2,0
2021,230959,41,5,5,1,4
2021,230959,41,6,37,24,13
2021,230959,42,0,12,6,6
2021,230959,42,2,2,0,2
2021,230959,42,3,7,3,4
2021,230959,42,4,1,1,0
2021,230959,42,6,2,2,0
2021,230959,44,0,56,31,25
2021,230959,44,2,6,4,2
2021,230959,44,3,6,0,6
2021,230959,44,4,2,2,0
2021,230959,44,5,5,1,4
2021,230959,44,6,37,24,13
2021,230995,0,0,163,89,74
2021,230995,10,0,163,89,74
2021,230995,10,1,32,19,13
2021,230995,10,2,49,32,17
2021,230995,10,3,36,18,18
2021,230995,10,4,1,1,0
2021,230995,10,5,35,12,23
2021,230995,10,6,10,7,3
2021,230995,20,0,72,44,28
2021,230995,20,1,29,17,12
2021,230995,20,2,42,27,15
2021,230995,20,3,1,0,1
2021,230995,30,0,43,23,20
2021,230995,30,1,2,1,1
2021,230995,30,2,6,4,2
2021,230995,30,3,35,18,17
2021,230995,40,0,48,22,26
2021,230995,40,1,1,1,0
2021,230995,40,2,1,1,0
2021,230995,40,4,1,1,0
2021,230995,40,5,35,12,23
2021,230995,40,6,10,7,3
2021,230995,41,0,1,1,0
2021,230995,41,6,1,1,0
2021,230995,42,0,45,20,25
2021,230995,42,1,1,1,0
2021,230995,42,2,1,1,0
2021,230995,42,4,1,1,0
2021,230995,42,5,33,11,22
2021,230995,42,6,9,6,3
2021,230995,43,0,2,1,1
2021,230995,43,5,2,1,1
2021,230995,44,0,1,1,0
2021,230995,44,6,1,1,0
2021,231059,0,0,108,55,53
2021,231059,10,0,108,55,53
2021,231059,10,1,36,25,11
2021,231059,10,2,34,18,16
2021,231059,10,3,20,6,14
2021,231059,10,4,18,6,12
2021,231059,20,0,69,42,27
2021,231059,20,1,36,25,11
2021,231059,20,2,33,17,16
2021,231059,30,0,18,6,12
2021,231059,30,2,1,1,0
2021,231059,30,3,17,5,12
2021,231059,40,0,21,7,14
2021,231059,40,3,3,1,2
2021,231059,40,4,18,6,12
2021,231059,41,0,3,2,1
2021,231059,41,3,2,1,1
2021,231059,41,4,1,1,0
2021,231059,42,0,16,4,12
2021,231059,42,4,16,4,12
2021,231059,43,0,2,1,1
2021,231059,43,3,1,0,1
2021,231059,43,4,1,1,0
2021,231059,44,0,3,2,1
2021,231059,44,3,2,1,1
2021,231059,44,4,1,1,0
2021,231068,0,0,6,1,5
2021,231068,10,0,6,1,5
2021,231068,10,1,2,0,2
2021,231068,10,2,3,1,2
2021,231068,10,3,1,0,1
2021,231068,40,0,6,1,5
2021,231068,40,1,2,0,2
2021,231068,40,2,3,1,2
2021,231068,40,3,1,0,1
2021,231068,41,0,6,1,5
2021,231068,41,1,2,0,2
2021,231068,41,2,3,1,2
2021,231068,41,3,1,0,1
2021,231068,44,0,6,1,5
2021,231068,44,1,2,0,2
2021,231068,44,2,3,1,2
2021,231068,44,3,1,0,1
2021,231095,0,0,16,8,8
2021,231095,10,0,16,8,8
2021,231095,10,6,16,8,8
2021,231095,40,0,16,8,8
2021,231095,40,6,16,8,8
2021,231095,41,0,16,8,8
2021,231095,41,6,16,8,8
2021,231095,45,0,16,8,8
2021,231095,45,6,16,8,8
2021,231147,0,0,52,17,35
2021,231147,10,0,52,17,35
2021,231147,10,1,22,11,11
2021,231147,10,2,5,0,5
2021,231147,10,3,25,6,19
2021,231147,20,0,2,1,1
2021,231147,20,1,2,1,1
2021,231147,40,0,50,16,34
2021,231147,40,1,20,10,10
2021,231147,40,2,5,0,5
2021,231147,40,3,25,6,19
2021,231147,41,0,27,9,18
2021,231147,41,1,16,8,8
2021,231147,41,2,1,0,1
2021,231147,41,3,10,1,9
2021,231147,42,0,23,7,16
2021,231147,42,1,4,2,2
2021,231147,42,2,4,0,4
2021,231147,42,3,15,5,10
2021,231147,44,0,27,9,18
2021,231147,44,1,16,8,8
2021,231147,44,2,1,0,1
2021,231147,44,3,10,1,9
2021,231165,0,0,83,38,45
2021,231165,10,0,83,38,45
2021,231165,10,1,32,20,12
2021,231165,10,2,14,5,9
2021,231165,10,3,37,13,24
2021,231165,20,0,46,25,21
2021,231165,20,1,32,20,12
2021,231165,20,2,14,5,9
2021,231165,30,0,33,11,22
2021,231165,30,3,33,11,22
2021,231165,40,0,4,2,2
2021,231165,40,3,4,2,2
2021,231165,42,0,4,2,2
2021,231165,42,3,4,2,2
2021,231174,0,0,734,390,344
2021,231174,10,0,734,390,344
2021,231174,10,1,241,165,76
2021,231174,10,2,211,100,111
2021,231174,10,3,110,47,63
2021,231174,10,4,8,3,5
2021,231174,10,5,164,75,89
2021,231174,20,0,426,258,168
2021,231174,20,1,235,164,71
2021,231174,20,2,191,94,97
2021,231174,30,0,76,42,34
2021,231174,30,3,76,42,34
2021,231174,40,0,232,90,142
2021,231174,40,1,6,1,5
2021,231174,40,2,20,6,14
2021,231174,40,3,34,5,29
2021,231174,40,4,8,3,5
2021,231174,40,5,164,75,89
2021,231174,42,0,232,90,142
2021,231174,42,1,6,1,5
2021,231174,42,2,20,6,14
2021,231174,42,3,34,5,29
2021,231174,42,4,8,3,5
2021,231174,42,5,164,75,89
2021,231411,0,0,21,18,3
2021,231411,10,0,21,18,3
2021,231411,10,4,21,18,3
2021,231411,40,0,21,18,3
2021,231411,40,4,21,18,3
2021,231411,41,0,21,18,3
2021,231411,41,4,21,18,3
2021,231411,45,0,21,18,3
2021,231411,45,4,21,18,3
2021,231420,0,0,53,28,25
2021,231420,10,0,53,28,25
2021,231420,10,1,13,9,4
2021,231420,10,2,19,7,12
2021,231420,10,3,14,7,7
2021,231420,10,4,7,5,2
2021,231420,20,0,30,13,17
2021,231420,20,1,11,8,3
2021,231420,20,2,15,4,11
2021,231420,20,3,3,0,3
2021,231420,20,4,1,1,0
2021,231420,30,0,14,10,4
2021,231420,30,1,2,1,1
2021,231420,30,2,1,1,0
2021,231420,30,3,9,6,3
2021,231420,30,4,2,2,0
2021,231420,40,0,9,5,4
2021,231420,40,2,3,2,1
2021,231420,40,3,2,1,1
2021,231420,40,4,4,2,2
2021,231420,41,0,9,5,4
2021,231420,41,2,3,2,1
2021,231420,41,3,2,1,1
2021,231420,41,4,4,2,2
2021,231420,44,0,9,5,4
2021,231420,44,2,3,2,1
2021,231420,44,3,2,1,1
2021,231420,44,4,4,2,2
2021,231536,0,0,65,32,33
2021,231536,10,0,65,32,33
2021,231536,10,1,8,3,5
2021,231536,10,2,23,14,9
2021,231536,10,3,18,5,13
2021,231536,10,4,13,7,6
2021,231536,10,5,3,3,0
2021,231536,40,0,65,32,33
2021,231536,40,1,8,3,5
2021,231536,40,2,23,14,9
2021,231536,40,3,18,5,13
2021,231536,40,4,13,7,6
2021,231536,40,5,3,3,0
2021,231536,42,0,65,32,33
2021,231536,42,1,8,3,5
2021,231536,42,2,23,14,9
2021,231536,42,3,18,5,13
2021,231536,42,4,13,7,6
2021,231536,42,5,3,3,0
2021,231554,0,0,47,26,21
2021,231554,10,0,47,26,21
2021,231554,10,1,11,7,4
2021,231554,10,2,9,5,4
2021,231554,10,3,26,14,12
2021,231554,10,4,1,0,1
2021,231554,40,0,47,26,21
2021,231554,40,1,11,7,4
2021,231554,40,2,9,5,4
2021,231554,40,3,26,14,12
2021,231554,40,4,1,0,1
2021,231554,42,0,47,26,21
2021,231554,42,1,11,7,4
2021,231554,42,2,9,5,4
2021,231554,42,3,26,14,12
2021,231554,42,4,1,0,1
2021,231581,0,0,92,48,44
2021,231581,10,0,92,48,44
2021,231581,10,1,14,10,4
2021,231581,10,2,44,23,21
2021,231581,10,3,23,11,12
2021,231581,10,4,11,4,7
2021,231581,20,0,57,32,25
2021,231581,20,1,14,10,4
2021,231581,20,2,42,22,20
2021,231581,20,3,1,0,1
2021,231581,30,0,17,8,9
2021,231581,30,2,1,0,1
2021,231581,30,3,16,8,8
2021,231581,40,0,18,8,10
2021,231581,40,2,1,1,0
2021,231581,40,3,6,3,3
2021,231581,40,4,11,4,7
2021,231581,42,0,18,8,10
2021,231581,42,2,1,1,0
2021,231581,42,3,6,3,3
2021,231581,42,4,11,4,7
2021,231624,0,0,672,382,290
2021,231624,10,0,672,382,290
2021,231624,10,1,254,166,88
2021,231624,10,2,195,116,79
2021,231624,10,3,136,68,68
2021,231624,10,4,17,6,11
2021,231624,10,5,70,26,44
2021,231624,20,0,413,266,147
2021,231624,20,1,242,160,82
2021,231624,20,2,171,106,65
2021,231624,30,0,97,52,45
2021,231624,30,2,4,1,3
2021,231624,30,3,93,51,42
2021,231624,40,0,162,64,98
2021,231624,40,1,12,6,6
2021,231624,40,2,20,9,11
2021,231624,40,3,43,17,26
2021,231624,40,4,17,6,11
2021,231624,40,5,70,26,44
2021,231624,41,0,84,28,56
2021,231624,41,1,8,5,3
2021,231624,41,2,7,2,5
2021,231624,41,3,18,5,13
2021,231624,41,4,1,0,1
2021,231624,41,5,50,16,34
2021,231624,42,0,68,34,34
2021,231624,42,1,4,1,3
2021,231624,42,2,13,7,6
2021,231624,42,3,24,11,13
2021,231624,42,4,9,5,4
2021,231624,42,5,18,10,8
2021,231624,43,0,10,2,8
2021,231624,43,3,1,1,0
2021,231624,43,4,7,1,6
2021,231624,43,5,2,0,2
2021,231624,44,0,26,11,15
2021,231624,44,1,1,1,0
2021,231624,44,3,11,4,7
2021,231624,44,5,14,6,8
2021,231624,45,0,58,17,41
2021,231624,45,1,7,4,3
2021,231624,45,2,7,2,5
2021,231624,45,3,7,1,6
2021,231624,45,4,1,0,1
2021,231624,45,5,36,10,26
2021,231651,0,0,133,90,43
2021,231651,10,0,133,90,43
2021,231651,10,1,37,30,7
2021,231651,10,2,49,30,19
2021,231651,10,3,45,30,15
2021,231651,10,4,2,0,2
2021,231651,20,0,68,48,20
2021,231651,20,1,33,26,7
2021,231651,20,2,35,22,13
2021,231651,30,0,41,30,11
2021,231651,30,1,1,1,0
2021,231651,30,2,5,3,2
2021,231651,30,3,35,26,9
2021,231651,40,0,24,12,12
2021,231651,40,1,3,3,0
2021,231651,40,2,9,5,4
2021,231651,40,3,10,4,6
2021,231651,40,4,2,0,2
2021,231651,41,0,6,5,1
2021,231651,41,1,1,1,0
2021,231651,41,2,4,3,1
2021,231651,41,3,1,1,0
2021,231651,42,0,18,7,11
2021,231651,42,1,2,2,0
2021,231651,42,2,5,2,3
2021,231651,42,3,9,3,6
2021,231651,42,4,2,0,2
2021,231651,44,0,6,5,1
2021,231651,44,1,1,1,0
2021,231651,44,2,4,3,1
2021,231651,44,3,1,1,0
2021,231697,0,0,57,28,29
2021,231697,10,0,57,28,29
2021,231697,10,1,19,9,10
2021,231697,10,2,16,8,8
2021,231697,10,3,13,9,4
2021,231697,10,4,8,2,6
2021,231697,10,5,1,0,1
2021,231697,40,0,57,28,29
2021,231697,40,1,19,9,10
2021,231697,40,2,16,8,8
2021,231697,40,3,13,9,4
2021,231697,40,4,8,2,6
2021,231697,40,5,1,0,1
2021,231697,42,0,57,28,29
2021,231697,42,1,19,9,10
2021,231697,42,2,16,8,8
2021,231697,42,3,13,9,4
2021,231697,42,4,8,2,6
2021,231697,42,5,1,0,1
2021,231712,0,0,282,162,120
2021,231712,10,0,282,162,120
2021,231712,10,1,53,38,15
2021,231712,10,2,97,52,45
2021,231712,10,3,70,43,27
2021,231712,10,4,17,8,9
2021,231712,10,5,45,21,24
2021,231712,20,0,149,90,59
2021,231712,20,1,53,38,15
2021,231712,20,2,96,52,44
2021,231712,30,0,71,43,28
2021,231712,30,2,1,0,1
2021,231712,30,3,70,43,27
2021,231712,40,0,62,29,33
2021,231712,40,4,17,8,9
2021,231712,40,5,45,21,24
2021,231712,41,0,45,21,24
2021,231712,41,5,45,21,24
2021,231712,42,0,17,8,9
2021,231712,42,4,17,8,9
2021,231712,44,0,45,21,24
2021,231712,44,5,45,21,24
2021,231785,0,0,33,7,26
2021,231785,10,0,33,7,26
2021,231785,10,4,33,7,26
2021,231785,40,0,33,7,26
2021,231785,40,4,33,7,26
2021,231785,41,0,33,7,26
2021,231785,41,4,33,7,26
2021,231785,45,0,33,7,26
2021,231785,45,4,33,7,26
2021,231873,0,0,20,6,14
2021,231873,10,0,20,6,14
2021,231873,10,2,5,2,3
2021,231873,10,3,1,0,1
2021,231873,10,4,14,4,10
2021,231873,40,0,20,6,14
2021,231873,40,2,5,2,3
2021,231873,40,3,1,0,1
2021,231873,40,4,14,4,10
2021,231873,42,0,20,6,14
2021,231873,42,2,5,2,3
2021,231873,42,3,1,0,1
2021,231873,42,4,14,4,10
2021,231882,0,0,54,36,18
2021,231882,10,0,54,36,18
2021,231882,10,1,7,6,1
2021,231882,10,2,14,7,7
2021,231882,10,3,9,5,4
2021,231882,10,4,19,13,6
2021,231882,10,5,5,5,0
2021,231882,40,0,54,36,18
2021,231882,40,1,7,6,1
2021,231882,40,2,14,7,7
2021,231882,40,3,9,5,4
2021,231882,40,4,19,13,6
2021,231882,40,5,5,5,0
2021,231882,42,0,54,36,18
2021,231882,42,1,7,6,1
2021,231882,42,2,14,7,7
2021,231882,42,3,9,5,4
2021,231882,42,4,19,13,6
2021,231882,42,5,5,5,0
2021,231970,0,0,205,103,102
2021,231970,10,0,205,103,102
2021,231970,10,1,40,29,11
2021,231970,10,2,55,30,25
2021,231970,10,3,94,42,52
2021,231970,10,4,16,2,14
2021,231970,20,0,10,7,3
2021,231970,20,1,10,7,3
2021,231970,30,0,52,33,19
2021,231970,30,1,26,19,7
2021,231970,30,2,26,14,12
2021,231970,40,0,143,63,80
2021,231970,40,1,4,3,1
2021,231970,40,2,29,16,13
2021,231970,40,3,94,42,52
2021,231970,40,4,16,2,14
2021,231970,41,0,143,63,80
2021,231970,41,1,4,3,1
2021,231970,41,2,29,16,13
2021,231970,41,3,94,42,52
2021,231970,41,4,16,2,14
2021,231970,44,0,143,63,80
2021,231970,44,1,4,3,1
2021,231970,44,2,29,16,13
2021,231970,44,3,94,42,52
2021,231970,44,4,16,2,14
2021,232016,0,0,5,2,3
2021,232016,50,0,5,2,3
2021,232025,0,0,92,37,55
2021,232025,10,0,92,37,55
2021,232025,10,1,14,10,4
2021,232025,10,2,24,9,15
2021,232025,10,3,48,16,32
2021,232025,10,4,5,2,3
2021,232025,10,5,1,0,1
2021,232025,20,0,44,22,22
2021,232025,20,1,14,10,4
2021,232025,20,2,22,9,13
2021,232025,20,3,8,3,5
2021,232025,30,0,9,3,6
2021,232025,30,3,9,3,6
2021,232025,40,0,39,12,27
2021,232025,40,2,2,0,2
2021,232025,40,3,31,10,21
2021,232025,40,4,5,2,3
2021,232025,40,5,1,0,1
2021,232025,42,0,39,12,27
2021,232025,42,2,2,0,2
2021,232025,42,3,31,10,21
2021,232025,42,4,5,2,3
2021,232025,42,5,1,0,1
2021,232043,0,0,85,40,45
2021,232043,10,0,85,40,45
2021,232043,10,1,20,12,8
2021,232043,10,2,19,9,10
2021,232043,10,3,31,14,17
2021,232043,10,4,14,4,10
2021,232043,10,5,1,1,0
2021,232043,20,0,31,17,14
2021,232043,20,1,20,12,8
2021,232043,20,2,11,5,6
2021,232043,30,0,24,12,12
2021,232043,30,2,6,3,3
2021,232043,30,3,18,9,9
2021,232043,40,0,30,11,19
2021,232043,40,2,2,1,1
2021,232043,40,3,13,5,8
2021,232043,40,4,14,4,10
2021,232043,40,5,1,1,0
2021,232043,41,0,6,3,3
2021,232043,41,2,1,1,0
2021,232043,41,3,4,1,3
2021,232043,41,4,1,1,0
2021,232043,42,0,24,8,16
2021,232043,42,2,1,0,1
2021,232043,42,3,9,4,5
2021,232043,42,4,13,3,10
2021,232043,42,5,1,1,0
2021,232043,44,0,6,3,3
2021,232043,44,2,1,1,0
2021,232043,44,3,4,1,3
2021,232043,44,4,1,1,0
2021,232052,0,0,15,6,9
2021,232052,10,0,15,6,9
2021,232052,10,1,1,0,1
2021,232052,10,2,4,2,2
2021,232052,10,3,6,3,3
2021,232052,10,4,4,1,3
2021,232052,40,0,15,6,9
2021,232052,40,1,1,0,1
2021,232052,40,2,4,2,2
2021,232052,40,3,6,3,3
2021,232052,40,4,4,1,3
2021,232052,42,0,15,6,9
2021,232052,42,1,1,0,1
2021,232052,42,2,4,2,2
2021,232052,42,3,6,3,3
2021,232052,42,4,4,1,3
2021,232089,0,0,62,29,33
2021,232089,10,0,62,29,33
2021,232089,10,1,6,1,5
2021,232089,10,2,24,14,10
2021,232089,10,3,26,11,15
2021,232089,10,4,4,3,1
2021,232089,10,5,2,0,2
2021,232089,20,0,31,16,15
2021,232089,20,1,6,1,5
2021,232089,20,2,23,14,9
2021,232089,20,3,2,1,1
2021,232089,30,0,12,5,7
2021,232089,30,2,1,0,1
2021,232089,30,3,11,5,6
2021,232089,40,0,19,8,11
2021,232089,40,3,13,5,8
2021,232089,40,4,4,3,1
2021,232089,40,5,2,0,2
2021,232089,42,0,19,8,11
2021,232089,42,3,13,5,8
2021,232089,42,4,4,3,1
2021,232089,42,5,2,0,2
2021,232186,0,0,1453,788,665
2021,232186,10,0,1453,788,665
2021,232186,10,1,392,261,131
2021,232186,10,2,505,264,241
2021,232186,10,3,468,230,238
2021,232186,10,4,88,33,55
2021,232186,20,0,689,432,257
2021,232186,20,1,346,240,106
2021,232186,20,2,343,192,151
2021,232186,30,0,249,136,113
2021,232186,30,1,1,1,0
2021,232186,30,2,12,8,4
2021,232186,30,3,236,127,109
2021,232186,40,0,515,220,295
2021,232186,40,1,45,20,25
2021,232186,40,2,150,64,86
2021,232186,40,3,232,103,129
2021,232186,40,4,88,33,55
2021,232186,41,0,327,139,188
2021,232186,41,1,44,20,24
2021,232186,41,2,131,56,75
2021,232186,41,3,108,48,60
2021,232186,41,4,44,15,29
2021,232186,42,0,188,81,107
2021,232186,42,1,1,0,1
2021,232186,42,2,19,8,11
2021,232186,42,3,124,55,69
2021,232186,42,4,44,18,26
2021,232186,44,0,327,139,188
2021,232186,44,1,44,20,24
2021,232186,44,2,131,56,75
2021,232186,44,3,108,48,60
2021,232186,44,4,44,15,29
2021,232195,0,0,104,33,71
2021,232195,10,0,104,33,71
2021,232195,10,1,11,2,9
2021,232195,10,2,21,4,17
2021,232195,10,3,45,23,22
2021,232195,10,4,25,4,21
2021,232195,10,5,2,0,2
2021,232195,40,0,104,33,71
2021,232195,40,1,11,2,9
2021,232195,40,2,21,4,17
2021,232195,40,3,45,23,22
2021,232195,40,4,25,4,21
2021,232195,40,5,2,0,2
2021,232195,42,0,104,33,71
2021,232195,42,1,11,2,9
2021,232195,42,2,21,4,17
2021,232195,42,3,45,23,22
2021,232195,42,4,25,4,21
2021,232195,42,5,2,0,2
2021,232256,0,0,97,64,33
2021,232256,10,0,97,64,33
2021,232256,10,1,32,24,8
2021,232256,10,2,28,16,12
2021,232256,10,3,20,13,7
2021,232256,10,5,17,11,6
2021,232256,20,0,60,40,20
2021,232256,20,1,32,24,8
2021,232256,20,2,28,16,12
2021,232256,30,0,20,13,7
2021,232256,30,3,20,13,7
2021,232256,40,0,17,11,6
2021,232256,40,5,17,11,6
2021,232256,42,0,17,11,6
2021,232256,42,5,17,11,6
2021,232265,0,0,243,125,118
2021,232265,10,0,240,124,116
2021,232265,10,1,33,23,10
2021,232265,10,2,39,21,18
2021,232265,10,3,132,72,60
2021,232265,10,4,14,3,11
2021,232265,10,5,2,2,0
2021,232265,10,6,20,3,17
2021,232265,20,0,50,34,16
2021,232265,20,1,28,19,9
2021,232265,20,2,14,9,5
2021,232265,20,3,6,6,0
2021,232265,20,6,2,0,2
2021,232265,30,0,25,13,12
2021,232265,30,1,3,2,1
2021,232265,30,2,5,2,3
2021,232265,30,3,17,9,8
2021,232265,40,0,165,77,88
2021,232265,40,1,2,2,0
2021,232265,40,2,20,10,10
2021,232265,40,3,109,57,52
2021,232265,40,4,14,3,11
2021,232265,40,5,2,2,0
2021,232265,40,6,18,3,15
2021,232265,41,0,1,1,0
2021,232265,41,3,1,1,0
2021,232265,42,0,164,76,88
2021,232265,42,1,2,2,0
2021,232265,42,2,20,10,10
2021,232265,42,3,108,56,52
2021,232265,42,4,14,3,11
2021,232265,42,5,2,2,0
2021,232265,42,6,18,3,15
2021,232265,44,0,1,1,0
2021,232265,44,3,1,1,0
2021,232265,50,0,3,1,2
2021,232308,0,0,101,42,59
2021,232308,10,0,99,42,57
2021,232308,10,1,21,11,10
2021,232308,10,2,21,9,12
2021,232308,10,3,40,15,25
2021,232308,10,4,7,3,4
2021,232308,10,5,4,1,3
2021,232308,10,6,6,3,3
2021,232308,20,0,38,17,21
2021,232308,20,1,20,10,10
2021,232308,20,2,18,7,11
2021,232308,30,0,16,4,12
2021,232308,30,2,1,0,1
2021,232308,30,3,15,4,11
2021,232308,40,0,45,21,24
2021,232308,40,1,1,1,0
2021,232308,40,2,2,2,0
2021,232308,40,3,25,11,14
2021,232308,40,4,7,3,4
2021,232308,40,5,4,1,3
2021,232308,40,6,6,3,3
2021,232308,41,0,24,11,13
2021,232308,41,1,1,1,0
2021,232308,41,2,1,1,0
2021,232308,41,3,17,7,10
2021,232308,41,5,2,0,2
2021,232308,41,6,3,2,1
2021,232308,42,0,20,10,10
2021,232308,42,2,1,1,0
2021,232308,42,3,7,4,3
2021,232308,42,4,7,3,4
2021,232308,42,5,2,1,1
2021,232308,42,6,3,1,2
2021,232308,43,0,1,0,1
2021,232308,43,3,1,0,1
2021,232308,44,0,24,11,13
2021,232308,44,1,1,1,0
2021,232308,44,2,1,1,0
2021,232308,44,3,17,7,10
2021,232308,44,5,2,0,2
2021,232308,44,6,3,2,1
2021,232308,50,0,2,0,2
2021,232414,0,0,111,48,63
2021,232414,10,0,111,48,63
2021,232414,10,1,31,14,17
2021,232414,10,2,39,15,24
2021,232414,10,3,25,10,15
2021,232414,10,4,16,9,7
2021,232414,40,0,111,48,63
2021,232414,40,1,31,14,17
2021,232414,40,2,39,15,24
2021,232414,40,3,25,10,15
2021,232414,40,4,16,9,7
2021,232414,42,0,111,48,63
2021,232414,42,1,31,14,17
2021,232414,42,2,39,15,24
2021,232414,42,3,25,10,15
2021,232414,42,4,16,9,7
2021,232423,0,0,1051,504,547
2021,232423,10,0,1051,504,547
2021,232423,10,1,385,222,163
2021,232423,10,2,281,135,146
2021,232423,10,3,223,84,139
2021,232423,10,4,162,63,99
2021,232423,20,0,639,341,298
2021,232423,20,1,382,219,163
2021,232423,20,2,257,122,135
2021,232423,30,0,169,74,95
2021,232423,30,2,8,6,2
2021,232423,30,3,156,66,90
2021,232423,30,4,5,2,3
2021,232423,40,0,243,89,154
2021,232423,40,1,3,3,0
2021,232423,40,2,16,7,9
2021,232423,40,3,67,18,49
2021,232423,40,4,157,61,96
2021,232423,42,0,243,89,154
2021,232423,42,1,3,3,0
2021,232423,42,2,16,7,9
2021,232423,42,3,67,18,49
2021,232423,42,4,157,61,96
2021,232450,0,0,118,45,73
2021,232450,10,0,118,45,73
2021,232450,10,1,38,13,25
2021,232450,10,2,17,5,12
2021,232450,10,3,26,6,20
2021,232450,10,4,36,20,16
2021,232450,10,5,1,1,0
2021,232450,40,0,118,45,73
2021,232450,40,1,38,13,25
2021,232450,40,2,17,5,12
2021,232450,40,3,26,6,20
2021,232450,40,4,36,20,16
2021,232450,40,5,1,1,0
2021,232450,42,0,118,45,73
2021,232450,42,1,38,13,25
2021,232450,42,2,17,5,12
2021,232450,42,3,26,6,20
2021,232450,42,4,36,20,16
2021,232450,42,5,1,1,0
2021,232557,0,0,1187,666,521
2021,232557,10,0,1187,666,521
2021,232557,10,1,213,162,51
2021,232557,10,2,235,140,95
2021,232557,10,3,723,358,365
2021,232557,10,4,16,6,10
2021,232557,20,0,11,9,2
2021,232557,20,1,11,9,2
2021,232557,30,0,2,1,1
2021,232557,30,2,1,1,0
2021,232557,30,3,1,0,1
2021,232557,40,0,1174,656,518
2021,232557,40,1,202,153,49
2021,232557,40,2,234,139,95
2021,232557,40,3,722,358,364
2021,232557,40,4,16,6,10
2021,232557,42,0,1174,656,518
2021,232557,42,1,202,153,49
2021,232557,42,2,234,139,95
2021,232557,42,3,722,358,364
2021,232557,42,4,16,6,10
2021,232566,0,0,253,117,136
2021,232566,10,0,244,117,127
2021,232566,10,1,56,31,25
2021,232566,10,2,79,43,36
2021,232566,10,3,77,29,48
2021,232566,10,4,4,3,1
2021,232566,10,5,28,11,17
2021,232566,20,0,134,73,61
2021,232566,20,1,56,31,25
2021,232566,20,2,78,42,36
2021,232566,30,0,78,30,48
2021,232566,30,2,1,1,0
2021,232566,30,3,77,29,48
2021,232566,40,0,32,14,18
2021,232566,40,4,4,3,1
2021,232566,40,5,28,11,17
2021,232566,41,0,6,1,5
2021,232566,41,5,6,1,5
2021,232566,42,0,26,13,13
2021,232566,42,4,4,3,1
2021,232566,42,5,22,10,12
2021,232566,44,0,6,1,5
2021,232566,44,5,6,1,5
2021,232566,50,0,9,0,9
2021,232575,0,0,64,20,44
2021,232575,10,0,64,20,44
2021,232575,10,1,17,7,10
2021,232575,10,2,18,5,13
2021,232575,10,3,18,3,15
2021,232575,10,4,11,5,6
2021,232575,40,0,64,20,44
2021,232575,40,1,17,7,10
2021,232575,40,2,18,5,13
2021,232575,40,3,18,3,15
2021,232575,40,4,11,5,6
2021,232575,42,0,64,20,44
2021,232575,42,1,17,7,10
2021,232575,42,2,18,5,13
2021,232575,42,3,18,3,15
2021,232575,42,4,11,5,6
2021,232609,0,0,185,88,97
2021,232609,10,0,185,88,97
2021,232609,10,1,50,30,20
2021,232609,10,2,61,28,33
2021,232609,10,3,64,25,39
2021,232609,10,4,10,5,5
2021,232609,20,0,95,52,43
2021,232609,20,1,47,27,20
2021,232609,20,2,46,23,23
2021,232609,20,3,2,2,0
2021,232609,30,0,42,18,24
2021,232609,30,2,4,2,2
2021,232609,30,3,37,16,21
2021,232609,30,4,1,0,1
2021,232609,40,0,48,18,30
2021,232609,40,1,3,3,0
2021,232609,40,2,11,3,8
2021,232609,40,3,25,7,18
2021,232609,40,4,9,5,4
2021,232609,42,0,48,18,30
2021,232609,42,1,3,3,0
2021,232609,42,2,11,3,8
2021,232609,42,3,25,7,18
2021,232609,42,4,9,5,4
2021,232618,0,0,24,1,23
2021,232618,10,0,24,1,23
2021,232618,10,6,24,1,23
2021,232618,40,0,24,1,23
2021,232618,40,6,24,1,23
2021,232618,42,0,7,1,6
2021,232618,42,6,7,1,6
2021,232618,43,0,17,0,17
2021,232618,43,6,17,0,17
2021,232672,0,0,96,28,68
2021,232672,10,0,96,28,68
2021,232672,10,1,12,3,9
2021,232672,10,2,39,8,31
2021,232672,10,3,42,17,25
2021,232672,10,4,3,0,3
2021,232672,20,0,34,10,24
2021,232672,20,1,12,3,9
2021,232672,20,2,21,6,15
2021,232672,20,3,1,1,0
2021,232672,40,0,62,18,44
2021,232672,40,2,18,2,16
2021,232672,40,3,41,16,25
2021,232672,40,4,3,0,3
2021,232672,41,0,62,18,44
2021,232672,41,2,18,2,16
2021,232672,41,3,41,16,25
2021,232672,41,4,3,0,3
2021,232672,44,0,62,18,44
2021,232672,44,2,18,2,16
2021,232672,44,3,41,16,25
2021,232672,44,4,3,0,3
2021,232681,0,0,242,118,124
2021,232681,10,0,242,118,124
2021,232681,10,1,81,39,42
2021,232681,10,2,69,37,32
2021,232681,10,3,57,23,34
2021,232681,10,4,5,2,3
2021,232681,10,5,30,17,13
2021,232681,20,0,148,74,74
2021,232681,20,1,81,39,42
2021,232681,20,2,62,33,29
2021,232681,20,3,5,2,3
2021,232681,30,0,48,17,31
2021,232681,30,2,7,4,3
2021,232681,30,3,40,13,27
2021,232681,30,5,1,0,1
2021,232681,40,0,46,27,19
2021,232681,40,3,12,8,4
2021,232681,40,4,5,2,3
2021,232681,40,5,29,17,12
2021,232681,43,0,46,27,19
2021,232681,43,3,12,8,4
2021,232681,43,4,5,2,3
2021,232681,43,5,29,17,12
2021,232706,0,0,152,42,110
2021,232706,10,0,152,42,110
2021,232706,10,1,44,10,34
2021,232706,10,2,34,18,16
2021,232706,10,3,53,9,44
2021,232706,10,4,21,5,16
2021,232706,20,0,73,25,48
2021,232706,20,1,43,10,33
2021,232706,20,2,30,15,15
2021,232706,30,0,55,11,44
2021,232706,30,2,3,2,1
2021,232706,30,3,52,9,43
2021,232706,40,0,24,6,18
2021,232706,40,1,1,0,1
2021,232706,40,2,1,1,0
2021,232706,40,3,1,0,1
2021,232706,40,4,21,5,16
2021,232706,42,0,24,6,18
2021,232706,42,1,1,0,1
2021,232706,42,2,1,1,0
2021,232706,42,3,1,0,1
2021,232706,42,4,21,5,16
2021,232788,0,0,43,19,24
2021,232788,10,0,43,19,24
2021,232788,10,1,10,4,6
2021,232788,10,2,7,2,5
2021,232788,10,3,13,5,8
2021,232788,10,4,13,8,5
2021,232788,40,0,43,19,24
2021,232788,40,1,10,4,6
2021,232788,40,2,7,2,5
2021,232788,40,3,13,5,8
2021,232788,40,4,13,8,5
2021,232788,41,0,31,14,17
2021,232788,41,1,10,4,6
2021,232788,41,2,7,2,5
2021,232788,41,3,7,4,3
2021,232788,41,4,7,4,3
2021,232788,42,0,12,5,7
2021,232788,42,3,6,1,5
2021,232788,42,4,6,4,2
2021,232788,44,0,31,14,17
2021,232788,44,1,10,4,6
2021,232788,44,2,7,2,5
2021,232788,44,3,7,4,3
2021,232788,44,4,7,4,3
2021,232797,0,0,13,1,12
2021,232797,50,0,13,1,12
2021,232867,0,0,49,26,23
2021,232867,10,0,49,26,23
2021,232867,10,1,18,8,10
2021,232867,10,2,10,7,3
2021,232867,10,3,12,7,5
2021,232867,10,4,9,4,5
2021,232867,40,0,49,26,23
2021,232867,40,1,18,8,10
2021,232867,40,2,10,7,3
2021,232867,40,3,12,7,5
2021,232867,40,4,9,4,5
2021,232867,42,0,49,26,23
2021,232867,42,1,18,8,10
2021,232867,42,2,10,7,3
2021,232867,42,3,12,7,5
2021,232867,42,4,9,4,5
2021,232885,0,0,41,2,39
2021,232885,10,0,41,2,39
2021,232885,10,1,3,0,3
2021,232885,10,2,10,0,10
2021,232885,10,3,23,2,21
2021,232885,10,4,4,0,4
2021,232885,10,5,1,0,1
2021,232885,40,0,41,2,39
2021,232885,40,1,3,0,3
2021,232885,40,2,10,0,10
2021,232885,40,3,23,2,21
2021,232885,40,4,4,0,4
2021,232885,40,5,1,0,1
2021,232885,42,0,41,2,39
2021,232885,42,1,3,0,3
2021,232885,42,2,10,0,10
2021,232885,42,3,23,2,21
2021,232885,42,4,4,0,4
2021,232885,42,5,1,0,1
2021,232937,0,0,228,125,103
2021,232937,10,0,228,125,103
2021,232937,10,1,82,54,28
2021,232937,10,2,57,26,31
2021,232937,10,3,70,37,33
2021,232937,10,4,18,8,10
2021,232937,10,5,1,0,1
2021,232937,20,0,127,76,51
2021,232937,20,1,73,51,22
2021,232937,20,2,48,22,26
2021,232937,20,3,6,3,3
2021,232937,30,0,70,33,37
2021,232937,30,1,6,2,4
2021,232937,30,2,6,2,4
2021,232937,30,3,55,29,26
2021,232937,30,4,2,0,2
2021,232937,30,5,1,0,1
2021,232937,40,0,31,16,15
2021,232937,40,1,3,1,2
2021,232937,40,2,3,2,1
2021,232937,40,3,9,5,4
2021,232937,40,4,16,8,8
2021,232937,42,0,7,6,1
2021,232937,42,1,2,1,1
2021,232937,42,2,1,1,0
2021,232937,42,3,1,1,0
2021,232937,42,4,3,3,0
2021,232937,43,0,24,10,14
2021,232937,43,1,1,0,1
2021,232937,43,2,2,1,1
2021,232937,43,3,8,4,4
2021,232937,43,4,13,5,8
2021,232946,0,0,589,251,338
2021,232946,10,0,589,251,338
2021,232946,10,1,212,100,112
2021,232946,10,2,158,66,92
2021,232946,10,3,125,48,77
2021,232946,10,4,88,35,53
2021,232946,10,5,6,2,4
2021,232946,40,0,589,251,338
2021,232946,40,1,212,100,112
2021,232946,40,2,158,66,92
2021,232946,40,3,125,48,77
2021,232946,40,4,88,35,53
2021,232946,40,5,6,2,4
2021,232946,42,0,589,251,338
2021,232946,42,1,212,100,112
2021,232946,42,2,158,66,92
2021,232946,42,3,125,48,77
2021,232946,42,4,88,35,53
2021,232946,42,5,6,2,4
2021,232982,0,0,867,464,403
2021,232982,10,0,866,464,402
2021,232982,10,1,222,170,52
2021,232982,10,2,216,124,92
2021,232982,10,3,194,85,109
2021,232982,10,4,5,1,4
2021,232982,10,5,229,84,145
2021,232982,20,0,421,283,138
2021,232982,20,1,219,168,51
2021,232982,20,2,202,115,87
2021,232982,30,0,160,80,80
2021,232982,30,1,1,1,0
2021,232982,30,2,11,7,4
2021,232982,30,3,148,72,76
2021,232982,40,0,285,101,184
2021,232982,40,1,2,1,1
2021,232982,40,2,3,2,1
2021,232982,40,3,46,13,33
2021,232982,40,4,5,1,4
2021,232982,40,5,229,84,145
2021,232982,42,0,285,101,184
2021,232982,42,1,2,1,1
2021,232982,42,2,3,2,1
2021,232982,42,3,46,13,33
2021,232982,42,4,5,1,4
2021,232982,42,5,229,84,145
2021,232982,50,0,1,0,1
2021,233019,0,0,44,22,22
2021,233019,10,0,44,22,22
2021,233019,10,1,5,3,2
2021,233019,10,2,15,6,9
2021,233019,10,3,10,4,6
2021,233019,10,4,14,9,5
2021,233019,40,0,44,22,22
2021,233019,40,1,5,3,2
2021,233019,40,2,15,6,9
2021,233019,40,3,10,4,6
2021,233019,40,4,14,9,5
2021,233019,41,0,30,15,15
2021,233019,41,1,4,3,1
2021,233019,41,2,14,6,8
2021,233019,41,3,6,3,3
2021,233019,41,4,6,3,3
2021,233019,42,0,14,7,7
2021,233019,42,1,1,0,1
2021,233019,42,2,1,0,1
2021,233019,42,3,4,1,3
2021,233019,42,4,8,6,2
2021,233019,44,0,30,15,15
2021,233019,44,1,4,3,1
2021,233019,44,2,14,6,8
2021,233019,44,3,6,3,3
2021,233019,44,4,6,3,3
2021,233037,0,0,19,6,13
2021,233037,10,0,19,6,13
2021,233037,10,1,1,1,0
2021,233037,10,2,8,3,5
2021,233037,10,3,7,1,6
2021,233037,10,4,3,1,2
2021,233037,40,0,19,6,13
2021,233037,40,1,1,1,0
2021,233037,40,2,8,3,5
2021,233037,40,3,7,1,6
2021,233037,40,4,3,1,2
2021,233037,42,0,19,6,13
2021,233037,42,1,1,1,0
2021,233037,42,2,8,3,5
2021,233037,42,3,7,1,6
2021,233037,42,4,3,1,2
2021,233082,0,0,8,0,8
2021,233082,10,0,8,0,8
2021,233082,10,6,8,0,8
2021,233082,40,0,8,0,8
2021,233082,40,6,8,0,8
2021,233082,41,0,8,0,8
2021,233082,41,6,8,0,8
2021,233082,45,0,8,0,8
2021,233082,45,6,8,0,8
2021,233116,0,0,77,33,44
2021,233116,10,0,77,33,44
2021,233116,10,1,20,9,11
2021,233116,10,2,31,13,18
2021,233116,10,3,13,4,9
2021,233116,10,4,13,7,6
2021,233116,40,0,77,33,44
2021,233116,40,1,20,9,11
2021,233116,40,2,31,13,18
2021,233116,40,3,13,4,9
2021,233116,40,4,13,7,6
2021,233116,42,0,77,33,44
2021,233116,42,1,20,9,11
2021,233116,42,2,31,13,18
2021,233116,42,3,13,4,9
2021,233116,42,4,13,7,6
2021,233277,0,0,489,217,272
2021,233277,10,0,489,217,272
2021,233277,10,1,155,88,67
2021,233277,10,2,125,55,70
2021,233277,10,3,139,52,87
2021,233277,10,4,70,22,48
2021,233277,20,0,258,133,125
2021,233277,20,1,149,86,63
2021,233277,20,2,106,44,62
2021,233277,20,3,3,3,0
2021,233277,30,0,107,46,61
2021,233277,30,1,3,1,2
2021,233277,30,2,11,6,5
2021,233277,30,3,93,39,54
2021,233277,40,0,124,38,86
2021,233277,40,1,3,1,2
2021,233277,40,2,8,5,3
2021,233277,40,3,43,10,33
2021,233277,40,4,70,22,48
2021,233277,42,0,124,38,86
2021,233277,42,1,3,1,2
2021,233277,42,2,8,5,3
2021,233277,42,3,43,10,33
2021,233277,42,4,70,22,48
2021,233295,0,0,123,54,69
2021,233295,10,0,123,54,69
2021,233295,10,1,47,26,21
2021,233295,10,2,28,12,16
2021,233295,10,3,24,8,16
2021,233295,10,4,16,7,9
2021,233295,10,5,8,1,7
2021,233295,20,0,74,38,36
2021,233295,20,1,47,26,21
2021,233295,20,2,27,12,15
2021,233295,30,0,21,8,13
2021,233295,30,2,1,0,1
2021,233295,30,3,20,8,12
2021,233295,40,0,28,8,20
2021,233295,40,3,4,0,4
2021,233295,40,4,16,7,9
2021,233295,40,5,8,1,7
2021,233295,42,0,28,8,20
2021,233295,42,3,4,0,4
2021,233295,42,4,16,7,9
2021,233295,42,5,8,1,7
2021,233301,0,0,60,20,40
2021,233301,10,0,60,20,40
2021,233301,10,1,23,9,14
2021,233301,10,2,19,7,12
2021,233301,10,3,16,4,12
2021,233301,10,4,2,0,2
2021,233301,20,0,41,16,25
2021,233301,20,1,23,9,14
2021,233301,20,2,18,7,11
2021,233301,30,0,11,4,7
2021,233301,30,3,11,4,7
2021,233301,40,0,8,0,8
2021,233301,40,2,1,0,1
2021,233301,40,3,5,0,5
2021,233301,40,4,2,0,2
2021,233301,41,0,8,0,8
2021,233301,41,2,1,0,1
2021,233301,41,3,5,0,5
2021,233301,41,4,2,0,2
2021,233301,44,0,8,0,8
2021,233301,44,2,1,0,1
2021,233301,44,3,5,0,5
2021,233301,44,4,2,0,2
2021,233310,0,0,31,7,24
2021,233310,10,0,31,7,24
2021,233310,10,1,7,4,3
2021,233310,10,2,8,0,8
2021,233310,10,3,8,2,6
2021,233310,10,4,8,1,7
2021,233310,40,0,31,7,24
2021,233310,40,1,7,4,3
2021,233310,40,2,8,0,8
2021,233310,40,3,8,2,6
2021,233310,40,4,8,1,7
2021,233310,42,0,31,7,24
2021,233310,42,1,7,4,3
2021,233310,42,2,8,0,8
2021,233310,42,3,8,2,6
2021,233310,42,4,8,1,7
2021,233329,0,0,15,3,12
2021,233329,10,0,15,3,12
2021,233329,10,4,15,3,12
2021,233329,40,0,15,3,12
2021,233329,40,4,15,3,12
2021,233329,41,0,15,3,12
2021,233329,41,4,15,3,12
2021,233329,45,0,15,3,12
2021,233329,45,4,15,3,12
2021,233338,0,0,32,14,18
2021,233338,10,0,32,14,18
2021,233338,10,1,9,3,6
2021,233338,10,2,7,4,3
2021,233338,10,3,12,6,6
2021,233338,10,4,4,1,3
2021,233338,20,0,13,4,9
2021,233338,20,1,9,3,6
2021,233338,20,2,4,1,3
2021,233338,40,0,19,10,9
2021,233338,40,2,3,3,0
2021,233338,40,3,12,6,6
2021,233338,40,4,4,1,3
2021,233338,41,0,1,1,0
2021,233338,41,2,1,1,0
2021,233338,42,0,18,9,9
2021,233338,42,2,2,2,0
2021,233338,42,3,12,6,6
2021,233338,42,4,4,1,3
2021,233338,44,0,1,1,0
2021,233338,44,2,1,1,0
2021,233356,0,0,33,4,29
2021,233356,10,0,33,4,29
2021,233356,10,1,1,0,1
2021,233356,10,2,7,3,4
2021,233356,10,3,14,0,14
2021,233356,10,4,11,1,10
2021,233356,40,0,33,4,29
2021,233356,40,1,1,0,1
2021,233356,40,2,7,3,4
2021,233356,40,3,14,0,14
2021,233356,40,4,11,1,10
2021,233356,41,0,2,0,2
2021,233356,41,4,2,0,2
2021,233356,43,0,31,4,27
2021,233356,43,1,1,0,1
2021,233356,43,2,7,3,4
2021,233356,43,3,14,0,14
2021,233356,43,4,9,1,8
2021,233356,45,0,2,0,2
2021,233356,45,4,2,0,2
2021,233374,0,0,425,224,201
2021,233374,10,0,425,224,201
2021,233374,10,1,128,77,51
2021,233374,10,2,137,73,64
2021,233374,10,3,70,29,41
2021,233374,10,4,1,0,1
2021,233374,10,5,1,1,0
2021,233374,10,6,88,44,44
2021,233374,20,0,245,140,105
2021,233374,20,1,115,72,43
2021,233374,20,2,129,68,61
2021,233374,20,3,1,0,1
2021,233374,30,0,69,31,38
2021,233374,30,2,4,3,1
2021,233374,30,3,61,26,35
2021,233374,30,6,4,2,2
2021,233374,40,0,111,53,58
2021,233374,40,1,13,5,8
2021,233374,40,2,4,2,2
2021,233374,40,3,8,3,5
2021,233374,40,4,1,0,1
2021,233374,40,5,1,1,0
2021,233374,40,6,84,42,42
2021,233374,41,0,44,16,28
2021,233374,41,1,11,3,8
2021,233374,41,2,1,0,1
2021,233374,41,3,4,1,3
2021,233374,41,6,28,12,16
2021,233374,42,0,46,26,20
2021,233374,42,1,2,2,0
2021,233374,42,2,2,1,1
2021,233374,42,3,2,2,0
2021,233374,42,4,1,0,1
2021,233374,42,5,1,1,0
2021,233374,42,6,38,20,18
2021,233374,43,0,21,11,10
2021,233374,43,2,1,1,0
2021,233374,43,3,2,0,2
2021,233374,43,6,18,10,8
2021,233374,45,0,44,16,28
2021,233374,45,1,11,3,8
2021,233374,45,2,1,0,1
2021,233374,45,3,4,1,3
2021,233374,45,6,28,12,16
2021,233408,0,0,31,0,31
2021,233408,10,0,31,0,31
2021,233408,10,4,31,0,31
2021,233408,40,0,31,0,31
2021,233408,40,4,31,0,31
2021,233408,41,0,31,0,31
2021,233408,41,4,31,0,31
2021,233408,45,0,31,0,31
2021,233408,45,4,31,0,31
2021,233426,0,0,154,77,77
2021,233426,10,0,154,77,77
2021,233426,10,1,44,24,20
2021,233426,10,2,53,29,24
2021,233426,10,3,16,6,10
2021,233426,10,4,1,1,0
2021,233426,10,6,40,17,23
2021,233426,20,0,95,52,43
2021,233426,20,1,44,24,20
2021,233426,20,2,51,28,23
2021,233426,30,0,19,8,11
2021,233426,30,2,2,1,1
2021,233426,30,3,16,6,10
2021,233426,30,4,1,1,0
2021,233426,40,0,40,17,23
2021,233426,40,6,40,17,23
2021,233426,42,0,40,17,23
2021,233426,42,6,40,17,23
2021,233541,0,0,260,110,150
2021,233541,10,0,260,110,150
2021,233541,10,1,54,26,28
2021,233541,10,2,96,44,52
2021,233541,10,3,88,34,54
2021,233541,10,4,5,1,4
2021,233541,10,5,15,3,12
2021,233541,10,6,2,2,0
2021,233541,40,0,260,110,150
2021,233541,40,1,54,26,28
2021,233541,40,2,96,44,52
2021,233541,40,3,88,34,54
2021,233541,40,4,5,1,4
2021,233541,40,5,15,3,12
2021,233541,40,6,2,2,0
2021,233541,41,0,148,65,83
2021,233541,41,1,52,26,26
2021,233541,41,2,78,33,45
2021,233541,41,3,18,6,12
2021,233541,42,0,112,45,67
2021,233541,42,1,2,0,2
2021,233541,42,2,18,11,7
2021,233541,42,3,70,28,42
2021,233541,42,4,5,1,4
2021,233541,42,5,15,3,12
2021,233541,42,6,2,2,0
2021,233541,44,0,148,65,83
2021,233541,44,1,52,26,26
2021,233541,44,2,78,33,45
2021,233541,44,3,18,6,12
2021,233611,0,0,59,42,17
2021,233611,10,0,59,42,17
2021,233611,10,1,17,11,6
2021,233611,10,2,10,10,0
2021,233611,10,3,24,16,8
2021,233611,10,4,8,5,3
2021,233611,40,0,59,42,17
2021,233611,40,1,17,11,6
2021,233611,40,2,10,10,0
2021,233611,40,3,24,16,8
2021,233611,40,4,8,5,3
2021,233611,41,0,23,17,6
2021,233611,41,1,15,9,6
2021,233611,41,2,8,8,0
2021,233611,42,0,36,25,11
2021,233611,42,1,2,2,0
2021,233611,42,2,2,2,0
2021,233611,42,3,24,16,8
2021,233611,42,4,8,5,3
2021,233611,44,0,23,17,6
2021,233611,44,1,15,9,6
2021,233611,44,2,8,8,0
2021,233639,0,0,47,21,26
2021,233639,10,0,47,21,26
2021,233639,10,1,9,2,7
2021,233639,10,2,13,6,7
2021,233639,10,3,15,8,7
2021,233639,10,4,5,4,1
2021,233639,10,5,5,1,4
2021,233639,40,0,47,21,26
2021,233639,40,1,9,2,7
2021,233639,40,2,13,6,7
2021,233639,40,3,15,8,7
2021,233639,40,4,5,4,1
2021,233639,40,5,5,1,4
2021,233639,42,0,47,21,26
2021,233639,42,1,9,2,7
2021,233639,42,2,13,6,7
2021,233639,42,3,15,8,7
2021,233639,42,4,5,4,1
2021,233639,42,5,5,1,4
2021,233648,0,0,48,19,29
2021,233648,10,0,48,19,29
2021,233648,10,1,3,1,2
2021,233648,10,2,13,4,9
2021,233648,10,3,17,7,10
2021,233648,10,4,14,6,8
2021,233648,10,5,1,1,0
2021,233648,40,0,48,19,29
2021,233648,40,1,3,1,2
2021,233648,40,2,13,4,9
2021,233648,40,3,17,7,10
2021,233648,40,4,14,6,8
2021,233648,40,5,1,1,0
2021,233648,42,0,48,19,29
2021,233648,42,1,3,1,2
2021,233648,42,2,13,4,9
2021,233648,42,3,17,7,10
2021,233648,42,4,14,6,8
2021,233648,42,5,1,1,0
2021,233718,0,0,47,15,32
2021,233718,10,0,47,15,32
2021,233718,10,1,6,3,3
2021,233718,10,2,8,2,6
2021,233718,10,3,24,8,16
2021,233718,10,4,9,2,7
2021,233718,20,0,10,5,5
2021,233718,20,1,5,3,2
2021,233718,20,2,5,2,3
2021,233718,30,0,6,2,4
2021,233718,30,3,6,2,4
2021,233718,40,0,31,8,23
2021,233718,40,1,1,0,1
2021,233718,40,2,3,0,3
2021,233718,40,3,18,6,12
2021,233718,40,4,9,2,7
2021,233718,41,0,24,5,19
2021,233718,41,2,3,0,3
2021,233718,41,3,13,3,10
2021,233718,41,4,8,2,6
2021,233718,42,0,6,3,3
2021,233718,42,1,1,0,1
2021,233718,42,3,5,3,2
2021,233718,43,0,1,0,1
2021,233718,43,4,1,0,1
2021,233718,44,0,24,5,19
2021,233718,44,2,3,0,3
2021,233718,44,3,13,3,10
2021,233718,44,4,8,2,6
2021,233754,0,0,86,32,54
2021,233754,10,0,86,32,54
2021,233754,10,1,17,4,13
2021,233754,10,2,28,8,20
2021,233754,10,3,21,12,9
2021,233754,10,4,20,8,12
2021,233754,40,0,86,32,54
2021,233754,40,1,17,4,13
2021,233754,40,2,28,8,20
2021,233754,40,3,21,12,9
2021,233754,40,4,20,8,12
2021,233754,42,0,86,32,54
2021,233754,42,1,17,4,13
2021,233754,42,2,28,8,20
2021,233754,42,3,21,12,9
2021,233754,42,4,20,8,12
2021,233772,0,0,271,125,146
2021,233772,10,0,271,125,146
2021,233772,10,1,66,28,38
2021,233772,10,2,75,38,37
2021,233772,10,3,62,28,34
2021,233772,10,4,63,28,35
2021,233772,10,5,5,3,2
2021,233772,40,0,271,125,146
2021,233772,40,1,66,28,38
2021,233772,40,2,75,38,37
2021,233772,40,3,62,28,34
2021,233772,40,4,63,28,35
2021,233772,40,5,5,3,2
2021,233772,42,0,271,125,146
2021,233772,42,1,66,28,38
2021,233772,42,2,75,38,37
2021,233772,42,3,62,28,34
2021,233772,42,4,63,28,35
2021,233772,42,5,5,3,2
2021,233842,0,0,25,14,11
2021,233842,10,0,25,14,11
2021,233842,10,1,9,6,3
2021,233842,10,2,8,4,4
2021,233842,10,3,7,4,3
2021,233842,10,4,1,0,1
2021,233842,20,0,13,8,5
2021,233842,20,1,8,5,3
2021,233842,20,2,5,3,2
2021,233842,30,0,5,2,3
2021,233842,30,3,4,2,2
2021,233842,30,4,1,0,1
2021,233842,40,0,7,4,3
2021,233842,40,1,1,1,0
2021,233842,40,2,3,1,2
2021,233842,40,3,3,2,1
2021,233842,41,0,7,4,3
2021,233842,41,1,1,1,0
2021,233842,41,2,3,1,2
2021,233842,41,3,3,2,1
2021,233842,44,0,2,1,1
2021,233842,44,3,2,1,1
2021,233842,45,0,5,3,2
2021,233842,45,1,1,1,0
2021,233842,45,2,3,1,2
2021,233842,45,3,1,1,0
2021,233897,0,0,102,54,48
2021,233897,10,0,102,54,48
2021,233897,10,1,25,16,9
2021,233897,10,2,32,21,11
2021,233897,10,3,18,11,7
2021,233897,10,4,27,6,21
2021,233897,20,0,56,37,19
2021,233897,20,1,25,16,9
2021,233897,20,2,30,20,10
2021,233897,20,3,1,1,0
2021,233897,30,0,18,10,8
2021,233897,30,2,2,1,1
2021,233897,30,3,16,9,7
2021,233897,40,0,28,7,21
2021,233897,40,3,1,1,0
2021,233897,40,4,27,6,21
2021,233897,42,0,28,7,21
2021,233897,42,3,1,1,0
2021,233897,42,4,27,6,21
2021,233903,0,0,38,15,23
2021,233903,10,0,38,15,23
2021,233903,10,1,4,0,4
2021,233903,10,2,15,4,11
2021,233903,10,3,12,7,5
2021,233903,10,4,7,4,3
2021,233903,40,0,38,15,23
2021,233903,40,1,4,0,4
2021,233903,40,2,15,4,11
2021,233903,40,3,12,7,5
2021,233903,40,4,7,4,3
2021,233903,42,0,38,15,23
2021,233903,42,1,4,0,4
2021,233903,42,2,15,4,11
2021,233903,42,3,12,7,5
2021,233903,42,4,7,4,3
2021,233921,0,0,2122,1320,802
2021,233921,10,0,2122,1320,802
2021,233921,10,1,641,493,148
2021,233921,10,2,549,337,212
2021,233921,10,3,588,328,260
2021,233921,10,4,302,138,164
2021,233921,10,5,2,2,0
2021,233921,10,6,40,22,18
2021,233921,20,0,1063,749,314
2021,233921,20,1,607,466,141
2021,233921,20,2,455,282,173
2021,233921,20,3,1,1,0
2021,233921,30,0,428,250,178
2021,233921,30,1,2,2,0
2021,233921,30,2,18,11,7
2021,233921,30,3,408,237,171
2021,233921,40,0,631,321,310
2021,233921,40,1,32,25,7
2021,233921,40,2,76,44,32
2021,233921,40,3,179,90,89
2021,233921,40,4,302,138,164
2021,233921,40,5,2,2,0
2021,233921,40,6,40,22,18
2021,233921,42,0,631,321,310
2021,233921,42,1,32,25,7
2021,233921,42,2,76,44,32
2021,233921,42,3,179,90,89
2021,233921,42,4,302,138,164
2021,233921,42,5,2,2,0
2021,233921,42,6,40,22,18
2021,233949,0,0,77,33,44
2021,233949,10,0,77,33,44
2021,233949,10,1,16,7,9
2021,233949,10,2,25,9,16
2021,233949,10,3,21,9,12
2021,233949,10,4,15,8,7
2021,233949,40,0,77,33,44
2021,233949,40,1,16,7,9
2021,233949,40,2,25,9,16
2021,233949,40,3,21,9,12
2021,233949,40,4,15,8,7
2021,233949,42,0,77,33,44
2021,233949,42,1,16,7,9
2021,233949,42,2,25,9,16
2021,233949,42,3,21,9,12
2021,233949,42,4,15,8,7
2021,234030,0,0,2155,1192,963
2021,234030,10,0,2155,1192,963
2021,234030,10,1,478,345,133
2021,234030,10,2,687,364,323
2021,234030,10,3,855,415,440
2021,234030,10,4,135,68,67
2021,234030,20,0,707,452,255
2021,234030,20,1,353,265,88
2021,234030,20,2,348,184,164
2021,234030,20,3,6,3,3
2021,234030,30,0,247,129,118
2021,234030,30,1,14,6,8
2021,234030,30,2,22,15,7
2021,234030,30,3,211,108,103
2021,234030,40,0,1201,611,590
2021,234030,40,1,111,74,37
2021,234030,40,2,317,165,152
2021,234030,40,3,638,304,334
2021,234030,40,4,135,68,67
2021,234030,42,0,1201,611,590
2021,234030,42,1,111,74,37
2021,234030,42,2,317,165,152
2021,234030,42,3,638,304,334
2021,234030,42,4,135,68,67
2021,234076,0,0,2479,1495,984
2021,234076,10,0,2479,1495,984
2021,234076,10,1,848,617,231
2021,234076,10,2,761,430,331
2021,234076,10,3,746,389,357
2021,234076,10,4,39,30,9
2021,234076,10,5,85,29,56
2021,234076,20,0,1114,778,336
2021,234076,20,1,727,542,185
2021,234076,20,2,387,236,151
2021,234076,30,0,366,210,156
2021,234076,30,2,65,35,30
2021,234076,30,3,301,175,126
2021,234076,40,0,999,507,492
2021,234076,40,1,121,75,46
2021,234076,40,2,309,159,150
2021,234076,40,3,445,214,231
2021,234076,40,4,39,30,9
2021,234076,40,5,85,29,56
2021,234076,41,0,888,438,450
2021,234076,41,1,119,73,46
2021,234076,41,2,304,156,148
2021,234076,41,3,404,185,219
2021,234076,41,4,7,5,2
2021,234076,41,5,54,19,35
2021,234076,42,0,109,69,40
2021,234076,42,1,2,2,0
2021,234076,42,2,5,3,2
2021,234076,42,3,40,29,11
2021,234076,42,4,31,25,6
2021,234076,42,5,31,10,21
2021,234076,43,0,2,0,2
2021,234076,43,3,1,0,1
2021,234076,43,4,1,0,1
2021,234076,44,0,888,438,450
2021,234076,44,1,119,73,46
2021,234076,44,2,304,156,148
2021,234076,44,3,404,185,219
2021,234076,44,4,7,5,2
2021,234076,44,5,54,19,35
2021,234085,0,0,148,95,53
2021,234085,10,0,147,94,53
2021,234085,10,1,65,51,14
2021,234085,10,2,24,11,13
2021,234085,10,3,47,26,21
2021,234085,10,4,5,2,3
2021,234085,10,5,5,3,2
2021,234085,10,6,1,1,0
2021,234085,20,0,68,53,15
2021,234085,20,1,61,48,13
2021,234085,20,2,7,5,2
2021,234085,30,0,47,23,24
2021,234085,30,1,1,1,0
2021,234085,30,2,16,6,10
2021,234085,30,3,30,16,14
2021,234085,40,0,32,18,14
2021,234085,40,1,3,2,1
2021,234085,40,2,1,0,1
2021,234085,40,3,17,10,7
2021,234085,40,4,5,2,3
2021,234085,40,5,5,3,2
2021,234085,40,6,1,1,0
2021,234085,42,0,32,18,14
2021,234085,42,1,3,2,1
2021,234085,42,2,1,0,1
2021,234085,42,3,17,10,7
2021,234085,42,4,5,2,3
2021,234085,42,5,5,3,2
2021,234085,42,6,1,1,0
2021,234085,50,0,1,1,0
2021,234137,0,0,5,5,0
2021,234137,10,0,5,5,0
2021,234137,10,1,4,4,0
2021,234137,10,4,1,1,0
2021,234137,40,0,5,5,0
2021,234137,40,1,4,4,0
2021,234137,40,4,1,1,0
2021,234137,41,0,5,5,0
2021,234137,41,1,4,4,0
2021,234137,41,4,1,1,0
2021,234137,45,0,5,5,0
2021,234137,45,1,4,4,0
2021,234137,45,4,1,1,0
2021,234155,0,0,265,144,121
2021,234155,10,0,265,144,121
2021,234155,10,1,61,41,20
2021,234155,10,2,81,46,35
2021,234155,10,3,87,47,40
2021,234155,10,4,36,10,26
2021,234155,20,0,124,75,49
2021,234155,20,1,58,38,20
2021,234155,20,2,65,36,29
2021,234155,20,3,1,1,0
2021,234155,30,0,39,14,25
2021,234155,30,2,9,4,5
2021,234155,30,3,30,10,20
2021,234155,40,0,102,55,47
2021,234155,40,1,3,3,0
2021,234155,40,2,7,6,1
2021,234155,40,3,56,36,20
2021,234155,40,4,36,10,26
2021,234155,42,0,102,55,47
2021,234155,42,1,3,3,0
2021,234155,42,2,7,6,1
2021,234155,42,3,56,36,20
2021,234155,42,4,36,10,26
2021,234164,0,0,53,32,21
2021,234164,10,0,49,31,18
2021,234164,10,1,8,8,0
2021,234164,10,2,18,12,6
2021,234164,10,3,22,11,11
2021,234164,10,6,1,0,1
2021,234164,20,0,16,12,4
2021,234164,20,1,8,8,0
2021,234164,20,2,4,3,1
2021,234164,20,3,4,1,3
2021,234164,30,0,32,19,13
2021,234164,30,2,14,9,5
2021,234164,30,3,18,10,8
2021,234164,40,0,1,0,1
2021,234164,40,6,1,0,1
2021,234164,41,0,1,0,1
2021,234164,41,6,1,0,1
2021,234164,44,0,1,0,1
2021,234164,44,6,1,0,1
2021,234164,50,0,4,1,3
2021,234173,0,0,87,44,43
2021,234173,10,0,87,44,43
2021,234173,10,1,43,20,23
2021,234173,10,2,28,17,11
2021,234173,10,3,12,5,7
2021,234173,10,4,4,2,2
2021,234173,20,0,71,37,34
2021,234173,20,1,43,20,23
2021,234173,20,2,28,17,11
2021,234173,30,0,12,5,7
2021,234173,30,3,12,5,7
2021,234173,40,0,4,2,2
2021,234173,40,4,4,2,2
2021,234173,42,0,4,2,2
2021,234173,42,4,4,2,2
2021,234207,0,0,245,134,111
2021,234207,10,0,245,134,111
2021,234207,10,1,103,69,34
2021,234207,10,2,55,29,26
2021,234207,10,3,70,27,43
2021,234207,10,4,11,6,5
2021,234207,10,5,6,3,3
2021,234207,20,0,150,94,56
2021,234207,20,1,101,67,34
2021,234207,20,2,49,27,22
2021,234207,30,0,47,20,27
2021,234207,30,2,4,2,2
2021,234207,30,3,43,18,25
2021,234207,40,0,48,20,28
2021,234207,40,1,2,2,0
2021,234207,40,2,2,0,2
2021,234207,40,3,27,9,18
2021,234207,40,4,11,6,5
2021,234207,40,5,6,3,3
2021,234207,41,0,13,6,7
2021,234207,41,3,3,2,1
2021,234207,41,4,7,4,3
2021,234207,41,5,3,0,3
2021,234207,42,0,35,14,21
2021,234207,42,1,2,2,0
2021,234207,42,2,2,0,2
2021,234207,42,3,24,7,17
2021,234207,42,4,4,2,2
2021,234207,42,5,3,3,0
2021,234207,44,0,13,6,7
2021,234207,44,3,3,2,1
2021,234207,44,4,7,4,3
2021,234207,44,5,3,0,3
2021,234377,0,0,30,8,22
2021,234377,10,0,30,8,22
2021,234377,10,1,3,1,2
2021,234377,10,2,10,2,8
2021,234377,10,3,12,2,10
2021,234377,10,4,5,3,2
2021,234377,40,0,30,8,22
2021,234377,40,1,3,1,2
2021,234377,40,2,10,2,8
2021,234377,40,3,12,2,10
2021,234377,40,4,5,3,2
2021,234377,42,0,30,8,22
2021,234377,42,1,3,1,2
2021,234377,42,2,10,2,8
2021,234377,42,3,12,2,10
2021,234377,42,4,5,3,2
2021,234669,0,0,199,85,114
2021,234669,10,0,199,85,114
2021,234669,10,1,46,18,28
2021,234669,10,2,113,54,59
2021,234669,10,3,35,13,22
2021,234669,10,4,5,0,5
2021,234669,20,0,153,68,85
2021,234669,20,1,46,18,28
2021,234669,20,2,107,50,57
2021,234669,30,0,35,13,22
2021,234669,30,3,35,13,22
2021,234669,40,0,11,4,7
2021,234669,40,2,6,4,2
2021,234669,40,4,5,0,5
2021,234669,42,0,10,4,6
2021,234669,42,2,6,4,2
2021,234669,42,4,4,0,4
2021,234669,43,0,1,0,1
2021,234669,43,4,1,0,1
2021,234696,0,0,70,34,36
2021,234696,10,0,70,34,36
2021,234696,10,4,70,34,36
2021,234696,20,0,41,22,19
2021,234696,20,4,41,22,19
2021,234696,30,0,10,4,6
2021,234696,30,4,10,4,6
2021,234696,40,0,19,8,11
2021,234696,40,4,19,8,11
2021,234696,42,0,19,8,11
2021,234696,42,4,19,8,11
2021,234711,0,0,46,27,19
2021,234711,10,0,46,27,19
2021,234711,10,4,46,27,19
2021,234711,20,0,32,20,12
2021,234711,20,4,32,20,12
2021,234711,30,0,14,7,7
2021,234711,30,4,14,7,7
2021,234827,0,0,465,244,221
2021,234827,10,0,448,229,219
2021,234827,10,1,153,95,58
2021,234827,10,2,111,56,55
2021,234827,10,3,57,28,29
2021,234827,10,5,127,50,77
2021,234827,20,0,264,151,113
2021,234827,20,1,153,95,58
2021,234827,20,2,111,56,55
2021,234827,30,0,57,28,29
2021,234827,30,3,57,28,29
2021,234827,40,0,127,50,77
2021,234827,40,5,127,50,77
2021,234827,42,0,109,44,65
2021,234827,42,5,109,44,65
2021,234827,43,0,18,6,12
2021,234827,43,5,18,6,12
2021,234827,50,0,17,15,2
2021,234845,0,0,64,25,39
2021,234845,10,0,64,25,39
2021,234845,10,4,64,25,39
2021,234845,20,0,40,14,26
2021,234845,20,4,40,14,26
2021,234845,30,0,14,8,6
2021,234845,30,4,14,8,6
2021,234845,40,0,10,3,7
2021,234845,40,4,10,3,7
2021,234845,42,0,10,3,7
2021,234845,42,4,10,3,7
2021,234915,0,0,28,13,15
2021,234915,10,0,28,13,15
2021,234915,10,6,28,13,15
2021,234915,40,0,28,13,15
2021,234915,40,6,28,13,15
2021,234915,41,0,28,13,15
2021,234915,41,6,28,13,15
2021,234915,45,0,28,13,15
2021,234915,45,6,28,13,15
2021,234933,0,0,172,68,104
2021,234933,10,0,172,68,104
2021,234933,10,4,172,68,104
2021,234933,20,0,120,47,73
2021,234933,20,4,120,47,73
2021,234933,30,0,26,9,17
2021,234933,30,4,26,9,17
2021,234933,40,0,26,12,14
2021,234933,40,4,26,12,14
2021,234933,42,0,26,12,14
2021,234933,42,4,26,12,14
2021,234951,0,0,95,46,49
2021,234951,10,0,95,46,49
2021,234951,10,4,89,42,47
2021,234951,10,6,6,4,2
2021,234951,20,0,69,31,38
2021,234951,20,4,65,29,36
2021,234951,20,6,4,2,2
2021,234951,30,0,19,11,8
2021,234951,30,4,19,11,8
2021,234951,40,0,7,4,3
2021,234951,40,4,5,2,3
2021,234951,40,6,2,2,0
2021,234951,42,0,7,4,3
2021,234951,42,4,5,2,3
2021,234951,42,6,2,2,0
2021,234979,0,0,130,62,68
2021,234979,10,0,130,62,68
2021,234979,10,6,130,62,68
2021,234979,20,0,94,46,48
2021,234979,20,6,94,46,48
2021,234979,30,0,26,10,16
2021,234979,30,6,26,10,16
2021,234979,40,0,10,6,4
2021,234979,40,6,10,6,4
2021,234979,42,0,10,6,4
2021,234979,42,6,10,6,4
2021,235024,0,0,38,14,24
2021,235024,10,0,38,14,24
2021,235024,10,1,15,5,10
2021,235024,10,2,12,3,9
2021,235024,10,3,11,6,5
2021,235024,40,0,38,14,24
2021,235024,40,1,15,5,10
2021,235024,40,2,12,3,9
2021,235024,40,3,11,6,5
2021,235024,41,0,28,10,18
2021,235024,41,1,15,5,10
2021,235024,41,2,9,3,6
2021,235024,41,3,4,2,2
2021,235024,42,0,10,4,6
2021,235024,42,2,3,0,3
2021,235024,42,3,7,4,3
2021,235024,44,0,28,10,18
2021,235024,44,1,15,5,10
2021,235024,44,2,9,3,6
2021,235024,44,3,4,2,2
2021,235097,0,0,414,212,202
2021,235097,10,0,414,212,202
2021,235097,10,1,143,88,55
2021,235097,10,2,73,41,32
2021,235097,10,3,53,22,31
2021,235097,10,5,145,61,84
2021,235097,20,0,216,129,87
2021,235097,20,1,143,88,55
2021,235097,20,2,73,41,32
2021,235097,30,0,53,22,31
2021,235097,30,3,53,22,31
2021,235097,40,0,145,61,84
2021,235097,40,5,145,61,84
2021,235097,41,0,53,24,29
2021,235097,41,5,53,24,29
2021,235097,42,0,92,37,55
2021,235097,42,5,92,37,55
2021,235097,44,0,53,24,29
2021,235097,44,5,53,24,29
2021,235103,0,0,106,46,60
2021,235103,10,0,106,46,60
2021,235103,10,4,106,46,60
2021,235103,20,0,91,43,48
2021,235103,20,4,91,43,48
2021,235103,30,0,7,2,5
2021,235103,30,4,7,2,5
2021,235103,40,0,8,1,7
2021,235103,40,4,8,1,7
2021,235103,42,0,8,1,7
2021,235103,42,4,8,1,7
2021,235149,0,0,125,56,69
2021,235149,10,0,125,56,69
2021,235149,10,6,125,56,69
2021,235149,20,0,91,40,51
2021,235149,20,6,91,40,51
2021,235149,30,0,23,11,12
2021,235149,30,6,23,11,12
2021,235149,40,0,11,5,6
2021,235149,40,6,11,5,6
2021,235149,42,0,10,5,5
2021,235149,42,6,10,5,5
2021,235149,43,0,1,0,1
2021,235149,43,6,1,0,1
2021,235167,0,0,120,51,69
2021,235167,10,0,120,51,69
2021,235167,10,6,120,51,69
2021,235167,40,0,120,51,69
2021,235167,40,6,120,51,69
2021,235167,41,0,115,50,65
2021,235167,41,6,115,50,65
2021,235167,43,0,5,1,4
2021,235167,43,6,5,1,4
2021,235167,44,0,115,50,65
2021,235167,44,6,115,50,65
2021,235237,0,0,135,53,82
2021,235237,10,0,135,53,82
2021,235237,10,4,135,53,82
2021,235237,20,0,94,40,54
2021,235237,20,4,94,40,54
2021,235237,30,0,30,10,20
2021,235237,30,4,30,10,20
2021,235237,40,0,11,3,8
2021,235237,40,4,11,3,8
2021,235237,42,0,11,3,8
2021,235237,42,4,11,3,8
2021,235316,0,0,454,254,200
2021,235316,10,0,454,254,200
2021,235316,10,1,135,87,48
2021,235316,10,2,145,79,66
2021,235316,10,3,151,81,70
2021,235316,10,5,23,7,16
2021,235316,20,0,234,144,90
2021,235316,20,1,131,85,46
2021,235316,20,2,100,56,44
2021,235316,20,3,3,3,0
2021,235316,30,0,121,63,58
2021,235316,30,1,3,1,2
2021,235316,30,2,31,18,13
2021,235316,30,3,87,44,43
2021,235316,40,0,99,47,52
2021,235316,40,1,1,1,0
2021,235316,40,2,14,5,9
2021,235316,40,3,61,34,27
2021,235316,40,5,23,7,16
2021,235316,41,0,44,19,25
2021,235316,41,1,1,1,0
2021,235316,41,2,14,5,9
2021,235316,41,3,20,10,10
2021,235316,41,5,9,3,6
2021,235316,42,0,55,28,27
2021,235316,42,3,41,24,17
2021,235316,42,5,14,4,10
2021,235316,44,0,44,19,25
2021,235316,44,1,1,1,0
2021,235316,44,2,14,5,9
2021,235316,44,3,20,10,10
2021,235316,44,5,9,3,6
2021,235334,0,0,58,35,23
2021,235334,10,0,58,35,23
2021,235334,10,3,58,35,23
2021,235334,20,0,43,25,18
2021,235334,20,3,43,25,18
2021,235334,30,0,8,5,3
2021,235334,30,3,8,5,3
2021,235334,40,0,7,5,2
2021,235334,40,3,7,5,2
2021,235334,42,0,7,5,2
2021,235334,42,3,7,5,2
2021,235343,0,0,168,88,80
2021,235343,10,0,168,88,80
2021,235343,10,4,168,88,80
2021,235343,20,0,128,71,57
2021,235343,20,4,128,71,57
2021,235343,30,0,35,15,20
2021,235343,30,4,35,15,20
2021,235343,40,0,5,2,3
2021,235343,40,4,5,2,3
2021,235343,42,0,5,2,3
2021,235343,42,4,5,2,3
2021,235422,0,0,53,23,30
2021,235422,10,0,53,23,30
2021,235422,10,1,7,5,2
2021,235422,10,2,21,13,8
2021,235422,10,3,21,4,17
2021,235422,10,4,4,1,3
2021,235422,40,0,53,23,30
2021,235422,40,1,7,5,2
2021,235422,40,2,21,13,8
2021,235422,40,3,21,4,17
2021,235422,40,4,4,1,3
2021,235422,41,0,9,4,5
2021,235422,41,1,4,2,2
2021,235422,41,2,4,2,2
2021,235422,41,3,1,0,1
2021,235422,42,0,44,19,25
2021,235422,42,1,3,3,0
2021,235422,42,2,17,11,6
2021,235422,42,3,20,4,16
2021,235422,42,4,4,1,3
2021,235422,44,0,9,4,5
2021,235422,44,1,4,2,2
2021,235422,44,2,4,2,2
2021,235422,44,3,1,0,1
2021,235431,0,0,156,57,99
2021,235431,10,0,156,57,99
2021,235431,10,4,156,57,99
2021,235431,20,0,98,37,61
2021,235431,20,4,98,37,61
2021,235431,30,0,30,8,22
2021,235431,30,4,30,8,22
2021,235431,40,0,28,12,16
2021,235431,40,4,28,12,16
2021,235431,42,0,28,12,16
2021,235431,42,4,28,12,16
2021,235547,0,0,29,6,23
2021,235547,10,0,29,6,23
2021,235547,10,1,7,3,4
2021,235547,10,2,10,2,8
2021,235547,10,3,12,1,11
2021,235547,40,0,29,6,23
2021,235547,40,1,7,3,4
2021,235547,40,2,10,2,8
2021,235547,40,3,12,1,11
2021,235547,41,0,9,2,7
2021,235547,41,1,2,1,1
2021,235547,41,2,6,1,5
2021,235547,41,3,1,0,1
2021,235547,42,0,20,4,16
2021,235547,42,1,5,2,3
2021,235547,42,2,4,1,3
2021,235547,42,3,11,1,10
2021,235547,44,0,9,2,7
2021,235547,44,1,2,1,1
2021,235547,44,2,6,1,5
2021,235547,44,3,1,0,1
2021,235671,0,0,70,41,29
2021,235671,10,0,70,41,29
2021,235671,10,4,66,39,27
2021,235671,10,6,4,2,2
2021,235671,20,0,44,22,22
2021,235671,20,4,42,21,21
2021,235671,20,6,2,1,1
2021,235671,30,0,8,7,1
2021,235671,30,4,8,7,1
2021,235671,40,0,18,12,6
2021,235671,40,4,16,11,5
2021,235671,40,6,2,1,1
2021,235671,42,0,18,12,6
2021,235671,42,4,16,11,5
2021,235671,42,6,2,1,1
2021,235699,0,0,80,27,53
2021,235699,10,0,80,27,53
2021,235699,10,6,80,27,53
2021,235699,20,0,39,16,23
2021,235699,20,6,39,16,23
2021,235699,30,0,17,5,12
2021,235699,30,6,17,5,12
2021,235699,40,0,24,6,18
2021,235699,40,6,24,6,18
2021,235699,42,0,24,6,18
2021,235699,42,6,24,6,18
2021,235750,0,0,70,30,40
2021,235750,10,0,70,30,40
2021,235750,10,4,70,30,40
2021,235750,20,0,57,26,31
2021,235750,20,4,57,26,31
2021,235750,30,0,12,4,8
2021,235750,30,4,12,4,8
2021,235750,40,0,1,0,1
2021,235750,40,4,1,0,1
2021,235750,42,0,1,0,1
2021,235750,42,4,1,0,1
2021,236072,0,0,81,33,48
2021,236072,10,0,81,33,48
2021,236072,10,4,81,33,48
2021,236072,20,0,68,27,41
2021,236072,20,4,68,27,41
2021,236072,30,0,1,0,1
2021,236072,30,4,1,0,1
2021,236072,40,0,12,6,6
2021,236072,40,4,12,6,6
2021,236072,42,0,12,6,6
2021,236072,42,4,12,6,6
2021,236133,0,0,57,25,32
2021,236133,10,0,57,25,32
2021,236133,10,1,12,7,5
2021,236133,10,2,23,11,12
2021,236133,10,3,20,7,13
2021,236133,10,4,2,0,2
2021,236133,20,0,25,13,12
2021,236133,20,1,11,6,5
2021,236133,20,2,14,7,7
2021,236133,30,0,30,12,18
2021,236133,30,1,1,1,0
2021,236133,30,2,9,4,5
2021,236133,30,3,20,7,13
2021,236133,40,0,2,0,2
2021,236133,40,4,2,0,2
2021,236133,42,0,2,0,2
2021,236133,42,4,2,0,2
2021,236188,0,0,125,54,71
2021,236188,10,0,125,54,71
2021,236188,10,4,125,54,71
2021,236188,20,0,93,44,49
2021,236188,20,4,93,44,49
2021,236188,30,0,23,9,14
2021,236188,30,4,23,9,14
2021,236188,40,0,9,1,8
2021,236188,40,4,9,1,8
2021,236188,42,0,9,1,8
2021,236188,42,4,9,1,8
2021,236212,0,0,50,44,6
2021,236212,10,0,50,44,6
2021,236212,10,4,50,44,6
2021,236212,40,0,50,44,6
2021,236212,40,4,50,44,6
2021,236212,41,0,50,44,6
2021,236212,41,4,50,44,6
2021,236212,45,0,50,44,6
2021,236212,45,4,50,44,6
2021,236230,0,0,189,82,107
2021,236230,10,0,189,82,107
2021,236230,10,1,49,30,19
2021,236230,10,2,69,23,46
2021,236230,10,3,57,28,29
2021,236230,10,4,14,1,13
2021,236230,20,0,120,54,66
2021,236230,20,1,49,30,19
2021,236230,20,2,68,22,46
2021,236230,20,3,3,2,1
2021,236230,30,0,31,14,17
2021,236230,30,2,1,1,0
2021,236230,30,3,30,13,17
2021,236230,40,0,38,14,24
2021,236230,40,3,24,13,11
2021,236230,40,4,14,1,13
2021,236230,41,0,1,1,0
2021,236230,41,3,1,1,0
2021,236230,42,0,34,12,22
2021,236230,42,3,22,12,10
2021,236230,42,4,12,0,12
2021,236230,43,0,3,1,2
2021,236230,43,3,1,0,1
2021,236230,43,4,2,1,1
2021,236230,44,0,1,1,0
2021,236230,44,3,1,1,0
2021,236258,0,0,45,23,22
2021,236258,10,0,45,23,22
2021,236258,10,4,45,23,22
2021,236258,20,0,22,11,11
2021,236258,20,4,22,11,11
2021,236258,30,0,9,4,5
2021,236258,30,4,9,4,5
2021,236258,40,0,14,8,6
2021,236258,40,4,14,8,6
2021,236258,42,0,14,8,6
2021,236258,42,4,14,8,6
2021,236328,0,0,214,97,117
2021,236328,10,0,214,97,117
2021,236328,10,1,117,62,55
2021,236328,10,2,38,17,21
2021,236328,10,3,47,14,33
2021,236328,10,4,12,4,8
2021,236328,20,0,137,73,64
2021,236328,20,1,113,60,53
2021,236328,20,2,24,13,11
2021,236328,30,0,35,11,24
2021,236328,30,1,2,0,2
2021,236328,30,2,8,4,4
2021,236328,30,3,25,7,18
2021,236328,40,0,42,13,29
2021,236328,40,1,2,2,0
2021,236328,40,2,6,0,6
2021,236328,40,3,22,7,15
2021,236328,40,4,12,4,8
2021,236328,41,0,3,1,2
2021,236328,41,3,3,1,2
2021,236328,42,0,39,12,27
2021,236328,42,1,2,2,0
2021,236328,42,2,6,0,6
2021,236328,42,3,19,6,13
2021,236328,42,4,12,4,8
2021,236328,44,0,3,1,2
2021,236328,44,3,3,1,2
2021,236382,0,0,64,31,33
2021,236382,10,0,64,31,33
2021,236382,10,4,64,31,33
2021,236382,20,0,44,21,23
2021,236382,20,4,44,21,23
2021,236382,30,0,13,7,6
2021,236382,30,4,13,7,6
2021,236382,40,0,7,3,4
2021,236382,40,4,7,3,4
2021,236382,42,0,7,3,4
2021,236382,42,4,7,3,4
2021,236452,0,0,98,48,50
2021,236452,10,0,98,48,50
2021,236452,10,1,25,15,10
2021,236452,10,2,25,11,14
2021,236452,10,3,35,17,18
2021,236452,10,4,13,5,8
2021,236452,20,0,48,25,23
2021,236452,20,1,25,15,10
2021,236452,20,2,23,10,13
2021,236452,30,0,34,17,17
2021,236452,30,2,2,1,1
2021,236452,30,3,32,16,16
2021,236452,40,0,16,6,10
2021,236452,40,3,3,1,2
2021,236452,40,4,13,5,8
2021,236452,42,0,9,4,5
2021,236452,42,4,9,4,5
2021,236452,43,0,7,2,5
2021,236452,43,3,3,1,2
2021,236452,43,4,4,1,3
2021,236504,0,0,64,33,31
2021,236504,10,0,64,33,31
2021,236504,10,4,64,33,31
2021,236504,20,0,47,25,22
2021,236504,20,4,47,25,22
2021,236504,40,0,17,8,9
2021,236504,40,4,17,8,9
2021,236504,42,0,17,8,9
2021,236504,42,4,17,8,9
2021,236513,0,0,139,54,85
2021,236513,10,0,139,54,85
2021,236513,10,4,139,54,85
2021,236513,20,0,97,41,56
2021,236513,20,4,97,41,56
2021,236513,40,0,42,13,29
2021,236513,40,4,42,13,29
2021,236513,42,0,42,13,29
2021,236513,42,4,42,13,29
2021,236577,0,0,209,101,108
2021,236577,10,0,209,101,108
2021,236577,10,1,65,40,25
2021,236577,10,2,65,27,38
2021,236577,10,3,71,32,39
2021,236577,10,4,8,2,6
2021,236577,20,0,111,62,49
2021,236577,20,1,62,38,24
2021,236577,20,2,46,23,23
2021,236577,20,3,3,1,2
2021,236577,30,0,59,26,33
2021,236577,30,2,14,2,12
2021,236577,30,3,45,24,21
2021,236577,40,0,39,13,26
2021,236577,40,1,3,2,1
2021,236577,40,2,5,2,3
2021,236577,40,3,23,7,16
2021,236577,40,4,8,2,6
2021,236577,41,0,27,10,17
2021,236577,41,1,1,1,0
2021,236577,41,2,5,2,3
2021,236577,41,3,16,6,10
2021,236577,41,4,5,1,4
2021,236577,42,0,12,3,9
2021,236577,42,1,2,1,1
2021,236577,42,3,7,1,6
2021,236577,42,4,3,1,2
2021,236577,44,0,27,10,17
2021,236577,44,1,1,1,0
2021,236577,44,2,5,2,3
2021,236577,44,3,16,6,10
2021,236577,44,4,5,1,4
2021,236595,0,0,522,233,289
2021,236595,10,0,522,233,289
2021,236595,10,1,115,60,55
2021,236595,10,2,156,79,77
2021,236595,10,3,88,32,56
2021,236595,10,4,101,35,66
2021,236595,10,5,57,23,34
2021,236595,10,6,5,4,1
2021,236595,20,0,256,137,119
2021,236595,20,1,106,56,50
2021,236595,20,2,147,79,68
2021,236595,20,3,3,2,1
2021,236595,30,0,64,29,35
2021,236595,30,1,2,2,0
2021,236595,30,2,3,0,3
2021,236595,30,3,59,27,32
2021,236595,40,0,202,67,135
2021,236595,40,1,7,2,5
2021,236595,40,2,6,0,6
2021,236595,40,3,26,3,23
2021,236595,40,4,101,35,66
2021,236595,40,5,57,23,34
2021,236595,40,6,5,4,1
2021,236595,42,0,202,67,135
2021,236595,42,1,7,2,5
2021,236595,42,2,6,0,6
2021,236595,42,3,26,3,23
2021,236595,42,4,101,35,66
2021,236595,42,5,57,23,34
2021,236595,42,6,5,4,1
2021,236610,0,0,119,43,76
2021,236610,10,0,119,43,76
2021,236610,10,6,119,43,76
2021,236610,20,0,83,32,51
2021,236610,20,6,83,32,51
2021,236610,30,0,13,7,6
2021,236610,30,6,13,7,6
2021,236610,40,0,23,4,19
2021,236610,40,6,23,4,19
2021,236610,42,0,23,4,19
2021,236610,42,6,23,4,19
2021,236638,0,0,89,36,53
2021,236638,10,0,89,36,53
2021,236638,10,6,89,36,53
2021,236638,20,0,57,23,34
2021,236638,20,6,57,23,34
2021,236638,30,0,26,11,15
2021,236638,30,6,26,11,15
2021,236638,40,0,6,2,4
2021,236638,40,6,6,2,4
2021,236638,42,0,6,2,4
2021,236638,42,6,6,2,4
2021,236656,0,0,93,40,53
2021,236656,10,0,93,40,53
2021,236656,10,6,93,40,53
2021,236656,20,0,73,36,37
2021,236656,20,6,73,36,37
2021,236656,30,0,19,4,15
2021,236656,30,6,19,4,15
2021,236656,40,0,1,0,1
2021,236656,40,6,1,0,1
2021,236656,42,0,1,0,1
2021,236656,42,6,1,0,1
2021,236692,0,0,198,97,101
2021,236692,10,0,198,97,101
2021,236692,10,4,198,97,101
2021,236692,20,0,153,77,76
2021,236692,20,4,153,77,76
2021,236692,30,0,25,11,14
2021,236692,30,4,25,11,14
2021,236692,40,0,20,9,11
2021,236692,40,4,20,9,11
2021,236692,42,0,20,9,11
2021,236692,42,4,20,9,11
2021,236708,0,0,127,58,69
2021,236708,10,0,127,58,69
2021,236708,10,4,127,58,69
2021,236708,20,0,104,48,56
2021,236708,20,4,104,48,56
2021,236708,30,0,8,4,4
2021,236708,30,4,8,4,4
2021,236708,40,0,15,6,9
2021,236708,40,4,15,6,9
2021,236708,42,0,15,6,9
2021,236708,42,4,15,6,9
2021,236753,0,0,137,62,75
2021,236753,10,0,137,62,75
2021,236753,10,4,137,62,75
2021,236753,20,0,101,46,55
2021,236753,20,4,101,46,55
2021,236753,30,0,15,7,8
2021,236753,30,4,15,7,8
2021,236753,40,0,21,9,12
2021,236753,40,4,21,9,12
2021,236753,42,0,21,9,12
2021,236753,42,4,21,9,12
2021,236887,0,0,106,58,48
2021,236887,10,0,106,58,48
2021,236887,10,6,106,58,48
2021,236887,20,0,63,32,31
2021,236887,20,6,63,32,31
2021,236887,30,0,9,2,7
2021,236887,30,6,9,2,7
2021,236887,40,0,34,24,10
2021,236887,40,6,34,24,10
2021,236887,42,0,34,24,10
2021,236887,42,6,34,24,10
2021,236896,0,0,86,48,38
2021,236896,10,0,86,48,38
2021,236896,10,1,32,19,13
2021,236896,10,2,24,14,10
2021,236896,10,3,22,8,14
2021,236896,10,4,8,7,1
2021,236896,20,0,52,31,21
2021,236896,20,1,30,17,13
2021,236896,20,2,16,11,5
2021,236896,20,3,6,3,3
2021,236896,30,0,20,8,12
2021,236896,30,1,1,1,0
2021,236896,30,2,6,3,3
2021,236896,30,3,12,4,8
2021,236896,30,4,1,0,1
2021,236896,40,0,14,9,5
2021,236896,40,1,1,1,0
2021,236896,40,2,2,0,2
2021,236896,40,3,4,1,3
2021,236896,40,4,7,7,0
2021,236896,42,0,14,9,5
2021,236896,42,1,1,1,0
2021,236896,42,2,2,0,2
2021,236896,42,3,4,1,3
2021,236896,42,4,7,7,0
2021,236939,0,0,1379,778,601
2021,236939,10,0,1379,778,601
2021,236939,10,1,395,272,123
2021,236939,10,2,471,272,199
2021,236939,10,3,456,205,251
2021,236939,10,4,6,3,3
2021,236939,10,5,46,22,24
2021,236939,10,6,5,4,1
2021,236939,20,0,663,443,220
2021,236939,20,1,361,254,107
2021,236939,20,2,302,189,113
2021,236939,30,0,211,114,97
2021,236939,30,1,1,1,0
2021,236939,30,2,10,7,3
2021,236939,30,3,200,106,94
2021,236939,40,0,505,221,284
2021,236939,40,1,33,17,16
2021,236939,40,2,159,76,83
2021,236939,40,3,256,99,157
2021,236939,40,4,6,3,3
2021,236939,40,5,46,22,24
2021,236939,40,6,5,4,1
2021,236939,41,0,354,166,188
2021,236939,41,1,32,17,15
2021,236939,41,2,146,71,75
2021,236939,41,3,166,72,94
2021,236939,41,4,4,1,3
2021,236939,41,5,3,2,1
2021,236939,41,6,3,3,0
2021,236939,42,0,150,54,96
2021,236939,42,1,1,0,1
2021,236939,42,2,13,5,8
2021,236939,42,3,90,27,63
2021,236939,42,4,2,2,0
2021,236939,42,5,42,19,23
2021,236939,42,6,2,1,1
2021,236939,43,0,1,1,0
2021,236939,43,5,1,1,0
2021,236939,44,0,216,90,126
2021,236939,44,1,15,3,12
2021,236939,44,2,80,35,45
2021,236939,44,3,114,49,65
2021,236939,44,4,4,1,3
2021,236939,44,5,3,2,1
2021,236939,45,0,138,76,62
2021,236939,45,1,17,14,3
2021,236939,45,2,66,36,30
2021,236939,45,3,52,23,29
2021,236939,45,6,3,3,0
2021,236948,0,0,5113,2637,2476
2021,236948,10,0,5112,2636,2476
2021,236948,10,1,1671,1090,581
2021,236948,10,2,1334,700,634
2021,236948,10,3,1367,593,774
2021,236948,10,4,318,165,153
2021,236948,10,5,422,88,334
2021,236948,20,0,2437,1502,935
2021,236948,20,1,1492,996,496
2021,236948,20,2,945,506,439
2021,236948,30,0,769,339,430
2021,236948,30,2,4,2,2
2021,236948,30,3,765,337,428
2021,236948,40,0,1906,795,1111
2021,236948,40,1,179,94,85
2021,236948,40,2,385,192,193
2021,236948,40,3,602,256,346
2021,236948,40,4,318,165,153
2021,236948,40,5,422,88,334
2021,236948,41,0,547,262,285
2021,236948,41,1,112,45,67
2021,236948,41,2,247,129,118
2021,236948,41,3,178,82,96
2021,236948,41,5,10,6,4
2021,236948,42,0,1359,533,826
2021,236948,42,1,67,49,18
2021,236948,42,2,138,63,75
2021,236948,42,3,424,174,250
2021,236948,42,4,318,165,153
2021,236948,42,5,412,82,330
2021,236948,44,0,547,262,285
2021,236948,44,1,112,45,67
2021,236948,44,2,247,129,118
2021,236948,44,3,178,82,96
2021,236948,44,5,10,6,4
2021,236948,50,0,1,1,0
2021,236975,0,0,84,38,46
2021,236975,10,0,84,38,46
2021,236975,10,4,84,38,46
2021,236975,20,0,61,33,28
2021,236975,20,4,61,33,28
2021,236975,30,0,14,2,12
2021,236975,30,4,14,2,12
2021,236975,40,0,9,3,6
2021,236975,40,4,9,3,6
2021,236975,42,0,9,3,6
2021,236975,42,4,9,3,6
2021,237011,0,0,674,353,321
2021,237011,10,0,674,353,321
2021,237011,10,1,233,142,91
2021,237011,10,2,184,99,85
2021,237011,10,3,129,57,72
2021,237011,10,4,128,55,73
2021,237011,20,0,416,241,175
2021,237011,20,1,233,142,91
2021,237011,20,2,183,99,84
2021,237011,30,0,130,57,73
2021,237011,30,2,1,0,1
2021,237011,30,3,129,57,72
2021,237011,40,0,128,55,73
2021,237011,40,4,128,55,73
2021,237011,41,0,75,30,45
2021,237011,41,4,75,30,45
2021,237011,42,0,53,25,28
2021,237011,42,4,53,25,28
2021,237011,44,0,75,30,45
2021,237011,44,4,75,30,45
2021,237039,0,0,89,35,54
2021,237039,10,0,89,35,54
2021,237039,10,4,89,35,54
2021,237039,20,0,73,29,44
2021,237039,20,4,73,29,44
2021,237039,30,0,15,6,9
2021,237039,30,4,15,6,9
2021,237039,40,0,1,0,1
2021,237039,40,4,1,0,1
2021,237039,42,0,1,0,1
2021,237039,42,4,1,0,1
2021,237057,0,0,174,89,85
2021,237057,10,0,171,88,83
2021,237057,10,1,41,27,14
2021,237057,10,2,61,25,36
2021,237057,10,3,41,20,21
2021,237057,10,4,7,3,4
2021,237057,10,5,21,13,8
2021,237057,20,0,98,50,48
2021,237057,20,1,41,27,14
2021,237057,20,2,57,23,34
2021,237057,30,0,24,12,12
2021,237057,30,2,2,1,1
2021,237057,30,3,22,11,11
2021,237057,40,0,49,26,23
2021,237057,40,2,2,1,1
2021,237057,40,3,19,9,10
2021,237057,40,4,7,3,4
2021,237057,40,5,21,13,8
2021,237057,41,0,18,12,6
2021,237057,41,3,1,1,0
2021,237057,41,4,2,1,1
2021,237057,41,5,15,10,5
2021,237057,42,0,30,13,17
2021,237057,42,2,2,1,1
2021,237057,42,3,18,8,10
2021,237057,42,4,4,1,3
2021,237057,42,5,6,3,3
2021,237057,43,0,1,1,0
2021,237057,43,4,1,1,0
2021,237057,44,0,18,12,6
2021,237057,44,3,1,1,0
2021,237057,44,4,2,1,1
2021,237057,44,5,15,10,5
2021,237057,50,0,3,1,2
2021,237066,0,0,189,100,89
2021,237066,10,0,189,100,89
2021,237066,10,1,45,31,14
2021,237066,10,2,53,27,26
2021,237066,10,3,46,19,27
2021,237066,10,4,9,6,3
2021,237066,10,5,36,17,19
2021,237066,20,0,78,46,32
2021,237066,20,1,40,28,12
2021,237066,20,2,37,17,20
2021,237066,20,3,1,1,0
2021,237066,30,0,34,13,21
2021,237066,30,1,2,2,0
2021,237066,30,2,5,3,2
2021,237066,30,3,27,8,19
2021,237066,40,0,77,41,36
2021,237066,40,1,3,1,2
2021,237066,40,2,11,7,4
2021,237066,40,3,18,10,8
2021,237066,40,4,9,6,3
2021,237066,40,5,36,17,19
2021,237066,42,0,77,41,36
2021,237066,42,1,3,1,2
2021,237066,42,2,11,7,4
2021,237066,42,3,18,10,8
2021,237066,42,4,9,6,3
2021,237066,42,5,36,17,19
2021,237109,0,0,136,65,71
2021,237109,10,0,136,65,71
2021,237109,10,4,135,65,70
2021,237109,10,6,1,0,1
2021,237109,20,0,65,34,31
2021,237109,20,4,65,34,31
2021,237109,30,0,8,4,4
2021,237109,30,4,7,4,3
2021,237109,30,6,1,0,1
2021,237109,40,0,63,27,36
2021,237109,40,4,63,27,36
2021,237109,42,0,61,26,35
2021,237109,42,4,61,26,35
2021,237109,43,0,2,1,1
2021,237109,43,4,2,1,1
2021,237118,0,0,50,28,22
2021,237118,10,0,50,28,22
2021,237118,10,1,3,3,0
2021,237118,10,2,17,9,8
2021,237118,10,3,29,16,13
2021,237118,10,4,1,0,1
2021,237118,20,0,17,8,9
2021,237118,20,1,3,3,0
2021,237118,20,2,11,5,6
2021,237118,20,3,3,0,3
2021,237118,30,0,33,20,13
2021,237118,30,2,6,4,2
2021,237118,30,3,26,16,10
2021,237118,30,4,1,0,1
2021,237136,0,0,14,9,5
2021,237136,10,0,14,9,5
2021,237136,10,1,3,2,1
2021,237136,10,2,2,1,1
2021,237136,10,3,5,5,0
2021,237136,10,4,4,1,3
2021,237136,40,0,14,9,5
2021,237136,40,1,3,2,1
2021,237136,40,2,2,1,1
2021,237136,40,3,5,5,0
2021,237136,40,4,4,1,3
2021,237136,42,0,14,9,5
2021,237136,42,1,3,2,1
2021,237136,42,2,2,1,1
2021,237136,42,3,5,5,0
2021,237136,42,4,4,1,3
2021,237181,0,0,42,22,20
2021,237181,10,0,42,22,20
2021,237181,10,1,13,6,7
2021,237181,10,2,12,9,3
2021,237181,10,3,11,4,7
2021,237181,10,6,6,3,3
2021,237181,20,0,22,12,10
2021,237181,20,1,13,6,7
2021,237181,20,2,8,6,2
2021,237181,20,3,1,0,1
2021,237181,30,0,14,7,7
2021,237181,30,2,4,3,1
2021,237181,30,3,10,4,6
2021,237181,40,0,6,3,3
2021,237181,40,6,6,3,3
2021,237181,42,0,6,3,3
2021,237181,42,6,6,3,3
2021,237215,0,0,70,36,34
2021,237215,10,0,70,36,34
2021,237215,10,1,23,17,6
2021,237215,10,2,18,9,9
2021,237215,10,3,13,3,10
2021,237215,10,4,15,7,8
2021,237215,10,5,1,0,1
2021,237215,20,0,35,23,12
2021,237215,20,1,23,17,6
2021,237215,20,2,10,6,4
2021,237215,20,3,2,0,2
2021,237215,30,0,13,6,7
2021,237215,30,2,6,3,3
2021,237215,30,3,6,3,3
2021,237215,30,4,1,0,1
2021,237215,40,0,22,7,15
2021,237215,40,2,2,0,2
2021,237215,40,3,5,0,5
2021,237215,40,4,14,7,7
2021,237215,40,5,1,0,1
2021,237215,42,0,22,7,15
2021,237215,42,2,2,0,2
2021,237215,42,3,5,0,5
2021,237215,42,4,14,7,7
2021,237215,42,5,1,0,1
2021,237312,0,0,117,43,74
2021,237312,10,0,117,43,74
2021,237312,10,1,8,5,3
2021,237312,10,2,26,14,12
2021,237312,10,3,69,22,47
2021,237312,10,4,13,2,11
2021,237312,10,6,1,0,1
2021,237312,40,0,117,43,74
2021,237312,40,1,8,5,3
2021,237312,40,2,26,14,12
2021,237312,40,3,69,22,47
2021,237312,40,4,13,2,11
2021,237312,40,6,1,0,1
2021,237312,41,0,69,27,42
2021,237312,41,1,7,4,3
2021,237312,41,2,25,14,11
2021,237312,41,3,32,8,24
2021,237312,41,4,5,1,4
2021,237312,42,0,48,16,32
2021,237312,42,1,1,1,0
2021,237312,42,2,1,0,1
2021,237312,42,3,37,14,23
2021,237312,42,4,8,1,7
2021,237312,42,6,1,0,1
2021,237312,44,0,69,27,42
2021,237312,44,1,7,4,3
2021,237312,44,2,25,14,11
2021,237312,44,3,32,8,24
2021,237312,44,4,5,1,4
2021,237330,0,0,94,48,46
2021,237330,10,0,94,48,46
2021,237330,10,1,33,17,16
2021,237330,10,2,18,9,9
2021,237330,10,3,29,16,13
2021,237330,10,4,14,6,8
2021,237330,20,0,49,25,24
2021,237330,20,1,33,17,16
2021,237330,20,2,16,8,8
2021,237330,30,0,22,13,9
2021,237330,30,2,2,1,1
2021,237330,30,3,20,12,8
2021,237330,40,0,23,10,13
2021,237330,40,3,9,4,5
2021,237330,40,4,14,6,8
2021,237330,42,0,23,10,13
2021,237330,42,3,9,4,5
2021,237330,42,4,14,6,8
2021,237358,0,0,44,18,26
2021,237358,10,0,44,18,26
2021,237358,10,1,9,3,6
2021,237358,10,2,7,2,5
2021,237358,10,3,19,11,8
2021,237358,10,4,9,2,7
2021,237358,20,0,14,4,10
2021,237358,20,1,8,3,5
2021,237358,20,2,5,1,4
2021,237358,20,3,1,0,1
2021,237358,30,0,1,0,1
2021,237358,30,3,1,0,1
2021,237358,40,0,29,14,15
2021,237358,40,1,1,0,1
2021,237358,40,2,2,1,1
2021,237358,40,3,17,11,6
2021,237358,40,4,9,2,7
2021,237358,41,0,8,4,4
2021,237358,41,3,5,3,2
2021,237358,41,4,3,1,2
2021,237358,42,0,21,10,11
2021,237358,42,1,1,0,1
2021,237358,42,2,2,1,1
2021,237358,42,3,12,8,4
2021,237358,42,4,6,1,5
2021,237358,44,0,8,4,4
2021,237358,44,3,5,3,2
2021,237358,44,4,3,1,2
2021,237367,0,0,153,70,83
2021,237367,10,0,138,64,74
2021,237367,10,1,37,21,16
2021,237367,10,2,33,16,17
2021,237367,10,3,61,24,37
2021,237367,10,4,7,3,4
2021,237367,20,0,64,32,32
2021,237367,20,1,36,20,16
2021,237367,20,2,26,12,14
2021,237367,20,3,2,0,2
2021,237367,30,0,49,19,30
2021,237367,30,2,6,3,3
2021,237367,30,3,43,16,27
2021,237367,40,0,25,13,12
2021,237367,40,1,1,1,0
2021,237367,40,2,1,1,0
2021,237367,40,3,16,8,8
2021,237367,40,4,7,3,4
2021,237367,42,0,25,13,12
2021,237367,42,1,1,1,0
2021,237367,42,2,1,1,0
2021,237367,42,3,16,8,8
2021,237367,42,4,7,3,4
2021,237367,50,0,15,6,9
2021,237385,0,0,58,37,21
2021,237385,10,0,58,37,21
2021,237385,10,1,10,9,1
2021,237385,10,2,19,12,7
2021,237385,10,3,20,13,7
2021,237385,10,5,9,3,6
2021,237385,20,0,28,21,7
2021,237385,20,1,10,9,1
2021,237385,20,2,18,12,6
2021,237385,30,0,21,13,8
2021,237385,30,2,1,0,1
2021,237385,30,3,20,13,7
2021,237385,40,0,9,3,6
2021,237385,40,5,9,3,6
2021,237385,42,0,9,3,6
2021,237385,42,5,9,3,6
2021,237437,0,0,6,3,3
2021,237437,50,0,6,3,3
2021,237525,0,0,830,469,361
2021,237525,10,0,829,468,361
2021,237525,10,1,238,158,80
2021,237525,10,2,214,119,95
2021,237525,10,3,312,168,144
2021,237525,10,4,65,23,42
2021,237525,20,0,383,227,156
2021,237525,20,1,225,146,79
2021,237525,20,2,157,81,76
2021,237525,20,3,1,0,1
2021,237525,30,0,161,87,74
2021,237525,30,1,4,4,0
2021,237525,30,2,19,8,11
2021,237525,30,3,138,75,63
2021,237525,40,0,285,154,131
2021,237525,40,1,9,8,1
2021,237525,40,2,38,30,8
2021,237525,40,3,173,93,80
2021,237525,40,4,65,23,42
2021,237525,41,0,52,22,30
2021,237525,41,3,13,10,3
2021,237525,41,4,39,12,27
2021,237525,42,0,233,132,101
2021,237525,42,1,9,8,1
2021,237525,42,2,38,30,8
2021,237525,42,3,160,83,77
2021,237525,42,4,26,11,15
2021,237525,44,0,52,22,30
2021,237525,44,3,13,10,3
2021,237525,44,4,39,12,27
2021,237525,50,0,1,1,0
2021,237686,0,0,77,36,41
2021,237686,10,0,67,29,38
2021,237686,10,1,13,7,6
2021,237686,10,2,14,6,8
2021,237686,10,3,23,11,12
2021,237686,10,4,17,5,12
2021,237686,20,0,10,7,3
2021,237686,20,1,10,7,3
2021,237686,40,0,57,22,35
2021,237686,40,1,3,0,3
2021,237686,40,2,14,6,8
2021,237686,40,3,23,11,12
2021,237686,40,4,17,5,12
2021,237686,41,0,26,10,16
2021,237686,41,1,3,0,3
2021,237686,41,2,9,3,6
2021,237686,41,3,10,6,4
2021,237686,41,4,4,1,3
2021,237686,42,0,31,12,19
2021,237686,42,2,5,3,2
2021,237686,42,3,13,5,8
2021,237686,42,4,13,4,9
2021,237686,44,0,26,10,16
2021,237686,44,1,3,0,3
2021,237686,44,2,9,3,6
2021,237686,44,3,10,6,4
2021,237686,44,4,4,1,3
2021,237686,50,0,10,7,3
2021,237701,0,0,54,21,33
2021,237701,10,0,54,21,33
2021,237701,10,1,11,7,4
2021,237701,10,2,9,3,6
2021,237701,10,3,13,6,7
2021,237701,10,4,20,4,16
2021,237701,10,6,1,1,0
2021,237701,20,0,23,11,12
2021,237701,20,1,11,7,4
2021,237701,20,2,8,2,6
2021,237701,20,3,3,1,2
2021,237701,20,6,1,1,0
2021,237701,30,0,19,7,12
2021,237701,30,3,10,5,5
2021,237701,30,4,9,2,7
2021,237701,40,0,12,3,9
2021,237701,40,2,1,1,0
2021,237701,40,4,11,2,9
2021,237701,42,0,12,3,9
2021,237701,42,2,1,1,0
2021,237701,42,4,11,2,9
2021,237783,0,0,31,17,14
2021,237783,10,0,31,17,14
2021,237783,10,1,11,7,4
2021,237783,10,2,16,8,8
2021,237783,10,3,4,2,2
2021,237783,40,0,31,17,14
2021,237783,40,1,11,7,4
2021,237783,40,2,16,8,8
2021,237783,40,3,4,2,2
2021,237783,41,0,31,17,14
2021,237783,41,1,11,7,4
2021,237783,41,2,16,8,8
2021,237783,41,3,4,2,2
2021,237783,45,0,31,17,14
2021,237783,45,1,11,7,4
2021,237783,45,2,16,8,8
2021,237783,45,3,4,2,2
2021,237792,0,0,132,62,70
2021,237792,10,0,132,62,70
2021,237792,10,1,34,17,17
2021,237792,10,2,48,24,24
2021,237792,10,3,36,16,20
2021,237792,10,5,14,5,9
2021,237792,20,0,80,40,40
2021,237792,20,1,34,17,17
2021,237792,20,2,46,23,23
2021,237792,30,0,38,17,21
2021,237792,30,2,2,1,1
2021,237792,30,3,36,16,20
2021,237792,40,0,14,5,9
2021,237792,40,5,14,5,9
2021,237792,41,0,8,3,5
2021,237792,41,5,8,3,5
2021,237792,42,0,6,2,4
2021,237792,42,5,6,2,4
2021,237792,44,0,8,3,5
2021,237792,44,5,8,3,5
2021,237817,0,0,58,19,39
2021,237817,10,0,58,19,39
2021,237817,10,1,14,4,10
2021,237817,10,2,9,3,6
2021,237817,10,3,21,8,13
2021,237817,10,4,13,4,9
2021,237817,10,6,1,0,1
2021,237817,20,0,4,1,3
2021,237817,20,1,2,0,2
2021,237817,20,2,1,1,0
2021,237817,20,3,1,0,1
2021,237817,40,0,54,18,36
2021,237817,40,1,12,4,8
2021,237817,40,2,8,2,6
2021,237817,40,3,20,8,12
2021,237817,40,4,13,4,9
2021,237817,40,6,1,0,1
2021,237817,42,0,54,18,36
2021,237817,42,1,12,4,8
2021,237817,42,2,8,2,6
2021,237817,42,3,20,8,12
2021,237817,42,4,13,4,9
2021,237817,42,6,1,0,1
2021,237880,0,0,60,26,34
2021,237880,10,0,60,26,34
2021,237880,10,1,16,7,9
2021,237880,10,2,31,14,17
2021,237880,10,3,13,5,8
2021,237880,20,0,37,14,23
2021,237880,20,1,14,5,9
2021,237880,20,2,21,8,13
2021,237880,20,3,2,1,1
2021,237880,30,0,16,8,8
2021,237880,30,2,7,5,2
2021,237880,30,3,9,3,6
2021,237880,40,0,7,4,3
2021,237880,40,1,2,2,0
2021,237880,40,2,3,1,2
2021,237880,40,3,2,1,1
2021,237880,41,0,7,4,3
2021,237880,41,1,2,2,0
2021,237880,41,2,3,1,2
2021,237880,41,3,2,1,1
2021,237880,45,0,7,4,3
2021,237880,45,1,2,2,0
2021,237880,45,2,3,1,2
2021,237880,45,3,2,1,1
2021,237899,0,0,99,57,42
2021,237899,10,0,99,57,42
2021,237899,10,1,32,21,11
2021,237899,10,2,27,18,9
2021,237899,10,3,26,14,12
2021,237899,10,4,14,4,10
2021,237899,20,0,46,29,17
2021,237899,20,1,25,15,10
2021,237899,20,2,16,10,6
2021,237899,20,3,5,4,1
2021,237899,30,0,22,11,11
2021,237899,30,1,5,4,1
2021,237899,30,2,6,3,3
2021,237899,30,3,11,4,7
2021,237899,40,0,31,17,14
2021,237899,40,1,2,2,0
2021,237899,40,2,5,5,0
2021,237899,40,3,10,6,4
2021,237899,40,4,14,4,10
2021,237899,42,0,31,17,14
2021,237899,42,1,2,2,0
2021,237899,42,2,5,5,0
2021,237899,42,3,10,6,4
2021,237899,42,4,14,4,10
2021,237932,0,0,149,74,75
2021,237932,10,0,148,73,75
2021,237932,10,1,38,24,14
2021,237932,10,2,37,18,19
2021,237932,10,3,47,21,26
2021,237932,10,4,24,9,15
2021,237932,10,5,2,1,1
2021,237932,20,0,65,37,28
2021,237932,20,1,38,24,14
2021,237932,20,2,24,12,12
2021,237932,20,3,3,1,2
2021,237932,30,0,32,17,15
2021,237932,30,2,7,3,4
2021,237932,30,3,24,13,11
2021,237932,30,4,1,1,0
2021,237932,40,0,51,19,32
2021,237932,40,2,6,3,3
2021,237932,40,3,20,7,13
2021,237932,40,4,23,8,15
2021,237932,40,5,2,1,1
2021,237932,42,0,51,19,32
2021,237932,42,2,6,3,3
2021,237932,42,3,20,7,13
2021,237932,42,4,23,8,15
2021,237932,42,5,2,1,1
2021,237932,50,0,1,1,0
2021,237950,0,0,90,54,36
2021,237950,10,0,90,54,36
2021,237950,10,1,8,6,2
2021,237950,10,2,25,15,10
2021,237950,10,3,50,33,17
2021,237950,10,4,7,0,7
2021,237950,20,0,31,19,12
2021,237950,20,1,8,6,2
2021,237950,20,2,22,13,9
2021,237950,20,3,1,0,1
2021,237950,30,0,37,28,9
2021,237950,30,2,1,1,0
2021,237950,30,3,36,27,9
2021,237950,40,0,22,7,15
2021,237950,40,2,2,1,1
2021,237950,40,3,13,6,7
2021,237950,40,4,7,0,7
2021,237950,42,0,22,7,15
2021,237950,42,2,2,1,1
2021,237950,42,3,13,6,7
2021,237950,42,4,7,0,7
2021,237969,0,0,59,30,29
2021,237969,10,0,59,30,29
2021,237969,10,1,6,4,2
2021,237969,10,2,28,9,19
2021,237969,10,3,25,17,8
2021,237969,20,0,40,16,24
2021,237969,20,1,6,4,2
2021,237969,20,2,28,9,19
2021,237969,20,3,6,3,3
2021,237969,30,0,11,8,3
2021,237969,30,3,11,8,3
2021,237969,40,0,8,6,2
2021,237969,40,3,8,6,2
2021,237969,42,0,8,6,2
2021,237969,42,3,8,6,2
2021,237987,0,0,8,3,5
2021,237987,50,0,8,3,5
2021,237996,0,0,26,8,18
2021,237996,50,0,26,8,18
2021,238014,0,0,52,20,32
2021,238014,10,0,52,20,32
2021,238014,10,1,7,4,3
2021,238014,10,2,6,1,5
2021,238014,10,3,18,7,11
2021,238014,10,4,21,8,13
2021,238014,20,0,2,0,2
2021,238014,20,1,2,0,2
2021,238014,40,0,50,20,30
2021,238014,40,1,5,4,1
2021,238014,40,2,6,1,5
2021,238014,40,3,18,7,11
2021,238014,40,4,21,8,13
2021,238014,42,0,50,20,30
2021,238014,42,1,5,4,1
2021,238014,42,2,6,1,5
2021,238014,42,3,18,7,11
2021,238014,42,4,21,8,13
2021,238032,0,0,1330,728,602
2021,238032,10,0,1330,728,602
2021,238032,10,1,423,292,131
2021,238032,10,2,427,221,206
2021,238032,10,3,408,193,215
2021,238032,10,4,67,19,48
2021,238032,10,5,2,2,0
2021,238032,10,6,3,1,2
2021,238032,20,0,639,417,222
2021,238032,20,1,356,253,103
2021,238032,20,2,279,161,118
2021,238032,20,3,2,1,1
2021,238032,20,5,1,1,0
2021,238032,20,6,1,1,0
2021,238032,30,0,244,145,99
2021,238032,30,1,17,15,2
2021,238032,30,2,28,17,11
2021,238032,30,3,199,113,86
2021,238032,40,0,447,166,281
2021,238032,40,1,50,24,26
2021,238032,40,2,120,43,77
2021,238032,40,3,207,79,128
2021,238032,40,4,67,19,48
2021,238032,40,5,1,1,0
2021,238032,40,6,2,0,2
2021,238032,42,0,447,166,281
2021,238032,42,1,50,24,26
2021,238032,42,2,120,43,77
2021,238032,42,3,207,79,128
2021,238032,42,4,67,19,48
2021,238032,42,5,1,1,0
2021,238032,42,6,2,0,2
2021,238078,0,0,20,8,12
2021,238078,10,0,20,8,12
2021,238078,10,1,4,3,1
2021,238078,10,2,6,1,5
2021,238078,10,3,9,4,5
2021,238078,10,4,1,0,1
2021,238078,20,0,4,3,1
2021,238078,20,1,2,2,0
2021,238078,20,2,2,1,1
2021,238078,30,0,8,2,6
2021,238078,30,1,1,0,1
2021,238078,30,2,2,0,2
2021,238078,30,3,4,2,2
2021,238078,30,4,1,0,1
2021,238078,40,0,8,3,5
2021,238078,40,1,1,1,0
2021,238078,40,2,2,0,2
2021,238078,40,3,5,2,3
2021,238078,42,0,8,3,5
2021,238078,42,1,1,1,0
2021,238078,42,2,2,0,2
2021,238078,42,3,5,2,3
2021,238193,0,0,90,16,74
2021,238193,10,0,90,16,74
2021,238193,10,1,26,8,18
2021,238193,10,2,23,2,21
2021,238193,10,3,41,6,35
2021,238193,20,0,32,10,22
2021,238193,20,1,25,8,17
2021,238193,20,2,6,1,5
2021,238193,20,3,1,1,0
2021,238193,30,0,39,5,34
2021,238193,30,1,1,0,1
2021,238193,30,2,14,1,13
2021,238193,30,3,24,4,20
2021,238193,40,0,19,1,18
2021,238193,40,2,3,0,3
2021,238193,40,3,16,1,15
2021,238193,42,0,19,1,18
2021,238193,42,2,3,0,3
2021,238193,42,3,16,1,15
2021,238263,0,0,436,198,238
2021,238263,10,0,436,198,238
2021,238263,10,4,436,198,238
2021,238263,40,0,436,198,238
2021,238263,40,4,436,198,238
2021,238263,42,0,436,198,238
2021,238263,42,4,436,198,238
2021,238324,0,0,20,1,19
2021,238324,10,0,20,1,19
2021,238324,10,2,1,0,1
2021,238324,10,3,11,1,10
2021,238324,10,4,8,0,8
2021,238324,40,0,20,1,19
2021,238324,40,2,1,0,1
2021,238324,40,3,11,1,10
2021,238324,40,4,8,0,8
2021,238324,42,0,20,1,19
2021,238324,42,2,1,0,1
2021,238324,42,3,11,1,10
2021,238324,42,4,8,0,8
2021,238333,0,0,91,42,49
2021,238333,10,0,91,42,49
2021,238333,10,1,32,17,15
2021,238333,10,2,25,7,18
2021,238333,10,3,31,15,16
2021,238333,10,6,3,3,0
2021,238333,20,0,52,23,29
2021,238333,20,1,32,17,15
2021,238333,20,2,20,6,14
2021,238333,30,0,18,10,8
2021,238333,30,2,1,1,0
2021,238333,30,3,17,9,8
2021,238333,40,0,21,9,12
2021,238333,40,2,4,0,4
2021,238333,40,3,14,6,8
2021,238333,40,6,3,3,0
2021,238333,41,0,7,1,6
2021,238333,41,2,3,0,3
2021,238333,41,3,3,0,3
2021,238333,41,6,1,1,0
2021,238333,42,0,14,8,6
2021,238333,42,2,1,0,1
2021,238333,42,3,11,6,5
2021,238333,42,6,2,2,0
2021,238333,44,0,7,1,6
2021,238333,44,2,3,0,3
2021,238333,44,3,3,0,3
2021,238333,44,6,1,1,0
2021,238397,0,0,80,38,42
2021,238397,10,0,80,38,42
2021,238397,10,4,80,38,42
2021,238397,40,0,80,38,42
2021,238397,40,4,80,38,42
2021,238397,42,0,80,38,42
2021,238397,42,4,80,38,42
2021,238430,0,0,56,23,33
2021,238430,10,0,56,23,33
2021,238430,10,1,5,3,2
2021,238430,10,2,20,9,11
2021,238430,10,3,31,11,20
2021,238430,20,0,28,14,14
2021,238430,20,1,4,2,2
2021,238430,20,2,19,9,10
2021,238430,20,3,5,3,2
2021,238430,30,0,5,3,2
2021,238430,30,1,1,1,0
2021,238430,30,3,4,2,2
2021,238430,40,0,23,6,17
2021,238430,40,2,1,0,1
2021,238430,40,3,22,6,16
2021,238430,42,0,23,6,17
2021,238430,42,2,1,0,1
2021,238430,42,3,22,6,16
2021,238458,0,0,148,50,98
2021,238458,10,0,148,50,98
2021,238458,10,1,19,10,9
2021,238458,10,2,43,14,29
2021,238458,10,3,45,14,31
2021,238458,10,5,41,12,29
2021,238458,20,0,43,20,23
2021,238458,20,1,18,9,9
2021,238458,20,2,25,11,14
2021,238458,30,0,27,14,13
2021,238458,30,2,5,2,3
2021,238458,30,3,22,12,10
2021,238458,40,0,78,16,62
2021,238458,40,1,1,1,0
2021,238458,40,2,13,1,12
2021,238458,40,3,23,2,21
2021,238458,40,5,41,12,29
2021,238458,41,0,63,13,50
2021,238458,41,1,1,1,0
2021,238458,41,2,12,1,11
2021,238458,41,3,18,1,17
2021,238458,41,5,32,10,22
2021,238458,42,0,15,3,12
2021,238458,42,2,1,0,1
2021,238458,42,3,5,1,4
2021,238458,42,5,9,2,7
2021,238458,44,0,63,13,50
2021,238458,44,1,1,1,0
2021,238458,44,2,12,1,11
2021,238458,44,3,18,1,17
2021,238458,44,5,32,10,22
2021,238476,0,0,142,78,64
2021,238476,10,0,142,78,64
2021,238476,10,1,34,27,7
2021,238476,10,2,50,25,25
2021,238476,10,3,58,26,32
2021,238476,20,0,70,47,23
2021,238476,20,1,33,26,7
2021,238476,20,2,37,21,16
2021,238476,30,0,20,6,14
2021,238476,30,2,3,1,2
2021,238476,30,3,17,5,12
2021,238476,40,0,52,25,27
2021,238476,40,1,1,1,0
2021,238476,40,2,10,3,7
2021,238476,40,3,41,21,20
2021,238476,41,0,48,24,24
2021,238476,41,1,1,1,0
2021,238476,41,2,10,3,7
2021,238476,41,3,37,20,17
2021,238476,42,0,4,1,3
2021,238476,42,3,4,1,3
2021,238476,44,0,48,24,24
2021,238476,44,1,1,1,0
2021,238476,44,2,10,3,7
2021,238476,44,3,37,20,17
2021,238616,0,0,226,104,122
2021,238616,10,0,226,104,122
2021,238616,10,1,62,44,18
2021,238616,10,2,66,31,35
2021,238616,10,3,91,29,62
2021,238616,10,4,7,0,7
2021,238616,40,0,226,104,122
2021,238616,40,1,62,44,18
2021,238616,40,2,66,31,35
2021,238616,40,3,91,29,62
2021,238616,40,4,7,0,7
2021,238616,41,0,191,96,95
2021,238616,41,1,62,44,18
2021,238616,41,2,66,31,35
2021,238616,41,3,63,21,42
2021,238616,42,0,35,8,27
2021,238616,42,3,28,8,20
2021,238616,42,4,7,0,7
2021,238616,44,0,191,96,95
2021,238616,44,1,62,44,18
2021,238616,44,2,66,31,35
2021,238616,44,3,63,21,42
2021,238661,0,0,88,35,53
2021,238661,10,0,88,35,53
2021,238661,10,1,15,9,6
2021,238661,10,2,30,12,18
2021,238661,10,3,14,5,9
2021,238661,10,5,29,9,20
2021,238661,20,0,38,18,20
2021,238661,20,1,15,9,6
2021,238661,20,2,23,9,14
2021,238661,30,0,18,7,11
2021,238661,30,2,7,3,4
2021,238661,30,3,11,4,7
2021,238661,40,0,32,10,22
2021,238661,40,3,3,1,2
2021,238661,40,5,29,9,20
2021,238661,42,0,32,10,22
2021,238661,42,3,3,1,2
2021,238661,42,5,29,9,20
2021,238722,0,0,293,164,129
2021,238722,10,0,293,164,129
2021,238722,10,6,293,164,129
2021,238722,40,0,293,164,129
2021,238722,40,6,293,164,129
2021,238722,41,0,293,164,129
2021,238722,41,6,293,164,129
2021,238722,44,0,293,164,129
2021,238722,44,6,293,164,129
2021,238759,0,0,229,103,126
2021,238759,10,0,229,103,126
2021,238759,10,6,229,103,126
2021,238759,40,0,229,103,126
2021,238759,40,6,229,103,126
2021,238759,42,0,229,103,126
2021,238759,42,6,229,103,126
2021,238980,0,0,36,19,17
2021,238980,10,0,36,19,17
2021,238980,10,1,8,5,3
2021,238980,10,2,13,9,4
2021,238980,10,3,10,4,6
2021,238980,10,4,5,1,4
2021,238980,20,0,16,9,7
2021,238980,20,1,8,5,3
2021,238980,20,2,8,4,4
2021,238980,30,0,9,6,3
2021,238980,30,2,4,4,0
2021,238980,30,3,5,2,3
2021,238980,40,0,11,4,7
2021,238980,40,2,1,1,0
2021,238980,40,3,5,2,3
2021,238980,40,4,5,1,4
2021,238980,42,0,11,4,7
2021,238980,42,2,1,1,0
2021,238980,42,3,5,2,3
2021,238980,42,4,5,1,4
2021,239008,0,0,100,46,54
2021,239008,10,0,100,46,54
2021,239008,10,4,100,46,54
2021,239008,40,0,100,46,54
2021,239008,40,4,100,46,54
2021,239008,42,0,100,46,54
2021,239008,42,4,100,46,54
2021,239017,0,0,167,79,88
2021,239017,10,0,167,79,88
2021,239017,10,1,32,22,10
2021,239017,10,2,75,36,39
2021,239017,10,3,46,16,30
2021,239017,10,4,13,4,9
2021,239017,10,5,1,1,0
2021,239017,20,0,105,58,47
2021,239017,20,1,32,22,10
2021,239017,20,2,73,36,37
2021,239017,30,0,32,10,22
2021,239017,30,2,2,0,2
2021,239017,30,3,29,10,19
2021,239017,30,4,1,0,1
2021,239017,40,0,30,11,19
2021,239017,40,3,17,6,11
2021,239017,40,4,12,4,8
2021,239017,40,5,1,1,0
2021,239017,41,0,21,8,13
2021,239017,41,3,10,4,6
2021,239017,41,4,11,4,7
2021,239017,42,0,9,3,6
2021,239017,42,3,7,2,5
2021,239017,42,4,1,0,1
2021,239017,42,5,1,1,0
2021,239017,44,0,21,8,13
2021,239017,44,3,10,4,6
2021,239017,44,4,11,4,7
2021,239071,0,0,47,32,15
2021,239071,10,0,47,32,15
2021,239071,10,1,12,9,3
2021,239071,10,2,19,12,7
2021,239071,10,3,3,2,1
2021,239071,10,6,13,9,4
2021,239071,40,0,47,32,15
2021,239071,40,1,12,9,3
2021,239071,40,2,19,12,7
2021,239071,40,3,3,2,1
2021,239071,40,6,13,9,4
2021,239071,42,0,47,32,15
2021,239071,42,1,12,9,3
2021,239071,42,2,19,12,7
2021,239071,42,3,3,2,1
2021,239071,42,6,13,9,4
2021,239080,0,0,53,17,36
2021,239080,10,0,50,15,35
2021,239080,10,1,5,3,2
2021,239080,10,2,17,5,12
2021,239080,10,3,27,6,21
2021,239080,10,4,1,1,0
2021,239080,20,0,15,8,7
2021,239080,20,1,4,3,1
2021,239080,20,2,10,5,5
2021,239080,20,3,1,0,1
2021,239080,30,0,16,5,11
2021,239080,30,2,2,0,2
2021,239080,30,3,14,5,9
2021,239080,40,0,19,2,17
2021,239080,40,1,1,0,1
2021,239080,40,2,5,0,5
2021,239080,40,3,12,1,11
2021,239080,40,4,1,1,0
2021,239080,42,0,19,2,17
2021,239080,42,1,1,0,1
2021,239080,42,2,5,0,5
2021,239080,42,3,12,1,11
2021,239080,42,4,1,1,0
2021,239080,50,0,3,2,1
2021,239105,0,0,666,346,320
2021,239105,10,0,666,346,320
2021,239105,10,1,155,98,57
2021,239105,10,2,209,105,104
2021,239105,10,3,205,99,106
2021,239105,10,4,49,17,32
2021,239105,10,5,1,0,1
2021,239105,10,6,47,27,20
2021,239105,20,0,290,171,119
2021,239105,20,1,129,85,44
2021,239105,20,2,161,86,75
2021,239105,30,0,129,67,62
2021,239105,30,2,3,3,0
2021,239105,30,3,126,64,62
2021,239105,40,0,247,108,139
2021,239105,40,1,26,13,13
2021,239105,40,2,45,16,29
2021,239105,40,3,79,35,44
2021,239105,40,4,49,17,32
2021,239105,40,5,1,0,1
2021,239105,40,6,47,27,20
2021,239105,42,0,247,108,139
2021,239105,42,1,26,13,13
2021,239105,42,2,45,16,29
2021,239105,42,3,79,35,44
2021,239105,42,4,49,17,32
2021,239105,42,5,1,0,1
2021,239105,42,6,47,27,20
2021,239169,0,0,1755,1026,729
2021,239169,10,0,1755,1026,729
2021,239169,10,1,394,285,109
2021,239169,10,2,361,206,155
2021,239169,10,3,899,470,429
2021,239169,10,4,86,53,33
2021,239169,10,6,15,12,3
2021,239169,20,0,156,115,41
2021,239169,20,1,153,113,40
2021,239169,20,2,3,2,1
2021,239169,30,0,1064,613,451
2021,239169,30,1,216,153,63
2021,239169,30,2,302,171,131
2021,239169,30,3,546,289,257
2021,239169,40,0,535,298,237
2021,239169,40,1,25,19,6
2021,239169,40,2,56,33,23
2021,239169,40,3,353,181,172
2021,239169,40,4,86,53,33
2021,239169,40,6,15,12,3
2021,239169,41,0,434,233,201
2021,239169,41,1,25,19,6
2021,239169,41,2,56,33,23
2021,239169,41,3,353,181,172
2021,239169,42,0,101,65,36
2021,239169,42,4,86,53,33
2021,239169,42,6,15,12,3
2021,239169,44,0,434,233,201
2021,239169,44,1,25,19,6
2021,239169,44,2,56,33,23
2021,239169,44,3,353,181,172
2021,239220,0,0,80,37,43
2021,239220,10,0,80,37,43
2021,239220,10,4,80,37,43
2021,239220,40,0,80,37,43
2021,239220,40,4,80,37,43
2021,239220,43,0,80,37,43
2021,239220,43,4,80,37,43
2021,239248,0,0,511,237,274
2021,239248,10,0,442,224,218
2021,239248,10,4,442,224,218
2021,239248,40,0,442,224,218
2021,239248,40,4,442,224,218
2021,239248,42,0,442,224,218
2021,239248,42,4,442,224,218
2021,239248,50,0,69,13,56
2021,239309,0,0,61,32,29
2021,239309,10,0,60,31,29
2021,239309,10,1,22,15,7
2021,239309,10,2,14,9,5
2021,239309,10,3,4,1,3
2021,239309,10,4,20,6,14
2021,239309,40,0,60,31,29
2021,239309,40,1,22,15,7
2021,239309,40,2,14,9,5
2021,239309,40,3,4,1,3
2021,239309,40,4,20,6,14
2021,239309,41,0,7,3,4
2021,239309,41,1,3,1,2
2021,239309,41,2,4,2,2
2021,239309,42,0,53,28,25
2021,239309,42,1,19,14,5
2021,239309,42,2,10,7,3
2021,239309,42,3,4,1,3
2021,239309,42,4,20,6,14
2021,239309,44,0,7,3,4
2021,239309,44,1,3,1,2
2021,239309,44,2,4,2,2
2021,239309,50,0,1,1,0
2021,239318,0,0,166,105,61
2021,239318,10,0,166,105,61
2021,239318,10,1,42,28,14
2021,239318,10,2,49,33,16
2021,239318,10,3,56,35,21
2021,239318,10,4,19,9,10
2021,239318,40,0,166,105,61
2021,239318,40,1,42,28,14
2021,239318,40,2,49,33,16
2021,239318,40,3,56,35,21
2021,239318,40,4,19,9,10
2021,239318,41,0,147,96,51
2021,239318,41,1,42,28,14
2021,239318,41,2,49,33,16
2021,239318,41,3,56,35,21
2021,239318,42,0,19,9,10
2021,239318,42,4,19,9,10
2021,239318,44,0,147,96,51
2021,239318,44,1,42,28,14
2021,239318,44,2,49,33,16
2021,239318,44,3,56,35,21
2021,239372,0,0,139,63,76
2021,239372,10,0,139,63,76
2021,239372,10,4,139,63,76
2021,239372,40,0,139,63,76
2021,239372,40,4,139,63,76
2021,239372,42,0,139,63,76
2021,239372,42,4,139,63,76
2021,239390,0,0,64,8,56
2021,239390,10,0,64,8,56
2021,239390,10,1,15,2,13
2021,239390,10,2,14,3,11
2021,239390,10,3,31,3,28
2021,239390,10,4,4,0,4
2021,239390,20,0,30,5,25
2021,239390,20,1,13,2,11
2021,239390,20,2,13,3,10
2021,239390,20,3,4,0,4
2021,239390,30,0,19,3,16
2021,239390,30,1,2,0,2
2021,239390,30,2,1,0,1
2021,239390,30,3,16,3,13
2021,239390,40,0,15,0,15
2021,239390,40,3,11,0,11
2021,239390,40,4,4,0,4
2021,239390,42,0,15,0,15
2021,239390,42,3,11,0,11
2021,239390,42,4,4,0,4
2021,239424,0,0,9,8,1
2021,239424,10,0,9,8,1
2021,239424,10,1,3,3,0
2021,239424,10,2,2,2,0
2021,239424,10,3,3,2,1
2021,239424,10,4,1,1,0
2021,239424,20,0,3,3,0
2021,239424,20,1,3,3,0
2021,239424,30,0,5,4,1
2021,239424,30,2,2,2,0
2021,239424,30,3,3,2,1
2021,239424,40,0,1,1,0
2021,239424,40,4,1,1,0
2021,239424,41,0,1,1,0
2021,239424,41,4,1,1,0
2021,239424,44,0,1,1,0
2021,239424,44,4,1,1,0
2021,239442,0,0,50,26,24
2021,239442,10,0,50,26,24
2021,239442,10,4,50,26,24
2021,239442,40,0,50,26,24
2021,239442,40,4,50,26,24
2021,239442,42,0,50,26,24
2021,239442,42,4,50,26,24
2021,239460,0,0,143,70,73
2021,239460,10,0,143,70,73
2021,239460,10,4,143,70,73
2021,239460,40,0,143,70,73
2021,239460,40,4,143,70,73
2021,239460,42,0,143,70,73
2021,239460,42,4,143,70,73
2021,239488,0,0,258,129,129
2021,239488,10,0,258,129,129
2021,239488,10,6,258,129,129
2021,239488,40,0,258,129,129
2021,239488,40,6,258,129,129
2021,239488,42,0,258,129,129
2021,239488,42,6,258,129,129
2021,239512,0,0,50,27,23
2021,239512,10,0,50,27,23
2021,239512,10,1,16,10,6
2021,239512,10,2,7,5,2
2021,239512,10,3,21,10,11
2021,239512,10,4,5,1,4
2021,239512,10,5,1,1,0
2021,239512,20,0,23,15,8
2021,239512,20,1,16,10,6
2021,239512,20,2,7,5,2
2021,239512,30,0,17,8,9
2021,239512,30,3,17,8,9
2021,239512,40,0,10,4,6
2021,239512,40,3,4,2,2
2021,239512,40,4,5,1,4
2021,239512,40,5,1,1,0
2021,239512,41,0,10,4,6
2021,239512,41,3,4,2,2
2021,239512,41,4,5,1,4
2021,239512,41,5,1,1,0
2021,239512,45,0,10,4,6
2021,239512,45,3,4,2,2
2021,239512,45,4,5,1,4
2021,239512,45,5,1,1,0
2021,239628,0,0,50,29,21
2021,239628,10,0,50,29,21
2021,239628,10,1,19,11,8
2021,239628,10,2,16,9,7
2021,239628,10,3,12,8,4
2021,239628,10,4,3,1,2
2021,239628,20,0,35,20,15
2021,239628,20,1,19,11,8
2021,239628,20,2,16,9,7
2021,239628,30,0,12,8,4
2021,239628,30,3,12,8,4
2021,239628,40,0,3,1,2
2021,239628,40,4,3,1,2
2021,239628,42,0,3,1,2
2021,239628,42,4,3,1,2
2021,239637,0,0,11,10,1
2021,239637,10,0,11,10,1
2021,239637,10,1,3,3,0
2021,239637,10,2,5,5,0
2021,239637,10,3,2,1,1
2021,239637,10,4,1,1,0
2021,239637,40,0,11,10,1
2021,239637,40,1,3,3,0
2021,239637,40,2,5,5,0
2021,239637,40,3,2,1,1
2021,239637,40,4,1,1,0
2021,239637,41,0,9,8,1
2021,239637,41,1,3,3,0
2021,239637,41,2,4,4,0
2021,239637,41,3,1,0,1
2021,239637,41,4,1,1,0
2021,239637,42,0,2,2,0
2021,239637,42,2,1,1,0
2021,239637,42,3,1,1,0
2021,239637,44,0,9,8,1
2021,239637,44,1,3,3,0
2021,239637,44,2,4,4,0
2021,239637,44,3,1,0,1
2021,239637,44,4,1,1,0
2021,239716,0,0,130,66,64
2021,239716,10,0,129,66,63
2021,239716,10,1,26,18,8
2021,239716,10,2,41,18,23
2021,239716,10,3,59,28,31
2021,239716,10,4,3,2,1
2021,239716,20,0,79,42,37
2021,239716,20,1,25,17,8
2021,239716,20,2,38,17,21
2021,239716,20,3,16,8,8
2021,239716,30,0,41,19,22
2021,239716,30,2,2,1,1
2021,239716,30,3,39,18,21
2021,239716,40,0,9,5,4
2021,239716,40,1,1,1,0
2021,239716,40,2,1,0,1
2021,239716,40,3,4,2,2
2021,239716,40,4,3,2,1
2021,239716,42,0,8,4,4
2021,239716,42,1,1,1,0
2021,239716,42,2,1,0,1
2021,239716,42,3,3,1,2
2021,239716,42,4,3,2,1
2021,239716,43,0,1,1,0
2021,239716,43,3,1,1,0
2021,239716,50,0,1,0,1
2021,239910,0,0,72,34,38
2021,239910,10,0,72,34,38
2021,239910,10,4,72,34,38
2021,239910,40,0,72,34,38
2021,239910,40,4,72,34,38
2021,239910,42,0,72,34,38
2021,239910,42,4,72,34,38
2021,240107,0,0,101,45,56
2021,240107,10,0,101,45,56
2021,240107,10,1,20,10,10
2021,240107,10,2,26,14,12
2021,240107,10,3,51,20,31
2021,240107,10,4,4,1,3
2021,240107,20,0,47,21,26
2021,240107,20,1,19,10,9
2021,240107,20,2,23,11,12
2021,240107,20,3,5,0,5
2021,240107,30,0,34,14,20
2021,240107,30,1,1,0,1
2021,240107,30,2,2,2,0
2021,240107,30,3,31,12,19
2021,240107,40,0,20,10,10
2021,240107,40,2,1,1,0
2021,240107,40,3,15,8,7
2021,240107,40,4,4,1,3
2021,240107,42,0,20,10,10
2021,240107,42,2,1,1,0
2021,240107,42,3,15,8,7
2021,240107,42,4,4,1,3
2021,240116,0,0,232,108,124
2021,240116,10,0,232,108,124
2021,240116,10,6,232,108,124
2021,240116,40,0,232,108,124
2021,240116,40,6,232,108,124
2021,240116,42,0,231,108,123
2021,240116,42,6,231,108,123
2021,240116,43,0,1,0,1
2021,240116,43,6,1,0,1
2021,240125,0,0,195,88,107
2021,240125,10,0,195,88,107
2021,240125,10,4,195,88,107
2021,240125,40,0,195,88,107
2021,240125,40,4,195,88,107
2021,240125,42,0,195,88,107
2021,240125,42,4,195,88,107
2021,240170,0,0,192,82,110
2021,240170,10,0,192,82,110
2021,240170,10,4,192,82,110
2021,240170,40,0,192,82,110
2021,240170,40,4,192,82,110
2021,240170,42,0,192,82,110
2021,240170,42,4,192,82,110
2021,240189,0,0,462,240,222
2021,240189,10,0,462,240,222
2021,240189,10,1,103,58,45
2021,240189,10,2,156,76,80
2021,240189,10,3,91,49,42
2021,240189,10,5,112,57,55
2021,240189,20,0,258,133,125
2021,240189,20,1,103,58,45
2021,240189,20,2,154,74,80
2021,240189,20,3,1,1,0
2021,240189,30,0,90,50,40
2021,240189,30,2,2,2,0
2021,240189,30,3,88,48,40
2021,240189,40,0,114,57,57
2021,240189,40,3,2,0,2
2021,240189,40,5,112,57,55
2021,240189,41,0,99,48,51
2021,240189,41,3,2,0,2
2021,240189,41,5,97,48,49
2021,240189,42,0,14,9,5
2021,240189,42,5,14,9,5
2021,240189,43,0,1,0,1
2021,240189,43,5,1,0,1
2021,240189,44,0,68,35,33
2021,240189,44,5,68,35,33
2021,240189,45,0,31,13,18
2021,240189,45,3,2,0,2
2021,240189,45,5,29,13,16
2021,240198,0,0,143,59,84
2021,240198,10,0,143,59,84
2021,240198,10,4,143,59,84
2021,240198,40,0,143,59,84
2021,240198,40,4,143,59,84
2021,240198,42,0,143,59,84
2021,240198,42,4,143,59,84
2021,240268,0,0,440,208,232
2021,240268,10,0,440,208,232
2021,240268,10,1,156,96,60
2021,240268,10,2,93,40,53
2021,240268,10,3,110,43,67
2021,240268,10,4,9,0,9
2021,240268,10,5,72,29,43
2021,240268,20,0,239,135,104
2021,240268,20,1,156,96,60
2021,240268,20,2,79,37,42
2021,240268,20,3,4,2,2
2021,240268,30,0,102,42,60
2021,240268,30,2,9,3,6
2021,240268,30,3,93,39,54
2021,240268,40,0,99,31,68
2021,240268,40,2,5,0,5
2021,240268,40,3,13,2,11
2021,240268,40,4,9,0,9
2021,240268,40,5,72,29,43
2021,240268,41,0,82,25,57
2021,240268,41,2,5,0,5
2021,240268,41,3,12,2,10
2021,240268,41,4,6,0,6
2021,240268,41,5,59,23,36
2021,240268,42,0,14,6,8
2021,240268,42,3,1,0,1
2021,240268,42,4,1,0,1
2021,240268,42,5,12,6,6
2021,240268,43,0,3,0,3
2021,240268,43,4,2,0,2
2021,240268,43,5,1,0,1
2021,240268,44,0,34,12,22
2021,240268,44,3,1,0,1
2021,240268,44,4,4,0,4
2021,240268,44,5,29,12,17
2021,240268,45,0,48,13,35
2021,240268,45,2,5,0,5
2021,240268,45,3,11,2,9
2021,240268,45,4,2,0,2
2021,240268,45,5,30,11,19
2021,240277,0,0,252,127,125
2021,240277,10,0,252,127,125
2021,240277,10,1,40,22,18
2021,240277,10,2,91,51,40
2021,240277,10,3,49,32,17
2021,240277,10,4,1,1,0
2021,240277,10,5,71,21,50
2021,240277,20,0,131,73,58
2021,240277,20,1,40,22,18
2021,240277,20,2,91,51,40
2021,240277,30,0,50,33,17
2021,240277,30,3,49,32,17
2021,240277,30,4,1,1,0
2021,240277,40,0,71,21,50
2021,240277,40,5,71,21,50
2021,240277,41,0,67,18,49
2021,240277,41,5,67,18,49
2021,240277,42,0,3,2,1
2021,240277,42,5,3,2,1
2021,240277,43,0,1,1,0
2021,240277,43,5,1,1,0
2021,240277,44,0,11,4,7
2021,240277,44,5,11,4,7
2021,240277,45,0,56,14,42
2021,240277,45,5,56,14,42
2021,240329,0,0,475,233,242
2021,240329,10,0,475,233,242
2021,240329,10,1,104,60,44
2021,240329,10,2,126,60,66
2021,240329,10,3,129,60,69
2021,240329,10,4,2,0,2
2021,240329,10,5,114,53,61
2021,240329,20,0,235,126,109
2021,240329,20,1,103,59,44
2021,240329,20,2,117,57,60
2021,240329,20,3,15,10,5
2021,240329,30,0,104,50,54
2021,240329,30,2,4,2,2
2021,240329,30,3,98,48,50
2021,240329,30,4,2,0,2
2021,240329,40,0,136,57,79
2021,240329,40,1,1,1,0
2021,240329,40,2,5,1,4
2021,240329,40,3,16,2,14
2021,240329,40,5,114,53,61
2021,240329,41,0,121,50,71
2021,240329,41,1,1,1,0
2021,240329,41,2,5,1,4
2021,240329,41,3,14,1,13
2021,240329,41,5,101,47,54
2021,240329,42,0,15,7,8
2021,240329,42,3,2,1,1
2021,240329,42,5,13,6,7
2021,240329,44,0,89,39,50
2021,240329,44,2,2,0,2
2021,240329,44,3,13,1,12
2021,240329,44,5,74,38,36
2021,240329,45,0,32,11,21
2021,240329,45,1,1,1,0
2021,240329,45,2,3,1,2
2021,240329,45,3,1,0,1
2021,240329,45,5,27,9,18
2021,240338,0,0,64,35,29
2021,240338,10,0,64,35,29
2021,240338,10,1,17,10,7
2021,240338,10,2,17,9,8
2021,240338,10,3,24,15,9
2021,240338,10,4,1,0,1
2021,240338,10,5,5,1,4
2021,240338,40,0,64,35,29
2021,240338,40,1,17,10,7
2021,240338,40,2,17,9,8
2021,240338,40,3,24,15,9
2021,240338,40,4,1,0,1
2021,240338,40,5,5,1,4
2021,240338,41,0,64,35,29
2021,240338,41,1,17,10,7
2021,240338,41,2,17,9,8
2021,240338,41,3,24,15,9
2021,240338,41,4,1,0,1
2021,240338,41,5,5,1,4
2021,240338,45,0,64,35,29
2021,240338,45,1,17,10,7
2021,240338,45,2,17,9,8
2021,240338,45,3,24,15,9
2021,240338,45,4,1,0,1
2021,240338,45,5,5,1,4
2021,240365,0,0,397,208,189
2021,240365,10,0,397,208,189
2021,240365,10,1,121,73,48
2021,240365,10,2,116,68,48
2021,240365,10,3,53,22,31
2021,240365,10,5,107,45,62
2021,240365,20,0,213,128,85
2021,240365,20,1,121,73,48
2021,240365,20,2,92,55,37
2021,240365,30,0,73,35,38
2021,240365,30,2,23,13,10
2021,240365,30,3,50,22,28
2021,240365,40,0,111,45,66
2021,240365,40,2,1,0,1
2021,240365,40,3,3,0,3
2021,240365,40,5,107,45,62
2021,240365,41,0,100,41,59
2021,240365,41,2,1,0,1
2021,240365,41,3,2,0,2
2021,240365,41,5,97,41,56
2021,240365,42,0,10,4,6
2021,240365,42,3,1,0,1
2021,240365,42,5,9,4,5
2021,240365,43,0,1,0,1
2021,240365,43,5,1,0,1
2021,240365,44,0,66,28,38
2021,240365,44,3,1,0,1
2021,240365,44,5,65,28,37
2021,240365,45,0,34,13,21
2021,240365,45,2,1,0,1
2021,240365,45,3,1,0,1
2021,240365,45,5,32,13,19
2021,240374,0,0,168,89,79
2021,240374,10,0,165,89,76
2021,240374,10,1,29,19,10
2021,240374,10,2,56,32,24
2021,240374,10,3,45,22,23
2021,240374,10,5,35,16,19
2021,240374,20,0,66,41,25
2021,240374,20,1,29,19,10
2021,240374,20,2,37,22,15
2021,240374,30,0,62,31,31
2021,240374,30,2,19,10,9
2021,240374,30,3,43,21,22
2021,240374,40,0,37,17,20
2021,240374,40,3,2,1,1
2021,240374,40,5,35,16,19
2021,240374,41,0,36,16,20
2021,240374,41,3,2,1,1
2021,240374,41,5,34,15,19
2021,240374,43,0,1,1,0
2021,240374,43,5,1,1,0
2021,240374,44,0,11,6,5
2021,240374,44,3,2,1,1
2021,240374,44,5,9,5,4
2021,240374,45,0,25,10,15
2021,240374,45,5,25,10,15
2021,240374,50,0,3,0,3
2021,240392,0,0,64,10,54
2021,240392,10,0,64,10,54
2021,240392,10,1,27,3,24
2021,240392,10,2,14,2,12
2021,240392,10,3,20,3,17
2021,240392,10,4,1,0,1
2021,240392,10,6,2,2,0
2021,240392,40,0,64,10,54
2021,240392,40,1,27,3,24
2021,240392,40,2,14,2,12
2021,240392,40,3,20,3,17
2021,240392,40,4,1,0,1
2021,240392,40,6,2,2,0
2021,240392,41,0,64,10,54
2021,240392,41,1,27,3,24
2021,240392,41,2,14,2,12
2021,240392,41,3,20,3,17
2021,240392,41,4,1,0,1
2021,240392,41,6,2,2,0
2021,240392,45,0,64,10,54
2021,240392,45,1,27,3,24
2021,240392,45,2,14,2,12
2021,240392,45,3,20,3,17
2021,240392,45,4,1,0,1
2021,240392,45,6,2,2,0
2021,240417,0,0,285,153,132
2021,240417,10,0,285,153,132
2021,240417,10,1,97,46,51
2021,240417,10,2,44,28,16
2021,240417,10,3,85,47,38
2021,240417,10,5,59,32,27
2021,240417,20,0,145,78,67
2021,240417,20,1,95,45,50
2021,240417,20,2,43,28,15
2021,240417,20,3,7,5,2
2021,240417,30,0,79,42,37
2021,240417,30,2,1,0,1
2021,240417,30,3,78,42,36
2021,240417,40,0,61,33,28
2021,240417,40,1,2,1,1
2021,240417,40,5,59,32,27
2021,240417,41,0,52,29,23
2021,240417,41,1,2,1,1
2021,240417,41,5,50,28,22
2021,240417,42,0,4,2,2
2021,240417,42,5,4,2,2
2021,240417,43,0,5,2,3
2021,240417,43,5,5,2,3
2021,240417,44,0,49,28,21
2021,240417,44,1,2,1,1
2021,240417,44,5,47,27,20
2021,240417,45,0,3,1,2
2021,240417,45,5,3,1,2
2021,240426,0,0,120,55,65
2021,240426,10,0,120,55,65
2021,240426,10,1,36,24,12
2021,240426,10,2,21,9,12
2021,240426,10,3,26,13,13
2021,240426,10,4,1,0,1
2021,240426,10,5,36,9,27
2021,240426,20,0,55,34,21
2021,240426,20,1,36,24,12
2021,240426,20,2,17,8,9
2021,240426,20,3,2,2,0
2021,240426,30,0,29,12,17
2021,240426,30,2,4,1,3
2021,240426,30,3,24,11,13
2021,240426,30,4,1,0,1
2021,240426,40,0,36,9,27
2021,240426,40,5,36,9,27
2021,240426,41,0,34,8,26
2021,240426,41,5,34,8,26
2021,240426,42,0,2,1,1
2021,240426,42,5,2,1,1
2021,240426,45,0,34,8,26
2021,240426,45,5,34,8,26
2021,240444,0,0,3748,2136,1612
2021,240444,10,0,3735,2131,1604
2021,240444,10,1,1505,982,523
2021,240444,10,2,790,425,365
2021,240444,10,3,1105,572,533
2021,240444,10,4,179,81,98
2021,240444,10,5,156,71,85
2021,240444,20,0,1444,946,498
2021,240444,20,1,1067,734,333
2021,240444,20,2,377,212,165
2021,240444,30,0,526,277,249
2021,240444,30,3,526,277,249
2021,240444,40,0,1765,908,857
2021,240444,40,1,438,248,190
2021,240444,40,2,413,213,200
2021,240444,40,3,579,295,284
2021,240444,40,4,179,81,98
2021,240444,40,5,156,71,85
2021,240444,41,0,1657,845,812
2021,240444,41,1,428,243,185
2021,240444,41,2,403,205,198
2021,240444,41,3,576,293,283
2021,240444,41,4,114,41,73
2021,240444,41,5,136,63,73
2021,240444,42,0,88,54,34
2021,240444,42,1,5,2,3
2021,240444,42,2,10,8,2
2021,240444,42,3,1,1,0
2021,240444,42,4,62,39,23
2021,240444,42,5,10,4,6
2021,240444,43,0,20,9,11
2021,240444,43,1,5,3,2
2021,240444,43,3,2,1,1
2021,240444,43,4,3,1,2
2021,240444,43,5,10,4,6
2021,240444,44,0,57,32,25
2021,240444,44,1,5,2,3
2021,240444,44,2,6,3,3
2021,240444,44,3,21,15,6
2021,240444,44,4,14,7,7
2021,240444,44,5,11,5,6
2021,240444,45,0,1600,813,787
2021,240444,45,1,423,241,182
2021,240444,45,2,397,202,195
2021,240444,45,3,555,278,277
2021,240444,45,4,100,34,66
2021,240444,45,5,125,58,67
2021,240444,50,0,13,5,8
2021,240453,0,0,952,483,469
2021,240453,10,0,952,483,469
2021,240453,10,1,240,151,89
2021,240453,10,2,333,178,155
2021,240453,10,3,146,51,95
2021,240453,10,4,22,3,19
2021,240453,10,5,211,100,111
2021,240453,20,0,509,312,197
2021,240453,20,1,224,146,78
2021,240453,20,2,285,166,119
2021,240453,30,0,114,46,68
2021,240453,30,2,22,6,16
2021,240453,30,3,92,40,52
2021,240453,40,0,329,125,204
2021,240453,40,1,16,5,11
2021,240453,40,2,26,6,20
2021,240453,40,3,54,11,43
2021,240453,40,4,22,3,19
2021,240453,40,5,211,100,111
2021,240453,41,0,307,116,191
2021,240453,41,1,16,5,11
2021,240453,41,2,26,6,20
2021,240453,41,3,48,8,40
2021,240453,41,4,20,3,17
2021,240453,41,5,197,94,103
2021,240453,42,0,14,5,9
2021,240453,42,3,4,2,2
2021,240453,42,4,2,0,2
2021,240453,42,5,8,3,5
2021,240453,43,0,8,4,4
2021,240453,43,3,2,1,1
2021,240453,43,5,6,3,3
2021,240453,44,0,117,53,64
2021,240453,44,1,1,1,0
2021,240453,44,2,2,2,0
2021,240453,44,3,16,4,12
2021,240453,44,4,14,0,14
2021,240453,44,5,84,46,38
2021,240453,45,0,190,63,127
2021,240453,45,1,15,4,11
2021,240453,45,2,24,4,20
2021,240453,45,3,32,4,28
2021,240453,45,4,6,3,3
2021,240453,45,5,113,48,65
2021,240462,0,0,272,168,104
2021,240462,10,0,272,168,104
2021,240462,10,1,79,49,30
2021,240462,10,2,69,47,22
2021,240462,10,3,63,40,23
2021,240462,10,5,61,32,29
2021,240462,20,0,145,95,50
2021,240462,20,1,79,49,30
2021,240462,20,2,66,46,20
2021,240462,30,0,66,41,25
2021,240462,30,2,3,1,2
2021,240462,30,3,63,40,23
2021,240462,40,0,61,32,29
2021,240462,40,5,61,32,29
2021,240462,41,0,52,28,24
2021,240462,41,5,52,28,24
2021,240462,42,0,5,3,2
2021,240462,42,5,5,3,2
2021,240462,43,0,4,1,3
2021,240462,43,5,4,1,3
2021,240462,44,0,47,25,22
2021,240462,44,5,47,25,22
2021,240462,45,0,5,3,2
2021,240462,45,5,5,3,2
2021,240471,0,0,207,121,86
2021,240471,10,0,207,121,86
2021,240471,10,1,91,58,33
2021,240471,10,2,32,15,17
2021,240471,10,3,63,36,27
2021,240471,10,5,21,12,9
2021,240471,20,0,120,72,48
2021,240471,20,1,89,57,32
2021,240471,20,2,31,15,16
2021,240471,30,0,53,33,20
2021,240471,30,3,53,33,20
2021,240471,40,0,34,16,18
2021,240471,40,1,2,1,1
2021,240471,40,2,1,0,1
2021,240471,40,3,10,3,7
2021,240471,40,5,21,12,9
2021,240471,41,0,29,12,17
2021,240471,41,1,2,1,1
2021,240471,41,2,1,0,1
2021,240471,41,3,7,1,6
2021,240471,41,5,19,10,9
2021,240471,42,0,5,4,1
2021,240471,42,3,3,2,1
2021,240471,42,5,2,2,0
2021,240471,44,0,11,5,6
2021,240471,44,3,1,0,1
2021,240471,44,5,10,5,5
2021,240471,45,0,18,7,11
2021,240471,45,1,2,1,1
2021,240471,45,2,1,0,1
2021,240471,45,3,6,1,5
2021,240471,45,5,9,5,4
2021,240480,0,0,318,172,146
2021,240480,10,0,318,172,146
2021,240480,10,1,126,78,48
2021,240480,10,2,81,47,34
2021,240480,10,3,67,30,37
2021,240480,10,4,1,1,0
2021,240480,10,5,43,16,27
2021,240480,20,0,201,123,78
2021,240480,20,1,126,78,48
2021,240480,20,2,75,45,30
2021,240480,30,0,66,30,36
2021,240480,30,2,3,1,2
2021,240480,30,3,62,28,34
2021,240480,30,4,1,1,0
2021,240480,40,0,51,19,32
2021,240480,40,2,3,1,2
2021,240480,40,3,5,2,3
2021,240480,40,5,43,16,27
2021,240480,41,0,44,15,29
2021,240480,41,2,3,1,2
2021,240480,41,3,4,2,2
2021,240480,41,5,37,12,25
2021,240480,42,0,6,4,2
2021,240480,42,3,1,0,1
2021,240480,42,5,5,4,1
2021,240480,43,0,1,0,1
2021,240480,43,5,1,0,1
2021,240480,44,0,23,10,13
2021,240480,44,5,23,10,13
2021,240480,45,0,21,5,16
2021,240480,45,2,3,1,2
2021,240480,45,3,4,2,2
2021,240480,45,5,14,2,12
2021,240505,0,0,119,63,56
2021,240505,10,0,119,63,56
2021,240505,10,4,119,63,56
2021,240505,20,0,93,51,42
2021,240505,20,4,93,51,42
2021,240505,30,0,26,12,14
2021,240505,30,4,26,12,14
2021,240514,0,0,62,27,35
2021,240514,10,0,62,27,35
2021,240514,10,1,28,15,13
2021,240514,10,2,6,2,4
2021,240514,10,3,8,2,6
2021,240514,10,4,20,8,12
2021,240514,40,0,62,27,35
2021,240514,40,1,28,15,13
2021,240514,40,2,6,2,4
2021,240514,40,3,8,2,6
2021,240514,40,4,20,8,12
2021,240514,41,0,62,27,35
2021,240514,41,1,28,15,13
2021,240514,41,2,6,2,4
2021,240514,41,3,8,2,6
2021,240514,41,4,20,8,12
2021,240514,44,0,62,27,35
2021,240514,44,1,28,15,13
2021,240514,44,2,6,2,4
2021,240514,44,3,8,2,6
2021,240514,44,4,20,8,12
2021,240596,0,0,33,12,21
2021,240596,10,0,31,11,20
2021,240596,10,1,8,3,5
2021,240596,10,2,8,2,6
2021,240596,10,3,15,6,9
2021,240596,20,0,17,5,12
2021,240596,20,1,8,3,5
2021,240596,20,2,7,1,6
2021,240596,20,3,2,1,1
2021,240596,30,0,14,6,8
2021,240596,30,2,1,1,0
2021,240596,30,3,13,5,8
2021,240596,50,0,2,1,1
2021,240620,0,0,114,45,69
2021,240620,10,0,113,45,68
2021,240620,10,6,113,45,68
2021,240620,40,0,113,45,68
2021,240620,40,6,113,45,68
2021,240620,41,0,40,13,27
2021,240620,41,6,40,13,27
2021,240620,42,0,66,30,36
2021,240620,42,6,66,30,36
2021,240620,43,0,7,2,5
2021,240620,43,6,7,2,5
2021,240620,45,0,40,13,27
2021,240620,45,6,40,13,27
2021,240620,50,0,1,0,1
2021,240657,0,0,51,30,21
2021,240657,10,0,51,30,21
2021,240657,10,1,3,1,2
2021,240657,10,2,17,12,5
2021,240657,10,3,19,12,7
2021,240657,10,4,12,5,7
2021,240657,20,0,35,22,13
2021,240657,20,1,3,1,2
2021,240657,20,2,17,12,5
2021,240657,20,3,15,9,6
2021,240657,30,0,6,5,1
2021,240657,30,3,3,3,0
2021,240657,30,4,3,2,1
2021,240657,40,0,10,3,7
2021,240657,40,3,1,0,1
2021,240657,40,4,9,3,6
2021,240657,42,0,10,3,7
2021,240657,42,3,1,0,1
2021,240657,42,4,9,3,6
2021,240666,0,0,98,45,53
2021,240666,10,0,92,42,50
2021,240666,10,2,3,2,1
2021,240666,10,3,49,28,21
2021,240666,10,4,40,12,28
2021,240666,20,0,55,31,24
2021,240666,20,2,3,2,1
2021,240666,20,3,49,28,21
2021,240666,20,4,3,1,2
2021,240666,30,0,30,8,22
2021,240666,30,4,30,8,22
2021,240666,40,0,7,3,4
2021,240666,40,4,7,3,4
2021,240666,42,0,7,3,4
2021,240666,42,4,7,3,4
2021,240666,50,0,6,3,3
2021,240693,0,0,64,34,30
2021,240693,10,0,64,34,30
2021,240693,10,1,12,7,5
2021,240693,10,2,19,8,11
2021,240693,10,3,13,10,3
2021,240693,10,4,20,9,11
2021,240693,40,0,64,34,30
2021,240693,40,1,12,7,5
2021,240693,40,2,19,8,11
2021,240693,40,3,13,10,3
2021,240693,40,4,20,9,11
2021,240693,42,0,64,34,30
2021,240693,42,1,12,7,5
2021,240693,42,2,19,8,11
2021,240693,42,3,13,10,3
2021,240693,42,4,20,9,11
2021,240718,0,0,42,40,2
2021,240718,10,0,42,40,2
2021,240718,10,4,42,40,2
2021,240718,40,0,42,40,2
2021,240718,40,4,42,40,2
2021,240718,41,0,42,40,2
2021,240718,41,4,42,40,2
2021,240718,45,0,42,40,2
2021,240718,45,4,42,40,2
2021,240727,0,0,711,399,312
2021,240727,10,0,711,399,312
2021,240727,10,1,217,158,59
2021,240727,10,2,175,97,78
2021,240727,10,3,143,72,71
2021,240727,10,4,7,1,6
2021,240727,10,5,169,71,98
2021,240727,20,0,379,245,134
2021,240727,20,1,210,151,59
2021,240727,20,2,169,94,75
2021,240727,30,0,137,69,68
2021,240727,30,2,5,2,3
2021,240727,30,3,132,67,65
2021,240727,40,0,195,85,110
2021,240727,40,1,7,7,0
2021,240727,40,2,1,1,0
2021,240727,40,3,11,5,6
2021,240727,40,4,7,1,6
2021,240727,40,5,169,71,98
2021,240727,41,0,112,45,67
2021,240727,41,1,1,1,0
2021,240727,41,3,9,3,6
2021,240727,41,5,102,41,61
2021,240727,42,0,83,40,43
2021,240727,42,1,6,6,0
2021,240727,42,2,1,1,0
2021,240727,42,3,2,2,0
2021,240727,42,4,7,1,6
2021,240727,42,5,67,30,37
2021,240727,44,0,112,45,67
2021,240727,44,1,1,1,0
2021,240727,44,3,9,3,6
2021,240727,44,5,102,41,61
2021,240736,0,0,81,41,40
2021,240736,10,0,81,41,40
2021,240736,10,4,81,41,40
2021,240736,20,0,50,25,25
2021,240736,20,4,50,25,25
2021,240736,30,0,1,1,0
2021,240736,30,4,1,1,0
2021,240736,40,0,30,15,15
2021,240736,40,4,30,15,15
2021,240736,42,0,7,6,1
2021,240736,42,4,7,6,1
2021,240736,43,0,23,9,14
2021,240736,43,4,23,9,14
2021,240745,0,0,50,20,30
2021,240745,10,0,50,20,30
2021,240745,10,1,7,1,6
2021,240745,10,2,4,1,3
2021,240745,10,3,15,7,8
2021,240745,10,4,19,9,10
2021,240745,10,5,5,2,3
2021,240745,20,0,45,19,26
2021,240745,20,1,7,1,6
2021,240745,20,2,4,1,3
2021,240745,20,3,15,7,8
2021,240745,20,4,17,8,9
2021,240745,20,5,2,2,0
2021,240745,30,0,1,1,0
2021,240745,30,4,1,1,0
2021,240745,40,0,4,0,4
2021,240745,40,4,1,0,1
2021,240745,40,5,3,0,3
2021,240745,42,0,3,0,3
2021,240745,42,4,1,0,1
2021,240745,42,5,2,0,2
2021,240745,43,0,1,0,1
2021,240745,43,5,1,0,1
2021,240754,0,0,137,70,67
2021,240754,10,0,137,70,67
2021,240754,10,1,38,23,15
2021,240754,10,2,44,19,25
2021,240754,10,3,35,20,15
2021,240754,10,4,20,8,12
2021,240754,20,0,73,39,34
2021,240754,20,1,36,22,14
2021,240754,20,2,35,15,20
2021,240754,20,3,2,2,0
2021,240754,30,0,37,21,16
2021,240754,30,1,1,1,0
2021,240754,30,2,7,4,3
2021,240754,30,3,27,15,12
2021,240754,30,4,2,1,1
2021,240754,40,0,27,10,17
2021,240754,40,1,1,0,1
2021,240754,40,2,2,0,2
2021,240754,40,3,6,3,3
2021,240754,40,4,18,7,11
2021,240754,41,0,15,5,10
2021,240754,41,1,1,0,1
2021,240754,41,3,4,1,3
2021,240754,41,4,10,4,6
2021,240754,42,0,11,5,6
2021,240754,42,2,1,0,1
2021,240754,42,3,2,2,0
2021,240754,42,4,8,3,5
2021,240754,43,0,1,0,1
2021,240754,43,2,1,0,1
2021,240754,44,0,15,5,10
2021,240754,44,1,1,0,1
2021,240754,44,3,4,1,3
2021,240754,44,4,10,4,6
2021,240790,0,0,34,14,20
2021,240790,10,0,34,14,20
2021,240790,10,1,1,1,0
2021,240790,10,2,6,2,4
2021,240790,10,3,18,8,10
2021,240790,10,4,9,3,6
2021,240790,40,0,34,14,20
2021,240790,40,1,1,1,0
2021,240790,40,2,6,2,4
2021,240790,40,3,18,8,10
2021,240790,40,4,9,3,6
2021,240790,41,0,34,14,20
2021,240790,41,1,1,1,0
2021,240790,41,2,6,2,4
2021,240790,41,3,18,8,10
2021,240790,41,4,9,3,6
2021,240790,44,0,34,14,20
2021,240790,44,1,1,1,0
2021,240790,44,2,6,2,4
2021,240790,44,3,18,8,10
2021,240790,44,4,9,3,6
2021,241100,0,0,7,4,3
2021,241100,10,0,7,4,3
2021,241100,10,1,1,1,0
2021,241100,10,4,6,3,3
2021,241100,20,0,7,4,3
2021,241100,20,1,1,1,0
2021,241100,20,4,6,3,3
2021,241128,0,0,6,2,4
2021,241128,10,0,6,2,4
2021,241128,10,4,6,2,4
2021,241128,20,0,6,2,4
2021,241128,20,4,6,2,4
2021,241191,0,0,35,19,16
2021,241191,10,0,35,19,16
2021,241191,10,1,1,1,0
2021,241191,10,2,8,4,4
2021,241191,10,3,17,9,8
2021,241191,10,4,3,2,1
2021,241191,10,6,6,3,3
2021,241191,20,0,16,9,7
2021,241191,20,2,7,4,3
2021,241191,20,3,8,4,4
2021,241191,20,4,1,1,0
2021,241191,30,0,15,8,7
2021,241191,30,1,1,1,0
2021,241191,30,2,1,0,1
2021,241191,30,3,9,5,4
2021,241191,30,4,2,1,1
2021,241191,30,6,2,1,1
2021,241191,40,0,4,2,2
2021,241191,40,6,4,2,2
2021,241191,42,0,2,1,1
2021,241191,42,6,2,1,1
2021,241191,43,0,2,1,1
2021,241191,43,6,2,1,1
2021,241216,0,0,64,33,31
2021,241216,10,0,64,33,31
2021,241216,10,1,64,33,31
2021,241216,40,0,64,33,31
2021,241216,40,1,64,33,31
2021,241216,41,0,25,15,10
2021,241216,41,1,25,15,10
2021,241216,42,0,6,5,1
2021,241216,42,1,6,5,1
2021,241216,43,0,33,13,20
2021,241216,43,1,33,13,20
2021,241216,44,0,25,15,10
2021,241216,44,1,25,15,10
2021,241225,0,0,24,8,16
2021,241225,10,0,21,7,14
2021,241225,10,1,2,1,1
2021,241225,10,2,8,3,5
2021,241225,10,3,3,2,1
2021,241225,10,4,8,1,7
2021,241225,40,0,21,7,14
2021,241225,40,1,2,1,1
2021,241225,40,2,8,3,5
2021,241225,40,3,3,2,1
2021,241225,40,4,8,1,7
2021,241225,41,0,1,1,0
2021,241225,41,1,1,1,0
2021,241225,42,0,20,6,14
2021,241225,42,1,1,0,1
2021,241225,42,2,8,3,5
2021,241225,42,3,3,2,1
2021,241225,42,4,8,1,7
2021,241225,44,0,1,1,0
2021,241225,44,1,1,1,0
2021,241225,50,0,3,1,2
2021,241304,0,0,47,18,29
2021,241304,10,0,29,14,15
2021,241304,10,1,29,14,15
2021,241304,40,0,29,14,15
2021,241304,40,1,29,14,15
2021,241304,41,0,29,14,15
2021,241304,41,1,29,14,15
2021,241304,44,0,29,14,15
2021,241304,44,1,29,14,15
2021,241304,50,0,18,4,14
2021,241331,0,0,36,15,21
2021,241331,10,0,36,15,21
2021,241331,10,1,7,6,1
2021,241331,10,2,15,5,10
2021,241331,10,3,14,4,10
2021,241331,40,0,36,15,21
2021,241331,40,1,7,6,1
2021,241331,40,2,15,5,10
2021,241331,40,3,14,4,10
2021,241331,41,0,30,11,19
2021,241331,41,1,7,6,1
2021,241331,41,2,13,4,9
2021,241331,41,3,10,1,9
2021,241331,42,0,6,4,2
2021,241331,42,2,2,1,1
2021,241331,42,3,4,3,1
2021,241331,44,0,30,11,19
2021,241331,44,1,7,6,1
2021,241331,44,2,13,4,9
2021,241331,44,3,10,1,9
2021,241377,0,0,19,10,9
2021,241377,10,0,19,10,9
2021,241377,10,1,1,1,0
2021,241377,10,2,1,0,1
2021,241377,10,3,4,1,3
2021,241377,10,4,13,8,5
2021,241377,40,0,19,10,9
2021,241377,40,1,1,1,0
2021,241377,40,2,1,0,1
2021,241377,40,3,4,1,3
2021,241377,40,4,13,8,5
2021,241377,42,0,19,10,9
2021,241377,42,1,1,1,0
2021,241377,42,2,1,0,1
2021,241377,42,3,4,1,3
2021,241377,42,4,13,8,5
2021,241386,0,0,6,3,3
2021,241386,10,0,6,3,3
2021,241386,10,3,2,1,1
2021,241386,10,4,4,2,2
2021,241386,40,0,6,3,3
2021,241386,40,3,2,1,1
2021,241386,40,4,4,2,2
2021,241386,42,0,6,3,3
2021,241386,42,3,2,1,1
2021,241386,42,4,4,2,2
2021,241395,0,0,23,6,17
2021,241395,10,0,23,6,17
2021,241395,10,1,2,1,1
2021,241395,10,2,7,1,6
2021,241395,10,3,6,2,4
2021,241395,10,4,2,0,2
2021,241395,10,6,6,2,4
2021,241395,40,0,23,6,17
2021,241395,40,1,2,1,1
2021,241395,40,2,7,1,6
2021,241395,40,3,6,2,4
2021,241395,40,4,2,0,2
2021,241395,40,6,6,2,4
2021,241395,41,0,10,3,7
2021,241395,41,1,2,1,1
2021,241395,41,2,6,1,5
2021,241395,41,3,2,1,1
2021,241395,42,0,8,1,7
2021,241395,42,2,1,0,1
2021,241395,42,3,4,1,3
2021,241395,42,4,2,0,2
2021,241395,42,6,1,0,1
2021,241395,43,0,5,2,3
2021,241395,43,6,5,2,3
2021,241395,45,0,10,3,7
2021,241395,45,1,2,1,1
2021,241395,45,2,6,1,5
2021,241395,45,3,2,1,1
2021,241410,0,0,204,91,113
2021,241410,10,0,204,91,113
2021,241410,10,1,37,20,17
2021,241410,10,2,65,30,35
2021,241410,10,3,69,29,40
2021,241410,10,4,21,6,15
2021,241410,10,6,12,6,6
2021,241410,40,0,204,91,113
2021,241410,40,1,37,20,17
2021,241410,40,2,65,30,35
2021,241410,40,3,69,29,40
2021,241410,40,4,21,6,15
2021,241410,40,6,12,6,6
2021,241410,41,0,151,69,82
2021,241410,41,1,36,20,16
2021,241410,41,2,64,29,35
2021,241410,41,3,49,18,31
2021,241410,41,4,2,2,0
2021,241410,42,0,47,18,29
2021,241410,42,1,1,0,1
2021,241410,42,2,1,1,0
2021,241410,42,3,20,11,9
2021,241410,42,4,19,4,15
2021,241410,42,6,6,2,4
2021,241410,43,0,6,4,2
2021,241410,43,6,6,4,2
2021,241410,45,0,151,69,82
2021,241410,45,1,36,20,16
2021,241410,45,2,64,29,35
2021,241410,45,3,49,18,31
2021,241410,45,4,2,2,0
2021,241517,0,0,2,1,1
2021,241517,10,0,2,1,1
2021,241517,10,1,2,1,1
2021,241517,20,0,2,1,1
2021,241517,20,1,2,1,1
2021,241614,0,0,18,11,7
2021,241614,10,0,18,11,7
2021,241614,10,1,1,0,1
2021,241614,10,4,2,2,0
2021,241614,10,6,15,9,6
2021,241614,20,0,2,1,1
2021,241614,20,1,1,0,1
2021,241614,20,4,1,1,0
2021,241614,40,0,16,10,6
2021,241614,40,4,1,1,0
2021,241614,40,6,15,9,6
2021,241614,41,0,1,1,0
2021,241614,41,4,1,1,0
2021,241614,43,0,15,9,6
2021,241614,43,6,15,9,6
2021,241614,44,0,1,1,0
2021,241614,44,4,1,1,0
2021,241720,0,0,20,8,12
2021,241720,10,0,20,8,12
2021,241720,10,2,1,1,0
2021,241720,10,3,5,2,3
2021,241720,10,4,14,5,9
2021,241720,20,0,20,8,12
2021,241720,20,2,1,1,0
2021,241720,20,3,5,2,3
2021,241720,20,4,14,5,9
2021,241739,0,0,126,38,88
2021,241739,10,0,126,38,88
2021,241739,10,1,8,3,5
2021,241739,10,2,14,6,8
2021,241739,10,3,45,14,31
2021,241739,10,4,59,15,44
2021,241739,20,0,3,1,2
2021,241739,20,1,1,0,1
2021,241739,20,2,2,1,1
2021,241739,40,0,123,37,86
2021,241739,40,1,7,3,4
2021,241739,40,2,12,5,7
2021,241739,40,3,45,14,31
2021,241739,40,4,59,15,44
2021,241739,41,0,46,18,28
2021,241739,41,1,7,3,4
2021,241739,41,2,11,5,6
2021,241739,41,3,23,8,15
2021,241739,41,4,5,2,3
2021,241739,42,0,77,19,58
2021,241739,42,2,1,0,1
2021,241739,42,3,22,6,16
2021,241739,42,4,54,13,41
2021,241739,44,0,46,18,28
2021,241739,44,1,7,3,4
2021,241739,44,2,11,5,6
2021,241739,44,3,23,8,15
2021,241739,44,4,5,2,3
2021,241766,0,0,33,24,9
2021,241766,10,0,33,24,9
2021,241766,10,1,9,4,5
2021,241766,10,2,13,10,3
2021,241766,10,3,8,8,0
2021,241766,10,4,3,2,1
2021,241766,20,0,32,23,9
2021,241766,20,1,9,4,5
2021,241766,20,2,13,10,3
2021,241766,20,3,8,8,0
2021,241766,20,4,2,1,1
2021,241766,30,0,1,1,0
2021,241766,30,4,1,1,0
2021,241836,0,0,36,8,28
2021,241836,10,0,36,8,28
2021,241836,10,4,36,8,28
2021,241836,40,0,36,8,28
2021,241836,40,4,36,8,28
2021,241836,41,0,36,8,28
2021,241836,41,4,36,8,28
2021,241836,45,0,36,8,28
2021,241836,45,4,36,8,28
2021,241951,0,0,19,9,10
2021,241951,10,0,19,9,10
2021,241951,10,1,1,0,1
2021,241951,10,2,1,0,1
2021,241951,10,4,9,6,3
2021,241951,10,6,8,3,5
2021,241951,20,0,11,6,5
2021,241951,20,1,1,0,1
2021,241951,20,2,1,0,1
2021,241951,20,4,9,6,3
2021,241951,40,0,8,3,5
2021,241951,40,6,8,3,5
2021,241951,43,0,8,3,5
2021,241951,43,6,8,3,5
2021,242042,0,0,45,15,30
2021,242042,10,0,45,15,30
2021,242042,10,1,45,15,30
2021,242042,20,0,26,6,20
2021,242042,20,1,26,6,20
2021,242042,30,0,18,9,9
2021,242042,30,1,18,9,9
2021,242042,40,0,1,0,1
2021,242042,40,1,1,0,1
2021,242042,43,0,1,0,1
2021,242042,43,1,1,0,1
2021,242112,0,0,12,3,9
2021,242112,10,0,12,3,9
2021,242112,10,1,12,3,9
2021,242112,20,0,12,3,9
2021,242112,20,1,12,3,9
2021,242121,0,0,6,3,3
2021,242121,10,0,6,3,3
2021,242121,10,1,6,3,3
2021,242121,40,0,6,3,3
2021,242121,40,1,6,3,3
2021,242121,42,0,6,3,3
2021,242121,42,1,6,3,3
2021,242130,0,0,12,3,9
2021,242130,10,0,12,3,9
2021,242130,10,4,12,3,9
2021,242130,40,0,12,3,9
2021,242130,40,4,12,3,9
2021,242130,43,0,12,3,9
2021,242130,43,4,12,3,9
2021,242149,0,0,10,3,7
2021,242149,10,0,10,3,7
2021,242149,10,4,10,3,7
2021,242149,40,0,10,3,7
2021,242149,40,4,10,3,7
2021,242149,43,0,10,3,7
2021,242149,43,4,10,3,7
2021,242556,0,0,35,18,17
2021,242556,10,0,35,18,17
2021,242556,10,1,35,18,17
2021,242556,20,0,30,14,16
2021,242556,20,1,30,14,16
2021,242556,30,0,2,1,1
2021,242556,30,1,2,1,1
2021,242556,40,0,3,3,0
2021,242556,40,1,3,3,0
2021,242556,41,0,3,3,0
2021,242556,41,1,3,3,0
2021,242556,44,0,3,3,0
2021,242556,44,1,3,3,0
2021,242565,0,0,32,13,19
2021,242565,10,0,32,13,19
2021,242565,10,1,32,13,19
2021,242565,40,0,32,13,19
2021,242565,40,1,32,13,19
2021,242565,41,0,32,13,19
2021,242565,41,1,32,13,19
2021,242565,45,0,32,13,19
2021,242565,45,1,32,13,19
2021,242583,0,0,34,17,17
2021,242583,10,0,34,17,17
2021,242583,10,1,34,17,17
2021,242583,20,0,18,7,11
2021,242583,20,1,18,7,11
2021,242583,30,0,16,10,6
2021,242583,30,1,16,10,6
2021,242617,0,0,73,29,44
2021,242617,10,0,73,29,44
2021,242617,10,1,17,11,6
2021,242617,10,2,29,11,18
2021,242617,10,3,25,7,18
2021,242617,10,4,2,0,2
2021,242617,20,0,57,24,33
2021,242617,20,1,17,11,6
2021,242617,20,2,27,9,18
2021,242617,20,3,13,4,9
2021,242617,30,0,10,4,6
2021,242617,30,2,1,1,0
2021,242617,30,3,9,3,6
2021,242617,40,0,6,1,5
2021,242617,40,2,1,1,0
2021,242617,40,3,3,0,3
2021,242617,40,4,2,0,2
2021,242617,41,0,1,0,1
2021,242617,41,4,1,0,1
2021,242617,42,0,5,1,4
2021,242617,42,2,1,1,0
2021,242617,42,3,3,0,3
2021,242617,42,4,1,0,1
2021,242617,44,0,1,0,1
2021,242617,44,4,1,0,1
2021,242626,0,0,76,31,45
2021,242626,10,0,76,31,45
2021,242626,10,1,7,0,7
2021,242626,10,2,15,6,9
2021,242626,10,3,37,21,16
2021,242626,10,4,17,4,13
2021,242626,20,0,42,18,24
2021,242626,20,1,7,0,7
2021,242626,20,2,13,6,7
2021,242626,20,3,22,12,10
2021,242626,30,0,12,5,7
2021,242626,30,2,2,0,2
2021,242626,30,3,10,5,5
2021,242626,40,0,22,8,14
2021,242626,40,3,5,4,1
2021,242626,40,4,17,4,13
2021,242626,42,0,16,6,10
2021,242626,42,3,4,3,1
2021,242626,42,4,12,3,9
2021,242626,43,0,6,2,4
2021,242626,43,3,1,1,0
2021,242626,43,4,5,1,4
2021,242635,0,0,67,32,35
2021,242635,10,0,67,32,35
2021,242635,10,1,17,9,8
2021,242635,10,2,8,4,4
2021,242635,10,3,33,16,17
2021,242635,10,4,9,3,6
2021,242635,20,0,36,20,16
2021,242635,20,1,17,9,8
2021,242635,20,2,8,4,4
2021,242635,20,3,11,7,4
2021,242635,30,0,14,5,9
2021,242635,30,3,9,4,5
2021,242635,30,4,5,1,4
2021,242635,40,0,17,7,10
2021,242635,40,3,13,5,8
2021,242635,40,4,4,2,2
2021,242635,42,0,16,7,9
2021,242635,42,3,12,5,7
2021,242635,42,4,4,2,2
2021,242635,43,0,1,0,1
2021,242635,43,3,1,0,1
2021,242644,0,0,29,12,17
2021,242644,10,0,29,12,17
2021,242644,10,1,1,1,0
2021,242644,10,2,5,2,3
2021,242644,10,3,14,7,7
2021,242644,10,4,9,2,7
2021,242644,20,0,10,4,6
2021,242644,20,1,1,1,0
2021,242644,20,2,4,1,3
2021,242644,20,3,5,2,3
2021,242644,30,0,6,2,4
2021,242644,30,2,1,1,0
2021,242644,30,3,2,1,1
2021,242644,30,4,3,0,3
2021,242644,40,0,13,6,7
2021,242644,40,3,7,4,3
2021,242644,40,4,6,2,4
2021,242644,42,0,13,6,7
2021,242644,42,3,7,4,3
2021,242644,42,4,6,2,4
2021,242653,0,0,150,72,78
2021,242653,10,0,150,72,78
2021,242653,10,1,38,22,16
2021,242653,10,2,56,27,29
2021,242653,10,3,43,16,27
2021,242653,10,4,13,7,6
2021,242653,20,0,88,46,42
2021,242653,20,1,36,22,14
2021,242653,20,2,43,22,21
2021,242653,20,3,9,2,7
2021,242653,30,0,33,12,21
2021,242653,30,1,2,0,2
2021,242653,30,2,7,3,4
2021,242653,30,3,20,8,12
2021,242653,30,4,4,1,3
2021,242653,40,0,29,14,15
2021,242653,40,2,6,2,4
2021,242653,40,3,14,6,8
2021,242653,40,4,9,6,3
2021,242653,42,0,29,14,15
2021,242653,42,2,6,2,4
2021,242653,42,3,14,6,8
2021,242653,42,4,9,6,3
2021,242662,0,0,90,35,55
2021,242662,10,0,90,35,55
2021,242662,10,1,17,8,9
2021,242662,10,2,27,14,13
2021,242662,10,3,38,12,26
2021,242662,10,4,8,1,7
2021,242662,20,0,57,26,31
2021,242662,20,1,16,8,8
2021,242662,20,2,21,12,9
2021,242662,20,3,20,6,14
2021,242662,30,0,21,5,16
2021,242662,30,2,6,2,4
2021,242662,30,3,10,2,8
2021,242662,30,4,5,1,4
2021,242662,40,0,12,4,8
2021,242662,40,1,1,0,1
2021,242662,40,3,8,4,4
2021,242662,40,4,3,0,3
2021,242662,42,0,12,4,8
2021,242662,42,1,1,0,1
2021,242662,42,3,8,4,4
2021,242662,42,4,3,0,3
2021,242680,0,0,33,12,21
2021,242680,10,0,33,12,21
2021,242680,10,1,3,2,1
2021,242680,10,2,9,4,5
2021,242680,10,3,19,6,13
2021,242680,10,4,2,0,2
2021,242680,20,0,20,11,9
2021,242680,20,1,3,2,1
2021,242680,20,2,7,4,3
2021,242680,20,3,10,5,5
2021,242680,30,0,7,1,6
2021,242680,30,2,2,0,2
2021,242680,30,3,5,1,4
2021,242680,40,0,6,0,6
2021,242680,40,3,4,0,4
2021,242680,40,4,2,0,2
2021,242680,42,0,6,0,6
2021,242680,42,3,4,0,4
2021,242680,42,4,2,0,2
2021,242699,0,0,34,13,21
2021,242699,10,0,34,13,21
2021,242699,10,1,1,0,1
2021,242699,10,2,7,4,3
2021,242699,10,3,15,5,10
2021,242699,10,4,11,4,7
2021,242699,20,0,17,5,12
2021,242699,20,1,1,0,1
2021,242699,20,2,6,3,3
2021,242699,20,3,10,2,8
2021,242699,30,0,6,3,3
2021,242699,30,2,1,1,0
2021,242699,30,3,3,2,1
2021,242699,30,4,2,0,2
2021,242699,40,0,11,5,6
2021,242699,40,3,2,1,1
2021,242699,40,4,9,4,5
2021,242699,42,0,11,5,6
2021,242699,42,3,2,1,1
2021,242699,42,4,9,4,5
2021,242705,0,0,82,44,38
2021,242705,10,0,82,44,38
2021,242705,10,1,13,10,3
2021,242705,10,2,20,10,10
2021,242705,10,3,37,20,17
2021,242705,10,4,12,4,8
2021,242705,20,0,51,29,22
2021,242705,20,1,13,10,3
2021,242705,20,2,16,8,8
2021,242705,20,3,22,11,11
2021,242705,30,0,17,9,8
2021,242705,30,2,4,2,2
2021,242705,30,3,9,6,3
2021,242705,30,4,4,1,3
2021,242705,40,0,14,6,8
2021,242705,40,3,6,3,3
2021,242705,40,4,8,3,5
2021,242705,42,0,11,5,6
2021,242705,42,3,4,2,2
2021,242705,42,4,7,3,4
2021,242705,43,0,3,1,2
2021,242705,43,3,2,1,1
2021,242705,43,4,1,0,1
2021,242723,0,0,20,12,8
2021,242723,10,0,20,12,8
2021,242723,10,1,12,7,5
2021,242723,10,2,7,4,3
2021,242723,10,3,1,1,0
2021,242723,20,0,17,10,7
2021,242723,20,1,12,7,5
2021,242723,20,2,5,3,2
2021,242723,30,0,3,2,1
2021,242723,30,2,2,1,1
2021,242723,30,3,1,1,0
2021,242972,0,0,282,94,188
2021,242972,10,0,282,94,188
2021,242972,10,1,7,5,2
2021,242972,10,2,56,18,38
2021,242972,10,4,219,71,148
2021,242972,20,0,79,25,54
2021,242972,20,1,7,5,2
2021,242972,20,2,56,18,38
2021,242972,20,4,16,2,14
2021,242972,40,0,203,69,134
2021,242972,40,4,203,69,134
2021,242972,42,0,5,0,5
2021,242972,42,4,5,0,5
2021,242972,43,0,198,69,129
2021,242972,43,4,198,69,129
2021,243081,0,0,114,40,74
2021,243081,10,0,114,40,74
2021,243081,10,1,34,15,19
2021,243081,10,2,19,7,12
2021,243081,10,3,57,16,41
2021,243081,10,4,4,2,2
2021,243081,40,0,114,40,74
2021,243081,40,1,34,15,19
2021,243081,40,2,19,7,12
2021,243081,40,3,57,16,41
2021,243081,40,4,4,2,2
2021,243081,41,0,114,40,74
2021,243081,41,1,34,15,19
2021,243081,41,2,19,7,12
2021,243081,41,3,57,16,41
2021,243081,41,4,4,2,2
2021,243081,44,0,10,3,7
2021,243081,44,1,1,1,0
2021,243081,44,2,1,0,1
2021,243081,44,3,8,2,6
2021,243081,45,0,104,37,67
2021,243081,45,1,33,14,19
2021,243081,45,2,18,7,11
2021,243081,45,3,49,14,35
2021,243081,45,4,4,2,2
2021,243106,0,0,87,42,45
2021,243106,10,0,87,42,45
2021,243106,10,1,38,21,17
2021,243106,10,2,17,10,7
2021,243106,10,3,21,6,15
2021,243106,10,4,11,5,6
2021,243106,20,0,63,35,28
2021,243106,20,1,38,21,17
2021,243106,20,2,17,10,7
2021,243106,20,3,6,2,4
2021,243106,20,4,2,2,0
2021,243106,40,0,24,7,17
2021,243106,40,3,15,4,11
2021,243106,40,4,9,3,6
2021,243106,43,0,24,7,17
2021,243106,43,3,15,4,11
2021,243106,43,4,9,3,6
2021,243115,0,0,130,58,72
2021,243115,10,0,130,58,72
2021,243115,10,1,69,31,38
2021,243115,10,2,29,13,16
2021,243115,10,3,19,10,9
2021,243115,10,4,13,4,9
2021,243115,20,0,108,52,56
2021,243115,20,1,68,31,37
2021,243115,20,2,28,12,16
2021,243115,20,3,10,7,3
2021,243115,20,4,2,2,0
2021,243115,30,0,2,1,1
2021,243115,30,1,1,0,1
2021,243115,30,2,1,1,0
2021,243115,40,0,20,5,15
2021,243115,40,3,9,3,6
2021,243115,40,4,11,2,9
2021,243115,42,0,15,3,12
2021,243115,42,3,6,1,5
2021,243115,42,4,9,2,7
2021,243115,43,0,5,2,3
2021,243115,43,3,3,2,1
2021,243115,43,4,2,0,2
2021,243133,0,0,164,81,83
2021,243133,10,0,164,81,83
2021,243133,10,1,54,31,23
2021,243133,10,2,37,17,20
2021,243133,10,3,55,23,32
2021,243133,10,4,18,10,8
2021,243133,20,0,114,59,55
2021,243133,20,1,54,31,23
2021,243133,20,2,36,16,20
2021,243133,20,3,22,10,12
2021,243133,20,4,2,2,0
2021,243133,30,0,6,2,4
2021,243133,30,2,1,1,0
2021,243133,30,3,5,1,4
2021,243133,40,0,44,20,24
2021,243133,40,3,28,12,16
2021,243133,40,4,16,8,8
2021,243133,43,0,44,20,24
2021,243133,43,3,28,12,16
2021,243133,43,4,16,8,8
2021,243142,0,0,82,42,40
2021,243142,10,0,82,42,40
2021,243142,10,1,24,14,10
2021,243142,10,2,18,8,10
2021,243142,10,3,16,8,8
2021,243142,10,4,24,12,12
2021,243142,20,0,55,30,25
2021,243142,20,1,24,14,10
2021,243142,20,2,18,8,10
2021,243142,20,3,9,6,3
2021,243142,20,4,4,2,2
2021,243142,30,0,2,2,0
2021,243142,30,3,1,1,0
2021,243142,30,4,1,1,0
2021,243142,40,0,25,10,15
2021,243142,40,3,6,1,5
2021,243142,40,4,19,9,10
2021,243142,42,0,17,7,10
2021,243142,42,3,5,1,4
2021,243142,42,4,12,6,6
2021,243142,43,0,8,3,5
2021,243142,43,3,1,0,1
2021,243142,43,4,7,3,4
2021,243151,0,0,118,58,60
2021,243151,10,0,118,58,60
2021,243151,10,1,31,15,16
2021,243151,10,2,37,20,17
2021,243151,10,3,41,17,24
2021,243151,10,4,9,6,3
2021,243151,20,0,68,38,30
2021,243151,20,1,31,15,16
2021,243151,20,2,31,19,12
2021,243151,20,3,6,4,2
2021,243151,30,0,10,4,6
2021,243151,30,2,6,1,5
2021,243151,30,3,4,3,1
2021,243151,40,0,40,16,24
2021,243151,40,3,31,10,21
2021,243151,40,4,9,6,3
2021,243151,43,0,40,16,24
2021,243151,43,3,31,10,21
2021,243151,43,4,9,6,3
2021,243179,0,0,146,74,72
2021,243179,10,0,146,74,72
2021,243179,10,1,77,42,35
2021,243179,10,2,26,14,12
2021,243179,10,3,27,12,15
2021,243179,10,4,16,6,10
2021,243179,20,0,108,61,47
2021,243179,20,1,77,42,35
2021,243179,20,2,25,14,11
2021,243179,20,3,6,5,1
2021,243179,30,0,7,3,4
2021,243179,30,2,1,0,1
2021,243179,30,3,5,3,2
2021,243179,30,4,1,0,1
2021,243179,40,0,31,10,21
2021,243179,40,3,16,4,12
2021,243179,40,4,15,6,9
2021,243179,43,0,31,10,21
2021,243179,43,3,16,4,12
2021,243179,43,4,15,6,9
2021,243188,0,0,41,18,23
2021,243188,10,0,41,18,23
2021,243188,10,1,17,9,8
2021,243188,10,2,8,3,5
2021,243188,10,3,8,3,5
2021,243188,10,4,8,3,5
2021,243188,20,0,29,14,15
2021,243188,20,1,17,9,8
2021,243188,20,2,8,3,5
2021,243188,20,3,3,1,2
2021,243188,20,4,1,1,0
2021,243188,40,0,12,4,8
2021,243188,40,3,5,2,3
2021,243188,40,4,7,2,5
2021,243188,43,0,12,4,8
2021,243188,43,3,5,2,3
2021,243188,43,4,7,2,5
2021,243197,0,0,466,296,170
2021,243197,10,0,466,296,170
2021,243197,10,1,297,201,96
2021,243197,10,2,73,43,30
2021,243197,10,3,63,35,28
2021,243197,10,4,32,16,16
2021,243197,10,6,1,1,0
2021,243197,20,0,376,249,127
2021,243197,20,1,296,200,96
2021,243197,20,2,72,43,29
2021,243197,20,3,6,4,2
2021,243197,20,4,1,1,0
2021,243197,20,6,1,1,0
2021,243197,30,0,29,18,11
2021,243197,30,2,1,0,1
2021,243197,30,3,28,18,10
2021,243197,40,0,61,29,32
2021,243197,40,1,1,1,0
2021,243197,40,3,29,13,16
2021,243197,40,4,31,15,16
2021,243197,42,0,61,29,32
2021,243197,42,1,1,1,0
2021,243197,42,3,29,13,16
2021,243197,42,4,31,15,16
2021,243203,0,0,598,238,360
2021,243203,10,0,598,238,360
2021,243203,10,1,270,119,151
2021,243203,10,2,132,54,78
2021,243203,10,3,129,52,77
2021,243203,10,4,20,5,15
2021,243203,10,6,47,8,39
2021,243203,20,0,350,144,206
2021,243203,20,1,237,103,134
2021,243203,20,2,82,32,50
2021,243203,20,3,26,9,17
2021,243203,20,4,5,0,5
2021,243203,30,0,54,24,30
2021,243203,30,1,11,5,6
2021,243203,30,2,17,7,10
2021,243203,30,3,21,11,10
2021,243203,30,4,4,1,3
2021,243203,30,6,1,0,1
2021,243203,40,0,194,70,124
2021,243203,40,1,22,11,11
2021,243203,40,2,33,15,18
2021,243203,40,3,82,32,50
2021,243203,40,4,11,4,7
2021,243203,40,6,46,8,38
2021,243203,42,0,194,70,124
2021,243203,42,1,22,11,11
2021,243203,42,2,33,15,18
2021,243203,42,3,82,32,50
2021,243203,42,4,11,4,7
2021,243203,42,6,46,8,38
2021,243212,0,0,82,36,46
2021,243212,10,0,82,36,46
2021,243212,10,1,22,11,11
2021,243212,10,2,21,8,13
2021,243212,10,3,23,8,15
2021,243212,10,4,16,9,7
2021,243212,20,0,55,26,29
2021,243212,20,1,22,11,11
2021,243212,20,2,21,8,13
2021,243212,20,3,7,2,5
2021,243212,20,4,5,5,0
2021,243212,30,0,2,0,2
2021,243212,30,3,2,0,2
2021,243212,40,0,25,10,15
2021,243212,40,3,14,6,8
2021,243212,40,4,11,4,7
2021,243212,42,0,4,2,2
2021,243212,42,3,1,0,1
2021,243212,42,4,3,2,1
2021,243212,43,0,21,8,13
2021,243212,43,3,13,6,7
2021,243212,43,4,8,2,6
2021,243221,0,0,743,394,349
2021,243221,10,0,743,394,349
2021,243221,10,1,372,216,156
2021,243221,10,2,85,38,47
2021,243221,10,3,198,99,99
2021,243221,10,4,72,34,38
2021,243221,10,6,16,7,9
2021,243221,20,0,515,282,233
2021,243221,20,1,371,216,155
2021,243221,20,2,85,38,47
2021,243221,20,3,40,20,20
2021,243221,20,4,5,2,3
2021,243221,20,6,14,6,8
2021,243221,30,0,25,15,10
2021,243221,30,3,24,15,9
2021,243221,30,4,1,0,1
2021,243221,40,0,203,97,106
2021,243221,40,1,1,0,1
2021,243221,40,3,134,64,70
2021,243221,40,4,66,32,34
2021,243221,40,6,2,1,1
2021,243221,42,0,75,38,37
2021,243221,42,3,57,26,31
2021,243221,42,4,17,12,5
2021,243221,42,6,1,0,1
2021,243221,43,0,128,59,69
2021,243221,43,1,1,0,1
2021,243221,43,3,77,38,39
2021,243221,43,4,49,20,29
2021,243221,43,6,1,1,0
2021,243346,0,0,98,42,56
2021,243346,10,0,98,42,56
2021,243346,10,1,10,6,4
2021,243346,10,2,16,4,12
2021,243346,10,3,31,13,18
2021,243346,10,4,41,19,22
2021,243346,20,0,3,2,1
2021,243346,20,1,1,1,0
2021,243346,20,2,1,0,1
2021,243346,20,3,1,1,0
2021,243346,40,0,95,40,55
2021,243346,40,1,9,5,4
2021,243346,40,2,15,4,11
2021,243346,40,3,30,12,18
2021,243346,40,4,41,19,22
2021,243346,41,0,62,33,29
2021,243346,41,1,9,5,4
2021,243346,41,2,15,4,11
2021,243346,41,3,24,11,13
2021,243346,41,4,14,13,1
2021,243346,42,0,33,7,26
2021,243346,42,3,6,1,5
2021,243346,42,4,27,6,21
2021,243346,44,0,62,33,29
2021,243346,44,1,9,5,4
2021,243346,44,2,15,4,11
2021,243346,44,3,24,11,13
2021,243346,44,4,14,13,1
2021,243443,0,0,70,27,43
2021,243443,10,0,61,23,38
2021,243443,10,1,24,10,14
2021,243443,10,2,8,4,4
2021,243443,10,3,11,3,8
2021,243443,10,4,18,6,12
2021,243443,20,0,45,19,26
2021,243443,20,1,24,10,14
2021,243443,20,2,8,4,4
2021,243443,20,3,8,2,6
2021,243443,20,4,5,3,2
2021,243443,40,0,16,4,12
2021,243443,40,3,3,1,2
2021,243443,40,4,13,3,10
2021,243443,42,0,3,1,2
2021,243443,42,3,3,1,2
2021,243443,43,0,13,3,10
2021,243443,43,4,13,3,10
2021,243443,50,0,9,4,5
2021,243498,0,0,5,4,1
2021,243498,10,0,5,4,1
2021,243498,10,1,5,4,1
2021,243498,40,0,5,4,1
2021,243498,40,1,5,4,1
2021,243498,41,0,5,4,1
2021,243498,41,1,5,4,1
2021,243498,45,0,5,4,1
2021,243498,45,1,5,4,1
2021,243568,0,0,40,15,25
2021,243568,10,0,40,15,25
2021,243568,10,1,11,5,6
2021,243568,10,2,12,5,7
2021,243568,10,3,14,4,10
2021,243568,10,4,3,1,2
2021,243568,40,0,40,15,25
2021,243568,40,1,11,5,6
2021,243568,40,2,12,5,7
2021,243568,40,3,14,4,10
2021,243568,40,4,3,1,2
2021,243568,41,0,40,15,25
2021,243568,41,1,11,5,6
2021,243568,41,2,12,5,7
2021,243568,41,3,14,4,10
2021,243568,41,4,3,1,2
2021,243568,44,0,40,15,25
2021,243568,44,1,11,5,6
2021,243568,44,2,12,5,7
2021,243568,44,3,14,4,10
2021,243568,44,4,3,1,2
2021,243577,0,0,131,85,46
2021,243577,10,0,131,85,46
2021,243577,10,1,32,24,8
2021,243577,10,2,78,47,31
2021,243577,10,3,15,10,5
2021,243577,10,4,6,4,2
2021,243577,40,0,131,85,46
2021,243577,40,1,32,24,8
2021,243577,40,2,78,47,31
2021,243577,40,3,15,10,5
2021,243577,40,4,6,4,2
2021,243577,41,0,131,85,46
2021,243577,41,1,32,24,8
2021,243577,41,2,78,47,31
2021,243577,41,3,15,10,5
2021,243577,41,4,6,4,2
2021,243577,44,0,131,85,46
2021,243577,44,1,32,24,8
2021,243577,44,2,78,47,31
2021,243577,44,3,15,10,5
2021,243577,44,4,6,4,2
2021,243586,0,0,36,15,21
2021,243586,10,0,36,15,21
2021,243586,10,1,5,4,1
2021,243586,10,2,7,2,5
2021,243586,10,3,18,8,10
2021,243586,10,4,1,0,1
2021,243586,10,6,5,1,4
2021,243586,40,0,36,15,21
2021,243586,40,1,5,4,1
2021,243586,40,2,7,2,5
2021,243586,40,3,18,8,10
2021,243586,40,4,1,0,1
2021,243586,40,6,5,1,4
2021,243586,41,0,26,14,12
2021,243586,41,1,5,4,1
2021,243586,41,2,4,2,2
2021,243586,41,3,17,8,9
2021,243586,42,0,7,0,7
2021,243586,42,2,3,0,3
2021,243586,42,3,1,0,1
2021,243586,42,4,1,0,1
2021,243586,42,6,2,0,2
2021,243586,43,0,3,1,2
2021,243586,43,6,3,1,2
2021,243586,45,0,26,14,12
2021,243586,45,1,5,4,1
2021,243586,45,2,4,2,2
2021,243586,45,3,17,8,9
2021,243601,0,0,141,67,74
2021,243601,10,0,141,67,74
2021,243601,10,1,18,11,7
2021,243601,10,2,26,11,15
2021,243601,10,3,62,27,35
2021,243601,10,4,35,18,17
2021,243601,20,0,12,5,7
2021,243601,20,1,7,3,4
2021,243601,20,2,5,2,3
2021,243601,40,0,129,62,67
2021,243601,40,1,11,8,3
2021,243601,40,2,21,9,12
2021,243601,40,3,62,27,35
2021,243601,40,4,35,18,17
2021,243601,41,0,90,49,41
2021,243601,41,1,10,7,3
2021,243601,41,2,20,9,11
2021,243601,41,3,45,23,22
2021,243601,41,4,15,10,5
2021,243601,42,0,39,13,26
2021,243601,42,1,1,1,0
2021,243601,42,2,1,0,1
2021,243601,42,3,17,4,13
2021,243601,42,4,20,8,12
2021,243601,44,0,90,49,41
2021,243601,44,1,10,7,3
2021,243601,44,2,20,9,11
2021,243601,44,3,45,23,22
2021,243601,44,4,15,10,5
2021,243638,0,0,91,59,32
2021,243638,10,0,91,59,32
2021,243638,10,1,48,30,18
2021,243638,10,2,11,10,1
2021,243638,10,3,14,8,6
2021,243638,10,4,18,11,7
2021,243638,40,0,91,59,32
2021,243638,40,1,48,30,18
2021,243638,40,2,11,10,1
2021,243638,40,3,14,8,6
2021,243638,40,4,18,11,7
2021,243638,41,0,91,59,32
2021,243638,41,1,48,30,18
2021,243638,41,2,11,10,1
2021,243638,41,3,14,8,6
2021,243638,41,4,18,11,7
2021,243638,44,0,91,59,32
2021,243638,44,1,48,30,18
2021,243638,44,2,11,10,1
2021,243638,44,3,14,8,6
2021,243638,44,4,18,11,7
2021,243647,0,0,36,16,20
2021,243647,10,0,36,16,20
2021,243647,10,2,13,5,8
2021,243647,10,4,19,8,11
2021,243647,10,5,4,3,1
2021,243647,40,0,36,16,20
2021,243647,40,2,13,5,8
2021,243647,40,4,19,8,11
2021,243647,40,5,4,3,1
2021,243647,41,0,34,15,19
2021,243647,41,2,13,5,8
2021,243647,41,4,18,8,10
2021,243647,41,5,3,2,1
2021,243647,42,0,2,1,1
2021,243647,42,4,1,0,1
2021,243647,42,5,1,1,0
2021,243647,44,0,34,15,19
2021,243647,44,2,13,5,8
2021,243647,44,4,18,8,10
2021,243647,44,5,3,2,1
2021,243665,0,0,114,52,62
2021,243665,10,0,114,52,62
2021,243665,10,1,22,15,7
2021,243665,10,2,22,12,10
2021,243665,10,3,57,20,37
2021,243665,10,4,13,5,8
2021,243665,20,0,28,20,8
2021,243665,20,1,13,10,3
2021,243665,20,2,11,8,3
2021,243665,20,3,4,2,2
2021,243665,30,0,32,14,18
2021,243665,30,1,1,1,0
2021,243665,30,2,8,3,5
2021,243665,30,3,23,10,13
2021,243665,40,0,54,18,36
2021,243665,40,1,8,4,4
2021,243665,40,2,3,1,2
2021,243665,40,3,30,8,22
2021,243665,40,4,13,5,8
2021,243665,41,0,21,6,15
2021,243665,41,1,2,1,1
2021,243665,41,2,1,0,1
2021,243665,41,3,13,2,11
2021,243665,41,4,5,3,2
2021,243665,42,0,33,12,21
2021,243665,42,1,6,3,3
2021,243665,42,2,2,1,1
2021,243665,42,3,17,6,11
2021,243665,42,4,8,2,6
2021,243665,44,0,21,6,15
2021,243665,44,1,2,1,1
2021,243665,44,2,1,0,1
2021,243665,44,3,13,2,11
2021,243665,44,4,5,3,2
2021,243744,0,0,3821,2238,1583
2021,243744,10,0,2116,1450,666
2021,243744,10,1,1249,942,307
2021,243744,10,2,449,277,172
2021,243744,10,3,418,231,187
2021,243744,20,0,1177,871,306
2021,243744,20,1,906,700,206
2021,243744,20,2,271,171,100
2021,243744,30,0,316,178,138
2021,243744,30,1,8,6,2
2021,243744,30,2,29,17,12
2021,243744,30,3,279,155,124
2021,243744,40,0,623,401,222
2021,243744,40,1,335,236,99
2021,243744,40,2,149,89,60
2021,243744,40,3,139,76,63
2021,243744,41,0,623,401,222
2021,243744,41,1,335,236,99
2021,243744,41,2,149,89,60
2021,243744,41,3,139,76,63
2021,243744,44,0,623,401,222
2021,243744,44,1,335,236,99
2021,243744,44,2,149,89,60
2021,243744,44,3,139,76,63
2021,243744,50,0,1705,788,917
2021,243780,0,0,2075,1397,678
2021,243780,10,0,1828,1287,541
2021,243780,10,1,800,624,176
2021,243780,10,2,493,315,178
2021,243780,10,3,518,335,183
2021,243780,10,4,17,13,4
2021,243780,20,0,1266,916,350
2021,243780,20,1,789,613,176
2021,243780,20,2,476,302,174
2021,243780,20,3,1,1,0
2021,243780,30,0,478,309,169
2021,243780,30,1,2,2,0
2021,243780,30,2,17,13,4
2021,243780,30,3,459,294,165
2021,243780,40,0,84,62,22
2021,243780,40,1,9,9,0
2021,243780,40,3,58,40,18
2021,243780,40,4,17,13,4
2021,243780,41,0,29,24,5
2021,243780,41,1,3,3,0
2021,243780,41,3,26,21,5
2021,243780,42,0,49,32,17
2021,243780,42,1,3,3,0
2021,243780,42,3,31,18,13
2021,243780,42,4,15,11,4
2021,243780,43,0,6,6,0
2021,243780,43,1,3,3,0
2021,243780,43,3,1,1,0
2021,243780,43,4,2,2,0
2021,243780,44,0,29,24,5
2021,243780,44,1,3,3,0
2021,243780,44,3,26,21,5
2021,243780,50,0,247,110,137
2021,243823,0,0,91,50,41
2021,243823,10,0,90,50,40
2021,243823,10,1,18,11,7
2021,243823,10,2,21,10,11
2021,243823,10,3,35,21,14
2021,243823,10,4,14,7,7
2021,243823,10,6,2,1,1
2021,243823,40,0,90,50,40
2021,243823,40,1,18,11,7
2021,243823,40,2,21,10,11
2021,243823,40,3,35,21,14
2021,243823,40,4,14,7,7
2021,243823,40,6,2,1,1
2021,243823,41,0,14,7,7
2021,243823,41,4,14,7,7
2021,243823,42,0,76,43,33
2021,243823,42,1,18,11,7
2021,243823,42,2,21,10,11
2021,243823,42,3,35,21,14
2021,243823,42,6,2,1,1
2021,243823,45,0,14,7,7
2021,243823,45,4,14,7,7
2021,243823,50,0,1,0,1
2021,243832,0,0,48,15,33
2021,243832,10,0,48,15,33
2021,243832,10,4,48,15,33
2021,243832,40,0,48,15,33
2021,243832,40,4,48,15,33
2021,243832,42,0,48,15,33
2021,243832,42,4,48,15,33
2021,243841,0,0,11,1,10
2021,243841,10,0,11,1,10
2021,243841,10,4,11,1,10
2021,243841,40,0,11,1,10
2021,243841,40,4,11,1,10
2021,243841,43,0,11,1,10
2021,243841,43,4,11,1,10
2021,244233,0,0,5,2,3
2021,244233,10,0,5,2,3
2021,244233,10,4,5,2,3
2021,244233,40,0,5,2,3
2021,244233,40,4,5,2,3
2021,244233,41,0,5,2,3
2021,244233,41,4,5,2,3
2021,244233,45,0,5,2,3
2021,244233,45,4,5,2,3
2021,244437,0,0,396,174,222
2021,244437,10,0,393,172,221
2021,244437,10,1,47,25,22
2021,244437,10,2,134,57,77
2021,244437,10,3,114,49,65
2021,244437,10,4,21,9,12
2021,244437,10,5,52,19,33
2021,244437,10,6,25,13,12
2021,244437,20,0,219,98,121
2021,244437,20,1,47,25,22
2021,244437,20,2,130,56,74
2021,244437,20,3,42,17,25
2021,244437,30,0,93,39,54
2021,244437,30,2,4,1,3
2021,244437,30,3,71,32,39
2021,244437,30,4,18,6,12
2021,244437,40,0,81,35,46
2021,244437,40,3,1,0,1
2021,244437,40,4,3,3,0
2021,244437,40,5,52,19,33
2021,244437,40,6,25,13,12
2021,244437,41,0,2,2,0
2021,244437,41,4,1,1,0
2021,244437,41,6,1,1,0
2021,244437,42,0,79,33,46
2021,244437,42,3,1,0,1
2021,244437,42,4,2,2,0
2021,244437,42,5,52,19,33
2021,244437,42,6,24,12,12
2021,244437,45,0,2,2,0
2021,244437,45,4,1,1,0
2021,244437,45,6,1,1,0
2021,244437,50,0,3,2,1
2021,244446,0,0,67,29,38
2021,244446,10,0,67,29,38
2021,244446,10,6,67,29,38
2021,244446,40,0,67,29,38
2021,244446,40,6,67,29,38
2021,244446,41,0,67,29,38
2021,244446,41,6,67,29,38
2021,244446,44,0,67,29,38
2021,244446,44,6,67,29,38
2021,245625,0,0,21,6,15
2021,245625,10,0,15,5,10
2021,245625,10,1,8,4,4
2021,245625,10,2,5,1,4
2021,245625,10,3,2,0,2
2021,245625,20,0,15,5,10
2021,245625,20,1,8,4,4
2021,245625,20,2,5,1,4
2021,245625,20,3,2,0,2
2021,245625,50,0,6,1,5
2021,245652,0,0,40,27,13
2021,245652,10,0,40,27,13
2021,245652,10,6,40,27,13
2021,245652,20,0,25,21,4
2021,245652,20,6,25,21,4
2021,245652,30,0,15,6,9
2021,245652,30,6,15,6,9
2021,245838,0,0,35,14,21
2021,245838,50,0,35,14,21
2021,245847,0,0,4,1,3
2021,245847,50,0,4,1,3
2021,245865,0,0,62,14,48
2021,245865,50,0,62,14,48
2021,245883,0,0,56,11,45
2021,245883,50,0,56,11,45
2021,245892,0,0,21,11,10
2021,245892,50,0,21,11,10
2021,245953,0,0,33,17,16
2021,245953,10,0,33,17,16
2021,245953,10,1,9,6,3
2021,245953,10,2,12,7,5
2021,245953,10,3,10,4,6
2021,245953,10,4,2,0,2
2021,245953,40,0,33,17,16
2021,245953,40,1,9,6,3
2021,245953,40,2,12,7,5
2021,245953,40,3,10,4,6
2021,245953,40,4,2,0,2
2021,245953,42,0,33,17,16
2021,245953,42,1,9,6,3
2021,245953,42,2,12,7,5
2021,245953,42,3,10,4,6
2021,245953,42,4,2,0,2
2021,245962,0,0,5,0,5
2021,245962,10,0,5,0,5
2021,245962,10,4,5,0,5
2021,245962,40,0,5,0,5
2021,245962,40,4,5,0,5
2021,245962,41,0,5,0,5
2021,245962,41,4,5,0,5
2021,245962,45,0,5,0,5
2021,245962,45,4,5,0,5
2021,246354,0,0,130,66,64
2021,246354,10,0,109,54,55
2021,246354,10,1,25,12,13
2021,246354,10,2,14,8,6
2021,246354,10,3,28,17,11
2021,246354,10,4,42,17,25
2021,246354,20,0,53,26,27
2021,246354,20,1,25,12,13
2021,246354,20,2,7,4,3
2021,246354,20,3,14,8,6
2021,246354,20,4,7,2,5
2021,246354,40,0,56,28,28
2021,246354,40,2,7,4,3
2021,246354,40,3,14,9,5
2021,246354,40,4,35,15,20
2021,246354,42,0,56,28,28
2021,246354,42,2,7,4,3
2021,246354,42,3,14,9,5
2021,246354,42,4,35,15,20
2021,246354,50,0,21,12,9
2021,246813,0,0,101,47,54
2021,246813,10,0,101,47,54
2021,246813,10,6,101,47,54
2021,246813,40,0,101,47,54
2021,246813,40,6,101,47,54
2021,246813,41,0,101,47,54
2021,246813,41,6,101,47,54
2021,246813,45,0,101,47,54
2021,246813,45,6,101,47,54
2021,246974,0,0,10,3,7
2021,246974,10,0,10,3,7
2021,246974,10,4,10,3,7
2021,246974,40,0,10,3,7
2021,246974,40,4,10,3,7
2021,246974,41,0,10,3,7
2021,246974,41,4,10,3,7
2021,246974,45,0,10,3,7
2021,246974,45,4,10,3,7
2021,247065,0,0,16,1,15
2021,247065,10,0,16,1,15
2021,247065,10,4,16,1,15
2021,247065,40,0,16,1,15
2021,247065,40,4,16,1,15
2021,247065,41,0,16,1,15
2021,247065,41,4,16,1,15
2021,247065,44,0,16,1,15
2021,247065,44,4,16,1,15
2021,247603,0,0,19,8,11
2021,247603,10,0,19,8,11
2021,247603,10,1,3,1,2
2021,247603,10,2,6,3,3
2021,247603,10,3,6,2,4
2021,247603,10,4,4,2,2
2021,247603,20,0,15,5,10
2021,247603,20,1,3,1,2
2021,247603,20,2,6,3,3
2021,247603,20,3,5,1,4
2021,247603,20,4,1,0,1
2021,247603,30,0,4,3,1
2021,247603,30,3,1,1,0
2021,247603,30,4,3,2,1
2021,247649,0,0,57,27,30
2021,247649,10,0,57,27,30
2021,247649,10,1,11,4,7
2021,247649,10,2,27,14,13
2021,247649,10,3,19,9,10
2021,247649,40,0,57,27,30
2021,247649,40,1,11,4,7
2021,247649,40,2,27,14,13
2021,247649,40,3,19,9,10
2021,247649,41,0,57,27,30
2021,247649,41,1,11,4,7
2021,247649,41,2,27,14,13
2021,247649,41,3,19,9,10
2021,247649,45,0,57,27,30
2021,247649,45,1,11,4,7
2021,247649,45,2,27,14,13
2021,247649,45,3,19,9,10
2021,247834,0,0,548,238,310
2021,247834,10,0,548,238,310
2021,247834,10,6,548,238,310
2021,247834,40,0,548,238,310
2021,247834,40,6,548,238,310
2021,247834,41,0,340,146,194
2021,247834,41,6,340,146,194
2021,247834,42,0,202,88,114
2021,247834,42,6,202,88,114
2021,247834,43,0,6,4,2
2021,247834,43,6,6,4,2
2021,247834,44,0,340,146,194
2021,247834,44,6,340,146,194
2021,247940,0,0,72,38,34
2021,247940,10,0,72,38,34
2021,247940,10,1,32,15,17
2021,247940,10,2,17,10,7
2021,247940,10,3,8,3,5
2021,247940,10,4,15,10,5
2021,247940,20,0,17,9,8
2021,247940,20,1,14,8,6
2021,247940,20,2,3,1,2
2021,247940,30,0,1,0,1
2021,247940,30,3,1,0,1
2021,247940,40,0,54,29,25
2021,247940,40,1,18,7,11
2021,247940,40,2,14,9,5
2021,247940,40,3,7,3,4
2021,247940,40,4,15,10,5
2021,247940,42,0,15,9,6
2021,247940,42,1,4,3,1
2021,247940,42,2,2,0,2
2021,247940,42,3,3,1,2
2021,247940,42,4,6,5,1
2021,247940,43,0,39,20,19
2021,247940,43,1,14,4,10
2021,247940,43,2,12,9,3
2021,247940,43,3,4,2,2
2021,247940,43,4,9,5,4
2021,248934,0,0,414,149,265
2021,248934,10,0,406,141,265
2021,248934,10,1,16,9,7
2021,248934,10,2,153,90,63
2021,248934,10,4,237,42,195
2021,248934,40,0,406,141,265
2021,248934,40,1,16,9,7
2021,248934,40,2,153,90,63
2021,248934,40,4,237,42,195
2021,248934,41,0,406,141,265
2021,248934,41,1,16,9,7
2021,248934,41,2,153,90,63
2021,248934,41,4,237,42,195
2021,248934,45,0,406,141,265
2021,248934,45,1,16,9,7
2021,248934,45,2,153,90,63
2021,248934,45,4,237,42,195
2021,248934,50,0,8,8,0
2021,250027,0,0,22,7,15
2021,250027,10,0,22,7,15
2021,250027,10,4,22,7,15
2021,250027,40,0,22,7,15
2021,250027,40,4,22,7,15
2021,250027,41,0,22,7,15
2021,250027,41,4,22,7,15
2021,250027,45,0,22,7,15
2021,250027,45,4,22,7,15
2021,251260,0,0,92,40,52
2021,251260,10,0,92,40,52
2021,251260,10,6,92,40,52
2021,251260,20,0,57,25,32
2021,251260,20,6,57,25,32
2021,251260,30,0,35,15,20
2021,251260,30,6,35,15,20
2021,251312,0,0,10,3,7
2021,251312,10,0,10,3,7
2021,251312,10,3,7,2,5
2021,251312,10,4,3,1,2
2021,251312,40,0,10,3,7
2021,251312,40,3,7,2,5
2021,251312,40,4,3,1,2
2021,251312,41,0,10,3,7
2021,251312,41,3,7,2,5
2021,251312,41,4,3,1,2
2021,251312,45,0,10,3,7
2021,251312,45,3,7,2,5
2021,251312,45,4,3,1,2
2021,260372,0,0,15,6,9
2021,260372,10,0,15,6,9
2021,260372,10,4,15,6,9
2021,260372,40,0,15,6,9
2021,260372,40,4,15,6,9
2021,260372,42,0,15,6,9
2021,260372,42,4,15,6,9
2021,260691,0,0,41,7,34
2021,260691,10,0,41,7,34
2021,260691,10,4,41,7,34
2021,260691,40,0,41,7,34
2021,260691,40,4,41,7,34
2021,260691,41,0,41,7,34
2021,260691,41,4,41,7,34
2021,260691,45,0,41,7,34
2021,260691,45,4,41,7,34
2021,260789,0,0,18,5,13
2021,260789,10,0,18,5,13
2021,260789,10,4,18,5,13
2021,260789,40,0,18,5,13
2021,260789,40,4,18,5,13
2021,260789,41,0,18,5,13
2021,260789,41,4,18,5,13
2021,260789,45,0,18,5,13
2021,260789,45,4,18,5,13
2021,260813,0,0,10,3,7
2021,260813,10,0,10,3,7
2021,260813,10,4,10,3,7
2021,260813,40,0,10,3,7
2021,260813,40,4,10,3,7
2021,260813,42,0,10,3,7
2021,260813,42,4,10,3,7
2021,260992,0,0,16,4,12
2021,260992,10,0,16,4,12
2021,260992,10,1,1,1,0
2021,260992,10,2,10,3,7
2021,260992,10,3,2,0,2
2021,260992,10,4,3,0,3
2021,260992,40,0,16,4,12
2021,260992,40,1,1,1,0
2021,260992,40,2,10,3,7
2021,260992,40,3,2,0,2
2021,260992,40,4,3,0,3
2021,260992,41,0,16,4,12
2021,260992,41,1,1,1,0
2021,260992,41,2,10,3,7
2021,260992,41,3,2,0,2
2021,260992,41,4,3,0,3
2021,260992,45,0,16,4,12
2021,260992,45,1,1,1,0
2021,260992,45,2,10,3,7
2021,260992,45,3,2,0,2
2021,260992,45,4,3,0,3
2021,261861,0,0,6,0,6
2021,261861,50,0,6,0,6
2021,262031,0,0,99,40,59
2021,262031,10,0,99,40,59
2021,262031,10,1,32,13,19
2021,262031,10,2,25,12,13
2021,262031,10,3,21,5,16
2021,262031,10,4,21,10,11
2021,262031,20,0,73,27,46
2021,262031,20,1,32,13,19
2021,262031,20,2,24,11,13
2021,262031,20,3,12,3,9
2021,262031,20,4,5,0,5
2021,262031,30,0,22,11,11
2021,262031,30,2,1,1,0
2021,262031,30,3,8,2,6
2021,262031,30,4,13,8,5
2021,262031,40,0,4,2,2
2021,262031,40,3,1,0,1
2021,262031,40,4,3,2,1
2021,262031,42,0,3,2,1
2021,262031,42,3,1,0,1
2021,262031,42,4,2,2,0
2021,262031,43,0,1,0,1
2021,262031,43,4,1,0,1
2021,262086,0,0,98,28,70
2021,262086,10,0,98,28,70
2021,262086,10,1,21,11,10
2021,262086,10,2,40,10,30
2021,262086,10,3,37,7,30
2021,262086,40,0,98,28,70
2021,262086,40,1,21,11,10
2021,262086,40,2,40,10,30
2021,262086,40,3,37,7,30
2021,262086,41,0,71,24,47
2021,262086,41,1,20,10,10
2021,262086,41,2,33,9,24
2021,262086,41,3,18,5,13
2021,262086,42,0,27,4,23
2021,262086,42,1,1,1,0
2021,262086,42,2,7,1,6
2021,262086,42,3,19,2,17
2021,262086,44,0,71,24,47
2021,262086,44,1,20,10,10
2021,262086,44,2,33,9,24
2021,262086,44,3,18,5,13
2021,262129,0,0,103,44,59
2021,262129,10,0,98,42,56
2021,262129,10,1,31,17,14
2021,262129,10,2,26,8,18
2021,262129,10,3,34,16,18
2021,262129,10,4,4,0,4
2021,262129,10,6,3,1,2
2021,262129,20,0,57,25,32
2021,262129,20,1,31,17,14
2021,262129,20,2,26,8,18
2021,262129,30,0,26,15,11
2021,262129,30,3,26,15,11
2021,262129,40,0,15,2,13
2021,262129,40,3,8,1,7
2021,262129,40,4,4,0,4
2021,262129,40,6,3,1,2
2021,262129,42,0,15,2,13
2021,262129,42,3,8,1,7
2021,262129,42,4,4,0,4
2021,262129,42,6,3,1,2
2021,262129,50,0,5,2,3
2021,262457,0,0,13,3,10
2021,262457,10,0,13,3,10
2021,262457,10,4,13,3,10
2021,262457,40,0,13,3,10
2021,262457,40,4,13,3,10
2021,262457,41,0,13,3,10
2021,262457,41,4,13,3,10
2021,262457,45,0,13,3,10
2021,262457,45,4,13,3,10
2021,363633,0,0,19,4,15
2021,363633,10,0,19,4,15
2021,363633,10,4,19,4,15
2021,363633,40,0,19,4,15
2021,363633,40,4,19,4,15
2021,363633,42,0,1,0,1
2021,363633,42,4,1,0,1
2021,363633,43,0,18,4,14
2021,363633,43,4,18,4,14
2021,363907,0,0,17,5,12
2021,363907,10,0,17,5,12
2021,363907,10,3,6,3,3
2021,363907,10,4,11,2,9
2021,363907,40,0,17,5,12
2021,363907,40,3,6,3,3
2021,363907,40,4,11,2,9
2021,363907,42,0,17,5,12
2021,363907,42,3,6,3,3
2021,363907,42,4,11,2,9
2021,363934,0,0,38,23,15
2021,363934,10,0,31,20,11
2021,363934,10,1,31,20,11
2021,363934,40,0,31,20,11
2021,363934,40,1,31,20,11
2021,363934,42,0,31,20,11
2021,363934,42,1,31,20,11
2021,363934,50,0,7,3,4
2021,364016,0,0,116,52,64
2021,364016,10,0,116,52,64
2021,364016,10,6,116,52,64
2021,364016,20,0,83,40,43
2021,364016,20,6,83,40,43
2021,364016,30,0,19,6,13
2021,364016,30,6,19,6,13
2021,364016,40,0,14,6,8
2021,364016,40,6,14,6,8
2021,364016,42,0,14,6,8
2021,364016,42,6,14,6,8
2021,364025,0,0,144,58,86
2021,364025,10,0,144,58,86
2021,364025,10,6,144,58,86
2021,364025,20,0,88,36,52
2021,364025,20,6,88,36,52
2021,364025,30,0,47,18,29
2021,364025,30,6,47,18,29
2021,364025,40,0,9,4,5
2021,364025,40,6,9,4,5
2021,364025,42,0,8,4,4
2021,364025,42,6,8,4,4
2021,364025,43,0,1,0,1
2021,364025,43,6,1,0,1
2021,366003,0,0,8,5,3
2021,366003,10,0,8,5,3
2021,366003,10,1,8,5,3
2021,366003,40,0,8,5,3
2021,366003,40,1,8,5,3
2021,366003,41,0,7,4,3
2021,366003,41,1,7,4,3
2021,366003,43,0,1,1,0
2021,366003,43,1,1,1,0
2021,366003,45,0,7,4,3
2021,366003,45,1,7,4,3
2021,366252,0,0,263,183,80
2021,366252,10,0,263,183,80
2021,366252,10,1,10,8,2
2021,366252,10,2,41,23,18
2021,366252,10,3,87,61,26
2021,366252,10,4,121,87,34
2021,366252,10,5,4,4,0
2021,366252,40,0,263,183,80
2021,366252,40,1,10,8,2
2021,366252,40,2,41,23,18
2021,366252,40,3,87,61,26
2021,366252,40,4,121,87,34
2021,366252,40,5,4,4,0
2021,366252,42,0,262,182,80
2021,366252,42,1,10,8,2
2021,366252,42,2,41,23,18
2021,366252,42,3,87,61,26
2021,366252,42,4,121,87,34
2021,366252,42,5,3,3,0
2021,366252,43,0,1,1,0
2021,366252,43,5,1,1,0
2021,366270,0,0,17,1,16
2021,366270,10,0,17,1,16
2021,366270,10,4,17,1,16
2021,366270,40,0,17,1,16
2021,366270,40,4,17,1,16
2021,366270,41,0,17,1,16
2021,366270,41,4,17,1,16
2021,366270,45,0,17,1,16
2021,366270,45,4,17,1,16
2021,366340,0,0,8,5,3
2021,366340,10,0,8,5,3
2021,366340,10,4,8,5,3
2021,366340,40,0,8,5,3
2021,366340,40,4,8,5,3
2021,366340,43,0,8,5,3
2021,366340,43,4,8,5,3
2021,366368,0,0,6,5,1
2021,366368,10,0,6,5,1
2021,366368,10,1,6,5,1
2021,366368,40,0,6,5,1
2021,366368,40,1,6,5,1
2021,366368,41,0,5,4,1
2021,366368,41,1,5,4,1
2021,366368,42,0,1,1,0
2021,366368,42,1,1,1,0
2021,366368,44,0,5,4,1
2021,366368,44,1,5,4,1
2021,366395,0,0,249,134,115
2021,366395,10,0,249,134,115
2021,366395,10,1,118,59,59
2021,366395,10,2,68,40,28
2021,366395,10,3,51,28,23
2021,366395,10,4,12,7,5
2021,366395,20,0,142,76,66
2021,366395,20,1,99,47,52
2021,366395,20,2,27,18,9
2021,366395,20,3,16,11,5
2021,366395,30,0,107,58,49
2021,366395,30,1,19,12,7
2021,366395,30,2,41,22,19
2021,366395,30,3,35,17,18
2021,366395,30,4,12,7,5
2021,366401,0,0,123,60,63
2021,366401,10,0,123,60,63
2021,366401,10,4,123,60,63
2021,366401,20,0,99,47,52
2021,366401,20,4,99,47,52
2021,366401,30,0,20,10,10
2021,366401,30,4,20,10,10
2021,366401,40,0,4,3,1
2021,366401,40,4,4,3,1
2021,366401,43,0,4,3,1
2021,366401,43,4,4,3,1
2021,366465,0,0,72,35,37
2021,366465,50,0,72,35,37
2021,366535,0,0,9,4,5
2021,366535,50,0,9,4,5
2021,366553,0,0,60,14,46
2021,366553,10,0,60,14,46
2021,366553,10,4,60,14,46
2021,366553,40,0,60,14,46
2021,366553,40,4,60,14,46
2021,366553,41,0,60,14,46
2021,366553,41,4,60,14,46
2021,366553,45,0,60,14,46
2021,366553,45,4,60,14,46
2021,366711,0,0,394,169,225
2021,366711,10,0,394,169,225
2021,366711,10,1,113,58,55
2021,366711,10,2,85,45,40
2021,366711,10,3,79,34,45
2021,366711,10,5,117,32,85
2021,366711,20,0,194,100,94
2021,366711,20,1,113,58,55
2021,366711,20,2,81,42,39
2021,366711,30,0,83,37,46
2021,366711,30,2,4,3,1
2021,366711,30,3,79,34,45
2021,366711,40,0,117,32,85
2021,366711,40,5,117,32,85
2021,366711,41,0,86,24,62
2021,366711,41,5,86,24,62
2021,366711,42,0,25,7,18
2021,366711,42,5,25,7,18
2021,366711,43,0,6,1,5
2021,366711,43,5,6,1,5
2021,366711,44,0,86,24,62
2021,366711,44,5,86,24,62
2021,367112,0,0,8,2,6
2021,367112,10,0,8,2,6
2021,367112,10,4,8,2,6
2021,367112,40,0,8,2,6
2021,367112,40,4,8,2,6
2021,367112,41,0,8,2,6
2021,367112,41,4,8,2,6
2021,367112,45,0,8,2,6
2021,367112,45,4,8,2,6
2021,367459,0,0,149,59,90
2021,367459,10,0,149,59,90
2021,367459,10,1,27,12,15
2021,367459,10,2,10,3,7
2021,367459,10,3,3,0,3
2021,367459,10,4,30,12,18
2021,367459,10,6,79,32,47
2021,367459,40,0,149,59,90
2021,367459,40,1,27,12,15
2021,367459,40,2,10,3,7
2021,367459,40,3,3,0,3
2021,367459,40,4,30,12,18
2021,367459,40,6,79,32,47
2021,367459,42,0,148,59,89
2021,367459,42,1,27,12,15
2021,367459,42,2,10,3,7
2021,367459,42,3,3,0,3
2021,367459,42,4,30,12,18
2021,367459,42,6,78,32,46
2021,367459,43,0,1,0,1
2021,367459,43,6,1,0,1
2021,367884,0,0,17,7,10
2021,367884,10,0,17,7,10
2021,367884,10,6,17,7,10
2021,367884,40,0,17,7,10
2021,367884,40,6,17,7,10
2021,367884,41,0,2,0,2
2021,367884,41,6,2,0,2
2021,367884,42,0,15,7,8
2021,367884,42,6,15,7,8
2021,367884,44,0,2,0,2
2021,367884,44,6,2,0,2
2021,367954,0,0,215,63,152
2021,367954,10,0,215,63,152
2021,367954,10,1,4,2,2
2021,367954,10,2,24,10,14
2021,367954,10,3,117,37,80
2021,367954,10,4,55,13,42
2021,367954,10,5,1,0,1
2021,367954,10,6,14,1,13
2021,367954,40,0,215,63,152
2021,367954,40,1,4,2,2
2021,367954,40,2,24,10,14
2021,367954,40,3,117,37,80
2021,367954,40,4,55,13,42
2021,367954,40,5,1,0,1
2021,367954,40,6,14,1,13
2021,367954,41,0,215,63,152
2021,367954,41,1,4,2,2
2021,367954,41,2,24,10,14
2021,367954,41,3,117,37,80
2021,367954,41,4,55,13,42
2021,367954,41,5,1,0,1
2021,367954,41,6,14,1,13
2021,367954,45,0,215,63,152
2021,367954,45,1,4,2,2
2021,367954,45,2,24,10,14
2021,367954,45,3,117,37,80
2021,367954,45,4,55,13,42
2021,367954,45,5,1,0,1
2021,367954,45,6,14,1,13
2021,368443,0,0,5,2,3
2021,368443,50,0,5,2,3
2021,368452,0,0,4,4,0
2021,368452,10,0,4,4,0
2021,368452,10,4,4,4,0
2021,368452,40,0,4,4,0
2021,368452,40,4,4,4,0
2021,368452,43,0,4,4,0
2021,368452,43,4,4,4,0
2021,368629,0,0,22,3,19
2021,368629,10,0,22,3,19
2021,368629,10,4,22,3,19
2021,368629,40,0,22,3,19
2021,368629,40,4,22,3,19
2021,368629,41,0,22,3,19
2021,368629,41,4,22,3,19
2021,368629,45,0,22,3,19
2021,368629,45,4,22,3,19
2021,368911,0,0,81,25,56
2021,368911,10,0,81,25,56
2021,368911,10,4,81,25,56
2021,368911,40,0,81,25,56
2021,368911,40,4,81,25,56
2021,368911,41,0,81,25,56
2021,368911,41,4,81,25,56
2021,368911,45,0,81,25,56
2021,368911,45,4,81,25,56
2021,369002,0,0,13,8,5
2021,369002,10,0,13,8,5
2021,369002,10,1,5,3,2
2021,369002,10,2,3,3,0
2021,369002,10,3,5,2,3
2021,369002,20,0,5,3,2
2021,369002,20,1,5,3,2
2021,369002,30,0,8,5,3
2021,369002,30,2,3,3,0
2021,369002,30,3,5,2,3
2021,369400,0,0,63,63,0
2021,369400,50,0,63,63,0
2021,369516,0,0,4,3,1
2021,369516,50,0,4,3,1
2021,369659,0,0,3,1,2
2021,369659,10,0,3,1,2
2021,369659,10,6,3,1,2
2021,369659,40,0,3,1,2
2021,369659,40,6,3,1,2
2021,369659,42,0,3,1,2
2021,369659,42,6,3,1,2
2021,369668,0,0,20,13,7
2021,369668,10,0,20,13,7
2021,369668,10,4,20,13,7
2021,369668,40,0,20,13,7
2021,369668,40,4,20,13,7
2021,369668,41,0,20,13,7
2021,369668,41,4,20,13,7
2021,369668,44,0,20,13,7
2021,369668,44,4,20,13,7
2021,372329,0,0,19,2,17
2021,372329,10,0,19,2,17
2021,372329,10,4,19,2,17
2021,372329,40,0,19,2,17
2021,372329,40,4,19,2,17
2021,372329,41,0,19,2,17
2021,372329,41,4,19,2,17
2021,372329,45,0,19,2,17
2021,372329,45,4,19,2,17
2021,372921,0,0,8,3,5
2021,372921,10,0,8,3,5
2021,372921,10,4,8,3,5
2021,372921,40,0,8,3,5
2021,372921,40,4,8,3,5
2021,372921,41,0,8,3,5
2021,372921,41,4,8,3,5
2021,372921,45,0,8,3,5
2021,372921,45,4,8,3,5
2021,374024,0,0,11,3,8
2021,374024,10,0,11,3,8
2021,374024,10,2,4,1,3
2021,374024,10,3,6,2,4
2021,374024,10,4,1,0,1
2021,374024,40,0,11,3,8
2021,374024,40,2,4,1,3
2021,374024,40,3,6,2,4
2021,374024,40,4,1,0,1
2021,374024,41,0,11,3,8
2021,374024,41,2,4,1,3
2021,374024,41,3,6,2,4
2021,374024,41,4,1,0,1
2021,374024,45,0,11,3,8
2021,374024,45,2,4,1,3
2021,374024,45,3,6,2,4
2021,374024,45,4,1,0,1
2021,375416,0,0,8,2,6
2021,375416,50,0,8,2,6
2021,376224,0,0,2,0,2
2021,376224,10,0,2,0,2
2021,376224,10,1,2,0,2
2021,376224,20,0,2,0,2
2021,376224,20,1,2,0,2
2021,376385,0,0,14,5,9
2021,376385,10,0,14,5,9
2021,376385,10,1,14,5,9
2021,376385,40,0,14,5,9
2021,376385,40,1,14,5,9
2021,376385,43,0,14,5,9
2021,376385,43,1,14,5,9
2021,376695,0,0,57,35,22
2021,376695,10,0,57,35,22
2021,376695,10,4,53,32,21
2021,376695,10,5,4,3,1
2021,376695,40,0,57,35,22
2021,376695,40,4,53,32,21
2021,376695,40,5,4,3,1
2021,376695,41,0,57,35,22
2021,376695,41,4,53,32,21
2021,376695,41,5,4,3,1
2021,376695,44,0,57,35,22
2021,376695,44,4,53,32,21
2021,376695,44,5,4,3,1
2021,377111,0,0,9,2,7
2021,377111,50,0,9,2,7
2021,377449,0,0,4,1,3
2021,377449,50,0,4,1,3
2021,377458,0,0,18,5,13
2021,377458,50,0,18,5,13
2021,377555,0,0,212,104,108
2021,377555,10,0,212,104,108
2021,377555,10,1,45,24,21
2021,377555,10,2,98,50,48
2021,377555,10,3,66,28,38
2021,377555,10,5,3,2,1
2021,377555,20,0,101,54,47
2021,377555,20,1,37,20,17
2021,377555,20,2,64,34,30
2021,377555,30,0,38,16,22
2021,377555,30,3,38,16,22
2021,377555,40,0,73,34,39
2021,377555,40,1,8,4,4
2021,377555,40,2,34,16,18
2021,377555,40,3,28,12,16
2021,377555,40,5,3,2,1
2021,377555,41,0,72,33,39
2021,377555,41,1,7,3,4
2021,377555,41,2,34,16,18
2021,377555,41,3,28,12,16
2021,377555,41,5,3,2,1
2021,377555,42,0,1,1,0
2021,377555,42,1,1,1,0
2021,377555,44,0,72,33,39
2021,377555,44,1,7,3,4
2021,377555,44,2,34,16,18
2021,377555,44,3,28,12,16
2021,377555,44,5,3,2,1
2021,377564,0,0,277,131,146
2021,377564,10,0,277,131,146
2021,377564,10,1,55,29,26
2021,377564,10,2,113,50,63
2021,377564,10,3,94,46,48
2021,377564,10,5,15,6,9
2021,377564,20,0,129,67,62
2021,377564,20,1,52,29,23
2021,377564,20,2,77,38,39
2021,377564,30,0,55,24,31
2021,377564,30,3,55,24,31
2021,377564,40,0,93,40,53
2021,377564,40,1,3,0,3
2021,377564,40,2,36,12,24
2021,377564,40,3,39,22,17
2021,377564,40,5,15,6,9
2021,377564,41,0,79,35,44
2021,377564,41,1,3,0,3
2021,377564,41,2,36,12,24
2021,377564,41,3,39,22,17
2021,377564,41,5,1,1,0
2021,377564,42,0,14,5,9
2021,377564,42,5,14,5,9
2021,377564,44,0,79,35,44
2021,377564,44,1,3,0,3
2021,377564,44,2,36,12,24
2021,377564,44,3,39,22,17
2021,377564,44,5,1,1,0
2021,377661,0,0,1,0,1
2021,377661,50,0,1,0,1
2021,378105,0,0,9,4,5
2021,378105,10,0,9,4,5
2021,378105,10,4,9,4,5
2021,378105,40,0,9,4,5
2021,378105,40,4,9,4,5
2021,378105,41,0,9,4,5
2021,378105,41,4,9,4,5
2021,378105,45,0,9,4,5
2021,378105,45,4,9,4,5
2021,378576,0,0,14,9,5
2021,378576,10,0,14,9,5
2021,378576,10,4,14,9,5
2021,378576,40,0,14,9,5
2021,378576,40,4,14,9,5
2021,378576,42,0,9,5,4
2021,378576,42,4,9,5,4
2021,378576,43,0,5,4,1
2021,378576,43,4,5,4,1
2021,379746,0,0,9,4,5
2021,379746,10,0,9,4,5
2021,379746,10,4,9,4,5
2021,379746,40,0,9,4,5
2021,379746,40,4,9,4,5
2021,379746,41,0,9,4,5
2021,379746,41,4,9,4,5
2021,379746,45,0,9,4,5
2021,379746,45,4,9,4,5
2021,380359,0,0,16,6,10
2021,380359,10,0,16,6,10
2021,380359,10,6,16,6,10
2021,380359,40,0,16,6,10
2021,380359,40,6,16,6,10
2021,380359,42,0,16,6,10
2021,380359,42,6,16,6,10
2021,380368,0,0,24,12,12
2021,380368,10,0,24,12,12
2021,380368,10,4,24,12,12
2021,380368,20,0,19,11,8
2021,380368,20,4,19,11,8
2021,380368,30,0,5,1,4
2021,380368,30,4,5,1,4
2021,380377,0,0,30,12,18
2021,380377,10,0,30,12,18
2021,380377,10,6,30,12,18
2021,380377,40,0,30,12,18
2021,380377,40,6,30,12,18
2021,380377,42,0,30,12,18
2021,380377,42,6,30,12,18
2021,380438,0,0,17,5,12
2021,380438,10,0,17,5,12
2021,380438,10,4,17,5,12
2021,380438,40,0,17,5,12
2021,380438,40,4,17,5,12
2021,380438,41,0,17,5,12
2021,380438,41,4,17,5,12
2021,380438,45,0,17,5,12
2021,380438,45,4,17,5,12
2021,381459,0,0,6,6,0
2021,381459,10,0,6,6,0
2021,381459,10,1,3,3,0
2021,381459,10,2,2,2,0
2021,381459,10,3,1,1,0
2021,381459,40,0,6,6,0
2021,381459,40,1,3,3,0
2021,381459,40,2,2,2,0
2021,381459,40,3,1,1,0
2021,381459,41,0,6,6,0
2021,381459,41,1,3,3,0
2021,381459,41,2,2,2,0
2021,381459,41,3,1,1,0
2021,381459,44,0,6,6,0
2021,381459,44,1,3,3,0
2021,381459,44,2,2,2,0
2021,381459,44,3,1,1,0
2021,382957,0,0,17,4,13
2021,382957,10,0,17,4,13
2021,382957,10,4,17,4,13
2021,382957,40,0,17,4,13
2021,382957,40,4,17,4,13
2021,382957,41,0,17,4,13
2021,382957,41,4,17,4,13
2021,382957,45,0,17,4,13
2021,382957,45,4,17,4,13
2021,383084,0,0,18,7,11
2021,383084,10,0,18,7,11
2021,383084,10,4,18,7,11
2021,383084,20,0,14,5,9
2021,383084,20,4,14,5,9
2021,383084,30,0,4,2,2
2021,383084,30,4,4,2,2
2021,383190,0,0,68,26,42
2021,383190,10,0,68,26,42
2021,383190,10,1,9,3,6
2021,383190,10,2,13,7,6
2021,383190,10,3,22,10,12
2021,383190,10,4,24,6,18
2021,383190,20,0,42,18,24
2021,383190,20,1,9,3,6
2021,383190,20,2,12,6,6
2021,383190,20,3,21,9,12
2021,383190,30,0,21,4,17
2021,383190,30,4,21,4,17
2021,383190,40,0,5,4,1
2021,383190,40,2,1,1,0
2021,383190,40,3,1,1,0
2021,383190,40,4,3,2,1
2021,383190,42,0,5,4,1
2021,383190,42,2,1,1,0
2021,383190,42,3,1,1,0
2021,383190,42,4,3,2,1
2021,383996,0,0,6,4,2
2021,383996,10,0,6,4,2
2021,383996,10,1,4,2,2
2021,383996,10,2,2,2,0
2021,383996,20,0,4,2,2
2021,383996,20,1,3,1,2
2021,383996,20,2,1,1,0
2021,383996,30,0,2,2,0
2021,383996,30,1,1,1,0
2021,383996,30,2,1,1,0
2021,384254,0,0,39,18,21
2021,384254,10,0,39,18,21
2021,384254,10,1,3,3,0
2021,384254,10,2,9,5,4
2021,384254,10,3,12,4,8
2021,384254,10,4,15,6,9
2021,384254,40,0,39,18,21
2021,384254,40,1,3,3,0
2021,384254,40,2,9,5,4
2021,384254,40,3,12,4,8
2021,384254,40,4,15,6,9
2021,384254,41,0,19,13,6
2021,384254,41,1,3,3,0
2021,384254,41,2,8,5,3
2021,384254,41,3,1,0,1
2021,384254,41,4,7,5,2
2021,384254,42,0,20,5,15
2021,384254,42,2,1,0,1
2021,384254,42,3,11,4,7
2021,384254,42,4,8,1,7
2021,384254,44,0,19,13,6
2021,384254,44,1,3,3,0
2021,384254,44,2,8,5,3
2021,384254,44,3,1,0,1
2021,384254,44,4,7,5,2
2021,384333,0,0,105,43,62
2021,384333,10,0,105,43,62
2021,384333,10,6,105,43,62
2021,384333,20,0,60,23,37
2021,384333,20,6,60,23,37
2021,384333,30,0,33,15,18
2021,384333,30,6,33,15,18
2021,384333,40,0,12,5,7
2021,384333,40,6,12,5,7
2021,384333,42,0,11,4,7
2021,384333,42,6,11,4,7
2021,384333,43,0,1,1,0
2021,384333,43,6,1,1,0
2021,384342,0,0,80,36,44
2021,384342,10,0,80,36,44
2021,384342,10,1,42,22,20
2021,384342,10,2,13,4,9
2021,384342,10,3,10,4,6
2021,384342,10,4,15,6,9
2021,384342,20,0,65,30,35
2021,384342,20,1,42,22,20
2021,384342,20,2,13,4,9
2021,384342,20,3,10,4,6
2021,384342,30,0,15,6,9
2021,384342,30,4,15,6,9
2021,384412,0,0,2,2,0
2021,384412,10,0,1,1,0
2021,384412,10,4,1,1,0
2021,384412,40,0,1,1,0
2021,384412,40,4,1,1,0
2021,384412,41,0,1,1,0
2021,384412,41,4,1,1,0
2021,384412,45,0,1,1,0
2021,384412,45,4,1,1,0
2021,384412,50,0,1,1,0
2021,385415,0,0,39,16,23
2021,385415,10,0,39,16,23
2021,385415,10,1,9,4,5
2021,385415,10,2,16,8,8
2021,385415,10,3,11,3,8
2021,385415,10,5,3,1,2
2021,385415,40,0,39,16,23
2021,385415,40,1,9,4,5
2021,385415,40,2,16,8,8
2021,385415,40,3,11,3,8
2021,385415,40,5,3,1,2
2021,385415,41,0,36,15,21
2021,385415,41,1,9,4,5
2021,385415,41,2,16,8,8
2021,385415,41,3,11,3,8
2021,385415,42,0,3,1,2
2021,385415,42,5,3,1,2
2021,385415,44,0,27,11,16
2021,385415,44,2,16,8,8
2021,385415,44,3,11,3,8
2021,385415,45,0,9,4,5
2021,385415,45,1,9,4,5
2021,385503,0,0,6,0,6
2021,385503,10,0,6,0,6
2021,385503,10,4,6,0,6
2021,385503,40,0,6,0,6
2021,385503,40,4,6,0,6
2021,385503,41,0,6,0,6
2021,385503,41,4,6,0,6
2021,385503,45,0,6,0,6
2021,385503,45,4,6,0,6
2021,385619,0,0,56,39,17
2021,385619,10,0,56,39,17
2021,385619,10,4,56,39,17
2021,385619,40,0,56,39,17
2021,385619,40,4,56,39,17
2021,385619,41,0,56,39,17
2021,385619,41,4,56,39,17
2021,385619,45,0,56,39,17
2021,385619,45,4,56,39,17
2021,386472,0,0,19,2,17
2021,386472,10,0,19,2,17
2021,386472,10,1,1,0,1
2021,386472,10,2,3,0,3
2021,386472,10,3,14,2,12
2021,386472,10,4,1,0,1
2021,386472,40,0,19,2,17
2021,386472,40,1,1,0,1
2021,386472,40,2,3,0,3
2021,386472,40,3,14,2,12
2021,386472,40,4,1,0,1
2021,386472,41,0,19,2,17
2021,386472,41,1,1,0,1
2021,386472,41,2,3,0,3
2021,386472,41,3,14,2,12
2021,386472,41,4,1,0,1
2021,386472,45,0,19,2,17
2021,386472,45,1,1,0,1
2021,386472,45,2,3,0,3
2021,386472,45,3,14,2,12
2021,386472,45,4,1,0,1
2021,388520,0,0,9,7,2
2021,388520,10,0,9,7,2
2021,388520,10,1,6,5,1
2021,388520,10,2,1,1,0
2021,388520,10,3,2,1,1
2021,388520,40,0,9,7,2
2021,388520,40,1,6,5,1
2021,388520,40,2,1,1,0
2021,388520,40,3,2,1,1
2021,388520,42,0,9,7,2
2021,388520,42,1,6,5,1
2021,388520,42,2,1,1,0
2021,388520,42,3,2,1,1
2021,392257,0,0,57,12,45
2021,392257,10,0,57,12,45
2021,392257,10,4,57,12,45
2021,392257,40,0,57,12,45
2021,392257,40,4,57,12,45
2021,392257,41,0,57,12,45
2021,392257,41,4,57,12,45
2021,392257,45,0,57,12,45
2021,392257,45,4,57,12,45
2021,392415,0,0,7,2,5
2021,392415,10,0,7,2,5
2021,392415,10,4,7,2,5
2021,392415,40,0,7,2,5
2021,392415,40,4,7,2,5
2021,392415,41,0,7,2,5
2021,392415,41,4,7,2,5
2021,392415,45,0,7,2,5
2021,392415,45,4,7,2,5
2021,395362,0,0,33,18,15
2021,395362,10,0,33,18,15
2021,395362,10,4,32,18,14
2021,395362,10,6,1,0,1
2021,395362,20,0,26,15,11
2021,395362,20,4,26,15,11
2021,395362,30,0,4,1,3
2021,395362,30,4,4,1,3
2021,395362,40,0,3,2,1
2021,395362,40,4,2,2,0
2021,395362,40,6,1,0,1
2021,395362,42,0,3,2,1
2021,395362,42,4,2,2,0
2021,395362,42,6,1,0,1
2021,399212,0,0,120,40,80
2021,399212,10,0,120,40,80
2021,399212,10,4,120,40,80
2021,399212,20,0,35,13,22
2021,399212,20,4,35,13,22
2021,399212,30,0,73,22,51
2021,399212,30,4,73,22,51
2021,399212,40,0,12,5,7
2021,399212,40,4,12,5,7
2021,399212,42,0,7,3,4
2021,399212,42,4,7,3,4
2021,399212,43,0,5,2,3
2021,399212,43,4,5,2,3
2021,399869,0,0,12,11,1
2021,399869,10,0,11,10,1
2021,399869,10,1,1,1,0
2021,399869,10,2,1,1,0
2021,399869,10,3,1,1,0
2021,399869,10,4,5,5,0
2021,399869,10,5,3,2,1
2021,399869,40,0,11,10,1
2021,399869,40,1,1,1,0
2021,399869,40,2,1,1,0
2021,399869,40,3,1,1,0
2021,399869,40,4,5,5,0
2021,399869,40,5,3,2,1
2021,399869,41,0,11,10,1
2021,399869,41,1,1,1,0
2021,399869,41,2,1,1,0
2021,399869,41,3,1,1,0
2021,399869,41,4,5,5,0
2021,399869,41,5,3,2,1
2021,399869,45,0,11,10,1
2021,399869,45,1,1,1,0
2021,399869,45,2,1,1,0
2021,399869,45,3,1,1,0
2021,399869,45,4,5,5,0
2021,399869,45,5,3,2,1
2021,399869,50,0,1,1,0
2021,399911,0,0,57,29,28
2021,399911,10,0,57,29,28
2021,399911,10,1,17,13,4
2021,399911,10,2,22,9,13
2021,399911,10,3,14,4,10
2021,399911,10,4,3,2,1
2021,399911,10,6,1,1,0
2021,399911,20,0,39,22,17
2021,399911,20,1,17,13,4
2021,399911,20,2,22,9,13
2021,399911,30,0,8,2,6
2021,399911,30,3,8,2,6
2021,399911,40,0,10,5,5
2021,399911,40,3,6,2,4
2021,399911,40,4,3,2,1
2021,399911,40,6,1,1,0
2021,399911,41,0,3,3,0
2021,399911,41,3,2,2,0
2021,399911,41,6,1,1,0
2021,399911,42,0,7,2,5
2021,399911,42,3,4,0,4
2021,399911,42,4,3,2,1
2021,399911,44,0,2,2,0
2021,399911,44,3,2,2,0
2021,399911,45,0,1,1,0
2021,399911,45,6,1,1,0
2021,403469,0,0,6,2,4
2021,403469,10,0,6,2,4
2021,403469,10,2,2,0,2
2021,403469,10,3,1,1,0
2021,403469,10,4,3,1,2
2021,403469,20,0,4,1,3
2021,403469,20,2,2,0,2
2021,403469,20,3,1,1,0
2021,403469,20,4,1,0,1
2021,403469,30,0,1,1,0
2021,403469,30,4,1,1,0
2021,403469,40,0,1,0,1
2021,403469,40,4,1,0,1
2021,403469,43,0,1,0,1
2021,403469,43,4,1,0,1
2021,403478,0,0,16,8,8
2021,403478,10,0,16,8,8
2021,403478,10,1,1,0,1
2021,403478,10,2,2,0,2
2021,403478,10,3,4,2,2
2021,403478,10,4,9,6,3
2021,403478,20,0,8,3,5
2021,403478,20,1,1,0,1
2021,403478,20,2,2,0,2
2021,403478,20,3,4,2,2
2021,403478,20,4,1,1,0
2021,403478,30,0,8,5,3
2021,403478,30,4,8,5,3
2021,403487,0,0,28,19,9
2021,403487,10,0,28,19,9
2021,403487,10,1,2,1,1
2021,403487,10,2,2,2,0
2021,403487,10,3,8,6,2
2021,403487,10,4,16,10,6
2021,403487,20,0,17,14,3
2021,403487,20,1,2,1,1
2021,403487,20,2,2,2,0
2021,403487,20,3,8,6,2
2021,403487,20,4,5,5,0
2021,403487,30,0,11,5,6
2021,403487,30,4,11,5,6
2021,404055,0,0,11,3,8
2021,404055,50,0,11,3,8
2021,404222,0,0,17,9,8
2021,404222,10,0,17,9,8
2021,404222,10,1,3,2,1
2021,404222,10,2,2,1,1
2021,404222,10,3,11,5,6
2021,404222,10,4,1,1,0
2021,404222,20,0,8,5,3
2021,404222,20,1,3,2,1
2021,404222,20,2,1,1,0
2021,404222,20,3,4,2,2
2021,404222,30,0,7,3,4
2021,404222,30,2,1,0,1
2021,404222,30,3,6,3,3
2021,404222,40,0,2,1,1
2021,404222,40,3,1,0,1
2021,404222,40,4,1,1,0
2021,404222,42,0,2,1,1
2021,404222,42,3,1,0,1
2021,404222,42,4,1,1,0
2021,404426,0,0,38,18,20
2021,404426,10,0,38,18,20
2021,404426,10,6,38,18,20
2021,404426,40,0,38,18,20
2021,404426,40,6,38,18,20
2021,404426,42,0,38,18,20
2021,404426,42,6,38,18,20
2021,404912,0,0,35,8,27
2021,404912,10,0,35,8,27
2021,404912,10,4,35,8,27
2021,404912,40,0,35,8,27
2021,404912,40,4,35,8,27
2021,404912,41,0,35,8,27
2021,404912,41,4,35,8,27
2021,404912,45,0,35,8,27
2021,404912,45,4,35,8,27
2021,404994,0,0,142,63,79
2021,404994,10,0,140,62,78
2021,404994,10,2,6,2,4
2021,404994,10,3,34,18,16
2021,404994,10,4,100,42,58
2021,404994,40,0,140,62,78
2021,404994,40,2,6,2,4
2021,404994,40,3,34,18,16
2021,404994,40,4,100,42,58
2021,404994,41,0,30,12,18
2021,404994,41,2,1,0,1
2021,404994,41,3,15,7,8
2021,404994,41,4,14,5,9
2021,404994,43,0,110,50,60
2021,404994,43,2,5,2,3
2021,404994,43,3,19,11,8
2021,404994,43,4,86,37,49
2021,404994,45,0,30,12,18
2021,404994,45,2,1,0,1
2021,404994,45,3,15,7,8
2021,404994,45,4,14,5,9
2021,404994,50,0,2,1,1
2021,405058,0,0,6,6,0
2021,405058,10,0,6,6,0
2021,405058,10,4,6,6,0
2021,405058,40,0,6,6,0
2021,405058,40,4,6,6,0
2021,405058,42,0,6,6,0
2021,405058,42,4,6,6,0
2021,405872,0,0,78,21,57
2021,405872,10,0,78,21,57
2021,405872,10,1,13,2,11
2021,405872,10,2,25,10,15
2021,405872,10,3,39,8,31
2021,405872,10,5,1,1,0
2021,405872,40,0,78,21,57
2021,405872,40,1,13,2,11
2021,405872,40,2,25,10,15
2021,405872,40,3,39,8,31
2021,405872,40,5,1,1,0
2021,405872,41,0,65,17,48
2021,405872,41,1,13,2,11
2021,405872,41,2,25,10,15
2021,405872,41,3,26,4,22
2021,405872,41,5,1,1,0
2021,405872,42,0,13,4,9
2021,405872,42,3,13,4,9
2021,405872,44,0,65,17,48
2021,405872,44,1,13,2,11
2021,405872,44,2,25,10,15
2021,405872,44,3,26,4,22
2021,405872,44,5,1,1,0
2021,406024,0,0,71,11,60
2021,406024,10,0,71,11,60
2021,406024,10,3,6,1,5
2021,406024,10,4,65,10,55
2021,406024,40,0,71,11,60
2021,406024,40,3,6,1,5
2021,406024,40,4,65,10,55
2021,406024,41,0,71,11,60
2021,406024,41,3,6,1,5
2021,406024,41,4,65,10,55
2021,406024,45,0,71,11,60
2021,406024,45,3,6,1,5
2021,406024,45,4,65,10,55
2021,406033,0,0,76,13,63
2021,406033,10,0,76,13,63
2021,406033,10,2,1,1,0
2021,406033,10,3,6,0,6
2021,406033,10,4,69,12,57
2021,406033,40,0,76,13,63
2021,406033,40,2,1,1,0
2021,406033,40,3,6,0,6
2021,406033,40,4,69,12,57
2021,406033,41,0,76,13,63
2021,406033,41,2,1,1,0
2021,406033,41,3,6,0,6
2021,406033,41,4,69,12,57
2021,406033,45,0,76,13,63
2021,406033,45,2,1,1,0
2021,406033,45,3,6,0,6
2021,406033,45,4,69,12,57
2021,406547,0,0,2,1,1
2021,406547,10,0,2,1,1
2021,406547,10,4,2,1,1
2021,406547,40,0,2,1,1
2021,406547,40,4,2,1,1
2021,406547,41,0,2,1,1
2021,406547,41,4,2,1,1
2021,406547,45,0,2,1,1
2021,406547,45,4,2,1,1
2021,407629,0,0,160,94,66
2021,407629,10,0,160,94,66
2021,407629,10,1,35,27,8
2021,407629,10,2,36,19,17
2021,407629,10,3,80,45,35
2021,407629,10,4,9,3,6
2021,407629,40,0,160,94,66
2021,407629,40,1,35,27,8
2021,407629,40,2,36,19,17
2021,407629,40,3,80,45,35
2021,407629,40,4,9,3,6
2021,407629,41,0,160,94,66
2021,407629,41,1,35,27,8
2021,407629,41,2,36,19,17
2021,407629,41,3,80,45,35
2021,407629,41,4,9,3,6
2021,407629,44,0,160,94,66
2021,407629,44,1,35,27,8
2021,407629,44,2,36,19,17
2021,407629,44,3,80,45,35
2021,407629,44,4,9,3,6
2021,408729,0,0,6,0,6
2021,408729,10,0,6,0,6
2021,408729,10,4,6,0,6
2021,408729,40,0,6,0,6
2021,408729,40,4,6,0,6
2021,408729,41,0,6,0,6
2021,408729,41,4,6,0,6
2021,408729,45,0,6,0,6
2021,408729,45,4,6,0,6
2021,408844,0,0,81,42,39
2021,408844,10,0,81,42,39
2021,408844,10,4,81,42,39
2021,408844,40,0,81,42,39
2021,408844,40,4,81,42,39
2021,408844,43,0,81,42,39
2021,408844,43,4,81,42,39
2021,409254,0,0,21,1,20
2021,409254,10,0,21,1,20
2021,409254,10,1,4,0,4
2021,409254,10,2,7,1,6
2021,409254,10,3,3,0,3
2021,409254,10,4,7,0,7
2021,409254,20,0,7,1,6
2021,409254,20,1,3,0,3
2021,409254,20,2,4,1,3
2021,409254,30,0,2,0,2
2021,409254,30,2,1,0,1
2021,409254,30,3,1,0,1
2021,409254,40,0,12,0,12
2021,409254,40,1,1,0,1
2021,409254,40,2,2,0,2
2021,409254,40,3,2,0,2
2021,409254,40,4,7,0,7
2021,409254,41,0,12,0,12
2021,409254,41,1,1,0,1
2021,409254,41,2,2,0,2
2021,409254,41,3,2,0,2
2021,409254,41,4,7,0,7
2021,409254,44,0,12,0,12
2021,409254,44,1,1,0,1
2021,409254,44,2,2,0,2
2021,409254,44,3,2,0,2
2021,409254,44,4,7,0,7
2021,409315,0,0,546,318,228
2021,409315,10,0,546,318,228
2021,409315,10,1,8,6,2
2021,409315,10,2,23,12,11
2021,409315,10,3,43,25,18
2021,409315,10,4,395,224,171
2021,409315,10,5,77,51,26
2021,409315,40,0,546,318,228
2021,409315,40,1,8,6,2
2021,409315,40,2,23,12,11
2021,409315,40,3,43,25,18
2021,409315,40,4,395,224,171
2021,409315,40,5,77,51,26
2021,409315,42,0,511,296,215
2021,409315,42,1,8,6,2
2021,409315,42,2,23,12,11
2021,409315,42,3,43,25,18
2021,409315,42,4,395,224,171
2021,409315,42,5,42,29,13
2021,409315,43,0,35,22,13
2021,409315,43,5,35,22,13
2021,409616,0,0,23,8,15
2021,409616,10,0,23,8,15
2021,409616,10,1,21,8,13
2021,409616,10,2,2,0,2
2021,409616,20,0,14,7,7
2021,409616,20,1,14,7,7
2021,409616,40,0,9,1,8
2021,409616,40,1,7,1,6
2021,409616,40,2,2,0,2
2021,409616,41,0,9,1,8
2021,409616,41,1,7,1,6
2021,409616,41,2,2,0,2
2021,409616,44,0,9,1,8
2021,409616,44,1,7,1,6
2021,409616,44,2,2,0,2
2021,409698,0,0,218,93,125
2021,409698,10,0,218,93,125
2021,409698,10,1,60,32,28
2021,409698,10,2,56,23,33
2021,409698,10,3,54,19,35
2021,409698,10,5,48,19,29
2021,409698,20,0,114,54,60
2021,409698,20,1,60,32,28
2021,409698,20,2,54,22,32
2021,409698,30,0,56,20,36
2021,409698,30,2,2,1,1
2021,409698,30,3,54,19,35
2021,409698,40,0,48,19,29
2021,409698,40,5,48,19,29
2021,409698,41,0,31,13,18
2021,409698,41,5,31,13,18
2021,409698,42,0,13,5,8
2021,409698,42,5,13,5,8
2021,409698,43,0,4,1,3
2021,409698,43,5,4,1,3
2021,409698,44,0,31,13,18
2021,409698,44,5,31,13,18
2021,412173,0,0,17,4,13
2021,412173,10,0,17,4,13
2021,412173,10,6,17,4,13
2021,412173,40,0,17,4,13
2021,412173,40,6,17,4,13
2021,412173,41,0,17,4,13
2021,412173,41,6,17,4,13
2021,412173,45,0,17,4,13
2021,412173,45,6,17,4,13
2021,412599,0,0,8,5,3
2021,412599,50,0,8,5,3
2021,413413,0,0,177,48,129
2021,413413,10,0,177,48,129
2021,413413,10,6,177,48,129
2021,413413,40,0,177,48,129
2021,413413,40,6,177,48,129
2021,413413,42,0,177,48,129
2021,413413,42,6,177,48,129
2021,413617,0,0,14,6,8
2021,413617,10,0,14,6,8
2021,413617,10,4,14,6,8
2021,413617,40,0,14,6,8
2021,413617,40,4,14,6,8
2021,413617,42,0,14,6,8
2021,413617,42,4,14,6,8
2021,413626,0,0,21,12,9
2021,413626,10,0,21,12,9
2021,413626,10,4,21,12,9
2021,413626,40,0,21,12,9
2021,413626,40,4,21,12,9
2021,413626,42,0,16,8,8
2021,413626,42,4,16,8,8
2021,413626,43,0,5,4,1
2021,413626,43,4,5,4,1
2021,413680,0,0,26,25,1
2021,413680,50,0,26,25,1
2021,414461,0,0,44,39,5
2021,414461,10,0,44,39,5
2021,414461,10,1,14,10,4
2021,414461,10,4,30,29,1
2021,414461,40,0,44,39,5
2021,414461,40,1,14,10,4
2021,414461,40,4,30,29,1
2021,414461,41,0,44,39,5
2021,414461,41,1,14,10,4
2021,414461,41,4,30,29,1
2021,414461,44,0,44,39,5
2021,414461,44,1,14,10,4
2021,414461,44,4,30,29,1
2021,414595,0,0,5,1,4
2021,414595,10,0,5,1,4
2021,414595,10,4,5,1,4
2021,414595,40,0,5,1,4
2021,414595,40,4,5,1,4
2021,414595,42,0,3,0,3
2021,414595,42,4,3,0,3
2021,414595,43,0,2,1,1
2021,414595,43,4,2,1,1
2021,414911,0,0,28,10,18
2021,414911,10,0,28,10,18
2021,414911,10,1,8,2,6
2021,414911,10,2,9,4,5
2021,414911,10,3,3,1,2
2021,414911,10,4,5,3,2
2021,414911,10,5,3,0,3
2021,414911,20,0,15,5,10
2021,414911,20,1,8,2,6
2021,414911,20,2,6,3,3
2021,414911,20,4,1,0,1
2021,414911,30,0,7,3,4
2021,414911,30,2,3,1,2
2021,414911,30,3,2,0,2
2021,414911,30,4,2,2,0
2021,414911,40,0,6,2,4
2021,414911,40,3,1,1,0
2021,414911,40,4,2,1,1
2021,414911,40,5,3,0,3
2021,414911,41,0,6,2,4
2021,414911,41,3,1,1,0
2021,414911,41,4,2,1,1
2021,414911,41,5,3,0,3
2021,414911,45,0,6,2,4
2021,414911,45,3,1,1,0
2021,414911,45,4,2,1,1
2021,414911,45,5,3,0,3
2021,414939,0,0,5,1,4
2021,414939,50,0,5,1,4
2021,414966,0,0,14,5,9
2021,414966,10,0,14,5,9
2021,414966,10,1,3,2,1
2021,414966,10,2,3,1,2
2021,414966,10,3,6,2,4
2021,414966,10,4,2,0,2
2021,414966,20,0,6,3,3
2021,414966,20,1,3,2,1
2021,414966,20,2,3,1,2
2021,414966,30,0,5,2,3
2021,414966,30,3,5,2,3
2021,414966,40,0,3,0,3
2021,414966,40,3,1,0,1
2021,414966,40,4,2,0,2
2021,414966,41,0,1,0,1
2021,414966,41,3,1,0,1
2021,414966,42,0,2,0,2
2021,414966,42,4,2,0,2
2021,414966,44,0,1,0,1
2021,414966,44,3,1,0,1
2021,416458,0,0,11,7,4
2021,416458,10,0,11,7,4
2021,416458,10,4,11,7,4
2021,416458,40,0,11,7,4
2021,416458,40,4,11,7,4
2021,416458,41,0,11,7,4
2021,416458,41,4,11,7,4
2021,416458,45,0,11,7,4
2021,416458,45,4,11,7,4
2021,416801,0,0,20,10,10
2021,416801,10,0,20,10,10
2021,416801,10,1,1,1,0
2021,416801,10,5,19,9,10
2021,416801,20,0,1,1,0
2021,416801,20,1,1,1,0
2021,416801,40,0,19,9,10
2021,416801,40,5,19,9,10
2021,416801,42,0,19,9,10
2021,416801,42,5,19,9,10
2021,417327,0,0,2,1,1
2021,417327,10,0,2,1,1
2021,417327,10,4,2,1,1
2021,417327,40,0,2,1,1
2021,417327,40,4,2,1,1
2021,417327,41,0,2,1,1
2021,417327,41,4,2,1,1
2021,417327,45,0,2,1,1
2021,417327,45,4,2,1,1
2021,417734,0,0,16,2,14
2021,417734,10,0,16,2,14
2021,417734,10,2,1,1,0
2021,417734,10,3,6,1,5
2021,417734,10,4,9,0,9
2021,417734,40,0,16,2,14
2021,417734,40,2,1,1,0
2021,417734,40,3,6,1,5
2021,417734,40,4,9,0,9
2021,417734,42,0,16,2,14
2021,417734,42,2,1,1,0
2021,417734,42,3,6,1,5
2021,417734,42,4,9,0,9
2021,418126,0,0,7,3,4
2021,418126,10,0,7,3,4
2021,418126,10,4,7,3,4
2021,418126,40,0,7,3,4
2021,418126,40,4,7,3,4
2021,418126,41,0,7,3,4
2021,418126,41,4,7,3,4
2021,418126,45,0,7,3,4
2021,418126,45,4,7,3,4
2021,418533,0,0,58,35,23
2021,418533,50,0,58,35,23
2021,419244,0,0,7,7,0
2021,419244,10,0,7,7,0
2021,419244,10,6,7,7,0
2021,419244,40,0,7,7,0
2021,419244,40,6,7,7,0
2021,419244,41,0,7,7,0
2021,419244,41,6,7,7,0
2021,419244,45,0,7,7,0
2021,419244,45,6,7,7,0
2021,420024,0,0,8,1,7
2021,420024,50,0,8,1,7
2021,420246,0,0,19,8,11
2021,420246,10,0,19,8,11
2021,420246,10,1,10,6,4
2021,420246,10,2,4,0,4
2021,420246,10,3,5,2,3
2021,420246,40,0,19,8,11
2021,420246,40,1,10,6,4
2021,420246,40,2,4,0,4
2021,420246,40,3,5,2,3
2021,420246,42,0,19,8,11
2021,420246,42,1,10,6,4
2021,420246,42,2,4,0,4
2021,420246,42,3,5,2,3
2021,420370,0,0,9,3,6
2021,420370,10,0,9,3,6
2021,420370,10,4,9,3,6
2021,420370,40,0,9,3,6
2021,420370,40,4,9,3,6
2021,420370,41,0,9,3,6
2021,420370,41,4,9,3,6
2021,420370,45,0,9,3,6
2021,420370,45,4,9,3,6
2021,420398,0,0,188,93,95
2021,420398,10,0,170,84,86
2021,420398,10,1,47,23,24
2021,420398,10,2,27,15,12
2021,420398,10,3,46,20,26
2021,420398,10,4,50,26,24
2021,420398,20,0,97,52,45
2021,420398,20,1,47,23,24
2021,420398,20,2,18,10,8
2021,420398,20,3,12,5,7
2021,420398,20,4,20,14,6
2021,420398,40,0,73,32,41
2021,420398,40,2,9,5,4
2021,420398,40,3,34,15,19
2021,420398,40,4,30,12,18
2021,420398,42,0,73,32,41
2021,420398,42,2,9,5,4
2021,420398,42,3,34,15,19
2021,420398,42,4,30,12,18
2021,420398,50,0,18,9,9
2021,420431,0,0,61,22,39
2021,420431,50,0,61,22,39
2021,420440,0,0,18,8,10
2021,420440,10,0,18,8,10
2021,420440,10,4,18,8,10
2021,420440,40,0,18,8,10
2021,420440,40,4,18,8,10
2021,420440,42,0,18,8,10
2021,420440,42,4,18,8,10
2021,420538,0,0,38,16,22
2021,420538,10,0,38,16,22
2021,420538,10,3,8,4,4
2021,420538,10,4,30,12,18
2021,420538,40,0,38,16,22
2021,420538,40,3,8,4,4
2021,420538,40,4,30,12,18
2021,420538,42,0,38,16,22
2021,420538,42,3,8,4,4
2021,420538,42,4,30,12,18
2021,420556,0,0,28,12,16
2021,420556,10,0,28,12,16
2021,420556,10,4,28,12,16
2021,420556,40,0,28,12,16
2021,420556,40,4,28,12,16
2021,420556,42,0,28,12,16
2021,420556,42,4,28,12,16
2021,420723,0,0,8,6,2
2021,420723,10,0,8,6,2
2021,420723,10,4,8,6,2
2021,420723,40,0,8,6,2
2021,420723,40,4,8,6,2
2021,420723,43,0,8,6,2
2021,420723,43,4,8,6,2
2021,421708,0,0,25,3,22
2021,421708,50,0,25,3,22
2021,421832,0,0,15,9,6
2021,421832,10,0,15,9,6
2021,421832,10,4,15,9,6
2021,421832,40,0,15,9,6
2021,421832,40,4,15,9,6
2021,421832,42,0,15,9,6
2021,421832,42,4,15,9,6
2021,421841,0,0,4,2,2
2021,421841,10,0,4,2,2
2021,421841,10,6,4,2,2
2021,421841,40,0,4,2,2
2021,421841,40,6,4,2,2
2021,421841,43,0,4,2,2
2021,421841,43,6,4,2,2
2021,421878,0,0,12,3,9
2021,421878,10,0,12,3,9
2021,421878,10,4,12,3,9
2021,421878,40,0,12,3,9
2021,421878,40,4,12,3,9
2021,421878,41,0,12,3,9
2021,421878,41,4,12,3,9
2021,421878,44,0,12,3,9
2021,421878,44,4,12,3,9
2021,422020,0,0,7,7,0
2021,422020,10,0,7,7,0
2021,422020,10,4,7,7,0
2021,422020,40,0,7,7,0
2021,422020,40,4,7,7,0
2021,422020,41,0,7,7,0
2021,422020,41,4,7,7,0
2021,422020,45,0,7,7,0
2021,422020,45,4,7,7,0
2021,422695,0,0,9,2,7
2021,422695,10,0,9,2,7
2021,422695,10,6,9,2,7
2021,422695,40,0,9,2,7
2021,422695,40,6,9,2,7
2021,422695,42,0,9,2,7
2021,422695,42,6,9,2,7
2021,423120,0,0,8,2,6
2021,423120,10,0,8,2,6
2021,423120,10,4,8,2,6
2021,423120,40,0,8,2,6
2021,423120,40,4,8,2,6
2021,423120,41,0,8,2,6
2021,423120,41,4,8,2,6
2021,423120,45,0,8,2,6
2021,423120,45,4,8,2,6
2021,423643,0,0,308,132,176
2021,423643,10,0,297,131,166
2021,423643,10,1,40,22,18
2021,423643,10,2,98,41,57
2021,423643,10,3,154,66,88
2021,423643,10,4,5,2,3
2021,423643,20,0,81,44,37
2021,423643,20,1,29,20,9
2021,423643,20,2,52,24,28
2021,423643,30,0,61,25,36
2021,423643,30,1,5,1,4
2021,423643,30,2,7,5,2
2021,423643,30,3,49,19,30
2021,423643,40,0,155,62,93
2021,423643,40,1,6,1,5
2021,423643,40,2,39,12,27
2021,423643,40,3,105,47,58
2021,423643,40,4,5,2,3
2021,423643,41,0,155,62,93
2021,423643,41,1,6,1,5
2021,423643,41,2,39,12,27
2021,423643,41,3,105,47,58
2021,423643,41,4,5,2,3
2021,423643,44,0,155,62,93
2021,423643,44,1,6,1,5
2021,423643,44,2,39,12,27
2021,423643,44,3,105,47,58
2021,423643,44,4,5,2,3
2021,423643,50,0,11,1,10
2021,423652,0,0,13,6,7
2021,423652,10,0,13,6,7
2021,423652,10,4,13,6,7
2021,423652,40,0,13,6,7
2021,423652,40,4,13,6,7
2021,423652,41,0,13,6,7
2021,423652,41,4,13,6,7
2021,423652,45,0,13,6,7
2021,423652,45,4,13,6,7
2021,426314,0,0,129,80,49
2021,426314,10,0,129,80,49
2021,426314,10,1,4,3,1
2021,426314,10,2,43,30,13
2021,426314,10,3,56,29,27
2021,426314,10,4,26,18,8
2021,426314,20,0,26,16,10
2021,426314,20,1,2,1,1
2021,426314,20,2,24,15,9
2021,426314,30,0,32,15,17
2021,426314,30,2,4,4,0
2021,426314,30,3,28,11,17
2021,426314,40,0,71,49,22
2021,426314,40,1,2,2,0
2021,426314,40,2,15,11,4
2021,426314,40,3,28,18,10
2021,426314,40,4,26,18,8
2021,426314,42,0,71,49,22
2021,426314,42,1,2,2,0
2021,426314,42,2,15,11,4
2021,426314,42,3,28,18,10
2021,426314,42,4,26,18,8
2021,427982,0,0,10,8,2
2021,427982,50,0,10,8,2
2021,428170,0,0,50,4,46
2021,428170,10,0,50,4,46
2021,428170,10,4,50,4,46
2021,428170,40,0,50,4,46
2021,428170,40,4,50,4,46
2021,428170,41,0,50,4,46
2021,428170,41,4,50,4,46
2021,428170,45,0,50,4,46
2021,428170,45,4,50,4,46
2021,428392,0,0,31,13,18
2021,428392,10,0,31,13,18
2021,428392,10,6,31,13,18
2021,428392,40,0,31,13,18
2021,428392,40,6,31,13,18
2021,428392,41,0,31,13,18
2021,428392,41,6,31,13,18
2021,428392,44,0,31,13,18
2021,428392,44,6,31,13,18
2021,429085,0,0,8,5,3
2021,429085,10,0,8,5,3
2021,429085,10,1,2,1,1
2021,429085,10,2,3,2,1
2021,429085,10,3,1,1,0
2021,429085,10,4,1,1,0
2021,429085,10,5,1,0,1
2021,429085,40,0,8,5,3
2021,429085,40,1,2,1,1
2021,429085,40,2,3,2,1
2021,429085,40,3,1,1,0
2021,429085,40,4,1,1,0
2021,429085,40,5,1,0,1
2021,429085,42,0,8,5,3
2021,429085,42,1,2,1,1
2021,429085,42,2,3,2,1
2021,429085,42,3,1,1,0
2021,429085,42,4,1,1,0
2021,429085,42,5,1,0,1
2021,429094,0,0,11,6,5
2021,429094,10,0,7,4,3
2021,429094,10,1,7,4,3
2021,429094,40,0,7,4,3
2021,429094,40,1,7,4,3
2021,429094,41,0,7,4,3
2021,429094,41,1,7,4,3
2021,429094,44,0,7,4,3
2021,429094,44,1,7,4,3
2021,429094,50,0,4,2,2
2021,430670,0,0,41,25,16
2021,430670,10,0,41,25,16
2021,430670,10,1,1,1,0
2021,430670,10,2,8,7,1
2021,430670,10,3,23,13,10
2021,430670,10,4,9,4,5
2021,430670,20,0,11,6,5
2021,430670,20,2,5,5,0
2021,430670,20,3,5,1,4
2021,430670,20,4,1,0,1
2021,430670,30,0,10,3,7
2021,430670,30,2,1,0,1
2021,430670,30,3,3,0,3
2021,430670,30,4,6,3,3
2021,430670,40,0,20,16,4
2021,430670,40,1,1,1,0
2021,430670,40,2,2,2,0
2021,430670,40,3,15,12,3
2021,430670,40,4,2,1,1
2021,430670,42,0,18,14,4
2021,430670,42,1,1,1,0
2021,430670,42,2,2,2,0
2021,430670,42,3,13,10,3
2021,430670,42,4,2,1,1
2021,430670,43,0,2,2,0
2021,430670,43,3,2,2,0
2021,430704,0,0,7,3,4
2021,430704,10,0,7,3,4
2021,430704,10,4,7,3,4
2021,430704,40,0,7,3,4
2021,430704,40,4,7,3,4
2021,430704,41,0,7,3,4
2021,430704,41,4,7,3,4
2021,430704,44,0,7,3,4
2021,430704,44,4,7,3,4
2021,430795,0,0,11,5,6
2021,430795,10,0,11,5,6
2021,430795,10,4,11,5,6
2021,430795,40,0,11,5,6
2021,430795,40,4,11,5,6
2021,430795,42,0,11,5,6
2021,430795,42,4,11,5,6
2021,430935,0,0,12,7,5
2021,430935,10,0,10,6,4
2021,430935,10,1,10,6,4
2021,430935,40,0,10,6,4
2021,430935,40,1,10,6,4
2021,430935,41,0,7,4,3
2021,430935,41,1,7,4,3
2021,430935,42,0,3,2,1
2021,430935,42,1,3,2,1
2021,430935,44,0,5,3,2
2021,430935,44,1,5,3,2
2021,430935,45,0,2,1,1
2021,430935,45,1,2,1,1
2021,430935,50,0,2,1,1
2021,431141,0,0,57,21,36
2021,431141,10,0,57,21,36
2021,431141,10,4,57,21,36
2021,431141,40,0,57,21,36
2021,431141,40,4,57,21,36
2021,431141,41,0,57,21,36
2021,431141,41,4,57,21,36
2021,431141,45,0,57,21,36
2021,431141,45,4,57,21,36
2021,431983,0,0,5,5,0
2021,431983,10,0,5,5,0
2021,431983,10,4,5,5,0
2021,431983,40,0,5,5,0
2021,431983,40,4,5,5,0
2021,431983,42,0,5,5,0
2021,431983,42,4,5,5,0
2021,432348,0,0,17,10,7
2021,432348,10,0,17,10,7
2021,432348,10,1,1,1,0
2021,432348,10,2,2,2,0
2021,432348,10,3,8,4,4
2021,432348,10,6,6,3,3
2021,432348,20,0,3,3,0
2021,432348,20,1,1,1,0
2021,432348,20,2,2,2,0
2021,432348,40,0,14,7,7
2021,432348,40,3,8,4,4
2021,432348,40,6,6,3,3
2021,432348,41,0,8,4,4
2021,432348,41,3,8,4,4
2021,432348,42,0,2,1,1
2021,432348,42,6,2,1,1
2021,432348,43,0,4,2,2
2021,432348,43,6,4,2,2
2021,432348,44,0,8,4,4
2021,432348,44,3,8,4,4
2021,432384,0,0,17,9,8
2021,432384,10,0,17,9,8
2021,432384,10,4,17,9,8
2021,432384,40,0,17,9,8
2021,432384,40,4,17,9,8
2021,432384,41,0,17,9,8
2021,432384,41,4,17,9,8
2021,432384,45,0,17,9,8
2021,432384,45,4,17,9,8
2021,432524,0,0,6,4,2
2021,432524,10,0,6,4,2
2021,432524,10,1,6,4,2
2021,432524,40,0,6,4,2
2021,432524,40,1,6,4,2
2021,432524,42,0,6,4,2
2021,432524,42,1,6,4,2
2021,433004,0,0,46,24,22
2021,433004,10,0,46,24,22
2021,433004,10,1,8,5,3
2021,433004,10,2,11,5,6
2021,433004,10,3,15,8,7
2021,433004,10,4,12,6,6
2021,433004,40,0,46,24,22
2021,433004,40,1,8,5,3
2021,433004,40,2,11,5,6
2021,433004,40,3,15,8,7
2021,433004,40,4,12,6,6
2021,433004,41,0,46,24,22
2021,433004,41,1,8,5,3
2021,433004,41,2,11,5,6
2021,433004,41,3,15,8,7
2021,433004,41,4,12,6,6
2021,433004,44,0,46,24,22
2021,433004,44,1,8,5,3
2021,433004,44,2,11,5,6
2021,433004,44,3,15,8,7
2021,433004,44,4,12,6,6
2021,433013,0,0,25,10,15
2021,433013,10,0,25,10,15
2021,433013,10,4,25,10,15
2021,433013,40,0,25,10,15
2021,433013,40,4,25,10,15
2021,433013,41,0,25,10,15
2021,433013,41,4,25,10,15
2021,433013,45,0,25,10,15
2021,433013,45,4,25,10,15
2021,433174,0,0,29,2,27
2021,433174,10,0,29,2,27
2021,433174,10,6,29,2,27
2021,433174,40,0,29,2,27
2021,433174,40,6,29,2,27
2021,433174,41,0,29,2,27
2021,433174,41,6,29,2,27
2021,433174,45,0,29,2,27
2021,433174,45,6,29,2,27
2021,433387,0,0,2956,786,2170
2021,433387,10,0,2956,786,2170
2021,433387,10,6,2956,786,2170
2021,433387,40,0,2956,786,2170
2021,433387,40,6,2956,786,2170
2021,433387,41,0,2956,786,2170
2021,433387,41,6,2956,786,2170
2021,433387,45,0,2956,786,2170
2021,433387,45,6,2956,786,2170
2021,433420,0,0,22,20,2
2021,433420,10,0,22,20,2
2021,433420,10,4,22,20,2
2021,433420,40,0,22,20,2
2021,433420,40,4,22,20,2
2021,433420,41,0,22,20,2
2021,433420,41,4,22,20,2
2021,433420,45,0,22,20,2
2021,433420,45,4,22,20,2
2021,433536,0,0,7,0,7
2021,433536,10,0,7,0,7
2021,433536,10,1,3,0,3
2021,433536,10,3,1,0,1
2021,433536,10,4,3,0,3
2021,433536,40,0,7,0,7
2021,433536,40,1,3,0,3
2021,433536,40,3,1,0,1
2021,433536,40,4,3,0,3
2021,433536,41,0,7,0,7
2021,433536,41,1,3,0,3
2021,433536,41,3,1,0,1
2021,433536,41,4,3,0,3
2021,433536,45,0,7,0,7
2021,433536,45,1,3,0,3
2021,433536,45,3,1,0,1
2021,433536,45,4,3,0,3
2021,433660,0,0,529,283,246
2021,433660,10,0,529,283,246
2021,433660,10,1,108,74,34
2021,433660,10,2,134,82,52
2021,433660,10,3,152,70,82
2021,433660,10,4,135,57,78
2021,433660,20,0,2,0,2
2021,433660,20,1,1,0,1
2021,433660,20,2,1,0,1
2021,433660,40,0,527,283,244
2021,433660,40,1,107,74,33
2021,433660,40,2,133,82,51
2021,433660,40,3,152,70,82
2021,433660,40,4,135,57,78
2021,433660,41,0,506,271,235
2021,433660,41,1,106,73,33
2021,433660,41,2,133,82,51
2021,433660,41,3,146,67,79
2021,433660,41,4,121,49,72
2021,433660,42,0,21,12,9
2021,433660,42,1,1,1,0
2021,433660,42,3,6,3,3
2021,433660,42,4,14,8,6
2021,433660,44,0,506,271,235
2021,433660,44,1,106,73,33
2021,433660,44,2,133,82,51
2021,433660,44,3,146,67,79
2021,433660,44,4,121,49,72
2021,434016,0,0,8,4,4
2021,434016,10,0,8,4,4
2021,434016,10,4,8,4,4
2021,434016,40,0,8,4,4
2021,434016,40,4,8,4,4
2021,434016,42,0,8,4,4
2021,434016,42,4,8,4,4
2021,434061,0,0,152,69,83
2021,434061,10,0,152,69,83
2021,434061,10,1,10,3,7
2021,434061,10,2,9,5,4
2021,434061,10,3,29,13,16
2021,434061,10,4,100,46,54
2021,434061,10,5,4,2,2
2021,434061,20,0,4,3,1
2021,434061,20,1,1,1,0
2021,434061,20,2,1,1,0
2021,434061,20,4,2,1,1
2021,434061,40,0,148,66,82
2021,434061,40,1,9,2,7
2021,434061,40,2,8,4,4
2021,434061,40,3,29,13,16
2021,434061,40,4,98,45,53
2021,434061,40,5,4,2,2
2021,434061,42,0,147,66,81
2021,434061,42,1,9,2,7
2021,434061,42,2,8,4,4
2021,434061,42,3,29,13,16
2021,434061,42,4,97,45,52
2021,434061,42,5,4,2,2
2021,434061,43,0,1,0,1
2021,434061,43,4,1,0,1
2021,434140,0,0,32,5,27
2021,434140,10,0,32,5,27
2021,434140,10,4,32,5,27
2021,434140,40,0,32,5,27
2021,434140,40,4,32,5,27
2021,434140,41,0,32,5,27
2021,434140,41,4,32,5,27
2021,434140,45,0,32,5,27
2021,434140,45,4,32,5,27
2021,434159,0,0,12,9,3
2021,434159,10,0,12,9,3
2021,434159,10,4,12,9,3
2021,434159,40,0,12,9,3
2021,434159,40,4,12,9,3
2021,434159,41,0,12,9,3
2021,434159,41,4,12,9,3
2021,434159,45,0,12,9,3
2021,434159,45,4,12,9,3
2021,434584,0,0,11,6,5
2021,434584,10,0,11,6,5
2021,434584,10,2,3,1,2
2021,434584,10,3,6,3,3
2021,434584,10,4,2,2,0
2021,434584,40,0,11,6,5
2021,434584,40,2,3,1,2
2021,434584,40,3,6,3,3
2021,434584,40,4,2,2,0
2021,434584,42,0,11,6,5
2021,434584,42,2,3,1,2
2021,434584,42,3,6,3,3
2021,434584,42,4,2,2,0
2021,434672,0,0,384,151,233
2021,434672,10,0,384,151,233
2021,434672,10,1,69,22,47
2021,434672,10,2,134,55,79
2021,434672,10,3,156,60,96
2021,434672,10,4,25,14,11
2021,434672,20,0,18,7,11
2021,434672,20,1,13,6,7
2021,434672,20,2,5,1,4
2021,434672,40,0,366,144,222
2021,434672,40,1,56,16,40
2021,434672,40,2,129,54,75
2021,434672,40,3,156,60,96
2021,434672,40,4,25,14,11
2021,434672,41,0,321,127,194
2021,434672,41,1,56,16,40
2021,434672,41,2,128,54,74
2021,434672,41,3,128,49,79
2021,434672,41,4,9,8,1
2021,434672,42,0,44,17,27
2021,434672,42,2,1,0,1
2021,434672,42,3,27,11,16
2021,434672,42,4,16,6,10
2021,434672,43,0,1,0,1
2021,434672,43,3,1,0,1
2021,434672,44,0,321,127,194
2021,434672,44,1,56,16,40
2021,434672,44,2,128,54,74
2021,434672,44,3,128,49,79
2021,434672,44,4,9,8,1
2021,434751,0,0,4,2,2
2021,434751,10,0,4,2,2
2021,434751,10,4,4,2,2
2021,434751,40,0,4,2,2
2021,434751,40,4,4,2,2
2021,434751,42,0,4,2,2
2021,434751,42,4,4,2,2
2021,434821,0,0,22,2,20
2021,434821,50,0,22,2,20
2021,434900,0,0,19,10,9
2021,434900,10,0,19,10,9
2021,434900,10,1,19,10,9
2021,434900,40,0,19,10,9
2021,434900,40,1,19,10,9
2021,434900,41,0,19,10,9
2021,434900,41,1,19,10,9
2021,434900,44,0,19,10,9
2021,434900,44,1,19,10,9
2021,435000,0,0,471,270,201
2021,435000,10,0,471,270,201
2021,435000,10,1,50,34,16
2021,435000,10,2,87,62,25
2021,435000,10,3,266,151,115
2021,435000,10,4,68,23,45
2021,435000,20,0,74,58,16
2021,435000,20,1,31,23,8
2021,435000,20,2,31,26,5
2021,435000,20,3,10,7,3
2021,435000,20,4,2,2,0
2021,435000,30,0,47,32,15
2021,435000,30,1,1,0,1
2021,435000,30,2,5,4,1
2021,435000,30,3,41,28,13
2021,435000,40,0,350,180,170
2021,435000,40,1,18,11,7
2021,435000,40,2,51,32,19
2021,435000,40,3,215,116,99
2021,435000,40,4,66,21,45
2021,435000,42,0,350,180,170
2021,435000,42,1,18,11,7
2021,435000,42,2,51,32,19
2021,435000,42,3,215,116,99
2021,435000,42,4,66,21,45
2021,436304,0,0,64,26,38
2021,436304,10,0,64,26,38
2021,436304,10,1,4,2,2
2021,436304,10,2,8,1,7
2021,436304,10,3,9,3,6
2021,436304,10,4,42,20,22
2021,436304,10,6,1,0,1
2021,436304,40,0,64,26,38
2021,436304,40,1,4,2,2
2021,436304,40,2,8,1,7
2021,436304,40,3,9,3,6
2021,436304,40,4,42,20,22
2021,436304,40,6,1,0,1
2021,436304,42,0,63,26,37
2021,436304,42,1,4,2,2
2021,436304,42,2,8,1,7
2021,436304,42,3,9,3,6
2021,436304,42,4,42,20,22
2021,436304,43,0,1,0,1
2021,436304,43,6,1,0,1
2021,436429,0,0,207,145,62
2021,436429,10,0,207,145,62
2021,436429,10,4,207,145,62
2021,436429,40,0,207,145,62
2021,436429,40,4,207,145,62
2021,436429,41,0,207,145,62
2021,436429,41,4,207,145,62
2021,436429,45,0,207,145,62
2021,436429,45,4,207,145,62
2021,436614,0,0,6,4,2
2021,436614,10,0,6,4,2
2021,436614,10,1,6,4,2
2021,436614,40,0,6,4,2
2021,436614,40,1,6,4,2
2021,436614,42,0,6,4,2
2021,436614,42,1,6,4,2
2021,437097,0,0,24,18,6
2021,437097,10,0,22,17,5
2021,437097,10,1,2,2,0
2021,437097,10,4,14,10,4
2021,437097,10,5,6,5,1
2021,437097,40,0,22,17,5
2021,437097,40,1,2,2,0
2021,437097,40,4,14,10,4
2021,437097,40,5,6,5,1
2021,437097,41,0,16,12,4
2021,437097,41,1,2,2,0
2021,437097,41,4,14,10,4
2021,437097,42,0,6,5,1
2021,437097,42,5,6,5,1
2021,437097,44,0,16,12,4
2021,437097,44,1,2,2,0
2021,437097,44,4,14,10,4
2021,437097,50,0,2,1,1
2021,437103,0,0,128,53,75
2021,437103,10,0,128,53,75
2021,437103,10,1,28,7,21
2021,437103,10,2,32,12,20
2021,437103,10,3,27,16,11
2021,437103,10,4,41,18,23
2021,437103,40,0,128,53,75
2021,437103,40,1,28,7,21
2021,437103,40,2,32,12,20
2021,437103,40,3,27,16,11
2021,437103,40,4,41,18,23
2021,437103,42,0,128,53,75
2021,437103,42,1,28,7,21
2021,437103,42,2,32,12,20
2021,437103,42,3,27,16,11
2021,437103,42,4,41,18,23
2021,437635,0,0,34,8,26
2021,437635,10,0,34,8,26
2021,437635,10,4,34,8,26
2021,437635,40,0,34,8,26
2021,437635,40,4,34,8,26
2021,437635,41,0,34,8,26
2021,437635,41,4,34,8,26
2021,437635,45,0,34,8,26
2021,437635,45,4,34,8,26
2021,437936,0,0,19,5,14
2021,437936,10,0,19,5,14
2021,437936,10,4,19,5,14
2021,437936,40,0,19,5,14
2021,437936,40,4,19,5,14
2021,437936,41,0,19,5,14
2021,437936,41,4,19,5,14
2021,437936,45,0,19,5,14
2021,437936,45,4,19,5,14
2021,438179,0,0,5,0,5
2021,438179,50,0,5,0,5
2021,438258,0,0,9,1,8
2021,438258,10,0,9,1,8
2021,438258,10,4,9,1,8
2021,438258,40,0,9,1,8
2021,438258,40,4,9,1,8
2021,438258,41,0,9,1,8
2021,438258,41,4,9,1,8
2021,438258,45,0,9,1,8
2021,438258,45,4,9,1,8
2021,438498,0,0,56,22,34
2021,438498,50,0,56,22,34
2021,438504,0,0,33,33,0
2021,438504,50,0,33,33,0
2021,438586,0,0,3,2,1
2021,438586,50,0,3,2,1
2021,438708,0,0,14,6,8
2021,438708,10,0,14,6,8
2021,438708,10,2,3,1,2
2021,438708,10,3,2,2,0
2021,438708,10,4,9,3,6
2021,438708,40,0,14,6,8
2021,438708,40,2,3,1,2
2021,438708,40,3,2,2,0
2021,438708,40,4,9,3,6
2021,438708,42,0,14,6,8
2021,438708,42,2,3,1,2
2021,438708,42,3,2,2,0
2021,438708,42,4,9,3,6
2021,439118,0,0,7,0,7
2021,439118,10,0,7,0,7
2021,439118,10,4,7,0,7
2021,439118,40,0,7,0,7
2021,439118,40,4,7,0,7
2021,439118,41,0,7,0,7
2021,439118,41,4,7,0,7
2021,439118,45,0,7,0,7
2021,439118,45,4,7,0,7
2021,439190,0,0,48,20,28
2021,439190,10,0,48,20,28
2021,439190,10,4,48,20,28
2021,439190,20,0,43,19,24
2021,439190,20,4,43,19,24
2021,439190,30,0,3,1,2
2021,439190,30,4,3,1,2
2021,439190,40,0,2,0,2
2021,439190,40,4,2,0,2
2021,439190,42,0,2,0,2
2021,439190,42,4,2,0,2
2021,439367,0,0,25,6,19
2021,439367,10,0,25,6,19
2021,439367,10,4,25,6,19
2021,439367,40,0,25,6,19
2021,439367,40,4,25,6,19
2021,439367,41,0,25,6,19
2021,439367,41,4,25,6,19
2021,439367,45,0,25,6,19
2021,439367,45,4,25,6,19
2021,439446,0,0,7,5,2
2021,439446,10,0,7,5,2
2021,439446,10,4,7,5,2
2021,439446,40,0,7,5,2
2021,439446,40,4,7,5,2
2021,439446,41,0,7,5,2
2021,439446,41,4,7,5,2
2021,439446,44,0,7,5,2
2021,439446,44,4,7,5,2
2021,439570,0,0,24,4,20
2021,439570,10,0,24,4,20
2021,439570,10,4,24,4,20
2021,439570,40,0,24,4,20
2021,439570,40,4,24,4,20
2021,439570,41,0,24,4,20
2021,439570,41,4,24,4,20
2021,439570,45,0,24,4,20
2021,439570,45,4,24,4,20
2021,439701,0,0,13,11,2
2021,439701,10,0,13,11,2
2021,439701,10,1,7,7,0
2021,439701,10,2,3,2,1
2021,439701,10,3,3,2,1
2021,439701,40,0,13,11,2
2021,439701,40,1,7,7,0
2021,439701,40,2,3,2,1
2021,439701,40,3,3,2,1
2021,439701,41,0,3,3,0
2021,439701,41,1,3,3,0
2021,439701,42,0,5,5,0
2021,439701,42,1,3,3,0
2021,439701,42,2,2,2,0
2021,439701,43,0,5,3,2
2021,439701,43,1,1,1,0
2021,439701,43,2,1,0,1
2021,439701,43,3,3,2,1
2021,439701,44,0,3,3,0
2021,439701,44,1,3,3,0
2021,439738,0,0,13,6,7
2021,439738,10,0,13,6,7
2021,439738,10,4,13,6,7
2021,439738,40,0,13,6,7
2021,439738,40,4,13,6,7
2021,439738,41,0,13,6,7
2021,439738,41,4,13,6,7
2021,439738,45,0,13,6,7
2021,439738,45,4,13,6,7
2021,439792,0,0,11,1,10
2021,439792,10,0,11,1,10
2021,439792,10,4,11,1,10
2021,439792,40,0,11,1,10
2021,439792,40,4,11,1,10
2021,439792,41,0,11,1,10
2021,439792,41,4,11,1,10
2021,439792,45,0,11,1,10
2021,439792,45,4,11,1,10
2021,440031,0,0,54,23,31
2021,440031,10,0,51,22,29
2021,440031,10,1,24,11,13
2021,440031,10,2,12,7,5
2021,440031,10,3,15,4,11
2021,440031,40,0,51,22,29
2021,440031,40,1,24,11,13
2021,440031,40,2,12,7,5
2021,440031,40,3,15,4,11
2021,440031,41,0,51,22,29
2021,440031,41,1,24,11,13
2021,440031,41,2,12,7,5
2021,440031,41,3,15,4,11
2021,440031,44,0,51,22,29
2021,440031,44,1,24,11,13
2021,440031,44,2,12,7,5
2021,440031,44,3,15,4,11
2021,440031,50,0,3,1,2
2021,440059,0,0,40,39,1
2021,440059,50,0,40,39,1
2021,440138,0,0,1,0,1
2021,440138,50,0,1,0,1
2021,440262,0,0,20,19,1
2021,440262,10,0,20,19,1
2021,440262,10,1,4,4,0
2021,440262,10,4,16,15,1
2021,440262,40,0,20,19,1
2021,440262,40,1,4,4,0
2021,440262,40,4,16,15,1
2021,440262,43,0,20,19,1
2021,440262,43,1,4,4,0
2021,440262,43,4,16,15,1
2021,440396,0,0,14,13,1
2021,440396,10,0,14,13,1
2021,440396,10,1,11,11,0
2021,440396,10,4,1,1,0
2021,440396,10,5,2,1,1
2021,440396,40,0,14,13,1
2021,440396,40,1,11,11,0
2021,440396,40,4,1,1,0
2021,440396,40,5,2,1,1
2021,440396,42,0,14,13,1
2021,440396,42,1,11,11,0
2021,440396,42,4,1,1,0
2021,440396,42,5,2,1,1
2021,440402,0,0,67,28,39
2021,440402,10,0,67,28,39
2021,440402,10,1,1,1,0
2021,440402,10,2,3,1,2
2021,440402,10,3,24,5,19
2021,440402,10,4,39,21,18
2021,440402,20,0,3,1,2
2021,440402,20,1,1,1,0
2021,440402,20,3,2,0,2
2021,440402,40,0,64,27,37
2021,440402,40,2,3,1,2
2021,440402,40,3,22,5,17
2021,440402,40,4,39,21,18
2021,440402,42,0,64,27,37
2021,440402,42,2,3,1,2
2021,440402,42,3,22,5,17
2021,440402,42,4,39,21,18
2021,440651,0,0,14,3,11
2021,440651,10,0,14,3,11
2021,440651,10,1,13,2,11
2021,440651,10,6,1,1,0
2021,440651,20,0,12,2,10
2021,440651,20,1,12,2,10
2021,440651,40,0,2,1,1
2021,440651,40,1,1,0,1
2021,440651,40,6,1,1,0
2021,440651,41,0,1,1,0
2021,440651,41,6,1,1,0
2021,440651,43,0,1,0,1
2021,440651,43,1,1,0,1
2021,440651,44,0,1,1,0
2021,440651,44,6,1,1,0
2021,440794,0,0,12,7,5
2021,440794,10,0,12,7,5
2021,440794,10,1,5,3,2
2021,440794,10,2,3,3,0
2021,440794,10,3,4,1,3
2021,440794,40,0,12,7,5
2021,440794,40,1,5,3,2
2021,440794,40,2,3,3,0
2021,440794,40,3,4,1,3
2021,440794,41,0,12,7,5
2021,440794,41,1,5,3,2
2021,440794,41,2,3,3,0
2021,440794,41,3,4,1,3
2021,440794,44,0,12,7,5
2021,440794,44,1,5,3,2
2021,440794,44,2,3,3,0
2021,440794,44,3,4,1,3
2021,440916,0,0,38,18,20
2021,440916,10,0,38,18,20
2021,440916,10,1,3,2,1
2021,440916,10,2,15,7,8
2021,440916,10,3,12,7,5
2021,440916,10,4,8,2,6
2021,440916,20,0,11,4,7
2021,440916,20,1,2,2,0
2021,440916,20,2,9,2,7
2021,440916,30,0,6,5,1
2021,440916,30,2,6,5,1
2021,440916,40,0,21,9,12
2021,440916,40,1,1,0,1
2021,440916,40,3,12,7,5
2021,440916,40,4,8,2,6
2021,440916,42,0,13,7,6
2021,440916,42,1,1,0,1
2021,440916,42,3,12,7,5
2021,440916,43,0,8,2,6
2021,440916,43,4,8,2,6
2021,441025,0,0,8,5,3
2021,441025,10,0,8,5,3
2021,441025,10,4,8,5,3
2021,441025,40,0,8,5,3
2021,441025,40,4,8,5,3
2021,441025,41,0,8,5,3
2021,441025,41,4,8,5,3
2021,441025,45,0,8,5,3
2021,441025,45,4,8,5,3
2021,441052,0,0,29,6,23
2021,441052,50,0,29,6,23
2021,441070,0,0,8,5,3
2021,441070,10,0,6,4,2
2021,441070,10,4,6,4,2
2021,441070,40,0,6,4,2
2021,441070,40,4,6,4,2
2021,441070,41,0,6,4,2
2021,441070,41,4,6,4,2
2021,441070,45,0,6,4,2
2021,441070,45,4,6,4,2
2021,441070,50,0,2,1,1
2021,441104,0,0,13,8,5
2021,441104,10,0,13,8,5
2021,441104,10,1,6,3,3
2021,441104,10,2,3,1,2
2021,441104,10,3,4,4,0
2021,441104,40,0,13,8,5
2021,441104,40,1,6,3,3
2021,441104,40,2,3,1,2
2021,441104,40,3,4,4,0
2021,441104,41,0,13,8,5
2021,441104,41,1,6,3,3
2021,441104,41,2,3,1,2
2021,441104,41,3,4,4,0
2021,441104,44,0,13,8,5
2021,441104,44,1,6,3,3
2021,441104,44,2,3,1,2
2021,441104,44,3,4,4,0
2021,441131,0,0,9,6,3
2021,441131,10,0,9,6,3
2021,441131,10,1,2,2,0
2021,441131,10,2,6,3,3
2021,441131,10,3,1,1,0
2021,441131,40,0,9,6,3
2021,441131,40,1,2,2,0
2021,441131,40,2,6,3,3
2021,441131,40,3,1,1,0
2021,441131,42,0,9,6,3
2021,441131,42,1,2,2,0
2021,441131,42,2,6,3,3
2021,441131,42,3,1,1,0
2021,441229,0,0,85,38,47
2021,441229,50,0,85,38,47
2021,441371,0,0,314,63,251
2021,441371,10,0,314,63,251
2021,441371,10,4,314,63,251
2021,441371,40,0,314,63,251
2021,441371,40,4,314,63,251
2021,441371,41,0,314,63,251
2021,441371,41,4,314,63,251
2021,441371,45,0,314,63,251
2021,441371,45,4,314,63,251
2021,441423,0,0,7,3,4
2021,441423,10,0,7,3,4
2021,441423,10,4,7,3,4
2021,441423,40,0,7,3,4
2021,441423,40,4,7,3,4
2021,441423,41,0,7,3,4
2021,441423,41,4,7,3,4
2021,441423,45,0,7,3,4
2021,441423,45,4,7,3,4
2021,441609,0,0,12,12,0
2021,441609,10,0,12,12,0
2021,441609,10,4,12,12,0
2021,441609,40,0,12,12,0
2021,441609,40,4,12,12,0
2021,441609,42,0,12,12,0
2021,441609,42,4,12,12,0
2021,441636,0,0,18,3,15
2021,441636,10,0,18,3,15
2021,441636,10,4,18,3,15
2021,441636,40,0,18,3,15
2021,441636,40,4,18,3,15
2021,441636,41,0,18,3,15
2021,441636,41,4,18,3,15
2021,441636,45,0,18,3,15
2021,441636,45,4,18,3,15
2021,441742,0,0,16,8,8
2021,441742,10,0,16,8,8
2021,441742,10,4,16,8,8
2021,441742,40,0,16,8,8
2021,441742,40,4,16,8,8
2021,441742,41,0,16,8,8
2021,441742,41,4,16,8,8
2021,441742,45,0,16,8,8
2021,441742,45,4,16,8,8
2021,441760,0,0,71,29,42
2021,441760,10,0,71,29,42
2021,441760,10,4,67,28,39
2021,441760,10,6,4,1,3
2021,441760,20,0,47,16,31
2021,441760,20,4,47,16,31
2021,441760,30,0,12,8,4
2021,441760,30,4,12,8,4
2021,441760,40,0,12,5,7
2021,441760,40,4,8,4,4
2021,441760,40,6,4,1,3
2021,441760,42,0,7,3,4
2021,441760,42,4,7,3,4
2021,441760,43,0,5,2,3
2021,441760,43,4,1,1,0
2021,441760,43,6,4,1,3
2021,441858,0,0,8,0,8
2021,441858,10,0,8,0,8
2021,441858,10,4,8,0,8
2021,441858,40,0,8,0,8
2021,441858,40,4,8,0,8
2021,441858,41,0,8,0,8
2021,441858,41,4,8,0,8
2021,441858,45,0,8,0,8
2021,441858,45,4,8,0,8
2021,441900,0,0,119,40,79
2021,441900,10,0,119,40,79
2021,441900,10,1,7,4,3
2021,441900,10,2,23,9,14
2021,441900,10,3,44,13,31
2021,441900,10,5,45,14,31
2021,441900,20,0,30,13,17
2021,441900,20,1,7,4,3
2021,441900,20,2,23,9,14
2021,441900,30,0,44,13,31
2021,441900,30,3,44,13,31
2021,441900,40,0,45,14,31
2021,441900,40,5,45,14,31
2021,441900,42,0,45,14,31
2021,441900,42,5,45,14,31
2021,441937,0,0,227,96,131
2021,441937,10,0,227,96,131
2021,441937,10,1,55,29,26
2021,441937,10,2,42,17,25
2021,441937,10,3,52,17,35
2021,441937,10,5,78,33,45
2021,441937,20,0,97,46,51
2021,441937,20,1,55,29,26
2021,441937,20,2,42,17,25
2021,441937,30,0,52,17,35
2021,441937,30,3,52,17,35
2021,441937,40,0,78,33,45
2021,441937,40,5,78,33,45
2021,441937,41,0,57,24,33
2021,441937,41,5,57,24,33
2021,441937,42,0,21,9,12
2021,441937,42,5,21,9,12
2021,441937,44,0,57,24,33
2021,441937,44,5,57,24,33
2021,441982,0,0,45,22,23
2021,441982,10,0,45,22,23
2021,441982,10,1,18,9,9
2021,441982,10,2,8,5,3
2021,441982,10,3,13,5,8
2021,441982,10,4,6,3,3
2021,441982,40,0,45,22,23
2021,441982,40,1,18,9,9
2021,441982,40,2,8,5,3
2021,441982,40,3,13,5,8
2021,441982,40,4,6,3,3
2021,441982,41,0,42,20,22
2021,441982,41,1,18,9,9
2021,441982,41,2,8,5,3
2021,441982,41,3,11,4,7
2021,441982,41,4,5,2,3
2021,441982,42,0,3,2,1
2021,441982,42,3,2,1,1
2021,441982,42,4,1,1,0
2021,441982,44,0,39,18,21
2021,441982,44,1,18,9,9
2021,441982,44,2,8,5,3
2021,441982,44,3,11,4,7
2021,441982,44,4,2,0,2
2021,441982,45,0,3,2,1
2021,441982,45,4,3,2,1
2021,442064,0,0,7,2,5
2021,442064,10,0,7,2,5
2021,442064,10,2,1,0,1
2021,442064,10,3,6,2,4
2021,442064,40,0,7,2,5
2021,442064,40,2,1,0,1
2021,442064,40,3,6,2,4
2021,442064,41,0,7,2,5
2021,442064,41,2,1,0,1
2021,442064,41,3,6,2,4
2021,442064,44,0,6,2,4
2021,442064,44,2,1,0,1
2021,442064,44,3,5,2,3
2021,442064,45,0,1,0,1
2021,442064,45,3,1,0,1
2021,442134,0,0,15,2,13
2021,442134,10,0,15,2,13
2021,442134,10,4,15,2,13
2021,442134,40,0,15,2,13
2021,442134,40,4,15,2,13
2021,442134,41,0,15,2,13
2021,442134,41,4,15,2,13
2021,442134,45,0,15,2,13
2021,442134,45,4,15,2,13
2021,442295,0,0,26,18,8
2021,442295,10,0,24,16,8
2021,442295,10,1,16,12,4
2021,442295,10,2,1,1,0
2021,442295,10,3,7,3,4
2021,442295,20,0,10,7,3
2021,442295,20,1,10,7,3
2021,442295,30,0,3,3,0
2021,442295,30,1,2,2,0
2021,442295,30,2,1,1,0
2021,442295,40,0,11,6,5
2021,442295,40,1,4,3,1
2021,442295,40,3,7,3,4
2021,442295,41,0,11,6,5
2021,442295,41,1,4,3,1
2021,442295,41,3,7,3,4
2021,442295,44,0,11,6,5
2021,442295,44,1,4,3,1
2021,442295,44,3,7,3,4
2021,442295,50,0,2,2,0
2021,442356,0,0,78,7,71
2021,442356,10,0,78,7,71
2021,442356,10,1,1,0,1
2021,442356,10,2,2,0,2
2021,442356,10,3,5,1,4
2021,442356,10,4,67,5,62
2021,442356,10,5,3,1,2
2021,442356,40,0,78,7,71
2021,442356,40,1,1,0,1
2021,442356,40,2,2,0,2
2021,442356,40,3,5,1,4
2021,442356,40,4,67,5,62
2021,442356,40,5,3,1,2
2021,442356,42,0,78,7,71
2021,442356,42,1,1,0,1
2021,442356,42,2,2,0,2
2021,442356,42,3,5,1,4
2021,442356,42,4,67,5,62
2021,442356,42,5,3,1,2
2021,442383,0,0,11,1,10
2021,442383,50,0,11,1,10
2021,442426,0,0,21,5,16
2021,442426,10,0,21,5,16
2021,442426,10,4,21,5,16
2021,442426,40,0,21,5,16
2021,442426,40,4,21,5,16
2021,442426,41,0,21,5,16
2021,442426,41,4,21,5,16
2021,442426,45,0,21,5,16
2021,442426,45,4,21,5,16
2021,442444,0,0,28,11,17
2021,442444,10,0,28,11,17
2021,442444,10,4,28,11,17
2021,442444,40,0,28,11,17
2021,442444,40,4,28,11,17
2021,442444,41,0,28,11,17
2021,442444,41,4,28,11,17
2021,442444,45,0,28,11,17
2021,442444,45,4,28,11,17
2021,442569,0,0,14,4,10
2021,442569,10,0,14,4,10
2021,442569,10,1,1,0,1
2021,442569,10,2,4,0,4
2021,442569,10,3,6,4,2
2021,442569,10,4,3,0,3
2021,442569,40,0,14,4,10
2021,442569,40,1,1,0,1
2021,442569,40,2,4,0,4
2021,442569,40,3,6,4,2
2021,442569,40,4,3,0,3
2021,442569,41,0,14,4,10
2021,442569,41,1,1,0,1
2021,442569,41,2,4,0,4
2021,442569,41,3,6,4,2
2021,442569,41,4,3,0,3
2021,442569,45,0,14,4,10
2021,442569,45,1,1,0,1
2021,442569,45,2,4,0,4
2021,442569,45,3,6,4,2
2021,442569,45,4,3,0,3
2021,442602,0,0,12,1,11
2021,442602,10,0,12,1,11
2021,442602,10,4,12,1,11
2021,442602,40,0,12,1,11
2021,442602,40,4,12,1,11
2021,442602,41,0,12,1,11
2021,442602,41,4,12,1,11
2021,442602,45,0,12,1,11
2021,442602,45,4,12,1,11
2021,442781,0,0,15,7,8
2021,442781,10,0,15,7,8
2021,442781,10,4,15,7,8
2021,442781,40,0,15,7,8
2021,442781,40,4,15,7,8
2021,442781,42,0,15,7,8
2021,442781,42,4,15,7,8
2021,442806,0,0,136,76,60
2021,442806,10,0,136,76,60
2021,442806,10,1,7,5,2
2021,442806,10,2,26,15,11
2021,442806,10,3,93,52,41
2021,442806,10,4,10,4,6
2021,442806,20,0,2,2,0
2021,442806,20,1,2,2,0
2021,442806,30,0,117,66,51
2021,442806,30,1,5,3,2
2021,442806,30,2,26,15,11
2021,442806,30,3,86,48,38
2021,442806,40,0,17,8,9
2021,442806,40,3,7,4,3
2021,442806,40,4,10,4,6
2021,442806,42,0,7,4,3
2021,442806,42,3,7,4,3
2021,442806,43,0,10,4,6
2021,442806,43,4,10,4,6
2021,442842,0,0,2,1,1
2021,442842,10,0,2,1,1
2021,442842,10,4,2,1,1
2021,442842,40,0,2,1,1
2021,442842,40,4,2,1,1
2021,442842,42,0,2,1,1
2021,442842,42,4,2,1,1
2021,442879,0,0,1,0,1
2021,442879,50,0,1,0,1
2021,442930,0,0,13,7,6
2021,442930,10,0,13,7,6
2021,442930,10,4,13,7,6
2021,442930,40,0,13,7,6
2021,442930,40,4,13,7,6
2021,442930,41,0,13,7,6
2021,442930,41,4,13,7,6
2021,442930,45,0,13,7,6
2021,442930,45,4,13,7,6
2021,443049,0,0,6,5,1
2021,443049,10,0,6,5,1
2021,443049,10,1,4,3,1
2021,443049,10,2,1,1,0
2021,443049,10,4,1,1,0
2021,443049,40,0,6,5,1
2021,443049,40,1,4,3,1
2021,443049,40,2,1,1,0
2021,443049,40,4,1,1,0
2021,443049,42,0,6,5,1
2021,443049,42,1,4,3,1
2021,443049,42,2,1,1,0
2021,443049,42,4,1,1,0
2021,443076,0,0,4,1,3
2021,443076,10,0,3,1,2
2021,443076,10,1,1,0,1
2021,443076,10,2,2,1,1
2021,443076,20,0,1,0,1
2021,443076,20,1,1,0,1
2021,443076,30,0,2,1,1
2021,443076,30,2,2,1,1
2021,443076,50,0,1,0,1
2021,443128,0,0,9,9,0
2021,443128,10,0,7,7,0
2021,443128,10,1,7,7,0
2021,443128,40,0,7,7,0
2021,443128,40,1,7,7,0
2021,443128,41,0,7,7,0
2021,443128,41,1,7,7,0
2021,443128,44,0,7,7,0
2021,443128,44,1,7,7,0
2021,443128,50,0,2,2,0
2021,443261,0,0,18,4,14
2021,443261,10,0,18,4,14
2021,443261,10,4,18,4,14
2021,443261,40,0,18,4,14
2021,443261,40,4,18,4,14
2021,443261,41,0,18,4,14
2021,443261,41,4,18,4,14
2021,443261,45,0,18,4,14
2021,443261,45,4,18,4,14
2021,443331,0,0,52,20,32
2021,443331,10,0,51,19,32
2021,443331,10,1,1,1,0
2021,443331,10,2,8,4,4
2021,443331,10,3,13,6,7
2021,443331,10,4,29,8,21
2021,443331,40,0,51,19,32
2021,443331,40,1,1,1,0
2021,443331,40,2,8,4,4
2021,443331,40,3,13,6,7
2021,443331,40,4,29,8,21
2021,443331,41,0,51,19,32
2021,443331,41,1,1,1,0
2021,443331,41,2,8,4,4
2021,443331,41,3,13,6,7
2021,443331,41,4,29,8,21
2021,443331,45,0,51,19,32
2021,443331,45,1,1,1,0
2021,443331,45,2,8,4,4
2021,443331,45,3,13,6,7
2021,443331,45,4,29,8,21
2021,443331,50,0,1,1,0
2021,443377,0,0,10,8,2
2021,443377,10,0,10,8,2
2021,443377,10,4,10,8,2
2021,443377,40,0,10,8,2
2021,443377,40,4,10,8,2
2021,443377,41,0,10,8,2
2021,443377,41,4,10,8,2
2021,443377,45,0,10,8,2
2021,443377,45,4,10,8,2
2021,443410,0,0,78,58,20
2021,443410,10,0,78,58,20
2021,443410,10,1,9,7,2
2021,443410,10,2,11,6,5
2021,443410,10,3,15,10,5
2021,443410,10,5,43,35,8
2021,443410,40,0,78,58,20
2021,443410,40,1,9,7,2
2021,443410,40,2,11,6,5
2021,443410,40,3,15,10,5
2021,443410,40,5,43,35,8
2021,443410,41,0,78,58,20
2021,443410,41,1,9,7,2
2021,443410,41,2,11,6,5
2021,443410,41,3,15,10,5
2021,443410,41,5,43,35,8
2021,443410,45,0,78,58,20
2021,443410,45,1,9,7,2
2021,443410,45,2,11,6,5
2021,443410,45,3,15,10,5
2021,443410,45,5,43,35,8
2021,443492,0,0,55,20,35
2021,443492,10,0,55,20,35
2021,443492,10,1,9,3,6
2021,443492,10,2,11,1,10
2021,443492,10,3,18,5,13
2021,443492,10,4,15,11,4
2021,443492,10,6,2,0,2
2021,443492,20,0,8,2,6
2021,443492,20,1,7,2,5
2021,443492,20,2,1,0,1
2021,443492,30,0,4,0,4
2021,443492,30,2,2,0,2
2021,443492,30,3,2,0,2
2021,443492,40,0,43,18,25
2021,443492,40,1,2,1,1
2021,443492,40,2,8,1,7
2021,443492,40,3,16,5,11
2021,443492,40,4,15,11,4
2021,443492,40,6,2,0,2
2021,443492,42,0,43,18,25
2021,443492,42,1,2,1,1
2021,443492,42,2,8,1,7
2021,443492,42,3,16,5,11
2021,443492,42,4,15,11,4
2021,443492,42,6,2,0,2
2021,443562,0,0,37,19,18
2021,443562,10,0,37,19,18
2021,443562,10,1,37,19,18
2021,443562,40,0,37,19,18
2021,443562,40,1,37,19,18
2021,443562,41,0,37,19,18
2021,443562,41,1,37,19,18
2021,443562,44,0,37,19,18
2021,443562,44,1,37,19,18
2021,443571,0,0,2,1,1
2021,443571,10,0,2,1,1
2021,443571,10,4,2,1,1
2021,443571,40,0,2,1,1
2021,443571,40,4,2,1,1
2021,443571,41,0,2,1,1
2021,443571,41,4,2,1,1
2021,443571,45,0,2,1,1
2021,443571,45,4,2,1,1
2021,443599,0,0,15,7,8
2021,443599,10,0,15,7,8
2021,443599,10,1,14,7,7
2021,443599,10,2,1,0,1
2021,443599,40,0,15,7,8
2021,443599,40,1,14,7,7
2021,443599,40,2,1,0,1
2021,443599,41,0,15,7,8
2021,443599,41,1,14,7,7
2021,443599,41,2,1,0,1
2021,443599,45,0,15,7,8
2021,443599,45,1,14,7,7
2021,443599,45,2,1,0,1
2021,443650,0,0,9,4,5
2021,443650,10,0,9,4,5
2021,443650,10,4,9,4,5
2021,443650,40,0,9,4,5
2021,443650,40,4,9,4,5
2021,443650,41,0,9,4,5
2021,443650,41,4,9,4,5
2021,443650,45,0,9,4,5
2021,443650,45,4,9,4,5
2021,443748,0,0,14,5,9
2021,443748,10,0,5,0,5
2021,443748,10,4,5,0,5
2021,443748,40,0,5,0,5
2021,443748,40,4,5,0,5
2021,443748,41,0,5,0,5
2021,443748,41,4,5,0,5
2021,443748,45,0,5,0,5
2021,443748,45,4,5,0,5
2021,443748,50,0,9,5,4
2021,444088,0,0,17,1,16
2021,444088,10,0,17,1,16
2021,444088,10,4,17,1,16
2021,444088,40,0,17,1,16
2021,444088,40,4,17,1,16
2021,444088,41,0,17,1,16
2021,444088,41,4,17,1,16
2021,444088,45,0,17,1,16
2021,444088,45,4,17,1,16
2021,444130,0,0,101,38,63
2021,444130,10,0,101,38,63
2021,444130,10,1,67,25,42
2021,444130,10,2,27,7,20
2021,444130,10,3,7,6,1
2021,444130,40,0,101,38,63
2021,444130,40,1,67,25,42
2021,444130,40,2,27,7,20
2021,444130,40,3,7,6,1
2021,444130,41,0,101,38,63
2021,444130,41,1,67,25,42
2021,444130,41,2,27,7,20
2021,444130,41,3,7,6,1
2021,444130,45,0,101,38,63
2021,444130,45,1,67,25,42
2021,444130,45,2,27,7,20
2021,444130,45,3,7,6,1
2021,444219,0,0,125,57,68
2021,444219,10,0,125,57,68
2021,444219,10,4,125,57,68
2021,444219,20,0,92,46,46
2021,444219,20,4,92,46,46
2021,444219,30,0,29,9,20
2021,444219,30,4,29,9,20
2021,444219,40,0,4,2,2
2021,444219,40,4,4,2,2
2021,444219,43,0,4,2,2
2021,444219,43,4,4,2,2
2021,444556,0,0,26,16,10
2021,444556,10,0,26,16,10
2021,444556,10,4,26,16,10
2021,444556,40,0,26,16,10
2021,444556,40,4,26,16,10
2021,444556,41,0,26,16,10
2021,444556,41,4,26,16,10
2021,444556,45,0,26,16,10
2021,444556,45,4,26,16,10
2021,444565,0,0,27,11,16
2021,444565,10,0,14,9,5
2021,444565,10,4,14,9,5
2021,444565,40,0,14,9,5
2021,444565,40,4,14,9,5
2021,444565,41,0,14,9,5
2021,444565,41,4,14,9,5
2021,444565,45,0,14,9,5
2021,444565,45,4,14,9,5
2021,444565,50,0,13,2,11
2021,444787,0,0,146,24,122
2021,444787,10,0,146,24,122
2021,444787,10,3,145,24,121
2021,444787,10,4,1,0,1
2021,444787,40,0,146,24,122
2021,444787,40,3,145,24,121
2021,444787,40,4,1,0,1
2021,444787,41,0,145,24,121
2021,444787,41,3,144,24,120
2021,444787,41,4,1,0,1
2021,444787,43,0,1,0,1
2021,444787,43,3,1,0,1
2021,444787,45,0,145,24,121
2021,444787,45,3,144,24,120
2021,444787,45,4,1,0,1
2021,444811,0,0,4,1,3
2021,444811,10,0,4,1,3
2021,444811,10,4,4,1,3
2021,444811,40,0,4,1,3
2021,444811,40,4,4,1,3
2021,444811,41,0,4,1,3
2021,444811,41,4,4,1,3
2021,444811,45,0,4,1,3
2021,444811,45,4,4,1,3
2021,444866,0,0,14,2,12
2021,444866,10,0,14,2,12
2021,444866,10,4,14,2,12
2021,444866,40,0,14,2,12
2021,444866,40,4,14,2,12
2021,444866,41,0,14,2,12
2021,444866,41,4,14,2,12
2021,444866,45,0,14,2,12
2021,444866,45,4,14,2,12
2021,444954,0,0,53,20,33
2021,444954,10,0,53,20,33
2021,444954,10,1,14,6,8
2021,444954,10,2,15,6,9
2021,444954,10,3,20,5,15
2021,444954,10,4,3,2,1
2021,444954,10,6,1,1,0
2021,444954,20,0,4,2,2
2021,444954,20,1,4,2,2
2021,444954,40,0,49,18,31
2021,444954,40,1,10,4,6
2021,444954,40,2,15,6,9
2021,444954,40,3,20,5,15
2021,444954,40,4,3,2,1
2021,444954,40,6,1,1,0
2021,444954,41,0,1,0,1
2021,444954,41,2,1,0,1
2021,444954,42,0,48,18,30
2021,444954,42,1,10,4,6
2021,444954,42,2,14,6,8
2021,444954,42,3,20,5,15
2021,444954,42,4,3,2,1
2021,444954,42,6,1,1,0
2021,444954,44,0,1,0,1
2021,444954,44,2,1,0,1
2021,445027,0,0,80,28,52
2021,445027,50,0,80,28,52
2021,445133,0,0,2,2,0
2021,445133,50,0,2,2,0
2021,445188,0,0,451,238,213
2021,445188,10,0,451,238,213
2021,445188,10,1,93,55,38
2021,445188,10,2,92,55,37
2021,445188,10,3,114,48,66
2021,445188,10,5,152,80,72
2021,445188,20,0,199,119,80
2021,445188,20,1,93,55,38
2021,445188,20,2,92,55,37
2021,445188,20,5,14,9,5
2021,445188,30,0,123,52,71
2021,445188,30,3,112,46,66
2021,445188,30,5,11,6,5
2021,445188,40,0,129,67,62
2021,445188,40,3,2,2,0
2021,445188,40,5,127,65,62
2021,445188,41,0,69,32,37
2021,445188,41,5,69,32,37
2021,445188,42,0,60,35,25
2021,445188,42,3,2,2,0
2021,445188,42,5,58,33,25
2021,445188,44,0,69,32,37
2021,445188,44,5,69,32,37
2021,445203,0,0,7,3,4
2021,445203,50,0,7,3,4
2021,445230,0,0,34,13,21
2021,445230,10,0,34,13,21
2021,445230,10,4,34,13,21
2021,445230,40,0,34,13,21
2021,445230,40,4,34,13,21
2021,445230,41,0,34,13,21
2021,445230,41,4,34,13,21
2021,445230,45,0,34,13,21
2021,445230,45,4,34,13,21
2021,445249,0,0,6,3,3
2021,445249,50,0,6,3,3
2021,445267,0,0,16,3,13
2021,445267,10,0,16,3,13
2021,445267,10,1,1,0,1
2021,445267,10,2,6,0,6
2021,445267,10,3,9,3,6
2021,445267,20,0,1,0,1
2021,445267,20,3,1,0,1
2021,445267,30,0,4,2,2
2021,445267,30,3,4,2,2
2021,445267,40,0,11,1,10
2021,445267,40,1,1,0,1
2021,445267,40,2,6,0,6
2021,445267,40,3,4,1,3
2021,445267,42,0,11,1,10
2021,445267,42,1,1,0,1
2021,445267,42,2,6,0,6
2021,445267,42,3,4,1,3
2021,445461,0,0,8,4,4
2021,445461,10,0,1,1,0
2021,445461,10,4,1,1,0
2021,445461,40,0,1,1,0
2021,445461,40,4,1,1,0
2021,445461,41,0,1,1,0
2021,445461,41,4,1,1,0
2021,445461,45,0,1,1,0
2021,445461,45,4,1,1,0
2021,445461,50,0,7,3,4
2021,445692,0,0,11,11,0
2021,445692,10,0,11,11,0
2021,445692,10,4,11,11,0
2021,445692,40,0,11,11,0
2021,445692,40,4,11,11,0
2021,445692,41,0,11,11,0
2021,445692,41,4,11,11,0
2021,445692,45,0,11,11,0
2021,445692,45,4,11,11,0
2021,445708,0,0,74,38,36
2021,445708,10,0,74,38,36
2021,445708,10,1,18,13,5
2021,445708,10,2,36,14,22
2021,445708,10,3,16,11,5
2021,445708,10,4,1,0,1
2021,445708,10,5,3,0,3
2021,445708,40,0,74,38,36
2021,445708,40,1,18,13,5
2021,445708,40,2,36,14,22
2021,445708,40,3,16,11,5
2021,445708,40,4,1,0,1
2021,445708,40,5,3,0,3
2021,445708,41,0,71,38,33
2021,445708,41,1,18,13,5
2021,445708,41,2,36,14,22
2021,445708,41,3,16,11,5
2021,445708,41,4,1,0,1
2021,445708,42,0,3,0,3
2021,445708,42,5,3,0,3
2021,445708,45,0,71,38,33
2021,445708,45,1,18,13,5
2021,445708,45,2,36,14,22
2021,445708,45,3,16,11,5
2021,445708,45,4,1,0,1
2021,445735,0,0,114,58,56
2021,445735,10,0,114,58,56
2021,445735,10,1,2,2,0
2021,445735,10,2,41,29,12
2021,445735,10,3,68,26,42
2021,445735,10,4,3,1,2
2021,445735,40,0,114,58,56
2021,445735,40,1,2,2,0
2021,445735,40,2,41,29,12
2021,445735,40,3,68,26,42
2021,445735,40,4,3,1,2
2021,445735,41,0,111,57,54
2021,445735,41,1,2,2,0
2021,445735,41,2,41,29,12
2021,445735,41,3,68,26,42
2021,445735,42,0,3,1,2
2021,445735,42,4,3,1,2
2021,445735,44,0,111,57,54
2021,445735,44,1,2,2,0
2021,445735,44,2,41,29,12
2021,445735,44,3,68,26,42
2021,445744,0,0,10,1,9
2021,445744,10,0,10,1,9
2021,445744,10,4,10,1,9
2021,445744,40,0,10,1,9
2021,445744,40,4,10,1,9
2021,445744,41,0,10,1,9
2021,445744,41,4,10,1,9
2021,445744,45,0,10,1,9
2021,445744,45,4,10,1,9
2021,445869,0,0,28,13,15
2021,445869,10,0,28,13,15
2021,445869,10,1,7,5,2
2021,445869,10,2,12,4,8
2021,445869,10,3,8,4,4
2021,445869,10,4,1,0,1
2021,445869,40,0,28,13,15
2021,445869,40,1,7,5,2
2021,445869,40,2,12,4,8
2021,445869,40,3,8,4,4
2021,445869,40,4,1,0,1
2021,445869,41,0,28,13,15
2021,445869,41,1,7,5,2
2021,445869,41,2,12,4,8
2021,445869,41,3,8,4,4
2021,445869,41,4,1,0,1
2021,445869,44,0,28,13,15
2021,445869,44,1,7,5,2
2021,445869,44,2,12,4,8
2021,445869,44,3,8,4,4
2021,445869,44,4,1,0,1
2021,445948,0,0,54,14,40
2021,445948,10,0,54,14,40
2021,445948,10,6,54,14,40
2021,445948,40,0,54,14,40
2021,445948,40,6,54,14,40
2021,445948,41,0,54,14,40
2021,445948,41,6,54,14,40
2021,445948,45,0,54,14,40
2021,445948,45,6,54,14,40
2021,446048,0,0,63,45,18
2021,446048,10,0,63,45,18
2021,446048,10,1,6,5,1
2021,446048,10,2,28,23,5
2021,446048,10,3,25,14,11
2021,446048,10,4,4,3,1
2021,446048,40,0,63,45,18
2021,446048,40,1,6,5,1
2021,446048,40,2,28,23,5
2021,446048,40,3,25,14,11
2021,446048,40,4,4,3,1
2021,446048,41,0,31,25,6
2021,446048,41,1,6,5,1
2021,446048,41,2,22,18,4
2021,446048,41,3,2,1,1
2021,446048,41,4,1,1,0
2021,446048,42,0,32,20,12
2021,446048,42,2,6,5,1
2021,446048,42,3,23,13,10
2021,446048,42,4,3,2,1
2021,446048,44,0,31,25,6
2021,446048,44,1,6,5,1
2021,446048,44,2,22,18,4
2021,446048,44,3,2,1,1
2021,446048,44,4,1,1,0
2021,446109,0,0,13,5,8
2021,446109,50,0,13,5,8
2021,446118,0,0,31,7,24
2021,446118,10,0,31,7,24
2021,446118,10,4,31,7,24
2021,446118,40,0,31,7,24
2021,446118,40,4,31,7,24
2021,446118,41,0,31,7,24
2021,446118,41,4,31,7,24
2021,446118,45,0,31,7,24
2021,446118,45,4,31,7,24
2021,446127,0,0,5,0,5
2021,446127,10,0,5,0,5
2021,446127,10,4,5,0,5
2021,446127,40,0,5,0,5
2021,446127,40,4,5,0,5
2021,446127,41,0,5,0,5
2021,446127,41,4,5,0,5
2021,446127,45,0,5,0,5
2021,446127,45,4,5,0,5
2021,446163,0,0,1,1,0
2021,446163,10,0,1,1,0
2021,446163,10,1,1,1,0
2021,446163,40,0,1,1,0
2021,446163,40,1,1,1,0
2021,446163,41,0,1,1,0
2021,446163,41,1,1,1,0
2021,446163,45,0,1,1,0
2021,446163,45,1,1,1,0
2021,446233,0,0,7,6,1
2021,446233,10,0,7,6,1
2021,446233,10,4,7,6,1
2021,446233,40,0,7,6,1
2021,446233,40,4,7,6,1
2021,446233,41,0,1,1,0
2021,446233,41,4,1,1,0
2021,446233,43,0,6,5,1
2021,446233,43,4,6,5,1
2021,446233,44,0,1,1,0
2021,446233,44,4,1,1,0
2021,446385,0,0,10,7,3
2021,446385,10,0,10,7,3
2021,446385,10,6,10,7,3
2021,446385,40,0,10,7,3
2021,446385,40,6,10,7,3
2021,446385,41,0,10,7,3
2021,446385,41,6,10,7,3
2021,446385,44,0,9,7,2
2021,446385,44,6,9,7,2
2021,446385,45,0,1,0,1
2021,446385,45,6,1,0,1
2021,446552,0,0,56,31,25
2021,446552,10,0,56,31,25
2021,446552,10,4,56,31,25
2021,446552,40,0,56,31,25
2021,446552,40,4,56,31,25
2021,446552,41,0,56,31,25
2021,446552,41,4,56,31,25
2021,446552,45,0,56,31,25
2021,446552,45,4,56,31,25
2021,446561,0,0,48,18,30
2021,446561,10,0,48,18,30
2021,446561,10,4,48,18,30
2021,446561,40,0,48,18,30
2021,446561,40,4,48,18,30
2021,446561,41,0,48,18,30
2021,446561,41,4,48,18,30
2021,446561,45,0,48,18,30
2021,446561,45,4,48,18,30
2021,446589,0,0,7,3,4
2021,446589,10,0,7,3,4
2021,446589,10,4,7,3,4
2021,446589,40,0,7,3,4
2021,446589,40,4,7,3,4
2021,446589,43,0,7,3,4
2021,446589,43,4,7,3,4
2021,446604,0,0,168,168,0
2021,446604,10,0,168,168,0
2021,446604,10,1,15,15,0
2021,446604,10,4,83,83,0
2021,446604,10,5,58,58,0
2021,446604,10,6,12,12,0
2021,446604,40,0,168,168,0
2021,446604,40,1,15,15,0
2021,446604,40,4,83,83,0
2021,446604,40,5,58,58,0
2021,446604,40,6,12,12,0
2021,446604,41,0,168,168,0
2021,446604,41,1,15,15,0
2021,446604,41,4,83,83,0
2021,446604,41,5,58,58,0
2021,446604,41,6,12,12,0
2021,446604,45,0,168,168,0
2021,446604,45,1,15,15,0
2021,446604,45,4,83,83,0
2021,446604,45,5,58,58,0
2021,446604,45,6,12,12,0
2021,446640,0,0,141,101,40
2021,446640,10,0,141,101,40
2021,446640,10,1,10,8,2
2021,446640,10,2,25,17,8
2021,446640,10,3,41,27,14
2021,446640,10,4,21,16,5
2021,446640,10,6,44,33,11
2021,446640,40,0,141,101,40
2021,446640,40,1,10,8,2
2021,446640,40,2,25,17,8
2021,446640,40,3,41,27,14
2021,446640,40,4,21,16,5
2021,446640,40,6,44,33,11
2021,446640,41,0,141,101,40
2021,446640,41,1,10,8,2
2021,446640,41,2,25,17,8
2021,446640,41,3,41,27,14
2021,446640,41,4,21,16,5
2021,446640,41,6,44,33,11
2021,446640,45,0,141,101,40
2021,446640,45,1,10,8,2
2021,446640,45,2,25,17,8
2021,446640,45,3,41,27,14
2021,446640,45,4,21,16,5
2021,446640,45,6,44,33,11
2021,446774,0,0,101,37,64
2021,446774,10,0,101,37,64
2021,446774,10,1,6,2,4
2021,446774,10,2,8,1,7
2021,446774,10,3,19,4,15
2021,446774,10,4,24,12,12
2021,446774,10,5,44,18,26
2021,446774,20,0,1,0,1
2021,446774,20,1,1,0,1
2021,446774,40,0,100,37,63
2021,446774,40,1,5,2,3
2021,446774,40,2,8,1,7
2021,446774,40,3,19,4,15
2021,446774,40,4,24,12,12
2021,446774,40,5,44,18,26
2021,446774,42,0,79,30,49
2021,446774,42,1,5,2,3
2021,446774,42,2,6,1,5
2021,446774,42,3,13,2,11
2021,446774,42,4,21,10,11
2021,446774,42,5,34,15,19
2021,446774,43,0,21,7,14
2021,446774,43,2,2,0,2
2021,446774,43,3,6,2,4
2021,446774,43,4,3,2,1
2021,446774,43,5,10,3,7
2021,447014,0,0,13,4,9
2021,447014,10,0,10,3,7
2021,447014,10,4,10,3,7
2021,447014,40,0,10,3,7
2021,447014,40,4,10,3,7
2021,447014,41,0,10,3,7
2021,447014,41,4,10,3,7
2021,447014,45,0,10,3,7
2021,447014,45,4,10,3,7
2021,447014,50,0,3,1,2
2021,447050,0,0,8,1,7
2021,447050,10,0,8,1,7
2021,447050,10,4,8,1,7
2021,447050,40,0,8,1,7
2021,447050,40,4,8,1,7
2021,447050,41,0,8,1,7
2021,447050,41,4,8,1,7
2021,447050,45,0,8,1,7
2021,447050,45,4,8,1,7
2021,447263,0,0,74,13,61
2021,447263,10,0,74,13,61
2021,447263,10,1,9,2,7
2021,447263,10,2,37,5,32
2021,447263,10,3,28,6,22
2021,447263,40,0,74,13,61
2021,447263,40,1,9,2,7
2021,447263,40,2,37,5,32
2021,447263,40,3,28,6,22
2021,447263,41,0,74,13,61
2021,447263,41,1,9,2,7
2021,447263,41,2,37,5,32
2021,447263,41,3,28,6,22
2021,447263,45,0,74,13,61
2021,447263,45,1,9,2,7
2021,447263,45,2,37,5,32
2021,447263,45,3,28,6,22
2021,447351,0,0,10,4,6
2021,447351,10,0,10,4,6
2021,447351,10,4,10,4,6
2021,447351,40,0,10,4,6
2021,447351,40,4,10,4,6
2021,447351,41,0,10,4,6
2021,447351,41,4,10,4,6
2021,447351,45,0,10,4,6
2021,447351,45,4,10,4,6
2021,447421,0,0,8,1,7
2021,447421,50,0,8,1,7
2021,447582,0,0,51,27,24
2021,447582,10,0,51,27,24
2021,447582,10,1,3,3,0
2021,447582,10,2,3,1,2
2021,447582,10,3,9,3,6
2021,447582,10,4,36,20,16
2021,447582,20,0,3,3,0
2021,447582,20,1,3,3,0
2021,447582,40,0,48,24,24
2021,447582,40,2,3,1,2
2021,447582,40,3,9,3,6
2021,447582,40,4,36,20,16
2021,447582,42,0,48,24,24
2021,447582,42,2,3,1,2
2021,447582,42,3,9,3,6
2021,447582,42,4,36,20,16
2021,447591,0,0,26,5,21
2021,447591,10,0,26,5,21
2021,447591,10,4,26,5,21
2021,447591,40,0,26,5,21
2021,447591,40,4,26,5,21
2021,447591,41,0,26,5,21
2021,447591,41,4,26,5,21
2021,447591,45,0,26,5,21
2021,447591,45,4,26,5,21
2021,447689,0,0,447,215,232
2021,447689,10,0,447,215,232
2021,447689,10,1,77,44,33
2021,447689,10,2,182,90,92
2021,447689,10,3,124,59,65
2021,447689,10,4,31,5,26
2021,447689,10,5,33,17,16
2021,447689,40,0,447,215,232
2021,447689,40,1,77,44,33
2021,447689,40,2,182,90,92
2021,447689,40,3,124,59,65
2021,447689,40,4,31,5,26
2021,447689,40,5,33,17,16
2021,447689,42,0,447,215,232
2021,447689,42,1,77,44,33
2021,447689,42,2,182,90,92
2021,447689,42,3,124,59,65
2021,447689,42,4,31,5,26
2021,447689,42,5,33,17,16
2021,447698,0,0,1,1,0
2021,447698,10,0,1,1,0
2021,447698,10,1,1,1,0
2021,447698,40,0,1,1,0
2021,447698,40,1,1,1,0
2021,447698,41,0,1,1,0
2021,447698,41,1,1,1,0
2021,447698,45,0,1,1,0
2021,447698,45,1,1,1,0
2021,447759,0,0,4,3,1
2021,447759,10,0,4,3,1
2021,447759,10,4,4,3,1
2021,447759,40,0,4,3,1
2021,447759,40,4,4,3,1
2021,447759,41,0,4,3,1
2021,447759,41,4,4,3,1
2021,447759,45,0,4,3,1
2021,447759,45,4,4,3,1
2021,447768,0,0,26,10,16
2021,447768,50,0,26,10,16
2021,447777,0,0,19,8,11
2021,447777,50,0,19,8,11
2021,447847,0,0,63,54,9
2021,447847,10,0,62,54,8
2021,447847,10,1,8,6,2
2021,447847,10,4,54,48,6
2021,447847,40,0,62,54,8
2021,447847,40,1,8,6,2
2021,447847,40,4,54,48,6
2021,447847,41,0,62,54,8
2021,447847,41,1,8,6,2
2021,447847,41,4,54,48,6
2021,447847,45,0,62,54,8
2021,447847,45,1,8,6,2
2021,447847,45,4,54,48,6
2021,447847,50,0,1,0,1
2021,447935,0,0,7,1,6
2021,447935,10,0,7,1,6
2021,447935,10,4,7,1,6
2021,447935,40,0,7,1,6
2021,447935,40,4,7,1,6
2021,447935,41,0,7,1,6
2021,447935,41,4,7,1,6
2021,447935,45,0,7,1,6
2021,447935,45,4,7,1,6
2021,447953,0,0,2,2,0
2021,447953,10,0,2,2,0
2021,447953,10,2,1,1,0
2021,447953,10,3,1,1,0
2021,447953,40,0,2,2,0
2021,447953,40,2,1,1,0
2021,447953,40,3,1,1,0
2021,447953,42,0,2,2,0
2021,447953,42,2,1,1,0
2021,447953,42,3,1,1,0
2021,448354,0,0,4,2,2
2021,448354,10,0,4,2,2
2021,448354,10,4,4,2,2
2021,448354,40,0,4,2,2
2021,448354,40,4,4,2,2
2021,448354,41,0,4,2,2
2021,448354,41,4,4,2,2
2021,448354,45,0,4,2,2
2021,448354,45,4,4,2,2
2021,448433,0,0,29,29,0
2021,448433,50,0,29,29,0
2021,448594,0,0,40,18,22
2021,448594,10,0,40,18,22
2021,448594,10,4,40,18,22
2021,448594,20,0,30,15,15
2021,448594,20,4,30,15,15
2021,448594,30,0,4,2,2
2021,448594,30,4,4,2,2
2021,448594,40,0,6,1,5
2021,448594,40,4,6,1,5
2021,448594,42,0,6,1,5
2021,448594,42,4,6,1,5
2021,448600,0,0,13,1,12
2021,448600,10,0,13,1,12
2021,448600,10,6,13,1,12
2021,448600,40,0,13,1,12
2021,448600,40,6,13,1,12
2021,448600,41,0,13,1,12
2021,448600,41,6,13,1,12
2021,448600,45,0,13,1,12
2021,448600,45,6,13,1,12
2021,448673,0,0,48,5,43
2021,448673,10,0,48,5,43
2021,448673,10,4,48,5,43
2021,448673,40,0,48,5,43
2021,448673,40,4,48,5,43
2021,448673,41,0,48,5,43
2021,448673,41,4,48,5,43
2021,448673,45,0,48,5,43
2021,448673,45,4,48,5,43
2021,448691,0,0,6,0,6
2021,448691,10,0,6,0,6
2021,448691,10,1,1,0,1
2021,448691,10,2,1,0,1
2021,448691,10,3,2,0,2
2021,448691,10,5,2,0,2
2021,448691,40,0,6,0,6
2021,448691,40,1,1,0,1
2021,448691,40,2,1,0,1
2021,448691,40,3,2,0,2
2021,448691,40,5,2,0,2
2021,448691,41,0,6,0,6
2021,448691,41,1,1,0,1
2021,448691,41,2,1,0,1
2021,448691,41,3,2,0,2
2021,448691,41,5,2,0,2
2021,448691,45,0,6,0,6
2021,448691,45,1,1,0,1
2021,448691,45,2,1,0,1
2021,448691,45,3,2,0,2
2021,448691,45,5,2,0,2
2021,448859,0,0,14,14,0
2021,448859,10,0,14,14,0
2021,448859,10,4,14,14,0
2021,448859,40,0,14,14,0
2021,448859,40,4,14,14,0
2021,448859,41,0,14,14,0
2021,448859,41,4,14,14,0
2021,448859,45,0,14,14,0
2021,448859,45,4,14,14,0
2021,449074,0,0,23,6,17
2021,449074,10,0,23,6,17
2021,449074,10,4,23,6,17
2021,449074,40,0,23,6,17
2021,449074,40,4,23,6,17
2021,449074,41,0,23,6,17
2021,449074,41,4,23,6,17
2021,449074,45,0,23,6,17
2021,449074,45,4,23,6,17
2021,449135,0,0,10,5,5
2021,449135,10,0,10,5,5
2021,449135,10,1,10,5,5
2021,449135,40,0,10,5,5
2021,449135,40,1,10,5,5
2021,449135,41,0,10,5,5
2021,449135,41,1,10,5,5
2021,449135,44,0,10,5,5
2021,449135,44,1,10,5,5
2021,449250,0,0,27,5,22
2021,449250,10,0,27,5,22
2021,449250,10,4,27,5,22
2021,449250,40,0,27,5,22
2021,449250,40,4,27,5,22
2021,449250,41,0,27,5,22
2021,449250,41,4,27,5,22
2021,449250,45,0,27,5,22
2021,449250,45,4,27,5,22
2021,449339,0,0,338,149,189
2021,449339,10,0,338,149,189
2021,449339,10,1,51,24,27
2021,449339,10,2,148,70,78
2021,449339,10,3,55,20,35
2021,449339,10,4,84,35,49
2021,449339,40,0,338,149,189
2021,449339,40,1,51,24,27
2021,449339,40,2,148,70,78
2021,449339,40,3,55,20,35
2021,449339,40,4,84,35,49
2021,449339,41,0,338,149,189
2021,449339,41,1,51,24,27
2021,449339,41,2,148,70,78
2021,449339,41,3,55,20,35
2021,449339,41,4,84,35,49
2021,449339,45,0,338,149,189
2021,449339,45,1,51,24,27
2021,449339,45,2,148,70,78
2021,449339,45,3,55,20,35
2021,449339,45,4,84,35,49
2021,449506,0,0,5,2,3
2021,449506,10,0,5,2,3
2021,449506,10,4,5,2,3
2021,449506,40,0,5,2,3
2021,449506,40,4,5,2,3
2021,449506,42,0,5,2,3
2021,449506,42,4,5,2,3
2021,449524,0,0,11,2,9
2021,449524,10,0,11,2,9
2021,449524,10,4,11,2,9
2021,449524,40,0,11,2,9
2021,449524,40,4,11,2,9
2021,449524,41,0,11,2,9
2021,449524,41,4,11,2,9
2021,449524,45,0,11,2,9
2021,449524,45,4,11,2,9
2021,449612,0,0,6,4,2
2021,449612,50,0,6,4,2
2021,449728,0,0,6,1,5
2021,449728,10,0,6,1,5
2021,449728,10,4,6,1,5
2021,449728,40,0,6,1,5
2021,449728,40,4,6,1,5
2021,449728,41,0,6,1,5
2021,449728,41,4,6,1,5
2021,449728,45,0,6,1,5
2021,449728,45,4,6,1,5
2021,449764,0,0,15,14,1
2021,449764,10,0,15,14,1
2021,449764,10,1,7,6,1
2021,449764,10,2,1,1,0
2021,449764,10,3,7,7,0
2021,449764,40,0,15,14,1
2021,449764,40,1,7,6,1
2021,449764,40,2,1,1,0
2021,449764,40,3,7,7,0
2021,449764,41,0,13,12,1
2021,449764,41,1,7,6,1
2021,449764,41,2,1,1,0
2021,449764,41,3,5,5,0
2021,449764,43,0,2,2,0
2021,449764,43,3,2,2,0
2021,449764,45,0,13,12,1
2021,449764,45,1,7,6,1
2021,449764,45,2,1,1,0
2021,449764,45,3,5,5,0
2021,449861,0,0,8,1,7
2021,449861,10,0,8,1,7
2021,449861,10,4,8,1,7
2021,449861,40,0,8,1,7
2021,449861,40,4,8,1,7
2021,449861,41,0,8,1,7
2021,449861,41,4,8,1,7
2021,449861,45,0,8,1,7
2021,449861,45,4,8,1,7
2021,449870,0,0,15,9,6
2021,449870,10,0,15,9,6
2021,449870,10,1,3,3,0
2021,449870,10,2,2,1,1
2021,449870,10,3,8,4,4
2021,449870,10,4,2,1,1
2021,449870,20,0,5,4,1
2021,449870,20,1,3,3,0
2021,449870,20,2,2,1,1
2021,449870,30,0,5,3,2
2021,449870,30,3,5,3,2
2021,449870,40,0,5,2,3
2021,449870,40,3,3,1,2
2021,449870,40,4,2,1,1
2021,449870,42,0,5,2,3
2021,449870,42,3,3,1,2
2021,449870,42,4,2,1,1
2021,449889,0,0,92,25,67
2021,449889,10,0,92,25,67
2021,449889,10,4,92,25,67
2021,449889,40,0,92,25,67
2021,449889,40,4,92,25,67
2021,449889,41,0,92,25,67
2021,449889,41,4,92,25,67
2021,449889,45,0,92,25,67
2021,449889,45,4,92,25,67
2021,449898,0,0,22,4,18
2021,449898,10,0,22,4,18
2021,449898,10,2,1,0,1
2021,449898,10,3,15,3,12
2021,449898,10,4,6,1,5
2021,449898,40,0,22,4,18
2021,449898,40,2,1,0,1
2021,449898,40,3,15,3,12
2021,449898,40,4,6,1,5
2021,449898,41,0,22,4,18
2021,449898,41,2,1,0,1
2021,449898,41,3,15,3,12
2021,449898,41,4,6,1,5
2021,449898,45,0,22,4,18
2021,449898,45,2,1,0,1
2021,449898,45,3,15,3,12
2021,449898,45,4,6,1,5
2021,449922,0,0,22,15,7
2021,449922,10,0,22,15,7
2021,449922,10,1,1,1,0
2021,449922,10,2,4,3,1
2021,449922,10,3,17,11,6
2021,449922,40,0,22,15,7
2021,449922,40,1,1,1,0
2021,449922,40,2,4,3,1
2021,449922,40,3,17,11,6
2021,449922,41,0,8,7,1
2021,449922,41,1,1,1,0
2021,449922,41,2,3,2,1
2021,449922,41,3,4,4,0
2021,449922,42,0,14,8,6
2021,449922,42,2,1,1,0
2021,449922,42,3,13,7,6
2021,449922,44,0,7,6,1
2021,449922,44,1,1,1,0
2021,449922,44,2,3,2,1
2021,449922,44,3,3,3,0
2021,449922,45,0,1,1,0
2021,449922,45,3,1,1,0
2021,450058,0,0,34,8,26
2021,450058,10,0,34,8,26
2021,450058,10,4,34,8,26
2021,450058,40,0,34,8,26
2021,450058,40,4,34,8,26
2021,450058,41,0,34,8,26
2021,450058,41,4,34,8,26
2021,450058,45,0,34,8,26
2021,450058,45,4,34,8,26
2021,450067,0,0,21,6,15
2021,450067,10,0,21,6,15
2021,450067,10,4,21,6,15
2021,450067,40,0,21,6,15
2021,450067,40,4,21,6,15
2021,450067,41,0,21,6,15
2021,450067,41,4,21,6,15
2021,450067,45,0,21,6,15
2021,450067,45,4,21,6,15
2021,450128,0,0,11,1,10
2021,450128,50,0,11,1,10
2021,450304,0,0,14,8,6
2021,450304,10,0,14,8,6
2021,450304,10,1,5,2,3
2021,450304,10,2,6,5,1
2021,450304,10,3,3,1,2
2021,450304,20,0,11,7,4
2021,450304,20,1,5,2,3
2021,450304,20,2,6,5,1
2021,450304,30,0,3,1,2
2021,450304,30,3,3,1,2
2021,450571,0,0,17,4,13
2021,450571,10,0,17,4,13
2021,450571,10,4,17,4,13
2021,450571,40,0,17,4,13
2021,450571,40,4,17,4,13
2021,450571,41,0,17,4,13
2021,450571,41,4,17,4,13
2021,450571,45,0,17,4,13
2021,450571,45,4,17,4,13
2021,450696,0,0,11,3,8
2021,450696,10,0,11,3,8
2021,450696,10,4,11,3,8
2021,450696,40,0,11,3,8
2021,450696,40,4,11,3,8
2021,450696,41,0,11,3,8
2021,450696,41,4,11,3,8
2021,450696,45,0,11,3,8
2021,450696,45,4,11,3,8
2021,450702,0,0,7,1,6
2021,450702,10,0,7,1,6
2021,450702,10,4,7,1,6
2021,450702,40,0,7,1,6
2021,450702,40,4,7,1,6
2021,450702,41,0,7,1,6
2021,450702,41,4,7,1,6
2021,450702,45,0,7,1,6
2021,450702,45,4,7,1,6
2021,450933,0,0,307,178,129
2021,450933,10,0,307,178,129
2021,450933,10,4,307,178,129
2021,450933,40,0,307,178,129
2021,450933,40,4,307,178,129
2021,450933,41,0,307,178,129
2021,450933,41,4,307,178,129
2021,450933,45,0,307,178,129
2021,450933,45,4,307,178,129
2021,451103,0,0,61,28,33
2021,451103,10,0,61,28,33
2021,451103,10,2,3,1,2
2021,451103,10,3,58,27,31
2021,451103,40,0,61,28,33
2021,451103,40,2,3,1,2
2021,451103,40,3,58,27,31
2021,451103,41,0,61,28,33
2021,451103,41,2,3,1,2
2021,451103,41,3,58,27,31
2021,451103,45,0,61,28,33
2021,451103,45,2,3,1,2
2021,451103,45,3,58,27,31
2021,451228,0,0,5,5,0
2021,451228,50,0,5,5,0
2021,451404,0,0,37,37,0
2021,451404,10,0,37,37,0
2021,451404,10,4,37,37,0
2021,451404,40,0,37,37,0
2021,451404,40,4,37,37,0
2021,451404,42,0,37,37,0
2021,451404,42,4,37,37,0
2021,451477,0,0,54,41,13
2021,451477,50,0,54,41,13
2021,451510,0,0,24,12,12
2021,451510,10,0,24,12,12
2021,451510,10,1,13,7,6
2021,451510,10,2,6,2,4
2021,451510,10,3,3,2,1
2021,451510,10,4,2,1,1
2021,451510,20,0,14,7,7
2021,451510,20,1,10,6,4
2021,451510,20,2,4,1,3
2021,451510,30,0,3,1,2
2021,451510,30,2,2,1,1
2021,451510,30,3,1,0,1
2021,451510,40,0,7,4,3
2021,451510,40,1,3,1,2
2021,451510,40,3,2,2,0
2021,451510,40,4,2,1,1
2021,451510,42,0,6,3,3
2021,451510,42,1,2,0,2
2021,451510,42,3,2,2,0
2021,451510,42,4,2,1,1
2021,451510,43,0,1,1,0
2021,451510,43,1,1,1,0
2021,451556,0,0,80,42,38
2021,451556,50,0,80,42,38
2021,451741,0,0,1,0,1
2021,451741,10,0,1,0,1
2021,451741,10,1,1,0,1
2021,451741,20,0,1,0,1
2021,451741,20,1,1,0,1
2021,451750,0,0,49,8,41
2021,451750,10,0,49,8,41
2021,451750,10,4,49,8,41
2021,451750,40,0,49,8,41
2021,451750,40,4,49,8,41
2021,451750,41,0,49,8,41
2021,451750,41,4,49,8,41
2021,451750,45,0,49,8,41
2021,451750,45,4,49,8,41
2021,451866,0,0,5,2,3
2021,451866,50,0,5,2,3
2021,451927,0,0,18,14,4
2021,451927,10,0,18,14,4
2021,451927,10,1,8,8,0
2021,451927,10,2,4,3,1
2021,451927,10,3,6,3,3
2021,451927,40,0,18,14,4
2021,451927,40,1,8,8,0
2021,451927,40,2,4,3,1
2021,451927,40,3,6,3,3
2021,451927,41,0,13,12,1
2021,451927,41,1,8,8,0
2021,451927,41,2,4,3,1
2021,451927,41,3,1,1,0
2021,451927,42,0,5,2,3
2021,451927,42,3,5,2,3
2021,451927,44,0,13,12,1
2021,451927,44,1,8,8,0
2021,451927,44,2,4,3,1
2021,451927,44,3,1,1,0
2021,452081,0,0,5,0,5
2021,452081,50,0,5,0,5
2021,452124,0,0,15,3,12
2021,452124,10,0,15,3,12
2021,452124,10,4,15,3,12
2021,452124,40,0,15,3,12
2021,452124,40,4,15,3,12
2021,452124,41,0,15,3,12
2021,452124,41,4,15,3,12
2021,452124,45,0,15,3,12
2021,452124,45,4,15,3,12
2021,452373,0,0,7,0,7
2021,452373,10,0,7,0,7
2021,452373,10,4,7,0,7
2021,452373,40,0,7,0,7
2021,452373,40,4,7,0,7
2021,452373,41,0,7,0,7
2021,452373,41,4,7,0,7
2021,452373,45,0,7,0,7
2021,452373,45,4,7,0,7
2021,452948,0,0,28,2,26
2021,452948,10,0,26,2,24
2021,452948,10,2,2,0,2
2021,452948,10,3,1,0,1
2021,452948,10,4,21,2,19
2021,452948,10,6,2,0,2
2021,452948,40,0,26,2,24
2021,452948,40,2,2,0,2
2021,452948,40,3,1,0,1
2021,452948,40,4,21,2,19
2021,452948,40,6,2,0,2
2021,452948,41,0,26,2,24
2021,452948,41,2,2,0,2
2021,452948,41,3,1,0,1
2021,452948,41,4,21,2,19
2021,452948,41,6,2,0,2
2021,452948,45,0,26,2,24
2021,452948,45,2,2,0,2
2021,452948,45,3,1,0,1
2021,452948,45,4,21,2,19
2021,452948,45,6,2,0,2
2021,452948,50,0,2,0,2
2021,454184,0,0,28,22,6
2021,454184,10,0,28,22,6
2021,454184,10,1,5,4,1
2021,454184,10,2,17,13,4
2021,454184,10,3,6,5,1
2021,454184,40,0,28,22,6
2021,454184,40,1,5,4,1
2021,454184,40,2,17,13,4
2021,454184,40,3,6,5,1
2021,454184,41,0,28,22,6
2021,454184,41,1,5,4,1
2021,454184,41,2,17,13,4
2021,454184,41,3,6,5,1
2021,454184,44,0,28,22,6
2021,454184,44,1,5,4,1
2021,454184,44,2,17,13,4
2021,454184,44,3,6,5,1
2021,454218,0,0,351,31,320
2021,454218,10,0,351,31,320
2021,454218,10,1,17,3,14
2021,454218,10,2,43,6,37
2021,454218,10,3,153,13,140
2021,454218,10,4,138,9,129
2021,454218,40,0,351,31,320
2021,454218,40,1,17,3,14
2021,454218,40,2,43,6,37
2021,454218,40,3,153,13,140
2021,454218,40,4,138,9,129
2021,454218,41,0,351,31,320
2021,454218,41,1,17,3,14
2021,454218,41,2,43,6,37
2021,454218,41,3,153,13,140
2021,454218,41,4,138,9,129
2021,454218,45,0,351,31,320
2021,454218,45,1,17,3,14
2021,454218,45,2,43,6,37
2021,454218,45,3,153,13,140
2021,454218,45,4,138,9,129
2021,454616,0,0,5,4,1
2021,454616,50,0,5,4,1
2021,454689,0,0,1,0,1
2021,454689,10,0,1,0,1
2021,454689,10,1,1,0,1
2021,454689,40,0,1,0,1
2021,454689,40,1,1,0,1
2021,454689,42,0,1,0,1
2021,454689,42,1,1,0,1
2021,454698,0,0,16,6,10
2021,454698,50,0,16,6,10
2021,454786,0,0,36,20,16
2021,454786,10,0,36,20,16
2021,454786,10,4,36,20,16
2021,454786,40,0,36,20,16
2021,454786,40,4,36,20,16
2021,454786,41,0,36,20,16
2021,454786,41,4,36,20,16
2021,454786,45,0,36,20,16
2021,454786,45,4,36,20,16
2021,454810,0,0,145,62,83
2021,454810,10,0,131,57,74
2021,454810,10,4,131,57,74
2021,454810,40,0,131,57,74
2021,454810,40,4,131,57,74
2021,454810,41,0,131,57,74
2021,454810,41,4,131,57,74
2021,454810,45,0,131,57,74
2021,454810,45,4,131,57,74
2021,454810,50,0,14,5,9
2021,454829,0,0,46,4,42
2021,454829,10,0,46,4,42
2021,454829,10,4,46,4,42
2021,454829,40,0,46,4,42
2021,454829,40,4,46,4,42
2021,454829,41,0,46,4,42
2021,454829,41,4,46,4,42
2021,454829,45,0,46,4,42
2021,454829,45,4,46,4,42
2021,454856,0,0,26,5,21
2021,454856,10,0,26,5,21
2021,454856,10,4,26,5,21
2021,454856,40,0,26,5,21
2021,454856,40,4,26,5,21
2021,454856,41,0,26,5,21
2021,454856,41,4,26,5,21
2021,454856,45,0,26,5,21
2021,454856,45,4,26,5,21
2021,454865,0,0,31,5,26
2021,454865,50,0,31,5,26
2021,455114,0,0,165,86,79
2021,455114,10,0,165,86,79
2021,455114,10,1,7,2,5
2021,455114,10,2,31,12,19
2021,455114,10,3,43,24,19
2021,455114,10,4,79,47,32
2021,455114,10,6,5,1,4
2021,455114,40,0,165,86,79
2021,455114,40,1,7,2,5
2021,455114,40,2,31,12,19
2021,455114,40,3,43,24,19
2021,455114,40,4,79,47,32
2021,455114,40,6,5,1,4
2021,455114,42,0,164,85,79
2021,455114,42,1,7,2,5
2021,455114,42,2,31,12,19
2021,455114,42,3,42,23,19
2021,455114,42,4,79,47,32
2021,455114,42,6,5,1,4
2021,455114,43,0,1,1,0
2021,455114,43,3,1,1,0
2021,455196,0,0,86,12,74
2021,455196,10,0,86,12,74
2021,455196,10,4,86,12,74
2021,455196,40,0,86,12,74
2021,455196,40,4,86,12,74
2021,455196,41,0,86,12,74
2021,455196,41,4,86,12,74
2021,455196,45,0,86,12,74
2021,455196,45,4,86,12,74
2021,455257,0,0,14,14,0
2021,455257,10,0,14,14,0
2021,455257,10,4,14,14,0
2021,455257,40,0,14,14,0
2021,455257,40,4,14,14,0
2021,455257,42,0,14,14,0
2021,455257,42,4,14,14,0
2021,455336,0,0,2,1,1
2021,455336,10,0,2,1,1
2021,455336,10,4,2,1,1
2021,455336,40,0,2,1,1
2021,455336,40,4,2,1,1
2021,455336,41,0,2,1,1
2021,455336,41,4,2,1,1
2021,455336,45,0,2,1,1
2021,455336,45,4,2,1,1
2021,455406,0,0,27,15,12
2021,455406,10,0,27,15,12
2021,455406,10,1,3,2,1
2021,455406,10,2,9,5,4
2021,455406,10,3,15,8,7
2021,455406,40,0,27,15,12
2021,455406,40,1,3,2,1
2021,455406,40,2,9,5,4
2021,455406,40,3,15,8,7
2021,455406,41,0,27,15,12
2021,455406,41,1,3,2,1
2021,455406,41,2,9,5,4
2021,455406,41,3,15,8,7
2021,455406,44,0,27,15,12
2021,455406,44,1,3,2,1
2021,455406,44,2,9,5,4
2021,455406,44,3,15,8,7
2021,455433,0,0,20,10,10
2021,455433,10,0,20,10,10
2021,455433,10,1,7,4,3
2021,455433,10,2,8,4,4
2021,455433,10,3,5,2,3
2021,455433,40,0,20,10,10
2021,455433,40,1,7,4,3
2021,455433,40,2,8,4,4
2021,455433,40,3,5,2,3
2021,455433,41,0,20,10,10
2021,455433,41,1,7,4,3
2021,455433,41,2,8,4,4
2021,455433,41,3,5,2,3
2021,455433,44,0,20,10,10
2021,455433,44,1,7,4,3
2021,455433,44,2,8,4,4
2021,455433,44,3,5,2,3
2021,455479,0,0,16,4,12
2021,455479,10,0,16,4,12
2021,455479,10,4,16,4,12
2021,455479,40,0,16,4,12
2021,455479,40,4,16,4,12
2021,455479,41,0,16,4,12
2021,455479,41,4,16,4,12
2021,455479,45,0,16,4,12
2021,455479,45,4,16,4,12
2021,455512,0,0,43,15,28
2021,455512,10,0,43,15,28
2021,455512,10,4,43,15,28
2021,455512,20,0,29,12,17
2021,455512,20,4,29,12,17
2021,455512,30,0,7,2,5
2021,455512,30,4,7,2,5
2021,455512,40,0,7,1,6
2021,455512,40,4,7,1,6
2021,455512,43,0,7,1,6
2021,455512,43,4,7,1,6
2021,455628,0,0,15,5,10
2021,455628,10,0,15,5,10
2021,455628,10,4,15,5,10
2021,455628,40,0,15,5,10
2021,455628,40,4,15,5,10
2021,455628,41,0,15,5,10
2021,455628,41,4,15,5,10
2021,455628,45,0,15,5,10
2021,455628,45,4,15,5,10
2021,455664,0,0,91,32,59
2021,455664,10,0,91,32,59
2021,455664,10,1,11,7,4
2021,455664,10,2,38,10,28
2021,455664,10,3,40,14,26
2021,455664,10,4,2,1,1
2021,455664,40,0,91,32,59
2021,455664,40,1,11,7,4
2021,455664,40,2,38,10,28
2021,455664,40,3,40,14,26
2021,455664,40,4,2,1,1
2021,455664,41,0,91,32,59
2021,455664,41,1,11,7,4
2021,455664,41,2,38,10,28
2021,455664,41,3,40,14,26
2021,455664,41,4,2,1,1
2021,455664,44,0,91,32,59
2021,455664,44,1,11,7,4
2021,455664,44,2,38,10,28
2021,455664,44,3,40,14,26
2021,455664,44,4,2,1,1
2021,455770,0,0,7,5,2
2021,455770,10,0,7,5,2
2021,455770,10,1,1,1,0
2021,455770,10,2,1,1,0
2021,455770,10,3,5,3,2
2021,455770,40,0,7,5,2
2021,455770,40,1,1,1,0
2021,455770,40,2,1,1,0
2021,455770,40,3,5,3,2
2021,455770,42,0,7,5,2
2021,455770,42,1,1,1,0
2021,455770,42,2,1,1,0
2021,455770,42,3,5,3,2
2021,455804,0,0,42,31,11
2021,455804,10,0,42,31,11
2021,455804,10,1,42,31,11
2021,455804,40,0,42,31,11
2021,455804,40,1,42,31,11
2021,455804,41,0,9,9,0
2021,455804,41,1,9,9,0
2021,455804,42,0,33,22,11
2021,455804,42,1,33,22,11
2021,455804,45,0,9,9,0
2021,455804,45,1,9,9,0
2021,455813,0,0,10,8,2
2021,455813,10,0,10,8,2
2021,455813,10,1,2,2,0
2021,455813,10,2,6,5,1
2021,455813,10,3,2,1,1
2021,455813,40,0,10,8,2
2021,455813,40,1,2,2,0
2021,455813,40,2,6,5,1
2021,455813,40,3,2,1,1
2021,455813,41,0,10,8,2
2021,455813,41,1,2,2,0
2021,455813,41,2,6,5,1
2021,455813,41,3,2,1,1
2021,455813,44,0,10,8,2
2021,455813,44,1,2,2,0
2021,455813,44,2,6,5,1
2021,455813,44,3,2,1,1
2021,455868,0,0,14,2,12
2021,455868,10,0,10,0,10
2021,455868,10,4,10,0,10
2021,455868,40,0,10,0,10
2021,455868,40,4,10,0,10
2021,455868,41,0,10,0,10
2021,455868,41,4,10,0,10
2021,455868,45,0,10,0,10
2021,455868,45,4,10,0,10
2021,455868,50,0,4,2,2
2021,455983,0,0,1,0,1
2021,455983,10,0,1,0,1
2021,455983,10,2,1,0,1
2021,455983,40,0,1,0,1
2021,455983,40,2,1,0,1
2021,455983,41,0,1,0,1
2021,455983,41,2,1,0,1
2021,455983,45,0,1,0,1
2021,455983,45,2,1,0,1
2021,455992,0,0,1,0,1
2021,455992,10,0,1,0,1
2021,455992,10,4,1,0,1
2021,455992,40,0,1,0,1
2021,455992,40,4,1,0,1
2021,455992,43,0,1,0,1
2021,455992,43,4,1,0,1
2021,456038,0,0,10,0,10
2021,456038,10,0,10,0,10
2021,456038,10,4,10,0,10
2021,456038,40,0,10,0,10
2021,456038,40,4,10,0,10
2021,456038,41,0,10,0,10
2021,456038,41,4,10,0,10
2021,456038,45,0,10,0,10
2021,456038,45,4,10,0,10
2021,456205,0,0,7,3,4
2021,456205,10,0,7,3,4
2021,456205,10,4,7,3,4
2021,456205,40,0,7,3,4
2021,456205,40,4,7,3,4
2021,456205,41,0,7,3,4
2021,456205,41,4,7,3,4
2021,456205,45,0,7,3,4
2021,456205,45,4,7,3,4
2021,456214,0,0,8,6,2
2021,456214,10,0,8,6,2
2021,456214,10,6,8,6,2
2021,456214,40,0,8,6,2
2021,456214,40,6,8,6,2
2021,456214,41,0,8,6,2
2021,456214,41,6,8,6,2
2021,456214,45,0,8,6,2
2021,456214,45,6,8,6,2
2021,456454,0,0,15,6,9
2021,456454,10,0,15,6,9
2021,456454,10,4,15,6,9
2021,456454,40,0,15,6,9
2021,456454,40,4,15,6,9
2021,456454,41,0,15,6,9
2021,456454,41,4,15,6,9
2021,456454,45,0,15,6,9
2021,456454,45,4,15,6,9
2021,456490,0,0,7,6,1
2021,456490,10,0,7,6,1
2021,456490,10,1,1,0,1
2021,456490,10,2,6,6,0
2021,456490,40,0,7,6,1
2021,456490,40,1,1,0,1
2021,456490,40,2,6,6,0
2021,456490,42,0,7,6,1
2021,456490,42,1,1,0,1
2021,456490,42,2,6,6,0
2021,456542,0,0,43,22,21
2021,456542,10,0,43,22,21
2021,456542,10,1,13,6,7
2021,456542,10,2,15,9,6
2021,456542,10,3,13,7,6
2021,456542,10,4,2,0,2
2021,456542,20,0,4,1,3
2021,456542,20,1,4,1,3
2021,456542,30,0,36,21,15
2021,456542,30,1,9,5,4
2021,456542,30,2,14,9,5
2021,456542,30,3,13,7,6
2021,456542,40,0,3,0,3
2021,456542,40,2,1,0,1
2021,456542,40,4,2,0,2
2021,456542,41,0,3,0,3
2021,456542,41,2,1,0,1
2021,456542,41,4,2,0,2
2021,456542,44,0,3,0,3
2021,456542,44,2,1,0,1
2021,456542,44,4,2,0,2
2021,456579,0,0,9,4,5
2021,456579,10,0,9,4,5
2021,456579,10,4,9,4,5
2021,456579,40,0,9,4,5
2021,456579,40,4,9,4,5
2021,456579,41,0,9,4,5
2021,456579,41,4,9,4,5
2021,456579,45,0,9,4,5
2021,456579,45,4,9,4,5
2021,456852,0,0,6,4,2
2021,456852,10,0,6,4,2
2021,456852,10,4,6,4,2
2021,456852,40,0,6,4,2
2021,456852,40,4,6,4,2
2021,456852,41,0,6,4,2
2021,456852,41,4,6,4,2
2021,456852,45,0,6,4,2
2021,456852,45,4,6,4,2
2021,456959,0,0,38,17,21
2021,456959,10,0,12,5,7
2021,456959,10,2,7,4,3
2021,456959,10,3,5,1,4
2021,456959,20,0,6,3,3
2021,456959,20,2,6,3,3
2021,456959,30,0,6,2,4
2021,456959,30,2,1,1,0
2021,456959,30,3,5,1,4
2021,456959,50,0,26,12,14
2021,457086,0,0,6,3,3
2021,457086,10,0,6,3,3
2021,457086,10,4,6,3,3
2021,457086,40,0,6,3,3
2021,457086,40,4,6,3,3
2021,457086,42,0,6,3,3
2021,457086,42,4,6,3,3
2021,457101,0,0,12,4,8
2021,457101,10,0,12,4,8
2021,457101,10,4,12,4,8
2021,457101,40,0,12,4,8
2021,457101,40,4,12,4,8
2021,457101,41,0,12,4,8
2021,457101,41,4,12,4,8
2021,457101,45,0,12,4,8
2021,457101,45,4,12,4,8
2021,457110,0,0,14,2,12
2021,457110,10,0,14,2,12
2021,457110,10,4,14,2,12
2021,457110,40,0,14,2,12
2021,457110,40,4,14,2,12
2021,457110,41,0,14,2,12
2021,457110,41,4,14,2,12
2021,457110,45,0,14,2,12
2021,457110,45,4,14,2,12
2021,457299,0,0,12,6,6
2021,457299,10,0,12,6,6
2021,457299,10,1,2,1,1
2021,457299,10,3,2,1,1
2021,457299,10,4,8,4,4
2021,457299,40,0,12,6,6
2021,457299,40,1,2,1,1
2021,457299,40,3,2,1,1
2021,457299,40,4,8,4,4
2021,457299,41,0,12,6,6
2021,457299,41,1,2,1,1
2021,457299,41,3,2,1,1
2021,457299,41,4,8,4,4
2021,457299,44,0,12,6,6
2021,457299,44,1,2,1,1
2021,457299,44,3,2,1,1
2021,457299,44,4,8,4,4
2021,457402,0,0,3,1,2
2021,457402,10,0,3,1,2
2021,457402,10,1,3,1,2
2021,457402,40,0,3,1,2
2021,457402,40,1,3,1,2
2021,457402,41,0,3,1,2
2021,457402,41,1,3,1,2
2021,457402,44,0,3,1,2
2021,457402,44,1,3,1,2
2021,457527,0,0,7,0,7
2021,457527,10,0,7,0,7
2021,457527,10,1,2,0,2
2021,457527,10,3,1,0,1
2021,457527,10,4,4,0,4
2021,457527,40,0,7,0,7
2021,457527,40,1,2,0,2
2021,457527,40,3,1,0,1
2021,457527,40,4,4,0,4
2021,457527,41,0,2,0,2
2021,457527,41,1,2,0,2
2021,457527,42,0,5,0,5
2021,457527,42,3,1,0,1
2021,457527,42,4,4,0,4
2021,457527,45,0,2,0,2
2021,457527,45,1,2,0,2
2021,457536,0,0,6,4,2
2021,457536,10,0,6,4,2
2021,457536,10,4,6,4,2
2021,457536,40,0,6,4,2
2021,457536,40,4,6,4,2
2021,457536,41,0,6,4,2
2021,457536,41,4,6,4,2
2021,457536,45,0,6,4,2
2021,457536,45,4,6,4,2
2021,458210,0,0,56,22,34
2021,458210,10,0,53,22,31
2021,458210,10,1,3,3,0
2021,458210,10,2,3,0,3
2021,458210,10,3,17,7,10
2021,458210,10,4,30,12,18
2021,458210,40,0,53,22,31
2021,458210,40,1,3,3,0
2021,458210,40,2,3,0,3
2021,458210,40,3,17,7,10
2021,458210,40,4,30,12,18
2021,458210,41,0,53,22,31
2021,458210,41,1,3,3,0
2021,458210,41,2,3,0,3
2021,458210,41,3,17,7,10
2021,458210,41,4,30,12,18
2021,458210,45,0,53,22,31
2021,458210,45,1,3,3,0
2021,458210,45,2,3,0,3
2021,458210,45,3,17,7,10
2021,458210,45,4,30,12,18
2021,458210,50,0,3,0,3
2021,458229,0,0,47,8,39
2021,458229,10,0,46,8,38
2021,458229,10,1,3,0,3
2021,458229,10,2,1,0,1
2021,458229,10,3,9,2,7
2021,458229,10,4,33,6,27
2021,458229,40,0,46,8,38
2021,458229,40,1,3,0,3
2021,458229,40,2,1,0,1
2021,458229,40,3,9,2,7
2021,458229,40,4,33,6,27
2021,458229,41,0,46,8,38
2021,458229,41,1,3,0,3
2021,458229,41,2,1,0,1
2021,458229,41,3,9,2,7
2021,458229,41,4,33,6,27
2021,458229,45,0,46,8,38
2021,458229,45,1,3,0,3
2021,458229,45,2,1,0,1
2021,458229,45,3,9,2,7
2021,458229,45,4,33,6,27
2021,458229,50,0,1,0,1
2021,458405,0,0,9,8,1
2021,458405,10,0,9,8,1
2021,458405,10,4,9,8,1
2021,458405,40,0,9,8,1
2021,458405,40,4,9,8,1
2021,458405,41,0,9,8,1
2021,458405,41,4,9,8,1
2021,458405,45,0,9,8,1
2021,458405,45,4,9,8,1
2021,458441,0,0,6,2,4
2021,458441,10,0,6,2,4
2021,458441,10,4,6,2,4
2021,458441,40,0,6,2,4
2021,458441,40,4,6,2,4
2021,458441,41,0,6,2,4
2021,458441,41,4,6,2,4
2021,458441,45,0,6,2,4
2021,458441,45,4,6,2,4
2021,458681,0,0,11,2,9
2021,458681,10,0,11,2,9
2021,458681,10,4,11,2,9
2021,458681,40,0,11,2,9
2021,458681,40,4,11,2,9
2021,458681,41,0,11,2,9
2021,458681,41,4,11,2,9
2021,458681,45,0,11,2,9
2021,458681,45,4,11,2,9
2021,458982,0,0,4,3,1
2021,458982,10,0,4,3,1
2021,458982,10,4,4,3,1
2021,458982,40,0,4,3,1
2021,458982,40,4,4,3,1
2021,458982,41,0,4,3,1
2021,458982,41,4,4,3,1
2021,458982,45,0,4,3,1
2021,458982,45,4,4,3,1
2021,459204,0,0,64,9,55
2021,459204,10,0,64,9,55
2021,459204,10,4,64,9,55
2021,459204,40,0,64,9,55
2021,459204,40,4,64,9,55
2021,459204,41,0,64,9,55
2021,459204,41,4,64,9,55
2021,459204,45,0,64,9,55
2021,459204,45,4,64,9,55
2021,459213,0,0,88,23,65
2021,459213,10,0,88,23,65
2021,459213,10,4,88,23,65
2021,459213,40,0,88,23,65
2021,459213,40,4,88,23,65
2021,459213,41,0,88,23,65
2021,459213,41,4,88,23,65
2021,459213,45,0,88,23,65
2021,459213,45,4,88,23,65
2021,459259,0,0,14,0,14
2021,459259,10,0,14,0,14
2021,459259,10,3,8,0,8
2021,459259,10,4,6,0,6
2021,459259,40,0,14,0,14
2021,459259,40,3,8,0,8
2021,459259,40,4,6,0,6
2021,459259,41,0,14,0,14
2021,459259,41,3,8,0,8
2021,459259,41,4,6,0,6
2021,459259,45,0,14,0,14
2021,459259,45,3,8,0,8
2021,459259,45,4,6,0,6
2021,459268,0,0,11,1,10
2021,459268,10,0,11,1,10
2021,459268,10,2,1,0,1
2021,459268,10,3,4,1,3
2021,459268,10,4,6,0,6
2021,459268,40,0,11,1,10
2021,459268,40,2,1,0,1
2021,459268,40,3,4,1,3
2021,459268,40,4,6,0,6
2021,459268,41,0,11,1,10
2021,459268,41,2,1,0,1
2021,459268,41,3,4,1,3
2021,459268,41,4,6,0,6
2021,459268,45,0,11,1,10
2021,459268,45,2,1,0,1
2021,459268,45,3,4,1,3
2021,459268,45,4,6,0,6
2021,459310,0,0,7,3,4
2021,459310,10,0,7,3,4
2021,459310,10,4,7,3,4
2021,459310,40,0,7,3,4
2021,459310,40,4,7,3,4
2021,459310,42,0,7,3,4
2021,459310,42,4,7,3,4
2021,459727,0,0,13,7,6
2021,459727,10,0,13,7,6
2021,459727,10,1,2,2,0
2021,459727,10,2,11,5,6
2021,459727,40,0,13,7,6
2021,459727,40,1,2,2,0
2021,459727,40,2,11,5,6
2021,459727,41,0,13,7,6
2021,459727,41,1,2,2,0
2021,459727,41,2,11,5,6
2021,459727,45,0,13,7,6
2021,459727,45,1,2,2,0
2021,459727,45,2,11,5,6
2021,459736,0,0,105,40,65
2021,459736,10,0,105,40,65
2021,459736,10,1,25,14,11
2021,459736,10,2,37,12,25
2021,459736,10,3,42,13,29
2021,459736,10,4,1,1,0
2021,459736,40,0,105,40,65
2021,459736,40,1,25,14,11
2021,459736,40,2,37,12,25
2021,459736,40,3,42,13,29
2021,459736,40,4,1,1,0
2021,459736,41,0,60,22,38
2021,459736,41,1,17,9,8
2021,459736,41,2,23,6,17
2021,459736,41,3,19,6,13
2021,459736,41,4,1,1,0
2021,459736,42,0,45,18,27
2021,459736,42,1,8,5,3
2021,459736,42,2,14,6,8
2021,459736,42,3,23,7,16
2021,459736,44,0,60,22,38
2021,459736,44,1,17,9,8
2021,459736,44,2,23,6,17
2021,459736,44,3,19,6,13
2021,459736,44,4,1,1,0
2021,459745,0,0,24,8,16
2021,459745,10,0,24,8,16
2021,459745,10,1,5,3,2
2021,459745,10,2,9,2,7
2021,459745,10,3,10,3,7
2021,459745,40,0,24,8,16
2021,459745,40,1,5,3,2
2021,459745,40,2,9,2,7
2021,459745,40,3,10,3,7
2021,459745,41,0,24,8,16
2021,459745,41,1,5,3,2
2021,459745,41,2,9,2,7
2021,459745,41,3,10,3,7
2021,459745,44,0,24,8,16
2021,459745,44,1,5,3,2
2021,459745,44,2,9,2,7
2021,459745,44,3,10,3,7
2021,459824,0,0,93,36,57
2021,459824,10,0,93,36,57
2021,459824,10,1,14,6,8
2021,459824,10,2,29,13,16
2021,459824,10,3,49,16,33
2021,459824,10,4,1,1,0
2021,459824,40,0,93,36,57
2021,459824,40,1,14,6,8
2021,459824,40,2,29,13,16
2021,459824,40,3,49,16,33
2021,459824,40,4,1,1,0
2021,459824,41,0,81,32,49
2021,459824,41,1,14,6,8
2021,459824,41,2,26,12,14
2021,459824,41,3,40,13,27
2021,459824,41,4,1,1,0
2021,459824,42,0,12,4,8
2021,459824,42,2,3,1,2
2021,459824,42,3,9,3,6
2021,459824,44,0,81,32,49
2021,459824,44,1,14,6,8
2021,459824,44,2,26,12,14
2021,459824,44,3,40,13,27
2021,459824,44,4,1,1,0
2021,459842,0,0,21,3,18
2021,459842,10,0,21,3,18
2021,459842,10,1,2,1,1
2021,459842,10,2,2,1,1
2021,459842,10,3,13,1,12
2021,459842,10,4,4,0,4
2021,459842,40,0,21,3,18
2021,459842,40,1,2,1,1
2021,459842,40,2,2,1,1
2021,459842,40,3,13,1,12
2021,459842,40,4,4,0,4
2021,459842,41,0,21,3,18
2021,459842,41,1,2,1,1
2021,459842,41,2,2,1,1
2021,459842,41,3,13,1,12
2021,459842,41,4,4,0,4
2021,459842,45,0,21,3,18
2021,459842,45,1,2,1,1
2021,459842,45,2,2,1,1
2021,459842,45,3,13,1,12
2021,459842,45,4,4,0,4
2021,459851,0,0,16,2,14
2021,459851,10,0,16,2,14
2021,459851,10,1,2,0,2
2021,459851,10,2,4,1,3
2021,459851,10,3,4,0,4
2021,459851,10,4,6,1,5
2021,459851,40,0,16,2,14
2021,459851,40,1,2,0,2
2021,459851,40,2,4,1,3
2021,459851,40,3,4,0,4
2021,459851,40,4,6,1,5
2021,459851,41,0,16,2,14
2021,459851,41,1,2,0,2
2021,459851,41,2,4,1,3
2021,459851,41,3,4,0,4
2021,459851,41,4,6,1,5
2021,459851,45,0,16,2,14
2021,459851,45,1,2,0,2
2021,459851,45,2,4,1,3
2021,459851,45,3,4,0,4
2021,459851,45,4,6,1,5
2021,459949,0,0,223,107,116
2021,459949,10,0,223,107,116
2021,459949,10,1,19,14,5
2021,459949,10,2,58,30,28
2021,459949,10,3,54,23,31
2021,459949,10,4,27,14,13
2021,459949,10,5,65,26,39
2021,459949,20,0,72,42,30
2021,459949,20,1,19,14,5
2021,459949,20,2,53,28,25
2021,459949,30,0,58,25,33
2021,459949,30,2,5,2,3
2021,459949,30,3,53,23,30
2021,459949,40,0,93,40,53
2021,459949,40,3,1,0,1
2021,459949,40,4,27,14,13
2021,459949,40,5,65,26,39
2021,459949,41,0,27,14,13
2021,459949,41,4,27,14,13
2021,459949,42,0,66,26,40
2021,459949,42,3,1,0,1
2021,459949,42,5,65,26,39
2021,459949,45,0,27,14,13
2021,459949,45,4,27,14,13
2021,459958,0,0,8,3,5
2021,459958,10,0,8,3,5
2021,459958,10,4,8,3,5
2021,459958,40,0,8,3,5
2021,459958,40,4,8,3,5
2021,459958,41,0,8,3,5
2021,459958,41,4,8,3,5
2021,459958,45,0,8,3,5
2021,459958,45,4,8,3,5
2021,460020,0,0,9,2,7
2021,460020,10,0,9,2,7
2021,460020,10,4,9,2,7
2021,460020,40,0,9,2,7
2021,460020,40,4,9,2,7
2021,460020,41,0,9,2,7
2021,460020,41,4,9,2,7
2021,460020,45,0,9,2,7
2021,460020,45,4,9,2,7
2021,460136,0,0,42,5,37
2021,460136,10,0,42,5,37
2021,460136,10,4,42,5,37
2021,460136,40,0,42,5,37
2021,460136,40,4,42,5,37
2021,460136,41,0,42,5,37
2021,460136,41,4,42,5,37
2021,460136,45,0,42,5,37
2021,460136,45,4,42,5,37
2021,460181,0,0,17,3,14
2021,460181,10,0,17,3,14
2021,460181,10,4,17,3,14
2021,460181,40,0,17,3,14
2021,460181,40,4,17,3,14
2021,460181,41,0,17,3,14
2021,460181,41,4,17,3,14
2021,460181,45,0,17,3,14
2021,460181,45,4,17,3,14
2021,460190,0,0,10,1,9
2021,460190,10,0,10,1,9
2021,460190,10,4,10,1,9
2021,460190,40,0,10,1,9
2021,460190,40,4,10,1,9
2021,460190,41,0,10,1,9
2021,460190,41,4,10,1,9
2021,460190,45,0,10,1,9
2021,460190,45,4,10,1,9
2021,460206,0,0,13,4,9
2021,460206,10,0,13,4,9
2021,460206,10,4,13,4,9
2021,460206,40,0,13,4,9
2021,460206,40,4,13,4,9
2021,460206,41,0,13,4,9
2021,460206,41,4,13,4,9
2021,460206,45,0,13,4,9
2021,460206,45,4,13,4,9
2021,460349,0,0,3,3,0
2021,460349,10,0,3,3,0
2021,460349,10,1,1,1,0
2021,460349,10,2,1,1,0
2021,460349,10,5,1,1,0
2021,460349,40,0,3,3,0
2021,460349,40,1,1,1,0
2021,460349,40,2,1,1,0
2021,460349,40,5,1,1,0
2021,460349,41,0,2,2,0
2021,460349,41,1,1,1,0
2021,460349,41,2,1,1,0
2021,460349,42,0,1,1,0
2021,460349,42,5,1,1,0
2021,460349,45,0,2,2,0
2021,460349,45,1,1,1,0
2021,460349,45,2,1,1,0
2021,460376,0,0,5,4,1
2021,460376,10,0,5,4,1
2021,460376,10,1,1,1,0
2021,460376,10,2,1,0,1
2021,460376,10,3,2,2,0
2021,460376,10,4,1,1,0
2021,460376,40,0,5,4,1
2021,460376,40,1,1,1,0
2021,460376,40,2,1,0,1
2021,460376,40,3,2,2,0
2021,460376,40,4,1,1,0
2021,460376,41,0,5,4,1
2021,460376,41,1,1,1,0
2021,460376,41,2,1,0,1
2021,460376,41,3,2,2,0
2021,460376,41,4,1,1,0
2021,460376,45,0,5,4,1
2021,460376,45,1,1,1,0
2021,460376,45,2,1,0,1
2021,460376,45,3,2,2,0
2021,460376,45,4,1,1,0
2021,460394,0,0,105,41,64
2021,460394,10,0,105,41,64
2021,460394,10,4,105,41,64
2021,460394,20,0,74,28,46
2021,460394,20,4,74,28,46
2021,460394,30,0,27,12,15
2021,460394,30,4,27,12,15
2021,460394,40,0,4,1,3
2021,460394,40,4,4,1,3
2021,460394,42,0,4,1,3
2021,460394,42,4,4,1,3
2021,460464,0,0,96,45,51
2021,460464,10,0,96,45,51
2021,460464,10,4,96,45,51
2021,460464,20,0,69,27,42
2021,460464,20,4,69,27,42
2021,460464,30,0,23,17,6
2021,460464,30,4,23,17,6
2021,460464,40,0,4,1,3
2021,460464,40,4,4,1,3
2021,460464,42,0,3,0,3
2021,460464,42,4,3,0,3
2021,460464,43,0,1,1,0
2021,460464,43,4,1,1,0
2021,460543,0,0,41,41,0
2021,460543,50,0,41,41,0
2021,460677,0,0,14,1,13
2021,460677,10,0,14,1,13
2021,460677,10,4,14,1,13
2021,460677,40,0,14,1,13
2021,460677,40,4,14,1,13
2021,460677,43,0,14,1,13
2021,460677,43,4,14,1,13
2021,460738,0,0,19,0,19
2021,460738,10,0,15,0,15
2021,460738,10,2,11,0,11
2021,460738,10,3,4,0,4
2021,460738,40,0,15,0,15
2021,460738,40,2,11,0,11
2021,460738,40,3,4,0,4
2021,460738,41,0,15,0,15
2021,460738,41,2,11,0,11
2021,460738,41,3,4,0,4
2021,460738,44,0,15,0,15
2021,460738,44,2,11,0,11
2021,460738,44,3,4,0,4
2021,460738,50,0,4,0,4
2021,460756,0,0,12,3,9
2021,460756,10,0,12,3,9
2021,460756,10,4,12,3,9
2021,460756,40,0,12,3,9
2021,460756,40,4,12,3,9
2021,460756,41,0,12,3,9
2021,460756,41,4,12,3,9
2021,460756,45,0,12,3,9
2021,460756,45,4,12,3,9
2021,460817,0,0,7,3,4
2021,460817,10,0,7,3,4
2021,460817,10,4,7,3,4
2021,460817,40,0,7,3,4
2021,460817,40,4,7,3,4
2021,460817,41,0,7,3,4
2021,460817,41,4,7,3,4
2021,460817,45,0,7,3,4
2021,460817,45,4,7,3,4
2021,460826,0,0,13,4,9
2021,460826,10,0,13,4,9
2021,460826,10,4,13,4,9
2021,460826,40,0,13,4,9
2021,460826,40,4,13,4,9
2021,460826,41,0,13,4,9
2021,460826,41,4,13,4,9
2021,460826,45,0,13,4,9
2021,460826,45,4,13,4,9
2021,460835,0,0,7,4,3
2021,460835,10,0,7,4,3
2021,460835,10,4,7,4,3
2021,460835,40,0,7,4,3
2021,460835,40,4,7,4,3
2021,460835,41,0,7,4,3
2021,460835,41,4,7,4,3
2021,460835,45,0,7,4,3
2021,460835,45,4,7,4,3
2021,461014,0,0,19,8,11
2021,461014,50,0,19,8,11
2021,461148,0,0,132,79,53
2021,461148,10,0,91,61,30
2021,461148,10,4,91,61,30
2021,461148,40,0,91,61,30
2021,461148,40,4,91,61,30
2021,461148,41,0,52,34,18
2021,461148,41,4,52,34,18
2021,461148,43,0,39,27,12
2021,461148,43,4,39,27,12
2021,461148,45,0,52,34,18
2021,461148,45,4,52,34,18
2021,461148,50,0,41,18,23
2021,461218,0,0,18,4,14
2021,461218,10,0,18,4,14
2021,461218,10,4,18,4,14
2021,461218,40,0,18,4,14
2021,461218,40,4,18,4,14
2021,461218,41,0,18,4,14
2021,461218,41,4,18,4,14
2021,461218,45,0,18,4,14
2021,461218,45,4,18,4,14
2021,461315,0,0,7,1,6
2021,461315,10,0,7,1,6
2021,461315,10,4,7,1,6
2021,461315,40,0,7,1,6
2021,461315,40,4,7,1,6
2021,461315,42,0,7,1,6
2021,461315,42,4,7,1,6
2021,461324,0,0,7,4,3
2021,461324,10,0,7,4,3
2021,461324,10,4,7,4,3
2021,461324,40,0,7,4,3
2021,461324,40,4,7,4,3
2021,461324,41,0,7,4,3
2021,461324,41,4,7,4,3
2021,461324,45,0,7,4,3
2021,461324,45,4,7,4,3
2021,461528,0,0,8,7,1
2021,461528,10,0,8,7,1
2021,461528,10,1,8,7,1
2021,461528,40,0,8,7,1
2021,461528,40,1,8,7,1
2021,461528,43,0,8,7,1
2021,461528,43,1,8,7,1
2021,461689,0,0,16,3,13
2021,461689,10,0,16,3,13
2021,461689,10,4,16,3,13
2021,461689,40,0,16,3,13
2021,461689,40,4,16,3,13
2021,461689,41,0,16,3,13
2021,461689,41,4,16,3,13
2021,461689,45,0,16,3,13
2021,461689,45,4,16,3,13
2021,461759,0,0,9,6,3
2021,461759,10,0,9,6,3
2021,461759,10,6,9,6,3
2021,461759,40,0,9,6,3
2021,461759,40,6,9,6,3
2021,461759,41,0,9,6,3
2021,461759,41,6,9,6,3
2021,461759,45,0,9,6,3
2021,461759,45,6,9,6,3
2021,461795,0,0,20,14,6
2021,461795,10,0,20,14,6
2021,461795,10,1,1,1,0
2021,461795,10,2,4,3,1
2021,461795,10,3,6,4,2
2021,461795,10,4,6,3,3
2021,461795,10,5,3,3,0
2021,461795,40,0,20,14,6
2021,461795,40,1,1,1,0
2021,461795,40,2,4,3,1
2021,461795,40,3,6,4,2
2021,461795,40,4,6,3,3
2021,461795,40,5,3,3,0
2021,461795,42,0,20,14,6
2021,461795,42,1,1,1,0
2021,461795,42,2,4,3,1
2021,461795,42,3,6,4,2
2021,461795,42,4,6,3,3
2021,461795,42,5,3,3,0
2021,462354,0,0,8,7,1
2021,462354,10,0,8,7,1
2021,462354,10,1,8,7,1
2021,462354,40,0,8,7,1
2021,462354,40,1,8,7,1
2021,462354,41,0,8,7,1
2021,462354,41,1,8,7,1
2021,462354,45,0,8,7,1
2021,462354,45,1,8,7,1
2021,464226,0,0,12,4,8
2021,464226,10,0,12,4,8
2021,464226,10,1,1,0,1
2021,464226,10,2,3,1,2
2021,464226,10,3,7,2,5
2021,464226,10,4,1,1,0
2021,464226,20,0,2,1,1
2021,464226,20,1,1,0,1
2021,464226,20,2,1,1,0
2021,464226,40,0,10,3,7
2021,464226,40,2,2,0,2
2021,464226,40,3,7,2,5
2021,464226,40,4,1,1,0
2021,464226,42,0,10,3,7
2021,464226,42,2,2,0,2
2021,464226,42,3,7,2,5
2021,464226,42,4,1,1,0
2021,469416,0,0,20,10,10
2021,469416,10,0,20,10,10
2021,469416,10,1,20,10,10
2021,469416,40,0,20,10,10
2021,469416,40,1,20,10,10
2021,469416,41,0,20,10,10
2021,469416,41,1,20,10,10
2021,469416,44,0,20,10,10
2021,469416,44,1,20,10,10
2021,469629,0,0,11,10,1
2021,469629,10,0,11,10,1
2021,469629,10,4,11,10,1
2021,469629,40,0,11,10,1
2021,469629,40,4,11,10,1
2021,469629,41,0,11,10,1
2021,469629,41,4,11,10,1
2021,469629,45,0,11,10,1
2021,469629,45,4,11,10,1
2021,474863,0,0,11,6,5
2021,474863,10,0,11,6,5
2021,474863,10,5,11,6,5
2021,474863,40,0,11,6,5
2021,474863,40,5,11,6,5
2021,474863,41,0,11,6,5
2021,474863,41,5,11,6,5
2021,474863,45,0,11,6,5
2021,474863,45,5,11,6,5
2021,475033,0,0,105,21,84
2021,475033,10,0,104,21,83
2021,475033,10,2,2,0,2
2021,475033,10,3,99,21,78
2021,475033,10,4,3,0,3
2021,475033,40,0,104,21,83
2021,475033,40,2,2,0,2
2021,475033,40,3,99,21,78
2021,475033,40,4,3,0,3
2021,475033,41,0,91,21,70
2021,475033,41,2,2,0,2
2021,475033,41,3,86,21,65
2021,475033,41,4,3,0,3
2021,475033,42,0,12,0,12
2021,475033,42,3,12,0,12
2021,475033,43,0,1,0,1
2021,475033,43,3,1,0,1
2021,475033,45,0,91,21,70
2021,475033,45,2,2,0,2
2021,475033,45,3,86,21,65
2021,475033,45,4,3,0,3
2021,475033,50,0,1,0,1
2021,475121,0,0,36,7,29
2021,475121,10,0,36,7,29
2021,475121,10,2,1,0,1
2021,475121,10,3,6,0,6
2021,475121,10,4,29,7,22
2021,475121,40,0,36,7,29
2021,475121,40,2,1,0,1
2021,475121,40,3,6,0,6
2021,475121,40,4,29,7,22
2021,475121,41,0,36,7,29
2021,475121,41,2,1,0,1
2021,475121,41,3,6,0,6
2021,475121,41,4,29,7,22
2021,475121,45,0,36,7,29
2021,475121,45,2,1,0,1
2021,475121,45,3,6,0,6
2021,475121,45,4,29,7,22
2021,475176,0,0,17,9,8
2021,475176,10,0,17,9,8
2021,475176,10,4,17,9,8
2021,475176,40,0,17,9,8
2021,475176,40,4,17,9,8
2021,475176,41,0,17,9,8
2021,475176,41,4,17,9,8
2021,475176,45,0,17,9,8
2021,475176,45,4,17,9,8
2021,475273,0,0,16,8,8
2021,475273,10,0,16,8,8
2021,475273,10,1,6,4,2
2021,475273,10,2,2,0,2
2021,475273,10,3,8,4,4
2021,475273,20,0,4,2,2
2021,475273,20,1,4,2,2
2021,475273,30,0,3,1,2
2021,475273,30,2,1,0,1
2021,475273,30,3,2,1,1
2021,475273,40,0,9,5,4
2021,475273,40,1,2,2,0
2021,475273,40,2,1,0,1
2021,475273,40,3,6,3,3
2021,475273,41,0,9,5,4
2021,475273,41,1,2,2,0
2021,475273,41,2,1,0,1
2021,475273,41,3,6,3,3
2021,475273,44,0,9,5,4
2021,475273,44,1,2,2,0
2021,475273,44,2,1,0,1
2021,475273,44,3,6,3,3
2021,475398,0,0,7,4,3
2021,475398,10,0,7,4,3
2021,475398,10,6,7,4,3
2021,475398,40,0,7,4,3
2021,475398,40,6,7,4,3
2021,475398,41,0,3,1,2
2021,475398,41,6,3,1,2
2021,475398,42,0,4,3,1
2021,475398,42,6,4,3,1
2021,475398,45,0,3,1,2
2021,475398,45,6,3,1,2
2021,475495,0,0,64,31,33
2021,475495,10,0,64,31,33
2021,475495,10,1,9,6,3
2021,475495,10,2,16,6,10
2021,475495,10,3,32,16,16
2021,475495,10,4,7,3,4
2021,475495,40,0,64,31,33
2021,475495,40,1,9,6,3
2021,475495,40,2,16,6,10
2021,475495,40,3,32,16,16
2021,475495,40,4,7,3,4
2021,475495,41,0,64,31,33
2021,475495,41,1,9,6,3
2021,475495,41,2,16,6,10
2021,475495,41,3,32,16,16
2021,475495,41,4,7,3,4
2021,475495,45,0,64,31,33
2021,475495,45,1,9,6,3
2021,475495,45,2,16,6,10
2021,475495,45,3,32,16,16
2021,475495,45,4,7,3,4
2021,475565,0,0,46,17,29
2021,475565,10,0,46,17,29
2021,475565,10,1,9,5,4
2021,475565,10,2,11,1,10
2021,475565,10,3,18,4,14
2021,475565,10,4,1,1,0
2021,475565,10,5,7,6,1
2021,475565,20,0,22,10,12
2021,475565,20,1,8,5,3
2021,475565,20,2,9,1,8
2021,475565,20,5,5,4,1
2021,475565,30,0,22,6,16
2021,475565,30,2,2,0,2
2021,475565,30,3,18,4,14
2021,475565,30,5,2,2,0
2021,475565,40,0,2,1,1
2021,475565,40,1,1,0,1
2021,475565,40,4,1,1,0
2021,475565,42,0,2,1,1
2021,475565,42,1,1,0,1
2021,475565,42,4,1,1,0
2021,475608,0,0,14,10,4
2021,475608,10,0,14,10,4
2021,475608,10,1,5,5,0
2021,475608,10,2,6,5,1
2021,475608,10,3,3,0,3
2021,475608,40,0,14,10,4
2021,475608,40,1,5,5,0
2021,475608,40,2,6,5,1
2021,475608,40,3,3,0,3
2021,475608,41,0,14,10,4
2021,475608,41,1,5,5,0
2021,475608,41,2,6,5,1
2021,475608,41,3,3,0,3
2021,475608,44,0,14,10,4
2021,475608,44,1,5,5,0
2021,475608,44,2,6,5,1
2021,475608,44,3,3,0,3
2021,475714,0,0,1,0,1
2021,475714,10,0,1,0,1
2021,475714,10,4,1,0,1
2021,475714,40,0,1,0,1
2021,475714,40,4,1,0,1
2021,475714,41,0,1,0,1
2021,475714,41,4,1,0,1
2021,475714,45,0,1,0,1
2021,475714,45,4,1,0,1
2021,476601,0,0,8,8,0
2021,476601,10,0,8,8,0
2021,476601,10,1,8,8,0
2021,476601,40,0,8,8,0
2021,476601,40,1,8,8,0
2021,476601,41,0,8,8,0
2021,476601,41,1,8,8,0
2021,476601,45,0,8,8,0
2021,476601,45,1,8,8,0
2021,476683,0,0,12,0,12
2021,476683,50,0,12,0,12
2021,476717,0,0,28,28,0
2021,476717,10,0,28,28,0
2021,476717,10,4,28,28,0
2021,476717,40,0,28,28,0
2021,476717,40,4,28,28,0
2021,476717,42,0,28,28,0
2021,476717,42,4,28,28,0
2021,476726,0,0,23,10,13
2021,476726,10,0,23,10,13
2021,476726,10,1,3,1,2
2021,476726,10,4,20,9,11
2021,476726,40,0,23,10,13
2021,476726,40,1,3,1,2
2021,476726,40,4,20,9,11
2021,476726,41,0,23,10,13
2021,476726,41,1,3,1,2
2021,476726,41,4,20,9,11
2021,476726,45,0,23,10,13
2021,476726,45,1,3,1,2
2021,476726,45,4,20,9,11
2021,476939,0,0,28,6,22
2021,476939,10,0,26,5,21
2021,476939,10,4,26,5,21
2021,476939,40,0,26,5,21
2021,476939,40,4,26,5,21
2021,476939,41,0,26,5,21
2021,476939,41,4,26,5,21
2021,476939,45,0,26,5,21
2021,476939,45,4,26,5,21
2021,476939,50,0,2,1,1
2021,476975,0,0,37,17,20
2021,476975,10,0,37,17,20
2021,476975,10,6,37,17,20
2021,476975,40,0,37,17,20
2021,476975,40,6,37,17,20
2021,476975,41,0,37,17,20
2021,476975,41,6,37,17,20
2021,476975,45,0,37,17,20
2021,476975,45,6,37,17,20
2021,477039,0,0,36,4,32
2021,477039,10,0,35,4,31
2021,477039,10,2,1,1,0
2021,477039,10,3,4,0,4
2021,477039,10,4,30,3,27
2021,477039,40,0,35,4,31
2021,477039,40,2,1,1,0
2021,477039,40,3,4,0,4
2021,477039,40,4,30,3,27
2021,477039,41,0,35,4,31
2021,477039,41,2,1,1,0
2021,477039,41,3,4,0,4
2021,477039,41,4,30,3,27
2021,477039,45,0,35,4,31
2021,477039,45,2,1,1,0
2021,477039,45,3,4,0,4
2021,477039,45,4,30,3,27
2021,477039,50,0,1,0,1
2021,480073,0,0,10,3,7
2021,480073,10,0,10,3,7
2021,480073,10,3,4,1,3
2021,480073,10,4,6,2,4
2021,480073,40,0,10,3,7
2021,480073,40,3,4,1,3
2021,480073,40,4,6,2,4
2021,480073,41,0,10,3,7
2021,480073,41,3,4,1,3
2021,480073,41,4,6,2,4
2021,480073,45,0,10,3,7
2021,480073,45,3,4,1,3
2021,480073,45,4,6,2,4
2021,480091,0,0,51,7,44
2021,480091,10,0,51,7,44
2021,480091,10,4,51,7,44
2021,480091,40,0,51,7,44
2021,480091,40,4,51,7,44
2021,480091,41,0,51,7,44
2021,480091,41,4,51,7,44
2021,480091,45,0,51,7,44
2021,480091,45,4,51,7,44
2021,480204,0,0,13,3,10
2021,480204,10,0,13,3,10
2021,480204,10,4,13,3,10
2021,480204,40,0,13,3,10
2021,480204,40,4,13,3,10
2021,480204,41,0,13,3,10
2021,480204,41,4,13,3,10
2021,480204,45,0,13,3,10
2021,480204,45,4,13,3,10
2021,480657,0,0,16,1,15
2021,480657,10,0,16,1,15
2021,480657,10,4,16,1,15
2021,480657,40,0,16,1,15
2021,480657,40,4,16,1,15
2021,480657,41,0,16,1,15
2021,480657,41,4,16,1,15
2021,480657,45,0,16,1,15
2021,480657,45,4,16,1,15
2021,480790,0,0,73,42,31
2021,480790,10,0,73,42,31
2021,480790,10,1,14,10,4
2021,480790,10,2,29,15,14
2021,480790,10,3,27,15,12
2021,480790,10,4,3,2,1
2021,480790,40,0,73,42,31
2021,480790,40,1,14,10,4
2021,480790,40,2,29,15,14
2021,480790,40,3,27,15,12
2021,480790,40,4,3,2,1
2021,480790,41,0,61,35,26
2021,480790,41,1,9,6,3
2021,480790,41,2,28,15,13
2021,480790,41,3,23,13,10
2021,480790,41,4,1,1,0
2021,480790,42,0,12,7,5
2021,480790,42,1,5,4,1
2021,480790,42,2,1,0,1
2021,480790,42,3,4,2,2
2021,480790,42,4,2,1,1
2021,480790,44,0,61,35,26
2021,480790,44,1,9,6,3
2021,480790,44,2,28,15,13
2021,480790,44,3,23,13,10
2021,480790,44,4,1,1,0
2021,480824,0,0,12,1,11
2021,480824,10,0,12,1,11
2021,480824,10,4,12,1,11
2021,480824,40,0,12,1,11
2021,480824,40,4,12,1,11
2021,480824,41,0,12,1,11
2021,480824,41,4,12,1,11
2021,480824,45,0,12,1,11
2021,480824,45,4,12,1,11
2021,480833,0,0,29,5,24
2021,480833,10,0,29,5,24
2021,480833,10,4,29,5,24
2021,480833,40,0,29,5,24
2021,480833,40,4,29,5,24
2021,480833,41,0,29,5,24
2021,480833,41,4,29,5,24
2021,480833,45,0,29,5,24
2021,480833,45,4,29,5,24
2021,480967,0,0,12,6,6
2021,480967,10,0,12,6,6
2021,480967,10,4,12,6,6
2021,480967,40,0,12,6,6
2021,480967,40,4,12,6,6
2021,480967,41,0,12,6,6
2021,480967,41,4,12,6,6
2021,480967,45,0,12,6,6
2021,480967,45,4,12,6,6
2021,481030,0,0,4,2,2
2021,481030,10,0,4,2,2
2021,481030,10,1,2,1,1
2021,481030,10,3,1,0,1
2021,481030,10,4,1,1,0
2021,481030,40,0,4,2,2
2021,481030,40,1,2,1,1
2021,481030,40,3,1,0,1
2021,481030,40,4,1,1,0
2021,481030,42,0,3,2,1
2021,481030,42,1,2,1,1
2021,481030,42,4,1,1,0
2021,481030,43,0,1,0,1
2021,481030,43,3,1,0,1
2021,481094,0,0,2,1,1
2021,481094,10,0,2,1,1
2021,481094,10,6,2,1,1
2021,481094,40,0,2,1,1
2021,481094,40,6,2,1,1
2021,481094,41,0,2,1,1
2021,481094,41,6,2,1,1
2021,481094,44,0,2,1,1
2021,481094,44,6,2,1,1
2021,481155,0,0,11,3,8
2021,481155,10,0,11,3,8
2021,481155,10,4,11,3,8
2021,481155,40,0,11,3,8
2021,481155,40,4,11,3,8
2021,481155,41,0,11,3,8
2021,481155,41,4,11,3,8
2021,481155,44,0,11,3,8
2021,481155,44,4,11,3,8
2021,481225,0,0,3,3,0
2021,481225,10,0,3,3,0
2021,481225,10,6,3,3,0
2021,481225,40,0,3,3,0
2021,481225,40,6,3,3,0
2021,481225,42,0,3,3,0
2021,481225,42,6,3,3,0
2021,481401,0,0,6,6,0
2021,481401,10,0,6,6,0
2021,481401,10,1,4,4,0
2021,481401,10,2,1,1,0
2021,481401,10,3,1,1,0
2021,481401,40,0,6,6,0
2021,481401,40,1,4,4,0
2021,481401,40,2,1,1,0
2021,481401,40,3,1,1,0
2021,481401,41,0,6,6,0
2021,481401,41,1,4,4,0
2021,481401,41,2,1,1,0
2021,481401,41,3,1,1,0
2021,481401,45,0,6,6,0
2021,481401,45,1,4,4,0
2021,481401,45,2,1,1,0
2021,481401,45,3,1,1,0
2021,481535,0,0,38,28,10
2021,481535,10,0,38,28,10
2021,481535,10,1,23,18,5
2021,481535,10,2,4,4,0
2021,481535,10,3,11,6,5
2021,481535,40,0,38,28,10
2021,481535,40,1,23,18,5
2021,481535,40,2,4,4,0
2021,481535,40,3,11,6,5
2021,481535,41,0,38,28,10
2021,481535,41,1,23,18,5
2021,481535,41,2,4,4,0
2021,481535,41,3,11,6,5
2021,481535,45,0,38,28,10
2021,481535,45,1,23,18,5
2021,481535,45,2,4,4,0
2021,481535,45,3,11,6,5
2021,481775,0,0,4,3,1
2021,481775,10,0,4,3,1
2021,481775,10,4,4,3,1
2021,481775,40,0,4,3,1
2021,481775,40,4,4,3,1
2021,481775,41,0,4,3,1
2021,481775,41,4,4,3,1
2021,481775,45,0,4,3,1
2021,481775,45,4,4,3,1
2021,482149,0,0,999,533,466
2021,482149,10,0,946,515,431
2021,482149,10,1,215,152,63
2021,482149,10,2,258,141,117
2021,482149,10,3,387,183,204
2021,482149,10,4,30,15,15
2021,482149,10,5,55,23,32
2021,482149,10,6,1,1,0
2021,482149,20,0,187,112,75
2021,482149,20,1,98,66,32
2021,482149,20,2,82,43,39
2021,482149,20,3,7,3,4
2021,482149,30,0,77,37,40
2021,482149,30,1,2,2,0
2021,482149,30,2,3,1,2
2021,482149,30,3,72,34,38
2021,482149,40,0,682,366,316
2021,482149,40,1,115,84,31
2021,482149,40,2,173,97,76
2021,482149,40,3,308,146,162
2021,482149,40,4,30,15,15
2021,482149,40,5,55,23,32
2021,482149,40,6,1,1,0
2021,482149,42,0,682,366,316
2021,482149,42,1,115,84,31
2021,482149,42,2,173,97,76
2021,482149,42,3,308,146,162
2021,482149,42,4,30,15,15
2021,482149,42,5,55,23,32
2021,482149,42,6,1,1,0
2021,482149,50,0,53,18,35
2021,482158,0,0,270,134,136
2021,482158,10,0,269,133,136
2021,482158,10,1,52,30,22
2021,482158,10,2,66,32,34
2021,482158,10,3,100,42,58
2021,482158,10,4,5,2,3
2021,482158,10,5,46,27,19
2021,482158,20,0,126,65,61
2021,482158,20,1,52,30,22
2021,482158,20,2,64,30,34
2021,482158,20,3,10,5,5
2021,482158,30,0,92,39,53
2021,482158,30,2,2,2,0
2021,482158,30,3,90,37,53
2021,482158,40,0,51,29,22
2021,482158,40,4,5,2,3
2021,482158,40,5,46,27,19
2021,482158,42,0,51,29,22
2021,482158,42,4,5,2,3
2021,482158,42,5,46,27,19
2021,482158,50,0,1,1,0
2021,482413,0,0,11,10,1
2021,482413,10,0,11,10,1
2021,482413,10,1,10,9,1
2021,482413,10,2,1,1,0
2021,482413,40,0,11,10,1
2021,482413,40,1,10,9,1
2021,482413,40,2,1,1,0
2021,482413,41,0,11,10,1
2021,482413,41,1,10,9,1
2021,482413,41,2,1,1,0
2021,482413,45,0,11,10,1
2021,482413,45,1,10,9,1
2021,482413,45,2,1,1,0
2021,482422,0,0,8,4,4
2021,482422,10,0,8,4,4
2021,482422,10,1,6,4,2
2021,482422,10,2,2,0,2
2021,482422,40,0,8,4,4
2021,482422,40,1,6,4,2
2021,482422,40,2,2,0,2
2021,482422,41,0,8,4,4
2021,482422,41,1,6,4,2
2021,482422,41,2,2,0,2
2021,482422,45,0,8,4,4
2021,482422,45,1,6,4,2
2021,482422,45,2,2,0,2
2021,482431,0,0,26,22,4
2021,482431,10,0,26,22,4
2021,482431,10,1,22,19,3
2021,482431,10,2,4,3,1
2021,482431,40,0,26,22,4
2021,482431,40,1,22,19,3
2021,482431,40,2,4,3,1
2021,482431,41,0,26,22,4
2021,482431,41,1,22,19,3
2021,482431,41,2,4,3,1
2021,482431,45,0,26,22,4
2021,482431,45,1,22,19,3
2021,482431,45,2,4,3,1
2021,482459,0,0,6,5,1
2021,482459,10,0,6,5,1
2021,482459,10,1,6,5,1
2021,482459,40,0,6,5,1
2021,482459,40,1,6,5,1
2021,482459,41,0,6,5,1
2021,482459,41,1,6,5,1
2021,482459,45,0,6,5,1
2021,482459,45,1,6,5,1
2021,482468,0,0,7,5,2
2021,482468,10,0,7,5,2
2021,482468,10,1,6,4,2
2021,482468,10,2,1,1,0
2021,482468,40,0,7,5,2
2021,482468,40,1,6,4,2
2021,482468,40,2,1,1,0
2021,482468,41,0,7,5,2
2021,482468,41,1,6,4,2
2021,482468,41,2,1,1,0
2021,482468,45,0,7,5,2
2021,482468,45,1,6,4,2
2021,482468,45,2,1,1,0
2021,482477,0,0,56,37,19
2021,482477,10,0,56,37,19
2021,482477,10,1,39,26,13
2021,482477,10,2,12,7,5
2021,482477,10,3,5,4,1
2021,482477,40,0,56,37,19
2021,482477,40,1,39,26,13
2021,482477,40,2,12,7,5
2021,482477,40,3,5,4,1
2021,482477,41,0,56,37,19
2021,482477,41,1,39,26,13
2021,482477,41,2,12,7,5
2021,482477,41,3,5,4,1
2021,482477,45,0,56,37,19
2021,482477,45,1,39,26,13
2021,482477,45,2,12,7,5
2021,482477,45,3,5,4,1
2021,482556,0,0,7,4,3
2021,482556,10,0,7,4,3
2021,482556,10,1,7,4,3
2021,482556,40,0,7,4,3
2021,482556,40,1,7,4,3
2021,482556,41,0,7,4,3
2021,482556,41,1,7,4,3
2021,482556,45,0,7,4,3
2021,482556,45,1,7,4,3
2021,482574,0,0,8,6,2
2021,482574,10,0,8,6,2
2021,482574,10,1,8,6,2
2021,482574,40,0,8,6,2
2021,482574,40,1,8,6,2
2021,482574,41,0,8,6,2
2021,482574,41,1,8,6,2
2021,482574,45,0,8,6,2
2021,482574,45,1,8,6,2
2021,482608,0,0,3,2,1
2021,482608,10,0,3,2,1
2021,482608,10,1,3,2,1
2021,482608,40,0,3,2,1
2021,482608,40,1,3,2,1
2021,482608,41,0,3,2,1
2021,482608,41,1,3,2,1
2021,482608,45,0,3,2,1
2021,482608,45,1,3,2,1
2021,482635,0,0,15,10,5
2021,482635,10,0,15,10,5
2021,482635,10,1,9,6,3
2021,482635,10,2,6,4,2
2021,482635,40,0,15,10,5
2021,482635,40,1,9,6,3
2021,482635,40,2,6,4,2
2021,482635,41,0,15,10,5
2021,482635,41,1,9,6,3
2021,482635,41,2,6,4,2
2021,482635,45,0,15,10,5
2021,482635,45,1,9,6,3
2021,482635,45,2,6,4,2
2021,482653,0,0,3,2,1
2021,482653,10,0,3,2,1
2021,482653,10,1,3,2,1
2021,482653,40,0,3,2,1
2021,482653,40,1,3,2,1
2021,482653,41,0,3,2,1
2021,482653,41,1,3,2,1
2021,482653,45,0,3,2,1
2021,482653,45,1,3,2,1
2021,482680,0,0,718,364,354
2021,482680,10,0,718,364,354
2021,482680,10,1,134,81,53
2021,482680,10,2,175,101,74
2021,482680,10,3,176,85,91
2021,482680,10,5,204,85,119
2021,482680,10,6,29,12,17
2021,482680,20,0,310,182,128
2021,482680,20,1,133,80,53
2021,482680,20,2,164,94,70
2021,482680,20,3,13,8,5
2021,482680,30,0,166,82,84
2021,482680,30,2,11,7,4
2021,482680,30,3,155,75,80
2021,482680,40,0,242,100,142
2021,482680,40,1,1,1,0
2021,482680,40,3,8,2,6
2021,482680,40,5,204,85,119
2021,482680,40,6,29,12,17
2021,482680,42,0,242,100,142
2021,482680,42,1,1,1,0
2021,482680,42,3,8,2,6
2021,482680,42,5,204,85,119
2021,482680,42,6,29,12,17
2021,482699,0,0,62,29,33
2021,482699,10,0,62,29,33
2021,482699,10,1,11,5,6
2021,482699,10,2,20,9,11
2021,482699,10,3,19,7,12
2021,482699,10,4,2,2,0
2021,482699,10,5,10,6,4
2021,482699,20,0,31,13,18
2021,482699,20,1,11,5,6
2021,482699,20,2,19,8,11
2021,482699,20,3,1,0,1
2021,482699,30,0,21,10,11
2021,482699,30,2,1,1,0
2021,482699,30,3,18,7,11
2021,482699,30,4,2,2,0
2021,482699,40,0,10,6,4
2021,482699,40,5,10,6,4
2021,482699,42,0,10,6,4
2021,482699,42,5,10,6,4
2021,482705,0,0,86,37,49
2021,482705,10,0,86,37,49
2021,482705,10,1,11,3,8
2021,482705,10,2,34,14,20
2021,482705,10,3,27,12,15
2021,482705,10,4,13,8,5
2021,482705,10,6,1,0,1
2021,482705,40,0,86,37,49
2021,482705,40,1,11,3,8
2021,482705,40,2,34,14,20
2021,482705,40,3,27,12,15
2021,482705,40,4,13,8,5
2021,482705,40,6,1,0,1
2021,482705,41,0,6,3,3
2021,482705,41,1,1,0,1
2021,482705,41,2,2,2,0
2021,482705,41,4,2,1,1
2021,482705,41,6,1,0,1
2021,482705,42,0,80,34,46
2021,482705,42,1,10,3,7
2021,482705,42,2,32,12,20
2021,482705,42,3,27,12,15
2021,482705,42,4,11,7,4
2021,482705,44,0,6,3,3
2021,482705,44,1,1,0,1
2021,482705,44,2,2,2,0
2021,482705,44,4,2,1,1
2021,482705,44,6,1,0,1
2021,482936,0,0,72,56,16
2021,482936,10,0,72,56,16
2021,482936,10,1,6,4,2
2021,482936,10,2,10,9,1
2021,482936,10,3,45,36,9
2021,482936,10,4,11,7,4
2021,482936,40,0,72,56,16
2021,482936,40,1,6,4,2
2021,482936,40,2,10,9,1
2021,482936,40,3,45,36,9
2021,482936,40,4,11,7,4
2021,482936,41,0,70,54,16
2021,482936,41,1,6,4,2
2021,482936,41,2,10,9,1
2021,482936,41,3,43,34,9
2021,482936,41,4,11,7,4
2021,482936,43,0,2,2,0
2021,482936,43,3,2,2,0
2021,482936,44,0,59,47,12
2021,482936,44,1,6,4,2
2021,482936,44,2,10,9,1
2021,482936,44,3,43,34,9
2021,482936,45,0,11,7,4
2021,482936,45,4,11,7,4
2021,482990,0,0,6,1,5
2021,482990,50,0,6,1,5
2021,483018,0,0,18,9,9
2021,483018,10,0,18,9,9
2021,483018,10,2,11,7,4
2021,483018,10,3,7,2,5
2021,483018,20,0,7,5,2
2021,483018,20,2,7,5,2
2021,483018,30,0,11,4,7
2021,483018,30,2,4,2,2
2021,483018,30,3,7,2,5
2021,483036,0,0,88,40,48
2021,483036,10,0,88,40,48
2021,483036,10,1,4,4,0
2021,483036,10,2,39,14,25
2021,483036,10,3,34,17,17
2021,483036,10,4,1,0,1
2021,483036,10,5,10,5,5
2021,483036,20,0,21,12,9
2021,483036,20,1,4,4,0
2021,483036,20,2,17,8,9
2021,483036,30,0,44,20,24
2021,483036,30,2,15,5,10
2021,483036,30,3,26,14,12
2021,483036,30,4,1,0,1
2021,483036,30,5,2,1,1
2021,483036,40,0,23,8,15
2021,483036,40,2,7,1,6
2021,483036,40,3,8,3,5
2021,483036,40,5,8,4,4
2021,483036,42,0,9,1,8
2021,483036,42,2,5,0,5
2021,483036,42,3,2,0,2
2021,483036,42,5,2,1,1
2021,483036,43,0,14,7,7
2021,483036,43,2,2,1,1
2021,483036,43,3,6,3,3
2021,483036,43,5,6,3,3
2021,483045,0,0,249,117,132
2021,483045,10,0,249,117,132
2021,483045,10,6,249,117,132
2021,483045,40,0,249,117,132
2021,483045,40,6,249,117,132
2021,483045,41,0,25,13,12
2021,483045,41,6,25,13,12
2021,483045,42,0,224,104,120
2021,483045,42,6,224,104,120
2021,483045,45,0,25,13,12
2021,483045,45,6,25,13,12
2021,483124,0,0,1107,500,607
2021,483124,10,0,1107,500,607
2021,483124,10,1,191,119,72
2021,483124,10,2,232,105,127
2021,483124,10,3,182,71,111
2021,483124,10,4,191,69,122
2021,483124,10,5,310,136,174
2021,483124,10,6,1,0,1
2021,483124,20,0,327,182,145
2021,483124,20,1,150,97,53
2021,483124,20,2,177,85,92
2021,483124,30,0,101,46,55
2021,483124,30,2,5,1,4
2021,483124,30,3,96,45,51
2021,483124,40,0,679,272,407
2021,483124,40,1,41,22,19
2021,483124,40,2,50,19,31
2021,483124,40,3,86,26,60
2021,483124,40,4,191,69,122
2021,483124,40,5,310,136,174
2021,483124,40,6,1,0,1
2021,483124,41,0,77,31,46
2021,483124,41,1,9,3,6
2021,483124,41,2,4,4,0
2021,483124,41,3,3,1,2
2021,483124,41,5,61,23,38
2021,483124,42,0,602,241,361
2021,483124,42,1,32,19,13
2021,483124,42,2,46,15,31
2021,483124,42,3,83,25,58
2021,483124,42,4,191,69,122
2021,483124,42,5,249,113,136
2021,483124,42,6,1,0,1
2021,483124,44,0,77,31,46
2021,483124,44,1,9,3,6
2021,483124,44,2,4,4,0
2021,483124,44,3,3,1,2
2021,483124,44,5,61,23,38
2021,483212,0,0,73,38,35
2021,483212,10,0,73,38,35
2021,483212,10,1,1,0,1
2021,483212,10,2,6,3,3
2021,483212,10,3,9,3,6
2021,483212,10,4,57,32,25
2021,483212,20,0,2,0,2
2021,483212,20,1,1,0,1
2021,483212,20,4,1,0,1
2021,483212,40,0,71,38,33
2021,483212,40,2,6,3,3
2021,483212,40,3,9,3,6
2021,483212,40,4,56,32,24
2021,483212,42,0,59,33,26
2021,483212,42,2,6,3,3
2021,483212,42,3,6,2,4
2021,483212,42,4,47,28,19
2021,483212,43,0,12,5,7
2021,483212,43,3,3,1,2
2021,483212,43,4,9,4,5
2021,483373,0,0,7,2,5
2021,483373,10,0,7,2,5
2021,483373,10,4,7,2,5
2021,483373,40,0,7,2,5
2021,483373,40,4,7,2,5
2021,483373,41,0,7,2,5
2021,483373,41,4,7,2,5
2021,483373,45,0,7,2,5
2021,483373,45,4,7,2,5
2021,483595,0,0,35,15,20
2021,483595,10,0,35,15,20
2021,483595,10,1,5,4,1
2021,483595,10,2,5,0,5
2021,483595,10,3,17,7,10
2021,483595,10,4,8,4,4
2021,483595,40,0,35,15,20
2021,483595,40,1,5,4,1
2021,483595,40,2,5,0,5
2021,483595,40,3,17,7,10
2021,483595,40,4,8,4,4
2021,483595,41,0,9,6,3
2021,483595,41,1,3,3,0
2021,483595,41,3,3,1,2
2021,483595,41,4,3,2,1
2021,483595,42,0,20,6,14
2021,483595,42,1,2,1,1
2021,483595,42,2,5,0,5
2021,483595,42,3,8,3,5
2021,483595,42,4,5,2,3
2021,483595,43,0,6,3,3
2021,483595,43,3,6,3,3
2021,483595,44,0,9,6,3
2021,483595,44,1,3,3,0
2021,483595,44,3,3,1,2
2021,483595,44,4,3,2,1
2021,483647,0,0,6,1,5
2021,483647,50,0,6,1,5
2021,483814,0,0,8,1,7
2021,483814,10,0,8,1,7
2021,483814,10,4,8,1,7
2021,483814,40,0,8,1,7
2021,483814,40,4,8,1,7
2021,483814,41,0,8,1,7
2021,483814,41,4,8,1,7
2021,483814,45,0,8,1,7
2021,483814,45,4,8,1,7
2021,483975,0,0,34,21,13
2021,483975,10,0,34,21,13
2021,483975,10,1,4,3,1
2021,483975,10,2,16,11,5
2021,483975,10,3,10,6,4
2021,483975,10,4,4,1,3
2021,483975,40,0,34,21,13
2021,483975,40,1,4,3,1
2021,483975,40,2,16,11,5
2021,483975,40,3,10,6,4
2021,483975,40,4,4,1,3
2021,483975,41,0,34,21,13
2021,483975,41,1,4,3,1
2021,483975,41,2,16,11,5
2021,483975,41,3,10,6,4
2021,483975,41,4,4,1,3
2021,483975,44,0,34,21,13
2021,483975,44,1,4,3,1
2021,483975,44,2,16,11,5
2021,483975,44,3,10,6,4
2021,483975,44,4,4,1,3
2021,484002,0,0,46,10,36
2021,484002,10,0,46,10,36
2021,484002,10,4,46,10,36
2021,484002,40,0,46,10,36
2021,484002,40,4,46,10,36
2021,484002,41,0,46,10,36
2021,484002,41,4,46,10,36
2021,484002,45,0,46,10,36
2021,484002,45,4,46,10,36
2021,484066,0,0,36,2,34
2021,484066,10,0,36,2,34
2021,484066,10,4,36,2,34
2021,484066,40,0,36,2,34
2021,484066,40,4,36,2,34
2021,484066,41,0,36,2,34
2021,484066,41,4,36,2,34
2021,484066,45,0,36,2,34
2021,484066,45,4,36,2,34
2021,484473,0,0,23,9,14
2021,484473,10,0,23,9,14
2021,484473,10,1,1,1,0
2021,484473,10,3,2,1,1
2021,484473,10,5,16,6,10
2021,484473,10,6,4,1,3
2021,484473,20,0,1,1,0
2021,484473,20,1,1,1,0
2021,484473,30,0,1,0,1
2021,484473,30,3,1,0,1
2021,484473,40,0,21,8,13
2021,484473,40,3,1,1,0
2021,484473,40,5,16,6,10
2021,484473,40,6,4,1,3
2021,484473,42,0,21,8,13
2021,484473,42,3,1,1,0
2021,484473,42,5,16,6,10
2021,484473,42,6,4,1,3
2021,484613,0,0,76,11,65
2021,484613,10,0,76,11,65
2021,484613,10,6,76,11,65
2021,484613,40,0,76,11,65
2021,484613,40,6,76,11,65
2021,484613,41,0,76,11,65
2021,484613,41,6,76,11,65
2021,484613,45,0,76,11,65
2021,484613,45,6,76,11,65
2021,484835,0,0,1,1,0
2021,484835,10,0,1,1,0
2021,484835,10,1,1,1,0
2021,484835,20,0,1,1,0
2021,484835,20,1,1,1,0
2021,484844,0,0,40,24,16
2021,484844,10,0,40,24,16
2021,484844,10,1,12,9,3
2021,484844,10,2,11,5,6
2021,484844,10,3,17,10,7
2021,484844,40,0,40,24,16
2021,484844,40,1,12,9,3
2021,484844,40,2,11,5,6
2021,484844,40,3,17,10,7
2021,484844,41,0,40,24,16
2021,484844,41,1,12,9,3
2021,484844,41,2,11,5,6
2021,484844,41,3,17,10,7
2021,484844,45,0,40,24,16
2021,484844,45,1,12,9,3
2021,484844,45,2,11,5,6
2021,484844,45,3,17,10,7
2021,484862,0,0,7,6,1
2021,484862,10,0,7,6,1
2021,484862,10,1,7,6,1
2021,484862,40,0,7,6,1
2021,484862,40,1,7,6,1
2021,484862,42,0,1,1,0
2021,484862,42,1,1,1,0
2021,484862,43,0,6,5,1
2021,484862,43,1,6,5,1
2021,484905,0,0,135,68,67
2021,484905,10,0,104,52,52
2021,484905,10,1,5,2,3
2021,484905,10,2,19,10,9
2021,484905,10,3,37,23,14
2021,484905,10,4,5,1,4
2021,484905,10,5,38,16,22
2021,484905,20,0,20,10,10
2021,484905,20,1,5,2,3
2021,484905,20,2,15,8,7
2021,484905,30,0,33,18,15
2021,484905,30,2,3,2,1
2021,484905,30,3,30,16,14
2021,484905,40,0,51,24,27
2021,484905,40,2,1,0,1
2021,484905,40,3,7,7,0
2021,484905,40,4,5,1,4
2021,484905,40,5,38,16,22
2021,484905,42,0,49,23,26
2021,484905,42,2,1,0,1
2021,484905,42,3,7,7,0
2021,484905,42,4,3,0,3
2021,484905,42,5,38,16,22
2021,484905,43,0,2,1,1
2021,484905,43,4,2,1,1
2021,484905,50,0,31,16,15
2021,484932,0,0,83,27,56
2021,484932,10,0,83,27,56
2021,484932,10,1,15,5,10
2021,484932,10,2,24,7,17
2021,484932,10,3,20,5,15
2021,484932,10,4,24,10,14
2021,484932,40,0,83,27,56
2021,484932,40,1,15,5,10
2021,484932,40,2,24,7,17
2021,484932,40,3,20,5,15
2021,484932,40,4,24,10,14
2021,484932,42,0,83,27,56
2021,484932,42,1,15,5,10
2021,484932,42,2,24,7,17
2021,484932,42,3,20,5,15
2021,484932,42,4,24,10,14
2021,485111,0,0,109,47,62
2021,485111,10,0,109,47,62
2021,485111,10,1,27,13,14
2021,485111,10,2,13,7,6
2021,485111,10,3,69,27,42
2021,485111,40,0,109,47,62
2021,485111,40,1,27,13,14
2021,485111,40,2,13,7,6
2021,485111,40,3,69,27,42
2021,485111,42,0,109,47,62
2021,485111,42,1,27,13,14
2021,485111,42,2,13,7,6
2021,485111,42,3,69,27,42
2021,485272,0,0,37,8,29
2021,485272,10,0,36,7,29
2021,485272,10,2,2,2,0
2021,485272,10,3,8,2,6
2021,485272,10,4,26,3,23
2021,485272,40,0,36,7,29
2021,485272,40,2,2,2,0
2021,485272,40,3,8,2,6
2021,485272,40,4,26,3,23
2021,485272,41,0,36,7,29
2021,485272,41,2,2,2,0
2021,485272,41,3,8,2,6
2021,485272,41,4,26,3,23
2021,485272,45,0,36,7,29
2021,485272,45,2,2,2,0
2021,485272,45,3,8,2,6
2021,485272,45,4,26,3,23
2021,485272,50,0,1,1,0
2021,485403,0,0,1,0,1
2021,485403,50,0,1,0,1
2021,485458,0,0,90,40,50
2021,485458,10,0,90,40,50
2021,485458,10,6,90,40,50
2021,485458,40,0,90,40,50
2021,485458,40,6,90,40,50
2021,485458,41,0,76,34,42
2021,485458,41,6,76,34,42
2021,485458,43,0,14,6,8
2021,485458,43,6,14,6,8
2021,485458,45,0,76,34,42
2021,485458,45,6,76,34,42
2021,485519,0,0,3,2,1
2021,485519,50,0,3,2,1
2021,485546,0,0,5,4,1
2021,485546,50,0,5,4,1
2021,485698,0,0,12,10,2
2021,485698,10,0,12,10,2
2021,485698,10,6,12,10,2
2021,485698,40,0,12,10,2
2021,485698,40,6,12,10,2
2021,485698,42,0,12,10,2
2021,485698,42,6,12,10,2
2021,485768,0,0,30,21,9
2021,485768,10,0,28,20,8
2021,485768,10,4,28,20,8
2021,485768,40,0,28,20,8
2021,485768,40,4,28,20,8
2021,485768,43,0,28,20,8
2021,485768,43,4,28,20,8
2021,485768,50,0,2,1,1
2021,485999,0,0,12,12,0
2021,485999,10,0,12,12,0
2021,485999,10,4,12,12,0
2021,485999,40,0,12,12,0
2021,485999,40,4,12,12,0
2021,485999,42,0,12,12,0
2021,485999,42,4,12,12,0
2021,486053,0,0,11,11,0
2021,486053,10,0,11,11,0
2021,486053,10,2,5,5,0
2021,486053,10,3,6,6,0
2021,486053,40,0,11,11,0
2021,486053,40,2,5,5,0
2021,486053,40,3,6,6,0
2021,486053,41,0,11,11,0
2021,486053,41,2,5,5,0
2021,486053,41,3,6,6,0
2021,486053,45,0,11,11,0
2021,486053,45,2,5,5,0
2021,486053,45,3,6,6,0
2021,486196,0,0,11,11,0
2021,486196,10,0,11,11,0
2021,486196,10,4,11,11,0
2021,486196,40,0,11,11,0
2021,486196,40,4,11,11,0
2021,486196,42,0,11,11,0
2021,486196,42,4,11,11,0
2021,486257,0,0,3,3,0
2021,486257,10,0,3,3,0
2021,486257,10,3,3,3,0
2021,486257,40,0,3,3,0
2021,486257,40,3,3,3,0
2021,486257,43,0,3,3,0
2021,486257,43,3,3,3,0
2021,486284,0,0,4,3,1
2021,486284,10,0,4,3,1
2021,486284,10,6,4,3,1
2021,486284,40,0,4,3,1
2021,486284,40,6,4,3,1
2021,486284,41,0,4,3,1
2021,486284,41,6,4,3,1
2021,486284,45,0,4,3,1
2021,486284,45,6,4,3,1
2021,486372,0,0,14,9,5
2021,486372,10,0,14,9,5
2021,486372,10,6,14,9,5
2021,486372,40,0,14,9,5
2021,486372,40,6,14,9,5
2021,486372,43,0,14,9,5
2021,486372,43,6,14,9,5
2021,486424,0,0,11,5,6
2021,486424,10,0,9,4,5
2021,486424,10,1,9,4,5
2021,486424,40,0,9,4,5
2021,486424,40,1,9,4,5
2021,486424,41,0,9,4,5
2021,486424,41,1,9,4,5
2021,486424,45,0,9,4,5
2021,486424,45,1,9,4,5
2021,486424,50,0,2,1,1
2021,486433,0,0,1,0,1
2021,486433,10,0,1,0,1
2021,486433,10,3,1,0,1
2021,486433,40,0,1,0,1
2021,486433,40,3,1,0,1
2021,486433,41,0,1,0,1
2021,486433,41,3,1,0,1
2021,486433,45,0,1,0,1
2021,486433,45,3,1,0,1
2021,486813,0,0,26,10,16
2021,486813,10,0,26,10,16
2021,486813,10,4,26,10,16
2021,486813,40,0,26,10,16
2021,486813,40,4,26,10,16
2021,486813,41,0,26,10,16
2021,486813,41,4,26,10,16
2021,486813,45,0,26,10,16
2021,486813,45,4,26,10,16
2021,486822,0,0,36,6,30
2021,486822,10,0,36,6,30
2021,486822,10,4,36,6,30
2021,486822,40,0,36,6,30
2021,486822,40,4,36,6,30
2021,486822,41,0,36,6,30
2021,486822,41,4,36,6,30
2021,486822,45,0,36,6,30
2021,486822,45,4,36,6,30
2021,486840,0,0,1294,668,626
2021,486840,10,0,1294,668,626
2021,486840,10,1,281,170,111
2021,486840,10,2,283,157,126
2021,486840,10,3,374,190,184
2021,486840,10,4,54,23,31
2021,486840,10,5,302,128,174
2021,486840,20,0,566,328,238
2021,486840,20,1,278,168,110
2021,486840,20,2,273,151,122
2021,486840,20,3,15,9,6
2021,486840,30,0,267,147,120
2021,486840,30,1,1,0,1
2021,486840,30,2,6,3,3
2021,486840,30,3,260,144,116
2021,486840,40,0,461,193,268
2021,486840,40,1,2,2,0
2021,486840,40,2,4,3,1
2021,486840,40,3,99,37,62
2021,486840,40,4,54,23,31
2021,486840,40,5,302,128,174
2021,486840,42,0,461,193,268
2021,486840,42,1,2,2,0
2021,486840,42,2,4,3,1
2021,486840,42,3,99,37,62
2021,486840,42,4,54,23,31
2021,486840,42,5,302,128,174
2021,486901,0,0,95,53,42
2021,486901,10,0,95,53,42
2021,486901,10,1,36,24,12
2021,486901,10,2,31,16,15
2021,486901,10,3,25,12,13
2021,486901,10,4,3,1,2
2021,486901,20,0,66,39,27
2021,486901,20,1,35,23,12
2021,486901,20,2,31,16,15
2021,486901,30,0,24,11,13
2021,486901,30,3,24,11,13
2021,486901,40,0,5,3,2
2021,486901,40,1,1,1,0
2021,486901,40,3,1,1,0
2021,486901,40,4,3,1,2
2021,486901,41,0,1,1,0
2021,486901,41,3,1,1,0
2021,486901,42,0,4,2,2
2021,486901,42,1,1,1,0
2021,486901,42,4,3,1,2
2021,486901,44,0,1,1,0
2021,486901,44,3,1,1,0
2021,486965,0,0,8,6,2
2021,486965,50,0,8,6,2
2021,487010,0,0,1315,760,555
2021,487010,10,0,1315,760,555
2021,487010,10,1,289,211,78
2021,487010,10,2,343,209,134
2021,487010,10,3,599,313,286
2021,487010,10,4,84,27,57
2021,487010,20,0,273,192,81
2021,487010,20,1,186,141,45
2021,487010,20,2,85,51,34
2021,487010,20,3,2,0,2
2021,487010,30,0,74,47,27
2021,487010,30,1,15,11,4
2021,487010,30,2,22,15,7
2021,487010,30,3,37,21,16
2021,487010,40,0,968,521,447
2021,487010,40,1,88,59,29
2021,487010,40,2,236,143,93
2021,487010,40,3,560,292,268
2021,487010,40,4,84,27,57
2021,487010,42,0,968,521,447
2021,487010,42,1,88,59,29
2021,487010,42,2,236,143,93
2021,487010,42,3,560,292,268
2021,487010,42,4,84,27,57
2021,487092,0,0,102,50,52
2021,487092,10,0,102,50,52
2021,487092,10,1,11,4,7
2021,487092,10,2,28,13,15
2021,487092,10,3,39,21,18
2021,487092,10,5,24,12,12
2021,487092,20,0,37,17,20
2021,487092,20,1,9,4,5
2021,487092,20,2,28,13,15
2021,487092,30,0,23,12,11
2021,487092,30,3,23,12,11
2021,487092,40,0,42,21,21
2021,487092,40,1,2,0,2
2021,487092,40,3,16,9,7
2021,487092,40,5,24,12,12
2021,487092,41,0,19,7,12
2021,487092,41,1,2,0,2
2021,487092,41,5,17,7,10
2021,487092,42,0,21,13,8
2021,487092,42,3,15,9,6
2021,487092,42,5,6,4,2
2021,487092,43,0,2,1,1
2021,487092,43,3,1,0,1
2021,487092,43,5,1,1,0
2021,487092,44,0,19,7,12
2021,487092,44,1,2,0,2
2021,487092,44,5,17,7,10
2021,487162,0,0,137,51,86
2021,487162,10,0,137,51,86
2021,487162,10,6,137,51,86
2021,487162,40,0,137,51,86
2021,487162,40,6,137,51,86
2021,487162,41,0,137,51,86
2021,487162,41,6,137,51,86
2021,487162,45,0,137,51,86
2021,487162,45,6,137,51,86
2021,487302,0,0,10,4,6
2021,487302,10,0,10,4,6
2021,487302,10,4,10,4,6
2021,487302,40,0,10,4,6
2021,487302,40,4,10,4,6
2021,487302,41,0,10,4,6
2021,487302,41,4,10,4,6
2021,487302,45,0,10,4,6
2021,487302,45,4,10,4,6
2021,487311,0,0,31,27,4
2021,487311,50,0,31,27,4
2021,487320,0,0,530,396,134
2021,487320,10,0,530,396,134
2021,487320,10,1,4,3,1
2021,487320,10,2,25,13,12
2021,487320,10,4,501,380,121
2021,487320,40,0,530,396,134
2021,487320,40,1,4,3,1
2021,487320,40,2,25,13,12
2021,487320,40,4,501,380,121
2021,487320,42,0,507,385,122
2021,487320,42,1,4,3,1
2021,487320,42,2,23,12,11
2021,487320,42,4,480,370,110
2021,487320,43,0,23,11,12
2021,487320,43,2,2,1,1
2021,487320,43,4,21,10,11
2021,487375,0,0,22,8,14
2021,487375,50,0,22,8,14
2021,487384,0,0,4,2,2
2021,487384,50,0,4,2,2
2021,487393,0,0,21,6,15
2021,487393,50,0,21,6,15
2021,487409,0,0,11,5,6
2021,487409,50,0,11,5,6
2021,487418,0,0,15,7,8
2021,487418,50,0,15,7,8
2021,487427,0,0,20,6,14
2021,487427,50,0,20,6,14
2021,487436,0,0,8,1,7
2021,487436,50,0,8,1,7
2021,487445,0,0,8,2,6
2021,487445,50,0,8,2,6
2021,487454,0,0,3,0,3
2021,487454,50,0,3,0,3
2021,487472,0,0,20,10,10
2021,487472,50,0,20,10,10
2021,487490,0,0,22,9,13
2021,487490,50,0,22,9,13
2021,487524,0,0,127,64,63
2021,487524,10,0,127,64,63
2021,487524,10,1,19,9,10
2021,487524,10,2,29,16,13
2021,487524,10,3,53,23,30
2021,487524,10,4,26,16,10
2021,487524,40,0,127,64,63
2021,487524,40,1,19,9,10
2021,487524,40,2,29,16,13
2021,487524,40,3,53,23,30
2021,487524,40,4,26,16,10
2021,487524,41,0,58,32,26
2021,487524,41,1,18,9,9
2021,487524,41,2,21,12,9
2021,487524,41,3,15,10,5
2021,487524,41,4,4,1,3
2021,487524,42,0,69,32,37
2021,487524,42,1,1,0,1
2021,487524,42,2,8,4,4
2021,487524,42,3,38,13,25
2021,487524,42,4,22,15,7
2021,487524,44,0,58,32,26
2021,487524,44,1,18,9,9
2021,487524,44,2,21,12,9
2021,487524,44,3,15,10,5
2021,487524,44,4,4,1,3
2021,487588,0,0,6,0,6
2021,487588,10,0,6,0,6
2021,487588,10,4,6,0,6
2021,487588,40,0,6,0,6
2021,487588,40,4,6,0,6
2021,487588,41,0,6,0,6
2021,487588,41,4,6,0,6
2021,487588,45,0,6,0,6
2021,487588,45,4,6,0,6
2021,487597,0,0,36,35,1
2021,487597,50,0,36,35,1
2021,487603,0,0,1,0,1
2021,487603,10,0,1,0,1
2021,487603,10,6,1,0,1
2021,487603,40,0,1,0,1
2021,487603,40,6,1,0,1
2021,487603,41,0,1,0,1
2021,487603,41,6,1,0,1
2021,487603,45,0,1,0,1
2021,487603,45,6,1,0,1
2021,487649,0,0,3,3,0
2021,487649,10,0,3,3,0
2021,487649,10,1,3,3,0
2021,487649,40,0,3,3,0
2021,487649,40,1,3,3,0
2021,487649,41,0,3,3,0
2021,487649,41,1,3,3,0
2021,487649,45,0,3,3,0
2021,487649,45,1,3,3,0
2021,487861,0,0,6,2,4
2021,487861,10,0,6,2,4
2021,487861,10,4,6,2,4
2021,487861,40,0,6,2,4
2021,487861,40,4,6,2,4
2021,487861,41,0,6,2,4
2021,487861,41,4,6,2,4
2021,487861,45,0,6,2,4
2021,487861,45,4,6,2,4
2021,487977,0,0,25,2,23
2021,487977,10,0,25,2,23
2021,487977,10,4,25,2,23
2021,487977,40,0,25,2,23
2021,487977,40,4,25,2,23
2021,487977,41,0,25,2,23
2021,487977,41,4,25,2,23
2021,487977,45,0,25,2,23
2021,487977,45,4,25,2,23
2021,488077,0,0,7,5,2
2021,488077,10,0,7,5,2
2021,488077,10,6,7,5,2
2021,488077,40,0,7,5,2
2021,488077,40,6,7,5,2
2021,488077,41,0,7,5,2
2021,488077,41,6,7,5,2
2021,488077,45,0,7,5,2
2021,488077,45,6,7,5,2
2021,488305,0,0,5,4,1
2021,488305,10,0,5,4,1
2021,488305,10,4,5,4,1
2021,488305,40,0,5,4,1
2021,488305,40,4,5,4,1
2021,488305,41,0,5,4,1
2021,488305,41,4,5,4,1
2021,488305,45,0,5,4,1
2021,488305,45,4,5,4,1
2021,488387,0,0,1,0,1
2021,488387,10,0,1,0,1
2021,488387,10,6,1,0,1
2021,488387,40,0,1,0,1
2021,488387,40,6,1,0,1
2021,488387,41,0,1,0,1
2021,488387,41,6,1,0,1
2021,488387,45,0,1,0,1
2021,488387,45,6,1,0,1
2021,488527,0,0,39,20,19
2021,488527,10,0,39,20,19
2021,488527,10,1,4,4,0
2021,488527,10,2,6,3,3
2021,488527,10,3,26,13,13
2021,488527,10,4,3,0,3
2021,488527,40,0,39,20,19
2021,488527,40,1,4,4,0
2021,488527,40,2,6,3,3
2021,488527,40,3,26,13,13
2021,488527,40,4,3,0,3
2021,488527,42,0,39,20,19
2021,488527,42,1,4,4,0
2021,488527,42,2,6,3,3
2021,488527,42,3,26,13,13
2021,488527,42,4,3,0,3
2021,488554,0,0,24,14,10
2021,488554,10,0,24,14,10
2021,488554,10,1,6,4,2
2021,488554,10,2,14,7,7
2021,488554,10,3,3,2,1
2021,488554,10,4,1,1,0
2021,488554,40,0,24,14,10
2021,488554,40,1,6,4,2
2021,488554,40,2,14,7,7
2021,488554,40,3,3,2,1
2021,488554,40,4,1,1,0
2021,488554,41,0,24,14,10
2021,488554,41,1,6,4,2
2021,488554,41,2,14,7,7
2021,488554,41,3,3,2,1
2021,488554,41,4,1,1,0
2021,488554,44,0,24,14,10
2021,488554,44,1,6,4,2
2021,488554,44,2,14,7,7
2021,488554,44,3,3,2,1
2021,488554,44,4,1,1,0
2021,488572,0,0,39,20,19
2021,488572,10,0,39,20,19
2021,488572,10,1,4,2,2
2021,488572,10,2,6,5,1
2021,488572,10,3,28,13,15
2021,488572,10,6,1,0,1
2021,488572,40,0,39,20,19
2021,488572,40,1,4,2,2
2021,488572,40,2,6,5,1
2021,488572,40,3,28,13,15
2021,488572,40,6,1,0,1
2021,488572,41,0,1,0,1
2021,488572,41,3,1,0,1
2021,488572,42,0,38,20,18
2021,488572,42,1,4,2,2
2021,488572,42,2,6,5,1
2021,488572,42,3,27,13,14
2021,488572,42,6,1,0,1
2021,488572,44,0,1,0,1
2021,488572,44,3,1,0,1
2021,488730,0,0,75,30,45
2021,488730,10,0,72,28,44
2021,488730,10,1,16,8,8
2021,488730,10,2,20,5,15
2021,488730,10,3,16,7,9
2021,488730,10,4,20,8,12
2021,488730,20,0,46,19,27
2021,488730,20,1,16,8,8
2021,488730,20,2,17,5,12
2021,488730,20,3,6,3,3
2021,488730,20,4,7,3,4
2021,488730,40,0,26,9,17
2021,488730,40,2,3,0,3
2021,488730,40,3,10,4,6
2021,488730,40,4,13,5,8
2021,488730,42,0,26,9,17
2021,488730,42,2,3,0,3
2021,488730,42,3,10,4,6
2021,488730,42,4,13,5,8
2021,488730,50,0,3,2,1
2021,488785,0,0,6,4,2
2021,488785,10,0,6,4,2
2021,488785,10,3,6,4,2
2021,488785,40,0,6,4,2
2021,488785,40,3,6,4,2
2021,488785,41,0,6,4,2
2021,488785,41,3,6,4,2
2021,488785,44,0,6,4,2
2021,488785,44,3,6,4,2
2021,488800,0,0,12,0,12
2021,488800,10,0,12,0,12
2021,488800,10,4,12,0,12
2021,488800,40,0,12,0,12
2021,488800,40,4,12,0,12
2021,488800,42,0,12,0,12
2021,488800,42,4,12,0,12
2021,489201,0,0,107,50,57
2021,489201,10,0,107,50,57
2021,489201,10,4,107,50,57
2021,489201,20,0,60,34,26
2021,489201,20,4,60,34,26
2021,489201,30,0,30,11,19
2021,489201,30,4,30,11,19
2021,489201,40,0,17,5,12
2021,489201,40,4,17,5,12
2021,489201,42,0,12,3,9
2021,489201,42,4,12,3,9
2021,489201,43,0,5,2,3
2021,489201,43,4,5,2,3
2021,489283,0,0,25,10,15
2021,489283,10,0,25,10,15
2021,489283,10,4,25,10,15
2021,489283,40,0,25,10,15
2021,489283,40,4,25,10,15
2021,489283,41,0,25,10,15
2021,489283,41,4,25,10,15
2021,489283,45,0,25,10,15
2021,489283,45,4,25,10,15
2021,489779,0,0,342,124,218
2021,489779,10,0,342,124,218
2021,489779,10,6,342,124,218
2021,489779,40,0,342,124,218
2021,489779,40,6,342,124,218
2021,489779,41,0,342,124,218
2021,489779,41,6,342,124,218
2021,489779,45,0,342,124,218
2021,489779,45,6,342,124,218
2021,489858,0,0,35,13,22
2021,489858,10,0,34,13,21
2021,489858,10,1,4,2,2
2021,489858,10,2,9,3,6
2021,489858,10,3,21,8,13
2021,489858,40,0,34,13,21
2021,489858,40,1,4,2,2
2021,489858,40,2,9,3,6
2021,489858,40,3,21,8,13
2021,489858,41,0,34,13,21
2021,489858,41,1,4,2,2
2021,489858,41,2,9,3,6
2021,489858,41,3,21,8,13
2021,489858,45,0,34,13,21
2021,489858,45,1,4,2,2
2021,489858,45,2,9,3,6
2021,489858,45,3,21,8,13
2021,489858,50,0,1,0,1
2021,489937,0,0,33,17,16
2021,489937,10,0,33,17,16
2021,489937,10,1,5,5,0
2021,489937,10,2,3,1,2
2021,489937,10,3,23,10,13
2021,489937,10,5,2,1,1
2021,489937,40,0,33,17,16
2021,489937,40,1,5,5,0
2021,489937,40,2,3,1,2
2021,489937,40,3,23,10,13
2021,489937,40,5,2,1,1
2021,489937,41,0,33,17,16
2021,489937,41,1,5,5,0
2021,489937,41,2,3,1,2
2021,489937,41,3,23,10,13
2021,489937,41,5,2,1,1
2021,489937,44,0,33,17,16
2021,489937,44,1,5,5,0
2021,489937,44,2,3,1,2
2021,489937,44,3,23,10,13
2021,489937,44,5,2,1,1
2021,490054,0,0,20,4,16
2021,490054,10,0,20,4,16
2021,490054,10,4,20,4,16
2021,490054,40,0,20,4,16
2021,490054,40,4,20,4,16
2021,490054,41,0,20,4,16
2021,490054,41,4,20,4,16
2021,490054,45,0,20,4,16
2021,490054,45,4,20,4,16
2021,490106,0,0,3,2,1
2021,490106,10,0,3,2,1
2021,490106,10,1,3,2,1
2021,490106,40,0,3,2,1
2021,490106,40,1,3,2,1
2021,490106,41,0,3,2,1
2021,490106,41,1,3,2,1
2021,490106,45,0,3,2,1
2021,490106,45,1,3,2,1
2021,490133,0,0,39,18,21
2021,490133,10,0,39,18,21
2021,490133,10,1,9,5,4
2021,490133,10,2,1,0,1
2021,490133,10,3,17,7,10
2021,490133,10,4,2,1,1
2021,490133,10,6,10,5,5
2021,490133,20,0,9,5,4
2021,490133,20,1,9,5,4
2021,490133,30,0,1,0,1
2021,490133,30,2,1,0,1
2021,490133,40,0,29,13,16
2021,490133,40,3,17,7,10
2021,490133,40,4,2,1,1
2021,490133,40,6,10,5,5
2021,490133,41,0,25,13,12
2021,490133,41,3,13,7,6
2021,490133,41,4,2,1,1
2021,490133,41,6,10,5,5
2021,490133,42,0,4,0,4
2021,490133,42,3,4,0,4
2021,490133,45,0,25,13,12
2021,490133,45,3,13,7,6
2021,490133,45,4,2,1,1
2021,490133,45,6,10,5,5
2021,490203,0,0,9,1,8
2021,490203,10,0,9,1,8
2021,490203,10,4,9,1,8
2021,490203,40,0,9,1,8
2021,490203,40,4,9,1,8
2021,490203,42,0,9,1,8
2021,490203,42,4,9,1,8
2021,490230,0,0,29,15,14
2021,490230,10,0,29,15,14
2021,490230,10,4,29,15,14
2021,490230,40,0,29,15,14
2021,490230,40,4,29,15,14
2021,490230,41,0,29,15,14
2021,490230,41,4,29,15,14
2021,490230,44,0,29,15,14
2021,490230,44,4,29,15,14
2021,490276,0,0,13,13,0
2021,490276,10,0,13,13,0
2021,490276,10,1,1,1,0
2021,490276,10,4,12,12,0
2021,490276,40,0,13,13,0
2021,490276,40,1,1,1,0
2021,490276,40,4,12,12,0
2021,490276,42,0,13,13,0
2021,490276,42,1,1,1,0
2021,490276,42,4,12,12,0
2021,490373,0,0,122,62,60
2021,490373,10,0,122,62,60
2021,490373,10,1,24,19,5
2021,490373,10,2,31,14,17
2021,490373,10,3,66,29,37
2021,490373,10,4,1,0,1
2021,490373,40,0,122,62,60
2021,490373,40,1,24,19,5
2021,490373,40,2,31,14,17
2021,490373,40,3,66,29,37
2021,490373,40,4,1,0,1
2021,490373,41,0,122,62,60
2021,490373,41,1,24,19,5
2021,490373,41,2,31,14,17
2021,490373,41,3,66,29,37
2021,490373,41,4,1,0,1
2021,490373,45,0,122,62,60
2021,490373,45,1,24,19,5
2021,490373,45,2,31,14,17
2021,490373,45,3,66,29,37
2021,490373,45,4,1,0,1
2021,490513,0,0,12,12,0
2021,490513,10,0,12,12,0
2021,490513,10,4,12,12,0
2021,490513,40,0,12,12,0
2021,490513,40,4,12,12,0
2021,490513,42,0,12,12,0
2021,490513,42,4,12,12,0
2021,490559,0,0,25,6,19
2021,490559,50,0,25,6,19
2021,490805,0,0,250,145,105
2021,490805,10,0,224,134,90
2021,490805,10,1,76,51,25
2021,490805,10,2,94,54,40
2021,490805,10,3,42,24,18
2021,490805,10,4,12,5,7
2021,490805,20,0,158,100,58
2021,490805,20,1,76,51,25
2021,490805,20,2,82,49,33
2021,490805,30,0,52,27,25
2021,490805,30,2,12,5,7
2021,490805,30,3,40,22,18
2021,490805,40,0,14,7,7
2021,490805,40,3,2,2,0
2021,490805,40,4,12,5,7
2021,490805,41,0,3,1,2
2021,490805,41,4,3,1,2
2021,490805,42,0,7,4,3
2021,490805,42,3,2,2,0
2021,490805,42,4,5,2,3
2021,490805,43,0,4,2,2
2021,490805,43,4,4,2,2
2021,490805,45,0,3,1,2
2021,490805,45,4,3,1,2
2021,490805,50,0,26,11,15
2021,490832,0,0,12,1,11
2021,490832,50,0,12,1,11
2021,490878,0,0,11,2,9
2021,490878,10,0,11,2,9
2021,490878,10,4,11,2,9
2021,490878,40,0,11,2,9
2021,490878,40,4,11,2,9
2021,490878,41,0,11,2,9
2021,490878,41,4,11,2,9
2021,490878,45,0,11,2,9
2021,490878,45,4,11,2,9
2021,490975,0,0,6,2,4
2021,490975,10,0,6,2,4
2021,490975,10,4,6,2,4
2021,490975,40,0,6,2,4
2021,490975,40,4,6,2,4
2021,490975,41,0,6,2,4
2021,490975,41,4,6,2,4
2021,490975,45,0,6,2,4
2021,490975,45,4,6,2,4
2021,491057,0,0,11,11,0
2021,491057,10,0,11,11,0
2021,491057,10,4,11,11,0
2021,491057,40,0,11,11,0
2021,491057,40,4,11,11,0
2021,491057,42,0,11,11,0
2021,491057,42,4,11,11,0
2021,491181,0,0,12,1,11
2021,491181,10,0,12,1,11
2021,491181,10,4,12,1,11
2021,491181,40,0,12,1,11
2021,491181,40,4,12,1,11
2021,491181,41,0,12,1,11
2021,491181,41,4,12,1,11
2021,491181,45,0,12,1,11
2021,491181,45,4,12,1,11
2021,491525,0,0,8,6,2
2021,491525,10,0,8,6,2
2021,491525,10,1,8,6,2
2021,491525,40,0,8,6,2
2021,491525,40,1,8,6,2
2021,491525,41,0,6,4,2
2021,491525,41,1,6,4,2
2021,491525,42,0,2,2,0
2021,491525,42,1,2,2,0
2021,491525,44,0,6,4,2
2021,491525,44,1,6,4,2
2021,491808,0,0,4,1,3
2021,491808,10,0,4,1,3
2021,491808,10,1,4,1,3
2021,491808,40,0,4,1,3
2021,491808,40,1,4,1,3
2021,491808,41,0,4,1,3
2021,491808,41,1,4,1,3
2021,491808,45,0,4,1,3
2021,491808,45,1,4,1,3
2021,491844,0,0,6,4,2
2021,491844,10,0,6,4,2
2021,491844,10,4,6,4,2
2021,491844,40,0,6,4,2
2021,491844,40,4,6,4,2
2021,491844,42,0,6,4,2
2021,491844,42,4,6,4,2
2021,492449,0,0,23,6,17
2021,492449,10,0,23,6,17
2021,492449,10,4,23,6,17
2021,492449,40,0,23,6,17
2021,492449,40,4,23,6,17
2021,492449,41,0,23,6,17
2021,492449,41,4,23,6,17
2021,492449,45,0,23,6,17
2021,492449,45,4,23,6,17
2021,492476,0,0,1,0,1
2021,492476,10,0,1,0,1
2021,492476,10,4,1,0,1
2021,492476,40,0,1,0,1
2021,492476,40,4,1,0,1
2021,492476,42,0,1,0,1
2021,492476,42,4,1,0,1
2021,492607,0,0,10,3,7
2021,492607,10,0,10,3,7
2021,492607,10,2,8,2,6
2021,492607,10,3,2,1,1
2021,492607,40,0,10,3,7
2021,492607,40,2,8,2,6
2021,492607,40,3,2,1,1
2021,492607,41,0,10,3,7
2021,492607,41,2,8,2,6
2021,492607,41,3,2,1,1
2021,492607,44,0,10,3,7
2021,492607,44,2,8,2,6
2021,492607,44,3,2,1,1
2021,492689,0,0,306,160,146
2021,492689,10,0,304,160,144
2021,492689,10,1,39,25,14
2021,492689,10,2,63,41,22
2021,492689,10,3,172,85,87
2021,492689,10,4,13,3,10
2021,492689,10,5,17,6,11
2021,492689,20,0,27,21,6
2021,492689,20,1,20,16,4
2021,492689,20,2,7,5,2
2021,492689,30,0,14,4,10
2021,492689,30,1,3,2,1
2021,492689,30,2,3,1,2
2021,492689,30,3,8,1,7
2021,492689,40,0,263,135,128
2021,492689,40,1,16,7,9
2021,492689,40,2,53,35,18
2021,492689,40,3,164,84,80
2021,492689,40,4,13,3,10
2021,492689,40,5,17,6,11
2021,492689,42,0,263,135,128
2021,492689,42,1,16,7,9
2021,492689,42,2,53,35,18
2021,492689,42,3,164,84,80
2021,492689,42,4,13,3,10
2021,492689,42,5,17,6,11
2021,492689,50,0,2,0,2
2021,492722,0,0,15,3,12
2021,492722,10,0,15,3,12
2021,492722,10,4,15,3,12
2021,492722,40,0,15,3,12
2021,492722,40,4,15,3,12
2021,492722,41,0,15,3,12
2021,492722,41,4,15,3,12
2021,492722,45,0,15,3,12
2021,492722,45,4,15,3,12
2021,492801,0,0,4,1,3
2021,492801,10,0,4,1,3
2021,492801,10,1,1,0,1
2021,492801,10,2,1,1,0
2021,492801,10,4,2,0,2
2021,492801,20,0,2,1,1
2021,492801,20,1,1,0,1
2021,492801,20,2,1,1,0
2021,492801,40,0,2,0,2
2021,492801,40,4,2,0,2
2021,492801,42,0,2,0,2
2021,492801,42,4,2,0,2
2021,493080,0,0,8,5,3
2021,493080,10,0,8,5,3
2021,493080,10,6,8,5,3
2021,493080,40,0,8,5,3
2021,493080,40,6,8,5,3
2021,493080,41,0,8,5,3
2021,493080,41,6,8,5,3
2021,493080,45,0,8,5,3
2021,493080,45,6,8,5,3
2021,493600,0,0,19,19,0
2021,493600,10,0,19,19,0
2021,493600,10,4,19,19,0
2021,493600,40,0,19,19,0
2021,493600,40,4,19,19,0
2021,493600,42,0,19,19,0
2021,493600,42,4,19,19,0
2021,493646,0,0,24,0,24
2021,493646,10,0,24,0,24
2021,493646,10,4,24,0,24
2021,493646,40,0,24,0,24
2021,493646,40,4,24,0,24
2021,493646,42,0,24,0,24
2021,493646,42,4,24,0,24
2021,493947,0,0,37,20,17
2021,493947,10,0,37,20,17
2021,493947,10,2,9,7,2
2021,493947,10,3,25,13,12
2021,493947,10,4,3,0,3
2021,493947,40,0,37,20,17
2021,493947,40,2,9,7,2
2021,493947,40,3,25,13,12
2021,493947,40,4,3,0,3
2021,493947,41,0,37,20,17
2021,493947,41,2,9,7,2
2021,493947,41,3,25,13,12
2021,493947,41,4,3,0,3
2021,493947,44,0,37,20,17
2021,493947,44,2,9,7,2
2021,493947,44,3,25,13,12
2021,493947,44,4,3,0,3
2021,494010,0,0,12,5,7
2021,494010,10,0,12,5,7
2021,494010,10,1,1,1,0
2021,494010,10,2,3,1,2
2021,494010,10,3,8,3,5
2021,494010,40,0,12,5,7
2021,494010,40,1,1,1,0
2021,494010,40,2,3,1,2
2021,494010,40,3,8,3,5
2021,494010,41,0,12,5,7
2021,494010,41,1,1,1,0
2021,494010,41,2,3,1,2
2021,494010,41,3,8,3,5
2021,494010,45,0,12,5,7
2021,494010,45,1,1,1,0
2021,494010,45,2,3,1,2
2021,494010,45,3,8,3,5
2021,494162,0,0,8,1,7
2021,494162,50,0,8,1,7
2021,494250,0,0,15,5,10
2021,494250,50,0,15,5,10
2021,494278,0,0,2,1,1
2021,494278,10,0,2,1,1
2021,494278,10,4,2,1,1
2021,494278,40,0,2,1,1
2021,494278,40,4,2,1,1
2021,494278,42,0,2,1,1
2021,494278,42,4,2,1,1
2021,494287,0,0,8,0,8
2021,494287,10,0,8,0,8
2021,494287,10,4,8,0,8
2021,494287,40,0,8,0,8
2021,494287,40,4,8,0,8
2021,494287,42,0,8,0,8
2021,494287,42,4,8,0,8
2021,494436,0,0,15,2,13
2021,494436,10,0,15,2,13
2021,494436,10,4,15,2,13
2021,494436,40,0,15,2,13
2021,494436,40,4,15,2,13
2021,494436,41,0,15,2,13
2021,494436,41,4,15,2,13
2021,494436,45,0,15,2,13
2021,494436,45,4,15,2,13
2021,494588,0,0,11,3,8
2021,494588,10,0,11,3,8
2021,494588,10,4,11,3,8
2021,494588,40,0,11,3,8
2021,494588,40,4,11,3,8
2021,494588,41,0,11,3,8
2021,494588,41,4,11,3,8
2021,494588,45,0,11,3,8
2021,494588,45,4,11,3,8
2021,494603,0,0,41,38,3
2021,494603,10,0,41,38,3
2021,494603,10,6,41,38,3
2021,494603,40,0,41,38,3
2021,494603,40,6,41,38,3
2021,494603,41,0,41,38,3
2021,494603,41,6,41,38,3
2021,494603,45,0,41,38,3
2021,494603,45,6,41,38,3
2021,494737,0,0,19,19,0
2021,494737,10,0,19,19,0
2021,494737,10,4,19,19,0
2021,494737,40,0,19,19,0
2021,494737,40,4,19,19,0
2021,494737,42,0,19,19,0
2021,494737,42,4,19,19,0
2021,494746,0,0,7,2,5
2021,494746,50,0,7,2,5
2021,494755,0,0,6,0,6
2021,494755,50,0,6,0,6
2021,494843,0,0,16,3,13
2021,494843,10,0,16,3,13
2021,494843,10,4,16,3,13
2021,494843,40,0,16,3,13
2021,494843,40,4,16,3,13
2021,494843,41,0,16,3,13
2021,494843,41,4,16,3,13
2021,494843,45,0,16,3,13
2021,494843,45,4,16,3,13
2021,494852,0,0,26,8,18
2021,494852,10,0,26,8,18
2021,494852,10,6,26,8,18
2021,494852,40,0,26,8,18
2021,494852,40,6,26,8,18
2021,494852,41,0,26,8,18
2021,494852,41,6,26,8,18
2021,494852,45,0,26,8,18
2021,494852,45,6,26,8,18
2021,494959,0,0,3,3,0
2021,494959,10,0,3,3,0
2021,494959,10,4,3,3,0
2021,494959,40,0,3,3,0
2021,494959,40,4,3,3,0
2021,494959,41,0,3,3,0
2021,494959,41,4,3,3,0
2021,494959,45,0,3,3,0
2021,494959,45,4,3,3,0
2021,495192,0,0,5,1,4
2021,495192,10,0,5,1,4
2021,495192,10,6,5,1,4
2021,495192,40,0,5,1,4
2021,495192,40,6,5,1,4
2021,495192,41,0,5,1,4
2021,495192,41,6,5,1,4
2021,495192,45,0,5,1,4
2021,495192,45,6,5,1,4
2021,495314,0,0,11,5,6
2021,495314,10,0,11,5,6
2021,495314,10,1,5,3,2
2021,495314,10,2,3,1,2
2021,495314,10,3,3,1,2
2021,495314,40,0,11,5,6
2021,495314,40,1,5,3,2
2021,495314,40,2,3,1,2
2021,495314,40,3,3,1,2
2021,495314,41,0,11,5,6
2021,495314,41,1,5,3,2
2021,495314,41,2,3,1,2
2021,495314,41,3,3,1,2
2021,495314,44,0,11,5,6
2021,495314,44,1,5,3,2
2021,495314,44,2,3,1,2
2021,495314,44,3,3,1,2
2021,495420,0,0,4,2,2
2021,495420,50,0,4,2,2
2021,495439,0,0,5,1,4
2021,495439,50,0,5,1,4
2021,495448,0,0,8,3,5
2021,495448,50,0,8,3,5
2021,495457,0,0,3,0,3
2021,495457,50,0,3,0,3
2021,495767,0,0,5915,3340,2575
2021,495767,10,0,5853,3303,2550
2021,495767,10,1,1550,1092,458
2021,495767,10,2,1638,931,707
2021,495767,10,3,2144,1048,1096
2021,495767,10,4,188,69,119
2021,495767,10,5,320,155,165
2021,495767,10,6,13,8,5
2021,495767,20,0,2169,1458,711
2021,495767,20,1,1233,891,342
2021,495767,20,2,928,561,367
2021,495767,20,3,8,6,2
2021,495767,30,0,897,482,415
2021,495767,30,1,9,7,2
2021,495767,30,2,70,47,23
2021,495767,30,3,818,428,390
2021,495767,40,0,2787,1363,1424
2021,495767,40,1,308,194,114
2021,495767,40,2,640,323,317
2021,495767,40,3,1318,614,704
2021,495767,40,4,188,69,119
2021,495767,40,5,320,155,165
2021,495767,40,6,13,8,5
2021,495767,41,0,2086,1049,1037
2021,495767,41,1,279,172,107
2021,495767,41,2,580,289,291
2021,495767,41,3,959,453,506
2021,495767,41,4,74,31,43
2021,495767,41,5,181,96,85
2021,495767,41,6,13,8,5
2021,495767,42,0,625,266,359
2021,495767,42,1,22,16,6
2021,495767,42,2,39,20,19
2021,495767,42,3,325,140,185
2021,495767,42,4,102,32,70
2021,495767,42,5,137,58,79
2021,495767,43,0,76,48,28
2021,495767,43,1,7,6,1
2021,495767,43,2,21,14,7
2021,495767,43,3,34,21,13
2021,495767,43,4,12,6,6
2021,495767,43,5,2,1,1
2021,495767,44,0,1194,557,637
2021,495767,44,1,138,81,57
2021,495767,44,2,351,153,198
2021,495767,44,3,480,212,268
2021,495767,44,4,45,17,28
2021,495767,44,5,178,93,85
2021,495767,44,6,2,1,1
2021,495767,45,0,892,492,400
2021,495767,45,1,141,91,50
2021,495767,45,2,229,136,93
2021,495767,45,3,479,241,238
2021,495767,45,4,29,14,15
2021,495767,45,5,3,3,0
2021,495767,45,6,11,7,4
2021,495767,50,0,62,37,25
2021,496043,0,0,33,19,14
2021,496043,10,0,33,19,14
2021,496043,10,1,12,10,2
2021,496043,10,2,3,2,1
2021,496043,10,3,17,7,10
2021,496043,10,4,1,0,1
2021,496043,40,0,33,19,14
2021,496043,40,1,12,10,2
2021,496043,40,2,3,2,1
2021,496043,40,3,17,7,10
2021,496043,40,4,1,0,1
2021,496043,41,0,33,19,14
2021,496043,41,1,12,10,2
2021,496043,41,2,3,2,1
2021,496043,41,3,17,7,10
2021,496043,41,4,1,0,1
2021,496043,44,0,33,19,14
2021,496043,44,1,12,10,2
2021,496043,44,2,3,2,1
2021,496043,44,3,17,7,10
2021,496043,44,4,1,0,1
2021,496186,0,0,2,2,0
2021,496186,10,0,2,2,0
2021,496186,10,4,2,2,0
2021,496186,40,0,2,2,0
2021,496186,40,4,2,2,0
2021,496186,41,0,2,2,0
2021,496186,41,4,2,2,0
2021,496186,45,0,2,2,0
2021,496186,45,4,2,2,0
2021,496283,0,0,5,2,3
2021,496283,50,0,5,2,3
2021,496326,0,0,8,2,6
2021,496326,50,0,8,2,6
2021,496627,0,0,87,51,36
2021,496627,10,0,87,51,36
2021,496627,10,1,13,11,2
2021,496627,10,2,23,14,9
2021,496627,10,3,47,26,21
2021,496627,10,5,4,0,4
2021,496627,40,0,87,51,36
2021,496627,40,1,13,11,2
2021,496627,40,2,23,14,9
2021,496627,40,3,47,26,21
2021,496627,40,5,4,0,4
2021,496627,41,0,40,21,19
2021,496627,41,1,3,3,0
2021,496627,41,2,11,5,6
2021,496627,41,3,24,13,11
2021,496627,41,5,2,0,2
2021,496627,42,0,47,30,17
2021,496627,42,1,10,8,2
2021,496627,42,2,12,9,3
2021,496627,42,3,23,13,10
2021,496627,42,5,2,0,2
2021,496627,44,0,40,21,19
2021,496627,44,1,3,3,0
2021,496627,44,2,11,5,6
2021,496627,44,3,24,13,11
2021,496627,44,5,2,0,2
2021,496636,0,0,8,5,3
2021,496636,10,0,8,5,3
2021,496636,10,1,8,5,3
2021,496636,40,0,8,5,3
2021,496636,40,1,8,5,3
2021,496636,41,0,8,5,3
2021,496636,41,1,8,5,3
2021,496636,45,0,8,5,3
2021,496636,45,1,8,5,3
2021,496681,0,0,10,2,8
2021,496681,10,0,10,2,8
2021,496681,10,4,10,2,8
2021,496681,40,0,10,2,8
2021,496681,40,4,10,2,8
2021,496681,41,0,10,2,8
2021,496681,41,4,10,2,8
2021,496681,45,0,10,2,8
2021,496681,45,4,10,2,8
2021,496991,0,0,7,0,7
2021,496991,10,0,7,0,7
2021,496991,10,4,7,0,7
2021,496991,40,0,7,0,7
2021,496991,40,4,7,0,7
2021,496991,41,0,7,0,7
2021,496991,41,4,7,0,7
2021,496991,45,0,7,0,7
2021,496991,45,4,7,0,7
2021,497046,0,0,52,26,26
2021,497046,10,0,52,26,26
2021,497046,10,4,52,26,26
2021,497046,20,0,31,16,15
2021,497046,20,4,31,16,15
2021,497046,30,0,13,7,6
2021,497046,30,4,13,7,6
2021,497046,40,0,8,3,5
2021,497046,40,4,8,3,5
2021,497046,42,0,4,1,3
2021,497046,42,4,4,1,3
2021,497046,43,0,4,2,2
2021,497046,43,4,4,2,2
2021,497277,0,0,9,1,8
2021,497277,50,0,9,1,8
2021,497286,0,0,5,5,0
2021,497286,50,0,5,5,0
