Year,UNITID,FACSTAT,ARANK,HRTOTLT,HRTOTLM,HRTOTLW
2020,100654,0,0,253,137,116
2020,100654,10,0,239,129,110
2020,100654,10,1,52,40,12
2020,100654,10,2,46,31,15
2020,100654,10,3,94,43,51
2020,100654,10,4,40,12,28
2020,100654,10,6,7,3,4
2020,100654,20,0,90,63,27
2020,100654,20,1,50,38,12
2020,100654,20,2,34,22,12
2020,100654,20,3,6,3,3
2020,100654,30,0,48,20,28
2020,100654,30,2,7,5,2
2020,100654,30,3,41,15,26
2020,100654,40,0,101,46,55
2020,100654,40,1,2,2,0
2020,100654,40,2,5,4,1
2020,100654,40,3,47,25,22
2020,100654,40,4,40,12,28
2020,100654,40,6,7,3,4
2020,100654,42,0,101,46,55
2020,100654,42,1,2,2,0
2020,100654,42,2,5,4,1
2020,100654,42,3,47,25,22
2020,100654,42,4,40,12,28
2020,100654,42,6,7,3,4
2020,100654,50,0,14,8,6
2020,100663,0,0,2544,1438,1106
2020,100663,10,0,2544,1438,1106
2020,100663,10,1,744,506,238
2020,100663,10,2,695,404,291
2020,100663,10,3,890,432,458
2020,100663,10,4,215,96,119
2020,100663,20,0,896,601,295
2020,100663,20,1,597,423,174
2020,100663,20,2,298,178,120
2020,100663,20,3,1,0,1
2020,100663,30,0,511,268,243
2020,100663,30,1,8,4,4
2020,100663,30,2,119,70,49
2020,100663,30,3,384,194,190
2020,100663,40,0,1137,569,568
2020,100663,40,1,139,79,60
2020,100663,40,2,278,156,122
2020,100663,40,3,505,238,267
2020,100663,40,4,215,96,119
2020,100663,42,0,1137,569,568
2020,100663,42,1,139,79,60
2020,100663,42,2,278,156,122
2020,100663,42,3,505,238,267
2020,100663,42,4,215,96,119
2020,100690,0,0,35,26,9
2020,100690,10,0,35,26,9
2020,100690,10,1,13,11,2
2020,100690,10,2,8,7,1
2020,100690,10,3,6,4,2
2020,100690,10,4,3,2,1
2020,100690,10,6,5,2,3
2020,100690,40,0,35,26,9
2020,100690,40,1,13,11,2
2020,100690,40,2,8,7,1
2020,100690,40,3,6,4,2
2020,100690,40,4,3,2,1
2020,100690,40,6,5,2,3
2020,100690,42,0,30,24,6
2020,100690,42,1,13,11,2
2020,100690,42,2,8,7,1
2020,100690,42,3,6,4,2
2020,100690,42,4,3,2,1
2020,100690,43,0,5,2,3
2020,100690,43,6,5,2,3
2020,100706,0,0,353,194,159
2020,100706,10,0,353,194,159
2020,100706,10,1,75,60,15
2020,100706,10,2,97,67,30
2020,100706,10,3,94,37,57
2020,100706,10,4,14,2,12
2020,100706,10,5,73,28,45
2020,100706,20,0,159,122,37
2020,100706,20,1,74,60,14
2020,100706,20,2,84,62,22
2020,100706,20,3,1,0,1
2020,100706,30,0,68,36,32
2020,100706,30,2,4,2,2
2020,100706,30,3,64,34,30
2020,100706,40,0,126,36,90
2020,100706,40,1,1,0,1
2020,100706,40,2,9,3,6
2020,100706,40,3,29,3,26
2020,100706,40,4,14,2,12
2020,100706,40,5,73,28,45
2020,100706,41,0,117,29,88
2020,100706,41,1,1,0,1
2020,100706,41,2,9,3,6
2020,100706,41,3,29,3,26
2020,100706,41,4,14,2,12
2020,100706,41,5,64,21,43
2020,100706,42,0,9,7,2
2020,100706,42,5,9,7,2
2020,100706,44,0,117,29,88
2020,100706,44,1,1,0,1
2020,100706,44,2,9,3,6
2020,100706,44,3,29,3,26
2020,100706,44,4,14,2,12
2020,100706,44,5,64,21,43
2020,100724,0,0,221,114,107
2020,100724,10,0,217,114,103
2020,100724,10,1,59,35,24
2020,100724,10,2,57,30,27
2020,100724,10,3,63,35,28
2020,100724,10,4,38,14,24
2020,100724,20,0,101,56,45
2020,100724,20,1,59,35,24
2020,100724,20,2,39,20,19
2020,100724,20,3,3,1,2
2020,100724,30,0,64,39,25
2020,100724,30,2,16,9,7
2020,100724,30,3,48,30,18
2020,100724,40,0,52,19,33
2020,100724,40,2,2,1,1
2020,100724,40,3,12,4,8
2020,100724,40,4,38,14,24
2020,100724,42,0,52,19,33
2020,100724,42,2,2,1,1
2020,100724,42,3,12,4,8
2020,100724,42,4,38,14,24
2020,100724,50,0,4,0,4
2020,100751,0,0,1517,818,699
2020,100751,10,0,1517,818,699
2020,100751,10,1,321,222,99
2020,100751,10,2,392,221,171
2020,100751,10,3,474,231,243
2020,100751,10,4,324,140,184
2020,100751,10,5,6,4,2
2020,100751,20,0,614,393,221
2020,100751,20,1,287,206,81
2020,100751,20,2,323,185,138
2020,100751,20,3,4,2,2
2020,100751,30,0,384,215,169
2020,100751,30,1,17,10,7
2020,100751,30,2,25,20,5
2020,100751,30,3,342,185,157
2020,100751,40,0,519,210,309
2020,100751,40,1,17,6,11
2020,100751,40,2,44,16,28
2020,100751,40,3,128,44,84
2020,100751,40,4,324,140,184
2020,100751,40,5,6,4,2
2020,100751,42,0,517,210,307
2020,100751,42,1,17,6,11
2020,100751,42,2,44,16,28
2020,100751,42,3,127,44,83
2020,100751,42,4,323,140,183
2020,100751,42,5,6,4,2
2020,100751,43,0,2,0,2
2020,100751,43,3,1,0,1
2020,100751,43,4,1,0,1
2020,100760,0,0,43,21,22
2020,100760,10,0,41,20,21
2020,100760,10,6,41,20,21
2020,100760,20,0,35,20,15
2020,100760,20,6,35,20,15
2020,100760,30,0,5,0,5
2020,100760,30,6,5,0,5
2020,100760,40,0,1,0,1
2020,100760,40,6,1,0,1
2020,100760,42,0,1,0,1
2020,100760,42,6,1,0,1
2020,100760,50,0,2,1,1
2020,100812,0,0,84,39,45
2020,100812,10,0,84,39,45
2020,100812,10,1,26,16,10
2020,100812,10,2,24,5,19
2020,100812,10,3,31,15,16
2020,100812,10,4,3,3,0
2020,100812,20,0,57,26,31
2020,100812,20,1,26,16,10
2020,100812,20,2,24,5,19
2020,100812,20,3,7,5,2
2020,100812,30,0,24,10,14
2020,100812,30,3,24,10,14
2020,100812,40,0,3,3,0
2020,100812,40,4,3,3,0
2020,100812,42,0,3,3,0
2020,100812,42,4,3,3,0
2020,100830,0,0,225,115,110
2020,100830,10,0,217,111,106
2020,100830,10,1,51,33,18
2020,100830,10,2,66,40,26
2020,100830,10,3,61,22,39
2020,100830,10,4,1,0,1
2020,100830,10,5,38,16,22
2020,100830,20,0,114,74,40
2020,100830,20,1,51,33,18
2020,100830,20,2,57,38,19
2020,100830,20,3,6,3,3
2020,100830,30,0,50,21,29
2020,100830,30,2,6,2,4
2020,100830,30,3,44,19,25
2020,100830,40,0,53,16,37
2020,100830,40,2,3,0,3
2020,100830,40,3,11,0,11
2020,100830,40,4,1,0,1
2020,100830,40,5,38,16,22
2020,100830,42,0,53,16,37
2020,100830,42,2,3,0,3
2020,100830,42,3,11,0,11
2020,100830,42,4,1,0,1
2020,100830,42,5,38,16,22
2020,100830,50,0,8,4,4
2020,100858,0,0,1428,842,586
2020,100858,10,0,1428,842,586
2020,100858,10,1,406,297,109
2020,100858,10,2,386,221,165
2020,100858,10,3,377,205,172
2020,100858,10,4,74,34,40
2020,100858,10,5,171,77,94
2020,100858,10,6,14,8,6
2020,100858,20,0,710,481,229
2020,100858,20,1,389,293,96
2020,100858,20,2,321,188,133
2020,100858,30,0,351,210,141
2020,100858,30,1,5,3,2
2020,100858,30,2,24,17,7
2020,100858,30,3,322,190,132
2020,100858,40,0,367,151,216
2020,100858,40,1,12,1,11
2020,100858,40,2,41,16,25
2020,100858,40,3,55,15,40
2020,100858,40,4,74,34,40
2020,100858,40,5,171,77,94
2020,100858,40,6,14,8,6
2020,100858,43,0,367,151,216
2020,100858,43,1,12,1,11
2020,100858,43,2,41,16,25
2020,100858,43,3,55,15,40
2020,100858,43,4,74,34,40
2020,100858,43,5,171,77,94
2020,100858,43,6,14,8,6
2020,100937,0,0,102,54,48
2020,100937,10,0,102,54,48
2020,100937,10,1,38,28,10
2020,100937,10,2,23,13,10
2020,100937,10,3,26,8,18
2020,100937,10,4,2,1,1
2020,100937,10,5,13,4,9
2020,100937,20,0,60,40,20
2020,100937,20,1,38,28,10
2020,100937,20,2,22,12,10
2020,100937,30,0,22,6,16
2020,100937,30,2,1,1,0
2020,100937,30,3,21,5,16
2020,100937,40,0,20,8,12
2020,100937,40,3,5,3,2
2020,100937,40,4,2,1,1
2020,100937,40,5,13,4,9
2020,100937,42,0,20,8,12
2020,100937,42,3,5,3,2
2020,100937,42,4,2,1,1
2020,100937,42,5,13,4,9
2020,101028,0,0,42,16,26
2020,101028,10,0,42,16,26
2020,101028,10,6,42,16,26
2020,101028,20,0,29,10,19
2020,101028,20,6,29,10,19
2020,101028,30,0,12,5,7
2020,101028,30,6,12,5,7
2020,101028,40,0,1,1,0
2020,101028,40,6,1,1,0
2020,101028,43,0,1,1,0
2020,101028,43,6,1,1,0
2020,101116,0,0,4,1,3
2020,101116,10,0,4,1,3
2020,101116,10,4,4,1,3
2020,101116,40,0,4,1,3
2020,101116,40,4,4,1,3
2020,101116,41,0,4,1,3
2020,101116,41,4,4,1,3
2020,101116,45,0,4,1,3
2020,101116,45,4,4,1,3
2020,101143,0,0,54,30,24
2020,101143,10,0,54,30,24
2020,101143,10,6,54,30,24
2020,101143,20,0,34,16,18
2020,101143,20,6,34,16,18
2020,101143,30,0,18,13,5
2020,101143,30,6,18,13,5
2020,101143,40,0,2,1,1
2020,101143,40,6,2,1,1
2020,101143,41,0,2,1,1
2020,101143,41,6,2,1,1
2020,101143,45,0,2,1,1
2020,101143,45,6,2,1,1
2020,101161,0,0,169,80,89
2020,101161,10,0,169,80,89
2020,101161,10,6,169,80,89
2020,101161,20,0,130,60,70
2020,101161,20,6,130,60,70
2020,101161,30,0,37,19,18
2020,101161,30,6,37,19,18
2020,101161,40,0,2,1,1
2020,101161,40,6,2,1,1
2020,101161,42,0,2,1,1
2020,101161,42,6,2,1,1
2020,101189,0,0,122,65,57
2020,101189,10,0,122,65,57
2020,101189,10,1,38,26,12
2020,101189,10,2,24,17,7
2020,101189,10,3,31,10,21
2020,101189,10,4,3,1,2
2020,101189,10,5,25,11,14
2020,101189,10,6,1,0,1
2020,101189,20,0,45,34,11
2020,101189,20,1,34,25,9
2020,101189,20,2,10,8,2
2020,101189,20,3,1,1,0
2020,101189,30,0,47,17,30
2020,101189,30,1,4,1,3
2020,101189,30,2,11,7,4
2020,101189,30,3,29,9,20
2020,101189,30,4,2,0,2
2020,101189,30,6,1,0,1
2020,101189,40,0,30,14,16
2020,101189,40,2,3,2,1
2020,101189,40,3,1,0,1
2020,101189,40,4,1,1,0
2020,101189,40,5,25,11,14
2020,101189,42,0,30,14,16
2020,101189,42,2,3,2,1
2020,101189,42,3,1,0,1
2020,101189,42,4,1,1,0
2020,101189,42,5,25,11,14
2020,101240,0,0,129,59,70
2020,101240,10,0,129,59,70
2020,101240,10,6,129,59,70
2020,101240,20,0,109,51,58
2020,101240,20,6,109,51,58
2020,101240,30,0,16,8,8
2020,101240,30,6,16,8,8
2020,101240,40,0,4,0,4
2020,101240,40,6,4,0,4
2020,101240,42,0,4,0,4
2020,101240,42,6,4,0,4
2020,101286,0,0,129,44,85
2020,101286,10,0,129,44,85
2020,101286,10,6,129,44,85
2020,101286,20,0,104,32,72
2020,101286,20,6,104,32,72
2020,101286,30,0,24,11,13
2020,101286,30,6,24,11,13
2020,101286,40,0,1,1,0
2020,101286,40,6,1,1,0
2020,101286,43,0,1,1,0
2020,101286,43,6,1,1,0
2020,101295,0,0,123,46,77
2020,101295,10,0,123,46,77
2020,101295,10,6,123,46,77
2020,101295,20,0,80,26,54
2020,101295,20,6,80,26,54
2020,101295,30,0,42,20,22
2020,101295,30,6,42,20,22
2020,101295,40,0,1,0,1
2020,101295,40,6,1,0,1
2020,101295,43,0,1,0,1
2020,101295,43,6,1,0,1
2020,101301,0,0,48,15,33
2020,101301,10,0,48,15,33
2020,101301,10,6,48,15,33
2020,101301,20,0,17,6,11
2020,101301,20,6,17,6,11
2020,101301,30,0,22,8,14
2020,101301,30,6,22,8,14
2020,101301,40,0,9,1,8
2020,101301,40,6,9,1,8
2020,101301,42,0,8,1,7
2020,101301,42,6,8,1,7
2020,101301,43,0,1,0,1
2020,101301,43,6,1,0,1
2020,101365,0,0,15,2,13
2020,101365,10,0,15,2,13
2020,101365,10,1,1,0,1
2020,101365,10,3,6,1,5
2020,101365,10,4,8,1,7
2020,101365,40,0,15,2,13
2020,101365,40,1,1,0,1
2020,101365,40,3,6,1,5
2020,101365,40,4,8,1,7
2020,101365,41,0,15,2,13
2020,101365,41,1,1,0,1
2020,101365,41,3,6,1,5
2020,101365,41,4,8,1,7
2020,101365,45,0,15,2,13
2020,101365,45,1,1,0,1
2020,101365,45,3,6,1,5
2020,101365,45,4,8,1,7
2020,101435,0,0,52,28,24
2020,101435,10,0,52,28,24
2020,101435,10,1,18,12,6
2020,101435,10,2,7,3,4
2020,101435,10,3,20,10,10
2020,101435,10,4,7,3,4
2020,101435,20,0,21,14,7
2020,101435,20,1,17,12,5
2020,101435,20,2,4,2,2
2020,101435,30,0,16,6,10
2020,101435,30,3,16,6,10
2020,101435,40,0,15,8,7
2020,101435,40,1,1,0,1
2020,101435,40,2,3,1,2
2020,101435,40,3,4,4,0
2020,101435,40,4,7,3,4
2020,101435,41,0,3,1,2
2020,101435,41,2,2,1,1
2020,101435,41,4,1,0,1
2020,101435,42,0,12,7,5
2020,101435,42,1,1,0,1
2020,101435,42,2,1,0,1
2020,101435,42,3,4,4,0
2020,101435,42,4,6,3,3
2020,101435,44,0,3,1,2
2020,101435,44,2,2,1,1
2020,101435,44,4,1,0,1
2020,101453,0,0,6,6,0
2020,101453,10,0,6,6,0
2020,101453,10,6,6,6,0
2020,101453,40,0,6,6,0
2020,101453,40,6,6,6,0
2020,101453,42,0,6,6,0
2020,101453,42,6,6,6,0
2020,101462,0,0,24,12,12
2020,101462,10,0,24,12,12
2020,101462,10,6,24,12,12
2020,101462,20,0,10,6,4
2020,101462,20,6,10,6,4
2020,101462,30,0,11,5,6
2020,101462,30,6,11,5,6
2020,101462,40,0,3,1,2
2020,101462,40,6,3,1,2
2020,101462,42,0,3,1,2
2020,101462,42,6,3,1,2
2020,101471,0,0,34,26,8
2020,101471,10,0,34,26,8
2020,101471,10,6,34,26,8
2020,101471,20,0,29,21,8
2020,101471,20,6,29,21,8
2020,101471,30,0,5,5,0
2020,101471,30,6,5,5,0
2020,101480,0,0,348,176,172
2020,101480,10,0,348,176,172
2020,101480,10,1,92,61,31
2020,101480,10,2,66,36,30
2020,101480,10,3,106,49,57
2020,101480,10,4,84,30,54
2020,101480,20,0,139,86,53
2020,101480,20,1,86,57,29
2020,101480,20,2,53,29,24
2020,101480,30,0,150,68,82
2020,101480,30,1,6,4,2
2020,101480,30,2,13,7,6
2020,101480,30,3,106,49,57
2020,101480,30,4,25,8,17
2020,101480,40,0,59,22,37
2020,101480,40,4,59,22,37
2020,101480,42,0,59,22,37
2020,101480,42,4,59,22,37
2020,101505,0,0,131,49,82
2020,101505,10,0,131,49,82
2020,101505,10,6,131,49,82
2020,101505,20,0,106,34,72
2020,101505,20,6,106,34,72
2020,101505,30,0,13,9,4
2020,101505,30,6,13,9,4
2020,101505,40,0,12,6,6
2020,101505,40,6,12,6,6
2020,101505,42,0,11,5,6
2020,101505,42,6,11,5,6
2020,101505,43,0,1,1,0
2020,101505,43,6,1,1,0
2020,101514,0,0,153,66,87
2020,101514,10,0,153,66,87
2020,101514,10,6,153,66,87
2020,101514,20,0,109,45,64
2020,101514,20,6,109,45,64
2020,101514,30,0,35,17,18
2020,101514,30,6,35,17,18
2020,101514,40,0,9,4,5
2020,101514,40,6,9,4,5
2020,101514,42,0,9,4,5
2020,101514,42,6,9,4,5
2020,101541,0,0,23,5,18
2020,101541,10,0,23,5,18
2020,101541,10,1,2,1,1
2020,101541,10,2,6,1,5
2020,101541,10,3,14,3,11
2020,101541,10,4,1,0,1
2020,101541,20,0,3,1,2
2020,101541,20,1,2,1,1
2020,101541,20,2,1,0,1
2020,101541,30,0,20,4,16
2020,101541,30,2,5,1,4
2020,101541,30,3,14,3,11
2020,101541,30,4,1,0,1
2020,101569,0,0,79,38,41
2020,101569,10,0,79,38,41
2020,101569,10,6,79,38,41
2020,101569,20,0,65,32,33
2020,101569,20,6,65,32,33
2020,101569,30,0,13,5,8
2020,101569,30,6,13,5,8
2020,101569,40,0,1,1,0
2020,101569,40,6,1,1,0
2020,101569,42,0,1,1,0
2020,101569,42,6,1,1,0
2020,101587,0,0,114,48,66
2020,101587,10,0,114,48,66
2020,101587,10,1,26,16,10
2020,101587,10,2,32,12,20
2020,101587,10,3,33,11,22
2020,101587,10,4,19,8,11
2020,101587,10,5,4,1,3
2020,101587,20,0,55,27,28
2020,101587,20,1,22,13,9
2020,101587,20,2,24,9,15
2020,101587,20,3,9,5,4
2020,101587,30,0,23,11,12
2020,101587,30,1,4,3,1
2020,101587,30,2,5,3,2
2020,101587,30,3,14,5,9
2020,101587,40,0,36,10,26
2020,101587,40,2,3,0,3
2020,101587,40,3,10,1,9
2020,101587,40,4,19,8,11
2020,101587,40,5,4,1,3
2020,101587,42,0,36,10,26
2020,101587,42,2,3,0,3
2020,101587,42,3,10,1,9
2020,101587,42,4,19,8,11
2020,101587,42,5,4,1,3
2020,101602,0,0,54,20,34
2020,101602,10,0,54,20,34
2020,101602,10,6,54,20,34
2020,101602,20,0,40,14,26
2020,101602,20,6,40,14,26
2020,101602,30,0,12,5,7
2020,101602,30,6,12,5,7
2020,101602,40,0,2,1,1
2020,101602,40,6,2,1,1
2020,101602,42,0,2,1,1
2020,101602,42,6,2,1,1
2020,101648,0,0,22,12,10
2020,101648,10,0,22,12,10
2020,101648,10,6,22,12,10
2020,101648,20,0,14,8,6
2020,101648,20,6,14,8,6
2020,101648,30,0,7,3,4
2020,101648,30,6,7,3,4
2020,101648,40,0,1,1,0
2020,101648,40,6,1,1,0
2020,101648,43,0,1,1,0
2020,101648,43,6,1,1,0
2020,101675,0,0,83,34,49
2020,101675,10,0,83,34,49
2020,101675,10,1,11,8,3
2020,101675,10,2,5,3,2
2020,101675,10,3,15,4,11
2020,101675,10,4,52,19,33
2020,101675,20,0,7,5,2
2020,101675,20,1,7,5,2
2020,101675,30,0,76,29,47
2020,101675,30,1,4,3,1
2020,101675,30,2,5,3,2
2020,101675,30,3,15,4,11
2020,101675,30,4,52,19,33
2020,101693,0,0,68,28,40
2020,101693,10,0,68,28,40
2020,101693,10,1,12,8,4
2020,101693,10,2,23,8,15
2020,101693,10,3,27,9,18
2020,101693,10,4,6,3,3
2020,101693,20,0,7,7,0
2020,101693,20,1,6,6,0
2020,101693,20,2,1,1,0
2020,101693,30,0,55,18,37
2020,101693,30,1,6,2,4
2020,101693,30,2,22,7,15
2020,101693,30,3,27,9,18
2020,101693,40,0,6,3,3
2020,101693,40,4,6,3,3
2020,101693,42,0,6,3,3
2020,101693,42,4,6,3,3
2020,101709,0,0,142,71,71
2020,101709,10,0,142,71,71
2020,101709,10,1,42,26,16
2020,101709,10,2,54,27,27
2020,101709,10,3,32,14,18
2020,101709,10,4,14,4,10
2020,101709,20,0,97,53,44
2020,101709,20,1,41,25,16
2020,101709,20,2,54,27,27
2020,101709,20,3,2,1,1
2020,101709,30,0,30,13,17
2020,101709,30,3,30,13,17
2020,101709,40,0,15,5,10
2020,101709,40,1,1,1,0
2020,101709,40,4,14,4,10
2020,101709,41,0,15,5,10
2020,101709,41,1,1,1,0
2020,101709,41,4,14,4,10
2020,101709,45,0,15,5,10
2020,101709,45,1,1,1,0
2020,101709,45,4,14,4,10
2020,101736,0,0,74,35,39
2020,101736,10,0,74,35,39
2020,101736,10,6,74,35,39
2020,101736,20,0,56,25,31
2020,101736,20,6,56,25,31
2020,101736,30,0,17,9,8
2020,101736,30,6,17,9,8
2020,101736,40,0,1,1,0
2020,101736,40,6,1,1,0
2020,101736,43,0,1,1,0
2020,101736,43,6,1,1,0
2020,101879,0,0,272,138,134
2020,101879,10,0,272,138,134
2020,101879,10,1,80,47,33
2020,101879,10,2,68,39,29
2020,101879,10,3,71,34,37
2020,101879,10,5,53,18,35
2020,101879,20,0,143,78,65
2020,101879,20,1,78,45,33
2020,101879,20,2,59,32,27
2020,101879,20,3,6,1,5
2020,101879,30,0,74,41,33
2020,101879,30,1,2,2,0
2020,101879,30,2,9,7,2
2020,101879,30,3,63,32,31
2020,101879,40,0,55,19,36
2020,101879,40,3,2,1,1
2020,101879,40,5,53,18,35
2020,101879,41,0,18,4,14
2020,101879,41,3,1,1,0
2020,101879,41,5,17,3,14
2020,101879,42,0,37,15,22
2020,101879,42,3,1,0,1
2020,101879,42,5,36,15,21
2020,101879,44,0,18,4,14
2020,101879,44,3,1,1,0
2020,101879,44,5,17,3,14
2020,101897,0,0,56,23,33
2020,101897,10,0,56,23,33
2020,101897,10,6,56,23,33
2020,101897,40,0,56,23,33
2020,101897,40,6,56,23,33
2020,101897,42,0,56,23,33
2020,101897,42,6,56,23,33
2020,101912,0,0,105,58,47
2020,101912,10,0,105,58,47
2020,101912,10,1,15,13,2
2020,101912,10,2,39,20,19
2020,101912,10,3,47,24,23
2020,101912,10,6,4,1,3
2020,101912,20,0,8,6,2
2020,101912,20,1,3,2,1
2020,101912,20,2,5,4,1
2020,101912,30,0,49,31,18
2020,101912,30,1,11,10,1
2020,101912,30,2,19,10,9
2020,101912,30,3,19,11,8
2020,101912,40,0,48,21,27
2020,101912,40,1,1,1,0
2020,101912,40,2,15,6,9
2020,101912,40,3,28,13,15
2020,101912,40,6,4,1,3
2020,101912,42,0,27,15,12
2020,101912,42,1,1,1,0
2020,101912,42,2,6,2,4
2020,101912,42,3,16,11,5
2020,101912,42,6,4,1,3
2020,101912,43,0,21,6,15
2020,101912,43,2,9,4,5
2020,101912,43,3,12,2,10
2020,101994,0,0,15,6,9
2020,101994,10,0,15,6,9
2020,101994,10,6,15,6,9
2020,101994,20,0,12,6,6
2020,101994,20,6,12,6,6
2020,101994,30,0,3,0,3
2020,101994,30,6,3,0,3
2020,102030,0,0,59,21,38
2020,102030,10,0,59,21,38
2020,102030,10,6,59,21,38
2020,102030,20,0,49,16,33
2020,102030,20,6,49,16,33
2020,102030,30,0,10,5,5
2020,102030,30,6,10,5,5
2020,102049,0,0,362,175,187
2020,102049,10,0,362,175,187
2020,102049,10,1,135,86,49
2020,102049,10,2,77,36,41
2020,102049,10,3,125,49,76
2020,102049,10,4,25,4,21
2020,102049,20,0,180,113,67
2020,102049,20,1,124,82,42
2020,102049,20,2,53,29,24
2020,102049,20,3,3,2,1
2020,102049,30,0,89,40,49
2020,102049,30,1,2,2,0
2020,102049,30,2,13,4,9
2020,102049,30,3,74,34,40
2020,102049,40,0,93,22,71
2020,102049,40,1,9,2,7
2020,102049,40,2,11,3,8
2020,102049,40,3,48,13,35
2020,102049,40,4,25,4,21
2020,102049,42,0,42,10,32
2020,102049,42,1,7,1,6
2020,102049,42,2,8,1,7
2020,102049,42,3,19,8,11
2020,102049,42,4,8,0,8
2020,102049,43,0,51,12,39
2020,102049,43,1,2,1,1
2020,102049,43,2,3,2,1
2020,102049,43,3,29,5,24
2020,102049,43,4,17,4,13
2020,102067,0,0,99,45,54
2020,102067,10,0,99,45,54
2020,102067,10,6,99,45,54
2020,102067,20,0,76,37,39
2020,102067,20,6,76,37,39
2020,102067,30,0,19,8,11
2020,102067,30,6,19,8,11
2020,102067,40,0,4,0,4
2020,102067,40,6,4,0,4
2020,102067,42,0,4,0,4
2020,102067,42,6,4,0,4
2020,102076,0,0,36,18,18
2020,102076,10,0,36,18,18
2020,102076,10,6,36,18,18
2020,102076,20,0,33,18,15
2020,102076,20,6,33,18,15
2020,102076,30,0,3,0,3
2020,102076,30,6,3,0,3
2020,102094,0,0,801,421,380
2020,102094,10,0,801,421,380
2020,102094,10,1,163,126,37
2020,102094,10,2,178,100,78
2020,102094,10,3,338,161,177
2020,102094,10,4,121,34,87
2020,102094,10,5,1,0,1
2020,102094,20,0,253,171,82
2020,102094,20,1,133,103,30
2020,102094,20,2,116,66,50
2020,102094,20,3,4,2,2
2020,102094,30,0,123,69,54
2020,102094,30,1,2,2,0
2020,102094,30,2,11,6,5
2020,102094,30,3,110,61,49
2020,102094,40,0,425,181,244
2020,102094,40,1,28,21,7
2020,102094,40,2,51,28,23
2020,102094,40,3,224,98,126
2020,102094,40,4,121,34,87
2020,102094,40,5,1,0,1
2020,102094,42,0,425,181,244
2020,102094,42,1,28,21,7
2020,102094,42,2,51,28,23
2020,102094,42,3,224,98,126
2020,102094,42,4,121,34,87
2020,102094,42,5,1,0,1
2020,102234,0,0,77,40,37
2020,102234,10,0,77,40,37
2020,102234,10,1,13,7,6
2020,102234,10,2,34,19,15
2020,102234,10,3,24,13,11
2020,102234,10,4,6,1,5
2020,102234,20,0,42,25,17
2020,102234,20,1,11,7,4
2020,102234,20,2,31,18,13
2020,102234,30,0,20,10,10
2020,102234,30,1,1,0,1
2020,102234,30,2,2,1,1
2020,102234,30,3,17,9,8
2020,102234,40,0,15,5,10
2020,102234,40,1,1,0,1
2020,102234,40,2,1,0,1
2020,102234,40,3,7,4,3
2020,102234,40,4,6,1,5
2020,102234,42,0,15,5,10
2020,102234,42,1,1,0,1
2020,102234,42,2,1,0,1
2020,102234,42,3,7,4,3
2020,102234,42,4,6,1,5
2020,102270,0,0,43,19,24
2020,102270,10,0,43,19,24
2020,102270,10,1,2,1,1
2020,102270,10,2,15,9,6
2020,102270,10,3,21,8,13
2020,102270,10,4,5,1,4
2020,102270,20,0,15,7,8
2020,102270,20,1,2,1,1
2020,102270,20,2,11,6,5
2020,102270,20,3,2,0,2
2020,102270,30,0,28,12,16
2020,102270,30,2,4,3,1
2020,102270,30,3,19,8,11
2020,102270,30,4,5,1,4
2020,102298,0,0,41,21,20
2020,102298,10,0,41,21,20
2020,102298,10,1,2,2,0
2020,102298,10,2,10,7,3
2020,102298,10,3,25,12,13
2020,102298,10,4,4,0,4
2020,102298,20,0,5,4,1
2020,102298,20,1,2,2,0
2020,102298,20,2,3,2,1
2020,102298,30,0,36,17,19
2020,102298,30,2,7,5,2
2020,102298,30,3,25,12,13
2020,102298,30,4,4,0,4
2020,102313,0,0,51,28,23
2020,102313,10,0,51,28,23
2020,102313,10,6,51,28,23
2020,102313,20,0,35,20,15
2020,102313,20,6,35,20,15
2020,102313,30,0,16,8,8
2020,102313,30,6,16,8,8
2020,102368,0,0,482,235,247
2020,102368,10,0,482,235,247
2020,102368,10,1,58,46,12
2020,102368,10,2,154,88,66
2020,102368,10,3,123,49,74
2020,102368,10,5,142,47,95
2020,102368,10,6,5,5,0
2020,102368,20,0,228,138,90
2020,102368,20,1,57,45,12
2020,102368,20,2,143,81,62
2020,102368,20,3,27,11,16
2020,102368,20,6,1,1,0
2020,102368,30,0,105,44,61
2020,102368,30,2,11,7,4
2020,102368,30,3,94,37,57
2020,102368,40,0,149,53,96
2020,102368,40,1,1,1,0
2020,102368,40,3,2,1,1
2020,102368,40,5,142,47,95
2020,102368,40,6,4,4,0
2020,102368,41,0,149,53,96
2020,102368,41,1,1,1,0
2020,102368,41,3,2,1,1
2020,102368,41,5,142,47,95
2020,102368,41,6,4,4,0
2020,102368,45,0,149,53,96
2020,102368,45,1,1,1,0
2020,102368,45,3,2,1,1
2020,102368,45,5,142,47,95
2020,102368,45,6,4,4,0
2020,102377,0,0,236,132,104
2020,102377,10,0,236,132,104
2020,102377,10,1,52,40,12
2020,102377,10,2,83,44,39
2020,102377,10,3,86,42,44
2020,102377,10,4,13,5,8
2020,102377,10,5,2,1,1
2020,102377,20,0,107,68,39
2020,102377,20,1,48,36,12
2020,102377,20,2,53,29,24
2020,102377,20,3,6,3,3
2020,102377,30,0,69,39,30
2020,102377,30,1,2,2,0
2020,102377,30,2,13,8,5
2020,102377,30,3,53,29,24
2020,102377,30,4,1,0,1
2020,102377,40,0,60,25,35
2020,102377,40,1,2,2,0
2020,102377,40,2,17,7,10
2020,102377,40,3,27,10,17
2020,102377,40,4,12,5,7
2020,102377,40,5,2,1,1
2020,102377,42,0,60,25,35
2020,102377,42,1,2,2,0
2020,102377,42,2,17,7,10
2020,102377,42,3,27,10,17
2020,102377,42,4,12,5,7
2020,102377,42,5,2,1,1
2020,102395,0,0,7,5,2
2020,102395,10,0,7,5,2
2020,102395,10,2,4,4,0
2020,102395,10,3,1,0,1
2020,102395,10,5,2,1,1
2020,102395,40,0,7,5,2
2020,102395,40,2,4,4,0
2020,102395,40,3,1,0,1
2020,102395,40,5,2,1,1
2020,102395,41,0,7,5,2
2020,102395,41,2,4,4,0
2020,102395,41,3,1,0,1
2020,102395,41,5,2,1,1
2020,102395,45,0,7,5,2
2020,102395,45,2,4,4,0
2020,102395,45,3,1,0,1
2020,102395,45,5,2,1,1
2020,102429,0,0,108,54,54
2020,102429,10,0,107,53,54
2020,102429,10,6,107,53,54
2020,102429,20,0,93,46,47
2020,102429,20,6,93,46,47
2020,102429,30,0,14,7,7
2020,102429,30,6,14,7,7
2020,102429,50,0,1,1,0
2020,102553,0,0,411,196,215
2020,102553,10,0,411,196,215
2020,102553,10,1,112,59,53
2020,102553,10,2,102,60,42
2020,102553,10,3,172,70,102
2020,102553,10,4,25,7,18
2020,102553,20,0,205,114,91
2020,102553,20,1,110,58,52
2020,102553,20,2,94,55,39
2020,102553,20,3,1,1,0
2020,102553,30,0,100,38,62
2020,102553,30,1,1,0,1
2020,102553,30,2,5,2,3
2020,102553,30,3,94,36,58
2020,102553,40,0,106,44,62
2020,102553,40,1,1,1,0
2020,102553,40,2,3,3,0
2020,102553,40,3,77,33,44
2020,102553,40,4,25,7,18
2020,102553,41,0,3,1,2
2020,102553,41,3,2,0,2
2020,102553,41,4,1,1,0
2020,102553,42,0,101,43,58
2020,102553,42,1,1,1,0
2020,102553,42,2,3,3,0
2020,102553,42,3,74,33,41
2020,102553,42,4,23,6,17
2020,102553,43,0,2,0,2
2020,102553,43,3,1,0,1
2020,102553,43,4,1,0,1
2020,102553,44,0,3,1,2
2020,102553,44,3,2,0,2
2020,102553,44,4,1,1,0
2020,102614,0,0,289,161,128
2020,102614,10,0,289,161,128
2020,102614,10,1,80,53,27
2020,102614,10,2,91,50,41
2020,102614,10,3,87,42,45
2020,102614,10,4,26,14,12
2020,102614,10,5,1,0,1
2020,102614,10,6,4,2,2
2020,102614,20,0,163,100,63
2020,102614,20,1,80,53,27
2020,102614,20,2,82,47,35
2020,102614,20,3,1,0,1
2020,102614,30,0,42,21,21
2020,102614,30,2,2,1,1
2020,102614,30,3,40,20,20
2020,102614,40,0,84,40,44
2020,102614,40,2,7,2,5
2020,102614,40,3,46,22,24
2020,102614,40,4,26,14,12
2020,102614,40,5,1,0,1
2020,102614,40,6,4,2,2
2020,102614,41,0,3,1,2
2020,102614,41,3,2,0,2
2020,102614,41,4,1,1,0
2020,102614,42,0,24,11,13
2020,102614,42,3,17,6,11
2020,102614,42,4,5,3,2
2020,102614,42,6,2,2,0
2020,102614,43,0,57,28,29
2020,102614,43,2,7,2,5
2020,102614,43,3,27,16,11
2020,102614,43,4,20,10,10
2020,102614,43,5,1,0,1
2020,102614,43,6,2,0,2
2020,102614,44,0,3,1,2
2020,102614,44,3,2,0,2
2020,102614,44,4,1,1,0
2020,102632,0,0,87,49,38
2020,102632,10,0,87,49,38
2020,102632,10,1,17,12,5
2020,102632,10,2,28,12,16
2020,102632,10,3,41,25,16
2020,102632,10,4,1,0,1
2020,102632,20,0,42,24,18
2020,102632,20,1,16,12,4
2020,102632,20,2,25,11,14
2020,102632,20,3,1,1,0
2020,102632,30,0,15,9,6
2020,102632,30,3,15,9,6
2020,102632,40,0,30,16,14
2020,102632,40,1,1,0,1
2020,102632,40,2,3,1,2
2020,102632,40,3,25,15,10
2020,102632,40,4,1,0,1
2020,102632,41,0,8,5,3
2020,102632,41,1,1,0,1
2020,102632,41,2,1,1,0
2020,102632,41,3,6,4,2
2020,102632,42,0,18,9,9
2020,102632,42,2,2,0,2
2020,102632,42,3,16,9,7
2020,102632,43,0,4,2,2
2020,102632,43,3,3,2,1
2020,102632,43,4,1,0,1
2020,102632,44,0,3,1,2
2020,102632,44,3,3,1,2
2020,102632,45,0,5,4,1
2020,102632,45,1,1,0,1
2020,102632,45,2,1,1,0
2020,102632,45,3,3,3,0
2020,102669,0,0,49,21,28
2020,102669,10,0,49,21,28
2020,102669,10,1,8,5,3
2020,102669,10,2,12,5,7
2020,102669,10,3,21,8,13
2020,102669,10,4,8,3,5
2020,102669,40,0,49,21,28
2020,102669,40,1,8,5,3
2020,102669,40,2,12,5,7
2020,102669,40,3,21,8,13
2020,102669,40,4,8,3,5
2020,102669,41,0,33,14,19
2020,102669,41,1,6,5,1
2020,102669,41,2,11,5,6
2020,102669,41,3,16,4,12
2020,102669,42,0,16,7,9
2020,102669,42,1,2,0,2
2020,102669,42,2,1,0,1
2020,102669,42,3,5,4,1
2020,102669,42,4,8,3,5
2020,102669,44,0,33,14,19
2020,102669,44,1,6,5,1
2020,102669,44,2,11,5,6
2020,102669,44,3,16,4,12
2020,102845,0,0,82,33,49
2020,102845,10,0,82,33,49
2020,102845,10,4,82,33,49
2020,102845,40,0,82,33,49
2020,102845,40,4,82,33,49
2020,102845,41,0,82,33,49
2020,102845,41,4,82,33,49
2020,102845,45,0,82,33,49
2020,102845,45,4,82,33,49
2020,103501,0,0,5,2,3
2020,103501,10,0,5,2,3
2020,103501,10,4,5,2,3
2020,103501,40,0,5,2,3
2020,103501,40,4,5,2,3
2020,103501,42,0,5,2,3
2020,103501,42,4,5,2,3
2020,103893,0,0,22,4,18
2020,103893,10,0,22,4,18
2020,103893,10,4,22,4,18
2020,103893,40,0,22,4,18
2020,103893,40,4,22,4,18
2020,103893,41,0,22,4,18
2020,103893,41,4,22,4,18
2020,103893,45,0,22,4,18
2020,103893,45,4,22,4,18
2020,103909,0,0,15,0,15
2020,103909,10,0,15,0,15
2020,103909,10,4,15,0,15
2020,103909,40,0,15,0,15
2020,103909,40,4,15,0,15
2020,103909,41,0,15,0,15
2020,103909,41,4,15,0,15
2020,103909,45,0,15,0,15
2020,103909,45,4,15,0,15
2020,103927,0,0,8,0,8
2020,103927,10,0,8,0,8
2020,103927,10,4,8,0,8
2020,103927,40,0,8,0,8
2020,103927,40,4,8,0,8
2020,103927,41,0,8,0,8
2020,103927,41,4,8,0,8
2020,103927,45,0,8,0,8
2020,103927,45,4,8,0,8
2020,104090,0,0,24,7,17
2020,104090,10,0,24,7,17
2020,104090,10,4,24,7,17
2020,104090,40,0,24,7,17
2020,104090,40,4,24,7,17
2020,104090,41,0,24,7,17
2020,104090,41,4,24,7,17
2020,104090,45,0,24,7,17
2020,104090,45,4,24,7,17
2020,104151,0,0,3176,1679,1497
2020,104151,10,0,3176,1679,1497
2020,104151,10,1,825,553,272
2020,104151,10,2,754,421,333
2020,104151,10,3,684,313,371
2020,104151,10,4,352,140,212
2020,104151,10,5,559,250,309
2020,104151,10,6,2,2,0
2020,104151,20,0,1330,848,482
2020,104151,20,1,699,487,212
2020,104151,20,2,631,361,270
2020,104151,30,0,484,253,231
2020,104151,30,2,20,15,5
2020,104151,30,3,464,238,226
2020,104151,40,0,1362,578,784
2020,104151,40,1,126,66,60
2020,104151,40,2,103,45,58
2020,104151,40,3,220,75,145
2020,104151,40,4,352,140,212
2020,104151,40,5,559,250,309
2020,104151,40,6,2,2,0
2020,104151,41,0,203,97,106
2020,104151,41,1,32,20,12
2020,104151,41,2,19,12,7
2020,104151,41,3,7,4,3
2020,104151,41,5,145,61,84
2020,104151,42,0,1159,481,678
2020,104151,42,1,94,46,48
2020,104151,42,2,84,33,51
2020,104151,42,3,213,71,142
2020,104151,42,4,352,140,212
2020,104151,42,5,414,189,225
2020,104151,42,6,2,2,0
2020,104151,44,0,203,97,106
2020,104151,44,1,32,20,12
2020,104151,44,2,19,12,7
2020,104151,44,3,7,4,3
2020,104151,44,5,145,61,84
2020,104160,0,0,118,62,56
2020,104160,10,0,118,62,56
2020,104160,10,6,118,62,56
2020,104160,40,0,118,62,56
2020,104160,40,6,118,62,56
2020,104160,42,0,118,62,56
2020,104160,42,6,118,62,56
2020,104179,0,0,2077,1199,878
2020,104179,10,0,2056,1191,865
2020,104179,10,1,784,532,252
2020,104179,10,2,524,299,225
2020,104179,10,3,497,235,262
2020,104179,10,4,71,33,38
2020,104179,10,5,179,91,88
2020,104179,10,6,1,1,0
2020,104179,20,0,1146,753,393
2020,104179,20,1,726,499,227
2020,104179,20,2,419,253,166
2020,104179,20,6,1,1,0
2020,104179,30,0,370,203,167
2020,104179,30,1,2,1,1
2020,104179,30,2,27,17,10
2020,104179,30,3,341,185,156
2020,104179,40,0,540,235,305
2020,104179,40,1,56,32,24
2020,104179,40,2,78,29,49
2020,104179,40,3,156,50,106
2020,104179,40,4,71,33,38
2020,104179,40,5,179,91,88
2020,104179,41,0,99,51,48
2020,104179,41,1,10,5,5
2020,104179,41,2,15,7,8
2020,104179,41,3,19,6,13
2020,104179,41,5,55,33,22
2020,104179,42,0,441,184,257
2020,104179,42,1,46,27,19
2020,104179,42,2,63,22,41
2020,104179,42,3,137,44,93
2020,104179,42,4,71,33,38
2020,104179,42,5,124,58,66
2020,104179,44,0,99,51,48
2020,104179,44,1,10,5,5
2020,104179,44,2,15,7,8
2020,104179,44,3,19,6,13
2020,104179,44,5,55,33,22
2020,104179,50,0,21,8,13
2020,104346,0,0,96,43,53
2020,104346,10,0,96,43,53
2020,104346,10,1,96,43,53
2020,104346,40,0,96,43,53
2020,104346,40,1,96,43,53
2020,104346,42,0,4,4,0
2020,104346,42,1,4,4,0
2020,104346,43,0,92,39,53
2020,104346,43,1,92,39,53
2020,104425,0,0,97,39,58
2020,104425,10,0,97,39,58
2020,104425,10,6,97,39,58
2020,104425,40,0,97,39,58
2020,104425,40,6,97,39,58
2020,104425,42,0,97,39,58
2020,104425,42,6,97,39,58
2020,104577,0,0,84,52,32
2020,104577,10,0,84,52,32
2020,104577,10,1,18,11,7
2020,104577,10,2,66,41,25
2020,104577,40,0,84,52,32
2020,104577,40,1,18,11,7
2020,104577,40,2,66,41,25
2020,104577,42,0,84,52,32
2020,104577,42,1,18,11,7
2020,104577,42,2,66,41,25
2020,104586,0,0,133,100,33
2020,104586,10,0,133,100,33
2020,104586,10,1,19,15,4
2020,104586,10,2,29,24,5
2020,104586,10,3,69,51,18
2020,104586,10,4,16,10,6
2020,104586,20,0,51,39,12
2020,104586,20,1,19,15,4
2020,104586,20,2,20,16,4
2020,104586,20,3,12,8,4
2020,104586,30,0,48,37,11
2020,104586,30,2,6,5,1
2020,104586,30,3,42,32,10
2020,104586,40,0,34,24,10
2020,104586,40,2,3,3,0
2020,104586,40,3,15,11,4
2020,104586,40,4,16,10,6
2020,104586,42,0,34,24,10
2020,104586,42,2,3,3,0
2020,104586,42,3,15,11,4
2020,104586,42,4,16,10,6
2020,104708,0,0,260,118,142
2020,104708,10,0,259,118,141
2020,104708,10,6,259,118,141
2020,104708,20,0,188,90,98
2020,104708,20,6,188,90,98
2020,104708,30,0,55,22,33
2020,104708,30,6,55,22,33
2020,104708,40,0,16,6,10
2020,104708,40,6,16,6,10
2020,104708,42,0,15,6,9
2020,104708,42,6,15,6,9
2020,104708,43,0,1,0,1
2020,104708,43,6,1,0,1
2020,104708,50,0,1,0,1
2020,104717,0,0,461,217,244
2020,104717,10,0,461,217,244
2020,104717,10,1,15,8,7
2020,104717,10,2,55,30,25
2020,104717,10,3,84,34,50
2020,104717,10,4,296,141,155
2020,104717,10,5,9,4,5
2020,104717,10,6,2,0,2
2020,104717,20,0,4,3,1
2020,104717,20,1,2,2,0
2020,104717,20,2,2,1,1
2020,104717,40,0,457,214,243
2020,104717,40,1,13,6,7
2020,104717,40,2,53,29,24
2020,104717,40,3,84,34,50
2020,104717,40,4,296,141,155
2020,104717,40,5,9,4,5
2020,104717,40,6,2,0,2
2020,104717,41,0,194,81,113
2020,104717,41,1,4,2,2
2020,104717,41,2,18,6,12
2020,104717,41,3,24,6,18
2020,104717,41,4,146,67,79
2020,104717,41,6,2,0,2
2020,104717,42,0,263,133,130
2020,104717,42,1,9,4,5
2020,104717,42,2,35,23,12
2020,104717,42,3,60,28,32
2020,104717,42,4,150,74,76
2020,104717,42,5,9,4,5
2020,104717,44,0,6,3,3
2020,104717,44,1,4,2,2
2020,104717,44,2,2,1,1
2020,104717,45,0,188,78,110
2020,104717,45,2,16,5,11
2020,104717,45,3,24,6,18
2020,104717,45,4,146,67,79
2020,104717,45,6,2,0,2
2020,105145,0,0,108,39,69
2020,105145,10,0,100,36,64
2020,105145,10,6,100,36,64
2020,105145,20,0,54,22,32
2020,105145,20,6,54,22,32
2020,105145,30,0,45,13,32
2020,105145,30,6,45,13,32
2020,105145,40,0,1,1,0
2020,105145,40,6,1,1,0
2020,105145,42,0,1,1,0
2020,105145,42,6,1,1,0
2020,105145,50,0,8,3,5
2020,105154,0,0,289,132,157
2020,105154,10,0,289,132,157
2020,105154,10,6,289,132,157
2020,105154,20,0,216,103,113
2020,105154,20,6,216,103,113
2020,105154,30,0,52,19,33
2020,105154,30,6,52,19,33
2020,105154,40,0,21,10,11
2020,105154,40,6,21,10,11
2020,105154,42,0,18,9,9
2020,105154,42,6,18,9,9
2020,105154,43,0,3,1,2
2020,105154,43,6,3,1,2
2020,105206,0,0,82,35,47
2020,105206,10,0,82,35,47
2020,105206,10,4,82,35,47
2020,105206,40,0,82,35,47
2020,105206,40,4,82,35,47
2020,105206,42,0,82,35,47
2020,105206,42,4,82,35,47
2020,105297,0,0,63,41,22
2020,105297,10,0,63,41,22
2020,105297,10,1,13,9,4
2020,105297,10,2,14,11,3
2020,105297,10,3,12,6,6
2020,105297,10,4,24,15,9
2020,105297,40,0,63,41,22
2020,105297,40,1,13,9,4
2020,105297,40,2,14,11,3
2020,105297,40,3,12,6,6
2020,105297,40,4,24,15,9
2020,105297,41,0,63,41,22
2020,105297,41,1,13,9,4
2020,105297,41,2,14,11,3
2020,105297,41,3,12,6,6
2020,105297,41,4,24,15,9
2020,105297,44,0,63,41,22
2020,105297,44,1,13,9,4
2020,105297,44,2,14,11,3
2020,105297,44,3,12,6,6
2020,105297,44,4,24,15,9
2020,105330,0,0,975,477,498
2020,105330,10,0,975,477,498
2020,105330,10,1,281,166,115
2020,105330,10,2,213,111,102
2020,105330,10,3,254,100,154
2020,105330,10,4,7,2,5
2020,105330,10,5,220,98,122
2020,105330,20,0,404,241,163
2020,105330,20,1,264,161,103
2020,105330,20,2,140,80,60
2020,105330,30,0,129,65,64
2020,105330,30,2,4,4,0
2020,105330,30,3,125,61,64
2020,105330,40,0,442,171,271
2020,105330,40,1,17,5,12
2020,105330,40,2,69,27,42
2020,105330,40,3,129,39,90
2020,105330,40,4,7,2,5
2020,105330,40,5,220,98,122
2020,105330,41,0,31,14,17
2020,105330,41,1,3,1,2
2020,105330,41,2,5,4,1
2020,105330,41,5,23,9,14
2020,105330,42,0,411,157,254
2020,105330,42,1,14,4,10
2020,105330,42,2,64,23,41
2020,105330,42,3,129,39,90
2020,105330,42,4,7,2,5
2020,105330,42,5,197,89,108
2020,105330,44,0,31,14,17
2020,105330,44,1,3,1,2
2020,105330,44,2,5,4,1
2020,105330,44,5,23,9,14
2020,105349,0,0,71,35,36
2020,105349,10,0,70,35,35
2020,105349,10,4,70,35,35
2020,105349,40,0,70,35,35
2020,105349,40,4,70,35,35
2020,105349,42,0,70,35,35
2020,105349,42,4,70,35,35
2020,105349,50,0,1,0,1
2020,105367,0,0,3,1,2
2020,105367,10,0,3,1,2
2020,105367,10,1,1,0,1
2020,105367,10,2,1,0,1
2020,105367,10,3,1,1,0
2020,105367,40,0,3,1,2
2020,105367,40,1,1,0,1
2020,105367,40,2,1,0,1
2020,105367,40,3,1,1,0
2020,105367,42,0,3,1,2
2020,105367,42,1,1,0,1
2020,105367,42,2,1,0,1
2020,105367,42,3,1,1,0
2020,105428,0,0,151,67,84
2020,105428,10,0,148,67,81
2020,105428,10,6,148,67,81
2020,105428,20,0,85,44,41
2020,105428,20,6,85,44,41
2020,105428,30,0,54,21,33
2020,105428,30,6,54,21,33
2020,105428,40,0,9,2,7
2020,105428,40,6,9,2,7
2020,105428,42,0,9,2,7
2020,105428,42,6,9,2,7
2020,105428,50,0,3,0,3
2020,105525,0,0,243,106,137
2020,105525,10,0,243,106,137
2020,105525,10,6,243,106,137
2020,105525,40,0,243,106,137
2020,105525,40,6,243,106,137
2020,105525,42,0,243,106,137
2020,105525,42,6,243,106,137
2020,105534,0,0,61,7,54
2020,105534,10,0,61,7,54
2020,105534,10,4,61,7,54
2020,105534,40,0,61,7,54
2020,105534,40,4,61,7,54
2020,105534,41,0,61,7,54
2020,105534,41,4,61,7,54
2020,105534,45,0,61,7,54
2020,105534,45,4,61,7,54
2020,105543,0,0,43,8,35
2020,105543,10,0,43,8,35
2020,105543,10,4,43,8,35
2020,105543,40,0,43,8,35
2020,105543,40,4,43,8,35
2020,105543,41,0,43,8,35
2020,105543,41,4,43,8,35
2020,105543,45,0,43,8,35
2020,105543,45,4,43,8,35
2020,105589,0,0,50,15,35
2020,105589,10,0,50,15,35
2020,105589,10,2,20,7,13
2020,105589,10,3,5,3,2
2020,105589,10,4,25,5,20
2020,105589,40,0,50,15,35
2020,105589,40,2,20,7,13
2020,105589,40,3,5,3,2
2020,105589,40,4,25,5,20
2020,105589,41,0,24,10,14
2020,105589,41,2,18,7,11
2020,105589,41,3,4,2,2
2020,105589,41,4,2,1,1
2020,105589,42,0,26,5,21
2020,105589,42,2,2,0,2
2020,105589,42,3,1,1,0
2020,105589,42,4,23,4,19
2020,105589,44,0,24,10,14
2020,105589,44,2,18,7,11
2020,105589,44,3,4,2,2
2020,105589,44,4,2,1,1
2020,105659,0,0,24,23,1
2020,105659,10,0,24,23,1
2020,105659,10,4,24,23,1
2020,105659,40,0,24,23,1
2020,105659,40,4,24,23,1
2020,105659,41,0,24,23,1
2020,105659,41,4,24,23,1
2020,105659,45,0,24,23,1
2020,105659,45,4,24,23,1
2020,105668,0,0,44,16,28
2020,105668,10,0,20,5,15
2020,105668,10,6,20,5,15
2020,105668,20,0,15,5,10
2020,105668,20,6,15,5,10
2020,105668,30,0,5,0,5
2020,105668,30,6,5,0,5
2020,105668,50,0,24,11,13
2020,105747,0,0,130,65,65
2020,105747,10,0,130,65,65
2020,105747,10,6,130,65,65
2020,105747,20,0,107,58,49
2020,105747,20,6,107,58,49
2020,105747,30,0,17,6,11
2020,105747,30,6,17,6,11
2020,105747,40,0,6,1,5
2020,105747,40,6,6,1,5
2020,105747,42,0,6,1,5
2020,105747,42,6,6,1,5
2020,105792,0,0,59,28,31
2020,105792,10,0,59,28,31
2020,105792,10,6,59,28,31
2020,105792,20,0,36,18,18
2020,105792,20,6,36,18,18
2020,105792,30,0,16,8,8
2020,105792,30,6,16,8,8
2020,105792,40,0,7,2,5
2020,105792,40,6,7,2,5
2020,105792,42,0,6,2,4
2020,105792,42,6,6,2,4
2020,105792,43,0,1,0,1
2020,105792,43,6,1,0,1
2020,105899,0,0,25,17,8
2020,105899,10,0,25,17,8
2020,105899,10,1,2,1,1
2020,105899,10,2,9,6,3
2020,105899,10,3,12,9,3
2020,105899,10,4,2,1,1
2020,105899,40,0,25,17,8
2020,105899,40,1,2,1,1
2020,105899,40,2,9,6,3
2020,105899,40,3,12,9,3
2020,105899,40,4,2,1,1
2020,105899,42,0,25,17,8
2020,105899,42,1,2,1,1
2020,105899,42,2,9,6,3
2020,105899,42,3,12,9,3
2020,105899,42,4,2,1,1
2020,106041,0,0,45,45,0
2020,106041,50,0,45,45,0
2020,106148,0,0,107,55,52
2020,106148,10,0,107,55,52
2020,106148,10,4,107,55,52
2020,106148,40,0,107,55,52
2020,106148,40,4,107,55,52
2020,106148,42,0,107,55,52
2020,106148,42,4,107,55,52
2020,106245,0,0,372,216,156
2020,106245,10,0,372,216,156
2020,106245,10,1,119,82,37
2020,106245,10,2,94,61,33
2020,106245,10,3,98,47,51
2020,106245,10,4,61,26,35
2020,106245,20,0,208,138,70
2020,106245,20,1,115,81,34
2020,106245,20,2,90,57,33
2020,106245,20,3,3,0,3
2020,106245,30,0,88,48,40
2020,106245,30,1,3,1,2
2020,106245,30,2,3,3,0
2020,106245,30,3,81,43,38
2020,106245,30,4,1,1,0
2020,106245,40,0,76,30,46
2020,106245,40,1,1,0,1
2020,106245,40,2,1,1,0
2020,106245,40,3,14,4,10
2020,106245,40,4,60,25,35
2020,106245,42,0,76,30,46
2020,106245,42,1,1,0,1
2020,106245,42,2,1,1,0
2020,106245,42,3,14,4,10
2020,106245,42,4,60,25,35
2020,106263,0,0,202,80,122
2020,106263,10,0,202,80,122
2020,106263,10,1,40,25,15
2020,106263,10,2,51,23,28
2020,106263,10,3,94,29,65
2020,106263,10,4,17,3,14
2020,106263,20,0,63,32,31
2020,106263,20,1,35,21,14
2020,106263,20,2,27,11,16
2020,106263,20,3,1,0,1
2020,106263,30,0,131,46,85
2020,106263,30,1,5,4,1
2020,106263,30,2,23,12,11
2020,106263,30,3,91,29,62
2020,106263,30,4,12,1,11
2020,106263,40,0,8,2,6
2020,106263,40,2,1,0,1
2020,106263,40,3,2,0,2
2020,106263,40,4,5,2,3
2020,106263,42,0,8,2,6
2020,106263,42,2,1,0,1
2020,106263,42,3,2,0,2
2020,106263,42,4,5,2,3
2020,106306,0,0,10,5,5
2020,106306,10,0,10,5,5
2020,106306,10,1,1,1,0
2020,106306,10,4,9,4,5
2020,106306,40,0,10,5,5
2020,106306,40,1,1,1,0
2020,106306,40,4,9,4,5
2020,106306,42,0,10,5,5
2020,106306,42,1,1,1,0
2020,106306,42,4,9,4,5
2020,106342,0,0,54,35,19
2020,106342,10,0,54,35,19
2020,106342,10,1,10,9,1
2020,106342,10,2,19,11,8
2020,106342,10,3,22,13,9
2020,106342,10,4,3,2,1
2020,106342,20,0,30,21,9
2020,106342,20,1,10,9,1
2020,106342,20,2,18,11,7
2020,106342,20,3,2,1,1
2020,106342,30,0,15,9,6
2020,106342,30,2,1,0,1
2020,106342,30,3,14,9,5
2020,106342,40,0,9,5,4
2020,106342,40,3,6,3,3
2020,106342,40,4,3,2,1
2020,106342,41,0,9,5,4
2020,106342,41,3,6,3,3
2020,106342,41,4,3,2,1
2020,106342,44,0,9,5,4
2020,106342,44,3,6,3,3
2020,106342,44,4,3,2,1
2020,106397,0,0,1270,738,532
2020,106397,10,0,1270,738,532
2020,106397,10,1,333,250,83
2020,106397,10,2,323,195,128
2020,106397,10,3,380,195,185
2020,106397,10,4,215,92,123
2020,106397,10,5,19,6,13
2020,106397,20,0,592,408,184
2020,106397,20,1,315,235,80
2020,106397,20,2,277,173,104
2020,106397,30,0,253,147,106
2020,106397,30,2,8,7,1
2020,106397,30,3,245,140,105
2020,106397,40,0,425,183,242
2020,106397,40,1,18,15,3
2020,106397,40,2,38,15,23
2020,106397,40,3,135,55,80
2020,106397,40,4,215,92,123
2020,106397,40,5,19,6,13
2020,106397,41,0,254,110,144
2020,106397,41,1,12,10,2
2020,106397,41,2,28,12,16
2020,106397,41,3,92,37,55
2020,106397,41,4,117,50,67
2020,106397,41,5,5,1,4
2020,106397,42,0,76,26,50
2020,106397,42,1,2,1,1
2020,106397,42,2,5,1,4
2020,106397,42,3,26,12,14
2020,106397,42,4,40,11,29
2020,106397,42,5,3,1,2
2020,106397,43,0,95,47,48
2020,106397,43,1,4,4,0
2020,106397,43,2,5,2,3
2020,106397,43,3,17,6,11
2020,106397,43,4,58,31,27
2020,106397,43,5,11,4,7
2020,106397,44,0,113,47,66
2020,106397,44,1,12,10,2
2020,106397,44,2,11,5,6
2020,106397,44,3,54,22,32
2020,106397,44,4,31,9,22
2020,106397,44,5,5,1,4
2020,106397,45,0,141,63,78
2020,106397,45,2,17,7,10
2020,106397,45,3,38,15,23
2020,106397,45,4,86,41,45
2020,106412,0,0,155,88,67
2020,106412,10,0,155,88,67
2020,106412,10,1,20,14,6
2020,106412,10,2,27,20,7
2020,106412,10,3,53,31,22
2020,106412,10,4,55,23,32
2020,106412,20,0,47,33,14
2020,106412,20,1,20,14,6
2020,106412,20,2,20,15,5
2020,106412,20,3,7,4,3
2020,106412,30,0,46,22,24
2020,106412,30,2,6,4,2
2020,106412,30,3,36,18,18
2020,106412,30,4,4,0,4
2020,106412,40,0,62,33,29
2020,106412,40,2,1,1,0
2020,106412,40,3,10,9,1
2020,106412,40,4,51,23,28
2020,106412,42,0,62,33,29
2020,106412,42,2,1,1,0
2020,106412,42,3,10,9,1
2020,106412,42,4,51,23,28
2020,106449,0,0,94,48,46
2020,106449,10,0,94,48,46
2020,106449,10,1,4,4,0
2020,106449,10,2,8,2,6
2020,106449,10,3,35,16,19
2020,106449,10,4,47,26,21
2020,106449,20,0,13,11,2
2020,106449,20,1,4,4,0
2020,106449,20,2,4,2,2
2020,106449,20,3,5,5,0
2020,106449,30,0,2,0,2
2020,106449,30,2,1,0,1
2020,106449,30,3,1,0,1
2020,106449,40,0,79,37,42
2020,106449,40,2,3,0,3
2020,106449,40,3,29,11,18
2020,106449,40,4,47,26,21
2020,106449,42,0,79,37,42
2020,106449,42,2,3,0,3
2020,106449,42,3,29,11,18
2020,106449,42,4,47,26,21
2020,106458,0,0,536,239,297
2020,106458,10,0,533,237,296
2020,106458,10,1,110,67,43
2020,106458,10,2,125,62,63
2020,106458,10,3,162,58,104
2020,106458,10,4,136,50,86
2020,106458,20,0,221,118,103
2020,106458,20,1,104,64,40
2020,106458,20,2,109,52,57
2020,106458,20,3,8,2,6
2020,106458,30,0,126,56,70
2020,106458,30,1,3,1,2
2020,106458,30,2,15,9,6
2020,106458,30,3,101,42,59
2020,106458,30,4,7,4,3
2020,106458,40,0,186,63,123
2020,106458,40,1,3,2,1
2020,106458,40,2,1,1,0
2020,106458,40,3,53,14,39
2020,106458,40,4,129,46,83
2020,106458,42,0,186,63,123
2020,106458,42,1,3,2,1
2020,106458,42,2,1,1,0
2020,106458,42,3,53,14,39
2020,106458,42,4,129,46,83
2020,106458,50,0,3,2,1
2020,106467,0,0,358,180,178
2020,106467,10,0,353,178,175
2020,106467,10,1,77,49,28
2020,106467,10,2,76,39,37
2020,106467,10,3,100,56,44
2020,106467,10,4,43,9,34
2020,106467,10,6,57,25,32
2020,106467,20,0,145,84,61
2020,106467,20,1,74,47,27
2020,106467,20,2,67,34,33
2020,106467,20,3,4,3,1
2020,106467,30,0,89,54,35
2020,106467,30,1,3,2,1
2020,106467,30,2,7,5,2
2020,106467,30,3,79,47,32
2020,106467,40,0,119,40,79
2020,106467,40,2,2,0,2
2020,106467,40,3,17,6,11
2020,106467,40,4,43,9,34
2020,106467,40,6,57,25,32
2020,106467,42,0,119,40,79
2020,106467,42,2,2,0,2
2020,106467,42,3,17,6,11
2020,106467,42,4,43,9,34
2020,106467,42,6,57,25,32
2020,106467,50,0,5,2,3
2020,106485,0,0,153,75,78
2020,106485,10,0,153,75,78
2020,106485,10,1,24,20,4
2020,106485,10,2,36,17,19
2020,106485,10,3,24,12,12
2020,106485,10,4,69,26,43
2020,106485,20,0,61,37,24
2020,106485,20,1,24,20,4
2020,106485,20,2,36,17,19
2020,106485,20,4,1,0,1
2020,106485,30,0,23,11,12
2020,106485,30,3,23,11,12
2020,106485,40,0,69,27,42
2020,106485,40,3,1,1,0
2020,106485,40,4,68,26,42
2020,106485,42,0,69,27,42
2020,106485,42,3,1,1,0
2020,106485,42,4,68,26,42
2020,106546,0,0,50,3,47
2020,106546,10,0,50,3,47
2020,106546,10,6,50,3,47
2020,106546,40,0,50,3,47
2020,106546,40,6,50,3,47
2020,106546,41,0,47,3,44
2020,106546,41,6,47,3,44
2020,106546,43,0,3,0,3
2020,106546,43,6,3,0,3
2020,106546,45,0,47,3,44
2020,106546,45,6,47,3,44
2020,106625,0,0,59,23,36
2020,106625,10,0,59,23,36
2020,106625,10,6,59,23,36
2020,106625,40,0,59,23,36
2020,106625,40,6,59,23,36
2020,106625,42,0,59,23,36
2020,106625,42,6,59,23,36
2020,106704,0,0,525,246,279
2020,106704,10,0,525,246,279
2020,106704,10,1,101,65,36
2020,106704,10,2,136,76,60
2020,106704,10,3,128,60,68
2020,106704,10,4,65,9,56
2020,106704,10,5,75,31,44
2020,106704,10,6,20,5,15
2020,106704,20,0,246,147,99
2020,106704,20,1,100,65,35
2020,106704,20,2,136,76,60
2020,106704,20,3,10,6,4
2020,106704,30,0,120,54,66
2020,106704,30,3,118,54,64
2020,106704,30,4,2,0,2
2020,106704,40,0,159,45,114
2020,106704,40,1,1,0,1
2020,106704,40,4,63,9,54
2020,106704,40,5,75,31,44
2020,106704,40,6,20,5,15
2020,106704,41,0,139,40,99
2020,106704,41,1,1,0,1
2020,106704,41,4,63,9,54
2020,106704,41,5,75,31,44
2020,106704,42,0,20,5,15
2020,106704,42,6,20,5,15
2020,106704,45,0,139,40,99
2020,106704,45,1,1,0,1
2020,106704,45,4,63,9,54
2020,106704,45,5,75,31,44
2020,106713,0,0,27,15,12
2020,106713,10,0,27,15,12
2020,106713,10,1,8,4,4
2020,106713,10,2,6,4,2
2020,106713,10,3,12,6,6
2020,106713,10,4,1,1,0
2020,106713,40,0,27,15,12
2020,106713,40,1,8,4,4
2020,106713,40,2,6,4,2
2020,106713,40,3,12,6,6
2020,106713,40,4,1,1,0
2020,106713,41,0,27,15,12
2020,106713,41,1,8,4,4
2020,106713,41,2,6,4,2
2020,106713,41,3,12,6,6
2020,106713,41,4,1,1,0
2020,106713,45,0,27,15,12
2020,106713,45,1,8,4,4
2020,106713,45,2,6,4,2
2020,106713,45,3,12,6,6
2020,106713,45,4,1,1,0
2020,106795,0,0,41,13,28
2020,106795,10,0,41,13,28
2020,106795,10,4,41,13,28
2020,106795,40,0,41,13,28
2020,106795,40,4,41,13,28
2020,106795,42,0,41,13,28
2020,106795,42,4,41,13,28
2020,106810,0,0,11,5,6
2020,106810,10,0,11,5,6
2020,106810,10,2,2,1,1
2020,106810,10,3,9,4,5
2020,106810,40,0,11,5,6
2020,106810,40,2,2,1,1
2020,106810,40,3,9,4,5
2020,106810,43,0,11,5,6
2020,106810,43,2,2,1,1
2020,106810,43,3,9,4,5
2020,106883,0,0,48,25,23
2020,106883,10,0,48,25,23
2020,106883,10,6,48,25,23
2020,106883,40,0,48,25,23
2020,106883,40,6,48,25,23
2020,106883,42,0,6,5,1
2020,106883,42,6,6,5,1
2020,106883,43,0,42,20,22
2020,106883,43,6,42,20,22
2020,106980,0,0,89,31,58
2020,106980,10,0,89,31,58
2020,106980,10,4,89,31,58
2020,106980,40,0,89,31,58
2020,106980,40,4,89,31,58
2020,106980,42,0,5,2,3
2020,106980,42,4,5,2,3
2020,106980,43,0,84,29,55
2020,106980,43,4,84,29,55
2020,106999,0,0,47,13,34
2020,106999,10,0,41,11,30
2020,106999,10,6,41,11,30
2020,106999,40,0,41,11,30
2020,106999,40,6,41,11,30
2020,106999,42,0,41,11,30
2020,106999,42,6,41,11,30
2020,106999,50,0,6,2,4
2020,107044,0,0,303,184,119
2020,107044,10,0,303,184,119
2020,107044,10,1,63,54,9
2020,107044,10,2,111,70,41
2020,107044,10,3,94,46,48
2020,107044,10,4,28,11,17
2020,107044,10,5,7,3,4
2020,107044,40,0,303,184,119
2020,107044,40,1,63,54,9
2020,107044,40,2,111,70,41
2020,107044,40,3,94,46,48
2020,107044,40,4,28,11,17
2020,107044,40,5,7,3,4
2020,107044,41,0,234,146,88
2020,107044,41,1,60,51,9
2020,107044,41,2,102,64,38
2020,107044,41,3,64,30,34
2020,107044,41,4,8,1,7
2020,107044,42,0,69,38,31
2020,107044,42,1,3,3,0
2020,107044,42,2,9,6,3
2020,107044,42,3,30,16,14
2020,107044,42,4,20,10,10
2020,107044,42,5,7,3,4
2020,107044,44,0,120,67,53
2020,107044,44,1,3,3,0
2020,107044,44,2,62,38,24
2020,107044,44,3,47,25,22
2020,107044,44,4,8,1,7
2020,107044,45,0,114,79,35
2020,107044,45,1,57,48,9
2020,107044,45,2,40,26,14
2020,107044,45,3,17,5,12
2020,107071,0,0,178,90,88
2020,107071,10,0,178,90,88
2020,107071,10,1,54,40,14
2020,107071,10,2,37,18,19
2020,107071,10,3,60,19,41
2020,107071,10,4,24,11,13
2020,107071,10,5,3,2,1
2020,107071,20,0,82,53,29
2020,107071,20,1,53,40,13
2020,107071,20,2,28,12,16
2020,107071,20,3,1,1,0
2020,107071,30,0,44,14,30
2020,107071,30,2,8,5,3
2020,107071,30,3,36,9,27
2020,107071,40,0,52,23,29
2020,107071,40,1,1,0,1
2020,107071,40,2,1,1,0
2020,107071,40,3,23,9,14
2020,107071,40,4,24,11,13
2020,107071,40,5,3,2,1
2020,107071,42,0,52,23,29
2020,107071,42,1,1,0,1
2020,107071,42,2,1,1,0
2020,107071,42,3,23,9,14
2020,107071,42,4,24,11,13
2020,107071,42,5,3,2,1
2020,107080,0,0,98,49,49
2020,107080,10,0,98,49,49
2020,107080,10,1,50,26,24
2020,107080,10,2,18,12,6
2020,107080,10,3,20,7,13
2020,107080,10,4,10,4,6
2020,107080,20,0,67,37,30
2020,107080,20,1,50,26,24
2020,107080,20,2,17,11,6
2020,107080,30,0,17,8,9
2020,107080,30,2,1,1,0
2020,107080,30,3,16,7,9
2020,107080,40,0,14,4,10
2020,107080,40,3,4,0,4
2020,107080,40,4,10,4,6
2020,107080,41,0,12,4,8
2020,107080,41,3,3,0,3
2020,107080,41,4,9,4,5
2020,107080,42,0,2,0,2
2020,107080,42,3,1,0,1
2020,107080,42,4,1,0,1
2020,107080,44,0,8,3,5
2020,107080,44,3,3,0,3
2020,107080,44,4,5,3,2
2020,107080,45,0,4,1,3
2020,107080,45,4,4,1,3
2020,107141,0,0,79,51,28
2020,107141,10,0,79,51,28
2020,107141,10,1,19,18,1
2020,107141,10,2,31,23,8
2020,107141,10,3,25,9,16
2020,107141,10,4,4,1,3
2020,107141,40,0,79,51,28
2020,107141,40,1,19,18,1
2020,107141,40,2,31,23,8
2020,107141,40,3,25,9,16
2020,107141,40,4,4,1,3
2020,107141,41,0,77,50,27
2020,107141,41,1,18,17,1
2020,107141,41,2,30,23,7
2020,107141,41,3,25,9,16
2020,107141,41,4,4,1,3
2020,107141,43,0,2,1,1
2020,107141,43,1,1,1,0
2020,107141,43,2,1,0,1
2020,107141,44,0,77,50,27
2020,107141,44,1,18,17,1
2020,107141,44,2,30,23,7
2020,107141,44,3,25,9,16
2020,107141,44,4,4,1,3
2020,107318,0,0,39,23,16
2020,107318,10,0,39,23,16
2020,107318,10,4,39,23,16
2020,107318,40,0,39,23,16
2020,107318,40,4,39,23,16
2020,107318,42,0,39,23,16
2020,107318,42,4,39,23,16
2020,107327,0,0,45,22,23
2020,107327,10,0,45,22,23
2020,107327,10,1,1,0,1
2020,107327,10,2,6,4,2
2020,107327,10,3,6,1,5
2020,107327,10,6,32,17,15
2020,107327,40,0,45,22,23
2020,107327,40,1,1,0,1
2020,107327,40,2,6,4,2
2020,107327,40,3,6,1,5
2020,107327,40,6,32,17,15
2020,107327,42,0,45,22,23
2020,107327,42,1,1,0,1
2020,107327,42,2,6,4,2
2020,107327,42,3,6,1,5
2020,107327,42,6,32,17,15
2020,107460,0,0,65,32,33
2020,107460,10,0,65,32,33
2020,107460,10,1,6,0,6
2020,107460,10,2,10,4,6
2020,107460,10,3,15,7,8
2020,107460,10,4,34,21,13
2020,107460,40,0,65,32,33
2020,107460,40,1,6,0,6
2020,107460,40,2,10,4,6
2020,107460,40,3,15,7,8
2020,107460,40,4,34,21,13
2020,107460,42,0,65,32,33
2020,107460,42,1,6,0,6
2020,107460,42,2,10,4,6
2020,107460,42,3,15,7,8
2020,107460,42,4,34,21,13
2020,107512,0,0,104,62,42
2020,107512,10,0,104,62,42
2020,107512,10,1,43,35,8
2020,107512,10,2,28,11,17
2020,107512,10,3,21,10,11
2020,107512,10,4,7,3,4
2020,107512,10,5,5,3,2
2020,107512,20,0,68,46,22
2020,107512,20,1,42,35,7
2020,107512,20,2,23,10,13
2020,107512,20,3,3,1,2
2020,107512,30,0,18,7,11
2020,107512,30,2,5,1,4
2020,107512,30,3,10,5,5
2020,107512,30,4,3,1,2
2020,107512,40,0,18,9,9
2020,107512,40,1,1,0,1
2020,107512,40,3,8,4,4
2020,107512,40,4,4,2,2
2020,107512,40,5,5,3,2
2020,107512,42,0,18,9,9
2020,107512,42,1,1,0,1
2020,107512,42,3,8,4,4
2020,107512,42,4,4,2,2
2020,107512,42,5,5,3,2
2020,107521,0,0,29,15,14
2020,107521,10,0,29,15,14
2020,107521,10,1,1,1,0
2020,107521,10,2,4,1,3
2020,107521,10,3,1,0,1
2020,107521,10,4,22,13,9
2020,107521,10,5,1,0,1
2020,107521,40,0,29,15,14
2020,107521,40,1,1,1,0
2020,107521,40,2,4,1,3
2020,107521,40,3,1,0,1
2020,107521,40,4,22,13,9
2020,107521,40,5,1,0,1
2020,107521,42,0,29,15,14
2020,107521,42,1,1,1,0
2020,107521,42,2,4,1,3
2020,107521,42,3,1,0,1
2020,107521,42,4,22,13,9
2020,107521,42,5,1,0,1
2020,107549,0,0,34,17,17
2020,107549,10,0,34,17,17
2020,107549,10,4,34,17,17
2020,107549,40,0,34,17,17
2020,107549,40,4,34,17,17
2020,107549,42,0,34,17,17
2020,107549,42,4,34,17,17
2020,107558,0,0,48,26,22
2020,107558,10,0,48,26,22
2020,107558,10,1,15,10,5
2020,107558,10,2,5,1,4
2020,107558,10,3,19,12,7
2020,107558,10,4,9,3,6
2020,107558,20,0,20,11,9
2020,107558,20,1,15,10,5
2020,107558,20,2,5,1,4
2020,107558,30,0,19,12,7
2020,107558,30,3,19,12,7
2020,107558,40,0,9,3,6
2020,107558,40,4,9,3,6
2020,107558,41,0,9,3,6
2020,107558,41,4,9,3,6
2020,107558,45,0,9,3,6
2020,107558,45,4,9,3,6
2020,107585,0,0,59,27,32
2020,107585,10,0,59,27,32
2020,107585,10,6,59,27,32
2020,107585,40,0,59,27,32
2020,107585,40,6,59,27,32
2020,107585,42,0,59,27,32
2020,107585,42,6,59,27,32
2020,107600,0,0,46,22,24
2020,107600,10,0,46,22,24
2020,107600,10,1,5,2,3
2020,107600,10,2,11,7,4
2020,107600,10,3,19,11,8
2020,107600,10,4,11,2,9
2020,107600,20,0,12,6,6
2020,107600,20,1,4,2,2
2020,107600,20,2,8,4,4
2020,107600,30,0,16,10,6
2020,107600,30,1,1,0,1
2020,107600,30,2,2,2,0
2020,107600,30,3,13,8,5
2020,107600,40,0,18,6,12
2020,107600,40,2,1,1,0
2020,107600,40,3,6,3,3
2020,107600,40,4,11,2,9
2020,107600,42,0,18,6,12
2020,107600,42,2,1,1,0
2020,107600,42,3,6,3,3
2020,107600,42,4,11,2,9
2020,107619,0,0,53,17,36
2020,107619,10,0,53,17,36
2020,107619,10,4,53,17,36
2020,107619,40,0,53,17,36
2020,107619,40,4,53,17,36
2020,107619,42,0,53,17,36
2020,107619,42,4,53,17,36
2020,107637,0,0,44,17,27
2020,107637,10,0,44,17,27
2020,107637,10,4,44,17,27
2020,107637,40,0,44,17,27
2020,107637,40,4,44,17,27
2020,107637,42,0,10,2,8
2020,107637,42,4,10,2,8
2020,107637,43,0,34,15,19
2020,107637,43,4,34,15,19
2020,107664,0,0,166,73,93
2020,107664,10,0,166,73,93
2020,107664,10,6,166,73,93
2020,107664,40,0,166,73,93
2020,107664,40,6,166,73,93
2020,107664,42,0,16,7,9
2020,107664,42,6,16,7,9
2020,107664,43,0,150,66,84
2020,107664,43,6,150,66,84
2020,107725,0,0,43,12,31
2020,107725,10,0,41,12,29
2020,107725,10,4,41,12,29
2020,107725,40,0,41,12,29
2020,107725,40,4,41,12,29
2020,107725,42,0,41,12,29
2020,107725,42,4,41,12,29
2020,107725,50,0,2,0,2
2020,107743,0,0,19,8,11
2020,107743,10,0,19,8,11
2020,107743,10,4,19,8,11
2020,107743,40,0,19,8,11
2020,107743,40,4,19,8,11
2020,107743,42,0,19,8,11
2020,107743,42,4,19,8,11
2020,107840,0,0,13,6,7
2020,107840,10,0,13,6,7
2020,107840,10,4,13,6,7
2020,107840,40,0,13,6,7
2020,107840,40,4,13,6,7
2020,107840,42,0,13,6,7
2020,107840,42,4,13,6,7
2020,107877,0,0,29,16,13
2020,107877,10,0,28,16,12
2020,107877,10,1,4,3,1
2020,107877,10,2,6,4,2
2020,107877,10,3,15,7,8
2020,107877,10,4,3,2,1
2020,107877,20,0,8,4,4
2020,107877,20,1,3,2,1
2020,107877,20,2,4,2,2
2020,107877,20,3,1,0,1
2020,107877,30,0,15,8,7
2020,107877,30,1,1,1,0
2020,107877,30,2,2,2,0
2020,107877,30,3,12,5,7
2020,107877,40,0,5,4,1
2020,107877,40,3,2,2,0
2020,107877,40,4,3,2,1
2020,107877,42,0,5,4,1
2020,107877,42,3,2,2,0
2020,107877,42,4,3,2,1
2020,107877,50,0,1,0,1
2020,107974,0,0,49,17,32
2020,107974,10,0,47,17,30
2020,107974,10,1,13,3,10
2020,107974,10,2,4,1,3
2020,107974,10,3,2,0,2
2020,107974,10,4,28,13,15
2020,107974,20,0,4,1,3
2020,107974,20,1,4,1,3
2020,107974,40,0,43,16,27
2020,107974,40,1,9,2,7
2020,107974,40,2,4,1,3
2020,107974,40,3,2,0,2
2020,107974,40,4,28,13,15
2020,107974,42,0,43,16,27
2020,107974,42,1,9,2,7
2020,107974,42,2,4,1,3
2020,107974,42,3,2,0,2
2020,107974,42,4,28,13,15
2020,107974,50,0,2,0,2
2020,107983,0,0,157,82,75
2020,107983,10,0,157,82,75
2020,107983,10,1,22,13,9
2020,107983,10,2,40,24,16
2020,107983,10,3,54,25,29
2020,107983,10,4,41,20,21
2020,107983,20,0,63,35,28
2020,107983,20,1,22,13,9
2020,107983,20,2,37,22,15
2020,107983,20,3,4,0,4
2020,107983,30,0,42,22,20
2020,107983,30,2,2,2,0
2020,107983,30,3,40,20,20
2020,107983,40,0,52,25,27
2020,107983,40,2,1,0,1
2020,107983,40,3,10,5,5
2020,107983,40,4,41,20,21
2020,107983,42,0,52,25,27
2020,107983,42,2,1,0,1
2020,107983,42,3,10,5,5
2020,107983,42,4,41,20,21
2020,107992,0,0,57,32,25
2020,107992,10,0,57,32,25
2020,107992,10,6,57,32,25
2020,107992,40,0,57,32,25
2020,107992,40,6,57,32,25
2020,107992,42,0,57,32,25
2020,107992,42,6,57,32,25
2020,108092,0,0,224,105,119
2020,108092,10,0,224,105,119
2020,108092,10,1,40,23,17
2020,108092,10,2,47,26,21
2020,108092,10,3,78,37,41
2020,108092,10,4,50,13,37
2020,108092,10,6,9,6,3
2020,108092,20,0,13,10,3
2020,108092,20,1,7,6,1
2020,108092,20,2,3,3,0
2020,108092,20,3,3,1,2
2020,108092,40,0,211,95,116
2020,108092,40,1,33,17,16
2020,108092,40,2,44,23,21
2020,108092,40,3,75,36,39
2020,108092,40,4,50,13,37
2020,108092,40,6,9,6,3
2020,108092,41,0,137,72,65
2020,108092,41,1,32,17,15
2020,108092,41,2,43,22,21
2020,108092,41,3,62,33,29
2020,108092,42,0,74,23,51
2020,108092,42,1,1,0,1
2020,108092,42,2,1,1,0
2020,108092,42,3,13,3,10
2020,108092,42,4,50,13,37
2020,108092,42,6,9,6,3
2020,108092,44,0,137,72,65
2020,108092,44,1,32,17,15
2020,108092,44,2,43,22,21
2020,108092,44,3,62,33,29
2020,108232,0,0,202,114,88
2020,108232,10,0,202,114,88
2020,108232,10,6,202,114,88
2020,108232,40,0,202,114,88
2020,108232,40,6,202,114,88
2020,108232,41,0,202,114,88
2020,108232,41,6,202,114,88
2020,108232,45,0,202,114,88
2020,108232,45,6,202,114,88
2020,108667,0,0,61,31,30
2020,108667,10,0,61,31,30
2020,108667,10,4,61,31,30
2020,108667,20,0,37,22,15
2020,108667,20,4,37,22,15
2020,108667,30,0,22,8,14
2020,108667,30,4,22,8,14
2020,108667,40,0,2,1,1
2020,108667,40,4,2,1,1
2020,108667,43,0,2,1,1
2020,108667,43,4,2,1,1
2020,108807,0,0,174,80,94
2020,108807,10,0,174,80,94
2020,108807,10,4,174,80,94
2020,108807,20,0,94,43,51
2020,108807,20,4,94,43,51
2020,108807,30,0,62,27,35
2020,108807,30,4,62,27,35
2020,108807,40,0,18,10,8
2020,108807,40,4,18,10,8
2020,108807,42,0,5,3,2
2020,108807,42,4,5,3,2
2020,108807,43,0,13,7,6
2020,108807,43,4,13,7,6
2020,108852,0,0,7,2,5
2020,108852,10,0,7,2,5
2020,108852,10,4,7,2,5
2020,108852,40,0,7,2,5
2020,108852,40,4,7,2,5
2020,108852,43,0,7,2,5
2020,108852,43,4,7,2,5
2020,108861,0,0,5,2,3
2020,108861,10,0,5,2,3
2020,108861,10,1,3,1,2
2020,108861,10,2,2,1,1
2020,108861,20,0,3,1,2
2020,108861,20,1,3,1,2
2020,108861,40,0,2,1,1
2020,108861,40,2,2,1,1
2020,108861,41,0,2,1,1
2020,108861,41,2,2,1,1
2020,108861,44,0,2,1,1
2020,108861,44,2,2,1,1
2020,108870,0,0,12,8,4
2020,108870,10,0,12,8,4
2020,108870,10,1,6,4,2
2020,108870,10,5,6,4,2
2020,108870,40,0,12,8,4
2020,108870,40,1,6,4,2
2020,108870,40,5,6,4,2
2020,108870,42,0,12,8,4
2020,108870,42,1,6,4,2
2020,108870,42,5,6,4,2
2020,109040,0,0,38,15,23
2020,109040,50,0,38,15,23
2020,109086,0,0,5,2,3
2020,109086,10,0,5,2,3
2020,109086,10,6,5,2,3
2020,109086,40,0,5,2,3
2020,109086,40,6,5,2,3
2020,109086,41,0,1,1,0
2020,109086,41,6,1,1,0
2020,109086,43,0,4,1,3
2020,109086,43,6,4,1,3
2020,109086,45,0,1,1,0
2020,109086,45,6,1,1,0
2020,109208,0,0,370,156,214
2020,109208,10,0,370,156,214
2020,109208,10,4,370,156,214
2020,109208,20,0,301,134,167
2020,109208,20,4,301,134,167
2020,109208,30,0,65,21,44
2020,109208,30,4,65,21,44
2020,109208,40,0,4,1,3
2020,109208,40,4,4,1,3
2020,109208,43,0,4,1,3
2020,109208,43,4,4,1,3
2020,109350,0,0,162,91,71
2020,109350,10,0,158,90,68
2020,109350,10,1,46,22,24
2020,109350,10,2,67,43,24
2020,109350,10,4,18,9,9
2020,109350,10,6,27,16,11
2020,109350,20,0,122,70,52
2020,109350,20,1,45,22,23
2020,109350,20,2,67,43,24
2020,109350,20,4,7,3,4
2020,109350,20,6,3,2,1
2020,109350,30,0,36,20,16
2020,109350,30,1,1,0,1
2020,109350,30,4,11,6,5
2020,109350,30,6,24,14,10
2020,109350,50,0,4,1,3
2020,109651,0,0,128,89,39
2020,109651,10,0,128,89,39
2020,109651,10,1,49,32,17
2020,109651,10,2,66,49,17
2020,109651,10,3,11,7,4
2020,109651,10,4,2,1,1
2020,109651,40,0,128,89,39
2020,109651,40,1,49,32,17
2020,109651,40,2,66,49,17
2020,109651,40,3,11,7,4
2020,109651,40,4,2,1,1
2020,109651,41,0,62,40,22
2020,109651,41,1,31,19,12
2020,109651,41,2,28,19,9
2020,109651,41,3,3,2,1
2020,109651,42,0,66,49,17
2020,109651,42,1,18,13,5
2020,109651,42,2,38,30,8
2020,109651,42,3,8,5,3
2020,109651,42,4,2,1,1
2020,109651,44,0,62,40,22
2020,109651,44,1,31,19,12
2020,109651,44,2,28,19,9
2020,109651,44,3,3,2,1
2020,109785,0,0,447,189,258
2020,109785,10,0,447,189,258
2020,109785,10,1,141,83,58
2020,109785,10,2,120,54,66
2020,109785,10,3,166,49,117
2020,109785,10,4,20,3,17
2020,109785,40,0,447,189,258
2020,109785,40,1,141,83,58
2020,109785,40,2,120,54,66
2020,109785,40,3,166,49,117
2020,109785,40,4,20,3,17
2020,109785,41,0,297,141,156
2020,109785,41,1,129,75,54
2020,109785,41,2,97,47,50
2020,109785,41,3,67,19,48
2020,109785,41,4,4,0,4
2020,109785,42,0,150,48,102
2020,109785,42,1,12,8,4
2020,109785,42,2,23,7,16
2020,109785,42,3,99,30,69
2020,109785,42,4,16,3,13
2020,109785,44,0,297,141,156
2020,109785,44,1,129,75,54
2020,109785,44,2,97,47,50
2020,109785,44,3,67,19,48
2020,109785,44,4,4,0,4
2020,109819,0,0,350,183,167
2020,109819,10,0,350,183,167
2020,109819,10,4,350,183,167
2020,109819,20,0,196,103,93
2020,109819,20,4,196,103,93
2020,109819,30,0,114,61,53
2020,109819,30,4,114,61,53
2020,109819,40,0,40,19,21
2020,109819,40,4,40,19,21
2020,109819,42,0,17,5,12
2020,109819,42,4,17,5,12
2020,109819,43,0,23,14,9
2020,109819,43,4,23,14,9
2020,109907,0,0,44,23,21
2020,109907,10,0,44,23,21
2020,109907,10,1,21,11,10
2020,109907,10,2,13,8,5
2020,109907,10,3,10,4,6
2020,109907,20,0,25,15,10
2020,109907,20,1,15,9,6
2020,109907,20,2,7,5,2
2020,109907,20,3,3,1,2
2020,109907,30,0,19,8,11
2020,109907,30,1,6,2,4
2020,109907,30,2,6,3,3
2020,109907,30,3,7,3,4
2020,110060,0,0,7,5,2
2020,110060,10,0,7,5,2
2020,110060,10,6,7,5,2
2020,110060,40,0,7,5,2
2020,110060,40,6,7,5,2
2020,110060,42,0,7,5,2
2020,110060,42,6,7,5,2
2020,110097,0,0,212,126,86
2020,110097,10,0,212,126,86
2020,110097,10,1,55,48,7
2020,110097,10,2,104,53,51
2020,110097,10,3,42,20,22
2020,110097,10,4,11,5,6
2020,110097,20,0,53,45,8
2020,110097,20,1,43,37,6
2020,110097,20,2,10,8,2
2020,110097,30,0,159,81,78
2020,110097,30,1,12,11,1
2020,110097,30,2,94,45,49
2020,110097,30,3,42,20,22
2020,110097,30,4,11,5,6
2020,110219,0,0,13,6,7
2020,110219,10,0,13,6,7
2020,110219,10,4,13,6,7
2020,110219,40,0,13,6,7
2020,110219,40,4,13,6,7
2020,110219,41,0,13,6,7
2020,110219,41,4,13,6,7
2020,110219,45,0,13,6,7
2020,110219,45,4,13,6,7
2020,110246,0,0,192,87,105
2020,110246,10,0,192,87,105
2020,110246,10,4,192,87,105
2020,110246,20,0,140,65,75
2020,110246,20,4,140,65,75
2020,110246,30,0,51,21,30
2020,110246,30,4,51,21,30
2020,110246,40,0,1,1,0
2020,110246,40,4,1,1,0
2020,110246,42,0,1,1,0
2020,110246,42,4,1,1,0
2020,110316,0,0,55,25,30
2020,110316,10,0,55,25,30
2020,110316,10,1,24,16,8
2020,110316,10,2,14,4,10
2020,110316,10,3,13,3,10
2020,110316,10,5,4,2,2
2020,110316,40,0,55,25,30
2020,110316,40,1,24,16,8
2020,110316,40,2,14,4,10
2020,110316,40,3,13,3,10
2020,110316,40,5,4,2,2
2020,110316,41,0,47,24,23
2020,110316,41,1,24,16,8
2020,110316,41,2,12,4,8
2020,110316,41,3,10,3,7
2020,110316,41,5,1,1,0
2020,110316,42,0,8,1,7
2020,110316,42,2,2,0,2
2020,110316,42,3,3,0,3
2020,110316,42,5,3,1,2
2020,110316,44,0,47,24,23
2020,110316,44,1,24,16,8
2020,110316,44,2,12,4,8
2020,110316,44,3,10,3,7
2020,110316,44,5,1,1,0
2020,110334,0,0,208,88,120
2020,110334,10,0,208,88,120
2020,110334,10,4,208,88,120
2020,110334,20,0,100,50,50
2020,110334,20,4,100,50,50
2020,110334,30,0,63,22,41
2020,110334,30,4,63,22,41
2020,110334,40,0,45,16,29
2020,110334,40,4,45,16,29
2020,110334,42,0,45,16,29
2020,110334,42,4,45,16,29
2020,110361,0,0,347,184,163
2020,110361,10,0,347,184,163
2020,110361,10,1,111,74,37
2020,110361,10,2,104,49,55
2020,110361,10,3,104,46,58
2020,110361,10,4,1,1,0
2020,110361,10,5,18,10,8
2020,110361,10,6,9,4,5
2020,110361,20,0,153,86,67
2020,110361,20,1,95,62,33
2020,110361,20,2,58,24,34
2020,110361,30,0,166,83,83
2020,110361,30,1,16,12,4
2020,110361,30,2,46,25,21
2020,110361,30,3,104,46,58
2020,110361,40,0,28,15,13
2020,110361,40,4,1,1,0
2020,110361,40,5,18,10,8
2020,110361,40,6,9,4,5
2020,110361,42,0,28,15,13
2020,110361,42,4,1,1,0
2020,110361,42,5,18,10,8
2020,110361,42,6,9,4,5
2020,110370,0,0,86,38,48
2020,110370,10,0,86,38,48
2020,110370,10,1,23,13,10
2020,110370,10,2,41,16,25
2020,110370,10,3,22,9,13
2020,110370,20,0,41,21,20
2020,110370,20,1,20,13,7
2020,110370,20,2,21,8,13
2020,110370,30,0,26,11,15
2020,110370,30,2,9,4,5
2020,110370,30,3,17,7,10
2020,110370,40,0,19,6,13
2020,110370,40,1,3,0,3
2020,110370,40,2,11,4,7
2020,110370,40,3,5,2,3
2020,110370,41,0,19,6,13
2020,110370,41,1,3,0,3
2020,110370,41,2,11,4,7
2020,110370,41,3,5,2,3
2020,110370,44,0,19,6,13
2020,110370,44,1,3,0,3
2020,110370,44,2,11,4,7
2020,110370,44,3,5,2,3
2020,110398,0,0,64,30,34
2020,110398,10,0,64,30,34
2020,110398,10,1,44,22,22
2020,110398,10,2,2,1,1
2020,110398,10,5,18,7,11
2020,110398,20,0,36,21,15
2020,110398,20,1,36,21,15
2020,110398,30,0,2,1,1
2020,110398,30,2,2,1,1
2020,110398,40,0,26,8,18
2020,110398,40,1,8,1,7
2020,110398,40,5,18,7,11
2020,110398,41,0,25,7,18
2020,110398,41,1,7,0,7
2020,110398,41,5,18,7,11
2020,110398,43,0,1,1,0
2020,110398,43,1,1,1,0
2020,110398,44,0,25,7,18
2020,110398,44,1,7,0,7
2020,110398,44,5,18,7,11
2020,110404,0,0,357,270,87
2020,110404,10,0,352,269,83
2020,110404,10,1,266,213,53
2020,110404,10,2,1,1,0
2020,110404,10,3,43,28,15
2020,110404,10,4,20,12,8
2020,110404,10,5,20,13,7
2020,110404,10,6,2,2,0
2020,110404,20,0,266,213,53
2020,110404,20,1,266,213,53
2020,110404,30,0,43,28,15
2020,110404,30,2,1,1,0
2020,110404,30,3,42,27,15
2020,110404,40,0,43,28,15
2020,110404,40,3,1,1,0
2020,110404,40,4,20,12,8
2020,110404,40,5,20,13,7
2020,110404,40,6,2,2,0
2020,110404,41,0,38,24,14
2020,110404,41,3,1,1,0
2020,110404,41,4,19,12,7
2020,110404,41,5,18,11,7
2020,110404,42,0,1,1,0
2020,110404,42,5,1,1,0
2020,110404,43,0,4,3,1
2020,110404,43,4,1,0,1
2020,110404,43,5,1,1,0
2020,110404,43,6,2,2,0
2020,110404,44,0,38,24,14
2020,110404,44,3,1,1,0
2020,110404,44,4,19,12,7
2020,110404,44,5,18,11,7
2020,110404,50,0,5,1,4
2020,110413,0,0,179,87,92
2020,110413,10,0,179,87,92
2020,110413,10,1,61,31,30
2020,110413,10,2,50,22,28
2020,110413,10,3,40,22,18
2020,110413,10,4,3,1,2
2020,110413,10,5,25,11,14
2020,110413,20,0,105,51,54
2020,110413,20,1,57,28,29
2020,110413,20,2,45,20,25
2020,110413,20,3,3,3,0
2020,110413,30,0,36,17,19
2020,110413,30,2,5,2,3
2020,110413,30,3,29,15,14
2020,110413,30,4,2,0,2
2020,110413,40,0,38,19,19
2020,110413,40,1,4,3,1
2020,110413,40,3,8,4,4
2020,110413,40,4,1,1,0
2020,110413,40,5,25,11,14
2020,110413,41,0,4,3,1
2020,110413,41,1,4,3,1
2020,110413,42,0,34,16,18
2020,110413,42,3,8,4,4
2020,110413,42,4,1,1,0
2020,110413,42,5,25,11,14
2020,110413,44,0,4,3,1
2020,110413,44,1,4,3,1
2020,110422,0,0,881,552,329
2020,110422,10,0,881,552,329
2020,110422,10,1,323,230,93
2020,110422,10,2,165,98,67
2020,110422,10,3,182,94,88
2020,110422,10,5,209,128,81
2020,110422,10,6,2,2,0
2020,110422,20,0,466,315,151
2020,110422,20,1,320,228,92
2020,110422,20,2,144,85,59
2020,110422,20,6,2,2,0
2020,110422,30,0,206,109,97
2020,110422,30,1,3,2,1
2020,110422,30,2,21,13,8
2020,110422,30,3,182,94,88
2020,110422,40,0,209,128,81
2020,110422,40,5,209,128,81
2020,110422,41,0,102,55,47
2020,110422,41,5,102,55,47
2020,110422,42,0,96,65,31
2020,110422,42,5,96,65,31
2020,110422,43,0,11,8,3
2020,110422,43,5,11,8,3
2020,110422,44,0,102,55,47
2020,110422,44,5,102,55,47
2020,110468,0,0,106,46,60
2020,110468,10,0,106,46,60
2020,110468,10,1,42,26,16
2020,110468,10,2,32,11,21
2020,110468,10,3,32,9,23
2020,110468,40,0,106,46,60
2020,110468,40,1,42,26,16
2020,110468,40,2,32,11,21
2020,110468,40,3,32,9,23
2020,110468,41,0,106,46,60
2020,110468,41,1,42,26,16
2020,110468,41,2,32,11,21
2020,110468,41,3,32,9,23
2020,110468,44,0,106,46,60
2020,110468,44,1,42,26,16
2020,110468,44,2,32,11,21
2020,110468,44,3,32,9,23
2020,110486,0,0,347,182,165
2020,110486,10,0,347,182,165
2020,110486,10,1,76,45,31
2020,110486,10,2,54,34,20
2020,110486,10,3,108,57,51
2020,110486,10,5,109,46,63
2020,110486,20,0,129,79,50
2020,110486,20,1,76,45,31
2020,110486,20,2,53,34,19
2020,110486,30,0,109,57,52
2020,110486,30,2,1,0,1
2020,110486,30,3,108,57,51
2020,110486,40,0,109,46,63
2020,110486,40,5,109,46,63
2020,110486,41,0,46,19,27
2020,110486,41,5,46,19,27
2020,110486,42,0,53,23,30
2020,110486,42,5,53,23,30
2020,110486,43,0,10,4,6
2020,110486,43,5,10,4,6
2020,110486,44,0,46,19,27
2020,110486,44,5,46,19,27
2020,110495,0,0,359,186,173
2020,110495,10,0,359,186,173
2020,110495,10,1,130,76,54
2020,110495,10,2,65,39,26
2020,110495,10,3,77,33,44
2020,110495,10,5,87,38,49
2020,110495,20,0,191,113,78
2020,110495,20,1,130,76,54
2020,110495,20,2,61,37,24
2020,110495,30,0,81,35,46
2020,110495,30,2,4,2,2
2020,110495,30,3,77,33,44
2020,110495,40,0,87,38,49
2020,110495,40,5,87,38,49
2020,110495,41,0,56,26,30
2020,110495,41,5,56,26,30
2020,110495,42,0,28,10,18
2020,110495,42,5,28,10,18
2020,110495,43,0,3,2,1
2020,110495,43,5,3,2,1
2020,110495,44,0,56,26,30
2020,110495,44,5,56,26,30
2020,110510,0,0,498,239,259
2020,110510,10,0,498,239,259
2020,110510,10,1,185,105,80
2020,110510,10,2,86,45,41
2020,110510,10,3,136,60,76
2020,110510,10,5,91,29,62
2020,110510,20,0,267,151,116
2020,110510,20,1,184,105,79
2020,110510,20,2,80,44,36
2020,110510,20,3,3,2,1
2020,110510,30,0,140,59,81
2020,110510,30,1,1,0,1
2020,110510,30,2,6,1,5
2020,110510,30,3,133,58,75
2020,110510,40,0,91,29,62
2020,110510,40,5,91,29,62
2020,110510,41,0,62,18,44
2020,110510,41,5,62,18,44
2020,110510,42,0,28,11,17
2020,110510,42,5,28,11,17
2020,110510,43,0,1,0,1
2020,110510,43,5,1,0,1
2020,110510,44,0,62,18,44
2020,110510,44,5,62,18,44
2020,110529,0,0,669,377,292
2020,110529,10,0,669,377,292
2020,110529,10,1,244,150,94
2020,110529,10,2,129,69,60
2020,110529,10,3,177,93,84
2020,110529,10,5,119,65,54
2020,110529,20,0,362,214,148
2020,110529,20,1,244,150,94
2020,110529,20,2,116,62,54
2020,110529,20,3,2,2,0
2020,110529,30,0,188,98,90
2020,110529,30,2,13,7,6
2020,110529,30,3,175,91,84
2020,110529,40,0,119,65,54
2020,110529,40,5,119,65,54
2020,110529,41,0,76,40,36
2020,110529,41,5,76,40,36
2020,110529,42,0,40,23,17
2020,110529,42,5,40,23,17
2020,110529,43,0,3,2,1
2020,110529,43,5,3,2,1
2020,110529,44,0,76,40,36
2020,110529,44,5,76,40,36
2020,110538,0,0,510,255,255
2020,110538,10,0,510,255,255
2020,110538,10,1,169,102,67
2020,110538,10,2,99,52,47
2020,110538,10,3,143,61,82
2020,110538,10,5,99,40,59
2020,110538,20,0,261,149,112
2020,110538,20,1,169,102,67
2020,110538,20,2,91,47,44
2020,110538,20,3,1,0,1
2020,110538,30,0,150,66,84
2020,110538,30,2,8,5,3
2020,110538,30,3,142,61,81
2020,110538,40,0,99,40,59
2020,110538,40,5,99,40,59
2020,110538,41,0,62,27,35
2020,110538,41,5,62,27,35
2020,110538,42,0,35,11,24
2020,110538,42,5,35,11,24
2020,110538,43,0,2,2,0
2020,110538,43,5,2,2,0
2020,110538,44,0,62,27,35
2020,110538,44,5,62,27,35
2020,110547,0,0,419,188,231
2020,110547,10,0,419,188,231
2020,110547,10,1,111,63,48
2020,110547,10,2,69,27,42
2020,110547,10,3,111,43,68
2020,110547,10,5,128,55,73
2020,110547,20,0,168,82,86
2020,110547,20,1,107,59,48
2020,110547,20,2,61,23,38
2020,110547,30,0,123,51,72
2020,110547,30,1,4,4,0
2020,110547,30,2,8,4,4
2020,110547,30,3,111,43,68
2020,110547,40,0,128,55,73
2020,110547,40,5,128,55,73
2020,110547,41,0,80,41,39
2020,110547,41,5,80,41,39
2020,110547,42,0,45,13,32
2020,110547,42,5,45,13,32
2020,110547,43,0,3,1,2
2020,110547,43,5,3,1,2
2020,110547,44,0,80,41,39
2020,110547,44,5,80,41,39
2020,110556,0,0,796,411,385
2020,110556,10,0,796,411,385
2020,110556,10,1,224,150,74
2020,110556,10,2,145,69,76
2020,110556,10,3,198,95,103
2020,110556,10,5,224,93,131
2020,110556,10,6,5,4,1
2020,110556,20,0,365,218,147
2020,110556,20,1,224,150,74
2020,110556,20,2,138,65,73
2020,110556,20,6,3,3,0
2020,110556,30,0,207,100,107
2020,110556,30,2,7,4,3
2020,110556,30,3,198,95,103
2020,110556,30,6,2,1,1
2020,110556,40,0,224,93,131
2020,110556,40,5,224,93,131
2020,110556,41,0,154,61,93
2020,110556,41,5,154,61,93
2020,110556,42,0,65,30,35
2020,110556,42,5,65,30,35
2020,110556,43,0,5,2,3
2020,110556,43,5,5,2,3
2020,110556,44,0,154,61,93
2020,110556,44,5,154,61,93
2020,110565,0,0,1018,497,521
2020,110565,10,0,1018,497,521
2020,110565,10,1,364,208,156
2020,110565,10,2,217,108,109
2020,110565,10,3,212,86,126
2020,110565,10,5,225,95,130
2020,110565,20,0,571,310,261
2020,110565,20,1,364,208,156
2020,110565,20,2,207,102,105
2020,110565,30,0,222,92,130
2020,110565,30,2,10,6,4
2020,110565,30,3,212,86,126
2020,110565,40,0,225,95,130
2020,110565,40,5,225,95,130
2020,110565,41,0,169,77,92
2020,110565,41,5,169,77,92
2020,110565,42,0,55,17,38
2020,110565,42,5,55,17,38
2020,110565,43,0,1,1,0
2020,110565,43,5,1,1,0
2020,110565,44,0,169,77,92
2020,110565,44,5,169,77,92
2020,110574,0,0,379,178,201
2020,110574,10,0,379,178,201
2020,110574,10,1,118,62,56
2020,110574,10,2,80,40,40
2020,110574,10,3,127,57,70
2020,110574,10,5,54,19,35
2020,110574,20,0,189,95,94
2020,110574,20,1,116,60,56
2020,110574,20,2,69,34,35
2020,110574,20,3,4,1,3
2020,110574,30,0,136,64,72
2020,110574,30,1,2,2,0
2020,110574,30,2,11,6,5
2020,110574,30,3,123,56,67
2020,110574,40,0,54,19,35
2020,110574,40,5,54,19,35
2020,110574,41,0,37,10,27
2020,110574,41,5,37,10,27
2020,110574,42,0,17,9,8
2020,110574,42,5,17,9,8
2020,110574,44,0,37,10,27
2020,110574,44,5,37,10,27
2020,110583,0,0,1087,520,567
2020,110583,10,0,1087,520,567
2020,110583,10,1,362,197,165
2020,110583,10,2,194,95,99
2020,110583,10,3,231,91,140
2020,110583,10,5,298,137,161
2020,110583,10,6,2,0,2
2020,110583,20,0,552,288,264
2020,110583,20,1,360,195,165
2020,110583,20,2,189,93,96
2020,110583,20,3,1,0,1
2020,110583,20,6,2,0,2
2020,110583,30,0,237,95,142
2020,110583,30,1,2,2,0
2020,110583,30,2,5,2,3
2020,110583,30,3,230,91,139
2020,110583,40,0,298,137,161
2020,110583,40,5,298,137,161
2020,110583,41,0,234,104,130
2020,110583,41,5,234,104,130
2020,110583,42,0,57,31,26
2020,110583,42,5,57,31,26
2020,110583,43,0,7,2,5
2020,110583,43,5,7,2,5
2020,110583,44,0,234,104,130
2020,110583,44,5,234,104,130
2020,110592,0,0,696,321,375
2020,110592,10,0,696,321,375
2020,110592,10,1,259,135,124
2020,110592,10,2,78,37,41
2020,110592,10,3,197,83,114
2020,110592,10,5,162,66,96
2020,110592,20,0,336,171,165
2020,110592,20,1,259,135,124
2020,110592,20,2,77,36,41
2020,110592,30,0,198,84,114
2020,110592,30,2,1,1,0
2020,110592,30,3,197,83,114
2020,110592,40,0,162,66,96
2020,110592,40,5,162,66,96
2020,110592,41,0,85,34,51
2020,110592,41,5,85,34,51
2020,110592,42,0,65,25,40
2020,110592,42,5,65,25,40
2020,110592,43,0,12,7,5
2020,110592,43,5,12,7,5
2020,110592,44,0,85,34,51
2020,110592,44,5,85,34,51
2020,110608,0,0,906,450,456
2020,110608,10,0,906,450,456
2020,110608,10,1,384,209,175
2020,110608,10,2,185,89,96
2020,110608,10,3,173,82,91
2020,110608,10,5,155,66,89
2020,110608,10,6,9,4,5
2020,110608,20,0,556,288,268
2020,110608,20,1,384,209,175
2020,110608,20,2,163,76,87
2020,110608,20,3,1,0,1
2020,110608,20,6,8,3,5
2020,110608,30,0,195,96,99
2020,110608,30,2,22,13,9
2020,110608,30,3,172,82,90
2020,110608,30,6,1,1,0
2020,110608,40,0,155,66,89
2020,110608,40,5,155,66,89
2020,110608,41,0,113,49,64
2020,110608,41,5,113,49,64
2020,110608,42,0,34,14,20
2020,110608,42,5,34,14,20
2020,110608,43,0,8,3,5
2020,110608,43,5,8,3,5
2020,110608,44,0,113,49,64
2020,110608,44,5,113,49,64
2020,110617,0,0,821,395,426
2020,110617,10,0,821,395,426
2020,110617,10,1,326,175,151
2020,110617,10,2,117,61,56
2020,110617,10,3,226,91,135
2020,110617,10,5,146,63,83
2020,110617,10,6,6,5,1
2020,110617,20,0,444,239,205
2020,110617,20,1,326,175,151
2020,110617,20,2,113,60,53
2020,110617,20,6,5,4,1
2020,110617,30,0,231,93,138
2020,110617,30,2,4,1,3
2020,110617,30,3,226,91,135
2020,110617,30,6,1,1,0
2020,110617,40,0,146,63,83
2020,110617,40,5,146,63,83
2020,110617,41,0,110,38,72
2020,110617,41,5,110,38,72
2020,110617,42,0,33,22,11
2020,110617,42,5,33,22,11
2020,110617,43,0,3,3,0
2020,110617,43,5,3,3,0
2020,110617,44,0,110,38,72
2020,110617,44,5,110,38,72
2020,110635,0,0,1847,1112,735
2020,110635,10,0,1845,1112,733
2020,110635,10,1,885,624,261
2020,110635,10,2,345,196,149
2020,110635,10,3,286,156,130
2020,110635,10,4,1,1,0
2020,110635,10,5,312,133,179
2020,110635,10,6,16,2,14
2020,110635,20,0,1192,802,390
2020,110635,20,1,841,602,239
2020,110635,20,2,323,185,138
2020,110635,20,5,28,15,13
2020,110635,30,0,237,132,105
2020,110635,30,1,9,4,5
2020,110635,30,3,225,126,99
2020,110635,30,5,3,2,1
2020,110635,40,0,416,178,238
2020,110635,40,1,35,18,17
2020,110635,40,2,22,11,11
2020,110635,40,3,61,30,31
2020,110635,40,4,1,1,0
2020,110635,40,5,281,116,165
2020,110635,40,6,16,2,14
2020,110635,41,0,255,102,153
2020,110635,41,1,32,15,17
2020,110635,41,2,21,10,11
2020,110635,41,3,47,17,30
2020,110635,41,4,1,1,0
2020,110635,41,5,153,59,94
2020,110635,41,6,1,0,1
2020,110635,42,0,156,75,81
2020,110635,42,1,3,3,0
2020,110635,42,2,1,1,0
2020,110635,42,3,14,13,1
2020,110635,42,5,123,56,67
2020,110635,42,6,15,2,13
2020,110635,43,0,5,1,4
2020,110635,43,5,5,1,4
2020,110635,44,0,255,102,153
2020,110635,44,1,32,15,17
2020,110635,44,2,21,10,11
2020,110635,44,3,47,17,30
2020,110635,44,4,1,1,0
2020,110635,44,5,153,59,94
2020,110635,44,6,1,0,1
2020,110635,50,0,2,0,2
2020,110644,0,0,2678,1522,1156
2020,110644,10,0,2676,1522,1154
2020,110644,10,1,1247,822,425
2020,110644,10,2,510,266,244
2020,110644,10,3,629,294,335
2020,110644,10,5,290,140,150
2020,110644,20,0,1282,815,467
2020,110644,20,1,954,636,318
2020,110644,20,2,311,172,139
2020,110644,20,5,17,7,10
2020,110644,30,0,314,156,158
2020,110644,30,1,4,3,1
2020,110644,30,3,281,142,139
2020,110644,30,5,29,11,18
2020,110644,40,0,1080,551,529
2020,110644,40,1,289,183,106
2020,110644,40,2,199,94,105
2020,110644,40,3,348,152,196
2020,110644,40,5,244,122,122
2020,110644,41,0,927,469,458
2020,110644,41,1,288,183,105
2020,110644,41,2,196,94,102
2020,110644,41,3,325,137,188
2020,110644,41,5,118,55,63
2020,110644,42,0,150,80,70
2020,110644,42,1,1,0,1
2020,110644,42,2,3,0,3
2020,110644,42,3,23,15,8
2020,110644,42,5,123,65,58
2020,110644,43,0,3,2,1
2020,110644,43,5,3,2,1
2020,110644,44,0,927,469,458
2020,110644,44,1,288,183,105
2020,110644,44,2,196,94,102
2020,110644,44,3,325,137,188
2020,110644,44,5,118,55,63
2020,110644,50,0,2,0,2
2020,110653,0,0,2125,1230,895
2020,110653,10,0,2125,1230,895
2020,110653,10,1,932,640,292
2020,110653,10,2,410,214,196
2020,110653,10,3,472,234,238
2020,110653,10,4,47,26,21
2020,110653,10,5,263,116,147
2020,110653,10,6,1,0,1
2020,110653,20,0,1074,686,388
2020,110653,20,1,738,522,216
2020,110653,20,2,275,138,137
2020,110653,20,5,61,26,35
2020,110653,30,0,290,141,149
2020,110653,30,1,5,1,4
2020,110653,30,3,245,121,124
2020,110653,30,5,40,19,21
2020,110653,40,0,761,403,358
2020,110653,40,1,189,117,72
2020,110653,40,2,135,76,59
2020,110653,40,3,227,113,114
2020,110653,40,4,47,26,21
2020,110653,40,5,162,71,91
2020,110653,40,6,1,0,1
2020,110653,41,0,672,359,313
2020,110653,41,1,186,117,69
2020,110653,41,2,135,76,59
2020,110653,41,3,213,103,110
2020,110653,41,4,47,26,21
2020,110653,41,5,90,37,53
2020,110653,41,6,1,0,1
2020,110653,42,0,89,44,45
2020,110653,42,1,3,0,3
2020,110653,42,3,14,10,4
2020,110653,42,5,72,34,38
2020,110653,44,0,672,359,313
2020,110653,44,1,186,117,69
2020,110653,44,2,135,76,59
2020,110653,44,3,213,103,110
2020,110653,44,4,47,26,21
2020,110653,44,5,90,37,53
2020,110653,44,6,1,0,1
2020,110662,0,0,4153,2411,1742
2020,110662,10,0,4142,2404,1738
2020,110662,10,1,1712,1165,547
2020,110662,10,2,621,342,279
2020,110662,10,3,1148,593,555
2020,110662,10,4,369,173,196
2020,110662,10,5,286,128,158
2020,110662,10,6,6,3,3
2020,110662,20,0,1502,998,504
2020,110662,20,1,1211,834,377
2020,110662,20,2,283,160,123
2020,110662,20,5,8,4,4
2020,110662,30,0,305,160,145
2020,110662,30,1,7,2,5
2020,110662,30,3,293,154,139
2020,110662,30,5,5,4,1
2020,110662,40,0,2335,1246,1089
2020,110662,40,1,494,329,165
2020,110662,40,2,338,182,156
2020,110662,40,3,855,439,416
2020,110662,40,4,369,173,196
2020,110662,40,5,273,120,153
2020,110662,40,6,6,3,3
2020,110662,41,0,2178,1175,1003
2020,110662,41,1,490,327,163
2020,110662,41,2,338,182,156
2020,110662,41,3,852,438,414
2020,110662,41,4,369,173,196
2020,110662,41,5,125,53,72
2020,110662,41,6,4,2,2
2020,110662,42,0,157,71,86
2020,110662,42,1,4,2,2
2020,110662,42,3,3,1,2
2020,110662,42,5,148,67,81
2020,110662,42,6,2,1,1
2020,110662,44,0,2178,1175,1003
2020,110662,44,1,490,327,163
2020,110662,44,2,338,182,156
2020,110662,44,3,852,438,414
2020,110662,44,4,369,173,196
2020,110662,44,5,125,53,72
2020,110662,44,6,4,2,2
2020,110662,50,0,11,7,4
2020,110671,0,0,1051,652,399
2020,110671,10,0,1049,651,398
2020,110671,10,1,374,280,94
2020,110671,10,2,244,137,107
2020,110671,10,3,289,164,125
2020,110671,10,4,3,3,0
2020,110671,10,5,132,65,67
2020,110671,10,6,7,2,5
2020,110671,20,0,607,411,196
2020,110671,20,1,361,271,90
2020,110671,20,2,231,128,103
2020,110671,20,5,15,12,3
2020,110671,30,0,262,147,115
2020,110671,30,3,238,135,103
2020,110671,30,5,24,12,12
2020,110671,40,0,180,93,87
2020,110671,40,1,13,9,4
2020,110671,40,2,13,9,4
2020,110671,40,3,51,29,22
2020,110671,40,4,3,3,0
2020,110671,40,5,93,41,52
2020,110671,40,6,7,2,5
2020,110671,41,0,134,69,65
2020,110671,41,1,13,9,4
2020,110671,41,2,13,9,4
2020,110671,41,3,33,16,17
2020,110671,41,4,3,3,0
2020,110671,41,5,68,31,37
2020,110671,41,6,4,1,3
2020,110671,42,0,46,24,22
2020,110671,42,3,18,13,5
2020,110671,42,5,25,10,15
2020,110671,42,6,3,1,2
2020,110671,44,0,134,69,65
2020,110671,44,1,13,9,4
2020,110671,44,2,13,9,4
2020,110671,44,3,33,16,17
2020,110671,44,4,3,3,0
2020,110671,44,5,68,31,37
2020,110671,44,6,4,1,3
2020,110671,50,0,2,1,1
2020,110680,0,0,2799,1713,1086
2020,110680,10,0,2772,1704,1068
2020,110680,10,1,1232,897,335
2020,110680,10,2,564,317,247
2020,110680,10,3,686,347,339
2020,110680,10,5,290,143,147
2020,110680,20,0,1136,838,298
2020,110680,20,1,828,650,178
2020,110680,20,2,254,156,98
2020,110680,20,5,54,32,22
2020,110680,30,0,330,184,146
2020,110680,30,3,283,158,125
2020,110680,30,5,47,26,21
2020,110680,40,0,1306,682,624
2020,110680,40,1,404,247,157
2020,110680,40,2,310,161,149
2020,110680,40,3,403,189,214
2020,110680,40,5,189,85,104
2020,110680,41,0,1143,602,541
2020,110680,41,1,400,246,154
2020,110680,41,2,304,155,149
2020,110680,41,3,384,177,207
2020,110680,41,5,55,24,31
2020,110680,42,0,161,79,82
2020,110680,42,1,4,1,3
2020,110680,42,2,6,6,0
2020,110680,42,3,19,12,7
2020,110680,42,5,132,60,72
2020,110680,43,0,2,1,1
2020,110680,43,5,2,1,1
2020,110680,44,0,1143,602,541
2020,110680,44,1,400,246,154
2020,110680,44,2,304,155,149
2020,110680,44,3,384,177,207
2020,110680,44,5,55,24,31
2020,110680,50,0,27,9,18
2020,110699,0,0,2874,1375,1499
2020,110699,10,0,2874,1375,1499
2020,110699,10,1,1148,673,475
2020,110699,10,2,657,268,389
2020,110699,10,3,987,396,591
2020,110699,10,4,82,38,44
2020,110699,20,0,289,187,102
2020,110699,20,1,255,173,82
2020,110699,20,2,34,14,20
2020,110699,30,0,33,19,14
2020,110699,30,3,33,19,14
2020,110699,40,0,2552,1169,1383
2020,110699,40,1,893,500,393
2020,110699,40,2,623,254,369
2020,110699,40,3,954,377,577
2020,110699,40,4,82,38,44
2020,110699,41,0,2547,1166,1381
2020,110699,41,1,893,500,393
2020,110699,41,2,623,254,369
2020,110699,41,3,949,374,575
2020,110699,41,4,82,38,44
2020,110699,42,0,5,3,2
2020,110699,42,3,5,3,2
2020,110699,44,0,2547,1166,1381
2020,110699,44,1,893,500,393
2020,110699,44,2,623,254,369
2020,110699,44,3,949,374,575
2020,110699,44,4,82,38,44
2020,110705,0,0,1097,641,456
2020,110705,10,0,1097,641,456
2020,110705,10,1,505,341,164
2020,110705,10,2,162,88,74
2020,110705,10,3,215,121,94
2020,110705,10,5,215,91,124
2020,110705,20,0,701,448,253
2020,110705,20,1,505,341,164
2020,110705,20,2,161,87,74
2020,110705,20,5,35,20,15
2020,110705,30,0,223,120,103
2020,110705,30,3,200,110,90
2020,110705,30,5,23,10,13
2020,110705,40,0,173,73,100
2020,110705,40,2,1,1,0
2020,110705,40,3,15,11,4
2020,110705,40,5,157,61,96
2020,110705,41,0,87,34,53
2020,110705,41,2,1,1,0
2020,110705,41,5,86,33,53
2020,110705,42,0,85,39,46
2020,110705,42,3,15,11,4
2020,110705,42,5,70,28,42
2020,110705,43,0,1,0,1
2020,110705,43,5,1,0,1
2020,110705,44,0,87,34,53
2020,110705,44,2,1,1,0
2020,110705,44,5,86,33,53
2020,110714,0,0,688,374,314
2020,110714,10,0,687,374,313
2020,110714,10,1,302,196,106
2020,110714,10,2,121,63,58
2020,110714,10,3,142,67,75
2020,110714,10,5,118,46,72
2020,110714,10,6,4,2,2
2020,110714,20,0,434,263,171
2020,110714,20,1,301,195,106
2020,110714,20,2,121,63,58
2020,110714,20,5,12,5,7
2020,110714,30,0,145,68,77
2020,110714,30,3,131,62,69
2020,110714,30,5,14,6,8
2020,110714,40,0,108,43,65
2020,110714,40,1,1,1,0
2020,110714,40,3,11,5,6
2020,110714,40,5,92,35,57
2020,110714,40,6,4,2,2
2020,110714,41,0,51,19,32
2020,110714,41,1,1,1,0
2020,110714,41,3,3,1,2
2020,110714,41,5,44,15,29
2020,110714,41,6,3,2,1
2020,110714,42,0,57,24,33
2020,110714,42,3,8,4,4
2020,110714,42,5,48,20,28
2020,110714,42,6,1,0,1
2020,110714,44,0,51,19,32
2020,110714,44,1,1,1,0
2020,110714,44,3,3,1,2
2020,110714,44,5,44,15,29
2020,110714,44,6,3,2,1
2020,110714,50,0,1,0,1
2020,110778,0,0,11,7,4
2020,110778,10,0,11,7,4
2020,110778,10,6,11,7,4
2020,110778,40,0,11,7,4
2020,110778,40,6,11,7,4
2020,110778,42,0,11,7,4
2020,110778,42,6,11,7,4
2020,111081,0,0,154,85,69
2020,111081,10,0,154,85,69
2020,111081,10,6,154,85,69
2020,111081,40,0,154,85,69
2020,111081,40,6,154,85,69
2020,111081,41,0,137,79,58
2020,111081,41,6,137,79,58
2020,111081,42,0,17,6,11
2020,111081,42,6,17,6,11
2020,111081,44,0,137,79,58
2020,111081,44,6,137,79,58
2020,111188,0,0,63,46,17
2020,111188,10,0,63,46,17
2020,111188,10,1,15,11,4
2020,111188,10,2,18,15,3
2020,111188,10,3,16,10,6
2020,111188,10,5,14,10,4
2020,111188,20,0,34,27,7
2020,111188,20,1,15,11,4
2020,111188,20,2,18,15,3
2020,111188,20,3,1,1,0
2020,111188,30,0,15,9,6
2020,111188,30,3,15,9,6
2020,111188,40,0,14,10,4
2020,111188,40,5,14,10,4
2020,111188,41,0,5,2,3
2020,111188,41,5,5,2,3
2020,111188,42,0,7,7,0
2020,111188,42,5,7,7,0
2020,111188,43,0,2,1,1
2020,111188,43,5,2,1,1
2020,111188,44,0,5,2,3
2020,111188,44,5,5,2,3
2020,111391,0,0,33,19,14
2020,111391,10,0,33,19,14
2020,111391,10,1,24,16,8
2020,111391,10,2,6,2,4
2020,111391,10,3,2,0,2
2020,111391,10,4,1,1,0
2020,111391,20,0,20,14,6
2020,111391,20,1,18,13,5
2020,111391,20,2,2,1,1
2020,111391,30,0,6,1,5
2020,111391,30,2,4,1,3
2020,111391,30,3,2,0,2
2020,111391,40,0,7,4,3
2020,111391,40,1,6,3,3
2020,111391,40,4,1,1,0
2020,111391,41,0,6,3,3
2020,111391,41,1,6,3,3
2020,111391,43,0,1,1,0
2020,111391,43,4,1,1,0
2020,111391,44,0,6,3,3
2020,111391,44,1,6,3,3
2020,111434,0,0,84,30,54
2020,111434,10,0,84,30,54
2020,111434,10,4,84,30,54
2020,111434,20,0,59,23,36
2020,111434,20,4,59,23,36
2020,111434,30,0,19,5,14
2020,111434,30,4,19,5,14
2020,111434,40,0,6,2,4
2020,111434,40,4,6,2,4
2020,111434,43,0,6,2,4
2020,111434,43,4,6,2,4
2020,111461,0,0,245,103,142
2020,111461,10,0,215,90,125
2020,111461,10,1,165,71,94
2020,111461,10,2,40,17,23
2020,111461,10,3,10,2,8
2020,111461,20,0,165,71,94
2020,111461,20,1,165,71,94
2020,111461,30,0,50,19,31
2020,111461,30,2,40,17,23
2020,111461,30,3,10,2,8
2020,111461,50,0,30,13,17
2020,111638,0,0,8,6,2
2020,111638,10,0,8,6,2
2020,111638,10,4,8,6,2
2020,111638,40,0,8,6,2
2020,111638,40,4,8,6,2
2020,111638,41,0,8,6,2
2020,111638,41,4,8,6,2
2020,111638,45,0,8,6,2
2020,111638,45,4,8,6,2
2020,111887,0,0,304,128,176
2020,111887,10,0,304,128,176
2020,111887,10,4,304,128,176
2020,111887,20,0,237,103,134
2020,111887,20,4,237,103,134
2020,111887,30,0,28,16,12
2020,111887,30,4,28,16,12
2020,111887,40,0,39,9,30
2020,111887,40,4,39,9,30
2020,111887,42,0,1,0,1
2020,111887,42,4,1,0,1
2020,111887,43,0,38,9,29
2020,111887,43,4,38,9,29
2020,111896,0,0,70,37,33
2020,111896,10,0,70,37,33
2020,111896,10,4,70,37,33
2020,111896,20,0,44,24,20
2020,111896,20,4,44,24,20
2020,111896,30,0,19,10,9
2020,111896,30,4,19,10,9
2020,111896,40,0,7,3,4
2020,111896,40,4,7,3,4
2020,111896,43,0,7,3,4
2020,111896,43,4,7,3,4
2020,111920,0,0,198,101,97
2020,111920,10,0,198,101,97
2020,111920,10,4,198,101,97
2020,111920,20,0,138,72,66
2020,111920,20,4,138,72,66
2020,111920,30,0,34,16,18
2020,111920,30,4,34,16,18
2020,111920,40,0,26,13,13
2020,111920,40,4,26,13,13
2020,111920,43,0,26,13,13
2020,111920,43,4,26,13,13
2020,111939,0,0,235,93,142
2020,111939,10,0,235,93,142
2020,111939,10,4,235,93,142
2020,111939,20,0,185,73,112
2020,111939,20,4,185,73,112
2020,111939,30,0,42,16,26
2020,111939,30,4,42,16,26
2020,111939,40,0,8,4,4
2020,111939,40,4,8,4,4
2020,111939,42,0,5,2,3
2020,111939,42,4,5,2,3
2020,111939,43,0,3,2,1
2020,111939,43,4,3,2,1
2020,111948,0,0,544,306,238
2020,111948,10,0,544,306,238
2020,111948,10,1,160,112,48
2020,111948,10,2,157,83,74
2020,111948,10,3,197,93,104
2020,111948,10,4,26,14,12
2020,111948,10,6,4,4,0
2020,111948,20,0,246,157,89
2020,111948,20,1,135,99,36
2020,111948,20,2,111,58,53
2020,111948,30,0,99,49,50
2020,111948,30,2,6,3,3
2020,111948,30,3,93,46,47
2020,111948,40,0,199,100,99
2020,111948,40,1,25,13,12
2020,111948,40,2,40,22,18
2020,111948,40,3,104,47,57
2020,111948,40,4,26,14,12
2020,111948,40,6,4,4,0
2020,111948,41,0,173,83,90
2020,111948,41,1,24,12,12
2020,111948,41,2,37,19,18
2020,111948,41,3,90,39,51
2020,111948,41,4,18,9,9
2020,111948,41,6,4,4,0
2020,111948,42,0,25,16,9
2020,111948,42,1,1,1,0
2020,111948,42,2,3,3,0
2020,111948,42,3,13,7,6
2020,111948,42,4,8,5,3
2020,111948,43,0,1,1,0
2020,111948,43,3,1,1,0
2020,111948,44,0,173,83,90
2020,111948,44,1,24,12,12
2020,111948,44,2,37,19,18
2020,111948,44,3,90,39,51
2020,111948,44,4,18,9,9
2020,111948,44,6,4,4,0
2020,111966,0,0,63,22,41
2020,111966,10,0,63,22,41
2020,111966,10,1,6,3,3
2020,111966,10,2,9,5,4
2020,111966,10,3,28,8,20
2020,111966,10,4,20,6,14
2020,111966,40,0,63,22,41
2020,111966,40,1,6,3,3
2020,111966,40,2,9,5,4
2020,111966,40,3,28,8,20
2020,111966,40,4,20,6,14
2020,111966,41,0,41,16,25
2020,111966,41,1,5,3,2
2020,111966,41,2,8,4,4
2020,111966,41,3,18,6,12
2020,111966,41,4,10,3,7
2020,111966,42,0,22,6,16
2020,111966,42,1,1,0,1
2020,111966,42,2,1,1,0
2020,111966,42,3,10,2,8
2020,111966,42,4,10,3,7
2020,111966,44,0,41,16,25
2020,111966,44,1,5,3,2
2020,111966,44,2,8,4,4
2020,111966,44,3,18,6,12
2020,111966,44,4,10,3,7
2020,112075,0,0,94,52,42
2020,112075,10,0,94,52,42
2020,112075,10,1,31,21,10
2020,112075,10,2,23,11,12
2020,112075,10,3,40,20,20
2020,112075,40,0,94,52,42
2020,112075,40,1,31,21,10
2020,112075,40,2,23,11,12
2020,112075,40,3,40,20,20
2020,112075,41,0,70,45,25
2020,112075,41,1,31,21,10
2020,112075,41,2,20,10,10
2020,112075,41,3,19,14,5
2020,112075,42,0,24,7,17
2020,112075,42,2,3,1,2
2020,112075,42,3,21,6,15
2020,112075,44,0,70,45,25
2020,112075,44,1,31,21,10
2020,112075,44,2,20,10,10
2020,112075,44,3,19,14,5
2020,112084,0,0,13,8,5
2020,112084,10,0,13,8,5
2020,112084,10,1,1,1,0
2020,112084,10,2,2,1,1
2020,112084,10,3,8,6,2
2020,112084,10,4,2,0,2
2020,112084,40,0,13,8,5
2020,112084,40,1,1,1,0
2020,112084,40,2,2,1,1
2020,112084,40,3,8,6,2
2020,112084,40,4,2,0,2
2020,112084,42,0,13,8,5
2020,112084,42,1,1,1,0
2020,112084,42,2,2,1,1
2020,112084,42,3,8,6,2
2020,112084,42,4,2,0,2
2020,112127,0,0,6,3,3
2020,112127,10,0,6,3,3
2020,112127,10,1,1,0,1
2020,112127,10,2,4,3,1
2020,112127,10,4,1,0,1
2020,112127,20,0,2,1,1
2020,112127,20,1,1,0,1
2020,112127,20,2,1,1,0
2020,112127,30,0,1,1,0
2020,112127,30,2,1,1,0
2020,112127,40,0,3,1,2
2020,112127,40,2,2,1,1
2020,112127,40,4,1,0,1
2020,112127,41,0,2,1,1
2020,112127,41,2,2,1,1
2020,112127,42,0,1,0,1
2020,112127,42,4,1,0,1
2020,112127,44,0,2,1,1
2020,112127,44,2,2,1,1
2020,112172,0,0,169,76,93
2020,112172,10,0,169,76,93
2020,112172,10,4,169,76,93
2020,112172,20,0,138,68,70
2020,112172,20,4,138,68,70
2020,112172,30,0,31,8,23
2020,112172,30,4,31,8,23
2020,112190,0,0,551,222,329
2020,112190,10,0,551,222,329
2020,112190,10,4,551,222,329
2020,112190,20,0,391,174,217
2020,112190,20,4,391,174,217
2020,112190,30,0,147,47,100
2020,112190,30,4,147,47,100
2020,112190,40,0,13,1,12
2020,112190,40,4,13,1,12
2020,112190,43,0,13,1,12
2020,112190,43,4,13,1,12
2020,112251,0,0,93,54,39
2020,112251,10,0,93,54,39
2020,112251,10,1,52,35,17
2020,112251,10,2,23,10,13
2020,112251,10,3,18,9,9
2020,112251,20,0,62,39,23
2020,112251,20,1,44,31,13
2020,112251,20,2,18,8,10
2020,112251,30,0,11,7,4
2020,112251,30,2,1,1,0
2020,112251,30,3,10,6,4
2020,112251,40,0,20,8,12
2020,112251,40,1,8,4,4
2020,112251,40,2,4,1,3
2020,112251,40,3,8,3,5
2020,112251,41,0,18,8,10
2020,112251,41,1,7,4,3
2020,112251,41,2,4,1,3
2020,112251,41,3,7,3,4
2020,112251,42,0,1,0,1
2020,112251,42,3,1,0,1
2020,112251,43,0,1,0,1
2020,112251,43,1,1,0,1
2020,112251,44,0,15,8,7
2020,112251,44,1,6,4,2
2020,112251,44,2,3,1,2
2020,112251,44,3,6,3,3
2020,112251,45,0,3,0,3
2020,112251,45,1,1,0,1
2020,112251,45,2,1,0,1
2020,112251,45,3,1,0,1
2020,112260,0,0,170,108,62
2020,112260,10,0,170,108,62
2020,112260,10,1,63,47,16
2020,112260,10,2,52,35,17
2020,112260,10,3,55,26,29
2020,112260,20,0,112,79,33
2020,112260,20,1,62,46,16
2020,112260,20,2,50,33,17
2020,112260,30,0,24,10,14
2020,112260,30,3,24,10,14
2020,112260,40,0,34,19,15
2020,112260,40,1,1,1,0
2020,112260,40,2,2,2,0
2020,112260,40,3,31,16,15
2020,112260,41,0,25,14,11
2020,112260,41,1,1,1,0
2020,112260,41,2,2,2,0
2020,112260,41,3,22,11,11
2020,112260,42,0,9,5,4
2020,112260,42,3,9,5,4
2020,112260,44,0,25,14,11
2020,112260,44,1,1,1,0
2020,112260,44,2,2,2,0
2020,112260,44,3,22,11,11
2020,112385,0,0,52,21,31
2020,112385,10,0,52,21,31
2020,112385,10,4,52,21,31
2020,112385,20,0,36,15,21
2020,112385,20,4,36,15,21
2020,112385,30,0,14,6,8
2020,112385,30,4,14,6,8
2020,112385,40,0,2,0,2
2020,112385,40,4,2,0,2
2020,112385,43,0,2,0,2
2020,112385,43,4,2,0,2
2020,112394,0,0,11,8,3
2020,112394,10,0,11,8,3
2020,112394,10,1,4,2,2
2020,112394,10,2,4,3,1
2020,112394,10,3,2,2,0
2020,112394,10,4,1,1,0
2020,112394,40,0,11,8,3
2020,112394,40,1,4,2,2
2020,112394,40,2,4,3,1
2020,112394,40,3,2,2,0
2020,112394,40,4,1,1,0
2020,112394,41,0,7,5,2
2020,112394,41,1,2,0,2
2020,112394,41,2,3,3,0
2020,112394,41,3,2,2,0
2020,112394,42,0,4,3,1
2020,112394,42,1,2,2,0
2020,112394,42,2,1,0,1
2020,112394,42,4,1,1,0
2020,112394,45,0,7,5,2
2020,112394,45,1,2,0,2
2020,112394,45,2,3,3,0
2020,112394,45,3,2,2,0
2020,112525,0,0,314,143,171
2020,112525,10,0,314,143,171
2020,112525,10,1,55,34,21
2020,112525,10,2,102,47,55
2020,112525,10,3,137,56,81
2020,112525,10,4,20,6,14
2020,112525,20,0,68,41,27
2020,112525,20,1,41,25,16
2020,112525,20,2,27,16,11
2020,112525,30,0,32,12,20
2020,112525,30,1,2,1,1
2020,112525,30,2,10,2,8
2020,112525,30,3,20,9,11
2020,112525,40,0,214,90,124
2020,112525,40,1,12,8,4
2020,112525,40,2,65,29,36
2020,112525,40,3,117,47,70
2020,112525,40,4,20,6,14
2020,112525,42,0,203,88,115
2020,112525,42,1,12,8,4
2020,112525,42,2,64,29,35
2020,112525,42,3,116,47,69
2020,112525,42,4,11,4,7
2020,112525,43,0,11,2,9
2020,112525,43,2,1,0,1
2020,112525,43,3,1,0,1
2020,112525,43,4,9,2,7
2020,112561,0,0,51,26,25
2020,112561,10,0,51,26,25
2020,112561,10,4,51,26,25
2020,112561,20,0,23,11,12
2020,112561,20,4,23,11,12
2020,112561,30,0,7,4,3
2020,112561,30,4,7,4,3
2020,112561,40,0,21,11,10
2020,112561,40,4,21,11,10
2020,112561,42,0,21,11,10
2020,112561,42,4,21,11,10
2020,112570,0,0,16,13,3
2020,112570,10,0,16,13,3
2020,112570,10,4,16,13,3
2020,112570,40,0,16,13,3
2020,112570,40,4,16,13,3
2020,112570,41,0,16,13,3
2020,112570,41,4,16,13,3
2020,112570,45,0,16,13,3
2020,112570,45,4,16,13,3
2020,112686,0,0,98,41,57
2020,112686,10,0,98,41,57
2020,112686,10,4,98,41,57
2020,112686,20,0,69,32,37
2020,112686,20,4,69,32,37
2020,112686,30,0,29,9,20
2020,112686,30,4,29,9,20
2020,112826,0,0,99,42,57
2020,112826,10,0,99,42,57
2020,112826,10,4,99,42,57
2020,112826,20,0,55,20,35
2020,112826,20,4,55,20,35
2020,112826,30,0,30,17,13
2020,112826,30,4,30,17,13
2020,112826,40,0,14,5,9
2020,112826,40,4,14,5,9
2020,112826,42,0,4,1,3
2020,112826,42,4,4,1,3
2020,112826,43,0,10,4,6
2020,112826,43,4,10,4,6
2020,113096,0,0,196,92,104
2020,113096,10,0,196,92,104
2020,113096,10,4,196,92,104
2020,113096,20,0,151,68,83
2020,113096,20,4,151,68,83
2020,113096,30,0,44,23,21
2020,113096,30,4,44,23,21
2020,113096,40,0,1,1,0
2020,113096,40,4,1,1,0
2020,113096,43,0,1,1,0
2020,113096,43,4,1,1,0
2020,113111,0,0,74,35,39
2020,113111,10,0,58,30,28
2020,113111,10,4,58,30,28
2020,113111,20,0,48,27,21
2020,113111,20,4,48,27,21
2020,113111,30,0,10,3,7
2020,113111,30,4,10,3,7
2020,113111,50,0,16,5,11
2020,113193,0,0,143,75,68
2020,113193,10,0,143,75,68
2020,113193,10,4,143,75,68
2020,113193,20,0,118,62,56
2020,113193,20,4,118,62,56
2020,113193,30,0,16,7,9
2020,113193,30,4,16,7,9
2020,113193,40,0,9,6,3
2020,113193,40,4,9,6,3
2020,113193,43,0,9,6,3
2020,113193,43,4,9,6,3
2020,113218,0,0,108,46,62
2020,113218,10,0,108,46,62
2020,113218,10,4,108,46,62
2020,113218,20,0,61,28,33
2020,113218,20,4,61,28,33
2020,113218,30,0,24,8,16
2020,113218,30,4,24,8,16
2020,113218,40,0,23,10,13
2020,113218,40,4,23,10,13
2020,113218,42,0,20,7,13
2020,113218,42,4,20,7,13
2020,113218,43,0,3,3,0
2020,113218,43,4,3,3,0
2020,113236,0,0,224,113,111
2020,113236,10,0,224,113,111
2020,113236,10,4,224,113,111
2020,113236,20,0,153,84,69
2020,113236,20,4,153,84,69
2020,113236,30,0,69,29,40
2020,113236,30,4,69,29,40
2020,113236,40,0,2,0,2
2020,113236,40,4,2,0,2
2020,113236,42,0,2,0,2
2020,113236,42,4,2,0,2
2020,113333,0,0,257,106,151
2020,113333,10,0,257,106,151
2020,113333,10,4,257,106,151
2020,113333,20,0,200,86,114
2020,113333,20,4,200,86,114
2020,113333,30,0,53,19,34
2020,113333,30,4,53,19,34
2020,113333,40,0,4,1,3
2020,113333,40,4,4,1,3
2020,113333,42,0,4,1,3
2020,113333,42,4,4,1,3
2020,113573,0,0,155,72,83
2020,113573,10,0,155,72,83
2020,113573,10,4,155,72,83
2020,113573,20,0,90,42,48
2020,113573,20,4,90,42,48
2020,113573,30,0,48,22,26
2020,113573,30,4,48,22,26
2020,113573,40,0,17,8,9
2020,113573,40,4,17,8,9
2020,113573,42,0,8,5,3
2020,113573,42,4,8,5,3
2020,113573,43,0,9,3,6
2020,113573,43,4,9,3,6
2020,113634,0,0,293,143,150
2020,113634,10,0,293,143,150
2020,113634,10,4,293,143,150
2020,113634,20,0,197,96,101
2020,113634,20,4,197,96,101
2020,113634,30,0,70,30,40
2020,113634,30,4,70,30,40
2020,113634,40,0,26,17,9
2020,113634,40,4,26,17,9
2020,113634,43,0,26,17,9
2020,113634,43,4,26,17,9
2020,113698,0,0,99,42,57
2020,113698,10,0,99,42,57
2020,113698,10,1,26,10,16
2020,113698,10,2,18,8,10
2020,113698,10,3,55,24,31
2020,113698,20,0,35,13,22
2020,113698,20,1,26,10,16
2020,113698,20,2,9,3,6
2020,113698,30,0,35,18,17
2020,113698,30,2,8,4,4
2020,113698,30,3,27,14,13
2020,113698,40,0,29,11,18
2020,113698,40,2,1,1,0
2020,113698,40,3,28,10,18
2020,113698,42,0,29,11,18
2020,113698,42,2,1,1,0
2020,113698,42,3,28,10,18
2020,113704,0,0,11,9,2
2020,113704,10,0,11,9,2
2020,113704,10,1,8,6,2
2020,113704,10,3,3,3,0
2020,113704,40,0,11,9,2
2020,113704,40,1,8,6,2
2020,113704,40,3,3,3,0
2020,113704,42,0,11,9,2
2020,113704,42,1,8,6,2
2020,113704,42,3,3,3,0
2020,113856,0,0,325,149,176
2020,113856,10,0,325,149,176
2020,113856,10,4,325,149,176
2020,113856,20,0,273,128,145
2020,113856,20,4,273,128,145
2020,113856,30,0,46,18,28
2020,113856,30,4,46,18,28
2020,113856,40,0,6,3,3
2020,113856,40,4,6,3,3
2020,113856,42,0,1,1,0
2020,113856,42,4,1,1,0
2020,113856,43,0,5,2,3
2020,113856,43,4,5,2,3
2020,113980,0,0,336,162,174
2020,113980,10,0,336,162,174
2020,113980,10,4,336,162,174
2020,113980,20,0,276,126,150
2020,113980,20,4,276,126,150
2020,113980,30,0,56,34,22
2020,113980,30,4,56,34,22
2020,113980,40,0,4,2,2
2020,113980,40,4,4,2,2
2020,113980,43,0,4,2,2
2020,113980,43,4,4,2,2
2020,114123,0,0,16,4,12
2020,114123,10,0,16,4,12
2020,114123,10,4,16,4,12
2020,114123,40,0,16,4,12
2020,114123,40,4,16,4,12
2020,114123,41,0,16,4,12
2020,114123,41,4,16,4,12
2020,114123,44,0,16,4,12
2020,114123,44,4,16,4,12
2020,114266,0,0,116,43,73
2020,114266,10,0,116,43,73
2020,114266,10,4,116,43,73
2020,114266,20,0,40,20,20
2020,114266,20,4,40,20,20
2020,114266,30,0,54,18,36
2020,114266,30,4,54,18,36
2020,114266,40,0,22,5,17
2020,114266,40,4,22,5,17
2020,114266,42,0,13,3,10
2020,114266,42,4,13,3,10
2020,114266,43,0,9,2,7
2020,114266,43,4,9,2,7
2020,114354,0,0,16,10,6
2020,114354,10,0,16,10,6
2020,114354,10,4,16,10,6
2020,114354,40,0,16,10,6
2020,114354,40,4,16,10,6
2020,114354,43,0,16,10,6
2020,114354,43,4,16,10,6
2020,114433,0,0,21,13,8
2020,114433,10,0,21,13,8
2020,114433,10,4,21,13,8
2020,114433,20,0,16,10,6
2020,114433,20,4,16,10,6
2020,114433,30,0,5,3,2
2020,114433,30,4,5,3,2
2020,114549,0,0,51,15,36
2020,114549,10,0,51,15,36
2020,114549,10,6,51,15,36
2020,114549,40,0,51,15,36
2020,114549,40,6,51,15,36
2020,114549,41,0,51,15,36
2020,114549,41,6,51,15,36
2020,114549,44,0,50,15,35
2020,114549,44,6,50,15,35
2020,114549,45,0,1,0,1
2020,114549,45,6,1,0,1
2020,114585,0,0,1,1,0
2020,114585,10,0,1,1,0
2020,114585,10,1,1,1,0
2020,114585,40,0,1,1,0
2020,114585,40,1,1,1,0
2020,114585,41,0,1,1,0
2020,114585,41,1,1,1,0
2020,114585,44,0,1,1,0
2020,114585,44,1,1,1,0
2020,114716,0,0,171,71,100
2020,114716,10,0,171,71,100
2020,114716,10,4,171,71,100
2020,114716,20,0,137,59,78
2020,114716,20,4,137,59,78
2020,114716,30,0,30,12,18
2020,114716,30,4,30,12,18
2020,114716,40,0,4,0,4
2020,114716,40,4,4,0,4
2020,114716,42,0,4,0,4
2020,114716,42,4,4,0,4
2020,114789,0,0,355,168,187
2020,114789,10,0,355,168,187
2020,114789,10,4,355,168,187
2020,114789,20,0,242,119,123
2020,114789,20,4,242,119,123
2020,114789,30,0,77,38,39
2020,114789,30,4,77,38,39
2020,114789,40,0,36,11,25
2020,114789,40,4,36,11,25
2020,114789,42,0,29,8,21
2020,114789,42,4,29,8,21
2020,114789,43,0,7,3,4
2020,114789,43,4,7,3,4
2020,114813,0,0,103,48,55
2020,114813,10,0,103,48,55
2020,114813,10,1,18,13,5
2020,114813,10,2,41,25,16
2020,114813,10,3,40,8,32
2020,114813,10,4,4,2,2
2020,114813,20,0,52,33,19
2020,114813,20,1,14,10,4
2020,114813,20,2,37,23,14
2020,114813,20,3,1,0,1
2020,114813,30,0,25,8,17
2020,114813,30,1,1,1,0
2020,114813,30,2,2,1,1
2020,114813,30,3,21,5,16
2020,114813,30,4,1,1,0
2020,114813,40,0,26,7,19
2020,114813,40,1,3,2,1
2020,114813,40,2,2,1,1
2020,114813,40,3,18,3,15
2020,114813,40,4,3,1,2
2020,114813,42,0,26,7,19
2020,114813,42,1,3,2,1
2020,114813,42,2,2,1,1
2020,114813,42,3,18,3,15
2020,114813,42,4,3,1,2
2020,114831,0,0,1,0,1
2020,114831,10,0,1,0,1
2020,114831,10,4,1,0,1
2020,114831,40,0,1,0,1
2020,114831,40,4,1,0,1
2020,114831,43,0,1,0,1
2020,114831,43,4,1,0,1
2020,114840,0,0,47,30,17
2020,114840,10,0,47,30,17
2020,114840,10,1,17,14,3
2020,114840,10,2,21,12,9
2020,114840,10,3,9,4,5
2020,114840,20,0,32,22,10
2020,114840,20,1,16,13,3
2020,114840,20,2,16,9,7
2020,114840,30,0,13,7,6
2020,114840,30,1,1,1,0
2020,114840,30,2,4,3,1
2020,114840,30,3,8,3,5
2020,114840,40,0,2,1,1
2020,114840,40,2,1,0,1
2020,114840,40,3,1,1,0
2020,114840,42,0,2,1,1
2020,114840,42,2,1,0,1
2020,114840,42,3,1,1,0
2020,114859,0,0,325,173,152
2020,114859,10,0,325,173,152
2020,114859,10,4,325,173,152
2020,114859,20,0,296,155,141
2020,114859,20,4,296,155,141
2020,114859,30,0,28,17,11
2020,114859,30,4,28,17,11
2020,114859,40,0,1,1,0
2020,114859,40,4,1,1,0
2020,114859,42,0,1,1,0
2020,114859,42,4,1,1,0
2020,114938,0,0,75,35,40
2020,114938,10,0,75,35,40
2020,114938,10,4,75,35,40
2020,114938,20,0,45,18,27
2020,114938,20,4,45,18,27
2020,114938,30,0,22,11,11
2020,114938,30,4,22,11,11
2020,114938,40,0,8,6,2
2020,114938,40,4,8,6,2
2020,114938,41,0,1,1,0
2020,114938,41,4,1,1,0
2020,114938,42,0,2,1,1
2020,114938,42,4,2,1,1
2020,114938,43,0,5,4,1
2020,114938,43,4,5,4,1
2020,114938,45,0,1,1,0
2020,114938,45,4,1,1,0
2020,115001,0,0,222,92,130
2020,115001,10,0,222,92,130
2020,115001,10,4,222,92,130
2020,115001,20,0,171,78,93
2020,115001,20,4,171,78,93
2020,115001,30,0,33,12,21
2020,115001,30,4,33,12,21
2020,115001,40,0,18,2,16
2020,115001,40,4,18,2,16
2020,115001,42,0,2,1,1
2020,115001,42,4,2,1,1
2020,115001,43,0,16,1,15
2020,115001,43,4,16,1,15
2020,115010,0,0,16,5,11
2020,115010,10,0,16,5,11
2020,115010,10,4,16,5,11
2020,115010,40,0,16,5,11
2020,115010,40,4,16,5,11
2020,115010,41,0,16,5,11
2020,115010,41,4,16,5,11
2020,115010,45,0,16,5,11
2020,115010,45,4,16,5,11
2020,115083,0,0,57,28,29
2020,115083,10,0,57,28,29
2020,115083,10,1,30,15,15
2020,115083,10,2,18,9,9
2020,115083,10,3,1,0,1
2020,115083,10,5,8,4,4
2020,115083,20,0,23,12,11
2020,115083,20,1,23,12,11
2020,115083,30,0,2,1,1
2020,115083,30,2,2,1,1
2020,115083,40,0,32,15,17
2020,115083,40,1,7,3,4
2020,115083,40,2,16,8,8
2020,115083,40,3,1,0,1
2020,115083,40,5,8,4,4
2020,115083,41,0,22,9,13
2020,115083,41,1,7,3,4
2020,115083,41,2,14,6,8
2020,115083,41,3,1,0,1
2020,115083,42,0,10,6,4
2020,115083,42,2,2,2,0
2020,115083,42,5,8,4,4
2020,115083,44,0,22,9,13
2020,115083,44,1,7,3,4
2020,115083,44,2,14,6,8
2020,115083,44,3,1,0,1
2020,115126,0,0,128,49,79
2020,115126,10,0,128,49,79
2020,115126,10,4,128,49,79
2020,115126,20,0,94,36,58
2020,115126,20,4,94,36,58
2020,115126,30,0,33,13,20
2020,115126,30,4,33,13,20
2020,115126,40,0,1,0,1
2020,115126,40,4,1,0,1
2020,115126,43,0,1,0,1
2020,115126,43,4,1,0,1
2020,115214,0,0,9,5,4
2020,115214,10,0,8,5,3
2020,115214,10,1,2,2,0
2020,115214,10,2,4,2,2
2020,115214,10,3,1,1,0
2020,115214,10,5,1,0,1
2020,115214,20,0,2,1,1
2020,115214,20,2,2,1,1
2020,115214,30,0,1,1,0
2020,115214,30,3,1,1,0
2020,115214,40,0,5,3,2
2020,115214,40,1,2,2,0
2020,115214,40,2,2,1,1
2020,115214,40,5,1,0,1
2020,115214,41,0,5,3,2
2020,115214,41,1,2,2,0
2020,115214,41,2,2,1,1
2020,115214,41,5,1,0,1
2020,115214,44,0,5,3,2
2020,115214,44,1,2,2,0
2020,115214,44,2,2,1,1
2020,115214,44,5,1,0,1
2020,115214,50,0,1,0,1
2020,115296,0,0,263,112,151
2020,115296,10,0,263,112,151
2020,115296,10,4,263,112,151
2020,115296,20,0,165,79,86
2020,115296,20,4,165,79,86
2020,115296,30,0,53,18,35
2020,115296,30,4,53,18,35
2020,115296,40,0,45,15,30
2020,115296,40,4,45,15,30
2020,115296,42,0,33,10,23
2020,115296,42,4,33,10,23
2020,115296,43,0,12,5,7
2020,115296,43,4,12,5,7
2020,115393,0,0,127,56,71
2020,115393,10,0,127,56,71
2020,115393,10,2,91,41,50
2020,115393,10,3,33,14,19
2020,115393,10,4,3,1,2
2020,115393,20,0,91,41,50
2020,115393,20,2,91,41,50
2020,115393,30,0,33,14,19
2020,115393,30,3,33,14,19
2020,115393,40,0,3,1,2
2020,115393,40,4,3,1,2
2020,115393,42,0,3,1,2
2020,115393,42,4,3,1,2
2020,115409,0,0,101,60,41
2020,115409,10,0,99,60,39
2020,115409,10,1,53,38,15
2020,115409,10,2,21,9,12
2020,115409,10,3,22,13,9
2020,115409,10,4,3,0,3
2020,115409,20,0,72,46,26
2020,115409,20,1,53,38,15
2020,115409,20,2,19,8,11
2020,115409,30,0,24,14,10
2020,115409,30,2,2,1,1
2020,115409,30,3,22,13,9
2020,115409,40,0,3,0,3
2020,115409,40,4,3,0,3
2020,115409,42,0,3,0,3
2020,115409,42,4,3,0,3
2020,115409,50,0,2,0,2
2020,115728,0,0,40,15,25
2020,115728,10,0,40,15,25
2020,115728,10,1,6,3,3
2020,115728,10,2,12,7,5
2020,115728,10,3,20,4,16
2020,115728,10,4,2,1,1
2020,115728,20,0,15,9,6
2020,115728,20,1,5,3,2
2020,115728,20,2,10,6,4
2020,115728,30,0,7,1,6
2020,115728,30,1,1,0,1
2020,115728,30,2,1,0,1
2020,115728,30,3,5,1,4
2020,115728,40,0,18,5,13
2020,115728,40,2,1,1,0
2020,115728,40,3,15,3,12
2020,115728,40,4,2,1,1
2020,115728,42,0,18,5,13
2020,115728,42,2,1,1,0
2020,115728,42,3,15,3,12
2020,115728,42,4,2,1,1
2020,115746,0,0,33,17,16
2020,115746,10,0,33,17,16
2020,115746,10,1,33,17,16
2020,115746,40,0,33,17,16
2020,115746,40,1,33,17,16
2020,115746,41,0,28,15,13
2020,115746,41,1,28,15,13
2020,115746,42,0,5,2,3
2020,115746,42,1,5,2,3
2020,115746,44,0,28,15,13
2020,115746,44,1,28,15,13
2020,115755,0,0,281,134,147
2020,115755,10,0,281,134,147
2020,115755,10,1,102,60,42
2020,115755,10,2,61,27,34
2020,115755,10,3,64,24,40
2020,115755,10,5,54,23,31
2020,115755,20,0,161,86,75
2020,115755,20,1,102,60,42
2020,115755,20,2,58,25,33
2020,115755,20,3,1,1,0
2020,115755,30,0,66,25,41
2020,115755,30,2,3,2,1
2020,115755,30,3,63,23,40
2020,115755,40,0,54,23,31
2020,115755,40,5,54,23,31
2020,115755,41,0,37,18,19
2020,115755,41,5,37,18,19
2020,115755,42,0,14,4,10
2020,115755,42,5,14,4,10
2020,115755,43,0,3,1,2
2020,115755,43,5,3,1,2
2020,115755,44,0,37,18,19
2020,115755,44,5,37,18,19
2020,115773,0,0,8,2,6
2020,115773,10,0,8,2,6
2020,115773,10,1,3,2,1
2020,115773,10,3,3,0,3
2020,115773,10,4,2,0,2
2020,115773,40,0,8,2,6
2020,115773,40,1,3,2,1
2020,115773,40,3,3,0,3
2020,115773,40,4,2,0,2
2020,115773,41,0,8,2,6
2020,115773,41,1,3,2,1
2020,115773,41,3,3,0,3
2020,115773,41,4,2,0,2
2020,115773,44,0,8,2,6
2020,115773,44,1,3,2,1
2020,115773,44,3,3,0,3
2020,115773,44,4,2,0,2
2020,115861,0,0,149,73,76
2020,115861,10,0,149,73,76
2020,115861,10,4,149,73,76
2020,115861,20,0,100,56,44
2020,115861,20,4,100,56,44
2020,115861,30,0,23,12,11
2020,115861,30,4,23,12,11
2020,115861,40,0,26,5,21
2020,115861,40,4,26,5,21
2020,115861,42,0,12,3,9
2020,115861,42,4,12,3,9
2020,115861,43,0,14,2,12
2020,115861,43,4,14,2,12
2020,115931,0,0,12,7,5
2020,115931,10,0,12,7,5
2020,115931,10,6,12,7,5
2020,115931,40,0,12,7,5
2020,115931,40,6,12,7,5
2020,115931,41,0,12,7,5
2020,115931,41,6,12,7,5
2020,115931,45,0,12,7,5
2020,115931,45,6,12,7,5
2020,116439,0,0,153,83,70
2020,116439,10,0,153,83,70
2020,116439,10,4,153,83,70
2020,116439,20,0,128,71,57
2020,116439,20,4,128,71,57
2020,116439,30,0,25,12,13
2020,116439,30,4,25,12,13
2020,116846,0,0,8,7,1
2020,116846,10,0,6,5,1
2020,116846,10,1,6,5,1
2020,116846,20,0,6,5,1
2020,116846,20,1,6,5,1
2020,116846,50,0,2,2,0
2020,117052,0,0,188,91,97
2020,117052,10,0,188,91,97
2020,117052,10,4,188,91,97
2020,117052,20,0,115,64,51
2020,117052,20,4,115,64,51
2020,117052,30,0,44,21,23
2020,117052,30,4,44,21,23
2020,117052,40,0,29,6,23
2020,117052,40,4,29,6,23
2020,117052,42,0,26,5,21
2020,117052,42,4,26,5,21
2020,117052,43,0,3,1,2
2020,117052,43,4,3,1,2
2020,117104,0,0,16,12,4
2020,117104,10,0,16,12,4
2020,117104,10,1,3,3,0
2020,117104,10,2,5,4,1
2020,117104,10,3,6,4,2
2020,117104,10,4,2,1,1
2020,117104,40,0,16,12,4
2020,117104,40,1,3,3,0
2020,117104,40,2,5,4,1
2020,117104,40,3,6,4,2
2020,117104,40,4,2,1,1
2020,117104,41,0,5,5,0
2020,117104,41,1,3,3,0
2020,117104,41,2,2,2,0
2020,117104,42,0,11,7,4
2020,117104,42,2,3,2,1
2020,117104,42,3,6,4,2
2020,117104,42,4,2,1,1
2020,117104,44,0,5,5,0
2020,117104,44,1,3,3,0
2020,117104,44,2,2,2,0
2020,117140,0,0,229,107,122
2020,117140,10,0,229,107,122
2020,117140,10,1,76,45,31
2020,117140,10,2,60,22,38
2020,117140,10,3,72,32,40
2020,117140,10,4,21,8,13
2020,117140,20,0,135,70,65
2020,117140,20,1,65,41,24
2020,117140,20,2,50,19,31
2020,117140,20,3,20,10,10
2020,117140,30,0,43,19,24
2020,117140,30,1,6,2,4
2020,117140,30,2,7,3,4
2020,117140,30,3,30,14,16
2020,117140,40,0,51,18,33
2020,117140,40,1,5,2,3
2020,117140,40,2,3,0,3
2020,117140,40,3,22,8,14
2020,117140,40,4,21,8,13
2020,117140,42,0,51,18,33
2020,117140,42,1,5,2,3
2020,117140,42,2,3,0,3
2020,117140,42,3,22,8,14
2020,117140,42,4,21,8,13
2020,117168,0,0,24,18,6
2020,117168,10,0,24,18,6
2020,117168,10,1,6,3,3
2020,117168,10,2,12,9,3
2020,117168,10,3,6,6,0
2020,117168,40,0,24,18,6
2020,117168,40,1,6,3,3
2020,117168,40,2,12,9,3
2020,117168,40,3,6,6,0
2020,117168,41,0,2,1,1
2020,117168,41,1,2,1,1
2020,117168,42,0,22,17,5
2020,117168,42,1,4,2,2
2020,117168,42,2,12,9,3
2020,117168,42,3,6,6,0
2020,117168,45,0,2,1,1
2020,117168,45,1,2,1,1
2020,117195,0,0,34,16,18
2020,117195,10,0,34,16,18
2020,117195,10,4,34,16,18
2020,117195,20,0,26,14,12
2020,117195,20,4,26,14,12
2020,117195,30,0,8,2,6
2020,117195,30,4,8,2,6
2020,117247,0,0,97,48,49
2020,117247,10,0,97,48,49
2020,117247,10,4,97,48,49
2020,117247,20,0,70,37,33
2020,117247,20,4,70,37,33
2020,117247,30,0,20,8,12
2020,117247,30,4,20,8,12
2020,117247,40,0,7,3,4
2020,117247,40,4,7,3,4
2020,117247,43,0,7,3,4
2020,117247,43,4,7,3,4
2020,117274,0,0,39,20,19
2020,117274,10,0,39,20,19
2020,117274,10,4,39,20,19
2020,117274,20,0,25,14,11
2020,117274,20,4,25,14,11
2020,117274,30,0,13,5,8
2020,117274,30,4,13,5,8
2020,117274,40,0,1,1,0
2020,117274,40,4,1,1,0
2020,117274,42,0,1,1,0
2020,117274,42,4,1,1,0
2020,117520,0,0,37,19,18
2020,117520,10,0,37,19,18
2020,117520,10,1,28,14,14
2020,117520,10,2,7,4,3
2020,117520,10,4,2,1,1
2020,117520,40,0,37,19,18
2020,117520,40,1,28,14,14
2020,117520,40,2,7,4,3
2020,117520,40,4,2,1,1
2020,117520,41,0,37,19,18
2020,117520,41,1,28,14,14
2020,117520,41,2,7,4,3
2020,117520,41,4,2,1,1
2020,117520,45,0,37,19,18
2020,117520,45,1,28,14,14
2020,117520,45,2,7,4,3
2020,117520,45,4,2,1,1
2020,117557,0,0,11,7,4
2020,117557,10,0,11,7,4
2020,117557,10,1,6,4,2
2020,117557,10,2,3,3,0
2020,117557,10,3,2,0,2
2020,117557,40,0,11,7,4
2020,117557,40,1,6,4,2
2020,117557,40,2,3,3,0
2020,117557,40,3,2,0,2
2020,117557,42,0,11,7,4
2020,117557,42,1,6,4,2
2020,117557,42,2,3,3,0
2020,117557,42,3,2,0,2
2020,117575,0,0,5,5,0
2020,117575,10,0,5,5,0
2020,117575,10,1,5,5,0
2020,117575,40,0,5,5,0
2020,117575,40,1,5,5,0
2020,117575,41,0,5,5,0
2020,117575,41,1,5,5,0
2020,117575,45,0,5,5,0
2020,117575,45,1,5,5,0
2020,117627,0,0,93,55,38
2020,117627,10,0,93,55,38
2020,117627,10,1,26,19,7
2020,117627,10,2,35,22,13
2020,117627,10,3,23,11,12
2020,117627,10,4,2,1,1
2020,117627,10,5,7,2,5
2020,117627,20,0,41,29,12
2020,117627,20,1,19,15,4
2020,117627,20,2,22,14,8
2020,117627,30,0,17,10,7
2020,117627,30,1,3,2,1
2020,117627,30,2,7,6,1
2020,117627,30,3,4,1,3
2020,117627,30,5,3,1,2
2020,117627,40,0,35,16,19
2020,117627,40,1,4,2,2
2020,117627,40,2,6,2,4
2020,117627,40,3,19,10,9
2020,117627,40,4,2,1,1
2020,117627,40,5,4,1,3
2020,117627,41,0,35,16,19
2020,117627,41,1,4,2,2
2020,117627,41,2,6,2,4
2020,117627,41,3,19,10,9
2020,117627,41,4,2,1,1
2020,117627,41,5,4,1,3
2020,117627,45,0,35,16,19
2020,117627,45,1,4,2,2
2020,117627,45,2,6,2,4
2020,117627,45,3,19,10,9
2020,117627,45,4,2,1,1
2020,117627,45,5,4,1,3
2020,117636,0,0,391,162,229
2020,117636,10,0,391,162,229
2020,117636,10,1,55,36,19
2020,117636,10,2,74,28,46
2020,117636,10,3,215,86,129
2020,117636,10,4,47,12,35
2020,117636,20,0,16,10,6
2020,117636,20,1,10,7,3
2020,117636,20,2,2,2,0
2020,117636,20,3,4,1,3
2020,117636,30,0,51,25,26
2020,117636,30,1,13,8,5
2020,117636,30,2,14,6,8
2020,117636,30,3,23,11,12
2020,117636,30,4,1,0,1
2020,117636,40,0,324,127,197
2020,117636,40,1,32,21,11
2020,117636,40,2,58,20,38
2020,117636,40,3,188,74,114
2020,117636,40,4,46,12,34
2020,117636,41,0,305,121,184
2020,117636,41,1,31,21,10
2020,117636,41,2,52,18,34
2020,117636,41,3,179,71,108
2020,117636,41,4,43,11,32
2020,117636,42,0,19,6,13
2020,117636,42,1,1,0,1
2020,117636,42,2,6,2,4
2020,117636,42,3,9,3,6
2020,117636,42,4,3,1,2
2020,117636,44,0,305,121,184
2020,117636,44,1,31,21,10
2020,117636,44,2,52,18,34
2020,117636,44,3,179,71,108
2020,117636,44,4,43,11,32
2020,117645,0,0,329,139,190
2020,117645,10,0,329,139,190
2020,117645,10,4,329,139,190
2020,117645,20,0,261,113,148
2020,117645,20,4,261,113,148
2020,117645,30,0,65,26,39
2020,117645,30,4,65,26,39
2020,117645,40,0,3,0,3
2020,117645,40,4,3,0,3
2020,117645,42,0,3,0,3
2020,117645,42,4,3,0,3
2020,117672,0,0,52,27,25
2020,117672,10,0,50,26,24
2020,117672,10,1,9,6,3
2020,117672,10,2,8,4,4
2020,117672,10,3,23,11,12
2020,117672,10,4,8,3,5
2020,117672,10,6,2,2,0
2020,117672,40,0,50,26,24
2020,117672,40,1,9,6,3
2020,117672,40,2,8,4,4
2020,117672,40,3,23,11,12
2020,117672,40,4,8,3,5
2020,117672,40,6,2,2,0
2020,117672,42,0,50,26,24
2020,117672,42,1,9,6,3
2020,117672,42,2,8,4,4
2020,117672,42,3,23,11,12
2020,117672,42,4,8,3,5
2020,117672,42,6,2,2,0
2020,117672,50,0,2,1,1
2020,117681,0,0,11,4,7
2020,117681,10,0,11,4,7
2020,117681,10,4,11,4,7
2020,117681,20,0,9,4,5
2020,117681,20,4,9,4,5
2020,117681,30,0,2,0,2
2020,117681,30,4,2,0,2
2020,117690,0,0,92,41,51
2020,117690,10,0,92,41,51
2020,117690,10,4,92,41,51
2020,117690,20,0,82,36,46
2020,117690,20,4,82,36,46
2020,117690,30,0,9,5,4
2020,117690,30,4,9,5,4
2020,117690,40,0,1,0,1
2020,117690,40,4,1,0,1
2020,117690,43,0,1,0,1
2020,117690,43,4,1,0,1
2020,117706,0,0,240,93,147
2020,117706,10,0,240,93,147
2020,117706,10,4,240,93,147
2020,117706,20,0,208,85,123
2020,117706,20,4,208,85,123
2020,117706,30,0,27,7,20
2020,117706,30,4,27,7,20
2020,117706,40,0,5,1,4
2020,117706,40,4,5,1,4
2020,117706,42,0,5,1,4
2020,117706,42,4,5,1,4
2020,117715,0,0,89,31,58
2020,117715,10,0,89,31,58
2020,117715,10,4,89,31,58
2020,117715,20,0,68,28,40
2020,117715,20,4,68,28,40
2020,117715,30,0,11,1,10
2020,117715,30,4,11,1,10
2020,117715,40,0,10,2,8
2020,117715,40,4,10,2,8
2020,117715,42,0,4,0,4
2020,117715,42,4,4,0,4
2020,117715,43,0,6,2,4
2020,117715,43,4,6,2,4
2020,117724,0,0,185,95,90
2020,117724,10,0,185,95,90
2020,117724,10,4,185,95,90
2020,117724,20,0,139,72,67
2020,117724,20,4,139,72,67
2020,117724,30,0,44,23,21
2020,117724,30,4,44,23,21
2020,117724,40,0,2,0,2
2020,117724,40,4,2,0,2
2020,117724,42,0,1,0,1
2020,117724,42,4,1,0,1
2020,117724,43,0,1,0,1
2020,117724,43,4,1,0,1
2020,117733,0,0,182,80,102
2020,117733,10,0,182,80,102
2020,117733,10,4,182,80,102
2020,117733,20,0,154,70,84
2020,117733,20,4,154,70,84
2020,117733,30,0,24,10,14
2020,117733,30,4,24,10,14
2020,117733,40,0,4,0,4
2020,117733,40,4,4,0,4
2020,117733,42,0,3,0,3
2020,117733,42,4,3,0,3
2020,117733,43,0,1,0,1
2020,117733,43,4,1,0,1
2020,117751,0,0,61,51,10
2020,117751,10,0,61,51,10
2020,117751,10,1,26,25,1
2020,117751,10,2,14,12,2
2020,117751,10,3,18,13,5
2020,117751,10,4,3,1,2
2020,117751,40,0,61,51,10
2020,117751,40,1,26,25,1
2020,117751,40,2,14,12,2
2020,117751,40,3,18,13,5
2020,117751,40,4,3,1,2
2020,117751,42,0,61,51,10
2020,117751,42,1,26,25,1
2020,117751,42,2,14,12,2
2020,117751,42,3,18,13,5
2020,117751,42,4,3,1,2
2020,117788,0,0,175,86,89
2020,117788,10,0,175,86,89
2020,117788,10,4,175,86,89
2020,117788,20,0,155,78,77
2020,117788,20,4,155,78,77
2020,117788,30,0,18,7,11
2020,117788,30,4,18,7,11
2020,117788,40,0,2,1,1
2020,117788,40,4,2,1,1
2020,117788,42,0,1,0,1
2020,117788,42,4,1,0,1
2020,117788,43,0,1,1,0
2020,117788,43,4,1,1,0
2020,117803,0,0,26,4,22
2020,117803,10,0,26,4,22
2020,117803,10,6,26,4,22
2020,117803,40,0,26,4,22
2020,117803,40,6,26,4,22
2020,117803,41,0,26,4,22
2020,117803,41,6,26,4,22
2020,117803,45,0,26,4,22
2020,117803,45,6,26,4,22
2020,117867,0,0,103,44,59
2020,117867,10,0,103,44,59
2020,117867,10,4,103,44,59
2020,117867,20,0,83,36,47
2020,117867,20,4,83,36,47
2020,117867,30,0,16,8,8
2020,117867,30,4,16,8,8
2020,117867,40,0,4,0,4
2020,117867,40,4,4,0,4
2020,117867,42,0,4,0,4
2020,117867,42,4,4,0,4
2020,117894,0,0,143,67,76
2020,117894,10,0,143,67,76
2020,117894,10,4,143,67,76
2020,117894,20,0,75,37,38
2020,117894,20,4,75,37,38
2020,117894,30,0,38,19,19
2020,117894,30,4,38,19,19
2020,117894,40,0,30,11,19
2020,117894,40,4,30,11,19
2020,117894,42,0,3,1,2
2020,117894,42,4,3,1,2
2020,117894,43,0,27,10,17
2020,117894,43,4,27,10,17
2020,117946,0,0,615,315,300
2020,117946,10,0,615,315,300
2020,117946,10,1,227,144,83
2020,117946,10,2,149,57,92
2020,117946,10,3,196,98,98
2020,117946,10,4,32,11,21
2020,117946,10,6,11,5,6
2020,117946,20,0,329,185,144
2020,117946,20,1,213,136,77
2020,117946,20,2,113,47,66
2020,117946,20,3,3,2,1
2020,117946,30,0,109,47,62
2020,117946,30,2,4,1,3
2020,117946,30,3,105,46,59
2020,117946,40,0,177,83,94
2020,117946,40,1,14,8,6
2020,117946,40,2,32,9,23
2020,117946,40,3,88,50,38
2020,117946,40,4,32,11,21
2020,117946,40,6,11,5,6
2020,117946,41,0,177,83,94
2020,117946,41,1,14,8,6
2020,117946,41,2,32,9,23
2020,117946,41,3,88,50,38
2020,117946,41,4,32,11,21
2020,117946,41,6,11,5,6
2020,117946,44,0,177,83,94
2020,117946,44,1,14,8,6
2020,117946,44,2,32,9,23
2020,117946,44,3,88,50,38
2020,117946,44,4,32,11,21
2020,117946,44,6,11,5,6
2020,118198,0,0,19,7,12
2020,118198,10,0,19,7,12
2020,118198,10,4,19,7,12
2020,118198,40,0,19,7,12
2020,118198,40,4,19,7,12
2020,118198,41,0,19,7,12
2020,118198,41,4,19,7,12
2020,118198,45,0,19,7,12
2020,118198,45,4,19,7,12
2020,118347,0,0,116,46,70
2020,118347,10,0,116,46,70
2020,118347,10,4,116,46,70
2020,118347,20,0,94,36,58
2020,118347,20,4,94,36,58
2020,118347,30,0,14,6,8
2020,118347,30,4,14,6,8
2020,118347,40,0,8,4,4
2020,118347,40,4,8,4,4
2020,118347,43,0,8,4,4
2020,118347,43,4,8,4,4
2020,118541,0,0,27,16,11
2020,118541,10,0,27,16,11
2020,118541,10,1,16,9,7
2020,118541,10,2,8,4,4
2020,118541,10,3,3,3,0
2020,118541,40,0,27,16,11
2020,118541,40,1,16,9,7
2020,118541,40,2,8,4,4
2020,118541,40,3,3,3,0
2020,118541,41,0,27,16,11
2020,118541,41,1,16,9,7
2020,118541,41,2,8,4,4
2020,118541,41,3,3,3,0
2020,118541,44,0,27,16,11
2020,118541,44,1,16,9,7
2020,118541,44,2,8,4,4
2020,118541,44,3,3,3,0
2020,118684,0,0,55,28,27
2020,118684,10,0,55,28,27
2020,118684,10,4,55,28,27
2020,118684,20,0,19,11,8
2020,118684,20,4,19,11,8
2020,118684,30,0,26,14,12
2020,118684,30,4,26,14,12
2020,118684,40,0,10,3,7
2020,118684,40,4,10,3,7
2020,118684,42,0,10,3,7
2020,118684,42,4,10,3,7
2020,118693,0,0,17,7,10
2020,118693,10,0,17,7,10
2020,118693,10,1,5,1,4
2020,118693,10,2,7,4,3
2020,118693,10,3,2,1,1
2020,118693,10,5,3,1,2
2020,118693,40,0,17,7,10
2020,118693,40,1,5,1,4
2020,118693,40,2,7,4,3
2020,118693,40,3,2,1,1
2020,118693,40,5,3,1,2
2020,118693,41,0,15,7,8
2020,118693,41,1,4,1,3
2020,118693,41,2,7,4,3
2020,118693,41,3,2,1,1
2020,118693,41,5,2,1,1
2020,118693,42,0,2,0,2
2020,118693,42,1,1,0,1
2020,118693,42,5,1,0,1
2020,118693,44,0,15,7,8
2020,118693,44,1,4,1,3
2020,118693,44,2,7,4,3
2020,118693,44,3,2,1,1
2020,118693,44,5,2,1,1
2020,118718,0,0,191,85,106
2020,118718,10,0,191,85,106
2020,118718,10,4,191,85,106
2020,118718,20,0,128,59,69
2020,118718,20,4,128,59,69
2020,118718,30,0,59,23,36
2020,118718,30,4,59,23,36
2020,118718,40,0,4,3,1
2020,118718,40,4,4,3,1
2020,118718,42,0,3,2,1
2020,118718,42,4,3,2,1
2020,118718,43,0,1,1,0
2020,118718,43,4,1,1,0
2020,118772,0,0,53,20,33
2020,118772,10,0,53,20,33
2020,118772,10,4,53,20,33
2020,118772,20,0,32,11,21
2020,118772,20,4,32,11,21
2020,118772,30,0,19,8,11
2020,118772,30,4,19,8,11
2020,118772,40,0,2,1,1
2020,118772,40,4,2,1,1
2020,118772,43,0,2,1,1
2020,118772,43,4,2,1,1
2020,118888,0,0,80,20,60
2020,118888,10,0,80,20,60
2020,118888,10,1,25,7,18
2020,118888,10,2,17,5,12
2020,118888,10,3,34,7,27
2020,118888,10,6,4,1,3
2020,118888,20,0,42,9,33
2020,118888,20,1,19,5,14
2020,118888,20,2,12,3,9
2020,118888,20,3,11,1,10
2020,118888,30,0,12,3,9
2020,118888,30,2,3,1,2
2020,118888,30,3,9,2,7
2020,118888,40,0,26,8,18
2020,118888,40,1,6,2,4
2020,118888,40,2,2,1,1
2020,118888,40,3,14,4,10
2020,118888,40,6,4,1,3
2020,118888,41,0,5,1,4
2020,118888,41,1,1,0,1
2020,118888,41,6,4,1,3
2020,118888,42,0,19,7,12
2020,118888,42,1,5,2,3
2020,118888,42,2,2,1,1
2020,118888,42,3,12,4,8
2020,118888,43,0,2,0,2
2020,118888,43,3,2,0,2
2020,118888,44,0,5,1,4
2020,118888,44,1,1,0,1
2020,118888,44,6,4,1,3
2020,118912,0,0,180,84,96
2020,118912,10,0,180,84,96
2020,118912,10,4,180,84,96
2020,118912,20,0,146,71,75
2020,118912,20,4,146,71,75
2020,118912,30,0,33,13,20
2020,118912,30,4,33,13,20
2020,118912,40,0,1,0,1
2020,118912,40,4,1,0,1
2020,118912,42,0,1,0,1
2020,118912,42,4,1,0,1
2020,118930,0,0,160,60,100
2020,118930,10,0,160,60,100
2020,118930,10,4,160,60,100
2020,118930,20,0,103,40,63
2020,118930,20,4,103,40,63
2020,118930,30,0,30,13,17
2020,118930,30,4,30,13,17
2020,118930,40,0,27,7,20
2020,118930,40,4,27,7,20
2020,118930,43,0,27,7,20
2020,118930,43,4,27,7,20
2020,118976,0,0,255,117,138
2020,118976,10,0,255,117,138
2020,118976,10,4,255,117,138
2020,118976,20,0,94,44,50
2020,118976,20,4,94,44,50
2020,118976,30,0,47,33,14
2020,118976,30,4,47,33,14
2020,118976,40,0,114,40,74
2020,118976,40,4,114,40,74
2020,118976,42,0,102,33,69
2020,118976,42,4,102,33,69
2020,118976,43,0,12,7,5
2020,118976,43,4,12,7,5
2020,119058,0,0,73,36,37
2020,119058,10,0,73,36,37
2020,119058,10,1,18,9,9
2020,119058,10,2,23,11,12
2020,119058,10,3,17,7,10
2020,119058,10,6,15,9,6
2020,119058,40,0,73,36,37
2020,119058,40,1,18,9,9
2020,119058,40,2,23,11,12
2020,119058,40,3,17,7,10
2020,119058,40,6,15,9,6
2020,119058,41,0,68,34,34
2020,119058,41,1,18,9,9
2020,119058,41,2,23,11,12
2020,119058,41,3,17,7,10
2020,119058,41,6,10,7,3
2020,119058,42,0,5,2,3
2020,119058,42,6,5,2,3
2020,119058,44,0,68,34,34
2020,119058,44,1,18,9,9
2020,119058,44,2,23,11,12
2020,119058,44,3,17,7,10
2020,119058,44,6,10,7,3
2020,119067,0,0,125,57,68
2020,119067,10,0,125,57,68
2020,119067,10,4,125,57,68
2020,119067,20,0,73,41,32
2020,119067,20,4,73,41,32
2020,119067,30,0,38,12,26
2020,119067,30,4,38,12,26
2020,119067,40,0,14,4,10
2020,119067,40,4,14,4,10
2020,119067,42,0,1,0,1
2020,119067,42,4,1,0,1
2020,119067,43,0,13,4,9
2020,119067,43,4,13,4,9
2020,119137,0,0,169,74,95
2020,119137,10,0,169,74,95
2020,119137,10,4,169,74,95
2020,119137,20,0,132,58,74
2020,119137,20,4,132,58,74
2020,119137,30,0,31,13,18
2020,119137,30,4,31,13,18
2020,119137,40,0,6,3,3
2020,119137,40,4,6,3,3
2020,119137,42,0,3,1,2
2020,119137,42,4,3,1,2
2020,119137,43,0,3,2,1
2020,119137,43,4,3,2,1
2020,119164,0,0,410,193,217
2020,119164,10,0,410,193,217
2020,119164,10,4,410,193,217
2020,119164,20,0,322,153,169
2020,119164,20,4,322,153,169
2020,119164,30,0,80,37,43
2020,119164,30,4,80,37,43
2020,119164,40,0,8,3,5
2020,119164,40,4,8,3,5
2020,119164,42,0,3,0,3
2020,119164,42,4,3,0,3
2020,119164,43,0,5,3,2
2020,119164,43,4,5,3,2
2020,119173,0,0,127,35,92
2020,119173,10,0,127,35,92
2020,119173,10,1,35,12,23
2020,119173,10,2,37,10,27
2020,119173,10,3,43,8,35
2020,119173,10,4,12,5,7
2020,119173,20,0,60,16,44
2020,119173,20,1,32,10,22
2020,119173,20,2,24,5,19
2020,119173,20,3,4,1,3
2020,119173,30,0,18,6,12
2020,119173,30,1,1,1,0
2020,119173,30,2,6,3,3
2020,119173,30,3,11,2,9
2020,119173,40,0,49,13,36
2020,119173,40,1,2,1,1
2020,119173,40,2,7,2,5
2020,119173,40,3,28,5,23
2020,119173,40,4,12,5,7
2020,119173,42,0,49,13,36
2020,119173,42,1,2,1,1
2020,119173,42,2,7,2,5
2020,119173,42,3,28,5,23
2020,119173,42,4,12,5,7
2020,119216,0,0,184,83,101
2020,119216,10,0,184,83,101
2020,119216,10,4,184,83,101
2020,119216,20,0,127,56,71
2020,119216,20,4,127,56,71
2020,119216,30,0,49,26,23
2020,119216,30,4,49,26,23
2020,119216,40,0,8,1,7
2020,119216,40,4,8,1,7
2020,119216,42,0,8,1,7
2020,119216,42,4,8,1,7
2020,119270,0,0,53,43,10
2020,119270,10,0,53,43,10
2020,119270,10,4,53,43,10
2020,119270,40,0,53,43,10
2020,119270,40,4,53,43,10
2020,119270,41,0,53,43,10
2020,119270,41,4,53,43,10
2020,119270,45,0,53,43,10
2020,119270,45,4,53,43,10
2020,119331,0,0,115,42,73
2020,119331,10,0,115,42,73
2020,119331,10,4,115,42,73
2020,119331,20,0,79,30,49
2020,119331,20,4,79,30,49
2020,119331,30,0,33,12,21
2020,119331,30,4,33,12,21
2020,119331,40,0,3,0,3
2020,119331,40,4,3,0,3
2020,119331,42,0,1,0,1
2020,119331,42,4,1,0,1
2020,119331,43,0,2,0,2
2020,119331,43,4,2,0,2
2020,119605,0,0,211,99,112
2020,119605,10,0,211,99,112
2020,119605,10,1,95,50,45
2020,119605,10,2,56,26,30
2020,119605,10,3,47,15,32
2020,119605,10,4,13,8,5
2020,119605,40,0,211,99,112
2020,119605,40,1,95,50,45
2020,119605,40,2,56,26,30
2020,119605,40,3,47,15,32
2020,119605,40,4,13,8,5
2020,119605,41,0,207,98,109
2020,119605,41,1,95,50,45
2020,119605,41,2,56,26,30
2020,119605,41,3,43,14,29
2020,119605,41,4,13,8,5
2020,119605,42,0,4,1,3
2020,119605,42,3,4,1,3
2020,119605,44,0,207,98,109
2020,119605,44,1,95,50,45
2020,119605,44,2,56,26,30
2020,119605,44,3,43,14,29
2020,119605,44,4,13,8,5
2020,119678,0,0,294,239,55
2020,119678,10,0,294,239,55
2020,119678,10,1,91,76,15
2020,119678,10,2,75,58,17
2020,119678,10,3,48,37,11
2020,119678,10,5,80,68,12
2020,119678,20,0,141,111,30
2020,119678,20,1,76,63,13
2020,119678,20,2,65,48,17
2020,119678,30,0,58,47,11
2020,119678,30,2,10,10,0
2020,119678,30,3,48,37,11
2020,119678,40,0,95,81,14
2020,119678,40,1,15,13,2
2020,119678,40,5,80,68,12
2020,119678,42,0,95,81,14
2020,119678,42,1,15,13,2
2020,119678,42,5,80,68,12
2020,119775,0,0,16,9,7
2020,119775,10,0,16,9,7
2020,119775,10,1,5,3,2
2020,119775,10,2,7,3,4
2020,119775,10,3,3,2,1
2020,119775,10,5,1,1,0
2020,119775,40,0,16,9,7
2020,119775,40,1,5,3,2
2020,119775,40,2,7,3,4
2020,119775,40,3,3,2,1
2020,119775,40,5,1,1,0
2020,119775,41,0,16,9,7
2020,119775,41,1,5,3,2
2020,119775,41,2,7,3,4
2020,119775,41,3,3,2,1
2020,119775,41,5,1,1,0
2020,119775,45,0,16,9,7
2020,119775,45,1,5,3,2
2020,119775,45,2,7,3,4
2020,119775,45,3,3,2,1
2020,119775,45,5,1,1,0
2020,120078,0,0,10,3,7
2020,120078,10,0,10,3,7
2020,120078,10,4,10,3,7
2020,120078,40,0,10,3,7
2020,120078,40,4,10,3,7
2020,120078,41,0,10,3,7
2020,120078,41,4,10,3,7
2020,120078,45,0,10,3,7
2020,120078,45,4,10,3,7
2020,120166,0,0,4,4,0
2020,120166,10,0,4,4,0
2020,120166,10,4,4,4,0
2020,120166,40,0,4,4,0
2020,120166,40,4,4,4,0
2020,120166,41,0,4,4,0
2020,120166,41,4,4,4,0
2020,120166,45,0,4,4,0
2020,120166,45,4,4,4,0
2020,120184,0,0,29,11,18
2020,120184,10,0,29,11,18
2020,120184,10,1,18,9,9
2020,120184,10,2,5,1,4
2020,120184,10,3,5,1,4
2020,120184,10,4,1,0,1
2020,120184,20,0,20,9,11
2020,120184,20,1,18,9,9
2020,120184,20,2,2,0,2
2020,120184,30,0,1,0,1
2020,120184,30,2,1,0,1
2020,120184,40,0,8,2,6
2020,120184,40,2,2,1,1
2020,120184,40,3,5,1,4
2020,120184,40,4,1,0,1
2020,120184,42,0,8,2,6
2020,120184,42,2,2,1,1
2020,120184,42,3,5,1,4
2020,120184,42,4,1,0,1
2020,120254,0,0,200,96,104
2020,120254,10,0,199,96,103
2020,120254,10,1,72,35,37
2020,120254,10,2,49,22,27
2020,120254,10,3,33,18,15
2020,120254,10,6,45,21,24
2020,120254,20,0,118,56,62
2020,120254,20,1,72,35,37
2020,120254,20,2,46,21,25
2020,120254,30,0,36,19,17
2020,120254,30,2,3,1,2
2020,120254,30,3,33,18,15
2020,120254,40,0,45,21,24
2020,120254,40,6,45,21,24
2020,120254,41,0,33,15,18
2020,120254,41,6,33,15,18
2020,120254,42,0,12,6,6
2020,120254,42,6,12,6,6
2020,120254,44,0,33,15,18
2020,120254,44,6,33,15,18
2020,120254,50,0,1,0,1
2020,120290,0,0,124,53,71
2020,120290,10,0,124,53,71
2020,120290,10,4,124,53,71
2020,120290,20,0,83,35,48
2020,120290,20,4,83,35,48
2020,120290,30,0,32,15,17
2020,120290,30,4,32,15,17
2020,120290,40,0,9,3,6
2020,120290,40,4,9,3,6
2020,120290,42,0,2,1,1
2020,120290,42,4,2,1,1
2020,120290,43,0,7,2,5
2020,120290,43,4,7,2,5
2020,120342,0,0,264,129,135
2020,120342,10,0,264,129,135
2020,120342,10,4,264,129,135
2020,120342,20,0,189,97,92
2020,120342,20,4,189,97,92
2020,120342,30,0,68,27,41
2020,120342,30,4,68,27,41
2020,120342,40,0,7,5,2
2020,120342,40,4,7,5,2
2020,120342,43,0,7,5,2
2020,120342,43,4,7,5,2
2020,120403,0,0,48,18,30
2020,120403,10,0,48,18,30
2020,120403,10,1,14,4,10
2020,120403,10,2,19,10,9
2020,120403,10,3,15,4,11
2020,120403,40,0,48,18,30
2020,120403,40,1,14,4,10
2020,120403,40,2,19,10,9
2020,120403,40,3,15,4,11
2020,120403,41,0,26,12,14
2020,120403,41,1,12,4,8
2020,120403,41,2,13,8,5
2020,120403,41,3,1,0,1
2020,120403,42,0,22,6,16
2020,120403,42,1,2,0,2
2020,120403,42,2,6,2,4
2020,120403,42,3,14,4,10
2020,120403,44,0,26,12,14
2020,120403,44,1,12,4,8
2020,120403,44,2,13,8,5
2020,120403,44,3,1,0,1
2020,120421,0,0,96,46,50
2020,120421,10,0,96,46,50
2020,120421,10,4,96,46,50
2020,120421,20,0,70,37,33
2020,120421,20,4,70,37,33
2020,120421,30,0,23,9,14
2020,120421,30,4,23,9,14
2020,120421,40,0,3,0,3
2020,120421,40,4,3,0,3
2020,120421,42,0,2,0,2
2020,120421,42,4,2,0,2
2020,120421,43,0,1,0,1
2020,120421,43,4,1,0,1
2020,120537,0,0,35,17,18
2020,120537,10,0,35,17,18
2020,120537,10,1,6,3,3
2020,120537,10,2,18,10,8
2020,120537,10,3,11,4,7
2020,120537,40,0,35,17,18
2020,120537,40,1,6,3,3
2020,120537,40,2,18,10,8
2020,120537,40,3,11,4,7
2020,120537,42,0,35,17,18
2020,120537,42,1,6,3,3
2020,120537,42,2,18,10,8
2020,120537,42,3,11,4,7
2020,120661,0,0,19,4,15
2020,120661,10,0,19,4,15
2020,120661,10,4,19,4,15
2020,120661,40,0,19,4,15
2020,120661,40,4,19,4,15
2020,120661,41,0,19,4,15
2020,120661,41,4,19,4,15
2020,120661,45,0,19,4,15
2020,120661,45,4,19,4,15
2020,120698,0,0,51,16,35
2020,120698,10,0,51,16,35
2020,120698,10,1,12,6,6
2020,120698,10,2,13,5,8
2020,120698,10,3,16,2,14
2020,120698,10,6,10,3,7
2020,120698,20,0,12,6,6
2020,120698,20,1,6,4,2
2020,120698,20,2,5,2,3
2020,120698,20,3,1,0,1
2020,120698,30,0,6,2,4
2020,120698,30,2,3,1,2
2020,120698,30,3,3,1,2
2020,120698,40,0,33,8,25
2020,120698,40,1,6,2,4
2020,120698,40,2,5,2,3
2020,120698,40,3,12,1,11
2020,120698,40,6,10,3,7
2020,120698,42,0,33,8,25
2020,120698,42,1,6,2,4
2020,120698,42,2,5,2,3
2020,120698,42,3,12,1,11
2020,120698,42,6,10,3,7
2020,120768,0,0,25,4,21
2020,120768,10,0,25,4,21
2020,120768,10,6,25,4,21
2020,120768,40,0,25,4,21
2020,120768,40,6,25,4,21
2020,120768,42,0,25,4,21
2020,120768,42,6,25,4,21
2020,120795,0,0,7,3,4
2020,120795,10,0,7,3,4
2020,120795,10,1,1,0,1
2020,120795,10,2,2,2,0
2020,120795,10,3,4,1,3
2020,120795,20,0,2,1,1
2020,120795,20,1,1,0,1
2020,120795,20,2,1,1,0
2020,120795,40,0,5,2,3
2020,120795,40,2,1,1,0
2020,120795,40,3,4,1,3
2020,120795,41,0,5,2,3
2020,120795,41,2,1,1,0
2020,120795,41,3,4,1,3
2020,120795,44,0,5,2,3
2020,120795,44,2,1,1,0
2020,120795,44,3,4,1,3
2020,120865,0,0,65,31,34
2020,120865,10,0,65,31,34
2020,120865,10,1,28,15,13
2020,120865,10,2,11,5,6
2020,120865,10,3,23,9,14
2020,120865,10,4,3,2,1
2020,120865,20,0,24,12,12
2020,120865,20,1,18,9,9
2020,120865,20,2,6,3,3
2020,120865,30,0,23,13,10
2020,120865,30,1,8,5,3
2020,120865,30,2,3,2,1
2020,120865,30,3,10,4,6
2020,120865,30,4,2,2,0
2020,120865,40,0,18,6,12
2020,120865,40,1,2,1,1
2020,120865,40,2,2,0,2
2020,120865,40,3,13,5,8
2020,120865,40,4,1,0,1
2020,120865,42,0,18,6,12
2020,120865,42,1,2,1,1
2020,120865,42,2,2,0,2
2020,120865,42,3,13,5,8
2020,120865,42,4,1,0,1
2020,120883,0,0,409,226,183
2020,120883,10,0,409,226,183
2020,120883,10,1,143,89,54
2020,120883,10,2,123,68,55
2020,120883,10,3,117,51,66
2020,120883,10,4,10,7,3
2020,120883,10,5,16,11,5
2020,120883,20,0,226,138,88
2020,120883,20,1,124,81,43
2020,120883,20,2,98,54,44
2020,120883,20,3,4,3,1
2020,120883,30,0,54,27,27
2020,120883,30,2,4,3,1
2020,120883,30,3,49,23,26
2020,120883,30,4,1,1,0
2020,120883,40,0,129,61,68
2020,120883,40,1,19,8,11
2020,120883,40,2,21,11,10
2020,120883,40,3,64,25,39
2020,120883,40,4,9,6,3
2020,120883,40,5,16,11,5
2020,120883,41,0,129,61,68
2020,120883,41,1,19,8,11
2020,120883,41,2,21,11,10
2020,120883,41,3,64,25,39
2020,120883,41,4,9,6,3
2020,120883,41,5,16,11,5
2020,120883,44,0,129,61,68
2020,120883,44,1,19,8,11
2020,120883,44,2,21,11,10
2020,120883,44,3,64,25,39
2020,120883,44,4,9,6,3
2020,120883,44,5,16,11,5
2020,120953,0,0,31,20,11
2020,120953,10,0,31,20,11
2020,120953,10,4,31,20,11
2020,120953,20,0,18,13,5
2020,120953,20,4,18,13,5
2020,120953,30,0,13,7,6
2020,120953,30,4,13,7,6
2020,120971,0,0,283,133,150
2020,120971,10,0,283,133,150
2020,120971,10,4,283,133,150
2020,120971,20,0,119,57,62
2020,120971,20,4,119,57,62
2020,120971,30,0,162,75,87
2020,120971,30,4,162,75,87
2020,120971,40,0,2,1,1
2020,120971,40,4,2,1,1
2020,120971,43,0,2,1,1
2020,120971,43,4,2,1,1
2020,121044,0,0,424,177,247
2020,121044,10,0,424,177,247
2020,121044,10,4,424,177,247
2020,121044,20,0,236,90,146
2020,121044,20,4,236,90,146
2020,121044,30,0,182,84,98
2020,121044,30,4,182,84,98
2020,121044,40,0,6,3,3
2020,121044,40,4,6,3,3
2020,121044,42,0,5,2,3
2020,121044,42,4,5,2,3
2020,121044,43,0,1,1,0
2020,121044,43,4,1,1,0
2020,121150,0,0,391,210,181
2020,121150,10,0,391,210,181
2020,121150,10,1,139,91,48
2020,121150,10,2,76,38,38
2020,121150,10,3,87,39,48
2020,121150,10,4,45,21,24
2020,121150,10,5,20,10,10
2020,121150,10,6,24,11,13
2020,121150,20,0,191,121,70
2020,121150,20,1,128,86,42
2020,121150,20,2,60,32,28
2020,121150,20,3,3,3,0
2020,121150,30,0,63,29,34
2020,121150,30,1,2,0,2
2020,121150,30,2,12,5,7
2020,121150,30,3,49,24,25
2020,121150,40,0,137,60,77
2020,121150,40,1,9,5,4
2020,121150,40,2,4,1,3
2020,121150,40,3,35,12,23
2020,121150,40,4,45,21,24
2020,121150,40,5,20,10,10
2020,121150,40,6,24,11,13
2020,121150,42,0,137,60,77
2020,121150,42,1,9,5,4
2020,121150,42,2,4,1,3
2020,121150,42,3,35,12,23
2020,121150,42,4,45,21,24
2020,121150,42,5,20,10,10
2020,121150,42,6,24,11,13
2020,121178,0,0,3,1,2
2020,121178,10,0,3,1,2
2020,121178,10,4,3,1,2
2020,121178,20,0,2,1,1
2020,121178,20,4,2,1,1
2020,121178,30,0,1,0,1
2020,121178,30,4,1,0,1
2020,121257,0,0,93,41,52
2020,121257,10,0,93,41,52
2020,121257,10,1,43,22,21
2020,121257,10,2,20,8,12
2020,121257,10,3,21,8,13
2020,121257,10,4,4,2,2
2020,121257,10,5,5,1,4
2020,121257,20,0,63,30,33
2020,121257,20,1,43,22,21
2020,121257,20,2,20,8,12
2020,121257,30,0,13,3,10
2020,121257,30,3,13,3,10
2020,121257,40,0,17,8,9
2020,121257,40,3,8,5,3
2020,121257,40,4,4,2,2
2020,121257,40,5,5,1,4
2020,121257,41,0,5,1,4
2020,121257,41,5,5,1,4
2020,121257,42,0,12,7,5
2020,121257,42,3,8,5,3
2020,121257,42,4,4,2,2
2020,121257,44,0,4,1,3
2020,121257,44,5,4,1,3
2020,121257,45,0,1,0,1
2020,121257,45,5,1,0,1
2020,121275,0,0,6,4,2
2020,121275,10,0,6,4,2
2020,121275,10,4,6,4,2
2020,121275,40,0,6,4,2
2020,121275,40,4,6,4,2
2020,121275,41,0,6,4,2
2020,121275,41,4,6,4,2
2020,121275,45,0,6,4,2
2020,121275,45,4,6,4,2
2020,121309,0,0,149,73,76
2020,121309,10,0,149,73,76
2020,121309,10,1,83,53,30
2020,121309,10,2,41,12,29
2020,121309,10,3,25,8,17
2020,121309,20,0,76,47,29
2020,121309,20,1,73,46,27
2020,121309,20,2,3,1,2
2020,121309,30,0,58,20,38
2020,121309,30,1,9,6,3
2020,121309,30,2,29,8,21
2020,121309,30,3,20,6,14
2020,121309,40,0,15,6,9
2020,121309,40,1,1,1,0
2020,121309,40,2,9,3,6
2020,121309,40,3,5,2,3
2020,121309,41,0,1,1,0
2020,121309,41,1,1,1,0
2020,121309,42,0,14,5,9
2020,121309,42,2,9,3,6
2020,121309,42,3,5,2,3
2020,121309,44,0,1,1,0
2020,121309,44,1,1,1,0
2020,121345,0,0,215,112,103
2020,121345,10,0,175,96,79
2020,121345,10,1,91,50,41
2020,121345,10,2,51,28,23
2020,121345,10,3,33,18,15
2020,121345,20,0,140,78,62
2020,121345,20,1,89,50,39
2020,121345,20,2,51,28,23
2020,121345,30,0,33,18,15
2020,121345,30,3,33,18,15
2020,121345,40,0,2,0,2
2020,121345,40,1,2,0,2
2020,121345,41,0,2,0,2
2020,121345,41,1,2,0,2
2020,121345,44,0,2,0,2
2020,121345,44,1,2,0,2
2020,121345,50,0,40,16,24
2020,121363,0,0,67,29,38
2020,121363,10,0,67,29,38
2020,121363,10,4,67,29,38
2020,121363,20,0,42,18,24
2020,121363,20,4,42,18,24
2020,121363,30,0,20,9,11
2020,121363,30,4,20,9,11
2020,121363,40,0,5,2,3
2020,121363,40,4,5,2,3
2020,121363,42,0,4,1,3
2020,121363,42,4,4,1,3
2020,121363,43,0,1,1,0
2020,121363,43,4,1,1,0
2020,121619,0,0,240,110,130
2020,121619,10,0,240,110,130
2020,121619,10,4,240,110,130
2020,121619,20,0,77,34,43
2020,121619,20,4,77,34,43
2020,121619,30,0,158,73,85
2020,121619,30,4,158,73,85
2020,121619,40,0,5,3,2
2020,121619,40,4,5,3,2
2020,121619,42,0,5,3,2
2020,121619,42,4,5,3,2
2020,121691,0,0,214,105,109
2020,121691,10,0,214,105,109
2020,121691,10,1,121,58,63
2020,121691,10,2,30,19,11
2020,121691,10,3,22,10,12
2020,121691,10,4,1,1,0
2020,121691,10,5,11,4,7
2020,121691,10,6,29,13,16
2020,121691,20,0,146,73,73
2020,121691,20,1,119,56,63
2020,121691,20,2,27,17,10
2020,121691,30,0,26,13,13
2020,121691,30,2,3,2,1
2020,121691,30,3,22,10,12
2020,121691,30,4,1,1,0
2020,121691,40,0,42,19,23
2020,121691,40,1,2,2,0
2020,121691,40,5,11,4,7
2020,121691,40,6,29,13,16
2020,121691,41,0,16,7,9
2020,121691,41,1,2,2,0
2020,121691,41,5,11,4,7
2020,121691,41,6,3,1,2
2020,121691,42,0,26,12,14
2020,121691,42,6,26,12,14
2020,121691,44,0,16,7,9
2020,121691,44,1,2,2,0
2020,121691,44,5,11,4,7
2020,121691,44,6,3,1,2
2020,121707,0,0,73,37,36
2020,121707,10,0,73,37,36
2020,121707,10,4,73,37,36
2020,121707,20,0,57,30,27
2020,121707,20,4,57,30,27
2020,121707,30,0,13,6,7
2020,121707,30,4,13,6,7
2020,121707,40,0,3,1,2
2020,121707,40,4,3,1,2
2020,121707,43,0,3,1,2
2020,121707,43,4,3,1,2
2020,121886,0,0,198,96,102
2020,121886,10,0,198,96,102
2020,121886,10,4,198,96,102
2020,121886,20,0,159,81,78
2020,121886,20,4,159,81,78
2020,121886,30,0,37,14,23
2020,121886,30,4,37,14,23
2020,121886,40,0,2,1,1
2020,121886,40,4,2,1,1
2020,121886,43,0,2,1,1
2020,121886,43,4,2,1,1
2020,121901,0,0,269,131,138
2020,121901,10,0,269,131,138
2020,121901,10,4,269,131,138
2020,121901,20,0,188,94,94
2020,121901,20,4,188,94,94
2020,121901,30,0,68,30,38
2020,121901,30,4,68,30,38
2020,121901,40,0,13,7,6
2020,121901,40,4,13,7,6
2020,121901,42,0,9,4,5
2020,121901,42,4,9,4,5
2020,121901,43,0,4,3,1
2020,121901,43,4,4,3,1
2020,122180,0,0,303,138,165
2020,122180,10,0,303,138,165
2020,122180,10,4,303,138,165
2020,122180,20,0,239,110,129
2020,122180,20,4,239,110,129
2020,122180,30,0,62,27,35
2020,122180,30,4,62,27,35
2020,122180,40,0,2,1,1
2020,122180,40,4,2,1,1
2020,122180,43,0,2,1,1
2020,122180,43,4,2,1,1
2020,122205,0,0,242,97,145
2020,122205,10,0,242,97,145
2020,122205,10,4,242,97,145
2020,122205,20,0,208,89,119
2020,122205,20,4,208,89,119
2020,122205,30,0,34,8,26
2020,122205,30,4,34,8,26
2020,122296,0,0,180,50,130
2020,122296,10,0,180,50,130
2020,122296,10,1,22,9,13
2020,122296,10,2,22,3,19
2020,122296,10,3,90,26,64
2020,122296,10,4,46,12,34
2020,122296,40,0,180,50,130
2020,122296,40,1,22,9,13
2020,122296,40,2,22,3,19
2020,122296,40,3,90,26,64
2020,122296,40,4,46,12,34
2020,122296,41,0,39,9,30
2020,122296,41,1,15,4,11
2020,122296,41,2,10,2,8
2020,122296,41,3,14,3,11
2020,122296,42,0,141,41,100
2020,122296,42,1,7,5,2
2020,122296,42,2,12,1,11
2020,122296,42,3,76,23,53
2020,122296,42,4,46,12,34
2020,122296,44,0,39,9,30
2020,122296,44,1,15,4,11
2020,122296,44,2,10,2,8
2020,122296,44,3,14,3,11
2020,122339,0,0,178,69,109
2020,122339,10,0,178,69,109
2020,122339,10,4,178,69,109
2020,122339,20,0,9,2,7
2020,122339,20,4,9,2,7
2020,122339,30,0,168,66,102
2020,122339,30,4,168,66,102
2020,122339,40,0,1,1,0
2020,122339,40,4,1,1,0
2020,122339,43,0,1,1,0
2020,122339,43,4,1,1,0
2020,122375,0,0,259,111,148
2020,122375,10,0,259,111,148
2020,122375,10,4,259,111,148
2020,122375,20,0,19,10,9
2020,122375,20,4,19,10,9
2020,122375,30,0,237,101,136
2020,122375,30,4,237,101,136
2020,122375,40,0,3,0,3
2020,122375,40,4,3,0,3
2020,122375,43,0,3,0,3
2020,122375,43,4,3,0,3
2020,122384,0,0,126,68,58
2020,122384,10,0,126,68,58
2020,122384,10,4,126,68,58
2020,122384,20,0,6,3,3
2020,122384,20,4,6,3,3
2020,122384,30,0,119,65,54
2020,122384,30,4,119,65,54
2020,122384,40,0,1,0,1
2020,122384,40,4,1,0,1
2020,122384,43,0,1,0,1
2020,122384,43,4,1,0,1
2020,122409,0,0,954,507,447
2020,122409,10,0,954,507,447
2020,122409,10,1,311,196,115
2020,122409,10,2,239,129,110
2020,122409,10,3,208,104,104
2020,122409,10,5,192,76,116
2020,122409,10,6,4,2,2
2020,122409,20,0,553,326,227
2020,122409,20,1,311,196,115
2020,122409,20,2,234,127,107
2020,122409,20,3,4,1,3
2020,122409,20,6,4,2,2
2020,122409,30,0,209,105,104
2020,122409,30,2,5,2,3
2020,122409,30,3,204,103,101
2020,122409,40,0,192,76,116
2020,122409,40,5,192,76,116
2020,122409,41,0,129,49,80
2020,122409,41,5,129,49,80
2020,122409,42,0,49,21,28
2020,122409,42,5,49,21,28
2020,122409,43,0,14,6,8
2020,122409,43,5,14,6,8
2020,122409,44,0,129,49,80
2020,122409,44,5,129,49,80
2020,122436,0,0,486,249,237
2020,122436,10,0,486,249,237
2020,122436,10,1,206,124,82
2020,122436,10,2,147,66,81
2020,122436,10,3,113,49,64
2020,122436,10,4,16,9,7
2020,122436,10,6,4,1,3
2020,122436,20,0,290,161,129
2020,122436,20,1,164,101,63
2020,122436,20,2,126,60,66
2020,122436,30,0,87,40,47
2020,122436,30,1,1,0,1
2020,122436,30,2,6,1,5
2020,122436,30,3,79,38,41
2020,122436,30,4,1,1,0
2020,122436,40,0,109,48,61
2020,122436,40,1,41,23,18
2020,122436,40,2,15,5,10
2020,122436,40,3,34,11,23
2020,122436,40,4,15,8,7
2020,122436,40,6,4,1,3
2020,122436,41,0,72,29,43
2020,122436,41,1,24,12,12
2020,122436,41,2,13,4,9
2020,122436,41,3,24,7,17
2020,122436,41,4,11,6,5
2020,122436,42,0,37,19,18
2020,122436,42,1,17,11,6
2020,122436,42,2,2,1,1
2020,122436,42,3,10,4,6
2020,122436,42,4,4,2,2
2020,122436,42,6,4,1,3
2020,122436,44,0,32,15,17
2020,122436,44,1,10,6,4
2020,122436,44,3,16,7,9
2020,122436,44,4,6,2,4
2020,122436,45,0,40,14,26
2020,122436,45,1,14,6,8
2020,122436,45,2,13,4,9
2020,122436,45,3,8,0,8
2020,122436,45,4,5,4,1
2020,122454,0,0,15,9,6
2020,122454,10,0,15,9,6
2020,122454,10,1,3,2,1
2020,122454,10,2,9,5,4
2020,122454,10,3,3,2,1
2020,122454,20,0,12,7,5
2020,122454,20,1,3,2,1
2020,122454,20,2,9,5,4
2020,122454,30,0,3,2,1
2020,122454,30,3,3,2,1
2020,122506,0,0,29,23,6
2020,122506,10,0,29,23,6
2020,122506,10,6,29,23,6
2020,122506,40,0,29,23,6
2020,122506,40,6,29,23,6
2020,122506,41,0,7,7,0
2020,122506,41,6,7,7,0
2020,122506,42,0,22,16,6
2020,122506,42,6,22,16,6
2020,122506,44,0,5,5,0
2020,122506,44,6,5,5,0
2020,122506,45,0,2,2,0
2020,122506,45,6,2,2,0
2020,122597,0,0,840,399,441
2020,122597,10,0,840,399,441
2020,122597,10,1,352,184,168
2020,122597,10,2,173,72,101
2020,122597,10,3,184,63,121
2020,122597,10,5,128,79,49
2020,122597,10,6,3,1,2
2020,122597,20,0,528,258,270
2020,122597,20,1,352,184,168
2020,122597,20,2,171,72,99
2020,122597,20,3,2,1,1
2020,122597,20,6,3,1,2
2020,122597,30,0,184,62,122
2020,122597,30,2,2,0,2
2020,122597,30,3,182,62,120
2020,122597,40,0,128,79,49
2020,122597,40,5,128,79,49
2020,122597,41,0,82,44,38
2020,122597,41,5,82,44,38
2020,122597,42,0,42,31,11
2020,122597,42,5,42,31,11
2020,122597,43,0,4,4,0
2020,122597,43,5,4,4,0
2020,122597,44,0,82,44,38
2020,122597,44,5,82,44,38
2020,122612,0,0,453,205,248
2020,122612,10,0,453,205,248
2020,122612,10,1,148,84,64
2020,122612,10,2,156,65,91
2020,122612,10,3,137,48,89
2020,122612,10,4,12,8,4
2020,122612,20,0,263,129,134
2020,122612,20,1,134,75,59
2020,122612,20,2,128,53,75
2020,122612,20,3,1,1,0
2020,122612,30,0,77,31,46
2020,122612,30,2,6,3,3
2020,122612,30,3,71,28,43
2020,122612,40,0,113,45,68
2020,122612,40,1,14,9,5
2020,122612,40,2,22,9,13
2020,122612,40,3,65,19,46
2020,122612,40,4,12,8,4
2020,122612,41,0,80,29,51
2020,122612,41,1,13,8,5
2020,122612,41,2,21,8,13
2020,122612,41,3,38,8,30
2020,122612,41,4,8,5,3
2020,122612,42,0,33,16,17
2020,122612,42,1,1,1,0
2020,122612,42,2,1,1,0
2020,122612,42,3,27,11,16
2020,122612,42,4,4,3,1
2020,122612,44,0,79,29,50
2020,122612,44,1,13,8,5
2020,122612,44,2,21,8,13
2020,122612,44,3,37,8,29
2020,122612,44,4,8,5,3
2020,122612,45,0,1,0,1
2020,122612,45,3,1,0,1
2020,122649,0,0,5,1,4
2020,122649,10,0,5,1,4
2020,122649,10,1,5,1,4
2020,122649,40,0,5,1,4
2020,122649,40,1,5,1,4
2020,122649,41,0,3,1,2
2020,122649,41,1,3,1,2
2020,122649,42,0,2,0,2
2020,122649,42,1,2,0,2
2020,122649,44,0,3,1,2
2020,122649,44,1,3,1,2
2020,122658,0,0,426,205,221
2020,122658,10,0,426,205,221
2020,122658,10,4,426,205,221
2020,122658,20,0,191,95,96
2020,122658,20,4,191,95,96
2020,122658,30,0,26,12,14
2020,122658,30,4,26,12,14
2020,122658,40,0,209,98,111
2020,122658,40,4,209,98,111
2020,122658,42,0,4,3,1
2020,122658,42,4,4,3,1
2020,122658,43,0,205,95,110
2020,122658,43,4,205,95,110
2020,122685,0,0,41,9,32
2020,122685,10,0,41,9,32
2020,122685,10,4,41,9,32
2020,122685,40,0,41,9,32
2020,122685,40,4,41,9,32
2020,122685,41,0,41,9,32
2020,122685,41,4,41,9,32
2020,122685,45,0,41,9,32
2020,122685,45,4,41,9,32
2020,122694,0,0,18,3,15
2020,122694,10,0,18,3,15
2020,122694,10,4,18,3,15
2020,122694,40,0,18,3,15
2020,122694,40,4,18,3,15
2020,122694,41,0,18,3,15
2020,122694,41,4,18,3,15
2020,122694,45,0,18,3,15
2020,122694,45,4,18,3,15
2020,122728,0,0,47,32,15
2020,122728,10,0,47,32,15
2020,122728,10,1,3,2,1
2020,122728,10,2,22,15,7
2020,122728,10,3,18,11,7
2020,122728,10,6,4,4,0
2020,122728,20,0,13,9,4
2020,122728,20,1,3,2,1
2020,122728,20,2,10,7,3
2020,122728,30,0,30,19,11
2020,122728,30,2,12,8,4
2020,122728,30,3,18,11,7
2020,122728,40,0,4,4,0
2020,122728,40,6,4,4,0
2020,122728,42,0,4,4,0
2020,122728,42,6,4,4,0
2020,122746,0,0,131,49,82
2020,122746,10,0,131,49,82
2020,122746,10,4,131,49,82
2020,122746,20,0,41,17,24
2020,122746,20,4,41,17,24
2020,122746,30,0,56,22,34
2020,122746,30,4,56,22,34
2020,122746,40,0,34,10,24
2020,122746,40,4,34,10,24
2020,122746,42,0,26,10,16
2020,122746,42,4,26,10,16
2020,122746,43,0,8,0,8
2020,122746,43,4,8,0,8
2020,122755,0,0,884,404,480
2020,122755,10,0,884,404,480
2020,122755,10,1,285,154,131
2020,122755,10,2,143,59,84
2020,122755,10,3,277,124,153
2020,122755,10,5,177,66,111
2020,122755,10,6,2,1,1
2020,122755,20,0,427,216,211
2020,122755,20,1,285,154,131
2020,122755,20,2,137,58,79
2020,122755,20,3,3,3,0
2020,122755,20,6,2,1,1
2020,122755,30,0,280,122,158
2020,122755,30,2,6,1,5
2020,122755,30,3,274,121,153
2020,122755,40,0,177,66,111
2020,122755,40,5,177,66,111
2020,122755,41,0,121,45,76
2020,122755,41,5,121,45,76
2020,122755,42,0,55,20,35
2020,122755,42,5,55,20,35
2020,122755,43,0,1,1,0
2020,122755,43,5,1,1,0
2020,122755,44,0,121,45,76
2020,122755,44,5,121,45,76
2020,122782,0,0,1,0,1
2020,122782,10,0,1,0,1
2020,122782,10,4,1,0,1
2020,122782,20,0,1,0,1
2020,122782,20,4,1,0,1
2020,122791,0,0,152,68,84
2020,122791,10,0,152,68,84
2020,122791,10,4,152,68,84
2020,122791,20,0,105,50,55
2020,122791,20,4,105,50,55
2020,122791,30,0,40,15,25
2020,122791,30,4,40,15,25
2020,122791,40,0,7,3,4
2020,122791,40,4,7,3,4
2020,122791,43,0,7,3,4
2020,122791,43,4,7,3,4
2020,122834,0,0,4,0,4
2020,122834,10,0,4,0,4
2020,122834,10,4,4,0,4
2020,122834,40,0,4,0,4
2020,122834,40,4,4,0,4
2020,122834,41,0,4,0,4
2020,122834,41,4,4,0,4
2020,122834,45,0,4,0,4
2020,122834,45,4,4,0,4
2020,122889,0,0,235,107,128
2020,122889,10,0,235,107,128
2020,122889,10,4,235,107,128
2020,122889,20,0,186,88,98
2020,122889,20,4,186,88,98
2020,122889,30,0,32,13,19
2020,122889,30,4,32,13,19
2020,122889,40,0,17,6,11
2020,122889,40,4,17,6,11
2020,122889,42,0,17,6,11
2020,122889,42,4,17,6,11
2020,122931,0,0,585,310,275
2020,122931,10,0,585,310,275
2020,122931,10,1,146,89,57
2020,122931,10,2,151,90,61
2020,122931,10,3,103,48,55
2020,122931,10,5,185,83,102
2020,122931,20,0,293,176,117
2020,122931,20,1,146,89,57
2020,122931,20,2,147,87,60
2020,122931,30,0,107,51,56
2020,122931,30,2,4,3,1
2020,122931,30,3,103,48,55
2020,122931,40,0,185,83,102
2020,122931,40,5,185,83,102
2020,122931,41,0,164,73,91
2020,122931,41,5,164,73,91
2020,122931,42,0,21,10,11
2020,122931,42,5,21,10,11
2020,122931,44,0,119,58,61
2020,122931,44,5,119,58,61
2020,122931,45,0,45,15,30
2020,122931,45,5,45,15,30
2020,122977,0,0,327,139,188
2020,122977,10,0,327,139,188
2020,122977,10,4,327,139,188
2020,122977,20,0,241,105,136
2020,122977,20,4,241,105,136
2020,122977,30,0,73,31,42
2020,122977,30,4,73,31,42
2020,122977,40,0,13,3,10
2020,122977,40,4,13,3,10
2020,122977,42,0,1,0,1
2020,122977,42,4,1,0,1
2020,122977,43,0,12,3,9
2020,122977,43,4,12,3,9
2020,123013,0,0,310,125,185
2020,123013,10,0,310,125,185
2020,123013,10,4,310,125,185
2020,123013,20,0,223,93,130
2020,123013,20,4,223,93,130
2020,123013,30,0,61,24,37
2020,123013,30,4,61,24,37
2020,123013,40,0,26,8,18
2020,123013,40,4,26,8,18
2020,123013,43,0,26,8,18
2020,123013,43,4,26,8,18
2020,123095,0,0,28,10,18
2020,123095,10,0,28,10,18
2020,123095,10,6,28,10,18
2020,123095,40,0,28,10,18
2020,123095,40,6,28,10,18
2020,123095,41,0,22,6,16
2020,123095,41,6,22,6,16
2020,123095,42,0,5,4,1
2020,123095,42,6,5,4,1
2020,123095,43,0,1,0,1
2020,123095,43,6,1,0,1
2020,123095,44,0,22,6,16
2020,123095,44,6,22,6,16
2020,123165,0,0,98,40,58
2020,123165,10,0,98,40,58
2020,123165,10,1,28,10,18
2020,123165,10,2,33,15,18
2020,123165,10,3,35,15,20
2020,123165,10,4,1,0,1
2020,123165,10,6,1,0,1
2020,123165,20,0,61,25,36
2020,123165,20,1,28,10,18
2020,123165,20,2,33,15,18
2020,123165,30,0,29,11,18
2020,123165,30,3,29,11,18
2020,123165,40,0,8,4,4
2020,123165,40,3,6,4,2
2020,123165,40,4,1,0,1
2020,123165,40,6,1,0,1
2020,123165,41,0,2,1,1
2020,123165,41,3,1,1,0
2020,123165,41,6,1,0,1
2020,123165,42,0,6,3,3
2020,123165,42,3,5,3,2
2020,123165,42,4,1,0,1
2020,123165,44,0,2,1,1
2020,123165,44,3,1,1,0
2020,123165,44,6,1,0,1
2020,123217,0,0,201,95,106
2020,123217,10,0,201,95,106
2020,123217,10,4,201,95,106
2020,123217,20,0,139,60,79
2020,123217,20,4,139,60,79
2020,123217,30,0,52,31,21
2020,123217,30,4,52,31,21
2020,123217,40,0,10,4,6
2020,123217,40,4,10,4,6
2020,123217,42,0,10,4,6
2020,123217,42,4,10,4,6
2020,123299,0,0,159,85,74
2020,123299,10,0,159,85,74
2020,123299,10,4,159,85,74
2020,123299,20,0,51,32,19
2020,123299,20,4,51,32,19
2020,123299,30,0,30,19,11
2020,123299,30,4,30,19,11
2020,123299,40,0,78,34,44
2020,123299,40,4,78,34,44
2020,123299,42,0,78,34,44
2020,123299,42,4,78,34,44
2020,123341,0,0,245,102,143
2020,123341,10,0,245,102,143
2020,123341,10,4,245,102,143
2020,123341,20,0,175,70,105
2020,123341,20,4,175,70,105
2020,123341,30,0,52,18,34
2020,123341,30,4,52,18,34
2020,123341,40,0,18,14,4
2020,123341,40,4,18,14,4
2020,123341,42,0,18,14,4
2020,123341,42,4,18,14,4
2020,123448,0,0,7,6,1
2020,123448,10,0,7,6,1
2020,123448,10,1,2,2,0
2020,123448,10,2,1,0,1
2020,123448,10,3,2,2,0
2020,123448,10,6,2,2,0
2020,123448,20,0,1,0,1
2020,123448,20,2,1,0,1
2020,123448,40,0,6,6,0
2020,123448,40,1,2,2,0
2020,123448,40,3,2,2,0
2020,123448,40,6,2,2,0
2020,123448,41,0,2,2,0
2020,123448,41,6,2,2,0
2020,123448,42,0,4,4,0
2020,123448,42,1,2,2,0
2020,123448,42,3,2,2,0
2020,123448,45,0,2,2,0
2020,123448,45,6,2,2,0
2020,123457,0,0,30,18,12
2020,123457,10,0,30,18,12
2020,123457,10,1,2,2,0
2020,123457,10,2,6,4,2
2020,123457,10,3,13,9,4
2020,123457,10,4,2,1,1
2020,123457,10,6,7,2,5
2020,123457,40,0,30,18,12
2020,123457,40,1,2,2,0
2020,123457,40,2,6,4,2
2020,123457,40,3,13,9,4
2020,123457,40,4,2,1,1
2020,123457,40,6,7,2,5
2020,123457,41,0,30,18,12
2020,123457,41,1,2,2,0
2020,123457,41,2,6,4,2
2020,123457,41,3,13,9,4
2020,123457,41,4,2,1,1
2020,123457,41,6,7,2,5
2020,123457,44,0,30,18,12
2020,123457,44,1,2,2,0
2020,123457,44,2,6,4,2
2020,123457,44,3,13,9,4
2020,123457,44,4,2,1,1
2020,123457,44,6,7,2,5
2020,123484,0,0,35,14,21
2020,123484,10,0,35,14,21
2020,123484,10,4,35,14,21
2020,123484,20,0,24,10,14
2020,123484,20,4,24,10,14
2020,123484,30,0,10,4,6
2020,123484,30,4,10,4,6
2020,123484,40,0,1,0,1
2020,123484,40,4,1,0,1
2020,123484,43,0,1,0,1
2020,123484,43,4,1,0,1
2020,123509,0,0,148,63,85
2020,123509,10,0,148,63,85
2020,123509,10,4,148,63,85
2020,123509,20,0,97,44,53
2020,123509,20,4,97,44,53
2020,123509,30,0,33,11,22
2020,123509,30,4,33,11,22
2020,123509,40,0,18,8,10
2020,123509,40,4,18,8,10
2020,123509,43,0,18,8,10
2020,123509,43,4,18,8,10
2020,123527,0,0,170,73,97
2020,123527,10,0,127,63,64
2020,123527,10,4,127,63,64
2020,123527,20,0,117,55,62
2020,123527,20,4,117,55,62
2020,123527,30,0,10,8,2
2020,123527,30,4,10,8,2
2020,123527,50,0,43,10,33
2020,123554,0,0,203,87,116
2020,123554,10,0,203,87,116
2020,123554,10,1,67,36,31
2020,123554,10,2,83,33,50
2020,123554,10,3,53,18,35
2020,123554,20,0,121,59,62
2020,123554,20,1,67,36,31
2020,123554,20,2,54,23,31
2020,123554,30,0,57,19,38
2020,123554,30,2,17,6,11
2020,123554,30,3,40,13,27
2020,123554,40,0,25,9,16
2020,123554,40,2,12,4,8
2020,123554,40,3,13,5,8
2020,123554,42,0,25,9,16
2020,123554,42,2,12,4,8
2020,123554,42,3,13,5,8
2020,123563,0,0,135,58,77
2020,123563,10,0,135,58,77
2020,123563,10,4,135,58,77
2020,123563,20,0,118,50,68
2020,123563,20,4,118,50,68
2020,123563,30,0,15,7,8
2020,123563,30,4,15,7,8
2020,123563,40,0,2,1,1
2020,123563,40,4,2,1,1
2020,123563,43,0,2,1,1
2020,123563,43,4,2,1,1
2020,123572,0,0,261,121,140
2020,123572,10,0,261,121,140
2020,123572,10,1,124,69,55
2020,123572,10,2,44,19,25
2020,123572,10,3,68,24,44
2020,123572,10,5,25,9,16
2020,123572,20,0,164,86,78
2020,123572,20,1,124,69,55
2020,123572,20,2,40,17,23
2020,123572,30,0,72,26,46
2020,123572,30,2,4,2,2
2020,123572,30,3,68,24,44
2020,123572,40,0,25,9,16
2020,123572,40,5,25,9,16
2020,123572,41,0,17,7,10
2020,123572,41,5,17,7,10
2020,123572,42,0,7,2,5
2020,123572,42,5,7,2,5
2020,123572,43,0,1,0,1
2020,123572,43,5,1,0,1
2020,123572,44,0,17,7,10
2020,123572,44,5,17,7,10
2020,123633,0,0,11,6,5
2020,123633,10,0,11,6,5
2020,123633,10,6,11,6,5
2020,123633,40,0,11,6,5
2020,123633,40,6,11,6,5
2020,123633,41,0,11,6,5
2020,123633,41,6,11,6,5
2020,123633,45,0,11,6,5
2020,123633,45,6,11,6,5
2020,123651,0,0,83,40,43
2020,123651,10,0,83,40,43
2020,123651,10,1,29,18,11
2020,123651,10,2,18,6,12
2020,123651,10,3,33,14,19
2020,123651,10,4,2,2,0
2020,123651,10,6,1,0,1
2020,123651,20,0,38,18,20
2020,123651,20,1,26,16,10
2020,123651,20,2,10,2,8
2020,123651,20,3,1,0,1
2020,123651,20,6,1,0,1
2020,123651,30,0,24,11,13
2020,123651,30,1,2,1,1
2020,123651,30,2,5,3,2
2020,123651,30,3,17,7,10
2020,123651,40,0,21,11,10
2020,123651,40,1,1,1,0
2020,123651,40,2,3,1,2
2020,123651,40,3,15,7,8
2020,123651,40,4,2,2,0
2020,123651,42,0,21,11,10
2020,123651,42,1,1,1,0
2020,123651,42,2,3,1,2
2020,123651,42,3,15,7,8
2020,123651,42,4,2,2,0
2020,123679,0,0,21,6,15
2020,123679,10,0,21,6,15
2020,123679,10,4,21,6,15
2020,123679,40,0,21,6,15
2020,123679,40,4,21,6,15
2020,123679,41,0,21,6,15
2020,123679,41,4,21,6,15
2020,123679,45,0,21,6,15
2020,123679,45,4,21,6,15
2020,123800,0,0,206,85,121
2020,123800,10,0,201,85,116
2020,123800,10,1,168,71,97
2020,123800,10,3,33,14,19
2020,123800,20,0,168,71,97
2020,123800,20,1,168,71,97
2020,123800,30,0,33,14,19
2020,123800,30,3,33,14,19
2020,123800,50,0,5,0,5
2020,123916,0,0,4,1,3
2020,123916,10,0,4,1,3
2020,123916,10,1,4,1,3
2020,123916,40,0,4,1,3
2020,123916,40,1,4,1,3
2020,123916,42,0,4,1,3
2020,123916,42,1,4,1,3
2020,123943,0,0,70,31,39
2020,123943,10,0,70,31,39
2020,123943,10,1,7,6,1
2020,123943,10,2,20,13,7
2020,123943,10,3,42,11,31
2020,123943,10,4,1,1,0
2020,123943,20,0,17,11,6
2020,123943,20,1,6,5,1
2020,123943,20,2,11,6,5
2020,123943,30,0,31,12,19
2020,123943,30,1,1,1,0
2020,123943,30,2,9,7,2
2020,123943,30,3,21,4,17
2020,123943,40,0,22,8,14
2020,123943,40,3,21,7,14
2020,123943,40,4,1,1,0
2020,123943,41,0,22,8,14
2020,123943,41,3,21,7,14
2020,123943,41,4,1,1,0
2020,123943,44,0,22,8,14
2020,123943,44,3,21,7,14
2020,123943,44,4,1,1,0
2020,123952,0,0,45,27,18
2020,123952,10,0,45,27,18
2020,123952,10,6,45,27,18
2020,123952,40,0,45,27,18
2020,123952,40,6,45,27,18
2020,123952,41,0,45,27,18
2020,123952,41,6,45,27,18
2020,123952,44,0,45,27,18
2020,123952,44,6,45,27,18
2020,123961,0,0,2403,1437,966
2020,123961,10,0,2403,1437,966
2020,123961,10,1,1039,722,317
2020,123961,10,2,685,363,322
2020,123961,10,3,508,272,236
2020,123961,10,4,1,1,0
2020,123961,10,5,170,79,91
2020,123961,20,0,1174,822,352
2020,123961,20,1,820,606,214
2020,123961,20,2,354,216,138
2020,123961,30,0,312,180,132
2020,123961,30,1,1,1,0
2020,123961,30,2,6,3,3
2020,123961,30,3,305,176,129
2020,123961,40,0,917,435,482
2020,123961,40,1,218,115,103
2020,123961,40,2,325,144,181
2020,123961,40,3,203,96,107
2020,123961,40,4,1,1,0
2020,123961,40,5,170,79,91
2020,123961,42,0,917,435,482
2020,123961,42,1,218,115,103
2020,123961,42,2,325,144,181
2020,123961,42,3,203,96,107
2020,123961,42,4,1,1,0
2020,123961,42,5,170,79,91
2020,123970,0,0,54,26,28
2020,123970,10,0,54,26,28
2020,123970,10,1,38,22,16
2020,123970,10,2,16,4,12
2020,123970,20,0,25,19,6
2020,123970,20,1,25,19,6
2020,123970,30,0,1,0,1
2020,123970,30,2,1,0,1
2020,123970,40,0,28,7,21
2020,123970,40,1,13,3,10
2020,123970,40,2,15,4,11
2020,123970,41,0,13,2,11
2020,123970,41,1,10,1,9
2020,123970,41,2,3,1,2
2020,123970,42,0,15,5,10
2020,123970,42,1,3,2,1
2020,123970,42,2,12,3,9
2020,123970,44,0,13,2,11
2020,123970,44,1,10,1,9
2020,123970,44,2,3,1,2
2020,124113,0,0,44,22,22
2020,124113,10,0,43,22,21
2020,124113,10,1,34,16,18
2020,124113,10,2,9,6,3
2020,124113,20,0,34,16,18
2020,124113,20,1,34,16,18
2020,124113,30,0,9,6,3
2020,124113,30,2,9,6,3
2020,124113,50,0,1,0,1
2020,124283,0,0,17,13,4
2020,124283,10,0,17,13,4
2020,124283,10,1,17,13,4
2020,124283,20,0,17,13,4
2020,124283,20,1,17,13,4
2020,124292,0,0,42,38,4
2020,124292,10,0,42,38,4
2020,124292,10,6,42,38,4
2020,124292,40,0,42,38,4
2020,124292,40,6,42,38,4
2020,124292,41,0,33,30,3
2020,124292,41,6,33,30,3
2020,124292,42,0,9,8,1
2020,124292,42,6,9,8,1
2020,124292,44,0,4,4,0
2020,124292,44,6,4,4,0
2020,124292,45,0,29,26,3
2020,124292,45,6,29,26,3
2020,124487,0,0,7,5,2
2020,124487,10,0,7,5,2
2020,124487,10,6,7,5,2
2020,124487,40,0,7,5,2
2020,124487,40,6,7,5,2
2020,124487,43,0,7,5,2
2020,124487,43,6,7,5,2
2020,124557,0,0,225,118,107
2020,124557,50,0,225,118,107
2020,124706,0,0,26,6,20
2020,124706,10,0,26,6,20
2020,124706,10,4,26,6,20
2020,124706,40,0,26,6,20
2020,124706,40,4,26,6,20
2020,124706,41,0,26,6,20
2020,124706,41,4,26,6,20
2020,124706,45,0,26,6,20
2020,124706,45,4,26,6,20
2020,124937,0,0,14,4,10
2020,124937,10,0,14,4,10
2020,124937,10,4,14,4,10
2020,124937,40,0,14,4,10
2020,124937,40,4,14,4,10
2020,124937,41,0,14,4,10
2020,124937,41,4,14,4,10
2020,124937,45,0,14,4,10
2020,124937,45,4,14,4,10
2020,125028,0,0,158,74,84
2020,125028,10,0,158,74,84
2020,125028,10,4,158,74,84
2020,125028,20,0,119,60,59
2020,125028,20,4,119,60,59
2020,125028,30,0,35,11,24
2020,125028,30,4,35,11,24
2020,125028,40,0,4,3,1
2020,125028,40,4,4,3,1
2020,125028,42,0,2,1,1
2020,125028,42,4,2,1,1
2020,125028,43,0,2,2,0
2020,125028,43,4,2,2,0
2020,125091,0,0,104,60,44
2020,125091,10,0,104,60,44
2020,125091,10,4,104,60,44
2020,125091,20,0,58,37,21
2020,125091,20,4,58,37,21
2020,125091,30,0,45,23,22
2020,125091,30,4,45,23,22
2020,125091,40,0,1,0,1
2020,125091,40,4,1,0,1
2020,125091,42,0,1,0,1
2020,125091,42,4,1,0,1
2020,125170,0,0,55,28,27
2020,125170,10,0,55,28,27
2020,125170,10,4,55,28,27
2020,125170,20,0,41,25,16
2020,125170,20,4,41,25,16
2020,125170,30,0,12,2,10
2020,125170,30,4,12,2,10
2020,125170,40,0,2,1,1
2020,125170,40,4,2,1,1
2020,125170,43,0,2,1,1
2020,125170,43,4,2,1,1
2020,125231,0,0,233,71,162
2020,125231,10,0,233,71,162
2020,125231,10,6,233,71,162
2020,125231,40,0,233,71,162
2020,125231,40,6,233,71,162
2020,125231,41,0,233,71,162
2020,125231,41,6,233,71,162
2020,125231,45,0,233,71,162
2020,125231,45,6,233,71,162
2020,125462,0,0,32,21,11
2020,125462,10,0,32,21,11
2020,125462,10,4,32,21,11
2020,125462,20,0,25,15,10
2020,125462,20,4,25,15,10
2020,125462,30,0,7,6,1
2020,125462,30,4,7,6,1
2020,125471,0,0,126,52,74
2020,125471,10,0,126,52,74
2020,125471,10,4,126,52,74
2020,125471,20,0,102,43,59
2020,125471,20,4,102,43,59
2020,125471,30,0,17,6,11
2020,125471,30,4,17,6,11
2020,125471,40,0,7,3,4
2020,125471,40,4,7,3,4
2020,125471,42,0,2,1,1
2020,125471,42,4,2,1,1
2020,125471,43,0,5,2,3
2020,125471,43,4,5,2,3
2020,125499,0,0,172,68,104
2020,125499,10,0,172,68,104
2020,125499,10,4,172,68,104
2020,125499,20,0,124,48,76
2020,125499,20,4,124,48,76
2020,125499,30,0,45,18,27
2020,125499,30,4,45,18,27
2020,125499,40,0,3,2,1
2020,125499,40,4,3,2,1
2020,125499,43,0,3,2,1
2020,125499,43,4,3,2,1
2020,125532,0,0,26,3,23
2020,125532,10,0,26,3,23
2020,125532,10,4,26,3,23
2020,125532,40,0,26,3,23
2020,125532,40,4,26,3,23
2020,125532,41,0,26,3,23
2020,125532,41,4,26,3,23
2020,125532,45,0,26,3,23
2020,125532,45,4,26,3,23
2020,125718,0,0,8,8,0
2020,125718,10,0,8,8,0
2020,125718,10,1,6,6,0
2020,125718,10,2,2,2,0
2020,125718,20,0,6,6,0
2020,125718,20,1,6,6,0
2020,125718,30,0,2,2,0
2020,125718,30,2,2,2,0
2020,125727,0,0,96,55,41
2020,125727,10,0,96,55,41
2020,125727,10,1,50,36,14
2020,125727,10,2,23,10,13
2020,125727,10,3,21,8,13
2020,125727,10,4,2,1,1
2020,125727,20,0,61,39,22
2020,125727,20,1,46,33,13
2020,125727,20,2,15,6,9
2020,125727,30,0,23,7,16
2020,125727,30,1,2,1,1
2020,125727,30,2,4,1,3
2020,125727,30,3,17,5,12
2020,125727,40,0,12,9,3
2020,125727,40,1,2,2,0
2020,125727,40,2,4,3,1
2020,125727,40,3,4,3,1
2020,125727,40,4,2,1,1
2020,125727,41,0,6,5,1
2020,125727,41,1,1,1,0
2020,125727,41,2,3,2,1
2020,125727,41,3,2,2,0
2020,125727,42,0,5,3,2
2020,125727,42,2,1,1,0
2020,125727,42,3,2,1,1
2020,125727,42,4,2,1,1
2020,125727,43,0,1,1,0
2020,125727,43,1,1,1,0
2020,125727,44,0,6,5,1
2020,125727,44,1,1,1,0
2020,125727,44,2,3,2,1
2020,125727,44,3,2,2,0
2020,125763,0,0,114,57,57
2020,125763,10,0,114,57,57
2020,125763,10,1,37,22,15
2020,125763,10,2,43,19,24
2020,125763,10,3,27,12,15
2020,125763,10,4,2,1,1
2020,125763,10,5,5,3,2
2020,125763,20,0,70,37,33
2020,125763,20,1,35,21,14
2020,125763,20,2,35,16,19
2020,125763,30,0,20,7,13
2020,125763,30,2,6,2,4
2020,125763,30,3,14,5,9
2020,125763,40,0,24,13,11
2020,125763,40,1,2,1,1
2020,125763,40,2,2,1,1
2020,125763,40,3,13,7,6
2020,125763,40,4,2,1,1
2020,125763,40,5,5,3,2
2020,125763,42,0,24,13,11
2020,125763,42,1,2,1,1
2020,125763,42,2,2,1,1
2020,125763,42,3,13,7,6
2020,125763,42,4,2,1,1
2020,125763,42,5,5,3,2
2020,125897,0,0,62,35,27
2020,125897,10,0,62,35,27
2020,125897,10,1,29,19,10
2020,125897,10,2,21,9,12
2020,125897,10,3,12,7,5
2020,125897,40,0,62,35,27
2020,125897,40,1,29,19,10
2020,125897,40,2,21,9,12
2020,125897,40,3,12,7,5
2020,125897,41,0,50,28,22
2020,125897,41,1,29,19,10
2020,125897,41,2,21,9,12
2020,125897,42,0,12,7,5
2020,125897,42,3,12,7,5
2020,125897,44,0,50,28,22
2020,125897,44,1,29,19,10
2020,125897,44,2,21,9,12
2020,126012,0,0,29,7,22
2020,126012,10,0,28,7,21
2020,126012,10,1,3,0,3
2020,126012,10,2,1,0,1
2020,126012,10,3,5,0,5
2020,126012,10,6,19,7,12
2020,126012,20,0,4,0,4
2020,126012,20,1,2,0,2
2020,126012,20,2,1,0,1
2020,126012,20,3,1,0,1
2020,126012,30,0,5,0,5
2020,126012,30,1,1,0,1
2020,126012,30,3,4,0,4
2020,126012,40,0,19,7,12
2020,126012,40,6,19,7,12
2020,126012,41,0,19,7,12
2020,126012,41,6,19,7,12
2020,126012,45,0,19,7,12
2020,126012,45,6,19,7,12
2020,126012,50,0,1,0,1
2020,126049,0,0,4,3,1
2020,126049,10,0,4,3,1
2020,126049,10,1,2,2,0
2020,126049,10,2,2,1,1
2020,126049,20,0,4,3,1
2020,126049,20,1,2,2,0
2020,126049,20,2,2,1,1
2020,126076,0,0,8,8,0
2020,126076,10,0,8,8,0
2020,126076,10,4,8,8,0
2020,126076,40,0,8,8,0
2020,126076,40,4,8,8,0
2020,126076,42,0,8,8,0
2020,126076,42,4,8,8,0
2020,126100,0,0,10,8,2
2020,126100,10,0,10,8,2
2020,126100,10,4,10,8,2
2020,126100,20,0,7,6,1
2020,126100,20,4,7,6,1
2020,126100,30,0,2,2,0
2020,126100,30,4,2,2,0
2020,126100,40,0,1,0,1
2020,126100,40,4,1,0,1
2020,126100,42,0,1,0,1
2020,126100,42,4,1,0,1
2020,126119,0,0,76,35,41
2020,126119,10,0,76,35,41
2020,126119,10,1,76,35,41
2020,126119,20,0,58,28,30
2020,126119,20,1,58,28,30
2020,126119,30,0,15,7,8
2020,126119,30,1,15,7,8
2020,126119,40,0,3,0,3
2020,126119,40,1,3,0,3
2020,126119,42,0,3,0,3
2020,126119,42,1,3,0,3
2020,126182,0,0,95,43,52
2020,126182,10,0,95,43,52
2020,126182,10,1,18,10,8
2020,126182,10,2,10,4,6
2020,126182,10,3,16,8,8
2020,126182,10,6,51,21,30
2020,126182,20,0,31,17,14
2020,126182,20,1,18,10,8
2020,126182,20,2,9,4,5
2020,126182,20,3,4,3,1
2020,126182,30,0,15,7,8
2020,126182,30,2,1,0,1
2020,126182,30,3,11,4,7
2020,126182,30,6,3,3,0
2020,126182,40,0,49,19,30
2020,126182,40,3,1,1,0
2020,126182,40,6,48,18,30
2020,126182,42,0,49,19,30
2020,126182,42,3,1,1,0
2020,126182,42,6,48,18,30
2020,126207,0,0,118,56,62
2020,126207,10,0,118,56,62
2020,126207,10,1,48,23,25
2020,126207,10,2,8,3,5
2020,126207,10,3,3,1,2
2020,126207,10,4,59,29,30
2020,126207,20,0,68,30,38
2020,126207,20,1,48,23,25
2020,126207,20,2,8,3,5
2020,126207,20,3,3,1,2
2020,126207,20,4,9,3,6
2020,126207,30,0,40,18,22
2020,126207,30,4,40,18,22
2020,126207,40,0,10,8,2
2020,126207,40,4,10,8,2
2020,126207,41,0,10,8,2
2020,126207,41,4,10,8,2
2020,126207,45,0,10,8,2
2020,126207,45,4,10,8,2
2020,126289,0,0,109,43,66
2020,126289,10,0,109,43,66
2020,126289,10,1,109,43,66
2020,126289,20,0,78,30,48
2020,126289,20,1,78,30,48
2020,126289,30,0,31,13,18
2020,126289,30,1,31,13,18
2020,126359,0,0,9,2,7
2020,126359,10,0,9,2,7
2020,126359,10,1,1,1,0
2020,126359,10,4,8,1,7
2020,126359,40,0,9,2,7
2020,126359,40,1,1,1,0
2020,126359,40,4,8,1,7
2020,126359,41,0,9,2,7
2020,126359,41,1,1,1,0
2020,126359,41,4,8,1,7
2020,126359,45,0,9,2,7
2020,126359,45,1,1,1,0
2020,126359,45,4,8,1,7
2020,126562,0,0,4610,1901,2709
2020,126562,10,0,4610,1901,2709
2020,126562,10,1,689,450,239
2020,126562,10,2,951,491,460
2020,126562,10,3,1231,505,726
2020,126562,10,4,1739,455,1284
2020,126562,20,0,588,386,202
2020,126562,20,1,384,256,128
2020,126562,20,2,204,130,74
2020,126562,30,0,2084,986,1098
2020,126562,30,1,290,189,101
2020,126562,30,2,677,326,351
2020,126562,30,3,1117,471,646
2020,126562,40,0,1938,529,1409
2020,126562,40,1,15,5,10
2020,126562,40,2,70,35,35
2020,126562,40,3,114,34,80
2020,126562,40,4,1739,455,1284
2020,126562,41,0,1690,405,1285
2020,126562,41,1,9,1,8
2020,126562,41,2,41,20,21
2020,126562,41,3,67,19,48
2020,126562,41,4,1573,365,1208
2020,126562,42,0,243,121,122
2020,126562,42,1,6,4,2
2020,126562,42,2,28,15,13
2020,126562,42,3,47,15,32
2020,126562,42,4,162,87,75
2020,126562,43,0,5,3,2
2020,126562,43,2,1,0,1
2020,126562,43,4,4,3,1
2020,126562,45,0,1690,405,1285
2020,126562,45,1,9,1,8
2020,126562,45,2,41,20,21
2020,126562,45,3,67,19,48
2020,126562,45,4,1573,365,1208
2020,126580,0,0,457,227,230
2020,126580,10,0,457,227,230
2020,126580,10,1,79,54,25
2020,126580,10,2,81,45,36
2020,126580,10,3,112,55,57
2020,126580,10,4,185,73,112
2020,126580,20,0,160,99,61
2020,126580,20,1,79,54,25
2020,126580,20,2,81,45,36
2020,126580,30,0,110,53,57
2020,126580,30,3,110,53,57
2020,126580,40,0,187,75,112
2020,126580,40,3,2,2,0
2020,126580,40,4,185,73,112
2020,126580,42,0,185,73,112
2020,126580,42,4,185,73,112
2020,126580,43,0,2,2,0
2020,126580,43,3,2,2,0
2020,126605,0,0,20,20,0
2020,126605,50,0,20,20,0
2020,126614,0,0,1711,1010,701
2020,126614,10,0,1711,1010,701
2020,126614,10,1,528,381,147
2020,126614,10,2,376,214,162
2020,126614,10,3,338,192,146
2020,126614,10,4,469,223,246
2020,126614,20,0,887,585,302
2020,126614,20,1,528,381,147
2020,126614,20,2,359,204,155
2020,126614,30,0,355,202,153
2020,126614,30,2,17,10,7
2020,126614,30,3,338,192,146
2020,126614,40,0,469,223,246
2020,126614,40,4,469,223,246
2020,126614,41,0,5,2,3
2020,126614,41,4,5,2,3
2020,126614,42,0,464,221,243
2020,126614,42,4,464,221,243
2020,126614,45,0,5,2,3
2020,126614,45,4,5,2,3
2020,126669,0,0,107,68,39
2020,126669,10,0,107,68,39
2020,126669,10,1,24,17,7
2020,126669,10,2,28,18,10
2020,126669,10,3,54,33,21
2020,126669,10,4,1,0,1
2020,126669,40,0,107,68,39
2020,126669,40,1,24,17,7
2020,126669,40,2,28,18,10
2020,126669,40,3,54,33,21
2020,126669,40,4,1,0,1
2020,126669,41,0,45,25,20
2020,126669,41,1,3,1,2
2020,126669,41,2,13,8,5
2020,126669,41,3,29,16,13
2020,126669,42,0,62,43,19
2020,126669,42,1,21,16,5
2020,126669,42,2,15,10,5
2020,126669,42,3,25,17,8
2020,126669,42,4,1,0,1
2020,126669,45,0,45,25,20
2020,126669,45,1,3,1,2
2020,126669,45,2,13,8,5
2020,126669,45,3,29,16,13
2020,126678,0,0,214,104,110
2020,126678,10,0,214,104,110
2020,126678,10,1,58,31,27
2020,126678,10,2,59,27,32
2020,126678,10,3,88,39,49
2020,126678,10,5,5,3,2
2020,126678,10,6,4,4,0
2020,126678,20,0,116,58,58
2020,126678,20,1,58,31,27
2020,126678,20,2,58,27,31
2020,126678,30,0,63,24,39
2020,126678,30,2,1,0,1
2020,126678,30,3,62,24,38
2020,126678,40,0,35,22,13
2020,126678,40,3,26,15,11
2020,126678,40,5,5,3,2
2020,126678,40,6,4,4,0
2020,126678,41,0,5,3,2
2020,126678,41,5,5,3,2
2020,126678,42,0,30,19,11
2020,126678,42,3,26,15,11
2020,126678,42,6,4,4,0
2020,126678,45,0,5,3,2
2020,126678,45,5,5,3,2
2020,126687,0,0,25,7,18
2020,126687,10,0,25,7,18
2020,126687,10,4,25,7,18
2020,126687,40,0,25,7,18
2020,126687,40,4,25,7,18
2020,126687,41,0,25,7,18
2020,126687,41,4,25,7,18
2020,126687,45,0,25,7,18
2020,126687,45,4,25,7,18
2020,126711,0,0,114,56,58
2020,126711,10,0,114,56,58
2020,126711,10,1,52,27,25
2020,126711,10,2,42,18,24
2020,126711,10,3,20,11,9
2020,126711,40,0,114,56,58
2020,126711,40,1,52,27,25
2020,126711,40,2,42,18,24
2020,126711,40,3,20,11,9
2020,126711,42,0,114,56,58
2020,126711,42,1,52,27,25
2020,126711,42,2,42,18,24
2020,126711,42,3,20,11,9
2020,126748,0,0,36,19,17
2020,126748,10,0,36,19,17
2020,126748,10,4,36,19,17
2020,126748,40,0,36,19,17
2020,126748,40,4,36,19,17
2020,126748,42,0,36,19,17
2020,126748,42,4,36,19,17
2020,126775,0,0,328,226,102
2020,126775,10,0,328,226,102
2020,126775,10,1,99,81,18
2020,126775,10,2,72,50,22
2020,126775,10,3,47,33,14
2020,126775,10,4,76,42,34
2020,126775,10,5,15,7,8
2020,126775,10,6,19,13,6
2020,126775,20,0,162,124,38
2020,126775,20,1,95,77,18
2020,126775,20,2,67,47,20
2020,126775,30,0,54,38,16
2020,126775,30,1,2,2,0
2020,126775,30,2,5,3,2
2020,126775,30,3,47,33,14
2020,126775,40,0,112,64,48
2020,126775,40,1,2,2,0
2020,126775,40,4,76,42,34
2020,126775,40,5,15,7,8
2020,126775,40,6,19,13,6
2020,126775,42,0,98,56,42
2020,126775,42,1,2,2,0
2020,126775,42,4,76,42,34
2020,126775,42,5,15,7,8
2020,126775,42,6,5,5,0
2020,126775,43,0,14,8,6
2020,126775,43,6,14,8,6
2020,126784,0,0,7,7,0
2020,126784,50,0,7,7,0
2020,126818,0,0,1646,904,742
2020,126818,10,0,1462,797,665
2020,126818,10,1,482,323,159
2020,126818,10,2,370,200,170
2020,126818,10,3,393,182,211
2020,126818,10,4,217,92,125
2020,126818,20,0,776,489,287
2020,126818,20,1,464,313,151
2020,126818,20,2,310,176,134
2020,126818,20,3,2,0,2
2020,126818,30,0,286,148,138
2020,126818,30,1,6,2,4
2020,126818,30,2,14,8,6
2020,126818,30,3,266,138,128
2020,126818,40,0,400,160,240
2020,126818,40,1,12,8,4
2020,126818,40,2,46,16,30
2020,126818,40,3,125,44,81
2020,126818,40,4,217,92,125
2020,126818,41,0,380,149,231
2020,126818,41,1,11,7,4
2020,126818,41,2,45,15,30
2020,126818,41,3,122,43,79
2020,126818,41,4,202,84,118
2020,126818,42,0,20,11,9
2020,126818,42,1,1,1,0
2020,126818,42,2,1,1,0
2020,126818,42,3,3,1,2
2020,126818,42,4,15,8,7
2020,126818,44,0,380,149,231
2020,126818,44,1,11,7,4
2020,126818,44,2,45,15,30
2020,126818,44,3,122,43,79
2020,126818,44,4,202,84,118
2020,126818,50,0,184,107,77
2020,126827,0,0,61,23,38
2020,126827,50,0,61,23,38
2020,126863,0,0,58,23,35
2020,126863,10,0,58,23,35
2020,126863,10,6,58,23,35
2020,126863,40,0,58,23,35
2020,126863,40,6,58,23,35
2020,126863,42,0,58,23,35
2020,126863,42,6,58,23,35
2020,126942,0,0,110,52,58
2020,126942,10,0,110,52,58
2020,126942,10,1,53,26,27
2020,126942,10,2,19,13,6
2020,126942,10,3,7,2,5
2020,126942,10,4,31,11,20
2020,126942,40,0,110,52,58
2020,126942,40,1,53,26,27
2020,126942,40,2,19,13,6
2020,126942,40,3,7,2,5
2020,126942,40,4,31,11,20
2020,126942,42,0,110,52,58
2020,126942,42,1,53,26,27
2020,126942,42,2,19,13,6
2020,126942,42,3,7,2,5
2020,126942,42,4,31,11,20
2020,126951,0,0,41,39,2
2020,126951,10,0,41,39,2
2020,126951,10,4,41,39,2
2020,126951,40,0,41,39,2
2020,126951,40,4,41,39,2
2020,126951,41,0,41,39,2
2020,126951,41,4,41,39,2
2020,126951,45,0,41,39,2
2020,126951,45,4,41,39,2
2020,126979,0,0,27,18,9
2020,126979,10,0,26,18,8
2020,126979,10,1,11,9,2
2020,126979,10,2,7,5,2
2020,126979,10,3,7,4,3
2020,126979,10,4,1,0,1
2020,126979,20,0,16,13,3
2020,126979,20,1,11,9,2
2020,126979,20,2,4,3,1
2020,126979,20,3,1,1,0
2020,126979,30,0,5,2,3
2020,126979,30,2,2,1,1
2020,126979,30,3,3,1,2
2020,126979,40,0,5,3,2
2020,126979,40,2,1,1,0
2020,126979,40,3,3,2,1
2020,126979,40,4,1,0,1
2020,126979,42,0,5,3,2
2020,126979,42,2,1,1,0
2020,126979,42,3,3,2,1
2020,126979,42,4,1,0,1
2020,126979,50,0,1,0,1
2020,127060,0,0,742,385,357
2020,127060,10,0,742,385,357
2020,127060,10,1,219,138,81
2020,127060,10,2,195,91,104
2020,127060,10,3,186,92,94
2020,127060,10,4,1,1,0
2020,127060,10,5,141,63,78
2020,127060,20,0,358,205,153
2020,127060,20,1,187,120,67
2020,127060,20,2,171,85,86
2020,127060,30,0,129,67,62
2020,127060,30,2,1,0,1
2020,127060,30,3,127,66,61
2020,127060,30,4,1,1,0
2020,127060,40,0,255,113,142
2020,127060,40,1,32,18,14
2020,127060,40,2,23,6,17
2020,127060,40,3,59,26,33
2020,127060,40,5,141,63,78
2020,127060,41,0,218,92,126
2020,127060,41,1,30,17,13
2020,127060,41,2,22,5,17
2020,127060,41,3,25,7,18
2020,127060,41,5,141,63,78
2020,127060,42,0,37,21,16
2020,127060,42,1,2,1,1
2020,127060,42,2,1,1,0
2020,127060,42,3,34,19,15
2020,127060,44,0,218,92,126
2020,127060,44,1,30,17,13
2020,127060,44,2,22,5,17
2020,127060,44,3,25,7,18
2020,127060,44,5,141,63,78
2020,127185,0,0,186,93,93
2020,127185,10,0,186,93,93
2020,127185,10,1,58,31,27
2020,127185,10,2,37,16,21
2020,127185,10,3,59,33,26
2020,127185,10,4,11,5,6
2020,127185,10,5,21,8,13
2020,127185,20,0,92,44,48
2020,127185,20,1,58,31,27
2020,127185,20,2,34,13,21
2020,127185,30,0,55,32,23
2020,127185,30,2,2,2,0
2020,127185,30,3,53,30,23
2020,127185,40,0,39,17,22
2020,127185,40,2,1,1,0
2020,127185,40,3,6,3,3
2020,127185,40,4,11,5,6
2020,127185,40,5,21,8,13
2020,127185,41,0,21,8,13
2020,127185,41,5,21,8,13
2020,127185,42,0,18,9,9
2020,127185,42,2,1,1,0
2020,127185,42,3,6,3,3
2020,127185,42,4,11,5,6
2020,127185,45,0,21,8,13
2020,127185,45,5,21,8,13
2020,127200,0,0,240,101,139
2020,127200,10,0,240,101,139
2020,127200,10,1,240,101,139
2020,127200,20,0,190,84,106
2020,127200,20,1,190,84,106
2020,127200,30,0,38,15,23
2020,127200,30,1,38,15,23
2020,127200,40,0,12,2,10
2020,127200,40,1,12,2,10
2020,127200,42,0,12,2,10
2020,127200,42,1,12,2,10
2020,127273,0,0,18,10,8
2020,127273,10,0,18,10,8
2020,127273,10,1,9,5,4
2020,127273,10,2,3,2,1
2020,127273,10,3,2,1,1
2020,127273,10,6,4,2,2
2020,127273,20,0,12,7,5
2020,127273,20,1,9,5,4
2020,127273,20,2,3,2,1
2020,127273,30,0,2,1,1
2020,127273,30,3,2,1,1
2020,127273,40,0,4,2,2
2020,127273,40,6,4,2,2
2020,127273,41,0,4,2,2
2020,127273,41,6,4,2,2
2020,127273,44,0,4,2,2
2020,127273,44,6,4,2,2
2020,127389,0,0,19,9,10
2020,127389,10,0,19,9,10
2020,127389,10,1,19,9,10
2020,127389,20,0,14,6,8
2020,127389,20,1,14,6,8
2020,127389,30,0,5,3,2
2020,127389,30,1,5,3,2
2020,127556,0,0,313,162,151
2020,127556,10,0,313,162,151
2020,127556,10,1,57,35,22
2020,127556,10,2,56,33,23
2020,127556,10,3,79,35,44
2020,127556,10,4,116,56,60
2020,127556,10,5,3,1,2
2020,127556,10,6,2,2,0
2020,127556,20,0,109,66,43
2020,127556,20,1,56,35,21
2020,127556,20,2,52,30,22
2020,127556,20,3,1,1,0
2020,127556,30,0,84,38,46
2020,127556,30,2,4,3,1
2020,127556,30,3,78,34,44
2020,127556,30,4,1,0,1
2020,127556,30,6,1,1,0
2020,127556,40,0,120,58,62
2020,127556,40,1,1,0,1
2020,127556,40,4,115,56,59
2020,127556,40,5,3,1,2
2020,127556,40,6,1,1,0
2020,127556,42,0,119,57,62
2020,127556,42,1,1,0,1
2020,127556,42,4,115,56,59
2020,127556,42,5,2,0,2
2020,127556,42,6,1,1,0
2020,127556,43,0,1,1,0
2020,127556,43,5,1,1,0
2020,127565,0,0,558,270,288
2020,127565,10,0,558,270,288
2020,127565,10,1,221,123,98
2020,127565,10,2,136,63,73
2020,127565,10,3,92,38,54
2020,127565,10,5,109,46,63
2020,127565,20,0,334,177,157
2020,127565,20,1,219,123,96
2020,127565,20,2,114,54,60
2020,127565,20,3,1,0,1
2020,127565,30,0,112,46,66
2020,127565,30,1,1,0,1
2020,127565,30,2,22,9,13
2020,127565,30,3,88,36,52
2020,127565,30,5,1,1,0
2020,127565,40,0,112,47,65
2020,127565,40,1,1,0,1
2020,127565,40,3,3,2,1
2020,127565,40,5,108,45,63
2020,127565,42,0,112,47,65
2020,127565,42,1,1,0,1
2020,127565,42,3,3,2,1
2020,127565,42,5,108,45,63
2020,127617,0,0,43,23,20
2020,127617,10,0,43,23,20
2020,127617,10,6,43,23,20
2020,127617,40,0,43,23,20
2020,127617,40,6,43,23,20
2020,127617,42,0,43,23,20
2020,127617,42,6,43,23,20
2020,127653,0,0,57,21,36
2020,127653,10,0,57,21,36
2020,127653,10,1,13,5,8
2020,127653,10,2,18,10,8
2020,127653,10,3,16,5,11
2020,127653,10,4,10,1,9
2020,127653,40,0,57,21,36
2020,127653,40,1,13,5,8
2020,127653,40,2,18,10,8
2020,127653,40,3,16,5,11
2020,127653,40,4,10,1,9
2020,127653,41,0,47,20,27
2020,127653,41,1,13,5,8
2020,127653,41,2,18,10,8
2020,127653,41,3,16,5,11
2020,127653,42,0,10,1,9
2020,127653,42,4,10,1,9
2020,127653,44,0,47,20,27
2020,127653,44,1,13,5,8
2020,127653,44,2,18,10,8
2020,127653,44,3,16,5,11
2020,127714,0,0,7,6,1
2020,127714,10,0,7,6,1
2020,127714,10,6,7,6,1
2020,127714,40,0,7,6,1
2020,127714,40,6,7,6,1
2020,127714,42,0,7,6,1
2020,127714,42,6,7,6,1
2020,127732,0,0,50,25,25
2020,127732,10,0,49,25,24
2020,127732,10,1,13,8,5
2020,127732,10,2,25,11,14
2020,127732,10,3,11,6,5
2020,127732,40,0,49,25,24
2020,127732,40,1,13,8,5
2020,127732,40,2,25,11,14
2020,127732,40,3,11,6,5
2020,127732,42,0,49,25,24
2020,127732,42,1,13,8,5
2020,127732,42,2,25,11,14
2020,127732,42,3,11,6,5
2020,127732,50,0,1,0,1
2020,127741,0,0,441,205,236
2020,127741,10,0,441,205,236
2020,127741,10,1,180,101,79
2020,127741,10,2,111,54,57
2020,127741,10,3,101,40,61
2020,127741,10,4,12,2,10
2020,127741,10,5,37,8,29
2020,127741,20,0,272,148,124
2020,127741,20,1,177,98,79
2020,127741,20,2,95,50,45
2020,127741,30,0,74,32,42
2020,127741,30,1,1,1,0
2020,127741,30,2,4,2,2
2020,127741,30,3,69,29,40
2020,127741,40,0,95,25,70
2020,127741,40,1,2,2,0
2020,127741,40,2,12,2,10
2020,127741,40,3,32,11,21
2020,127741,40,4,12,2,10
2020,127741,40,5,37,8,29
2020,127741,42,0,95,25,70
2020,127741,42,1,2,2,0
2020,127741,42,2,12,2,10
2020,127741,42,3,32,11,21
2020,127741,42,4,12,2,10
2020,127741,42,5,37,8,29
2020,127778,0,0,31,13,18
2020,127778,10,0,31,13,18
2020,127778,10,6,31,13,18
2020,127778,40,0,31,13,18
2020,127778,40,6,31,13,18
2020,127778,42,0,31,13,18
2020,127778,42,6,31,13,18
2020,127820,0,0,189,70,119
2020,127820,10,0,189,70,119
2020,127820,10,6,189,70,119
2020,127820,40,0,189,70,119
2020,127820,40,6,189,70,119
2020,127820,42,0,189,70,119
2020,127820,42,6,189,70,119
2020,127884,0,0,81,35,46
2020,127884,10,0,81,35,46
2020,127884,10,6,81,35,46
2020,127884,40,0,81,35,46
2020,127884,40,6,81,35,46
2020,127884,43,0,81,35,46
2020,127884,43,6,81,35,46
2020,127909,0,0,98,38,60
2020,127909,10,0,98,38,60
2020,127909,10,4,98,38,60
2020,127909,40,0,98,38,60
2020,127909,40,4,98,38,60
2020,127909,42,0,98,38,60
2020,127909,42,4,98,38,60
2020,127918,0,0,308,129,179
2020,127918,10,0,308,129,179
2020,127918,10,1,77,37,40
2020,127918,10,2,102,45,57
2020,127918,10,3,74,21,53
2020,127918,10,4,37,16,21
2020,127918,10,5,17,10,7
2020,127918,10,6,1,0,1
2020,127918,20,0,78,43,35
2020,127918,20,1,33,18,15
2020,127918,20,2,45,25,20
2020,127918,30,0,30,11,19
2020,127918,30,1,1,0,1
2020,127918,30,2,3,2,1
2020,127918,30,3,26,9,17
2020,127918,40,0,200,75,125
2020,127918,40,1,43,19,24
2020,127918,40,2,54,18,36
2020,127918,40,3,48,12,36
2020,127918,40,4,37,16,21
2020,127918,40,5,17,10,7
2020,127918,40,6,1,0,1
2020,127918,41,0,117,41,76
2020,127918,41,1,35,15,20
2020,127918,41,2,46,15,31
2020,127918,41,3,26,5,21
2020,127918,41,4,10,6,4
2020,127918,42,0,83,34,49
2020,127918,42,1,8,4,4
2020,127918,42,2,8,3,5
2020,127918,42,3,22,7,15
2020,127918,42,4,27,10,17
2020,127918,42,5,17,10,7
2020,127918,42,6,1,0,1
2020,127918,44,0,117,41,76
2020,127918,44,1,35,15,20
2020,127918,44,2,46,15,31
2020,127918,44,3,26,5,21
2020,127918,44,4,10,6,4
2020,127945,0,0,57,35,22
2020,127945,10,0,57,35,22
2020,127945,10,1,8,3,5
2020,127945,10,2,15,10,5
2020,127945,10,3,28,18,10
2020,127945,10,4,6,4,2
2020,127945,40,0,57,35,22
2020,127945,40,1,8,3,5
2020,127945,40,2,15,10,5
2020,127945,40,3,28,18,10
2020,127945,40,4,6,4,2
2020,127945,41,0,57,35,22
2020,127945,41,1,8,3,5
2020,127945,41,2,15,10,5
2020,127945,41,3,28,18,10
2020,127945,41,4,6,4,2
2020,127945,45,0,57,35,22
2020,127945,45,1,8,3,5
2020,127945,45,2,15,10,5
2020,127945,45,3,28,18,10
2020,127945,45,4,6,4,2
2020,128106,0,0,171,90,81
2020,128106,10,0,171,90,81
2020,128106,10,1,42,29,13
2020,128106,10,2,37,20,17
2020,128106,10,3,59,27,32
2020,128106,10,5,28,11,17
2020,128106,10,6,5,3,2
2020,128106,20,0,84,52,32
2020,128106,20,1,42,29,13
2020,128106,20,2,37,20,17
2020,128106,20,3,5,3,2
2020,128106,30,0,33,16,17
2020,128106,30,3,33,16,17
2020,128106,40,0,54,22,32
2020,128106,40,3,21,8,13
2020,128106,40,5,28,11,17
2020,128106,40,6,5,3,2
2020,128106,41,0,24,8,16
2020,128106,41,3,10,2,8
2020,128106,41,5,14,6,8
2020,128106,42,0,30,14,16
2020,128106,42,3,11,6,5
2020,128106,42,5,14,5,9
2020,128106,42,6,5,3,2
2020,128106,45,0,24,8,16
2020,128106,45,3,10,2,8
2020,128106,45,5,14,6,8
2020,128179,0,0,20,16,4
2020,128179,10,0,20,16,4
2020,128179,10,4,20,16,4
2020,128179,40,0,20,16,4
2020,128179,40,4,20,16,4
2020,128179,41,0,20,16,4
2020,128179,41,4,20,16,4
2020,128179,45,0,20,16,4
2020,128179,45,4,20,16,4
2020,128188,0,0,44,17,27
2020,128188,10,0,44,17,27
2020,128188,10,4,44,17,27
2020,128188,40,0,44,17,27
2020,128188,40,4,44,17,27
2020,128188,41,0,44,17,27
2020,128188,41,4,44,17,27
2020,128188,45,0,44,17,27
2020,128188,45,4,44,17,27
2020,128258,0,0,47,26,21
2020,128258,10,0,47,26,21
2020,128258,10,6,47,26,21
2020,128258,40,0,47,26,21
2020,128258,40,6,47,26,21
2020,128258,42,0,47,26,21
2020,128258,42,6,47,26,21
2020,128328,0,0,228,156,72
2020,128328,10,0,228,156,72
2020,128328,10,1,63,48,15
2020,128328,10,2,50,37,13
2020,128328,10,3,95,58,37
2020,128328,10,4,20,13,7
2020,128328,40,0,228,156,72
2020,128328,40,1,63,48,15
2020,128328,40,2,50,37,13
2020,128328,40,3,95,58,37
2020,128328,40,4,20,13,7
2020,128328,41,0,188,130,58
2020,128328,41,1,58,46,12
2020,128328,41,2,46,34,12
2020,128328,41,3,82,49,33
2020,128328,41,4,2,1,1
2020,128328,42,0,23,14,9
2020,128328,42,3,9,5,4
2020,128328,42,4,14,9,5
2020,128328,43,0,17,12,5
2020,128328,43,1,5,2,3
2020,128328,43,2,4,3,1
2020,128328,43,3,4,4,0
2020,128328,43,4,4,3,1
2020,128328,44,0,188,130,58
2020,128328,44,1,58,46,12
2020,128328,44,2,46,34,12
2020,128328,44,3,82,49,33
2020,128328,44,4,2,1,1
2020,128391,0,0,136,79,57
2020,128391,10,0,136,79,57
2020,128391,10,1,47,32,15
2020,128391,10,2,16,8,8
2020,128391,10,3,22,14,8
2020,128391,10,5,51,25,26
2020,128391,20,0,60,38,22
2020,128391,20,1,46,31,15
2020,128391,20,2,14,7,7
2020,128391,30,0,25,16,9
2020,128391,30,1,1,1,0
2020,128391,30,2,2,1,1
2020,128391,30,3,22,14,8
2020,128391,40,0,51,25,26
2020,128391,40,5,51,25,26
2020,128391,42,0,51,25,26
2020,128391,42,5,51,25,26
2020,128498,0,0,49,24,25
2020,128498,10,0,49,24,25
2020,128498,10,1,20,14,6
2020,128498,10,2,12,3,9
2020,128498,10,3,16,7,9
2020,128498,10,4,1,0,1
2020,128498,20,0,5,2,3
2020,128498,20,1,5,2,3
2020,128498,40,0,44,22,22
2020,128498,40,1,15,12,3
2020,128498,40,2,12,3,9
2020,128498,40,3,16,7,9
2020,128498,40,4,1,0,1
2020,128498,42,0,44,22,22
2020,128498,42,1,15,12,3
2020,128498,42,2,12,3,9
2020,128498,42,3,16,7,9
2020,128498,42,4,1,0,1
2020,128577,0,0,34,22,12
2020,128577,10,0,24,12,12
2020,128577,10,1,11,5,6
2020,128577,10,2,5,3,2
2020,128577,10,3,5,2,3
2020,128577,10,4,1,1,0
2020,128577,10,5,2,1,1
2020,128577,20,0,12,5,7
2020,128577,20,1,11,5,6
2020,128577,20,2,1,0,1
2020,128577,30,0,12,7,5
2020,128577,30,2,4,3,1
2020,128577,30,3,5,2,3
2020,128577,30,4,1,1,0
2020,128577,30,5,2,1,1
2020,128577,50,0,10,10,0
2020,128744,0,0,133,70,63
2020,128744,10,0,131,69,62
2020,128744,10,1,26,18,8
2020,128744,10,2,48,27,21
2020,128744,10,3,30,11,19
2020,128744,10,5,17,9,8
2020,128744,10,6,10,4,6
2020,128744,20,0,63,39,24
2020,128744,20,1,25,18,7
2020,128744,20,2,32,20,12
2020,128744,20,3,4,0,4
2020,128744,20,6,2,1,1
2020,128744,30,0,29,9,20
2020,128744,30,2,9,2,7
2020,128744,30,3,18,7,11
2020,128744,30,5,1,0,1
2020,128744,30,6,1,0,1
2020,128744,40,0,39,21,18
2020,128744,40,1,1,0,1
2020,128744,40,2,7,5,2
2020,128744,40,3,8,4,4
2020,128744,40,5,16,9,7
2020,128744,40,6,7,3,4
2020,128744,41,0,27,14,13
2020,128744,41,2,3,2,1
2020,128744,41,3,4,2,2
2020,128744,41,5,15,9,6
2020,128744,41,6,5,1,4
2020,128744,43,0,12,7,5
2020,128744,43,1,1,0,1
2020,128744,43,2,4,3,1
2020,128744,43,3,4,2,2
2020,128744,43,5,1,0,1
2020,128744,43,6,2,2,0
2020,128744,45,0,27,14,13
2020,128744,45,2,3,2,1
2020,128744,45,3,4,2,2
2020,128744,45,5,15,9,6
2020,128744,45,6,5,1,4
2020,128744,50,0,2,1,1
2020,128771,0,0,428,241,187
2020,128771,10,0,428,241,187
2020,128771,10,1,200,127,73
2020,128771,10,2,136,71,65
2020,128771,10,3,90,42,48
2020,128771,10,4,2,1,1
2020,128771,20,0,320,188,132
2020,128771,20,1,200,127,73
2020,128771,20,2,112,58,54
2020,128771,20,3,8,3,5
2020,128771,30,0,97,47,50
2020,128771,30,2,21,12,9
2020,128771,30,3,76,35,41
2020,128771,40,0,11,6,5
2020,128771,40,2,3,1,2
2020,128771,40,3,6,4,2
2020,128771,40,4,2,1,1
2020,128771,42,0,11,6,5
2020,128771,42,2,3,1,2
2020,128771,42,3,6,4,2
2020,128771,42,4,2,1,1
2020,128902,0,0,199,98,101
2020,128902,10,0,199,98,101
2020,128902,10,1,69,39,30
2020,128902,10,2,57,29,28
2020,128902,10,3,53,23,30
2020,128902,10,4,2,1,1
2020,128902,10,5,18,6,12
2020,128902,20,0,113,58,55
2020,128902,20,1,59,31,28
2020,128902,20,2,54,27,27
2020,128902,30,0,34,10,24
2020,128902,30,3,34,10,24
2020,128902,40,0,52,30,22
2020,128902,40,1,10,8,2
2020,128902,40,2,3,2,1
2020,128902,40,3,19,13,6
2020,128902,40,4,2,1,1
2020,128902,40,5,18,6,12
2020,128902,41,0,50,28,22
2020,128902,41,1,10,8,2
2020,128902,41,2,3,2,1
2020,128902,41,3,17,11,6
2020,128902,41,4,2,1,1
2020,128902,41,5,18,6,12
2020,128902,42,0,2,2,0
2020,128902,42,3,2,2,0
2020,128902,44,0,13,7,6
2020,128902,44,3,12,7,5
2020,128902,44,5,1,0,1
2020,128902,45,0,37,21,16
2020,128902,45,1,10,8,2
2020,128902,45,2,3,2,1
2020,128902,45,3,5,4,1
2020,128902,45,4,2,1,1
2020,128902,45,5,17,6,11
2020,129020,0,0,2089,1174,915
2020,129020,10,0,2089,1174,915
2020,129020,10,1,643,431,212
2020,129020,10,2,618,337,281
2020,129020,10,3,709,358,351
2020,129020,10,4,66,28,38
2020,129020,10,5,52,20,32
2020,129020,10,6,1,0,1
2020,129020,20,0,1013,644,369
2020,129020,20,1,582,394,188
2020,129020,20,2,425,246,179
2020,129020,20,3,6,4,2
2020,129020,30,0,293,157,136
2020,129020,30,1,5,3,2
2020,129020,30,2,34,26,8
2020,129020,30,3,253,128,125
2020,129020,30,4,1,0,1
2020,129020,40,0,783,373,410
2020,129020,40,1,56,34,22
2020,129020,40,2,159,65,94
2020,129020,40,3,450,226,224
2020,129020,40,4,65,28,37
2020,129020,40,5,52,20,32
2020,129020,40,6,1,0,1
2020,129020,41,0,204,84,120
2020,129020,41,1,14,3,11
2020,129020,41,2,62,18,44
2020,129020,41,3,78,40,38
2020,129020,41,4,11,8,3
2020,129020,41,5,39,15,24
2020,129020,42,0,571,288,283
2020,129020,42,1,42,31,11
2020,129020,42,2,97,47,50
2020,129020,42,3,367,185,182
2020,129020,42,4,52,20,32
2020,129020,42,5,12,5,7
2020,129020,42,6,1,0,1
2020,129020,43,0,8,1,7
2020,129020,43,3,5,1,4
2020,129020,43,4,2,0,2
2020,129020,43,5,1,0,1
2020,129020,44,0,204,84,120
2020,129020,44,1,14,3,11
2020,129020,44,2,62,18,44
2020,129020,44,3,78,40,38
2020,129020,44,4,11,8,3
2020,129020,44,5,39,15,24
2020,129154,0,0,85,27,58
2020,129154,10,0,85,27,58
2020,129154,10,1,4,1,3
2020,129154,10,2,23,7,16
2020,129154,10,3,45,15,30
2020,129154,10,4,13,4,9
2020,129154,40,0,85,27,58
2020,129154,40,1,4,1,3
2020,129154,40,2,23,7,16
2020,129154,40,3,45,15,30
2020,129154,40,4,13,4,9
2020,129154,41,0,16,3,13
2020,129154,41,1,4,1,3
2020,129154,41,2,12,2,10
2020,129154,42,0,69,24,45
2020,129154,42,2,11,5,6
2020,129154,42,3,45,15,30
2020,129154,42,4,13,4,9
2020,129154,44,0,16,3,13
2020,129154,44,1,4,1,3
2020,129154,44,2,12,2,10
2020,129215,0,0,190,105,85
2020,129215,10,0,190,105,85
2020,129215,10,1,91,52,39
2020,129215,10,2,50,27,23
2020,129215,10,3,47,25,22
2020,129215,10,4,2,1,1
2020,129215,20,0,146,82,64
2020,129215,20,1,91,52,39
2020,129215,20,2,50,27,23
2020,129215,20,3,5,3,2
2020,129215,30,0,40,22,18
2020,129215,30,3,40,22,18
2020,129215,40,0,4,1,3
2020,129215,40,3,2,0,2
2020,129215,40,4,2,1,1
2020,129215,42,0,4,1,3
2020,129215,42,3,2,0,2
2020,129215,42,4,2,1,1
2020,129242,0,0,312,133,179
2020,129242,10,0,312,133,179
2020,129242,10,1,81,41,40
2020,129242,10,2,107,45,62
2020,129242,10,3,98,39,59
2020,129242,10,4,26,8,18
2020,129242,20,0,185,84,101
2020,129242,20,1,81,41,40
2020,129242,20,2,100,42,58
2020,129242,20,3,4,1,3
2020,129242,30,0,49,19,30
2020,129242,30,2,1,0,1
2020,129242,30,3,48,19,29
2020,129242,40,0,78,30,48
2020,129242,40,2,6,3,3
2020,129242,40,3,46,19,27
2020,129242,40,4,26,8,18
2020,129242,42,0,78,30,48
2020,129242,42,2,6,3,3
2020,129242,42,3,46,19,27
2020,129242,42,4,26,8,18
2020,129367,0,0,64,27,37
2020,129367,10,0,64,27,37
2020,129367,10,1,34,16,18
2020,129367,10,2,15,7,8
2020,129367,10,3,13,4,9
2020,129367,10,4,2,0,2
2020,129367,20,0,38,20,18
2020,129367,20,1,32,15,17
2020,129367,20,2,6,5,1
2020,129367,30,0,26,7,19
2020,129367,30,1,2,1,1
2020,129367,30,2,9,2,7
2020,129367,30,3,13,4,9
2020,129367,30,4,2,0,2
2020,129428,0,0,5,4,1
2020,129428,10,0,5,4,1
2020,129428,10,1,4,3,1
2020,129428,10,5,1,1,0
2020,129428,40,0,5,4,1
2020,129428,40,1,4,3,1
2020,129428,40,5,1,1,0
2020,129428,41,0,5,4,1
2020,129428,41,1,4,3,1
2020,129428,41,5,1,1,0
2020,129428,44,0,5,4,1
2020,129428,44,1,4,3,1
2020,129428,44,5,1,1,0
2020,129491,0,0,5,4,1
2020,129491,10,0,5,4,1
2020,129491,10,1,2,2,0
2020,129491,10,2,3,2,1
2020,129491,40,0,5,4,1
2020,129491,40,1,2,2,0
2020,129491,40,2,3,2,1
2020,129491,41,0,5,4,1
2020,129491,41,1,2,2,0
2020,129491,41,2,3,2,1
2020,129491,44,0,5,4,1
2020,129491,44,1,2,2,0
2020,129491,44,2,3,2,1
2020,129525,0,0,349,180,169
2020,129525,10,0,349,180,169
2020,129525,10,1,89,65,24
2020,129525,10,2,114,56,58
2020,129525,10,3,112,47,65
2020,129525,10,4,8,3,5
2020,129525,10,5,2,1,1
2020,129525,10,6,24,8,16
2020,129525,20,0,184,108,76
2020,129525,20,1,88,64,24
2020,129525,20,2,93,43,50
2020,129525,20,3,3,1,2
2020,129525,30,0,68,32,36
2020,129525,30,2,8,6,2
2020,129525,30,3,59,25,34
2020,129525,30,6,1,1,0
2020,129525,40,0,97,40,57
2020,129525,40,1,1,1,0
2020,129525,40,2,13,7,6
2020,129525,40,3,50,21,29
2020,129525,40,4,8,3,5
2020,129525,40,5,2,1,1
2020,129525,40,6,23,7,16
2020,129525,41,0,51,24,27
2020,129525,41,1,1,1,0
2020,129525,41,2,12,7,5
2020,129525,41,3,32,12,20
2020,129525,41,4,5,3,2
2020,129525,41,6,1,1,0
2020,129525,42,0,41,15,26
2020,129525,42,2,1,0,1
2020,129525,42,3,18,9,9
2020,129525,42,4,3,0,3
2020,129525,42,5,2,1,1
2020,129525,42,6,17,5,12
2020,129525,43,0,5,1,4
2020,129525,43,6,5,1,4
2020,129525,44,0,51,24,27
2020,129525,44,1,1,1,0
2020,129525,44,2,12,7,5
2020,129525,44,3,32,12,20
2020,129525,44,4,5,3,2
2020,129525,44,6,1,1,0
2020,129534,0,0,10,5,5
2020,129534,10,0,10,5,5
2020,129534,10,1,3,2,1
2020,129534,10,2,1,0,1
2020,129534,10,3,1,1,0
2020,129534,10,4,5,2,3
2020,129534,40,0,10,5,5
2020,129534,40,1,3,2,1
2020,129534,40,2,1,0,1
2020,129534,40,3,1,1,0
2020,129534,40,4,5,2,3
2020,129534,41,0,6,3,3
2020,129534,41,1,2,1,1
2020,129534,41,2,1,0,1
2020,129534,41,3,1,1,0
2020,129534,41,4,2,1,1
2020,129534,42,0,2,1,1
2020,129534,42,4,2,1,1
2020,129534,43,0,2,1,1
2020,129534,43,1,1,1,0
2020,129534,43,4,1,0,1
2020,129534,44,0,6,3,3
2020,129534,44,1,2,1,1
2020,129534,44,2,1,0,1
2020,129534,44,3,1,1,0
2020,129534,44,4,2,1,1
2020,129543,0,0,73,32,41
2020,129543,10,0,73,32,41
2020,129543,10,1,33,12,21
2020,129543,10,2,17,9,8
2020,129543,10,3,14,6,8
2020,129543,10,4,6,5,1
2020,129543,10,5,3,0,3
2020,129543,20,0,49,20,29
2020,129543,20,1,33,12,21
2020,129543,20,2,13,6,7
2020,129543,20,3,3,2,1
2020,129543,30,0,21,12,9
2020,129543,30,2,4,3,1
2020,129543,30,3,11,4,7
2020,129543,30,4,6,5,1
2020,129543,40,0,3,0,3
2020,129543,40,5,3,0,3
2020,129543,42,0,3,0,3
2020,129543,42,5,3,0,3
2020,129695,0,0,93,34,59
2020,129695,10,0,93,34,59
2020,129695,10,1,58,23,35
2020,129695,10,2,17,3,14
2020,129695,10,3,13,6,7
2020,129695,10,4,5,2,3
2020,129695,20,0,74,27,47
2020,129695,20,1,57,23,34
2020,129695,20,2,12,2,10
2020,129695,20,3,5,2,3
2020,129695,30,0,19,7,12
2020,129695,30,1,1,0,1
2020,129695,30,2,5,1,4
2020,129695,30,3,8,4,4
2020,129695,30,4,5,2,3
2020,129729,0,0,94,35,59
2020,129729,10,0,94,35,59
2020,129729,10,1,62,20,42
2020,129729,10,2,19,9,10
2020,129729,10,3,9,5,4
2020,129729,10,4,3,1,2
2020,129729,10,5,1,0,1
2020,129729,20,0,68,22,46
2020,129729,20,1,60,19,41
2020,129729,20,2,8,3,5
2020,129729,30,0,25,13,12
2020,129729,30,1,2,1,1
2020,129729,30,2,11,6,5
2020,129729,30,3,9,5,4
2020,129729,30,4,3,1,2
2020,129729,40,0,1,0,1
2020,129729,40,5,1,0,1
2020,129729,43,0,1,0,1
2020,129729,43,5,1,0,1
2020,129756,0,0,42,21,21
2020,129756,10,0,42,21,21
2020,129756,10,1,29,15,14
2020,129756,10,2,8,5,3
2020,129756,10,3,3,1,2
2020,129756,10,5,2,0,2
2020,129756,20,0,29,16,13
2020,129756,20,1,26,14,12
2020,129756,20,2,2,2,0
2020,129756,20,3,1,0,1
2020,129756,30,0,11,5,6
2020,129756,30,1,3,1,2
2020,129756,30,2,6,3,3
2020,129756,30,3,2,1,1
2020,129756,40,0,2,0,2
2020,129756,40,5,2,0,2
2020,129756,43,0,2,0,2
2020,129756,43,5,2,0,2
2020,129774,0,0,16,8,8
2020,129774,10,0,16,8,8
2020,129774,10,1,2,1,1
2020,129774,10,2,8,4,4
2020,129774,10,3,6,3,3
2020,129774,40,0,16,8,8
2020,129774,40,1,2,1,1
2020,129774,40,2,8,4,4
2020,129774,40,3,6,3,3
2020,129774,41,0,12,7,5
2020,129774,41,1,2,1,1
2020,129774,41,2,8,4,4
2020,129774,41,3,2,2,0
2020,129774,42,0,4,1,3
2020,129774,42,3,4,1,3
2020,129774,44,0,12,7,5
2020,129774,44,1,2,1,1
2020,129774,44,2,8,4,4
2020,129774,44,3,2,2,0
2020,129808,0,0,67,29,38
2020,129808,10,0,66,29,37
2020,129808,10,1,40,19,21
2020,129808,10,2,13,4,9
2020,129808,10,3,11,5,6
2020,129808,10,5,2,1,1
2020,129808,20,0,47,22,25
2020,129808,20,1,40,19,21
2020,129808,20,2,6,2,4
2020,129808,20,3,1,1,0
2020,129808,30,0,17,6,11
2020,129808,30,2,7,2,5
2020,129808,30,3,10,4,6
2020,129808,40,0,2,1,1
2020,129808,40,5,2,1,1
2020,129808,42,0,2,1,1
2020,129808,42,5,2,1,1
2020,129808,50,0,1,0,1
2020,129941,0,0,227,141,86
2020,129941,10,0,227,141,86
2020,129941,10,1,37,27,10
2020,129941,10,2,74,45,29
2020,129941,10,3,50,30,20
2020,129941,10,5,66,39,27
2020,129941,20,0,108,68,40
2020,129941,20,1,37,27,10
2020,129941,20,2,69,41,28
2020,129941,20,3,2,0,2
2020,129941,30,0,41,27,14
2020,129941,30,2,4,3,1
2020,129941,30,3,37,24,13
2020,129941,40,0,78,46,32
2020,129941,40,2,1,1,0
2020,129941,40,3,11,6,5
2020,129941,40,5,66,39,27
2020,129941,41,0,46,32,14
2020,129941,41,2,1,1,0
2020,129941,41,3,6,4,2
2020,129941,41,5,39,27,12
2020,129941,42,0,32,14,18
2020,129941,42,3,5,2,3
2020,129941,42,5,27,12,15
2020,129941,44,0,46,32,14
2020,129941,44,2,1,1,0
2020,129941,44,3,6,4,2
2020,129941,44,5,39,27,12
2020,130004,0,0,88,42,46
2020,130004,10,0,88,42,46
2020,130004,10,1,63,33,30
2020,130004,10,2,7,4,3
2020,130004,10,3,11,2,9
2020,130004,10,4,4,2,2
2020,130004,10,5,3,1,2
2020,130004,20,0,63,33,30
2020,130004,20,1,60,31,29
2020,130004,20,2,3,2,1
2020,130004,30,0,19,8,11
2020,130004,30,1,3,2,1
2020,130004,30,2,4,2,2
2020,130004,30,3,10,2,8
2020,130004,30,4,2,2,0
2020,130004,40,0,6,1,5
2020,130004,40,3,1,0,1
2020,130004,40,4,2,0,2
2020,130004,40,5,3,1,2
2020,130004,42,0,6,1,5
2020,130004,42,3,1,0,1
2020,130004,42,4,2,0,2
2020,130004,42,5,3,1,2
2020,130040,0,0,26,8,18
2020,130040,10,0,26,8,18
2020,130040,10,1,14,4,10
2020,130040,10,2,4,1,3
2020,130040,10,3,5,3,2
2020,130040,10,4,3,0,3
2020,130040,20,0,17,6,11
2020,130040,20,1,14,4,10
2020,130040,20,2,2,1,1
2020,130040,20,3,1,1,0
2020,130040,30,0,9,2,7
2020,130040,30,2,2,0,2
2020,130040,30,3,4,2,2
2020,130040,30,4,3,0,3
2020,130183,0,0,57,26,31
2020,130183,10,0,57,26,31
2020,130183,10,6,57,26,31
2020,130183,40,0,57,26,31
2020,130183,40,6,57,26,31
2020,130183,41,0,57,26,31
2020,130183,41,6,57,26,31
2020,130183,45,0,57,26,31
2020,130183,45,6,57,26,31
2020,130217,0,0,26,14,12
2020,130217,10,0,25,13,12
2020,130217,10,1,17,8,9
2020,130217,10,2,3,2,1
2020,130217,10,3,4,2,2
2020,130217,10,4,1,1,0
2020,130217,20,0,18,8,10
2020,130217,20,1,17,8,9
2020,130217,20,2,1,0,1
2020,130217,30,0,7,5,2
2020,130217,30,2,2,2,0
2020,130217,30,3,4,2,2
2020,130217,30,4,1,1,0
2020,130217,50,0,1,1,0
2020,130226,0,0,408,172,236
2020,130226,10,0,408,172,236
2020,130226,10,1,134,71,63
2020,130226,10,2,146,62,84
2020,130226,10,3,115,34,81
2020,130226,10,4,13,5,8
2020,130226,20,0,204,104,100
2020,130226,20,1,115,63,52
2020,130226,20,2,89,41,48
2020,130226,30,0,49,19,30
2020,130226,30,2,5,2,3
2020,130226,30,3,44,17,27
2020,130226,40,0,155,49,106
2020,130226,40,1,19,8,11
2020,130226,40,2,52,19,33
2020,130226,40,3,71,17,54
2020,130226,40,4,13,5,8
2020,130226,41,0,150,49,101
2020,130226,41,1,19,8,11
2020,130226,41,2,51,19,32
2020,130226,41,3,67,17,50
2020,130226,41,4,13,5,8
2020,130226,42,0,5,0,5
2020,130226,42,2,1,0,1
2020,130226,42,3,4,0,4
2020,130226,44,0,150,49,101
2020,130226,44,1,19,8,11
2020,130226,44,2,51,19,32
2020,130226,44,3,67,17,50
2020,130226,44,4,13,5,8
2020,130253,0,0,333,128,205
2020,130253,10,0,333,128,205
2020,130253,10,1,48,30,18
2020,130253,10,2,98,41,57
2020,130253,10,3,133,40,93
2020,130253,10,4,24,7,17
2020,130253,10,5,30,10,20
2020,130253,20,0,113,61,52
2020,130253,20,1,46,29,17
2020,130253,20,2,66,32,34
2020,130253,20,3,1,0,1
2020,130253,30,0,62,31,31
2020,130253,30,2,6,3,3
2020,130253,30,3,56,28,28
2020,130253,40,0,158,36,122
2020,130253,40,1,2,1,1
2020,130253,40,2,26,6,20
2020,130253,40,3,76,12,64
2020,130253,40,4,24,7,17
2020,130253,40,5,30,10,20
2020,130253,42,0,158,36,122
2020,130253,42,1,2,1,1
2020,130253,42,2,26,6,20
2020,130253,42,3,76,12,64
2020,130253,42,4,24,7,17
2020,130253,42,5,30,10,20
2020,130314,0,0,127,40,87
2020,130314,10,0,127,40,87
2020,130314,10,1,18,10,8
2020,130314,10,2,47,18,29
2020,130314,10,3,58,12,46
2020,130314,10,4,4,0,4
2020,130314,20,0,55,25,30
2020,130314,20,1,18,10,8
2020,130314,20,2,36,15,21
2020,130314,20,3,1,0,1
2020,130314,30,0,36,9,27
2020,130314,30,2,5,1,4
2020,130314,30,3,31,8,23
2020,130314,40,0,36,6,30
2020,130314,40,2,6,2,4
2020,130314,40,3,26,4,22
2020,130314,40,4,4,0,4
2020,130314,41,0,35,5,30
2020,130314,41,2,6,2,4
2020,130314,41,3,25,3,22
2020,130314,41,4,4,0,4
2020,130314,42,0,1,1,0
2020,130314,42,3,1,1,0
2020,130314,44,0,35,5,30
2020,130314,44,2,6,2,4
2020,130314,44,3,25,3,22
2020,130314,44,4,4,0,4
2020,130396,0,0,100,41,59
2020,130396,10,0,100,41,59
2020,130396,10,1,57,22,35
2020,130396,10,2,11,4,7
2020,130396,10,3,20,8,12
2020,130396,10,4,12,7,5
2020,130396,20,0,65,25,40
2020,130396,20,1,57,22,35
2020,130396,20,2,8,3,5
2020,130396,30,0,35,16,19
2020,130396,30,2,3,1,2
2020,130396,30,3,20,8,12
2020,130396,30,4,12,7,5
2020,130493,0,0,422,199,223
2020,130493,10,0,422,199,223
2020,130493,10,1,175,95,80
2020,130493,10,2,148,64,84
2020,130493,10,3,96,40,56
2020,130493,10,4,3,0,3
2020,130493,20,0,306,151,155
2020,130493,20,1,174,94,80
2020,130493,20,2,127,56,71
2020,130493,20,3,5,1,4
2020,130493,30,0,107,46,61
2020,130493,30,1,1,1,0
2020,130493,30,2,21,8,13
2020,130493,30,3,85,37,48
2020,130493,40,0,9,2,7
2020,130493,40,3,6,2,4
2020,130493,40,4,3,0,3
2020,130493,42,0,9,2,7
2020,130493,42,3,6,2,4
2020,130493,42,4,3,0,3
2020,130590,0,0,229,123,106
2020,130590,10,0,229,123,106
2020,130590,10,1,61,44,17
2020,130590,10,2,59,26,33
2020,130590,10,3,37,17,20
2020,130590,10,5,27,10,17
2020,130590,10,6,45,26,19
2020,130590,20,0,106,62,44
2020,130590,20,1,53,39,14
2020,130590,20,2,53,23,30
2020,130590,30,0,37,17,20
2020,130590,30,3,37,17,20
2020,130590,40,0,86,44,42
2020,130590,40,1,8,5,3
2020,130590,40,2,6,3,3
2020,130590,40,5,27,10,17
2020,130590,40,6,45,26,19
2020,130590,41,0,68,32,36
2020,130590,41,1,8,5,3
2020,130590,41,2,6,3,3
2020,130590,41,5,27,10,17
2020,130590,41,6,27,14,13
2020,130590,42,0,18,12,6
2020,130590,42,6,18,12,6
2020,130590,44,0,68,32,36
2020,130590,44,1,8,5,3
2020,130590,44,2,6,3,3
2020,130590,44,5,27,10,17
2020,130590,44,6,27,14,13
2020,130606,0,0,59,26,33
2020,130606,10,0,59,26,33
2020,130606,10,1,35,17,18
2020,130606,10,2,7,3,4
2020,130606,10,3,3,0,3
2020,130606,10,4,5,3,2
2020,130606,10,5,9,3,6
2020,130606,20,0,40,20,20
2020,130606,20,1,35,17,18
2020,130606,20,2,5,3,2
2020,130606,30,0,10,3,7
2020,130606,30,2,2,0,2
2020,130606,30,3,3,0,3
2020,130606,30,4,5,3,2
2020,130606,40,0,9,3,6
2020,130606,40,5,9,3,6
2020,130606,42,0,9,3,6
2020,130606,42,5,9,3,6
2020,130624,0,0,142,97,45
2020,130624,10,0,142,97,45
2020,130624,10,1,32,22,10
2020,130624,10,2,18,10,8
2020,130624,10,3,9,6,3
2020,130624,10,4,79,57,22
2020,130624,10,6,4,2,2
2020,130624,20,0,68,45,23
2020,130624,20,1,32,22,10
2020,130624,20,2,17,9,8
2020,130624,20,3,4,3,1
2020,130624,20,4,15,11,4
2020,130624,30,0,5,3,2
2020,130624,30,2,1,1,0
2020,130624,30,3,4,2,2
2020,130624,40,0,69,49,20
2020,130624,40,3,1,1,0
2020,130624,40,4,64,46,18
2020,130624,40,6,4,2,2
2020,130624,41,0,60,44,16
2020,130624,41,4,60,44,16
2020,130624,42,0,9,5,4
2020,130624,42,3,1,1,0
2020,130624,42,4,4,2,2
2020,130624,42,6,4,2,2
2020,130624,44,0,60,44,16
2020,130624,44,4,60,44,16
2020,130697,0,0,384,207,177
2020,130697,10,0,384,207,177
2020,130697,10,1,106,76,30
2020,130697,10,2,87,40,47
2020,130697,10,3,73,32,41
2020,130697,10,6,118,59,59
2020,130697,20,0,193,116,77
2020,130697,20,1,106,76,30
2020,130697,20,2,87,40,47
2020,130697,30,0,73,32,41
2020,130697,30,3,73,32,41
2020,130697,40,0,118,59,59
2020,130697,40,6,118,59,59
2020,130697,41,0,77,36,41
2020,130697,41,6,77,36,41
2020,130697,42,0,41,23,18
2020,130697,42,6,41,23,18
2020,130697,44,0,77,36,41
2020,130697,44,6,77,36,41
2020,130776,0,0,213,103,110
2020,130776,10,0,213,103,110
2020,130776,10,1,101,54,47
2020,130776,10,2,57,25,32
2020,130776,10,3,52,24,28
2020,130776,10,4,3,0,3
2020,130776,20,0,148,72,76
2020,130776,20,1,101,54,47
2020,130776,20,2,44,17,27
2020,130776,20,3,3,1,2
2020,130776,30,0,59,29,30
2020,130776,30,2,13,8,5
2020,130776,30,3,45,21,24
2020,130776,30,4,1,0,1
2020,130776,40,0,6,2,4
2020,130776,40,3,4,2,2
2020,130776,40,4,2,0,2
2020,130776,42,0,6,2,4
2020,130776,42,3,4,2,2
2020,130776,42,4,2,0,2
2020,130794,0,0,2715,1629,1086
2020,130794,10,0,2715,1629,1086
2020,130794,10,1,1028,758,270
2020,130794,10,2,575,333,242
2020,130794,10,3,669,339,330
2020,130794,10,5,443,199,244
2020,130794,20,0,1096,795,301
2020,130794,20,1,965,714,251
2020,130794,20,2,131,81,50
2020,130794,30,0,1078,575,503
2020,130794,30,2,430,242,188
2020,130794,30,3,648,333,315
2020,130794,40,0,541,259,282
2020,130794,40,1,63,44,19
2020,130794,40,2,14,10,4
2020,130794,40,3,21,6,15
2020,130794,40,5,443,199,244
2020,130794,41,0,303,157,146
2020,130794,41,1,58,40,18
2020,130794,41,2,14,10,4
2020,130794,41,3,20,5,15
2020,130794,41,5,211,102,109
2020,130794,42,0,232,100,132
2020,130794,42,1,5,4,1
2020,130794,42,3,1,1,0
2020,130794,42,5,226,95,131
2020,130794,43,0,6,2,4
2020,130794,43,5,6,2,4
2020,130794,44,0,298,153,145
2020,130794,44,1,53,36,17
2020,130794,44,2,14,10,4
2020,130794,44,3,20,5,15
2020,130794,44,5,211,102,109
2020,130794,45,0,5,4,1
2020,130794,45,1,5,4,1
2020,130907,0,0,396,137,259
2020,130907,10,0,396,137,259
2020,130907,10,6,396,137,259
2020,130907,40,0,396,137,259
2020,130907,40,6,396,137,259
2020,130907,41,0,396,137,259
2020,130907,41,6,396,137,259
2020,130907,45,0,396,137,259
2020,130907,45,6,396,137,259
2020,130934,0,0,215,111,104
2020,130934,10,0,210,108,102
2020,130934,10,1,56,38,18
2020,130934,10,2,86,46,40
2020,130934,10,3,42,16,26
2020,130934,10,4,2,2,0
2020,130934,10,5,24,6,18
2020,130934,20,0,128,78,50
2020,130934,20,1,56,38,18
2020,130934,20,2,72,40,32
2020,130934,30,0,37,12,25
2020,130934,30,2,13,5,8
2020,130934,30,3,24,7,17
2020,130934,40,0,45,18,27
2020,130934,40,2,1,1,0
2020,130934,40,3,18,9,9
2020,130934,40,4,2,2,0
2020,130934,40,5,24,6,18
2020,130934,42,0,45,18,27
2020,130934,42,2,1,1,0
2020,130934,42,3,18,9,9
2020,130934,42,4,2,2,0
2020,130934,42,5,24,6,18
2020,130934,50,0,5,3,2
2020,130943,0,0,1263,694,569
2020,130943,10,0,1263,694,569
2020,130943,10,1,403,279,124
2020,130943,10,2,379,201,178
2020,130943,10,3,395,190,205
2020,130943,10,4,86,24,62
2020,130943,20,0,677,430,247
2020,130943,20,1,377,265,112
2020,130943,20,2,300,165,135
2020,130943,30,0,222,110,112
2020,130943,30,2,2,1,1
2020,130943,30,3,220,109,111
2020,130943,40,0,364,154,210
2020,130943,40,1,26,14,12
2020,130943,40,2,77,35,42
2020,130943,40,3,175,81,94
2020,130943,40,4,86,24,62
2020,130943,41,0,257,112,145
2020,130943,41,1,21,11,10
2020,130943,41,2,63,27,36
2020,130943,41,3,118,54,64
2020,130943,41,4,55,20,35
2020,130943,42,0,107,42,65
2020,130943,42,1,5,3,2
2020,130943,42,2,14,8,6
2020,130943,42,3,57,27,30
2020,130943,42,4,31,4,27
2020,130943,44,0,257,112,145
2020,130943,44,1,21,11,10
2020,130943,44,2,63,27,36
2020,130943,44,3,118,54,64
2020,130943,44,4,55,20,35
2020,130989,0,0,21,13,8
2020,130989,10,0,21,13,8
2020,130989,10,1,6,3,3
2020,130989,10,2,6,5,1
2020,130989,10,3,9,5,4
2020,130989,40,0,21,13,8
2020,130989,40,1,6,3,3
2020,130989,40,2,6,5,1
2020,130989,40,3,9,5,4
2020,130989,42,0,21,13,8
2020,130989,42,1,6,3,3
2020,130989,42,2,6,5,1
2020,130989,42,3,9,5,4
2020,131098,0,0,67,23,44
2020,131098,10,0,67,23,44
2020,131098,10,1,22,11,11
2020,131098,10,2,20,5,15
2020,131098,10,3,17,5,12
2020,131098,10,4,8,2,6
2020,131098,20,0,38,15,23
2020,131098,20,1,22,11,11
2020,131098,20,2,15,4,11
2020,131098,20,3,1,0,1
2020,131098,30,0,21,6,15
2020,131098,30,2,5,1,4
2020,131098,30,3,16,5,11
2020,131098,40,0,8,2,6
2020,131098,40,4,8,2,6
2020,131098,42,0,8,2,6
2020,131098,42,4,8,2,6
2020,131113,0,0,95,37,58
2020,131113,10,0,95,37,58
2020,131113,10,1,8,2,6
2020,131113,10,2,31,11,20
2020,131113,10,3,56,24,32
2020,131113,40,0,95,37,58
2020,131113,40,1,8,2,6
2020,131113,40,2,31,11,20
2020,131113,40,3,56,24,32
2020,131113,41,0,95,37,58
2020,131113,41,1,8,2,6
2020,131113,41,2,31,11,20
2020,131113,41,3,56,24,32
2020,131113,44,0,95,37,58
2020,131113,44,1,8,2,6
2020,131113,44,2,31,11,20
2020,131113,44,3,56,24,32
2020,131159,0,0,827,411,416
2020,131159,10,0,827,411,416
2020,131159,10,1,187,121,66
2020,131159,10,2,178,90,88
2020,131159,10,3,141,66,75
2020,131159,10,4,321,134,187
2020,131159,20,0,345,202,143
2020,131159,20,1,177,117,60
2020,131159,20,2,165,85,80
2020,131159,20,3,3,0,3
2020,131159,30,0,96,43,53
2020,131159,30,2,7,3,4
2020,131159,30,3,89,40,49
2020,131159,40,0,386,166,220
2020,131159,40,1,10,4,6
2020,131159,40,2,6,2,4
2020,131159,40,3,49,26,23
2020,131159,40,4,321,134,187
2020,131159,41,0,218,91,127
2020,131159,41,1,7,4,3
2020,131159,41,2,6,2,4
2020,131159,41,3,36,18,18
2020,131159,41,4,169,67,102
2020,131159,42,0,168,75,93
2020,131159,42,1,3,0,3
2020,131159,42,3,13,8,5
2020,131159,42,4,152,67,85
2020,131159,44,0,218,91,127
2020,131159,44,1,7,4,3
2020,131159,44,2,6,2,4
2020,131159,44,3,36,18,18
2020,131159,44,4,169,67,102
2020,131283,0,0,351,212,139
2020,131283,10,0,351,212,139
2020,131283,10,1,102,76,26
2020,131283,10,2,137,74,63
2020,131283,10,3,103,60,43
2020,131283,10,4,9,2,7
2020,131283,20,0,201,130,71
2020,131283,20,1,96,72,24
2020,131283,20,2,105,58,47
2020,131283,30,0,59,40,19
2020,131283,30,1,3,2,1
2020,131283,30,2,11,7,4
2020,131283,30,3,45,31,14
2020,131283,40,0,91,42,49
2020,131283,40,1,3,2,1
2020,131283,40,2,21,9,12
2020,131283,40,3,58,29,29
2020,131283,40,4,9,2,7
2020,131283,42,0,91,42,49
2020,131283,42,1,3,2,1
2020,131283,42,2,21,9,12
2020,131283,42,3,58,29,29
2020,131283,42,4,9,2,7
2020,131399,0,0,209,94,115
2020,131399,10,0,209,94,115
2020,131399,10,1,45,22,23
2020,131399,10,2,76,38,38
2020,131399,10,3,72,28,44
2020,131399,10,4,16,6,10
2020,131399,20,0,104,53,51
2020,131399,20,1,45,22,23
2020,131399,20,2,44,23,21
2020,131399,20,3,12,6,6
2020,131399,20,4,3,2,1
2020,131399,30,0,77,29,48
2020,131399,30,2,24,11,13
2020,131399,30,3,53,18,35
2020,131399,40,0,28,12,16
2020,131399,40,2,8,4,4
2020,131399,40,3,7,4,3
2020,131399,40,4,13,4,9
2020,131399,41,0,20,8,12
2020,131399,41,2,5,3,2
2020,131399,41,3,2,1,1
2020,131399,41,4,13,4,9
2020,131399,42,0,8,4,4
2020,131399,42,2,3,1,2
2020,131399,42,3,5,3,2
2020,131399,44,0,20,8,12
2020,131399,44,2,5,3,2
2020,131399,44,3,2,1,1
2020,131399,44,4,13,4,9
2020,131405,0,0,19,18,1
2020,131405,10,0,19,18,1
2020,131405,10,1,2,2,0
2020,131405,10,2,3,3,0
2020,131405,10,3,13,12,1
2020,131405,10,4,1,1,0
2020,131405,40,0,19,18,1
2020,131405,40,1,2,2,0
2020,131405,40,2,3,3,0
2020,131405,40,3,13,12,1
2020,131405,40,4,1,1,0
2020,131405,41,0,17,17,0
2020,131405,41,1,1,1,0
2020,131405,41,2,3,3,0
2020,131405,41,3,12,12,0
2020,131405,41,4,1,1,0
2020,131405,42,0,2,1,1
2020,131405,42,1,1,1,0
2020,131405,42,3,1,0,1
2020,131405,44,0,17,17,0
2020,131405,44,1,1,1,0
2020,131405,44,2,3,3,0
2020,131405,44,3,12,12,0
2020,131405,44,4,1,1,0
2020,131450,0,0,197,80,117
2020,131450,10,0,192,76,116
2020,131450,10,1,73,27,46
2020,131450,10,2,38,16,22
2020,131450,10,3,44,18,26
2020,131450,10,4,14,8,6
2020,131450,10,5,23,7,16
2020,131450,20,0,106,43,63
2020,131450,20,1,73,27,46
2020,131450,20,2,26,12,14
2020,131450,20,3,7,4,3
2020,131450,30,0,54,23,31
2020,131450,30,2,12,4,8
2020,131450,30,3,35,13,22
2020,131450,30,4,7,6,1
2020,131450,40,0,32,10,22
2020,131450,40,3,2,1,1
2020,131450,40,4,7,2,5
2020,131450,40,5,23,7,16
2020,131450,42,0,32,10,22
2020,131450,42,3,2,1,1
2020,131450,42,4,7,2,5
2020,131450,42,5,23,7,16
2020,131450,50,0,5,4,1
2020,131469,0,0,1255,671,584
2020,131469,10,0,1255,671,584
2020,131469,10,1,426,287,139
2020,131469,10,2,391,202,189
2020,131469,10,3,268,118,150
2020,131469,10,4,1,0,1
2020,131469,10,6,169,64,105
2020,131469,20,0,645,402,243
2020,131469,20,1,380,252,128
2020,131469,20,2,265,150,115
2020,131469,30,0,166,79,87
2020,131469,30,1,4,3,1
2020,131469,30,2,20,9,11
2020,131469,30,3,142,67,75
2020,131469,40,0,444,190,254
2020,131469,40,1,42,32,10
2020,131469,40,2,106,43,63
2020,131469,40,3,126,51,75
2020,131469,40,4,1,0,1
2020,131469,40,6,169,64,105
2020,131469,41,0,245,107,138
2020,131469,41,1,25,21,4
2020,131469,41,2,67,27,40
2020,131469,41,3,78,30,48
2020,131469,41,6,75,29,46
2020,131469,42,0,197,81,116
2020,131469,42,1,17,11,6
2020,131469,42,2,39,16,23
2020,131469,42,3,48,21,27
2020,131469,42,4,1,0,1
2020,131469,42,6,92,33,59
2020,131469,43,0,2,2,0
2020,131469,43,6,2,2,0
2020,131469,44,0,245,107,138
2020,131469,44,1,25,21,4
2020,131469,44,2,67,27,40
2020,131469,44,3,78,30,48
2020,131469,44,6,75,29,46
2020,131496,0,0,1265,686,579
2020,131496,10,0,1253,679,574
2020,131496,10,1,446,286,160
2020,131496,10,2,246,134,112
2020,131496,10,3,120,62,58
2020,131496,10,6,441,197,244
2020,131496,20,0,665,408,257
2020,131496,20,1,437,280,157
2020,131496,20,2,226,127,99
2020,131496,20,3,2,1,1
2020,131496,30,0,139,72,67
2020,131496,30,1,8,5,3
2020,131496,30,2,19,7,12
2020,131496,30,3,112,60,52
2020,131496,40,0,449,199,250
2020,131496,40,1,1,1,0
2020,131496,40,2,1,0,1
2020,131496,40,3,6,1,5
2020,131496,40,6,441,197,244
2020,131496,41,0,205,89,116
2020,131496,41,6,205,89,116
2020,131496,42,0,186,78,108
2020,131496,42,1,1,1,0
2020,131496,42,2,1,0,1
2020,131496,42,3,6,1,5
2020,131496,42,6,178,76,102
2020,131496,43,0,58,32,26
2020,131496,43,6,58,32,26
2020,131496,44,0,205,89,116
2020,131496,44,6,205,89,116
2020,131496,50,0,12,7,5
2020,131520,0,0,929,481,448
2020,131520,10,0,929,481,448
2020,131520,10,1,232,152,80
2020,131520,10,2,298,160,138
2020,131520,10,3,234,99,135
2020,131520,10,4,61,24,37
2020,131520,10,5,104,46,58
2020,131520,20,0,467,278,189
2020,131520,20,1,220,146,74
2020,131520,20,2,239,130,109
2020,131520,20,3,7,2,5
2020,131520,20,4,1,0,1
2020,131520,30,0,155,72,83
2020,131520,30,1,2,2,0
2020,131520,30,2,15,6,9
2020,131520,30,3,136,63,73
2020,131520,30,4,2,1,1
2020,131520,40,0,307,131,176
2020,131520,40,1,10,4,6
2020,131520,40,2,44,24,20
2020,131520,40,3,91,34,57
2020,131520,40,4,58,23,35
2020,131520,40,5,104,46,58
2020,131520,41,0,146,62,84
2020,131520,41,1,5,3,2
2020,131520,41,2,39,20,19
2020,131520,41,3,62,21,41
2020,131520,41,4,40,18,22
2020,131520,42,0,161,69,92
2020,131520,42,1,5,1,4
2020,131520,42,2,5,4,1
2020,131520,42,3,29,13,16
2020,131520,42,4,18,5,13
2020,131520,42,5,104,46,58
2020,131520,44,0,146,62,84
2020,131520,44,1,5,3,2
2020,131520,44,2,39,20,19
2020,131520,44,3,62,21,41
2020,131520,44,4,40,18,22
2020,131803,0,0,202,80,122
2020,131803,10,0,202,80,122
2020,131803,10,1,127,60,67
2020,131803,10,4,41,9,32
2020,131803,10,6,34,11,23
2020,131803,40,0,202,80,122
2020,131803,40,1,127,60,67
2020,131803,40,4,41,9,32
2020,131803,40,6,34,11,23
2020,131803,41,0,146,47,99
2020,131803,41,1,71,27,44
2020,131803,41,4,41,9,32
2020,131803,41,6,34,11,23
2020,131803,42,0,56,33,23
2020,131803,42,1,56,33,23
2020,131803,45,0,146,47,99
2020,131803,45,1,71,27,44
2020,131803,45,4,41,9,32
2020,131803,45,6,34,11,23
2020,131876,0,0,72,17,55
2020,131876,10,0,62,15,47
2020,131876,10,1,3,0,3
2020,131876,10,2,24,7,17
2020,131876,10,3,33,8,25
2020,131876,10,4,2,0,2
2020,131876,20,0,25,6,19
2020,131876,20,1,3,0,3
2020,131876,20,2,22,6,16
2020,131876,30,0,13,3,10
2020,131876,30,2,1,1,0
2020,131876,30,3,12,2,10
2020,131876,40,0,24,6,18
2020,131876,40,2,1,0,1
2020,131876,40,3,21,6,15
2020,131876,40,4,2,0,2
2020,131876,42,0,24,6,18
2020,131876,42,2,1,0,1
2020,131876,42,3,21,6,15
2020,131876,42,4,2,0,2
2020,131876,50,0,10,2,8
2020,131973,0,0,20,11,9
2020,131973,10,0,20,11,9
2020,131973,10,1,12,7,5
2020,131973,10,2,6,3,3
2020,131973,10,3,2,1,1
2020,131973,20,0,11,6,5
2020,131973,20,1,11,6,5
2020,131973,30,0,6,3,3
2020,131973,30,2,5,3,2
2020,131973,30,3,1,0,1
2020,131973,40,0,3,2,1
2020,131973,40,1,1,1,0
2020,131973,40,2,1,0,1
2020,131973,40,3,1,1,0
2020,131973,41,0,3,2,1
2020,131973,41,1,1,1,0
2020,131973,41,2,1,0,1
2020,131973,41,3,1,1,0
2020,131973,44,0,1,0,1
2020,131973,44,2,1,0,1
2020,131973,45,0,2,2,0
2020,131973,45,1,1,1,0
2020,131973,45,3,1,1,0
2020,132408,0,0,23,16,7
2020,132408,10,0,23,16,7
2020,132408,10,1,11,10,1
2020,132408,10,2,4,3,1
2020,132408,10,3,5,3,2
2020,132408,10,4,3,0,3
2020,132408,20,0,5,4,1
2020,132408,20,1,5,4,1
2020,132408,30,0,1,1,0
2020,132408,30,2,1,1,0
2020,132408,40,0,17,11,6
2020,132408,40,1,6,6,0
2020,132408,40,2,3,2,1
2020,132408,40,3,5,3,2
2020,132408,40,4,3,0,3
2020,132408,42,0,17,11,6
2020,132408,42,1,6,6,0
2020,132408,42,2,3,2,1
2020,132408,42,3,5,3,2
2020,132408,42,4,3,0,3
2020,132471,0,0,275,125,150
2020,132471,10,0,275,125,150
2020,132471,10,1,71,39,32
2020,132471,10,2,90,35,55
2020,132471,10,3,94,42,52
2020,132471,10,4,20,9,11
2020,132471,20,0,14,6,8
2020,132471,20,1,9,5,4
2020,132471,20,2,5,1,4
2020,132471,30,0,16,8,8
2020,132471,30,2,6,3,3
2020,132471,30,3,10,5,5
2020,132471,40,0,245,111,134
2020,132471,40,1,62,34,28
2020,132471,40,2,79,31,48
2020,132471,40,3,84,37,47
2020,132471,40,4,20,9,11
2020,132471,41,0,117,52,65
2020,132471,41,1,44,26,18
2020,132471,41,2,38,15,23
2020,132471,41,3,35,11,24
2020,132471,42,0,128,59,69
2020,132471,42,1,18,8,10
2020,132471,42,2,41,16,25
2020,132471,42,3,49,26,23
2020,132471,42,4,20,9,11
2020,132471,44,0,117,52,65
2020,132471,44,1,44,26,18
2020,132471,44,2,38,15,23
2020,132471,44,3,35,11,24
2020,132602,0,0,152,82,70
2020,132602,10,0,152,82,70
2020,132602,10,1,14,10,4
2020,132602,10,2,33,18,15
2020,132602,10,3,68,37,31
2020,132602,10,4,37,17,20
2020,132602,20,0,41,24,17
2020,132602,20,1,13,9,4
2020,132602,20,2,28,15,13
2020,132602,30,0,58,34,24
2020,132602,30,1,1,1,0
2020,132602,30,2,4,3,1
2020,132602,30,3,51,28,23
2020,132602,30,4,2,2,0
2020,132602,40,0,53,24,29
2020,132602,40,2,1,0,1
2020,132602,40,3,17,9,8
2020,132602,40,4,35,15,20
2020,132602,42,0,53,24,29
2020,132602,42,2,1,0,1
2020,132602,42,3,17,9,8
2020,132602,42,4,35,15,20
2020,132657,0,0,122,70,52
2020,132657,10,0,122,70,52
2020,132657,10,1,26,14,12
2020,132657,10,2,50,30,20
2020,132657,10,3,38,20,18
2020,132657,10,4,5,4,1
2020,132657,10,5,1,1,0
2020,132657,10,6,2,1,1
2020,132657,40,0,122,70,52
2020,132657,40,1,26,14,12
2020,132657,40,2,50,30,20
2020,132657,40,3,38,20,18
2020,132657,40,4,5,4,1
2020,132657,40,5,1,1,0
2020,132657,40,6,2,1,1
2020,132657,42,0,122,70,52
2020,132657,42,1,26,14,12
2020,132657,42,2,50,30,20
2020,132657,42,3,38,20,18
2020,132657,42,4,5,4,1
2020,132657,42,5,1,1,0
2020,132657,42,6,2,1,1
2020,132693,0,0,265,119,146
2020,132693,10,0,265,119,146
2020,132693,10,1,52,21,31
2020,132693,10,2,47,19,28
2020,132693,10,3,52,23,29
2020,132693,10,4,114,56,58
2020,132693,20,0,159,68,91
2020,132693,20,1,51,21,30
2020,132693,20,2,44,19,25
2020,132693,20,3,48,20,28
2020,132693,20,4,16,8,8
2020,132693,30,0,94,46,48
2020,132693,30,1,1,0,1
2020,132693,30,3,2,2,0
2020,132693,30,4,91,44,47
2020,132693,40,0,12,5,7
2020,132693,40,2,3,0,3
2020,132693,40,3,2,1,1
2020,132693,40,4,7,4,3
2020,132693,43,0,12,5,7
2020,132693,43,2,3,0,3
2020,132693,43,3,2,1,1
2020,132693,43,4,7,4,3
2020,132709,0,0,378,175,203
2020,132709,10,0,378,175,203
2020,132709,10,1,55,30,25
2020,132709,10,2,152,66,86
2020,132709,10,3,144,61,83
2020,132709,10,4,27,18,9
2020,132709,20,0,274,128,146
2020,132709,20,1,55,30,25
2020,132709,20,2,152,66,86
2020,132709,20,3,55,25,30
2020,132709,20,4,12,7,5
2020,132709,30,0,103,46,57
2020,132709,30,3,89,36,53
2020,132709,30,4,14,10,4
2020,132709,40,0,1,1,0
2020,132709,40,4,1,1,0
2020,132709,43,0,1,1,0
2020,132709,43,4,1,1,0
2020,132842,0,0,24,6,18
2020,132842,10,0,24,6,18
2020,132842,10,1,4,1,3
2020,132842,10,2,8,2,6
2020,132842,10,3,12,3,9
2020,132842,40,0,24,6,18
2020,132842,40,1,4,1,3
2020,132842,40,2,8,2,6
2020,132842,40,3,12,3,9
2020,132842,41,0,20,4,16
2020,132842,41,1,4,1,3
2020,132842,41,2,8,2,6
2020,132842,41,3,8,1,7
2020,132842,42,0,4,2,2
2020,132842,42,3,4,2,2
2020,132842,44,0,20,4,16
2020,132842,44,1,4,1,3
2020,132842,44,2,8,2,6
2020,132842,44,3,8,1,7
2020,132851,0,0,123,48,75
2020,132851,10,0,123,48,75
2020,132851,10,1,19,6,13
2020,132851,10,2,36,19,17
2020,132851,10,3,19,8,11
2020,132851,10,4,7,5,2
2020,132851,10,6,42,10,32
2020,132851,20,0,78,33,45
2020,132851,20,1,18,5,13
2020,132851,20,2,33,17,16
2020,132851,20,3,18,7,11
2020,132851,20,4,6,4,2
2020,132851,20,6,3,0,3
2020,132851,40,0,45,15,30
2020,132851,40,1,1,1,0
2020,132851,40,2,3,2,1
2020,132851,40,3,1,1,0
2020,132851,40,4,1,1,0
2020,132851,40,6,39,10,29
2020,132851,43,0,45,15,30
2020,132851,43,1,1,1,0
2020,132851,43,2,3,2,1
2020,132851,43,3,1,1,0
2020,132851,43,4,1,1,0
2020,132851,43,6,39,10,29
2020,132879,0,0,13,6,7
2020,132879,10,0,13,6,7
2020,132879,10,1,5,1,4
2020,132879,10,2,5,4,1
2020,132879,10,3,2,1,1
2020,132879,10,4,1,0,1
2020,132879,40,0,13,6,7
2020,132879,40,1,5,1,4
2020,132879,40,2,5,4,1
2020,132879,40,3,2,1,1
2020,132879,40,4,1,0,1
2020,132879,42,0,13,6,7
2020,132879,42,1,5,1,4
2020,132879,42,2,5,4,1
2020,132879,42,3,2,1,1
2020,132879,42,4,1,0,1
2020,132903,0,0,1577,898,679
2020,132903,10,0,1577,898,679
2020,132903,10,1,359,268,91
2020,132903,10,2,390,228,162
2020,132903,10,3,350,196,154
2020,132903,10,4,200,76,124
2020,132903,10,5,278,130,148
2020,132903,20,0,712,478,234
2020,132903,20,1,347,261,86
2020,132903,20,2,363,215,148
2020,132903,20,3,2,2,0
2020,132903,30,0,319,188,131
2020,132903,30,1,1,1,0
2020,132903,30,2,7,5,2
2020,132903,30,3,311,182,129
2020,132903,40,0,546,232,314
2020,132903,40,1,11,6,5
2020,132903,40,2,20,8,12
2020,132903,40,3,37,12,25
2020,132903,40,4,200,76,124
2020,132903,40,5,278,130,148
2020,132903,41,0,44,16,28
2020,132903,41,1,6,3,3
2020,132903,41,2,14,6,8
2020,132903,41,3,24,7,17
2020,132903,42,0,502,216,286
2020,132903,42,1,5,3,2
2020,132903,42,2,6,2,4
2020,132903,42,3,13,5,8
2020,132903,42,4,200,76,124
2020,132903,42,5,278,130,148
2020,132903,44,0,44,16,28
2020,132903,44,1,6,3,3
2020,132903,44,2,14,6,8
2020,132903,44,3,24,7,17
2020,133021,0,0,41,15,26
2020,133021,10,0,41,15,26
2020,133021,10,1,8,4,4
2020,133021,10,2,1,0,1
2020,133021,10,3,14,6,8
2020,133021,10,4,18,5,13
2020,133021,20,0,21,8,13
2020,133021,20,1,8,4,4
2020,133021,20,2,1,0,1
2020,133021,20,3,10,4,6
2020,133021,20,4,2,0,2
2020,133021,30,0,18,7,11
2020,133021,30,3,4,2,2
2020,133021,30,4,14,5,9
2020,133021,40,0,2,0,2
2020,133021,40,4,2,0,2
2020,133021,42,0,2,0,2
2020,133021,42,4,2,0,2
2020,133386,0,0,222,115,107
2020,133386,10,0,222,115,107
2020,133386,10,1,123,71,52
2020,133386,10,2,55,23,32
2020,133386,10,3,36,13,23
2020,133386,10,4,8,8,0
2020,133386,20,0,178,98,80
2020,133386,20,1,123,71,52
2020,133386,20,2,48,21,27
2020,133386,20,3,7,6,1
2020,133386,30,0,44,17,27
2020,133386,30,2,7,2,5
2020,133386,30,3,29,7,22
2020,133386,30,4,8,8,0
2020,133465,0,0,19,6,13
2020,133465,10,0,19,6,13
2020,133465,10,2,1,0,1
2020,133465,10,3,8,1,7
2020,133465,10,4,10,5,5
2020,133465,40,0,19,6,13
2020,133465,40,2,1,0,1
2020,133465,40,3,8,1,7
2020,133465,40,4,10,5,5
2020,133465,41,0,19,6,13
2020,133465,41,2,1,0,1
2020,133465,41,3,8,1,7
2020,133465,41,4,10,5,5
2020,133465,45,0,19,6,13
2020,133465,45,2,1,0,1
2020,133465,45,3,8,1,7
2020,133465,45,4,10,5,5
2020,133492,0,0,156,79,77
2020,133492,10,0,156,79,77
2020,133492,10,1,45,28,17
2020,133492,10,2,29,14,15
2020,133492,10,3,63,27,36
2020,133492,10,4,19,10,9
2020,133492,20,0,84,46,38
2020,133492,20,1,45,28,17
2020,133492,20,2,29,14,15
2020,133492,20,3,10,4,6
2020,133492,30,0,38,15,23
2020,133492,30,3,38,15,23
2020,133492,40,0,34,18,16
2020,133492,40,3,15,8,7
2020,133492,40,4,19,10,9
2020,133492,42,0,34,18,16
2020,133492,42,3,15,8,7
2020,133492,42,4,19,10,9
2020,133508,0,0,197,93,104
2020,133508,10,0,197,93,104
2020,133508,10,6,197,93,104
2020,133508,20,0,111,53,58
2020,133508,20,6,111,53,58
2020,133508,30,0,83,38,45
2020,133508,30,6,83,38,45
2020,133508,40,0,3,2,1
2020,133508,40,6,3,2,1
2020,133508,42,0,3,2,1
2020,133508,42,6,3,2,1
2020,133526,0,0,52,29,23
2020,133526,10,0,52,29,23
2020,133526,10,1,11,8,3
2020,133526,10,2,12,5,7
2020,133526,10,3,19,10,9
2020,133526,10,4,10,6,4
2020,133526,20,0,10,7,3
2020,133526,20,1,10,7,3
2020,133526,30,0,27,12,15
2020,133526,30,1,1,1,0
2020,133526,30,2,10,4,6
2020,133526,30,3,16,7,9
2020,133526,40,0,15,10,5
2020,133526,40,2,2,1,1
2020,133526,40,3,3,3,0
2020,133526,40,4,10,6,4
2020,133526,43,0,15,10,5
2020,133526,43,2,2,1,1
2020,133526,43,3,3,3,0
2020,133526,43,4,10,6,4
2020,133553,0,0,342,239,103
2020,133553,10,0,342,239,103
2020,133553,10,1,91,74,17
2020,133553,10,2,113,87,26
2020,133553,10,3,115,66,49
2020,133553,10,4,23,12,11
2020,133553,20,0,153,115,38
2020,133553,20,1,83,69,14
2020,133553,20,2,70,46,24
2020,133553,30,0,55,35,20
2020,133553,30,1,1,1,0
2020,133553,30,2,4,4,0
2020,133553,30,3,50,30,20
2020,133553,40,0,134,89,45
2020,133553,40,1,7,4,3
2020,133553,40,2,39,37,2
2020,133553,40,3,65,36,29
2020,133553,40,4,23,12,11
2020,133553,42,0,134,89,45
2020,133553,42,1,7,4,3
2020,133553,42,2,39,37,2
2020,133553,42,3,65,36,29
2020,133553,42,4,23,12,11
2020,133650,0,0,577,295,282
2020,133650,10,0,533,285,248
2020,133650,10,1,150,105,45
2020,133650,10,2,166,83,83
2020,133650,10,3,137,63,74
2020,133650,10,4,80,34,46
2020,133650,20,0,292,179,113
2020,133650,20,1,143,103,40
2020,133650,20,2,135,68,67
2020,133650,20,3,14,8,6
2020,133650,30,0,102,53,49
2020,133650,30,1,2,0,2
2020,133650,30,2,25,15,10
2020,133650,30,3,75,38,37
2020,133650,40,0,139,53,86
2020,133650,40,1,5,2,3
2020,133650,40,2,6,0,6
2020,133650,40,3,48,17,31
2020,133650,40,4,80,34,46
2020,133650,42,0,139,53,86
2020,133650,42,1,5,2,3
2020,133650,42,2,6,0,6
2020,133650,42,3,48,17,31
2020,133650,42,4,80,34,46
2020,133650,50,0,44,10,34
2020,133669,0,0,877,479,398
2020,133669,10,0,877,479,398
2020,133669,10,1,247,174,73
2020,133669,10,2,235,125,110
2020,133669,10,3,177,94,83
2020,133669,10,4,214,85,129
2020,133669,10,5,1,0,1
2020,133669,10,6,3,1,2
2020,133669,20,0,454,285,169
2020,133669,20,1,239,169,70
2020,133669,20,2,215,116,99
2020,133669,30,0,149,81,68
2020,133669,30,1,1,1,0
2020,133669,30,2,5,2,3
2020,133669,30,3,143,78,65
2020,133669,40,0,274,113,161
2020,133669,40,1,7,4,3
2020,133669,40,2,15,7,8
2020,133669,40,3,34,16,18
2020,133669,40,4,214,85,129
2020,133669,40,5,1,0,1
2020,133669,40,6,3,1,2
2020,133669,42,0,274,113,161
2020,133669,42,1,7,4,3
2020,133669,42,2,15,7,8
2020,133669,42,3,34,16,18
2020,133669,42,4,214,85,129
2020,133669,42,5,1,0,1
2020,133669,42,6,3,1,2
2020,133702,0,0,343,161,182
2020,133702,10,0,343,161,182
2020,133702,10,6,343,161,182
2020,133702,20,0,230,102,128
2020,133702,20,6,230,102,128
2020,133702,30,0,107,58,49
2020,133702,30,6,107,58,49
2020,133702,40,0,6,1,5
2020,133702,40,6,6,1,5
2020,133702,43,0,6,1,5
2020,133702,43,6,6,1,5
2020,133711,0,0,121,50,71
2020,133711,10,0,121,50,71
2020,133711,10,1,20,10,10
2020,133711,10,2,38,16,22
2020,133711,10,3,58,23,35
2020,133711,10,4,2,1,1
2020,133711,10,5,3,0,3
2020,133711,40,0,121,50,71
2020,133711,40,1,20,10,10
2020,133711,40,2,38,16,22
2020,133711,40,3,58,23,35
2020,133711,40,4,2,1,1
2020,133711,40,5,3,0,3
2020,133711,41,0,99,43,56
2020,133711,41,1,20,10,10
2020,133711,41,2,38,16,22
2020,133711,41,3,41,17,24
2020,133711,42,0,22,7,15
2020,133711,42,3,17,6,11
2020,133711,42,4,2,1,1
2020,133711,42,5,3,0,3
2020,133711,44,0,99,43,56
2020,133711,44,1,20,10,10
2020,133711,44,2,38,16,22
2020,133711,44,3,41,17,24
2020,133809,0,0,38,29,9
2020,133809,10,0,38,29,9
2020,133809,10,1,38,29,9
2020,133809,20,0,23,17,6
2020,133809,20,1,23,17,6
2020,133809,30,0,15,12,3
2020,133809,30,1,15,12,3
2020,133845,0,0,17,1,16
2020,133845,10,0,17,1,16
2020,133845,10,4,17,1,16
2020,133845,40,0,17,1,16
2020,133845,40,4,17,1,16
2020,133845,41,0,17,1,16
2020,133845,41,4,17,1,16
2020,133845,45,0,17,1,16
2020,133845,45,4,17,1,16
2020,133854,0,0,9,2,7
2020,133854,10,0,9,2,7
2020,133854,10,4,9,2,7
2020,133854,40,0,9,2,7
2020,133854,40,4,9,2,7
2020,133854,41,0,9,2,7
2020,133854,41,4,9,2,7
2020,133854,45,0,9,2,7
2020,133854,45,4,9,2,7
2020,133863,0,0,6,0,6
2020,133863,10,0,6,0,6
2020,133863,10,4,6,0,6
2020,133863,40,0,6,0,6
2020,133863,40,4,6,0,6
2020,133863,41,0,6,0,6
2020,133863,41,4,6,0,6
2020,133863,45,0,6,0,6
2020,133863,45,4,6,0,6
2020,133872,0,0,95,26,69
2020,133872,10,0,95,26,69
2020,133872,10,1,12,7,5
2020,133872,10,2,27,5,22
2020,133872,10,3,40,12,28
2020,133872,10,4,16,2,14
2020,133872,40,0,95,26,69
2020,133872,40,1,12,7,5
2020,133872,40,2,27,5,22
2020,133872,40,3,40,12,28
2020,133872,40,4,16,2,14
2020,133872,42,0,95,26,69
2020,133872,42,1,12,7,5
2020,133872,42,2,27,5,22
2020,133872,42,3,40,12,28
2020,133872,42,4,16,2,14
2020,133881,0,0,272,201,71
2020,133881,10,0,272,201,71
2020,133881,10,1,73,62,11
2020,133881,10,2,76,65,11
2020,133881,10,3,102,66,36
2020,133881,10,4,21,8,13
2020,133881,20,0,71,55,16
2020,133881,20,1,47,37,10
2020,133881,20,2,24,18,6
2020,133881,30,0,28,20,8
2020,133881,30,1,4,4,0
2020,133881,30,2,8,6,2
2020,133881,30,3,16,10,6
2020,133881,40,0,173,126,47
2020,133881,40,1,22,21,1
2020,133881,40,2,44,41,3
2020,133881,40,3,86,56,30
2020,133881,40,4,21,8,13
2020,133881,42,0,173,126,47
2020,133881,42,1,22,21,1
2020,133881,42,2,44,41,3
2020,133881,42,3,86,56,30
2020,133881,42,4,21,8,13
2020,133951,0,0,1401,786,615
2020,133951,10,0,1398,784,614
2020,133951,10,1,295,220,75
2020,133951,10,2,357,207,150
2020,133951,10,3,299,137,162
2020,133951,10,4,414,208,206
2020,133951,10,5,13,3,10
2020,133951,10,6,20,9,11
2020,133951,20,0,529,358,171
2020,133951,20,1,265,199,66
2020,133951,20,2,263,159,104
2020,133951,20,3,1,0,1
2020,133951,30,0,203,115,88
2020,133951,30,1,4,3,1
2020,133951,30,2,37,23,14
2020,133951,30,3,161,89,72
2020,133951,30,4,1,0,1
2020,133951,40,0,666,311,355
2020,133951,40,1,26,18,8
2020,133951,40,2,57,25,32
2020,133951,40,3,137,48,89
2020,133951,40,4,413,208,205
2020,133951,40,5,13,3,10
2020,133951,40,6,20,9,11
2020,133951,41,0,37,18,19
2020,133951,41,1,9,6,3
2020,133951,41,2,8,4,4
2020,133951,41,3,11,2,9
2020,133951,41,4,9,6,3
2020,133951,42,0,629,293,336
2020,133951,42,1,17,12,5
2020,133951,42,2,49,21,28
2020,133951,42,3,126,46,80
2020,133951,42,4,404,202,202
2020,133951,42,5,13,3,10
2020,133951,42,6,20,9,11
2020,133951,44,0,37,18,19
2020,133951,44,1,9,6,3
2020,133951,44,2,8,4,4
2020,133951,44,3,11,2,9
2020,133951,44,4,9,6,3
2020,133951,50,0,3,2,1
2020,133960,0,0,28,12,16
2020,133960,10,0,28,12,16
2020,133960,10,1,8,4,4
2020,133960,10,2,10,3,7
2020,133960,10,3,8,4,4
2020,133960,10,4,2,1,1
2020,133960,20,0,6,1,5
2020,133960,20,1,4,1,3
2020,133960,20,2,2,0,2
2020,133960,30,0,22,11,11
2020,133960,30,1,4,3,1
2020,133960,30,2,8,3,5
2020,133960,30,3,8,4,4
2020,133960,30,4,2,1,1
2020,133979,0,0,61,34,27
2020,133979,10,0,61,34,27
2020,133979,10,1,6,3,3
2020,133979,10,2,26,13,13
2020,133979,10,3,21,14,7
2020,133979,10,4,8,4,4
2020,133979,20,0,23,12,11
2020,133979,20,1,6,3,3
2020,133979,20,2,17,9,8
2020,133979,30,0,30,18,12
2020,133979,30,2,9,4,5
2020,133979,30,3,21,14,7
2020,133979,40,0,8,4,4
2020,133979,40,4,8,4,4
2020,133979,42,0,8,4,4
2020,133979,42,4,8,4,4
2020,133997,0,0,6,2,4
2020,133997,50,0,6,2,4
2020,134079,0,0,157,78,79
2020,134079,10,0,157,78,79
2020,134079,10,1,20,14,6
2020,134079,10,2,55,28,27
2020,134079,10,3,66,29,37
2020,134079,10,4,16,7,9
2020,134079,20,0,50,26,24
2020,134079,20,1,14,10,4
2020,134079,20,2,36,16,20
2020,134079,30,0,45,19,26
2020,134079,30,2,7,3,4
2020,134079,30,3,37,16,21
2020,134079,30,4,1,0,1
2020,134079,40,0,62,33,29
2020,134079,40,1,6,4,2
2020,134079,40,2,12,9,3
2020,134079,40,3,29,13,16
2020,134079,40,4,15,7,8
2020,134079,41,0,27,15,12
2020,134079,41,1,5,4,1
2020,134079,41,2,11,8,3
2020,134079,41,3,5,1,4
2020,134079,41,4,6,2,4
2020,134079,42,0,35,18,17
2020,134079,42,1,1,0,1
2020,134079,42,2,1,1,0
2020,134079,42,3,24,12,12
2020,134079,42,4,9,5,4
2020,134079,45,0,27,15,12
2020,134079,45,1,5,4,1
2020,134079,45,2,11,8,3
2020,134079,45,3,5,1,4
2020,134079,45,4,6,2,4
2020,134097,0,0,1631,932,699
2020,134097,10,0,1603,916,687
2020,134097,10,1,511,364,147
2020,134097,10,2,371,216,155
2020,134097,10,3,336,171,165
2020,134097,10,6,385,165,220
2020,134097,20,0,835,554,281
2020,134097,20,1,495,356,139
2020,134097,20,2,340,198,142
2020,134097,30,0,324,171,153
2020,134097,30,1,2,2,0
2020,134097,30,2,18,10,8
2020,134097,30,3,304,159,145
2020,134097,40,0,444,191,253
2020,134097,40,1,14,6,8
2020,134097,40,2,13,8,5
2020,134097,40,3,32,12,20
2020,134097,40,6,385,165,220
2020,134097,42,0,444,191,253
2020,134097,42,1,14,6,8
2020,134097,42,2,13,8,5
2020,134097,42,3,32,12,20
2020,134097,42,6,385,165,220
2020,134097,50,0,28,16,12
2020,134130,0,0,2902,1760,1142
2020,134130,10,0,2902,1760,1142
2020,134130,10,1,1061,796,265
2020,134130,10,2,586,366,220
2020,134130,10,3,711,374,337
2020,134130,10,5,453,186,267
2020,134130,10,6,91,38,53
2020,134130,20,0,1500,1068,432
2020,134130,20,1,999,755,244
2020,134130,20,2,499,311,188
2020,134130,20,3,2,2,0
2020,134130,30,0,697,410,287
2020,134130,30,1,29,22,7
2020,134130,30,2,67,47,20
2020,134130,30,3,599,341,258
2020,134130,30,5,2,0,2
2020,134130,40,0,705,282,423
2020,134130,40,1,33,19,14
2020,134130,40,2,20,8,12
2020,134130,40,3,110,31,79
2020,134130,40,5,451,186,265
2020,134130,40,6,91,38,53
2020,134130,42,0,705,282,423
2020,134130,42,1,33,19,14
2020,134130,42,2,20,8,12
2020,134130,42,3,110,31,79
2020,134130,42,5,451,186,265
2020,134130,42,6,91,38,53
2020,134237,0,0,772,558,214
2020,134237,10,0,772,558,214
2020,134237,10,1,479,338,141
2020,134237,10,2,133,83,50
2020,134237,10,6,160,137,23
2020,134237,40,0,772,558,214
2020,134237,40,1,479,338,141
2020,134237,40,2,133,83,50
2020,134237,40,6,160,137,23
2020,134237,41,0,772,558,214
2020,134237,41,1,479,338,141
2020,134237,41,2,133,83,50
2020,134237,41,6,160,137,23
2020,134237,45,0,772,558,214
2020,134237,45,1,479,338,141
2020,134237,45,2,133,83,50
2020,134237,45,6,160,137,23
2020,134343,0,0,133,52,81
2020,134343,10,0,133,52,81
2020,134343,10,1,25,11,14
2020,134343,10,2,27,12,15
2020,134343,10,3,25,9,16
2020,134343,10,4,8,2,6
2020,134343,10,6,48,18,30
2020,134343,20,0,43,20,23
2020,134343,20,1,23,11,12
2020,134343,20,2,19,9,10
2020,134343,20,3,1,0,1
2020,134343,30,0,30,7,23
2020,134343,30,1,2,0,2
2020,134343,30,2,8,3,5
2020,134343,30,3,17,4,13
2020,134343,30,4,3,0,3
2020,134343,40,0,60,25,35
2020,134343,40,3,7,5,2
2020,134343,40,4,5,2,3
2020,134343,40,6,48,18,30
2020,134343,43,0,60,25,35
2020,134343,43,3,7,5,2
2020,134343,43,4,5,2,3
2020,134343,43,6,48,18,30
2020,134495,0,0,306,133,173
2020,134495,10,0,304,132,172
2020,134495,10,1,45,20,25
2020,134495,10,2,48,21,27
2020,134495,10,3,112,47,65
2020,134495,10,4,84,38,46
2020,134495,10,6,15,6,9
2020,134495,20,0,218,94,124
2020,134495,20,1,45,20,25
2020,134495,20,2,47,20,27
2020,134495,20,3,112,47,65
2020,134495,20,4,14,7,7
2020,134495,30,0,66,32,34
2020,134495,30,4,64,30,34
2020,134495,30,6,2,2,0
2020,134495,40,0,20,6,14
2020,134495,40,2,1,1,0
2020,134495,40,4,6,1,5
2020,134495,40,6,13,4,9
2020,134495,42,0,7,2,5
2020,134495,42,2,1,1,0
2020,134495,42,4,6,1,5
2020,134495,43,0,13,4,9
2020,134495,43,6,13,4,9
2020,134495,50,0,2,1,1
2020,134510,0,0,9,7,2
2020,134510,10,0,9,7,2
2020,134510,10,1,9,7,2
2020,134510,40,0,9,7,2
2020,134510,40,1,9,7,2
2020,134510,42,0,9,7,2
2020,134510,42,1,9,7,2
2020,134608,0,0,236,108,128
2020,134608,10,0,236,108,128
2020,134608,10,1,35,21,14
2020,134608,10,2,45,25,20
2020,134608,10,3,46,17,29
2020,134608,10,6,110,45,65
2020,134608,20,0,141,69,72
2020,134608,20,1,35,21,14
2020,134608,20,2,43,24,19
2020,134608,20,3,25,10,15
2020,134608,20,6,38,14,24
2020,134608,30,0,66,27,39
2020,134608,30,2,2,1,1
2020,134608,30,3,20,7,13
2020,134608,30,6,44,19,25
2020,134608,40,0,29,12,17
2020,134608,40,3,1,0,1
2020,134608,40,6,28,12,16
2020,134608,43,0,29,12,17
2020,134608,43,3,1,0,1
2020,134608,43,6,28,12,16
2020,134811,0,0,11,8,3
2020,134811,10,0,11,8,3
2020,134811,10,4,11,8,3
2020,134811,40,0,11,8,3
2020,134811,40,4,11,8,3
2020,134811,41,0,11,8,3
2020,134811,41,4,11,8,3
2020,134811,45,0,11,8,3
2020,134811,45,4,11,8,3
2020,134945,0,0,234,108,126
2020,134945,10,0,234,108,126
2020,134945,10,1,65,35,30
2020,134945,10,2,52,29,23
2020,134945,10,3,95,32,63
2020,134945,10,4,22,12,10
2020,134945,20,0,112,60,52
2020,134945,20,1,62,33,29
2020,134945,20,2,45,25,20
2020,134945,20,3,5,2,3
2020,134945,30,0,59,24,35
2020,134945,30,2,3,1,2
2020,134945,30,3,55,23,32
2020,134945,30,4,1,0,1
2020,134945,40,0,63,24,39
2020,134945,40,1,3,2,1
2020,134945,40,2,4,3,1
2020,134945,40,3,35,7,28
2020,134945,40,4,21,12,9
2020,134945,42,0,63,24,39
2020,134945,42,1,3,2,1
2020,134945,42,2,4,3,1
2020,134945,42,3,35,7,28
2020,134945,42,4,21,12,9
2020,135081,0,0,1247,453,794
2020,135081,10,0,1247,453,794
2020,135081,10,4,1247,453,794
2020,135081,40,0,1247,453,794
2020,135081,40,4,1247,453,794
2020,135081,41,0,1247,453,794
2020,135081,41,4,1247,453,794
2020,135081,45,0,1247,453,794
2020,135081,45,4,1247,453,794
2020,135160,0,0,74,28,46
2020,135160,10,0,74,28,46
2020,135160,10,3,1,0,1
2020,135160,10,6,73,28,45
2020,135160,20,0,25,11,14
2020,135160,20,6,25,11,14
2020,135160,30,0,40,13,27
2020,135160,30,3,1,0,1
2020,135160,30,6,39,13,26
2020,135160,40,0,9,4,5
2020,135160,40,6,9,4,5
2020,135160,42,0,9,4,5
2020,135160,42,6,9,4,5
2020,135188,0,0,82,34,48
2020,135188,10,0,82,34,48
2020,135188,10,1,3,0,3
2020,135188,10,2,8,3,5
2020,135188,10,3,31,11,20
2020,135188,10,4,36,18,18
2020,135188,10,6,4,2,2
2020,135188,20,0,50,17,33
2020,135188,20,1,3,0,3
2020,135188,20,2,8,3,5
2020,135188,20,3,31,11,20
2020,135188,20,4,7,3,4
2020,135188,20,6,1,0,1
2020,135188,30,0,25,14,11
2020,135188,30,4,23,13,10
2020,135188,30,6,2,1,1
2020,135188,40,0,7,3,4
2020,135188,40,4,6,2,4
2020,135188,40,6,1,1,0
2020,135188,43,0,7,3,4
2020,135188,43,4,6,2,4
2020,135188,43,6,1,1,0
2020,135364,0,0,25,24,1
2020,135364,10,0,25,24,1
2020,135364,10,1,5,5,0
2020,135364,10,2,7,6,1
2020,135364,10,3,9,9,0
2020,135364,10,4,4,4,0
2020,135364,40,0,25,24,1
2020,135364,40,1,5,5,0
2020,135364,40,2,7,6,1
2020,135364,40,3,9,9,0
2020,135364,40,4,4,4,0
2020,135364,42,0,25,24,1
2020,135364,42,1,5,5,0
2020,135364,42,2,7,6,1
2020,135364,42,3,9,9,0
2020,135364,42,4,4,4,0
2020,135391,0,0,138,58,80
2020,135391,10,0,138,58,80
2020,135391,10,1,40,22,18
2020,135391,10,2,32,9,23
2020,135391,10,3,28,12,16
2020,135391,10,4,18,10,8
2020,135391,10,5,5,5,0
2020,135391,10,6,15,0,15
2020,135391,20,0,85,37,48
2020,135391,20,1,40,22,18
2020,135391,20,2,27,8,19
2020,135391,20,3,13,6,7
2020,135391,20,4,5,1,4
2020,135391,30,0,32,15,17
2020,135391,30,2,5,1,4
2020,135391,30,3,15,6,9
2020,135391,30,4,12,8,4
2020,135391,40,0,21,6,15
2020,135391,40,4,1,1,0
2020,135391,40,5,5,5,0
2020,135391,40,6,15,0,15
2020,135391,42,0,21,6,15
2020,135391,42,4,1,1,0
2020,135391,42,5,5,5,0
2020,135391,42,6,15,0,15
2020,135717,0,0,737,357,380
2020,135717,10,0,737,357,380
2020,135717,10,1,185,89,96
2020,135717,10,2,270,135,135
2020,135717,10,3,164,75,89
2020,135717,10,4,118,58,60
2020,135717,20,0,530,255,275
2020,135717,20,1,171,80,91
2020,135717,20,2,253,125,128
2020,135717,20,3,96,44,52
2020,135717,20,4,10,6,4
2020,135717,30,0,207,102,105
2020,135717,30,1,14,9,5
2020,135717,30,2,17,10,7
2020,135717,30,3,68,31,37
2020,135717,30,4,108,52,56
2020,135726,0,0,1451,924,527
2020,135726,10,0,1451,924,527
2020,135726,10,1,595,450,145
2020,135726,10,2,336,212,124
2020,135726,10,3,233,122,111
2020,135726,10,4,1,0,1
2020,135726,10,5,286,140,146
2020,135726,20,0,815,585,230
2020,135726,20,1,564,427,137
2020,135726,20,2,251,158,93
2020,135726,30,0,202,119,83
2020,135726,30,1,10,7,3
2020,135726,30,2,30,22,8
2020,135726,30,3,161,90,71
2020,135726,30,4,1,0,1
2020,135726,40,0,434,220,214
2020,135726,40,1,21,16,5
2020,135726,40,2,55,32,23
2020,135726,40,3,72,32,40
2020,135726,40,5,286,140,146
2020,135726,41,0,82,35,47
2020,135726,41,5,82,35,47
2020,135726,42,0,352,185,167
2020,135726,42,1,21,16,5
2020,135726,42,2,55,32,23
2020,135726,42,3,72,32,40
2020,135726,42,5,204,105,99
2020,135726,44,0,82,35,47
2020,135726,44,5,82,35,47
2020,136145,0,0,25,12,13
2020,136145,10,0,25,12,13
2020,136145,10,6,25,12,13
2020,136145,20,0,12,8,4
2020,136145,20,6,12,8,4
2020,136145,30,0,3,1,2
2020,136145,30,6,3,1,2
2020,136145,40,0,10,3,7
2020,136145,40,6,10,3,7
2020,136145,43,0,10,3,7
2020,136145,43,6,10,3,7
2020,136172,0,0,544,269,275
2020,136172,10,0,544,269,275
2020,136172,10,1,96,59,37
2020,136172,10,2,162,88,74
2020,136172,10,3,123,46,77
2020,136172,10,4,130,55,75
2020,136172,10,5,31,20,11
2020,136172,10,6,2,1,1
2020,136172,20,0,256,147,109
2020,136172,20,1,96,59,37
2020,136172,20,2,160,88,72
2020,136172,30,0,105,42,63
2020,136172,30,2,1,0,1
2020,136172,30,3,104,42,62
2020,136172,40,0,183,80,103
2020,136172,40,2,1,0,1
2020,136172,40,3,19,4,15
2020,136172,40,4,130,55,75
2020,136172,40,5,31,20,11
2020,136172,40,6,2,1,1
2020,136172,42,0,183,80,103
2020,136172,42,2,1,0,1
2020,136172,42,3,19,4,15
2020,136172,42,4,130,55,75
2020,136172,42,5,31,20,11
2020,136172,42,6,2,1,1
2020,136215,0,0,832,375,457
2020,136215,10,0,832,375,457
2020,136215,10,1,201,115,86
2020,136215,10,2,251,114,137
2020,136215,10,3,332,129,203
2020,136215,10,4,40,14,26
2020,136215,10,5,3,0,3
2020,136215,10,6,5,3,2
2020,136215,20,0,27,14,13
2020,136215,20,1,26,13,13
2020,136215,20,2,1,1,0
2020,136215,40,0,805,361,444
2020,136215,40,1,175,102,73
2020,136215,40,2,250,113,137
2020,136215,40,3,332,129,203
2020,136215,40,4,40,14,26
2020,136215,40,5,3,0,3
2020,136215,40,6,5,3,2
2020,136215,41,0,384,183,201
2020,136215,41,1,140,83,57
2020,136215,41,2,183,79,104
2020,136215,41,3,61,21,40
2020,136215,42,0,419,178,241
2020,136215,42,1,35,19,16
2020,136215,42,2,67,34,33
2020,136215,42,3,271,108,163
2020,136215,42,4,40,14,26
2020,136215,42,5,3,0,3
2020,136215,42,6,3,3,0
2020,136215,43,0,2,0,2
2020,136215,43,6,2,0,2
2020,136215,44,0,384,183,201
2020,136215,44,1,140,83,57
2020,136215,44,2,183,79,104
2020,136215,44,3,61,21,40
2020,136233,0,0,81,33,48
2020,136233,10,0,81,33,48
2020,136233,10,1,37,20,17
2020,136233,10,3,13,5,8
2020,136233,10,6,31,8,23
2020,136233,20,0,37,20,17
2020,136233,20,1,37,20,17
2020,136233,30,0,8,2,6
2020,136233,30,3,8,2,6
2020,136233,40,0,36,11,25
2020,136233,40,3,5,3,2
2020,136233,40,6,31,8,23
2020,136233,42,0,36,11,25
2020,136233,42,3,5,3,2
2020,136233,42,6,31,8,23
2020,136330,0,0,164,91,73
2020,136330,10,0,164,91,73
2020,136330,10,1,44,32,12
2020,136330,10,2,61,33,28
2020,136330,10,3,52,23,29
2020,136330,10,4,7,3,4
2020,136330,40,0,164,91,73
2020,136330,40,1,44,32,12
2020,136330,40,2,61,33,28
2020,136330,40,3,52,23,29
2020,136330,40,4,7,3,4
2020,136330,42,0,164,91,73
2020,136330,42,1,44,32,12
2020,136330,42,2,61,33,28
2020,136330,42,3,52,23,29
2020,136330,42,4,7,3,4
2020,136358,0,0,340,146,194
2020,136358,10,0,340,146,194
2020,136358,10,1,58,21,37
2020,136358,10,2,42,21,21
2020,136358,10,3,85,39,46
2020,136358,10,4,155,65,90
2020,136358,20,0,161,66,95
2020,136358,20,1,48,19,29
2020,136358,20,2,17,8,9
2020,136358,20,3,34,18,16
2020,136358,20,4,62,21,41
2020,136358,30,0,146,62,84
2020,136358,30,1,9,2,7
2020,136358,30,2,24,12,12
2020,136358,30,3,51,21,30
2020,136358,30,4,62,27,35
2020,136358,40,0,33,18,15
2020,136358,40,1,1,0,1
2020,136358,40,2,1,1,0
2020,136358,40,4,31,17,14
2020,136358,42,0,33,18,15
2020,136358,42,1,1,0,1
2020,136358,42,2,1,1,0
2020,136358,42,4,31,17,14
2020,136400,0,0,152,57,95
2020,136400,10,0,152,57,95
2020,136400,10,1,31,12,19
2020,136400,10,2,32,13,19
2020,136400,10,3,38,12,26
2020,136400,10,4,47,17,30
2020,136400,10,6,4,3,1
2020,136400,20,0,94,33,61
2020,136400,20,1,30,12,18
2020,136400,20,2,31,12,19
2020,136400,20,3,28,9,19
2020,136400,20,4,5,0,5
2020,136400,30,0,54,21,33
2020,136400,30,1,1,0,1
2020,136400,30,2,1,1,0
2020,136400,30,3,10,3,7
2020,136400,30,4,42,17,25
2020,136400,40,0,4,3,1
2020,136400,40,6,4,3,1
2020,136400,42,0,4,3,1
2020,136400,42,6,4,3,1
2020,136473,0,0,161,69,92
2020,136473,10,0,161,69,92
2020,136473,10,1,38,18,20
2020,136473,10,2,29,12,17
2020,136473,10,3,26,14,12
2020,136473,10,4,58,23,35
2020,136473,10,5,10,2,8
2020,136473,20,0,87,41,46
2020,136473,20,1,38,18,20
2020,136473,20,2,28,11,17
2020,136473,20,3,17,9,8
2020,136473,20,4,4,3,1
2020,136473,30,0,65,27,38
2020,136473,30,2,1,1,0
2020,136473,30,3,9,5,4
2020,136473,30,4,54,20,34
2020,136473,30,5,1,1,0
2020,136473,40,0,9,1,8
2020,136473,40,5,9,1,8
2020,136473,42,0,9,1,8
2020,136473,42,5,9,1,8
2020,136516,0,0,152,68,84
2020,136516,10,0,152,68,84
2020,136516,10,6,152,68,84
2020,136516,20,0,120,55,65
2020,136516,20,6,120,55,65
2020,136516,30,0,32,13,19
2020,136516,30,6,32,13,19
2020,136701,0,0,14,11,3
2020,136701,10,0,14,11,3
2020,136701,10,1,7,6,1
2020,136701,10,2,2,1,1
2020,136701,10,3,5,4,1
2020,136701,40,0,14,11,3
2020,136701,40,1,7,6,1
2020,136701,40,2,2,1,1
2020,136701,40,3,5,4,1
2020,136701,42,0,14,11,3
2020,136701,42,1,7,6,1
2020,136701,42,2,2,1,1
2020,136701,42,3,5,4,1
2020,136774,0,0,120,85,35
2020,136774,10,0,120,85,35
2020,136774,10,6,120,85,35
2020,136774,40,0,120,85,35
2020,136774,40,6,120,85,35
2020,136774,42,0,120,85,35
2020,136774,42,6,120,85,35
2020,136950,0,0,206,101,105
2020,136950,10,0,206,101,105
2020,136950,10,1,73,40,33
2020,136950,10,2,59,32,27
2020,136950,10,3,50,18,32
2020,136950,10,5,24,11,13
2020,136950,20,0,131,71,60
2020,136950,20,1,72,39,33
2020,136950,20,2,59,32,27
2020,136950,30,0,45,17,28
2020,136950,30,3,45,17,28
2020,136950,40,0,30,13,17
2020,136950,40,1,1,1,0
2020,136950,40,3,5,1,4
2020,136950,40,5,24,11,13
2020,136950,41,0,30,13,17
2020,136950,41,1,1,1,0
2020,136950,41,3,5,1,4
2020,136950,41,5,24,11,13
2020,136950,44,0,6,2,4
2020,136950,44,1,1,1,0
2020,136950,44,3,5,1,4
2020,136950,45,0,24,11,13
2020,136950,45,5,24,11,13
2020,137032,0,0,130,71,59
2020,137032,10,0,130,71,59
2020,137032,10,1,22,13,9
2020,137032,10,2,48,32,16
2020,137032,10,3,41,21,20
2020,137032,10,4,19,5,14
2020,137032,20,0,71,42,29
2020,137032,20,1,21,12,9
2020,137032,20,2,39,26,13
2020,137032,20,3,11,4,7
2020,137032,30,0,26,15,11
2020,137032,30,2,7,4,3
2020,137032,30,3,19,11,8
2020,137032,40,0,33,14,19
2020,137032,40,1,1,1,0
2020,137032,40,2,2,2,0
2020,137032,40,3,11,6,5
2020,137032,40,4,19,5,14
2020,137032,42,0,33,14,19
2020,137032,42,1,1,1,0
2020,137032,42,2,2,2,0
2020,137032,42,3,11,6,5
2020,137032,42,4,19,5,14
2020,137078,0,0,329,138,191
2020,137078,10,0,329,138,191
2020,137078,10,6,329,138,191
2020,137078,20,0,261,121,140
2020,137078,20,6,261,121,140
2020,137078,30,0,68,17,51
2020,137078,30,6,68,17,51
2020,137096,0,0,248,109,139
2020,137096,10,0,248,109,139
2020,137096,10,6,248,109,139
2020,137096,20,0,164,70,94
2020,137096,20,6,164,70,94
2020,137096,30,0,84,39,45
2020,137096,30,6,84,39,45
2020,137209,0,0,207,79,128
2020,137209,10,0,207,79,128
2020,137209,10,6,207,79,128
2020,137209,20,0,144,54,90
2020,137209,20,6,144,54,90
2020,137209,30,0,63,25,38
2020,137209,30,6,63,25,38
2020,137272,0,0,6,3,3
2020,137272,10,0,6,3,3
2020,137272,10,1,6,3,3
2020,137272,40,0,6,3,3
2020,137272,40,1,6,3,3
2020,137272,42,0,6,3,3
2020,137272,42,1,6,3,3
2020,137281,0,0,141,68,73
2020,137281,10,0,141,68,73
2020,137281,10,1,22,10,12
2020,137281,10,4,104,52,52
2020,137281,10,6,15,6,9
2020,137281,20,0,62,34,28
2020,137281,20,1,22,10,12
2020,137281,20,4,36,22,14
2020,137281,20,6,4,2,2
2020,137281,30,0,72,32,40
2020,137281,30,4,67,30,37
2020,137281,30,6,5,2,3
2020,137281,40,0,7,2,5
2020,137281,40,4,1,0,1
2020,137281,40,6,6,2,4
2020,137281,42,0,7,2,5
2020,137281,42,4,1,0,1
2020,137281,42,6,6,2,4
2020,137315,0,0,66,21,45
2020,137315,10,0,66,21,45
2020,137315,10,4,66,21,45
2020,137315,20,0,42,16,26
2020,137315,20,4,42,16,26
2020,137315,30,0,24,5,19
2020,137315,30,4,24,5,19
2020,137351,0,0,2046,1103,943
2020,137351,10,0,2046,1103,943
2020,137351,10,1,511,358,153
2020,137351,10,2,534,290,244
2020,137351,10,3,512,249,263
2020,137351,10,4,455,187,268
2020,137351,10,6,34,19,15
2020,137351,20,0,853,543,310
2020,137351,20,1,451,317,134
2020,137351,20,2,402,226,176
2020,137351,30,0,215,113,102
2020,137351,30,1,10,8,2
2020,137351,30,2,20,9,11
2020,137351,30,3,185,96,89
2020,137351,40,0,978,447,531
2020,137351,40,1,50,33,17
2020,137351,40,2,112,55,57
2020,137351,40,3,327,153,174
2020,137351,40,4,455,187,268
2020,137351,40,6,34,19,15
2020,137351,42,0,956,433,523
2020,137351,42,1,50,33,17
2020,137351,42,2,112,55,57
2020,137351,42,3,327,153,174
2020,137351,42,4,455,187,268
2020,137351,42,6,12,5,7
2020,137351,43,0,22,14,8
2020,137351,43,6,22,14,8
2020,137476,0,0,78,41,37
2020,137476,10,0,78,41,37
2020,137476,10,1,30,23,7
2020,137476,10,2,19,7,12
2020,137476,10,3,22,9,13
2020,137476,10,4,5,1,4
2020,137476,10,5,2,1,1
2020,137476,20,0,17,12,5
2020,137476,20,1,17,12,5
2020,137476,30,0,1,1,0
2020,137476,30,3,1,1,0
2020,137476,40,0,60,28,32
2020,137476,40,1,13,11,2
2020,137476,40,2,19,7,12
2020,137476,40,3,21,8,13
2020,137476,40,4,5,1,4
2020,137476,40,5,2,1,1
2020,137476,41,0,28,16,12
2020,137476,41,1,12,10,2
2020,137476,41,2,16,6,10
2020,137476,42,0,32,12,20
2020,137476,42,1,1,1,0
2020,137476,42,2,3,1,2
2020,137476,42,3,21,8,13
2020,137476,42,4,5,1,4
2020,137476,42,5,2,1,1
2020,137476,44,0,28,16,12
2020,137476,44,1,12,10,2
2020,137476,44,2,16,6,10
2020,137546,0,0,278,136,142
2020,137546,10,0,278,136,142
2020,137546,10,1,103,56,47
2020,137546,10,2,67,35,32
2020,137546,10,3,60,27,33
2020,137546,10,6,48,18,30
2020,137546,20,0,166,89,77
2020,137546,20,1,101,54,47
2020,137546,20,2,65,35,30
2020,137546,30,0,54,24,30
2020,137546,30,2,2,0,2
2020,137546,30,3,52,24,28
2020,137546,40,0,58,23,35
2020,137546,40,1,2,2,0
2020,137546,40,3,8,3,5
2020,137546,40,6,48,18,30
2020,137546,43,0,58,23,35
2020,137546,43,1,2,2,0
2020,137546,43,3,8,3,5
2020,137546,43,6,48,18,30
2020,137564,0,0,122,63,59
2020,137564,10,0,122,63,59
2020,137564,10,1,36,27,9
2020,137564,10,2,37,17,20
2020,137564,10,3,40,17,23
2020,137564,10,4,6,1,5
2020,137564,10,5,3,1,2
2020,137564,40,0,122,63,59
2020,137564,40,1,36,27,9
2020,137564,40,2,37,17,20
2020,137564,40,3,40,17,23
2020,137564,40,4,6,1,5
2020,137564,40,5,3,1,2
2020,137564,41,0,66,40,26
2020,137564,41,1,34,25,9
2020,137564,41,2,22,11,11
2020,137564,41,3,7,2,5
2020,137564,41,4,1,1,0
2020,137564,41,5,2,1,1
2020,137564,42,0,56,23,33
2020,137564,42,1,2,2,0
2020,137564,42,2,15,6,9
2020,137564,42,3,33,15,18
2020,137564,42,4,5,0,5
2020,137564,42,5,1,0,1
2020,137564,44,0,66,40,26
2020,137564,44,1,34,25,9
2020,137564,44,2,22,11,11
2020,137564,44,3,7,2,5
2020,137564,44,4,1,1,0
2020,137564,44,5,2,1,1
2020,137759,0,0,205,75,130
2020,137759,10,0,162,62,100
2020,137759,10,1,75,30,45
2020,137759,10,2,47,19,28
2020,137759,10,3,25,7,18
2020,137759,10,6,15,6,9
2020,137759,20,0,119,48,71
2020,137759,20,1,75,30,45
2020,137759,20,2,44,18,26
2020,137759,30,0,7,1,6
2020,137759,30,3,1,0,1
2020,137759,30,6,6,1,5
2020,137759,40,0,36,13,23
2020,137759,40,2,3,1,2
2020,137759,40,3,24,7,17
2020,137759,40,6,9,5,4
2020,137759,42,0,36,13,23
2020,137759,42,2,3,1,2
2020,137759,42,3,24,7,17
2020,137759,42,6,9,5,4
2020,137759,50,0,43,13,30
2020,137777,0,0,9,9,0
2020,137777,10,0,7,7,0
2020,137777,10,1,6,6,0
2020,137777,10,2,1,1,0
2020,137777,40,0,7,7,0
2020,137777,40,1,6,6,0
2020,137777,40,2,1,1,0
2020,137777,41,0,7,7,0
2020,137777,41,1,6,6,0
2020,137777,41,2,1,1,0
2020,137777,45,0,7,7,0
2020,137777,45,1,6,6,0
2020,137777,45,2,1,1,0
2020,137777,50,0,2,2,0
2020,137801,0,0,12,10,2
2020,137801,10,0,12,10,2
2020,137801,10,4,12,10,2
2020,137801,40,0,12,10,2
2020,137801,40,4,12,10,2
2020,137801,41,0,12,10,2
2020,137801,41,4,12,10,2
2020,137801,45,0,12,10,2
2020,137801,45,4,12,10,2
2020,137847,0,0,390,205,185
2020,137847,10,0,390,205,185
2020,137847,10,1,44,30,14
2020,137847,10,2,133,82,51
2020,137847,10,3,113,53,60
2020,137847,10,4,63,26,37
2020,137847,10,5,37,14,23
2020,137847,20,0,137,85,52
2020,137847,20,1,43,29,14
2020,137847,20,2,92,55,37
2020,137847,20,3,2,1,1
2020,137847,30,0,128,69,59
2020,137847,30,2,37,25,12
2020,137847,30,3,90,43,47
2020,137847,30,4,1,1,0
2020,137847,40,0,125,51,74
2020,137847,40,1,1,1,0
2020,137847,40,2,4,2,2
2020,137847,40,3,21,9,12
2020,137847,40,4,62,25,37
2020,137847,40,5,37,14,23
2020,137847,42,0,125,51,74
2020,137847,42,1,1,1,0
2020,137847,42,2,4,2,2
2020,137847,42,3,21,9,12
2020,137847,42,4,62,25,37
2020,137847,42,5,37,14,23
2020,137953,0,0,11,8,3
2020,137953,10,0,11,8,3
2020,137953,10,1,6,5,1
2020,137953,10,2,5,3,2
2020,137953,40,0,11,8,3
2020,137953,40,1,6,5,1
2020,137953,40,2,5,3,2
2020,137953,42,0,11,8,3
2020,137953,42,1,6,5,1
2020,137953,42,2,5,3,2
2020,137962,0,0,9,4,5
2020,137962,10,0,9,4,5
2020,137962,10,1,4,3,1
2020,137962,10,2,1,1,0
2020,137962,10,3,4,0,4
2020,137962,40,0,9,4,5
2020,137962,40,1,4,3,1
2020,137962,40,2,1,1,0
2020,137962,40,3,4,0,4
2020,137962,42,0,9,4,5
2020,137962,42,1,4,3,1
2020,137962,42,2,1,1,0
2020,137962,42,3,4,0,4
2020,138187,0,0,607,262,345
2020,138187,10,0,607,262,345
2020,138187,10,6,607,262,345
2020,138187,20,0,340,151,189
2020,138187,20,6,340,151,189
2020,138187,30,0,114,39,75
2020,138187,30,6,114,39,75
2020,138187,40,0,153,72,81
2020,138187,40,6,153,72,81
2020,138187,42,0,93,50,43
2020,138187,42,6,93,50,43
2020,138187,43,0,60,22,38
2020,138187,43,6,60,22,38
2020,138275,0,0,34,21,13
2020,138275,10,0,34,21,13
2020,138275,10,1,6,3,3
2020,138275,10,2,13,7,6
2020,138275,10,3,12,11,1
2020,138275,10,4,3,0,3
2020,138275,40,0,34,21,13
2020,138275,40,1,6,3,3
2020,138275,40,2,13,7,6
2020,138275,40,3,12,11,1
2020,138275,40,4,3,0,3
2020,138275,42,0,34,21,13
2020,138275,42,1,6,3,3
2020,138275,42,2,13,7,6
2020,138275,42,3,12,11,1
2020,138275,42,4,3,0,3
2020,138293,0,0,25,11,14
2020,138293,10,0,25,11,14
2020,138293,10,1,4,3,1
2020,138293,10,2,4,3,1
2020,138293,10,3,17,5,12
2020,138293,40,0,25,11,14
2020,138293,40,1,4,3,1
2020,138293,40,2,4,3,1
2020,138293,40,3,17,5,12
2020,138293,42,0,25,11,14
2020,138293,42,1,4,3,1
2020,138293,42,2,4,3,1
2020,138293,42,3,17,5,12
2020,138309,0,0,124,20,104
2020,138309,10,0,124,20,104
2020,138309,10,4,124,20,104
2020,138309,40,0,124,20,104
2020,138309,40,4,124,20,104
2020,138309,41,0,124,20,104
2020,138309,41,4,124,20,104
2020,138309,45,0,124,20,104
2020,138309,45,4,124,20,104
2020,138354,0,0,339,179,160
2020,138354,10,0,339,179,160
2020,138354,10,1,80,55,25
2020,138354,10,2,68,37,31
2020,138354,10,3,106,53,53
2020,138354,10,4,54,20,34
2020,138354,10,5,31,14,17
2020,138354,20,0,148,90,58
2020,138354,20,1,79,54,25
2020,138354,20,2,65,35,30
2020,138354,20,3,4,1,3
2020,138354,30,0,71,45,26
2020,138354,30,2,2,2,0
2020,138354,30,3,69,43,26
2020,138354,40,0,120,44,76
2020,138354,40,1,1,1,0
2020,138354,40,2,1,0,1
2020,138354,40,3,33,9,24
2020,138354,40,4,54,20,34
2020,138354,40,5,31,14,17
2020,138354,41,0,45,15,30
2020,138354,41,1,1,1,0
2020,138354,41,2,1,0,1
2020,138354,41,3,3,1,2
2020,138354,41,4,30,8,22
2020,138354,41,5,10,5,5
2020,138354,42,0,18,4,14
2020,138354,42,3,10,2,8
2020,138354,42,4,4,1,3
2020,138354,42,5,4,1,3
2020,138354,43,0,57,25,32
2020,138354,43,3,20,6,14
2020,138354,43,4,20,11,9
2020,138354,43,5,17,8,9
2020,138354,44,0,45,15,30
2020,138354,44,1,1,1,0
2020,138354,44,2,1,0,1
2020,138354,44,3,3,1,2
2020,138354,44,4,30,8,22
2020,138354,44,5,10,5,5
2020,138558,0,0,143,75,68
2020,138558,10,0,143,75,68
2020,138558,10,1,26,18,8
2020,138558,10,2,38,18,20
2020,138558,10,3,47,29,18
2020,138558,10,4,4,2,2
2020,138558,10,5,27,8,19
2020,138558,10,6,1,0,1
2020,138558,20,0,75,42,33
2020,138558,20,1,26,18,8
2020,138558,20,2,34,16,18
2020,138558,20,3,15,8,7
2020,138558,30,0,36,23,13
2020,138558,30,2,4,2,2
2020,138558,30,3,32,21,11
2020,138558,40,0,32,10,22
2020,138558,40,4,4,2,2
2020,138558,40,5,27,8,19
2020,138558,40,6,1,0,1
2020,138558,42,0,32,10,22
2020,138558,42,4,4,2,2
2020,138558,42,5,27,8,19
2020,138558,42,6,1,0,1
2020,138600,0,0,87,24,63
2020,138600,10,0,87,24,63
2020,138600,10,1,40,17,23
2020,138600,10,2,20,4,16
2020,138600,10,3,14,1,13
2020,138600,10,4,12,2,10
2020,138600,10,6,1,0,1
2020,138600,20,0,58,21,37
2020,138600,20,1,40,17,23
2020,138600,20,2,18,4,14
2020,138600,30,0,16,1,15
2020,138600,30,2,2,0,2
2020,138600,30,3,14,1,13
2020,138600,40,0,13,2,11
2020,138600,40,4,12,2,10
2020,138600,40,6,1,0,1
2020,138600,42,0,13,2,11
2020,138600,42,4,12,2,10
2020,138600,42,6,1,0,1
2020,138655,0,0,5,4,1
2020,138655,10,0,5,4,1
2020,138655,10,4,5,4,1
2020,138655,40,0,5,4,1
2020,138655,40,4,5,4,1
2020,138655,41,0,5,4,1
2020,138655,41,4,5,4,1
2020,138655,45,0,5,4,1
2020,138655,45,4,5,4,1
2020,138682,0,0,81,29,52
2020,138682,10,0,73,26,47
2020,138682,10,4,73,26,47
2020,138682,40,0,73,26,47
2020,138682,40,4,73,26,47
2020,138682,42,0,62,20,42
2020,138682,42,4,62,20,42
2020,138682,43,0,11,6,5
2020,138682,43,4,11,6,5
2020,138682,50,0,8,3,5
2020,138716,0,0,203,93,110
2020,138716,10,0,203,93,110
2020,138716,10,1,47,30,17
2020,138716,10,2,50,28,22
2020,138716,10,3,60,23,37
2020,138716,10,4,35,8,27
2020,138716,10,5,11,4,7
2020,138716,20,0,92,60,32
2020,138716,20,1,46,30,16
2020,138716,20,2,41,25,16
2020,138716,20,3,5,5,0
2020,138716,30,0,39,16,23
2020,138716,30,2,7,2,5
2020,138716,30,3,32,14,18
2020,138716,40,0,72,17,55
2020,138716,40,1,1,0,1
2020,138716,40,2,2,1,1
2020,138716,40,3,23,4,19
2020,138716,40,4,35,8,27
2020,138716,40,5,11,4,7
2020,138716,42,0,72,17,55
2020,138716,42,1,1,0,1
2020,138716,42,2,2,1,1
2020,138716,42,3,23,4,19
2020,138716,42,4,35,8,27
2020,138716,42,5,11,4,7
2020,138761,0,0,26,10,16
2020,138761,10,0,26,10,16
2020,138761,10,1,1,0,1
2020,138761,10,2,8,5,3
2020,138761,10,3,16,5,11
2020,138761,10,4,1,0,1
2020,138761,20,0,3,1,2
2020,138761,20,1,1,0,1
2020,138761,20,2,2,1,1
2020,138761,30,0,14,6,8
2020,138761,30,2,6,4,2
2020,138761,30,3,8,2,6
2020,138761,40,0,9,3,6
2020,138761,40,3,8,3,5
2020,138761,40,4,1,0,1
2020,138761,42,0,3,0,3
2020,138761,42,3,2,0,2
2020,138761,42,4,1,0,1
2020,138761,43,0,6,3,3
2020,138761,43,3,6,3,3
2020,138813,0,0,8,5,3
2020,138813,10,0,8,5,3
2020,138813,10,4,8,5,3
2020,138813,40,0,8,5,3
2020,138813,40,4,8,5,3
2020,138813,41,0,8,5,3
2020,138813,41,4,8,5,3
2020,138813,45,0,8,5,3
2020,138813,45,4,8,5,3
2020,138840,0,0,98,49,49
2020,138840,10,0,98,49,49
2020,138840,10,4,98,49,49
2020,138840,40,0,98,49,49
2020,138840,40,4,98,49,49
2020,138840,41,0,95,47,48
2020,138840,41,4,95,47,48
2020,138840,42,0,3,2,1
2020,138840,42,4,3,2,1
2020,138840,45,0,95,47,48
2020,138840,45,4,95,47,48
2020,138868,0,0,45,21,24
2020,138868,10,0,45,21,24
2020,138868,10,1,16,10,6
2020,138868,10,2,7,1,6
2020,138868,10,3,2,1,1
2020,138868,10,4,20,9,11
2020,138868,40,0,45,21,24
2020,138868,40,1,16,10,6
2020,138868,40,2,7,1,6
2020,138868,40,3,2,1,1
2020,138868,40,4,20,9,11
2020,138868,42,0,45,21,24
2020,138868,42,1,16,10,6
2020,138868,42,2,7,1,6
2020,138868,42,3,2,1,1
2020,138868,42,4,20,9,11
2020,138901,0,0,42,21,21
2020,138901,10,0,42,21,21
2020,138901,10,1,5,3,2
2020,138901,10,2,10,6,4
2020,138901,10,3,11,5,6
2020,138901,10,4,8,5,3
2020,138901,10,5,4,1,3
2020,138901,10,6,4,1,3
2020,138901,20,0,14,7,7
2020,138901,20,1,4,2,2
2020,138901,20,2,9,5,4
2020,138901,20,3,1,0,1
2020,138901,30,0,8,5,3
2020,138901,30,1,1,1,0
2020,138901,30,2,1,1,0
2020,138901,30,3,6,3,3
2020,138901,40,0,20,9,11
2020,138901,40,3,4,2,2
2020,138901,40,4,8,5,3
2020,138901,40,5,4,1,3
2020,138901,40,6,4,1,3
2020,138901,42,0,20,9,11
2020,138901,42,3,4,2,2
2020,138901,42,4,8,5,3
2020,138901,42,5,4,1,3
2020,138901,42,6,4,1,3
2020,138929,0,0,17,8,9
2020,138929,10,0,15,8,7
2020,138929,10,1,6,5,1
2020,138929,10,2,9,3,6
2020,138929,20,0,14,7,7
2020,138929,20,1,6,5,1
2020,138929,20,2,8,2,6
2020,138929,40,0,1,1,0
2020,138929,40,2,1,1,0
2020,138929,42,0,1,1,0
2020,138929,42,2,1,1,0
2020,138929,50,0,2,0,2
2020,138947,0,0,177,95,82
2020,138947,10,0,177,95,82
2020,138947,10,1,46,37,9
2020,138947,10,2,75,40,35
2020,138947,10,3,28,8,20
2020,138947,10,4,12,5,7
2020,138947,10,5,10,4,6
2020,138947,10,6,6,1,5
2020,138947,20,0,120,75,45
2020,138947,20,1,46,37,9
2020,138947,20,2,69,37,32
2020,138947,20,3,5,1,4
2020,138947,30,0,30,11,19
2020,138947,30,2,6,3,3
2020,138947,30,3,21,7,14
2020,138947,30,5,3,1,2
2020,138947,40,0,27,9,18
2020,138947,40,3,2,0,2
2020,138947,40,4,12,5,7
2020,138947,40,5,7,3,4
2020,138947,40,6,6,1,5
2020,138947,43,0,27,9,18
2020,138947,43,3,2,0,2
2020,138947,43,4,12,5,7
2020,138947,43,5,7,3,4
2020,138947,43,6,6,1,5
2020,138956,0,0,127,51,76
2020,138956,10,0,127,51,76
2020,138956,10,6,127,51,76
2020,138956,40,0,127,51,76
2020,138956,40,6,127,51,76
2020,138956,42,0,127,51,76
2020,138956,42,6,127,51,76
2020,139144,0,0,159,87,72
2020,139144,10,0,159,87,72
2020,139144,10,1,40,28,12
2020,139144,10,2,49,28,21
2020,139144,10,3,51,24,27
2020,139144,10,4,8,4,4
2020,139144,10,5,11,3,8
2020,139144,20,0,86,54,32
2020,139144,20,1,39,27,12
2020,139144,20,2,46,26,20
2020,139144,20,3,1,1,0
2020,139144,30,0,35,16,19
2020,139144,30,1,1,1,0
2020,139144,30,3,34,15,19
2020,139144,40,0,38,17,21
2020,139144,40,2,3,2,1
2020,139144,40,3,16,8,8
2020,139144,40,4,8,4,4
2020,139144,40,5,11,3,8
2020,139144,43,0,38,17,21
2020,139144,43,2,3,2,1
2020,139144,43,3,16,8,8
2020,139144,43,4,8,4,4
2020,139144,43,5,11,3,8
2020,139153,0,0,8,5,3
2020,139153,10,0,8,5,3
2020,139153,10,4,8,5,3
2020,139153,40,0,8,5,3
2020,139153,40,4,8,5,3
2020,139153,42,0,8,5,3
2020,139153,42,4,8,5,3
2020,139199,0,0,146,40,106
2020,139199,10,0,146,40,106
2020,139199,10,1,21,7,14
2020,139199,10,2,53,18,35
2020,139199,10,3,64,14,50
2020,139199,10,4,8,1,7
2020,139199,40,0,146,40,106
2020,139199,40,1,21,7,14
2020,139199,40,2,53,18,35
2020,139199,40,3,64,14,50
2020,139199,40,4,8,1,7
2020,139199,41,0,70,21,49
2020,139199,41,1,21,7,14
2020,139199,41,2,33,11,22
2020,139199,41,3,15,3,12
2020,139199,41,4,1,0,1
2020,139199,42,0,68,17,51
2020,139199,42,2,19,7,12
2020,139199,42,3,48,10,38
2020,139199,42,4,1,0,1
2020,139199,43,0,8,2,6
2020,139199,43,2,1,0,1
2020,139199,43,3,1,1,0
2020,139199,43,4,6,1,5
2020,139199,44,0,70,21,49
2020,139199,44,1,21,7,14
2020,139199,44,2,33,11,22
2020,139199,44,3,15,3,12
2020,139199,44,4,1,0,1
2020,139205,0,0,27,17,10
2020,139205,10,0,27,17,10
2020,139205,10,1,3,2,1
2020,139205,10,2,8,4,4
2020,139205,10,3,15,10,5
2020,139205,10,4,1,1,0
2020,139205,40,0,27,17,10
2020,139205,40,1,3,2,1
2020,139205,40,2,8,4,4
2020,139205,40,3,15,10,5
2020,139205,40,4,1,1,0
2020,139205,41,0,2,1,1
2020,139205,41,1,1,1,0
2020,139205,41,3,1,0,1
2020,139205,42,0,24,15,9
2020,139205,42,1,2,1,1
2020,139205,42,2,8,4,4
2020,139205,42,3,14,10,4
2020,139205,43,0,1,1,0
2020,139205,43,4,1,1,0
2020,139205,44,0,2,1,1
2020,139205,44,1,1,1,0
2020,139205,44,3,1,0,1
2020,139250,0,0,102,44,58
2020,139250,10,0,102,44,58
2020,139250,10,1,10,4,6
2020,139250,10,2,28,14,14
2020,139250,10,3,43,17,26
2020,139250,10,4,6,3,3
2020,139250,10,5,14,5,9
2020,139250,10,6,1,1,0
2020,139250,20,0,30,14,16
2020,139250,20,1,8,3,5
2020,139250,20,2,22,11,11
2020,139250,30,0,45,17,28
2020,139250,30,1,1,0,1
2020,139250,30,2,4,2,2
2020,139250,30,3,40,15,25
2020,139250,40,0,27,13,14
2020,139250,40,1,1,1,0
2020,139250,40,2,2,1,1
2020,139250,40,3,3,2,1
2020,139250,40,4,6,3,3
2020,139250,40,5,14,5,9
2020,139250,40,6,1,1,0
2020,139250,42,0,27,13,14
2020,139250,42,1,1,1,0
2020,139250,42,2,2,1,1
2020,139250,42,3,3,2,1
2020,139250,42,4,6,3,3
2020,139250,42,5,14,5,9
2020,139250,42,6,1,1,0
2020,139278,0,0,129,47,82
2020,139278,10,0,129,47,82
2020,139278,10,4,129,47,82
2020,139278,40,0,129,47,82
2020,139278,40,4,129,47,82
2020,139278,42,0,117,46,71
2020,139278,42,4,117,46,71
2020,139278,43,0,12,1,11
2020,139278,43,4,12,1,11
2020,139311,0,0,207,95,112
2020,139311,10,0,207,95,112
2020,139311,10,1,61,34,27
2020,139311,10,2,60,30,30
2020,139311,10,3,33,14,19
2020,139311,10,4,9,0,9
2020,139311,10,5,44,17,27
2020,139311,20,0,115,61,54
2020,139311,20,1,60,33,27
2020,139311,20,2,55,28,27
2020,139311,30,0,32,15,17
2020,139311,30,2,5,2,3
2020,139311,30,3,27,13,14
2020,139311,40,0,60,19,41
2020,139311,40,1,1,1,0
2020,139311,40,3,6,1,5
2020,139311,40,4,9,0,9
2020,139311,40,5,44,17,27
2020,139311,42,0,60,19,41
2020,139311,42,1,1,1,0
2020,139311,42,3,6,1,5
2020,139311,42,4,9,0,9
2020,139311,42,5,44,17,27
2020,139348,0,0,22,11,11
2020,139348,10,0,22,11,11
2020,139348,10,1,9,3,6
2020,139348,10,2,7,5,2
2020,139348,10,3,5,2,3
2020,139348,10,5,1,1,0
2020,139348,20,0,16,8,8
2020,139348,20,1,9,3,6
2020,139348,20,2,7,5,2
2020,139348,30,0,5,2,3
2020,139348,30,3,5,2,3
2020,139348,40,0,1,1,0
2020,139348,40,5,1,1,0
2020,139348,41,0,1,1,0
2020,139348,41,5,1,1,0
2020,139348,44,0,1,1,0
2020,139348,44,5,1,1,0
2020,139357,0,0,94,31,63
2020,139357,10,0,94,31,63
2020,139357,10,4,94,31,63
2020,139357,40,0,94,31,63
2020,139357,40,4,94,31,63
2020,139357,41,0,94,31,63
2020,139357,41,4,94,31,63
2020,139357,45,0,94,31,63
2020,139357,45,4,94,31,63
2020,139366,0,0,331,167,164
2020,139366,10,0,331,167,164
2020,139366,10,1,97,62,35
2020,139366,10,2,75,42,33
2020,139366,10,3,93,39,54
2020,139366,10,4,23,7,16
2020,139366,10,5,43,17,26
2020,139366,20,0,167,102,65
2020,139366,20,1,96,61,35
2020,139366,20,2,68,40,28
2020,139366,20,3,3,1,2
2020,139366,30,0,90,39,51
2020,139366,30,1,1,1,0
2020,139366,30,2,6,2,4
2020,139366,30,3,83,36,47
2020,139366,40,0,74,26,48
2020,139366,40,2,1,0,1
2020,139366,40,3,7,2,5
2020,139366,40,4,23,7,16
2020,139366,40,5,43,17,26
2020,139366,41,0,1,0,1
2020,139366,41,4,1,0,1
2020,139366,42,0,73,26,47
2020,139366,42,2,1,0,1
2020,139366,42,3,7,2,5
2020,139366,42,4,22,7,15
2020,139366,42,5,43,17,26
2020,139366,45,0,1,0,1
2020,139366,45,4,1,0,1
2020,139384,0,0,118,52,66
2020,139384,50,0,118,52,66
2020,139393,0,0,58,42,16
2020,139393,10,0,58,42,16
2020,139393,10,1,33,29,4
2020,139393,10,2,14,6,8
2020,139393,10,3,11,7,4
2020,139393,20,0,33,25,8
2020,139393,20,1,28,24,4
2020,139393,20,2,5,1,4
2020,139393,30,0,25,17,8
2020,139393,30,1,5,5,0
2020,139393,30,2,9,5,4
2020,139393,30,3,11,7,4
2020,139463,0,0,159,71,88
2020,139463,10,0,159,71,88
2020,139463,10,1,29,16,13
2020,139463,10,2,61,27,34
2020,139463,10,3,51,22,29
2020,139463,10,4,3,0,3
2020,139463,10,5,15,6,9
2020,139463,20,0,93,43,50
2020,139463,20,1,29,16,13
2020,139463,20,2,59,27,32
2020,139463,20,3,5,0,5
2020,139463,30,0,47,22,25
2020,139463,30,2,2,0,2
2020,139463,30,3,44,21,23
2020,139463,30,5,1,1,0
2020,139463,40,0,19,6,13
2020,139463,40,3,2,1,1
2020,139463,40,4,3,0,3
2020,139463,40,5,14,5,9
2020,139463,42,0,19,6,13
2020,139463,42,3,2,1,1
2020,139463,42,4,3,0,3
2020,139463,42,5,14,5,9
2020,139579,0,0,36,14,22
2020,139579,10,0,36,14,22
2020,139579,10,1,3,3,0
2020,139579,10,2,4,1,3
2020,139579,10,3,24,10,14
2020,139579,10,4,5,0,5
2020,139579,40,0,36,14,22
2020,139579,40,1,3,3,0
2020,139579,40,2,4,1,3
2020,139579,40,3,24,10,14
2020,139579,40,4,5,0,5
2020,139579,41,0,36,14,22
2020,139579,41,1,3,3,0
2020,139579,41,2,4,1,3
2020,139579,41,3,24,10,14
2020,139579,41,4,5,0,5
2020,139579,45,0,36,14,22
2020,139579,45,1,3,3,0
2020,139579,45,2,4,1,3
2020,139579,45,3,24,10,14
2020,139579,45,4,5,0,5
2020,139621,0,0,69,36,33
2020,139621,10,0,69,36,33
2020,139621,10,1,17,10,7
2020,139621,10,2,29,13,16
2020,139621,10,3,14,9,5
2020,139621,10,4,9,4,5
2020,139621,20,0,47,24,23
2020,139621,20,1,17,10,7
2020,139621,20,2,28,12,16
2020,139621,20,3,2,2,0
2020,139621,30,0,18,9,9
2020,139621,30,2,1,1,0
2020,139621,30,3,12,7,5
2020,139621,30,4,5,1,4
2020,139621,40,0,4,3,1
2020,139621,40,4,4,3,1
2020,139621,42,0,4,3,1
2020,139621,42,4,4,3,1
2020,139630,0,0,46,24,22
2020,139630,10,0,46,24,22
2020,139630,10,1,15,8,7
2020,139630,10,2,10,4,6
2020,139630,10,3,19,11,8
2020,139630,10,4,2,1,1
2020,139630,40,0,46,24,22
2020,139630,40,1,15,8,7
2020,139630,40,2,10,4,6
2020,139630,40,3,19,11,8
2020,139630,40,4,2,1,1
2020,139630,42,0,46,24,22
2020,139630,42,1,15,8,7
2020,139630,42,2,10,4,6
2020,139630,42,3,19,11,8
2020,139630,42,4,2,1,1
2020,139658,0,0,2037,1188,849
2020,139658,10,0,2029,1187,842
2020,139658,10,1,721,507,214
2020,139658,10,2,506,293,213
2020,139658,10,3,591,305,286
2020,139658,10,4,85,27,58
2020,139658,10,5,126,55,71
2020,139658,20,0,742,501,241
2020,139658,20,1,502,365,137
2020,139658,20,2,240,136,104
2020,139658,30,0,257,128,129
2020,139658,30,1,7,3,4
2020,139658,30,2,20,10,10
2020,139658,30,3,230,115,115
2020,139658,40,0,1030,558,472
2020,139658,40,1,212,139,73
2020,139658,40,2,246,147,99
2020,139658,40,3,361,190,171
2020,139658,40,4,85,27,58
2020,139658,40,5,126,55,71
2020,139658,41,0,191,92,99
2020,139658,41,1,42,23,19
2020,139658,41,2,19,12,7
2020,139658,41,3,9,6,3
2020,139658,41,4,1,0,1
2020,139658,41,5,120,51,69
2020,139658,42,0,829,463,366
2020,139658,42,1,170,116,54
2020,139658,42,2,227,135,92
2020,139658,42,3,349,182,167
2020,139658,42,4,78,27,51
2020,139658,42,5,5,3,2
2020,139658,43,0,10,3,7
2020,139658,43,3,3,2,1
2020,139658,43,4,6,0,6
2020,139658,43,5,1,1,0
2020,139658,44,0,191,92,99
2020,139658,44,1,42,23,19
2020,139658,44,2,19,12,7
2020,139658,44,3,9,6,3
2020,139658,44,4,1,0,1
2020,139658,44,5,120,51,69
2020,139658,50,0,8,1,7
2020,139700,0,0,128,59,69
2020,139700,10,0,127,58,69
2020,139700,10,1,32,18,14
2020,139700,10,2,32,15,17
2020,139700,10,3,35,13,22
2020,139700,10,4,28,12,16
2020,139700,20,0,68,36,32
2020,139700,20,1,32,18,14
2020,139700,20,2,28,14,14
2020,139700,20,3,8,4,4
2020,139700,30,0,27,8,19
2020,139700,30,2,4,1,3
2020,139700,30,3,23,7,16
2020,139700,40,0,32,14,18
2020,139700,40,3,4,2,2
2020,139700,40,4,28,12,16
2020,139700,41,0,1,0,1
2020,139700,41,4,1,0,1
2020,139700,42,0,31,14,17
2020,139700,42,3,4,2,2
2020,139700,42,4,27,12,15
2020,139700,45,0,1,0,1
2020,139700,45,4,1,0,1
2020,139700,50,0,1,1,0
2020,139719,0,0,96,56,40
2020,139719,10,0,96,56,40
2020,139719,10,1,26,24,2
2020,139719,10,2,31,17,14
2020,139719,10,3,28,11,17
2020,139719,10,4,3,0,3
2020,139719,10,5,7,3,4
2020,139719,10,6,1,1,0
2020,139719,20,0,55,39,16
2020,139719,20,1,25,23,2
2020,139719,20,2,27,13,14
2020,139719,20,3,3,3,0
2020,139719,30,0,19,7,12
2020,139719,30,3,19,7,12
2020,139719,40,0,22,10,12
2020,139719,40,1,1,1,0
2020,139719,40,2,4,4,0
2020,139719,40,3,6,1,5
2020,139719,40,4,3,0,3
2020,139719,40,5,7,3,4
2020,139719,40,6,1,1,0
2020,139719,42,0,22,10,12
2020,139719,42,1,1,1,0
2020,139719,42,2,4,4,0
2020,139719,42,3,6,1,5
2020,139719,42,4,3,0,3
2020,139719,42,5,7,3,4
2020,139719,42,6,1,1,0
2020,139755,0,0,1122,783,339
2020,139755,10,0,930,674,256
2020,139755,10,1,411,343,68
2020,139755,10,2,258,180,78
2020,139755,10,3,170,104,66
2020,139755,10,5,81,44,37
2020,139755,10,6,10,3,7
2020,139755,20,0,662,517,145
2020,139755,20,1,407,339,68
2020,139755,20,2,247,174,73
2020,139755,20,3,7,4,3
2020,139755,20,6,1,0,1
2020,139755,30,0,179,111,68
2020,139755,30,1,4,4,0
2020,139755,30,2,11,6,5
2020,139755,30,3,163,100,63
2020,139755,30,6,1,1,0
2020,139755,40,0,89,46,43
2020,139755,40,5,81,44,37
2020,139755,40,6,8,2,6
2020,139755,41,0,2,2,0
2020,139755,41,5,2,2,0
2020,139755,42,0,87,44,43
2020,139755,42,5,79,42,37
2020,139755,42,6,8,2,6
2020,139755,45,0,2,2,0
2020,139755,45,5,2,2,0
2020,139755,50,0,192,109,83
2020,139764,0,0,116,55,61
2020,139764,10,0,116,55,61
2020,139764,10,1,32,20,12
2020,139764,10,2,26,13,13
2020,139764,10,3,24,11,13
2020,139764,10,4,2,1,1
2020,139764,10,5,32,10,22
2020,139764,20,0,54,31,23
2020,139764,20,1,32,20,12
2020,139764,20,2,22,11,11
2020,139764,30,0,28,13,15
2020,139764,30,2,4,2,2
2020,139764,30,3,24,11,13
2020,139764,40,0,34,11,23
2020,139764,40,4,2,1,1
2020,139764,40,5,32,10,22
2020,139764,42,0,34,11,23
2020,139764,42,4,2,1,1
2020,139764,42,5,32,10,22
2020,139861,0,0,340,146,194
2020,139861,10,0,340,146,194
2020,139861,10,1,108,60,48
2020,139861,10,2,70,27,43
2020,139861,10,3,84,34,50
2020,139861,10,4,1,0,1
2020,139861,10,5,76,24,52
2020,139861,10,6,1,1,0
2020,139861,20,0,176,86,90
2020,139861,20,1,108,60,48
2020,139861,20,2,68,26,42
2020,139861,30,0,79,33,46
2020,139861,30,2,2,1,1
2020,139861,30,3,77,32,45
2020,139861,40,0,85,27,58
2020,139861,40,3,7,2,5
2020,139861,40,4,1,0,1
2020,139861,40,5,76,24,52
2020,139861,40,6,1,1,0
2020,139861,41,0,1,1,0
2020,139861,41,6,1,1,0
2020,139861,42,0,84,26,58
2020,139861,42,3,7,2,5
2020,139861,42,4,1,0,1
2020,139861,42,5,76,24,52
2020,139861,45,0,1,1,0
2020,139861,45,6,1,1,0
2020,139931,0,0,984,480,504
2020,139931,10,0,984,480,504
2020,139931,10,1,213,127,86
2020,139931,10,2,266,154,112
2020,139931,10,3,248,123,125
2020,139931,10,4,78,22,56
2020,139931,10,5,179,54,125
2020,139931,20,0,484,283,201
2020,139931,20,1,213,127,86
2020,139931,20,2,262,151,111
2020,139931,20,3,9,5,4
2020,139931,30,0,201,101,100
2020,139931,30,2,2,2,0
2020,139931,30,3,199,99,100
2020,139931,40,0,299,96,203
2020,139931,40,2,2,1,1
2020,139931,40,3,40,19,21
2020,139931,40,4,78,22,56
2020,139931,40,5,179,54,125
2020,139931,42,0,299,96,203
2020,139931,42,2,2,1,1
2020,139931,42,3,40,19,21
2020,139931,42,4,78,22,56
2020,139931,42,5,179,54,125
2020,139940,0,0,1222,624,598
2020,139940,10,0,1132,590,542
2020,139940,10,1,290,194,96
2020,139940,10,2,341,176,165
2020,139940,10,3,227,104,123
2020,139940,10,4,41,10,31
2020,139940,10,5,171,74,97
2020,139940,10,6,62,32,30
2020,139940,20,0,546,331,215
2020,139940,20,1,274,186,88
2020,139940,20,2,272,145,127
2020,139940,30,0,162,80,82
2020,139940,30,2,13,8,5
2020,139940,30,3,149,72,77
2020,139940,40,0,424,179,245
2020,139940,40,1,16,8,8
2020,139940,40,2,56,23,33
2020,139940,40,3,78,32,46
2020,139940,40,4,41,10,31
2020,139940,40,5,171,74,97
2020,139940,40,6,62,32,30
2020,139940,41,0,4,1,3
2020,139940,41,4,2,1,1
2020,139940,41,6,2,0,2
2020,139940,42,0,420,178,242
2020,139940,42,1,16,8,8
2020,139940,42,2,56,23,33
2020,139940,42,3,78,32,46
2020,139940,42,4,39,9,30
2020,139940,42,5,171,74,97
2020,139940,42,6,60,32,28
2020,139940,45,0,4,1,3
2020,139940,45,4,2,1,1
2020,139940,45,6,2,0,2
2020,139940,50,0,90,34,56
2020,139959,0,0,2140,1252,888
2020,139959,10,0,2140,1252,888
2020,139959,10,1,727,518,209
2020,139959,10,2,539,314,225
2020,139959,10,3,394,200,194
2020,139959,10,4,66,33,33
2020,139959,10,5,261,125,136
2020,139959,10,6,153,62,91
2020,139959,20,0,1244,822,422
2020,139959,20,1,724,516,208
2020,139959,20,2,519,305,214
2020,139959,20,3,1,1,0
2020,139959,30,0,392,194,198
2020,139959,30,1,2,1,1
2020,139959,30,2,20,9,11
2020,139959,30,3,369,184,185
2020,139959,30,6,1,0,1
2020,139959,40,0,504,236,268
2020,139959,40,1,1,1,0
2020,139959,40,3,24,15,9
2020,139959,40,4,66,33,33
2020,139959,40,5,261,125,136
2020,139959,40,6,152,62,90
2020,139959,41,0,5,4,1
2020,139959,41,3,1,0,1
2020,139959,41,4,1,1,0
2020,139959,41,6,3,3,0
2020,139959,42,0,499,232,267
2020,139959,42,1,1,1,0
2020,139959,42,3,23,15,8
2020,139959,42,4,65,32,33
2020,139959,42,5,261,125,136
2020,139959,42,6,149,59,90
2020,139959,45,0,5,4,1
2020,139959,45,3,1,0,1
2020,139959,45,4,1,1,0
2020,139959,45,6,3,3,0
2020,139968,0,0,103,52,51
2020,139968,10,0,103,52,51
2020,139968,10,1,39,25,14
2020,139968,10,2,20,11,9
2020,139968,10,3,26,5,21
2020,139968,10,4,2,1,1
2020,139968,10,5,16,10,6
2020,139968,20,0,56,32,24
2020,139968,20,1,37,23,14
2020,139968,20,2,16,9,7
2020,139968,20,3,3,0,3
2020,139968,30,0,21,4,17
2020,139968,30,2,1,1,0
2020,139968,30,3,20,3,17
2020,139968,40,0,26,16,10
2020,139968,40,1,2,2,0
2020,139968,40,2,3,1,2
2020,139968,40,3,3,2,1
2020,139968,40,4,2,1,1
2020,139968,40,5,16,10,6
2020,139968,42,0,26,16,10
2020,139968,42,1,2,2,0
2020,139968,42,2,3,1,2
2020,139968,42,3,3,2,1
2020,139968,42,4,2,1,1
2020,139968,42,5,16,10,6
2020,139986,0,0,101,42,59
2020,139986,50,0,101,42,59
2020,140012,0,0,127,60,67
2020,140012,10,0,127,60,67
2020,140012,10,3,2,0,2
2020,140012,10,4,125,60,65
2020,140012,40,0,127,60,67
2020,140012,40,3,2,0,2
2020,140012,40,4,125,60,65
2020,140012,41,0,119,57,62
2020,140012,41,3,2,0,2
2020,140012,41,4,117,57,60
2020,140012,43,0,8,3,5
2020,140012,43,4,8,3,5
2020,140012,45,0,119,57,62
2020,140012,45,3,2,0,2
2020,140012,45,4,117,57,60
2020,140146,0,0,12,7,5
2020,140146,10,0,12,7,5
2020,140146,10,1,5,3,2
2020,140146,10,2,3,2,1
2020,140146,10,3,4,2,2
2020,140146,20,0,8,5,3
2020,140146,20,1,5,3,2
2020,140146,20,2,3,2,1
2020,140146,30,0,2,1,1
2020,140146,30,3,2,1,1
2020,140146,40,0,2,1,1
2020,140146,40,3,2,1,1
2020,140146,41,0,1,0,1
2020,140146,41,3,1,0,1
2020,140146,42,0,1,1,0
2020,140146,42,3,1,1,0
2020,140146,44,0,1,0,1
2020,140146,44,3,1,0,1
2020,140234,0,0,70,33,37
2020,140234,10,0,70,33,37
2020,140234,10,1,22,13,9
2020,140234,10,2,16,4,12
2020,140234,10,3,26,15,11
2020,140234,10,4,3,0,3
2020,140234,10,6,3,1,2
2020,140234,20,0,35,17,18
2020,140234,20,1,22,13,9
2020,140234,20,2,12,4,8
2020,140234,20,3,1,0,1
2020,140234,30,0,20,11,9
2020,140234,30,3,18,10,8
2020,140234,30,4,1,0,1
2020,140234,30,6,1,1,0
2020,140234,40,0,15,5,10
2020,140234,40,2,4,0,4
2020,140234,40,3,7,5,2
2020,140234,40,4,2,0,2
2020,140234,40,6,2,0,2
2020,140234,41,0,7,1,6
2020,140234,41,2,3,0,3
2020,140234,41,3,3,1,2
2020,140234,41,6,1,0,1
2020,140234,42,0,8,4,4
2020,140234,42,2,1,0,1
2020,140234,42,3,4,4,0
2020,140234,42,4,2,0,2
2020,140234,42,6,1,0,1
2020,140234,44,0,7,1,6
2020,140234,44,2,3,0,3
2020,140234,44,3,3,1,2
2020,140234,44,6,1,0,1
2020,140243,0,0,108,55,53
2020,140243,10,0,108,55,53
2020,140243,10,4,108,55,53
2020,140243,40,0,108,55,53
2020,140243,40,4,108,55,53
2020,140243,42,0,108,55,53
2020,140243,42,4,108,55,53
2020,140252,0,0,124,69,55
2020,140252,10,0,124,69,55
2020,140252,10,1,17,12,5
2020,140252,10,2,35,21,14
2020,140252,10,3,71,35,36
2020,140252,10,4,1,1,0
2020,140252,40,0,124,69,55
2020,140252,40,1,17,12,5
2020,140252,40,2,35,21,14
2020,140252,40,3,71,35,36
2020,140252,40,4,1,1,0
2020,140252,42,0,89,54,35
2020,140252,42,1,16,11,5
2020,140252,42,2,27,17,10
2020,140252,42,3,46,26,20
2020,140252,43,0,35,15,20
2020,140252,43,1,1,1,0
2020,140252,43,2,8,4,4
2020,140252,43,3,25,9,16
2020,140252,43,4,1,1,0
2020,140331,0,0,189,88,101
2020,140331,10,0,189,88,101
2020,140331,10,6,189,88,101
2020,140331,40,0,189,88,101
2020,140331,40,6,189,88,101
2020,140331,42,0,181,86,95
2020,140331,42,6,181,86,95
2020,140331,43,0,8,2,6
2020,140331,43,6,8,2,6
2020,140340,0,0,11,2,9
2020,140340,10,0,11,2,9
2020,140340,10,1,3,1,2
2020,140340,10,2,2,1,1
2020,140340,10,3,6,0,6
2020,140340,40,0,11,2,9
2020,140340,40,1,3,1,2
2020,140340,40,2,2,1,1
2020,140340,40,3,6,0,6
2020,140340,41,0,11,2,9
2020,140340,41,1,3,1,2
2020,140340,41,2,2,1,1
2020,140340,41,3,6,0,6
2020,140340,45,0,11,2,9
2020,140340,45,1,3,1,2
2020,140340,45,2,2,1,1
2020,140340,45,3,6,0,6
2020,140447,0,0,437,214,223
2020,140447,10,0,437,214,223
2020,140447,10,1,129,87,42
2020,140447,10,2,133,66,67
2020,140447,10,3,137,46,91
2020,140447,10,4,19,4,15
2020,140447,10,5,19,11,8
2020,140447,20,0,210,129,81
2020,140447,20,1,117,80,37
2020,140447,20,2,92,48,44
2020,140447,20,3,1,1,0
2020,140447,30,0,87,34,53
2020,140447,30,2,4,2,2
2020,140447,30,3,83,32,51
2020,140447,40,0,140,51,89
2020,140447,40,1,12,7,5
2020,140447,40,2,37,16,21
2020,140447,40,3,53,13,40
2020,140447,40,4,19,4,15
2020,140447,40,5,19,11,8
2020,140447,41,0,7,3,4
2020,140447,41,1,1,1,0
2020,140447,41,2,4,2,2
2020,140447,41,3,2,0,2
2020,140447,42,0,133,48,85
2020,140447,42,1,11,6,5
2020,140447,42,2,33,14,19
2020,140447,42,3,51,13,38
2020,140447,42,4,19,4,15
2020,140447,42,5,19,11,8
2020,140447,44,0,6,3,3
2020,140447,44,1,1,1,0
2020,140447,44,2,4,2,2
2020,140447,44,3,1,0,1
2020,140447,45,0,1,0,1
2020,140447,45,3,1,0,1
2020,140553,0,0,137,87,50
2020,140553,10,0,137,87,50
2020,140553,10,1,33,20,13
2020,140553,10,2,59,39,20
2020,140553,10,3,40,24,16
2020,140553,10,4,5,4,1
2020,140553,20,0,84,55,29
2020,140553,20,1,30,19,11
2020,140553,20,2,54,36,18
2020,140553,30,0,21,9,12
2020,140553,30,1,1,0,1
2020,140553,30,2,4,3,1
2020,140553,30,3,16,6,10
2020,140553,40,0,32,23,9
2020,140553,40,1,2,1,1
2020,140553,40,2,1,0,1
2020,140553,40,3,24,18,6
2020,140553,40,4,5,4,1
2020,140553,42,0,32,23,9
2020,140553,42,1,2,1,1
2020,140553,42,2,1,0,1
2020,140553,42,3,24,18,6
2020,140553,42,4,5,4,1
2020,140562,0,0,241,112,129
2020,140562,10,0,241,112,129
2020,140562,10,1,74,52,22
2020,140562,10,2,64,26,38
2020,140562,10,3,78,27,51
2020,140562,10,4,20,7,13
2020,140562,10,6,5,0,5
2020,140562,40,0,241,112,129
2020,140562,40,1,74,52,22
2020,140562,40,2,64,26,38
2020,140562,40,3,78,27,51
2020,140562,40,4,20,7,13
2020,140562,40,6,5,0,5
2020,140562,41,0,59,38,21
2020,140562,41,1,45,32,13
2020,140562,41,2,11,6,5
2020,140562,41,3,3,0,3
2020,140562,42,0,181,74,107
2020,140562,42,1,28,20,8
2020,140562,42,2,53,20,33
2020,140562,42,3,75,27,48
2020,140562,42,4,20,7,13
2020,140562,42,6,5,0,5
2020,140562,43,0,1,0,1
2020,140562,43,1,1,0,1
2020,140562,44,0,59,38,21
2020,140562,44,1,45,32,13
2020,140562,44,2,11,6,5
2020,140562,44,3,3,0,3
2020,140678,0,0,67,32,35
2020,140678,10,0,67,32,35
2020,140678,10,6,67,32,35
2020,140678,40,0,67,32,35
2020,140678,40,6,67,32,35
2020,140678,42,0,67,32,35
2020,140678,42,6,67,32,35
2020,140696,0,0,79,41,38
2020,140696,10,0,79,41,38
2020,140696,10,1,19,12,7
2020,140696,10,2,11,6,5
2020,140696,10,3,24,8,16
2020,140696,10,4,2,2,0
2020,140696,10,5,20,12,8
2020,140696,10,6,3,1,2
2020,140696,20,0,30,18,12
2020,140696,20,1,19,12,7
2020,140696,20,2,11,6,5
2020,140696,30,0,18,6,12
2020,140696,30,3,18,6,12
2020,140696,40,0,31,17,14
2020,140696,40,3,6,2,4
2020,140696,40,4,2,2,0
2020,140696,40,5,20,12,8
2020,140696,40,6,3,1,2
2020,140696,41,0,14,7,7
2020,140696,41,5,11,6,5
2020,140696,41,6,3,1,2
2020,140696,42,0,17,10,7
2020,140696,42,3,6,2,4
2020,140696,42,4,2,2,0
2020,140696,42,5,9,6,3
2020,140696,44,0,11,6,5
2020,140696,44,5,11,6,5
2020,140696,45,0,3,1,2
2020,140696,45,6,3,1,2
2020,140720,0,0,31,21,10
2020,140720,10,0,31,21,10
2020,140720,10,1,2,2,0
2020,140720,10,2,4,4,0
2020,140720,10,3,19,12,7
2020,140720,10,4,6,3,3
2020,140720,20,0,2,2,0
2020,140720,20,1,2,2,0
2020,140720,30,0,19,13,6
2020,140720,30,2,3,3,0
2020,140720,30,3,16,10,6
2020,140720,40,0,10,6,4
2020,140720,40,2,1,1,0
2020,140720,40,3,3,2,1
2020,140720,40,4,6,3,3
2020,140720,42,0,10,6,4
2020,140720,42,2,1,1,0
2020,140720,42,3,3,2,1
2020,140720,42,4,6,3,3
2020,140818,0,0,110,51,59
2020,140818,10,0,110,51,59
2020,140818,10,1,34,19,15
2020,140818,10,2,44,18,26
2020,140818,10,3,31,14,17
2020,140818,10,4,1,0,1
2020,140818,20,0,14,8,6
2020,140818,20,1,14,8,6
2020,140818,30,0,2,1,1
2020,140818,30,1,2,1,1
2020,140818,40,0,94,42,52
2020,140818,40,1,18,10,8
2020,140818,40,2,44,18,26
2020,140818,40,3,31,14,17
2020,140818,40,4,1,0,1
2020,140818,42,0,94,42,52
2020,140818,42,1,18,10,8
2020,140818,42,2,44,18,26
2020,140818,42,3,31,14,17
2020,140818,42,4,1,0,1
2020,140872,0,0,75,32,43
2020,140872,10,0,74,31,43
2020,140872,10,1,16,7,9
2020,140872,10,2,13,5,8
2020,140872,10,3,38,17,21
2020,140872,10,4,5,1,4
2020,140872,10,5,2,1,1
2020,140872,20,0,24,11,13
2020,140872,20,1,11,4,7
2020,140872,20,2,8,4,4
2020,140872,20,3,5,3,2
2020,140872,30,0,15,10,5
2020,140872,30,1,3,2,1
2020,140872,30,2,2,1,1
2020,140872,30,3,10,7,3
2020,140872,40,0,35,10,25
2020,140872,40,1,2,1,1
2020,140872,40,2,3,0,3
2020,140872,40,3,23,7,16
2020,140872,40,4,5,1,4
2020,140872,40,5,2,1,1
2020,140872,42,0,35,10,25
2020,140872,42,1,2,1,1
2020,140872,42,2,3,0,3
2020,140872,42,3,23,7,16
2020,140872,42,4,5,1,4
2020,140872,42,5,2,1,1
2020,140872,50,0,1,1,0
2020,140942,0,0,99,48,51
2020,140942,10,0,99,48,51
2020,140942,10,6,99,48,51
2020,140942,40,0,99,48,51
2020,140942,40,6,99,48,51
2020,140942,41,0,97,48,49
2020,140942,41,6,97,48,49
2020,140942,43,0,2,0,2
2020,140942,43,6,2,0,2
2020,140942,45,0,97,48,49
2020,140942,45,6,97,48,49
2020,140951,0,0,639,377,262
2020,140951,10,0,639,377,262
2020,140951,10,1,639,377,262
2020,140951,40,0,639,377,262
2020,140951,40,1,639,377,262
2020,140951,42,0,639,377,262
2020,140951,42,1,639,377,262
2020,140960,0,0,154,84,70
2020,140960,10,0,152,83,69
2020,140960,10,1,29,23,6
2020,140960,10,2,38,18,20
2020,140960,10,3,53,26,27
2020,140960,10,4,19,11,8
2020,140960,10,5,9,3,6
2020,140960,10,6,4,2,2
2020,140960,20,0,69,43,26
2020,140960,20,1,29,23,6
2020,140960,20,2,35,18,17
2020,140960,20,3,5,2,3
2020,140960,30,0,48,23,25
2020,140960,30,2,3,0,3
2020,140960,30,3,45,23,22
2020,140960,40,0,35,17,18
2020,140960,40,3,3,1,2
2020,140960,40,4,19,11,8
2020,140960,40,5,9,3,6
2020,140960,40,6,4,2,2
2020,140960,41,0,1,0,1
2020,140960,41,4,1,0,1
2020,140960,42,0,34,17,17
2020,140960,42,3,3,1,2
2020,140960,42,4,18,11,7
2020,140960,42,5,9,3,6
2020,140960,42,6,4,2,2
2020,140960,45,0,1,0,1
2020,140960,45,4,1,0,1
2020,140960,50,0,2,1,1
2020,140988,0,0,72,42,30
2020,140988,10,0,72,42,30
2020,140988,10,1,6,5,1
2020,140988,10,2,27,17,10
2020,140988,10,3,37,19,18
2020,140988,10,5,2,1,1
2020,140988,20,0,10,8,2
2020,140988,20,1,4,3,1
2020,140988,20,2,6,5,1
2020,140988,30,0,60,33,27
2020,140988,30,1,2,2,0
2020,140988,30,2,21,12,9
2020,140988,30,3,37,19,18
2020,140988,40,0,2,1,1
2020,140988,40,5,2,1,1
2020,140988,42,0,1,1,0
2020,140988,42,5,1,1,0
2020,140988,43,0,1,0,1
2020,140988,43,5,1,0,1
2020,141006,0,0,53,30,23
2020,141006,10,0,53,30,23
2020,141006,10,4,53,30,23
2020,141006,40,0,53,30,23
2020,141006,40,4,53,30,23
2020,141006,42,0,53,30,23
2020,141006,42,4,53,30,23
2020,141060,0,0,179,41,138
2020,141060,10,0,179,41,138
2020,141060,10,1,24,7,17
2020,141060,10,2,61,16,45
2020,141060,10,3,43,9,34
2020,141060,10,4,16,1,15
2020,141060,10,5,35,8,27
2020,141060,20,0,85,23,62
2020,141060,20,1,24,7,17
2020,141060,20,2,61,16,45
2020,141060,30,0,42,9,33
2020,141060,30,3,42,9,33
2020,141060,40,0,52,9,43
2020,141060,40,3,1,0,1
2020,141060,40,4,16,1,15
2020,141060,40,5,35,8,27
2020,141060,41,0,37,7,30
2020,141060,41,4,14,1,13
2020,141060,41,5,23,6,17
2020,141060,42,0,15,2,13
2020,141060,42,3,1,0,1
2020,141060,42,4,2,0,2
2020,141060,42,5,12,2,10
2020,141060,44,0,37,7,30
2020,141060,44,4,14,1,13
2020,141060,44,5,23,6,17
2020,141167,0,0,48,18,30
2020,141167,10,0,48,18,30
2020,141167,10,1,4,1,3
2020,141167,10,2,13,3,10
2020,141167,10,3,24,7,17
2020,141167,10,4,6,6,0
2020,141167,10,5,1,1,0
2020,141167,40,0,48,18,30
2020,141167,40,1,4,1,3
2020,141167,40,2,13,3,10
2020,141167,40,3,24,7,17
2020,141167,40,4,6,6,0
2020,141167,40,5,1,1,0
2020,141167,43,0,48,18,30
2020,141167,43,1,4,1,3
2020,141167,43,2,13,3,10
2020,141167,43,3,24,7,17
2020,141167,43,4,6,6,0
2020,141167,43,5,1,1,0
2020,141185,0,0,46,28,18
2020,141185,10,0,46,28,18
2020,141185,10,1,14,13,1
2020,141185,10,2,9,5,4
2020,141185,10,3,23,10,13
2020,141185,20,0,12,11,1
2020,141185,20,1,10,9,1
2020,141185,20,2,2,2,0
2020,141185,30,0,21,12,9
2020,141185,30,1,4,4,0
2020,141185,30,2,7,3,4
2020,141185,30,3,10,5,5
2020,141185,40,0,13,5,8
2020,141185,40,3,13,5,8
2020,141185,42,0,13,5,8
2020,141185,42,3,13,5,8
2020,141237,0,0,55,30,25
2020,141237,10,0,55,30,25
2020,141237,10,1,13,7,6
2020,141237,10,2,17,11,6
2020,141237,10,3,21,9,12
2020,141237,10,4,3,3,0
2020,141237,10,6,1,0,1
2020,141237,40,0,55,30,25
2020,141237,40,1,13,7,6
2020,141237,40,2,17,11,6
2020,141237,40,3,21,9,12
2020,141237,40,4,3,3,0
2020,141237,40,6,1,0,1
2020,141237,42,0,55,30,25
2020,141237,42,1,13,7,6
2020,141237,42,2,17,11,6
2020,141237,42,3,21,9,12
2020,141237,42,4,3,3,0
2020,141237,42,6,1,0,1
2020,141255,0,0,133,53,80
2020,141255,10,0,133,53,80
2020,141255,10,4,133,53,80
2020,141255,40,0,133,53,80
2020,141255,40,4,133,53,80
2020,141255,41,0,133,53,80
2020,141255,41,4,133,53,80
2020,141255,45,0,133,53,80
2020,141255,45,4,133,53,80
2020,141264,0,0,413,199,214
2020,141264,10,0,412,199,213
2020,141264,10,1,126,77,49
2020,141264,10,2,104,54,50
2020,141264,10,3,79,36,43
2020,141264,10,4,33,9,24
2020,141264,10,5,70,23,47
2020,141264,20,0,227,131,96
2020,141264,20,1,126,77,49
2020,141264,20,2,99,53,46
2020,141264,20,3,2,1,1
2020,141264,30,0,68,31,37
2020,141264,30,2,3,0,3
2020,141264,30,3,63,30,33
2020,141264,30,4,2,1,1
2020,141264,40,0,117,37,80
2020,141264,40,2,2,1,1
2020,141264,40,3,14,5,9
2020,141264,40,4,31,8,23
2020,141264,40,5,70,23,47
2020,141264,42,0,117,37,80
2020,141264,42,2,2,1,1
2020,141264,42,3,14,5,9
2020,141264,42,4,31,8,23
2020,141264,42,5,70,23,47
2020,141264,50,0,1,0,1
2020,141325,0,0,51,19,32
2020,141325,10,0,51,19,32
2020,141325,10,1,20,7,13
2020,141325,10,2,14,6,8
2020,141325,10,3,15,5,10
2020,141325,10,4,2,1,1
2020,141325,20,0,34,14,20
2020,141325,20,1,20,7,13
2020,141325,20,2,13,6,7
2020,141325,20,3,1,1,0
2020,141325,30,0,14,4,10
2020,141325,30,2,1,0,1
2020,141325,30,3,13,4,9
2020,141325,40,0,3,1,2
2020,141325,40,3,1,0,1
2020,141325,40,4,2,1,1
2020,141325,42,0,3,1,2
2020,141325,42,3,1,0,1
2020,141325,42,4,2,1,1
2020,141334,0,0,486,211,275
2020,141334,10,0,485,211,274
2020,141334,10,1,124,81,43
2020,141334,10,2,109,47,62
2020,141334,10,3,115,43,72
2020,141334,10,4,59,16,43
2020,141334,10,5,78,24,54
2020,141334,20,0,229,126,103
2020,141334,20,1,124,81,43
2020,141334,20,2,104,44,60
2020,141334,20,3,1,1,0
2020,141334,30,0,92,39,53
2020,141334,30,2,4,3,1
2020,141334,30,3,87,36,51
2020,141334,30,4,1,0,1
2020,141334,40,0,164,46,118
2020,141334,40,2,1,0,1
2020,141334,40,3,27,6,21
2020,141334,40,4,58,16,42
2020,141334,40,5,78,24,54
2020,141334,41,0,1,0,1
2020,141334,41,4,1,0,1
2020,141334,42,0,163,46,117
2020,141334,42,2,1,0,1
2020,141334,42,3,27,6,21
2020,141334,42,4,57,16,41
2020,141334,42,5,78,24,54
2020,141334,45,0,1,0,1
2020,141334,45,4,1,0,1
2020,141334,50,0,1,0,1
2020,141361,0,0,65,34,31
2020,141361,10,0,65,34,31
2020,141361,10,1,11,7,4
2020,141361,10,2,22,14,8
2020,141361,10,3,22,9,13
2020,141361,10,4,10,4,6
2020,141361,20,0,33,21,12
2020,141361,20,1,11,7,4
2020,141361,20,2,22,14,8
2020,141361,30,0,22,9,13
2020,141361,30,3,22,9,13
2020,141361,40,0,10,4,6
2020,141361,40,4,10,4,6
2020,141361,42,0,10,4,6
2020,141361,42,4,10,4,6
2020,141486,0,0,86,45,41
2020,141486,10,0,86,45,41
2020,141486,10,1,20,15,5
2020,141486,10,2,28,15,13
2020,141486,10,3,30,11,19
2020,141486,10,5,8,4,4
2020,141486,20,0,33,23,10
2020,141486,20,1,20,15,5
2020,141486,20,2,13,8,5
2020,141486,30,0,10,4,6
2020,141486,30,2,1,0,1
2020,141486,30,3,9,4,5
2020,141486,40,0,43,18,25
2020,141486,40,2,14,7,7
2020,141486,40,3,21,7,14
2020,141486,40,5,8,4,4
2020,141486,42,0,43,18,25
2020,141486,42,2,14,7,7
2020,141486,42,3,21,7,14
2020,141486,42,5,8,4,4
2020,141565,0,0,191,106,85
2020,141565,10,0,191,106,85
2020,141565,10,1,73,38,35
2020,141565,10,2,57,37,20
2020,141565,10,3,37,23,14
2020,141565,10,4,24,8,16
2020,141565,20,0,131,77,54
2020,141565,20,1,73,38,35
2020,141565,20,2,56,37,19
2020,141565,20,3,2,2,0
2020,141565,30,0,35,21,14
2020,141565,30,2,1,0,1
2020,141565,30,3,34,21,13
2020,141565,40,0,25,8,17
2020,141565,40,3,1,0,1
2020,141565,40,4,24,8,16
2020,141565,41,0,12,1,11
2020,141565,41,4,12,1,11
2020,141565,42,0,13,7,6
2020,141565,42,3,1,0,1
2020,141565,42,4,12,7,5
2020,141565,44,0,12,1,11
2020,141565,44,4,12,1,11
2020,141574,0,0,1131,595,536
2020,141574,10,0,1131,595,536
2020,141574,10,1,436,279,157
2020,141574,10,2,324,151,173
2020,141574,10,3,255,131,124
2020,141574,10,4,116,34,82
2020,141574,20,0,729,415,314
2020,141574,20,1,427,272,155
2020,141574,20,2,301,143,158
2020,141574,20,3,1,0,1
2020,141574,30,0,188,105,83
2020,141574,30,2,3,2,1
2020,141574,30,3,185,103,82
2020,141574,40,0,214,75,139
2020,141574,40,1,9,7,2
2020,141574,40,2,20,6,14
2020,141574,40,3,69,28,41
2020,141574,40,4,116,34,82
2020,141574,41,0,63,23,40
2020,141574,41,2,2,0,2
2020,141574,41,3,18,9,9
2020,141574,41,4,43,14,29
2020,141574,42,0,151,52,99
2020,141574,42,1,9,7,2
2020,141574,42,2,18,6,12
2020,141574,42,3,51,19,32
2020,141574,42,4,73,20,53
2020,141574,44,0,63,23,40
2020,141574,44,2,2,0,2
2020,141574,44,3,18,9,9
2020,141574,44,4,43,14,29
2020,141644,0,0,146,79,67
2020,141644,10,0,146,79,67
2020,141644,10,1,19,11,8
2020,141644,10,2,46,27,19
2020,141644,10,3,50,26,24
2020,141644,10,4,13,6,7
2020,141644,10,5,18,9,9
2020,141644,40,0,146,79,67
2020,141644,40,1,19,11,8
2020,141644,40,2,46,27,19
2020,141644,40,3,50,26,24
2020,141644,40,4,13,6,7
2020,141644,40,5,18,9,9
2020,141644,41,0,133,75,58
2020,141644,41,1,19,11,8
2020,141644,41,2,46,27,19
2020,141644,41,3,50,26,24
2020,141644,41,4,13,6,7
2020,141644,41,5,5,5,0
2020,141644,42,0,13,4,9
2020,141644,42,5,13,4,9
2020,141644,44,0,133,75,58
2020,141644,44,1,19,11,8
2020,141644,44,2,46,27,19
2020,141644,44,3,50,26,24
2020,141644,44,4,13,6,7
2020,141644,44,5,5,5,0
2020,141680,0,0,92,56,36
2020,141680,10,0,92,56,36
2020,141680,10,1,22,12,10
2020,141680,10,2,16,11,5
2020,141680,10,3,29,20,9
2020,141680,10,4,25,13,12
2020,141680,20,0,63,40,23
2020,141680,20,1,22,12,10
2020,141680,20,2,16,11,5
2020,141680,20,3,25,17,8
2020,141680,30,0,27,15,12
2020,141680,30,3,3,3,0
2020,141680,30,4,24,12,12
2020,141680,40,0,2,1,1
2020,141680,40,3,1,0,1
2020,141680,40,4,1,1,0
2020,141680,42,0,2,1,1
2020,141680,42,3,1,0,1
2020,141680,42,4,1,1,0
2020,141796,0,0,165,84,81
2020,141796,10,0,165,84,81
2020,141796,10,1,50,27,23
2020,141796,10,2,24,11,13
2020,141796,10,3,44,24,20
2020,141796,10,4,47,22,25
2020,141796,20,0,112,59,53
2020,141796,20,1,49,26,23
2020,141796,20,2,24,11,13
2020,141796,20,3,38,22,16
2020,141796,20,4,1,0,1
2020,141796,30,0,42,21,21
2020,141796,30,3,3,1,2
2020,141796,30,4,39,20,19
2020,141796,40,0,11,4,7
2020,141796,40,1,1,1,0
2020,141796,40,3,3,1,2
2020,141796,40,4,7,2,5
2020,141796,42,0,11,4,7
2020,141796,42,1,1,1,0
2020,141796,42,3,3,1,2
2020,141796,42,4,7,2,5
2020,141802,0,0,52,27,25
2020,141802,10,0,52,27,25
2020,141802,10,1,11,6,5
2020,141802,10,2,8,4,4
2020,141802,10,3,16,8,8
2020,141802,10,4,17,9,8
2020,141802,20,0,34,18,16
2020,141802,20,1,11,6,5
2020,141802,20,2,8,4,4
2020,141802,20,3,15,8,7
2020,141802,30,0,11,6,5
2020,141802,30,3,1,0,1
2020,141802,30,4,10,6,4
2020,141802,40,0,7,3,4
2020,141802,40,4,7,3,4
2020,141802,42,0,7,3,4
2020,141802,42,4,7,3,4
2020,141811,0,0,142,68,74
2020,141811,10,0,142,68,74
2020,141811,10,1,38,22,16
2020,141811,10,2,27,12,15
2020,141811,10,3,38,18,20
2020,141811,10,4,39,16,23
2020,141811,20,0,102,51,51
2020,141811,20,1,38,22,16
2020,141811,20,2,26,11,15
2020,141811,20,3,38,18,20
2020,141811,30,0,38,16,22
2020,141811,30,2,1,1,0
2020,141811,30,4,37,15,22
2020,141811,40,0,2,1,1
2020,141811,40,4,2,1,1
2020,141811,42,0,2,1,1
2020,141811,42,4,2,1,1
2020,141839,0,0,70,34,36
2020,141839,10,0,70,34,36
2020,141839,10,1,9,2,7
2020,141839,10,2,17,7,10
2020,141839,10,3,22,15,7
2020,141839,10,4,22,10,12
2020,141839,20,0,48,24,24
2020,141839,20,1,9,2,7
2020,141839,20,2,17,7,10
2020,141839,20,3,22,15,7
2020,141839,30,0,17,7,10
2020,141839,30,4,17,7,10
2020,141839,40,0,5,3,2
2020,141839,40,4,5,3,2
2020,141839,41,0,1,1,0
2020,141839,41,4,1,1,0
2020,141839,42,0,4,2,2
2020,141839,42,4,4,2,2
2020,141839,44,0,1,1,0
2020,141839,44,4,1,1,0
2020,141981,0,0,86,43,43
2020,141981,10,0,86,43,43
2020,141981,10,1,27,16,11
2020,141981,10,2,18,11,7
2020,141981,10,3,33,11,22
2020,141981,10,4,8,5,3
2020,141981,20,0,45,27,18
2020,141981,20,1,27,16,11
2020,141981,20,2,18,11,7
2020,141981,30,0,32,10,22
2020,141981,30,3,32,10,22
2020,141981,40,0,9,6,3
2020,141981,40,3,1,1,0
2020,141981,40,4,8,5,3
2020,141981,41,0,1,1,0
2020,141981,41,3,1,1,0
2020,141981,42,0,8,5,3
2020,141981,42,4,8,5,3
2020,141981,44,0,1,1,0
2020,141981,44,3,1,1,0
2020,141990,0,0,55,25,30
2020,141990,10,0,55,25,30
2020,141990,10,1,13,9,4
2020,141990,10,2,5,2,3
2020,141990,10,3,15,6,9
2020,141990,10,4,22,8,14
2020,141990,20,0,33,17,16
2020,141990,20,1,13,9,4
2020,141990,20,2,5,2,3
2020,141990,20,3,15,6,9
2020,141990,30,0,16,8,8
2020,141990,30,4,16,8,8
2020,141990,40,0,6,0,6
2020,141990,40,4,6,0,6
2020,141990,42,0,6,0,6
2020,141990,42,4,6,0,6
2020,142054,0,0,21,3,18
2020,142054,10,0,21,3,18
2020,142054,10,4,21,3,18
2020,142054,40,0,21,3,18
2020,142054,40,4,21,3,18
2020,142054,41,0,21,3,18
2020,142054,41,4,21,3,18
2020,142054,45,0,21,3,18
2020,142054,45,4,21,3,18
2020,142090,0,0,8,5,3
2020,142090,10,0,8,5,3
2020,142090,10,1,8,5,3
2020,142090,40,0,8,5,3
2020,142090,40,1,8,5,3
2020,142090,41,0,8,5,3
2020,142090,41,1,8,5,3
2020,142090,44,0,8,5,3
2020,142090,44,1,8,5,3
2020,142115,0,0,784,402,382
2020,142115,10,0,784,402,382
2020,142115,10,1,180,113,67
2020,142115,10,2,228,114,114
2020,142115,10,3,207,102,105
2020,142115,10,4,14,9,5
2020,142115,10,5,135,57,78
2020,142115,10,6,20,7,13
2020,142115,20,0,378,217,161
2020,142115,20,1,177,111,66
2020,142115,20,2,199,105,94
2020,142115,20,3,2,1,1
2020,142115,30,0,150,79,71
2020,142115,30,1,1,0,1
2020,142115,30,2,3,2,1
2020,142115,30,3,146,77,69
2020,142115,40,0,256,106,150
2020,142115,40,1,2,2,0
2020,142115,40,2,26,7,19
2020,142115,40,3,59,24,35
2020,142115,40,4,14,9,5
2020,142115,40,5,135,57,78
2020,142115,40,6,20,7,13
2020,142115,42,0,256,106,150
2020,142115,42,1,2,2,0
2020,142115,42,2,26,7,19
2020,142115,42,3,59,24,35
2020,142115,42,4,14,9,5
2020,142115,42,5,135,57,78
2020,142115,42,6,20,7,13
2020,142179,0,0,58,26,32
2020,142179,10,0,58,26,32
2020,142179,10,4,57,26,31
2020,142179,10,6,1,0,1
2020,142179,40,0,58,26,32
2020,142179,40,4,57,26,31
2020,142179,40,6,1,0,1
2020,142179,42,0,58,26,32
2020,142179,42,4,57,26,31
2020,142179,42,6,1,0,1
2020,142276,0,0,606,319,287
2020,142276,10,0,606,319,287
2020,142276,10,1,127,87,40
2020,142276,10,2,136,64,72
2020,142276,10,3,190,87,103
2020,142276,10,4,86,54,32
2020,142276,10,5,67,27,40
2020,142276,20,0,219,137,82
2020,142276,20,1,122,86,36
2020,142276,20,2,97,51,46
2020,142276,30,0,101,45,56
2020,142276,30,1,1,0,1
2020,142276,30,2,5,3,2
2020,142276,30,3,95,42,53
2020,142276,40,0,286,137,149
2020,142276,40,1,4,1,3
2020,142276,40,2,34,10,24
2020,142276,40,3,95,45,50
2020,142276,40,4,86,54,32
2020,142276,40,5,67,27,40
2020,142276,42,0,286,137,149
2020,142276,42,1,4,1,3
2020,142276,42,2,34,10,24
2020,142276,42,3,95,45,50
2020,142276,42,4,86,54,32
2020,142276,42,5,67,27,40
2020,142285,0,0,535,340,195
2020,142285,10,0,535,340,195
2020,142285,10,1,159,120,39
2020,142285,10,2,160,102,58
2020,142285,10,3,145,86,59
2020,142285,10,4,52,19,33
2020,142285,10,6,19,13,6
2020,142285,20,0,287,205,82
2020,142285,20,1,154,117,37
2020,142285,20,2,129,86,43
2020,142285,20,3,1,0,1
2020,142285,20,4,3,2,1
2020,142285,30,0,110,63,47
2020,142285,30,2,5,4,1
2020,142285,30,3,105,59,46
2020,142285,40,0,138,72,66
2020,142285,40,1,5,3,2
2020,142285,40,2,26,12,14
2020,142285,40,3,39,27,12
2020,142285,40,4,49,17,32
2020,142285,40,6,19,13,6
2020,142285,41,0,5,3,2
2020,142285,41,3,5,3,2
2020,142285,42,0,133,69,64
2020,142285,42,1,5,3,2
2020,142285,42,2,26,12,14
2020,142285,42,3,34,24,10
2020,142285,42,4,49,17,32
2020,142285,42,6,19,13,6
2020,142285,44,0,5,3,2
2020,142285,44,3,5,3,2
2020,142294,0,0,70,41,29
2020,142294,10,0,70,41,29
2020,142294,10,1,27,17,10
2020,142294,10,2,17,7,10
2020,142294,10,3,12,9,3
2020,142294,10,4,5,4,1
2020,142294,10,5,8,3,5
2020,142294,10,6,1,1,0
2020,142294,20,0,43,23,20
2020,142294,20,1,26,16,10
2020,142294,20,2,17,7,10
2020,142294,30,0,13,10,3
2020,142294,30,1,1,1,0
2020,142294,30,3,12,9,3
2020,142294,40,0,14,8,6
2020,142294,40,4,5,4,1
2020,142294,40,5,8,3,5
2020,142294,40,6,1,1,0
2020,142294,42,0,14,8,6
2020,142294,42,4,5,4,1
2020,142294,42,5,8,3,5
2020,142294,42,6,1,1,0
2020,142328,0,0,171,80,91
2020,142328,10,0,171,80,91
2020,142328,10,1,51,31,20
2020,142328,10,2,50,18,32
2020,142328,10,3,47,19,28
2020,142328,10,4,23,12,11
2020,142328,20,0,92,38,54
2020,142328,20,1,41,24,17
2020,142328,20,2,42,14,28
2020,142328,20,3,6,0,6
2020,142328,20,4,3,0,3
2020,142328,30,0,31,13,18
2020,142328,30,2,1,1,0
2020,142328,30,3,23,7,16
2020,142328,30,4,7,5,2
2020,142328,40,0,48,29,19
2020,142328,40,1,10,7,3
2020,142328,40,2,7,3,4
2020,142328,40,3,18,12,6
2020,142328,40,4,13,7,6
2020,142328,42,0,48,29,19
2020,142328,42,1,10,7,3
2020,142328,42,2,7,3,4
2020,142328,42,3,18,12,6
2020,142328,42,4,13,7,6
2020,142443,0,0,147,82,65
2020,142443,10,0,147,82,65
2020,142443,10,1,35,17,18
2020,142443,10,2,63,39,24
2020,142443,10,3,48,25,23
2020,142443,10,6,1,1,0
2020,142443,20,0,97,56,41
2020,142443,20,1,35,17,18
2020,142443,20,2,61,38,23
2020,142443,20,6,1,1,0
2020,142443,30,0,33,16,17
2020,142443,30,3,33,16,17
2020,142443,40,0,17,10,7
2020,142443,40,2,2,1,1
2020,142443,40,3,15,9,6
2020,142443,42,0,17,10,7
2020,142443,42,2,2,1,1
2020,142443,42,3,15,9,6
2020,142461,0,0,100,50,50
2020,142461,10,0,99,50,49
2020,142461,10,1,31,22,9
2020,142461,10,2,31,15,16
2020,142461,10,3,37,13,24
2020,142461,20,0,43,28,15
2020,142461,20,1,28,21,7
2020,142461,20,2,14,7,7
2020,142461,20,3,1,0,1
2020,142461,30,0,40,17,23
2020,142461,30,1,3,1,2
2020,142461,30,2,10,6,4
2020,142461,30,3,27,10,17
2020,142461,40,0,16,5,11
2020,142461,40,2,7,2,5
2020,142461,40,3,9,3,6
2020,142461,42,0,16,5,11
2020,142461,42,2,7,2,5
2020,142461,42,3,9,3,6
2020,142461,50,0,1,0,1
2020,142522,0,0,588,482,106
2020,142522,50,0,588,482,106
2020,142559,0,0,138,68,70
2020,142559,10,0,138,68,70
2020,142559,10,1,54,24,30
2020,142559,10,2,23,12,11
2020,142559,10,3,18,12,6
2020,142559,10,4,43,20,23
2020,142559,40,0,138,68,70
2020,142559,40,1,54,24,30
2020,142559,40,2,23,12,11
2020,142559,40,3,18,12,6
2020,142559,40,4,43,20,23
2020,142559,42,0,138,68,70
2020,142559,42,1,54,24,30
2020,142559,42,2,23,12,11
2020,142559,42,3,18,12,6
2020,142559,42,4,43,20,23
2020,142832,0,0,61,19,42
2020,142832,10,0,61,19,42
2020,142832,10,1,14,3,11
2020,142832,10,2,16,7,9
2020,142832,10,3,23,7,16
2020,142832,10,4,1,0,1
2020,142832,10,6,7,2,5
2020,142832,40,0,61,19,42
2020,142832,40,1,14,3,11
2020,142832,40,2,16,7,9
2020,142832,40,3,23,7,16
2020,142832,40,4,1,0,1
2020,142832,40,6,7,2,5
2020,142832,41,0,58,17,41
2020,142832,41,1,14,3,11
2020,142832,41,2,15,7,8
2020,142832,41,3,23,7,16
2020,142832,41,4,1,0,1
2020,142832,41,6,5,0,5
2020,142832,42,0,3,2,1
2020,142832,42,2,1,0,1
2020,142832,42,6,2,2,0
2020,142832,44,0,54,17,37
2020,142832,44,1,14,3,11
2020,142832,44,2,15,7,8
2020,142832,44,3,23,7,16
2020,142832,44,6,2,0,2
2020,142832,45,0,4,0,4
2020,142832,45,4,1,0,1
2020,142832,45,6,3,0,3
2020,142887,0,0,20,12,8
2020,142887,10,0,20,12,8
2020,142887,10,4,20,12,8
2020,142887,40,0,20,12,8
2020,142887,40,4,20,12,8
2020,142887,42,0,10,6,4
2020,142887,42,4,10,6,4
2020,142887,43,0,10,6,4
2020,142887,43,4,10,6,4
2020,143048,0,0,162,91,71
2020,143048,10,0,162,91,71
2020,143048,10,1,52,29,23
2020,143048,10,2,69,40,29
2020,143048,10,3,33,17,16
2020,143048,10,6,8,5,3
2020,143048,20,0,121,69,52
2020,143048,20,1,52,29,23
2020,143048,20,2,69,40,29
2020,143048,30,0,33,17,16
2020,143048,30,3,33,17,16
2020,143048,40,0,8,5,3
2020,143048,40,6,8,5,3
2020,143048,41,0,3,3,0
2020,143048,41,6,3,3,0
2020,143048,42,0,5,2,3
2020,143048,42,6,5,2,3
2020,143048,44,0,3,3,0
2020,143048,44,6,3,3,0
2020,143084,0,0,195,102,93
2020,143084,10,0,195,102,93
2020,143084,10,1,68,42,26
2020,143084,10,2,50,25,25
2020,143084,10,3,34,12,22
2020,143084,10,4,43,23,20
2020,143084,20,0,117,66,51
2020,143084,20,1,67,41,26
2020,143084,20,2,50,25,25
2020,143084,30,0,35,13,22
2020,143084,30,1,1,1,0
2020,143084,30,3,34,12,22
2020,143084,40,0,43,23,20
2020,143084,40,4,43,23,20
2020,143084,42,0,43,23,20
2020,143084,42,4,43,23,20
2020,143118,0,0,132,59,73
2020,143118,10,0,132,59,73
2020,143118,10,1,23,11,12
2020,143118,10,2,43,20,23
2020,143118,10,3,64,27,37
2020,143118,10,5,2,1,1
2020,143118,20,0,53,23,30
2020,143118,20,1,19,9,10
2020,143118,20,2,34,14,20
2020,143118,30,0,28,18,10
2020,143118,30,1,1,0,1
2020,143118,30,2,1,1,0
2020,143118,30,3,26,17,9
2020,143118,40,0,51,18,33
2020,143118,40,1,3,2,1
2020,143118,40,2,8,5,3
2020,143118,40,3,38,10,28
2020,143118,40,5,2,1,1
2020,143118,41,0,20,10,10
2020,143118,41,1,2,2,0
2020,143118,41,2,8,5,3
2020,143118,41,3,10,3,7
2020,143118,42,0,31,8,23
2020,143118,42,1,1,0,1
2020,143118,42,3,28,7,21
2020,143118,42,5,2,1,1
2020,143118,44,0,20,10,10
2020,143118,44,1,2,2,0
2020,143118,44,2,8,5,3
2020,143118,44,3,10,3,7
2020,143215,0,0,136,60,76
2020,143215,10,0,136,60,76
2020,143215,10,1,12,5,7
2020,143215,10,2,40,18,22
2020,143215,10,3,66,24,42
2020,143215,10,4,17,12,5
2020,143215,10,6,1,1,0
2020,143215,20,0,95,45,50
2020,143215,20,1,10,5,5
2020,143215,20,2,29,14,15
2020,143215,20,3,50,20,30
2020,143215,20,4,5,5,0
2020,143215,20,6,1,1,0
2020,143215,30,0,41,15,26
2020,143215,30,1,2,0,2
2020,143215,30,2,11,4,7
2020,143215,30,3,16,4,12
2020,143215,30,4,12,7,5
2020,143233,0,0,8,5,3
2020,143233,10,0,8,5,3
2020,143233,10,1,5,4,1
2020,143233,10,2,1,0,1
2020,143233,10,3,2,1,1
2020,143233,20,0,6,4,2
2020,143233,20,1,5,4,1
2020,143233,20,2,1,0,1
2020,143233,30,0,2,1,1
2020,143233,30,3,2,1,1
2020,143279,0,0,94,35,59
2020,143279,10,0,94,35,59
2020,143279,10,1,46,21,25
2020,143279,10,2,17,4,13
2020,143279,10,3,12,5,7
2020,143279,10,4,19,5,14
2020,143279,20,0,78,31,47
2020,143279,20,1,46,21,25
2020,143279,20,2,16,3,13
2020,143279,20,3,12,5,7
2020,143279,20,4,4,2,2
2020,143279,30,0,12,3,9
2020,143279,30,2,1,1,0
2020,143279,30,4,11,2,9
2020,143279,40,0,4,1,3
2020,143279,40,4,4,1,3
2020,143279,42,0,4,1,3
2020,143279,42,4,4,1,3
2020,143288,0,0,36,19,17
2020,143288,10,0,36,19,17
2020,143288,10,1,36,19,17
2020,143288,20,0,22,13,9
2020,143288,20,1,22,13,9
2020,143288,30,0,11,5,6
2020,143288,30,1,11,5,6
2020,143288,40,0,3,1,2
2020,143288,40,1,3,1,2
2020,143288,42,0,3,1,2
2020,143288,42,1,3,1,2
2020,143297,0,0,31,3,28
2020,143297,10,0,31,3,28
2020,143297,10,1,2,0,2
2020,143297,10,2,3,0,3
2020,143297,10,3,16,2,14
2020,143297,10,4,9,1,8
2020,143297,10,6,1,0,1
2020,143297,40,0,31,3,28
2020,143297,40,1,2,0,2
2020,143297,40,2,3,0,3
2020,143297,40,3,16,2,14
2020,143297,40,4,9,1,8
2020,143297,40,6,1,0,1
2020,143297,42,0,31,3,28
2020,143297,42,1,2,0,2
2020,143297,42,2,3,0,3
2020,143297,42,3,16,2,14
2020,143297,42,4,9,1,8
2020,143297,42,6,1,0,1
2020,143358,0,0,314,179,135
2020,143358,10,0,314,179,135
2020,143358,10,1,75,59,16
2020,143358,10,2,93,54,39
2020,143358,10,3,100,45,55
2020,143358,10,4,30,17,13
2020,143358,10,5,15,4,11
2020,143358,10,6,1,0,1
2020,143358,20,0,175,114,61
2020,143358,20,1,74,58,16
2020,143358,20,2,92,53,39
2020,143358,20,3,3,2,1
2020,143358,20,5,6,1,5
2020,143358,30,0,74,42,32
2020,143358,30,1,1,1,0
2020,143358,30,2,1,1,0
2020,143358,30,3,65,36,29
2020,143358,30,4,1,1,0
2020,143358,30,5,6,3,3
2020,143358,40,0,65,23,42
2020,143358,40,3,32,7,25
2020,143358,40,4,29,16,13
2020,143358,40,5,3,0,3
2020,143358,40,6,1,0,1
2020,143358,42,0,65,23,42
2020,143358,42,3,32,7,25
2020,143358,42,4,29,16,13
2020,143358,42,5,3,0,3
2020,143358,42,6,1,0,1
2020,143613,0,0,40,17,23
2020,143613,10,0,40,17,23
2020,143613,10,6,40,17,23
2020,143613,20,0,27,10,17
2020,143613,20,6,27,10,17
2020,143613,30,0,10,6,4
2020,143613,30,6,10,6,4
2020,143613,40,0,3,1,2
2020,143613,40,6,3,1,2
2020,143613,43,0,3,1,2
2020,143613,43,6,3,1,2
2020,143659,0,0,24,15,9
2020,143659,10,0,24,15,9
2020,143659,10,1,10,6,4
2020,143659,10,2,6,5,1
2020,143659,10,3,8,4,4
2020,143659,20,0,15,10,5
2020,143659,20,1,10,6,4
2020,143659,20,2,5,4,1
2020,143659,30,0,9,5,4
2020,143659,30,2,1,1,0
2020,143659,30,3,8,4,4
2020,143853,0,0,213,84,129
2020,143853,10,0,209,83,126
2020,143853,10,1,41,17,24
2020,143853,10,2,55,19,36
2020,143853,10,3,108,46,62
2020,143853,10,4,1,1,0
2020,143853,10,5,4,0,4
2020,143853,20,0,72,30,42
2020,143853,20,1,37,16,21
2020,143853,20,2,34,14,20
2020,143853,20,3,1,0,1
2020,143853,30,0,40,14,26
2020,143853,30,1,1,0,1
2020,143853,30,2,7,1,6
2020,143853,30,3,32,13,19
2020,143853,40,0,97,39,58
2020,143853,40,1,3,1,2
2020,143853,40,2,14,4,10
2020,143853,40,3,75,33,42
2020,143853,40,4,1,1,0
2020,143853,40,5,4,0,4
2020,143853,41,0,97,39,58
2020,143853,41,1,3,1,2
2020,143853,41,2,14,4,10
2020,143853,41,3,75,33,42
2020,143853,41,4,1,1,0
2020,143853,41,5,4,0,4
2020,143853,44,0,97,39,58
2020,143853,44,1,3,1,2
2020,143853,44,2,14,4,10
2020,143853,44,3,75,33,42
2020,143853,44,4,1,1,0
2020,143853,44,5,4,0,4
2020,143853,50,0,4,1,3
2020,143978,0,0,57,23,34
2020,143978,10,0,57,23,34
2020,143978,10,1,16,8,8
2020,143978,10,2,28,9,19
2020,143978,10,3,13,6,7
2020,143978,40,0,57,23,34
2020,143978,40,1,16,8,8
2020,143978,40,2,28,9,19
2020,143978,40,3,13,6,7
2020,143978,41,0,57,23,34
2020,143978,41,1,16,8,8
2020,143978,41,2,28,9,19
2020,143978,41,3,13,6,7
2020,143978,44,0,57,23,34
2020,143978,44,1,16,8,8
2020,143978,44,2,28,9,19
2020,143978,44,3,13,6,7
2020,144005,0,0,191,94,97
2020,144005,10,0,191,94,97
2020,144005,10,1,48,30,18
2020,144005,10,2,50,26,24
2020,144005,10,3,59,21,38
2020,144005,10,5,34,17,17
2020,144005,20,0,85,48,37
2020,144005,20,1,46,29,17
2020,144005,20,2,37,19,18
2020,144005,20,3,2,0,2
2020,144005,30,0,48,21,27
2020,144005,30,1,1,0,1
2020,144005,30,2,8,5,3
2020,144005,30,3,39,16,23
2020,144005,40,0,58,25,33
2020,144005,40,1,1,1,0
2020,144005,40,2,5,2,3
2020,144005,40,3,18,5,13
2020,144005,40,5,34,17,17
2020,144005,42,0,58,25,33
2020,144005,42,1,1,1,0
2020,144005,42,2,5,2,3
2020,144005,42,3,18,5,13
2020,144005,42,5,34,17,17
2020,144014,0,0,11,6,5
2020,144014,10,0,11,6,5
2020,144014,10,1,2,2,0
2020,144014,10,2,5,2,3
2020,144014,10,3,4,2,2
2020,144014,20,0,6,4,2
2020,144014,20,1,2,2,0
2020,144014,20,2,4,2,2
2020,144014,30,0,4,2,2
2020,144014,30,2,1,0,1
2020,144014,30,3,3,2,1
2020,144014,40,0,1,0,1
2020,144014,40,3,1,0,1
2020,144014,41,0,1,0,1
2020,144014,41,3,1,0,1
2020,144014,44,0,1,0,1
2020,144014,44,3,1,0,1
2020,144050,0,0,2376,1462,914
2020,144050,10,0,2376,1462,914
2020,144050,10,1,870,656,214
2020,144050,10,2,483,278,205
2020,144050,10,3,596,321,275
2020,144050,10,4,103,55,48
2020,144050,10,5,232,102,130
2020,144050,10,6,92,50,42
2020,144050,20,0,869,634,235
2020,144050,20,1,656,501,155
2020,144050,20,2,213,133,80
2020,144050,30,0,313,190,123
2020,144050,30,1,1,1,0
2020,144050,30,2,35,22,13
2020,144050,30,3,277,167,110
2020,144050,40,0,1194,638,556
2020,144050,40,1,213,154,59
2020,144050,40,2,235,123,112
2020,144050,40,3,319,154,165
2020,144050,40,4,103,55,48
2020,144050,40,5,232,102,130
2020,144050,40,6,92,50,42
2020,144050,41,0,1114,600,514
2020,144050,41,1,205,148,57
2020,144050,41,2,230,120,110
2020,144050,41,3,316,152,164
2020,144050,41,4,81,46,35
2020,144050,41,5,207,91,116
2020,144050,41,6,75,43,32
2020,144050,42,0,64,28,36
2020,144050,42,1,3,3,0
2020,144050,42,2,1,0,1
2020,144050,42,3,2,1,1
2020,144050,42,4,21,8,13
2020,144050,42,5,21,10,11
2020,144050,42,6,16,6,10
2020,144050,43,0,16,10,6
2020,144050,43,1,5,3,2
2020,144050,43,2,4,3,1
2020,144050,43,3,1,1,0
2020,144050,43,4,1,1,0
2020,144050,43,5,4,1,3
2020,144050,43,6,1,1,0
2020,144050,44,0,1090,585,505
2020,144050,44,1,202,145,57
2020,144050,44,2,230,120,110
2020,144050,44,3,316,152,164
2020,144050,44,4,81,46,35
2020,144050,44,5,186,79,107
2020,144050,44,6,75,43,32
2020,144050,45,0,24,15,9
2020,144050,45,1,3,3,0
2020,144050,45,5,21,12,9
2020,144157,0,0,65,31,34
2020,144157,10,0,65,31,34
2020,144157,10,1,4,2,2
2020,144157,10,2,12,4,8
2020,144157,10,3,22,6,16
2020,144157,10,4,18,13,5
2020,144157,10,6,9,6,3
2020,144157,20,0,53,23,30
2020,144157,20,1,4,2,2
2020,144157,20,2,12,4,8
2020,144157,20,3,22,6,16
2020,144157,20,4,15,11,4
2020,144157,30,0,3,2,1
2020,144157,30,4,3,2,1
2020,144157,40,0,9,6,3
2020,144157,40,6,9,6,3
2020,144157,42,0,9,6,3
2020,144157,42,6,9,6,3
2020,144166,0,0,114,35,79
2020,144166,10,0,114,35,79
2020,144166,10,1,4,1,3
2020,144166,10,2,10,2,8
2020,144166,10,3,34,9,25
2020,144166,10,4,66,23,43
2020,144166,20,0,93,29,64
2020,144166,20,1,4,1,3
2020,144166,20,2,10,2,8
2020,144166,20,3,34,9,25
2020,144166,20,4,45,17,28
2020,144166,30,0,21,6,15
2020,144166,30,4,21,6,15
2020,144175,0,0,44,19,25
2020,144175,10,0,44,19,25
2020,144175,10,1,3,1,2
2020,144175,10,2,10,3,7
2020,144175,10,3,21,6,15
2020,144175,10,4,10,9,1
2020,144175,20,0,43,18,25
2020,144175,20,1,3,1,2
2020,144175,20,2,10,3,7
2020,144175,20,3,21,6,15
2020,144175,20,4,9,8,1
2020,144175,30,0,1,1,0
2020,144175,30,4,1,1,0
2020,144184,0,0,64,31,33
2020,144184,10,0,64,31,33
2020,144184,10,1,5,4,1
2020,144184,10,2,12,5,7
2020,144184,10,3,13,7,6
2020,144184,10,4,31,14,17
2020,144184,10,6,3,1,2
2020,144184,20,0,56,28,28
2020,144184,20,1,5,4,1
2020,144184,20,2,12,5,7
2020,144184,20,3,13,7,6
2020,144184,20,4,26,12,14
2020,144184,30,0,5,2,3
2020,144184,30,4,5,2,3
2020,144184,40,0,3,1,2
2020,144184,40,6,3,1,2
2020,144184,42,0,3,1,2
2020,144184,42,6,3,1,2
2020,144193,0,0,54,26,28
2020,144193,10,0,54,26,28
2020,144193,10,1,4,1,3
2020,144193,10,2,12,5,7
2020,144193,10,3,12,5,7
2020,144193,10,4,26,15,11
2020,144193,20,0,49,22,27
2020,144193,20,1,4,1,3
2020,144193,20,2,12,5,7
2020,144193,20,3,12,5,7
2020,144193,20,4,21,11,10
2020,144193,30,0,5,4,1
2020,144193,30,4,5,4,1
2020,144209,0,0,100,42,58
2020,144209,10,0,100,42,58
2020,144209,10,1,13,7,6
2020,144209,10,2,28,9,19
2020,144209,10,3,38,18,20
2020,144209,10,4,21,8,13
2020,144209,20,0,97,42,55
2020,144209,20,1,13,7,6
2020,144209,20,2,28,9,19
2020,144209,20,3,38,18,20
2020,144209,20,4,18,8,10
2020,144209,30,0,3,0,3
2020,144209,30,4,3,0,3
2020,144218,0,0,85,38,47
2020,144218,10,0,85,38,47
2020,144218,10,1,19,5,14
2020,144218,10,2,26,13,13
2020,144218,10,3,24,11,13
2020,144218,10,4,16,9,7
2020,144218,20,0,81,37,44
2020,144218,20,1,19,5,14
2020,144218,20,2,26,13,13
2020,144218,20,3,24,11,13
2020,144218,20,4,12,8,4
2020,144218,30,0,4,1,3
2020,144218,30,4,4,1,3
2020,144281,0,0,260,142,118
2020,144281,10,0,260,142,118
2020,144281,10,1,38,22,16
2020,144281,10,2,136,75,61
2020,144281,10,3,33,18,15
2020,144281,10,5,53,27,26
2020,144281,20,0,174,97,77
2020,144281,20,1,38,22,16
2020,144281,20,2,136,75,61
2020,144281,30,0,33,18,15
2020,144281,30,3,33,18,15
2020,144281,40,0,53,27,26
2020,144281,40,5,53,27,26
2020,144281,41,0,53,27,26
2020,144281,41,5,53,27,26
2020,144281,44,0,53,27,26
2020,144281,44,5,53,27,26
2020,144351,0,0,272,123,149
2020,144351,10,0,272,123,149
2020,144351,10,1,51,24,27
2020,144351,10,2,58,23,35
2020,144351,10,3,42,16,26
2020,144351,10,4,121,60,61
2020,144351,20,0,53,25,28
2020,144351,20,1,42,19,23
2020,144351,20,2,11,6,5
2020,144351,30,0,77,32,45
2020,144351,30,1,8,4,4
2020,144351,30,2,39,15,24
2020,144351,30,3,30,13,17
2020,144351,40,0,142,66,76
2020,144351,40,1,1,1,0
2020,144351,40,2,8,2,6
2020,144351,40,3,12,3,9
2020,144351,40,4,121,60,61
2020,144351,41,0,1,0,1
2020,144351,41,3,1,0,1
2020,144351,42,0,20,6,14
2020,144351,42,1,1,1,0
2020,144351,42,2,8,2,6
2020,144351,42,3,10,3,7
2020,144351,42,4,1,0,1
2020,144351,43,0,121,60,61
2020,144351,43,3,1,0,1
2020,144351,43,4,120,60,60
2020,144351,44,0,1,0,1
2020,144351,44,3,1,0,1
2020,144485,0,0,17,13,4
2020,144485,10,0,17,13,4
2020,144485,10,4,17,13,4
2020,144485,40,0,17,13,4
2020,144485,40,4,17,13,4
2020,144485,41,0,17,13,4
2020,144485,41,4,17,13,4
2020,144485,45,0,17,13,4
2020,144485,45,4,17,13,4
2020,144564,0,0,61,27,34
2020,144564,10,0,61,27,34
2020,144564,10,1,27,11,16
2020,144564,10,4,29,13,16
2020,144564,10,6,5,3,2
2020,144564,20,0,46,21,25
2020,144564,20,1,23,10,13
2020,144564,20,4,20,9,11
2020,144564,20,6,3,2,1
2020,144564,30,0,14,6,8
2020,144564,30,1,4,1,3
2020,144564,30,4,8,4,4
2020,144564,30,6,2,1,1
2020,144564,40,0,1,0,1
2020,144564,40,4,1,0,1
2020,144564,43,0,1,0,1
2020,144564,43,4,1,0,1
2020,144740,0,0,874,465,409
2020,144740,10,0,874,465,409
2020,144740,10,1,196,122,74
2020,144740,10,2,339,174,165
2020,144740,10,3,125,61,64
2020,144740,10,4,214,108,106
2020,144740,20,0,531,297,234
2020,144740,20,1,196,122,74
2020,144740,20,2,334,174,160
2020,144740,20,3,1,1,0
2020,144740,30,0,126,59,67
2020,144740,30,2,4,0,4
2020,144740,30,3,122,59,63
2020,144740,40,0,217,109,108
2020,144740,40,2,1,0,1
2020,144740,40,3,2,1,1
2020,144740,40,4,214,108,106
2020,144740,41,0,16,8,8
2020,144740,41,4,16,8,8
2020,144740,42,0,201,101,100
2020,144740,42,2,1,0,1
2020,144740,42,3,2,1,1
2020,144740,42,4,198,100,98
2020,144740,44,0,16,8,8
2020,144740,44,4,16,8,8
2020,144865,0,0,267,129,138
2020,144865,10,0,267,129,138
2020,144865,10,1,122,66,56
2020,144865,10,2,77,40,37
2020,144865,10,3,57,19,38
2020,144865,10,4,11,4,7
2020,144865,20,0,266,129,137
2020,144865,20,1,122,66,56
2020,144865,20,2,77,40,37
2020,144865,20,3,56,19,37
2020,144865,20,4,11,4,7
2020,144865,40,0,1,0,1
2020,144865,40,3,1,0,1
2020,144865,42,0,1,0,1
2020,144865,42,3,1,0,1
2020,144883,0,0,9,5,4
2020,144883,10,0,9,5,4
2020,144883,10,2,3,0,3
2020,144883,10,3,6,5,1
2020,144883,40,0,9,5,4
2020,144883,40,2,3,0,3
2020,144883,40,3,6,5,1
2020,144883,42,0,9,5,4
2020,144883,42,2,3,0,3
2020,144883,42,3,6,5,1
2020,144892,0,0,378,197,181
2020,144892,10,0,378,197,181
2020,144892,10,1,136,77,59
2020,144892,10,2,71,40,31
2020,144892,10,3,56,24,32
2020,144892,10,4,115,56,59
2020,144892,20,0,210,119,91
2020,144892,20,1,136,77,59
2020,144892,20,2,71,40,31
2020,144892,20,3,3,2,1
2020,144892,30,0,52,22,30
2020,144892,30,3,51,21,30
2020,144892,30,4,1,1,0
2020,144892,40,0,116,56,60
2020,144892,40,3,2,1,1
2020,144892,40,4,114,55,59
2020,144892,41,0,39,16,23
2020,144892,41,4,39,16,23
2020,144892,42,0,61,32,29
2020,144892,42,3,1,1,0
2020,144892,42,4,60,31,29
2020,144892,43,0,16,8,8
2020,144892,43,3,1,0,1
2020,144892,43,4,15,8,7
2020,144892,44,0,39,16,23
2020,144892,44,4,39,16,23
2020,144944,0,0,133,65,68
2020,144944,10,0,133,65,68
2020,144944,10,1,60,26,34
2020,144944,10,2,30,18,12
2020,144944,10,3,23,12,11
2020,144944,10,4,20,9,11
2020,144944,20,0,105,52,53
2020,144944,20,1,60,26,34
2020,144944,20,2,29,17,12
2020,144944,20,3,13,8,5
2020,144944,20,4,3,1,2
2020,144944,30,0,27,12,15
2020,144944,30,2,1,1,0
2020,144944,30,3,10,4,6
2020,144944,30,4,16,7,9
2020,144944,40,0,1,1,0
2020,144944,40,4,1,1,0
2020,144944,42,0,1,1,0
2020,144944,42,4,1,1,0
2020,144962,0,0,158,62,96
2020,144962,10,0,158,62,96
2020,144962,10,1,56,24,32
2020,144962,10,2,33,13,20
2020,144962,10,3,47,17,30
2020,144962,10,4,1,0,1
2020,144962,10,5,16,6,10
2020,144962,10,6,5,2,3
2020,144962,20,0,86,36,50
2020,144962,20,1,56,24,32
2020,144962,20,2,28,11,17
2020,144962,20,3,2,1,1
2020,144962,30,0,31,13,18
2020,144962,30,3,27,11,16
2020,144962,30,4,1,0,1
2020,144962,30,5,1,1,0
2020,144962,30,6,2,1,1
2020,144962,40,0,41,13,28
2020,144962,40,2,5,2,3
2020,144962,40,3,18,5,13
2020,144962,40,5,15,5,10
2020,144962,40,6,3,1,2
2020,144962,42,0,41,13,28
2020,144962,42,2,5,2,3
2020,144962,42,3,18,5,13
2020,144962,42,5,15,5,10
2020,144962,42,6,3,1,2
2020,144971,0,0,34,17,17
2020,144971,10,0,34,17,17
2020,144971,10,1,7,4,3
2020,144971,10,2,11,5,6
2020,144971,10,3,16,8,8
2020,144971,20,0,14,7,7
2020,144971,20,1,7,4,3
2020,144971,20,2,7,3,4
2020,144971,30,0,12,5,7
2020,144971,30,2,2,1,1
2020,144971,30,3,10,4,6
2020,144971,40,0,8,5,3
2020,144971,40,2,2,1,1
2020,144971,40,3,6,4,2
2020,144971,42,0,8,5,3
2020,144971,42,2,2,1,1
2020,144971,42,3,6,4,2
2020,145239,0,0,26,1,25
2020,145239,10,0,26,1,25
2020,145239,10,4,26,1,25
2020,145239,40,0,26,1,25
2020,145239,40,4,26,1,25
2020,145239,41,0,26,1,25
2020,145239,41,4,26,1,25
2020,145239,45,0,26,1,25
2020,145239,45,4,26,1,25
2020,145275,0,0,27,17,10
2020,145275,10,0,27,17,10
2020,145275,10,1,11,7,4
2020,145275,10,2,11,7,4
2020,145275,10,3,4,2,2
2020,145275,10,4,1,1,0
2020,145275,20,0,11,5,6
2020,145275,20,1,8,4,4
2020,145275,20,2,3,1,2
2020,145275,30,0,4,3,1
2020,145275,30,1,1,1,0
2020,145275,30,3,3,2,1
2020,145275,40,0,12,9,3
2020,145275,40,1,2,2,0
2020,145275,40,2,8,6,2
2020,145275,40,3,1,0,1
2020,145275,40,4,1,1,0
2020,145275,41,0,12,9,3
2020,145275,41,1,2,2,0
2020,145275,41,2,8,6,2
2020,145275,41,3,1,0,1
2020,145275,41,4,1,1,0
2020,145275,44,0,12,9,3
2020,145275,44,1,2,2,0
2020,145275,44,2,8,6,2
2020,145275,44,3,1,0,1
2020,145275,44,4,1,1,0
2020,145336,0,0,241,101,140
2020,145336,10,0,241,101,140
2020,145336,10,1,32,18,14
2020,145336,10,2,72,32,40
2020,145336,10,3,68,22,46
2020,145336,10,4,1,0,1
2020,145336,10,5,58,23,35
2020,145336,10,6,10,6,4
2020,145336,20,0,80,42,38
2020,145336,20,1,32,18,14
2020,145336,20,2,48,24,24
2020,145336,30,0,93,30,63
2020,145336,30,2,24,8,16
2020,145336,30,3,68,22,46
2020,145336,30,4,1,0,1
2020,145336,40,0,68,29,39
2020,145336,40,5,58,23,35
2020,145336,40,6,10,6,4
2020,145336,42,0,68,29,39
2020,145336,42,5,58,23,35
2020,145336,42,6,10,6,4
2020,145372,0,0,51,34,17
2020,145372,10,0,51,34,17
2020,145372,10,1,8,7,1
2020,145372,10,2,11,7,4
2020,145372,10,3,26,18,8
2020,145372,10,4,5,2,3
2020,145372,10,6,1,0,1
2020,145372,20,0,22,16,6
2020,145372,20,1,8,7,1
2020,145372,20,2,9,6,3
2020,145372,20,3,5,3,2
2020,145372,30,0,17,12,5
2020,145372,30,3,16,12,4
2020,145372,30,4,1,0,1
2020,145372,40,0,12,6,6
2020,145372,40,2,2,1,1
2020,145372,40,3,5,3,2
2020,145372,40,4,4,2,2
2020,145372,40,6,1,0,1
2020,145372,42,0,7,3,4
2020,145372,42,2,1,0,1
2020,145372,42,3,2,1,1
2020,145372,42,4,3,2,1
2020,145372,42,6,1,0,1
2020,145372,43,0,5,3,2
2020,145372,43,2,1,1,0
2020,145372,43,3,3,2,1
2020,145372,43,4,1,0,1
2020,145497,0,0,14,9,5
2020,145497,10,0,14,9,5
2020,145497,10,1,1,1,0
2020,145497,10,2,3,0,3
2020,145497,10,3,10,8,2
2020,145497,40,0,14,9,5
2020,145497,40,1,1,1,0
2020,145497,40,2,3,0,3
2020,145497,40,3,10,8,2
2020,145497,42,0,14,9,5
2020,145497,42,1,1,1,0
2020,145497,42,2,3,0,3
2020,145497,42,3,10,8,2
2020,145521,0,0,51,24,27
2020,145521,10,0,51,24,27
2020,145521,10,6,51,24,27
2020,145521,20,0,38,18,20
2020,145521,20,6,38,18,20
2020,145521,30,0,13,6,7
2020,145521,30,6,13,6,7
2020,145558,0,0,172,92,80
2020,145558,10,0,166,90,76
2020,145558,10,1,36,24,12
2020,145558,10,2,46,27,19
2020,145558,10,3,69,33,36
2020,145558,10,4,14,6,8
2020,145558,10,5,1,0,1
2020,145558,20,0,34,23,11
2020,145558,20,1,30,20,10
2020,145558,20,2,4,3,1
2020,145558,30,0,64,38,26
2020,145558,30,1,2,1,1
2020,145558,30,2,24,18,6
2020,145558,30,3,32,17,15
2020,145558,30,4,6,2,4
2020,145558,40,0,68,29,39
2020,145558,40,1,4,3,1
2020,145558,40,2,18,6,12
2020,145558,40,3,37,16,21
2020,145558,40,4,8,4,4
2020,145558,40,5,1,0,1
2020,145558,41,0,21,10,11
2020,145558,41,1,1,1,0
2020,145558,41,2,11,4,7
2020,145558,41,3,8,5,3
2020,145558,41,4,1,0,1
2020,145558,42,0,47,19,28
2020,145558,42,1,3,2,1
2020,145558,42,2,7,2,5
2020,145558,42,3,29,11,18
2020,145558,42,4,7,4,3
2020,145558,42,5,1,0,1
2020,145558,44,0,21,10,11
2020,145558,44,1,1,1,0
2020,145558,44,2,11,4,7
2020,145558,44,3,8,5,3
2020,145558,44,4,1,0,1
2020,145558,50,0,6,2,4
2020,145600,0,0,2250,1171,1079
2020,145600,10,0,2250,1171,1079
2020,145600,10,1,573,381,192
2020,145600,10,2,609,308,301
2020,145600,10,3,748,353,395
2020,145600,10,4,138,47,91
2020,145600,10,5,169,80,89
2020,145600,10,6,13,2,11
2020,145600,20,0,940,573,367
2020,145600,20,1,505,346,159
2020,145600,20,2,433,225,208
2020,145600,20,3,1,1,0
2020,145600,20,6,1,1,0
2020,145600,30,0,392,215,177
2020,145600,30,1,14,10,4
2020,145600,30,2,45,23,22
2020,145600,30,3,333,182,151
2020,145600,40,0,918,383,535
2020,145600,40,1,54,25,29
2020,145600,40,2,131,60,71
2020,145600,40,3,414,170,244
2020,145600,40,4,138,47,91
2020,145600,40,5,169,80,89
2020,145600,40,6,12,1,11
2020,145600,41,0,292,124,168
2020,145600,41,1,29,12,17
2020,145600,41,2,82,38,44
2020,145600,41,3,105,40,65
2020,145600,41,4,8,0,8
2020,145600,41,5,68,34,34
2020,145600,42,0,625,258,367
2020,145600,42,1,25,13,12
2020,145600,42,2,49,22,27
2020,145600,42,3,309,130,179
2020,145600,42,4,130,47,83
2020,145600,42,5,100,45,55
2020,145600,42,6,12,1,11
2020,145600,43,0,1,1,0
2020,145600,43,5,1,1,0
2020,145600,44,0,292,124,168
2020,145600,44,1,29,12,17
2020,145600,44,2,82,38,44
2020,145600,44,3,105,40,65
2020,145600,44,4,8,0,8
2020,145600,44,5,68,34,34
2020,145619,0,0,141,68,73
2020,145619,10,0,141,68,73
2020,145619,10,1,48,27,21
2020,145619,10,2,35,15,20
2020,145619,10,3,47,20,27
2020,145619,10,4,11,6,5
2020,145619,20,0,71,37,34
2020,145619,20,1,47,27,20
2020,145619,20,2,24,10,14
2020,145619,30,0,38,15,23
2020,145619,30,2,8,3,5
2020,145619,30,3,30,12,18
2020,145619,40,0,32,16,16
2020,145619,40,1,1,0,1
2020,145619,40,2,3,2,1
2020,145619,40,3,17,8,9
2020,145619,40,4,11,6,5
2020,145619,42,0,32,16,16
2020,145619,42,1,1,0,1
2020,145619,42,2,3,2,1
2020,145619,42,3,17,8,9
2020,145619,42,4,11,6,5
2020,145628,0,0,49,11,38
2020,145628,10,0,48,11,37
2020,145628,10,1,5,1,4
2020,145628,10,2,26,9,17
2020,145628,10,3,15,1,14
2020,145628,10,4,2,0,2
2020,145628,20,0,32,11,21
2020,145628,20,1,5,1,4
2020,145628,20,2,23,9,14
2020,145628,20,3,2,1,1
2020,145628,20,4,2,0,2
2020,145628,30,0,16,0,16
2020,145628,30,2,3,0,3
2020,145628,30,3,13,0,13
2020,145628,50,0,1,0,1
2020,145637,0,0,2434,1469,965
2020,145637,10,0,2434,1469,965
2020,145637,10,1,869,631,238
2020,145637,10,2,543,305,238
2020,145637,10,3,727,386,341
2020,145637,10,4,90,44,46
2020,145637,10,5,174,86,88
2020,145637,10,6,31,17,14
2020,145637,20,0,1301,879,422
2020,145637,20,1,840,618,222
2020,145637,20,2,458,260,198
2020,145637,20,3,3,1,2
2020,145637,30,0,521,290,231
2020,145637,30,1,1,1,0
2020,145637,30,2,6,4,2
2020,145637,30,3,514,285,229
2020,145637,40,0,612,300,312
2020,145637,40,1,28,12,16
2020,145637,40,2,79,41,38
2020,145637,40,3,210,100,110
2020,145637,40,4,90,44,46
2020,145637,40,5,174,86,88
2020,145637,40,6,31,17,14
2020,145637,41,0,89,46,43
2020,145637,41,1,22,8,14
2020,145637,41,2,46,24,22
2020,145637,41,3,16,11,5
2020,145637,41,5,5,3,2
2020,145637,42,0,523,254,269
2020,145637,42,1,6,4,2
2020,145637,42,2,33,17,16
2020,145637,42,3,194,89,105
2020,145637,42,4,90,44,46
2020,145637,42,5,169,83,86
2020,145637,42,6,31,17,14
2020,145637,44,0,89,46,43
2020,145637,44,1,22,8,14
2020,145637,44,2,46,24,22
2020,145637,44,3,16,11,5
2020,145637,44,5,5,3,2
2020,145646,0,0,119,67,52
2020,145646,10,0,119,67,52
2020,145646,10,1,44,32,12
2020,145646,10,2,48,22,26
2020,145646,10,3,22,10,12
2020,145646,10,4,5,3,2
2020,145646,20,0,90,51,39
2020,145646,20,1,41,29,12
2020,145646,20,2,46,21,25
2020,145646,20,3,3,1,2
2020,145646,30,0,20,9,11
2020,145646,30,1,1,1,0
2020,145646,30,2,1,1,0
2020,145646,30,3,17,7,10
2020,145646,30,4,1,0,1
2020,145646,40,0,9,7,2
2020,145646,40,1,2,2,0
2020,145646,40,2,1,0,1
2020,145646,40,3,2,2,0
2020,145646,40,4,4,3,1
2020,145646,42,0,9,7,2
2020,145646,42,1,2,2,0
2020,145646,42,2,1,0,1
2020,145646,42,3,2,2,0
2020,145646,42,4,4,3,1
2020,145682,0,0,167,79,88
2020,145682,10,0,167,79,88
2020,145682,10,1,110,48,62
2020,145682,10,2,18,10,8
2020,145682,10,3,19,13,6
2020,145682,10,4,20,8,12
2020,145682,20,0,146,71,75
2020,145682,20,1,110,48,62
2020,145682,20,2,18,10,8
2020,145682,20,3,16,12,4
2020,145682,20,4,2,1,1
2020,145682,30,0,18,7,11
2020,145682,30,3,3,1,2
2020,145682,30,4,15,6,9
2020,145682,40,0,3,1,2
2020,145682,40,4,3,1,2
2020,145682,42,0,3,1,2
2020,145682,42,4,3,1,2
2020,145691,0,0,78,38,40
2020,145691,10,0,78,38,40
2020,145691,10,1,19,12,7
2020,145691,10,2,19,11,8
2020,145691,10,3,30,11,19
2020,145691,10,4,10,4,6
2020,145691,20,0,37,23,14
2020,145691,20,1,19,12,7
2020,145691,20,2,18,11,7
2020,145691,30,0,16,7,9
2020,145691,30,3,13,6,7
2020,145691,30,4,3,1,2
2020,145691,40,0,25,8,17
2020,145691,40,2,1,0,1
2020,145691,40,3,17,5,12
2020,145691,40,4,7,3,4
2020,145691,41,0,21,6,15
2020,145691,41,2,1,0,1
2020,145691,41,3,14,3,11
2020,145691,41,4,6,3,3
2020,145691,42,0,3,2,1
2020,145691,42,3,3,2,1
2020,145691,43,0,1,0,1
2020,145691,43,4,1,0,1
2020,145691,44,0,21,6,15
2020,145691,44,2,1,0,1
2020,145691,44,3,14,3,11
2020,145691,44,4,6,3,3
2020,145707,0,0,41,13,28
2020,145707,10,0,41,13,28
2020,145707,10,1,7,4,3
2020,145707,10,2,6,1,5
2020,145707,10,3,12,5,7
2020,145707,10,4,16,3,13
2020,145707,20,0,26,11,15
2020,145707,20,1,7,4,3
2020,145707,20,2,6,1,5
2020,145707,20,3,12,5,7
2020,145707,20,4,1,1,0
2020,145707,30,0,15,2,13
2020,145707,30,4,15,2,13
2020,145725,0,0,387,275,112
2020,145725,10,0,387,275,112
2020,145725,10,1,151,121,30
2020,145725,10,2,100,70,30
2020,145725,10,3,67,44,23
2020,145725,10,4,11,6,5
2020,145725,10,5,51,31,20
2020,145725,10,6,7,3,4
2020,145725,20,0,210,162,48
2020,145725,20,1,125,103,22
2020,145725,20,2,85,59,26
2020,145725,30,0,43,32,11
2020,145725,30,2,1,0,1
2020,145725,30,3,42,32,10
2020,145725,40,0,134,81,53
2020,145725,40,1,26,18,8
2020,145725,40,2,14,11,3
2020,145725,40,3,25,12,13
2020,145725,40,4,11,6,5
2020,145725,40,5,51,31,20
2020,145725,40,6,7,3,4
2020,145725,42,0,134,81,53
2020,145725,42,1,26,18,8
2020,145725,42,2,14,11,3
2020,145725,42,3,25,12,13
2020,145725,42,4,11,6,5
2020,145725,42,5,51,31,20
2020,145725,42,6,7,3,4
2020,145813,0,0,915,431,484
2020,145813,10,0,915,431,484
2020,145813,10,1,257,154,103
2020,145813,10,2,228,114,114
2020,145813,10,3,203,92,111
2020,145813,10,5,227,71,156
2020,145813,20,0,481,266,215
2020,145813,20,1,257,154,103
2020,145813,20,2,221,110,111
2020,145813,20,3,3,2,1
2020,145813,30,0,207,94,113
2020,145813,30,2,7,4,3
2020,145813,30,3,200,90,110
2020,145813,40,0,227,71,156
2020,145813,40,5,227,71,156
2020,145813,42,0,207,61,146
2020,145813,42,5,207,61,146
2020,145813,43,0,20,10,10
2020,145813,43,5,20,10,10
2020,145831,0,0,76,37,39
2020,145831,10,0,76,37,39
2020,145831,10,4,76,37,39
2020,145831,20,0,62,29,33
2020,145831,20,4,62,29,33
2020,145831,30,0,14,8,6
2020,145831,30,4,14,8,6
2020,146205,0,0,71,31,40
2020,146205,10,0,71,31,40
2020,146205,10,1,11,4,7
2020,146205,10,2,9,3,6
2020,146205,10,3,30,13,17
2020,146205,10,4,21,11,10
2020,146205,20,0,50,20,30
2020,146205,20,1,11,4,7
2020,146205,20,2,9,3,6
2020,146205,20,3,30,13,17
2020,146205,30,0,21,11,10
2020,146205,30,4,21,11,10
2020,146278,0,0,47,26,21
2020,146278,10,0,47,26,21
2020,146278,10,1,7,5,2
2020,146278,10,2,2,2,0
2020,146278,10,3,24,11,13
2020,146278,10,4,10,7,3
2020,146278,10,6,4,1,3
2020,146278,20,0,28,17,11
2020,146278,20,1,7,5,2
2020,146278,20,2,2,2,0
2020,146278,20,3,19,10,9
2020,146278,30,0,16,7,9
2020,146278,30,3,5,1,4
2020,146278,30,4,7,5,2
2020,146278,30,6,4,1,3
2020,146278,40,0,3,2,1
2020,146278,40,4,3,2,1
2020,146278,42,0,3,2,1
2020,146278,42,4,3,2,1
2020,146296,0,0,208,98,110
2020,146296,10,0,208,98,110
2020,146296,10,6,208,98,110
2020,146296,20,0,200,94,106
2020,146296,20,6,200,94,106
2020,146296,30,0,8,4,4
2020,146296,30,6,8,4,4
2020,146339,0,0,49,28,21
2020,146339,10,0,49,28,21
2020,146339,10,1,21,12,9
2020,146339,10,2,9,6,3
2020,146339,10,3,19,10,9
2020,146339,20,0,19,11,8
2020,146339,20,1,18,11,7
2020,146339,20,2,1,0,1
2020,146339,30,0,12,7,5
2020,146339,30,2,4,3,1
2020,146339,30,3,8,4,4
2020,146339,40,0,18,10,8
2020,146339,40,1,3,1,2
2020,146339,40,2,4,3,1
2020,146339,40,3,11,6,5
2020,146339,42,0,18,10,8
2020,146339,42,1,3,1,2
2020,146339,42,2,4,3,1
2020,146339,42,3,11,6,5
2020,146348,0,0,63,22,41
2020,146348,10,0,63,22,41
2020,146348,10,1,55,20,35
2020,146348,10,3,7,2,5
2020,146348,10,6,1,0,1
2020,146348,20,0,54,19,35
2020,146348,20,1,54,19,35
2020,146348,30,0,9,3,6
2020,146348,30,1,1,1,0
2020,146348,30,3,7,2,5
2020,146348,30,6,1,0,1
2020,146366,0,0,68,33,35
2020,146366,10,0,68,33,35
2020,146366,10,1,26,13,13
2020,146366,10,2,12,4,8
2020,146366,10,3,30,16,14
2020,146366,20,0,56,27,29
2020,146366,20,1,26,13,13
2020,146366,20,2,12,4,8
2020,146366,20,3,18,10,8
2020,146366,30,0,12,6,6
2020,146366,30,3,12,6,6
2020,146418,0,0,56,27,29
2020,146418,10,0,56,27,29
2020,146418,10,6,56,27,29
2020,146418,20,0,55,26,29
2020,146418,20,6,55,26,29
2020,146418,30,0,1,1,0
2020,146418,30,6,1,1,0
2020,146427,0,0,105,62,43
2020,146427,10,0,105,62,43
2020,146427,10,1,31,18,13
2020,146427,10,2,38,24,14
2020,146427,10,3,28,17,11
2020,146427,10,4,8,3,5
2020,146427,20,0,72,44,28
2020,146427,20,1,31,18,13
2020,146427,20,2,38,24,14
2020,146427,20,3,3,2,1
2020,146427,30,0,18,11,7
2020,146427,30,3,18,11,7
2020,146427,40,0,15,7,8
2020,146427,40,3,7,4,3
2020,146427,40,4,8,3,5
2020,146427,41,0,9,6,3
2020,146427,41,3,5,4,1
2020,146427,41,4,4,2,2
2020,146427,42,0,4,1,3
2020,146427,42,3,1,0,1
2020,146427,42,4,3,1,2
2020,146427,43,0,2,0,2
2020,146427,43,3,1,0,1
2020,146427,43,4,1,0,1
2020,146427,44,0,4,2,2
2020,146427,44,3,3,2,1
2020,146427,44,4,1,0,1
2020,146427,45,0,5,4,1
2020,146427,45,3,2,2,0
2020,146427,45,4,3,2,1
2020,146472,0,0,206,98,108
2020,146472,10,0,206,98,108
2020,146472,10,4,206,98,108
2020,146472,20,0,162,76,86
2020,146472,20,4,162,76,86
2020,146472,30,0,39,20,19
2020,146472,30,4,39,20,19
2020,146472,40,0,5,2,3
2020,146472,40,4,5,2,3
2020,146472,41,0,5,2,3
2020,146472,41,4,5,2,3
2020,146472,44,0,5,2,3
2020,146472,44,4,5,2,3
2020,146481,0,0,104,53,51
2020,146481,10,0,104,53,51
2020,146481,10,1,27,19,8
2020,146481,10,2,26,14,12
2020,146481,10,3,39,14,25
2020,146481,10,5,11,5,6
2020,146481,10,6,1,1,0
2020,146481,20,0,53,33,20
2020,146481,20,1,27,19,8
2020,146481,20,2,26,14,12
2020,146481,30,0,33,12,21
2020,146481,30,3,33,12,21
2020,146481,40,0,18,8,10
2020,146481,40,3,6,2,4
2020,146481,40,5,11,5,6
2020,146481,40,6,1,1,0
2020,146481,41,0,16,7,9
2020,146481,41,3,6,2,4
2020,146481,41,5,9,4,5
2020,146481,41,6,1,1,0
2020,146481,42,0,2,1,1
2020,146481,42,5,2,1,1
2020,146481,44,0,6,3,3
2020,146481,44,5,5,2,3
2020,146481,44,6,1,1,0
2020,146481,45,0,10,4,6
2020,146481,45,3,6,2,4
2020,146481,45,5,4,2,2
2020,146490,0,0,2,1,1
2020,146490,10,0,2,1,1
2020,146490,10,6,2,1,1
2020,146490,40,0,2,1,1
2020,146490,40,6,2,1,1
2020,146490,41,0,2,1,1
2020,146490,41,6,2,1,1
2020,146490,45,0,2,1,1
2020,146490,45,6,2,1,1
2020,146506,0,0,98,43,55
2020,146506,10,0,98,43,55
2020,146506,10,6,98,43,55
2020,146506,20,0,85,40,45
2020,146506,20,6,85,40,45
2020,146506,30,0,13,3,10
2020,146506,30,6,13,3,10
2020,146533,0,0,16,0,16
2020,146533,10,0,16,0,16
2020,146533,10,2,2,0,2
2020,146533,10,3,2,0,2
2020,146533,10,4,12,0,12
2020,146533,40,0,16,0,16
2020,146533,40,2,2,0,2
2020,146533,40,3,2,0,2
2020,146533,40,4,12,0,12
2020,146533,42,0,16,0,16
2020,146533,42,2,2,0,2
2020,146533,42,3,2,0,2
2020,146533,42,4,12,0,12
2020,146603,0,0,100,41,59
2020,146603,10,0,100,41,59
2020,146603,10,1,49,19,30
2020,146603,10,2,31,10,21
2020,146603,10,3,10,7,3
2020,146603,10,4,10,5,5
2020,146603,20,0,91,39,52
2020,146603,20,1,49,19,30
2020,146603,20,2,26,9,17
2020,146603,20,3,9,7,2
2020,146603,20,4,7,4,3
2020,146603,30,0,9,2,7
2020,146603,30,2,5,1,4
2020,146603,30,3,1,0,1
2020,146603,30,4,3,1,2
2020,146612,0,0,224,101,123
2020,146612,10,0,224,101,123
2020,146612,10,1,49,27,22
2020,146612,10,2,69,30,39
2020,146612,10,3,89,37,52
2020,146612,10,4,17,7,10
2020,146612,20,0,83,42,41
2020,146612,20,1,47,25,22
2020,146612,20,2,36,17,19
2020,146612,30,0,57,21,36
2020,146612,30,1,1,1,0
2020,146612,30,2,20,6,14
2020,146612,30,3,36,14,22
2020,146612,40,0,84,38,46
2020,146612,40,1,1,1,0
2020,146612,40,2,13,7,6
2020,146612,40,3,53,23,30
2020,146612,40,4,17,7,10
2020,146612,42,0,84,38,46
2020,146612,42,1,1,1,0
2020,146612,42,2,13,7,6
2020,146612,42,3,53,23,30
2020,146612,42,4,17,7,10
2020,146667,0,0,22,16,6
2020,146667,10,0,21,16,5
2020,146667,10,1,14,12,2
2020,146667,10,2,3,2,1
2020,146667,10,3,4,2,2
2020,146667,40,0,21,16,5
2020,146667,40,1,14,12,2
2020,146667,40,2,3,2,1
2020,146667,40,3,4,2,2
2020,146667,42,0,21,16,5
2020,146667,42,1,14,12,2
2020,146667,42,2,3,2,1
2020,146667,42,3,4,2,2
2020,146667,50,0,1,0,1
2020,146676,0,0,30,15,15
2020,146676,10,0,30,15,15
2020,146676,10,2,14,8,6
2020,146676,10,3,16,7,9
2020,146676,20,0,13,7,6
2020,146676,20,2,11,6,5
2020,146676,20,3,2,1,1
2020,146676,30,0,16,7,9
2020,146676,30,2,3,2,1
2020,146676,30,3,13,5,8
2020,146676,40,0,1,1,0
2020,146676,40,3,1,1,0
2020,146676,41,0,1,1,0
2020,146676,41,3,1,1,0
2020,146676,44,0,1,1,0
2020,146676,44,3,1,1,0
2020,146685,0,0,118,53,65
2020,146685,10,0,118,53,65
2020,146685,10,1,79,39,40
2020,146685,10,2,5,0,5
2020,146685,10,3,20,8,12
2020,146685,10,4,14,6,8
2020,146685,20,0,94,43,51
2020,146685,20,1,79,39,40
2020,146685,20,2,5,0,5
2020,146685,20,3,4,2,2
2020,146685,20,4,6,2,4
2020,146685,30,0,24,10,14
2020,146685,30,3,16,6,10
2020,146685,30,4,8,4,4
2020,146700,0,0,33,27,6
2020,146700,10,0,33,27,6
2020,146700,10,4,33,27,6
2020,146700,40,0,33,27,6
2020,146700,40,4,33,27,6
2020,146700,41,0,33,27,6
2020,146700,41,4,33,27,6
2020,146700,45,0,33,27,6
2020,146700,45,4,33,27,6
2020,146719,0,0,917,463,454
2020,146719,10,0,917,463,454
2020,146719,10,1,189,119,70
2020,146719,10,2,203,109,94
2020,146719,10,3,143,71,72
2020,146719,10,4,382,164,218
2020,146719,20,0,380,220,160
2020,146719,20,1,188,119,69
2020,146719,20,2,191,101,90
2020,146719,20,3,1,0,1
2020,146719,30,0,155,79,76
2020,146719,30,1,1,0,1
2020,146719,30,2,12,8,4
2020,146719,30,3,142,71,71
2020,146719,40,0,382,164,218
2020,146719,40,4,382,164,218
2020,146719,41,0,339,136,203
2020,146719,41,4,339,136,203
2020,146719,42,0,43,28,15
2020,146719,42,4,43,28,15
2020,146719,44,0,339,136,203
2020,146719,44,4,339,136,203
2020,146728,0,0,13,6,7
2020,146728,10,0,13,6,7
2020,146728,10,1,6,2,4
2020,146728,10,2,3,3,0
2020,146728,10,3,3,1,2
2020,146728,10,4,1,0,1
2020,146728,20,0,8,4,4
2020,146728,20,1,6,2,4
2020,146728,20,2,2,2,0
2020,146728,30,0,3,1,2
2020,146728,30,3,3,1,2
2020,146728,40,0,2,1,1
2020,146728,40,2,1,1,0
2020,146728,40,4,1,0,1
2020,146728,41,0,2,1,1
2020,146728,41,2,1,1,0
2020,146728,41,4,1,0,1
2020,146728,44,0,2,1,1
2020,146728,44,2,1,1,0
2020,146728,44,4,1,0,1
2020,146755,0,0,12,0,12
2020,146755,10,0,12,0,12
2020,146755,10,1,3,0,3
2020,146755,10,2,1,0,1
2020,146755,10,3,3,0,3
2020,146755,10,4,5,0,5
2020,146755,40,0,12,0,12
2020,146755,40,1,3,0,3
2020,146755,40,2,1,0,1
2020,146755,40,3,3,0,3
2020,146755,40,4,5,0,5
2020,146755,42,0,12,0,12
2020,146755,42,1,3,0,3
2020,146755,42,2,1,0,1
2020,146755,42,3,3,0,3
2020,146755,42,4,5,0,5
2020,146816,0,0,8,3,5
2020,146816,10,0,8,3,5
2020,146816,10,2,2,1,1
2020,146816,10,3,6,2,4
2020,146816,40,0,8,3,5
2020,146816,40,2,2,1,1
2020,146816,40,3,6,2,4
2020,146816,42,0,8,3,5
2020,146816,42,2,2,1,1
2020,146816,42,3,6,2,4
2020,146977,0,0,12,5,7
2020,146977,10,0,12,5,7
2020,146977,10,1,5,3,2
2020,146977,10,2,3,1,2
2020,146977,10,3,3,0,3
2020,146977,10,6,1,1,0
2020,146977,20,0,7,4,3
2020,146977,20,1,5,3,2
2020,146977,20,2,2,1,1
2020,146977,30,0,2,0,2
2020,146977,30,3,2,0,2
2020,146977,40,0,3,1,2
2020,146977,40,2,1,0,1
2020,146977,40,3,1,0,1
2020,146977,40,6,1,1,0
2020,146977,41,0,3,1,2
2020,146977,41,2,1,0,1
2020,146977,41,3,1,0,1
2020,146977,41,6,1,1,0
2020,146977,44,0,2,0,2
2020,146977,44,2,1,0,1
2020,146977,44,3,1,0,1
2020,146977,45,0,1,1,0
2020,146977,45,6,1,1,0
2020,147004,0,0,89,38,51
2020,147004,10,0,89,38,51
2020,147004,10,6,89,38,51
2020,147004,20,0,80,34,46
2020,147004,20,6,80,34,46
2020,147004,30,0,9,4,5
2020,147004,30,6,9,4,5
2020,147013,0,0,83,36,47
2020,147013,10,0,83,36,47
2020,147013,10,1,27,10,17
2020,147013,10,2,24,10,14
2020,147013,10,3,24,13,11
2020,147013,10,4,8,3,5
2020,147013,20,0,52,20,32
2020,147013,20,1,27,10,17
2020,147013,20,2,22,9,13
2020,147013,20,3,3,1,2
2020,147013,30,0,21,11,10
2020,147013,30,2,2,1,1
2020,147013,30,3,18,10,8
2020,147013,30,4,1,0,1
2020,147013,40,0,10,5,5
2020,147013,40,3,3,2,1
2020,147013,40,4,7,3,4
2020,147013,42,0,3,1,2
2020,147013,42,3,2,1,1
2020,147013,42,4,1,0,1
2020,147013,43,0,7,4,3
2020,147013,43,3,1,1,0
2020,147013,43,4,6,3,3
2020,147031,0,0,4,2,2
2020,147031,10,0,4,2,2
2020,147031,10,1,2,2,0
2020,147031,10,2,1,0,1
2020,147031,10,3,1,0,1
2020,147031,40,0,4,2,2
2020,147031,40,1,2,2,0
2020,147031,40,2,1,0,1
2020,147031,40,3,1,0,1
2020,147031,41,0,4,2,2
2020,147031,41,1,2,2,0
2020,147031,41,2,1,0,1
2020,147031,41,3,1,0,1
2020,147031,44,0,4,2,2
2020,147031,44,1,2,2,0
2020,147031,44,2,1,0,1
2020,147031,44,3,1,0,1
2020,147129,0,0,40,3,37
2020,147129,10,0,40,3,37
2020,147129,10,1,3,1,2
2020,147129,10,2,2,0,2
2020,147129,10,3,14,0,14
2020,147129,10,4,21,2,19
2020,147129,40,0,40,3,37
2020,147129,40,1,3,1,2
2020,147129,40,2,2,0,2
2020,147129,40,3,14,0,14
2020,147129,40,4,21,2,19
2020,147129,41,0,29,2,27
2020,147129,41,1,3,1,2
2020,147129,41,3,13,0,13
2020,147129,41,4,13,1,12
2020,147129,42,0,10,1,9
2020,147129,42,2,2,0,2
2020,147129,42,3,1,0,1
2020,147129,42,4,7,1,6
2020,147129,43,0,1,0,1
2020,147129,43,4,1,0,1
2020,147129,44,0,29,2,27
2020,147129,44,1,3,1,2
2020,147129,44,3,13,0,13
2020,147129,44,4,13,1,12
2020,147244,0,0,148,75,73
2020,147244,10,0,148,75,73
2020,147244,10,1,31,20,11
2020,147244,10,2,46,24,22
2020,147244,10,3,40,19,21
2020,147244,10,4,24,10,14
2020,147244,10,5,7,2,5
2020,147244,20,0,74,41,33
2020,147244,20,1,31,20,11
2020,147244,20,2,43,21,22
2020,147244,30,0,40,20,20
2020,147244,30,2,3,3,0
2020,147244,30,3,36,17,19
2020,147244,30,4,1,0,1
2020,147244,40,0,34,14,20
2020,147244,40,3,4,2,2
2020,147244,40,4,23,10,13
2020,147244,40,5,7,2,5
2020,147244,42,0,34,14,20
2020,147244,42,3,4,2,2
2020,147244,42,4,23,10,13
2020,147244,42,5,7,2,5
2020,147341,0,0,89,46,43
2020,147341,10,0,89,46,43
2020,147341,10,1,28,13,15
2020,147341,10,2,18,13,5
2020,147341,10,3,33,14,19
2020,147341,10,5,10,6,4
2020,147341,20,0,43,24,19
2020,147341,20,1,28,13,15
2020,147341,20,2,15,11,4
2020,147341,30,0,29,12,17
2020,147341,30,2,2,2,0
2020,147341,30,3,27,10,17
2020,147341,40,0,17,10,7
2020,147341,40,2,1,0,1
2020,147341,40,3,6,4,2
2020,147341,40,5,10,6,4
2020,147341,41,0,6,3,3
2020,147341,41,2,1,0,1
2020,147341,41,3,4,2,2
2020,147341,41,5,1,1,0
2020,147341,42,0,11,7,4
2020,147341,42,3,2,2,0
2020,147341,42,5,9,5,4
2020,147341,44,0,6,3,3
2020,147341,44,2,1,0,1
2020,147341,44,3,4,2,2
2020,147341,44,5,1,1,0
2020,147369,0,0,68,51,17
2020,147369,10,0,68,51,17
2020,147369,10,1,35,28,7
2020,147369,10,2,9,5,4
2020,147369,10,3,13,9,4
2020,147369,10,4,11,9,2
2020,147369,40,0,68,51,17
2020,147369,40,1,35,28,7
2020,147369,40,2,9,5,4
2020,147369,40,3,13,9,4
2020,147369,40,4,11,9,2
2020,147369,42,0,68,51,17
2020,147369,42,1,35,28,7
2020,147369,42,2,9,5,4
2020,147369,42,3,13,9,4
2020,147369,42,4,11,9,2
2020,147378,0,0,186,76,110
2020,147378,10,0,186,76,110
2020,147378,10,1,71,28,43
2020,147378,10,2,44,22,22
2020,147378,10,3,40,17,23
2020,147378,10,4,31,9,22
2020,147378,20,0,171,73,98
2020,147378,20,1,71,28,43
2020,147378,20,2,44,22,22
2020,147378,20,3,38,16,22
2020,147378,20,4,18,7,11
2020,147378,30,0,15,3,12
2020,147378,30,3,2,1,1
2020,147378,30,4,13,2,11
2020,147396,0,0,7,5,2
2020,147396,10,0,7,5,2
2020,147396,10,6,7,5,2
2020,147396,40,0,7,5,2
2020,147396,40,6,7,5,2
2020,147396,42,0,1,1,0
2020,147396,42,6,1,1,0
2020,147396,43,0,6,4,2
2020,147396,43,6,6,4,2
2020,147411,0,0,75,35,40
2020,147411,10,0,75,35,40
2020,147411,10,4,75,35,40
2020,147411,20,0,36,20,16
2020,147411,20,4,36,20,16
2020,147411,30,0,34,14,20
2020,147411,30,4,34,14,20
2020,147411,40,0,5,1,4
2020,147411,40,4,5,1,4
2020,147411,43,0,5,1,4
2020,147411,43,4,5,1,4
2020,147536,0,0,183,59,124
2020,147536,10,0,183,59,124
2020,147536,10,1,17,6,11
2020,147536,10,2,51,15,36
2020,147536,10,3,109,32,77
2020,147536,10,5,6,6,0
2020,147536,20,0,46,19,27
2020,147536,20,1,10,4,6
2020,147536,20,2,32,12,20
2020,147536,20,3,4,3,1
2020,147536,30,0,4,1,3
2020,147536,30,2,1,0,1
2020,147536,30,3,3,1,2
2020,147536,40,0,133,39,94
2020,147536,40,1,7,2,5
2020,147536,40,2,18,3,15
2020,147536,40,3,102,28,74
2020,147536,40,5,6,6,0
2020,147536,41,0,56,22,34
2020,147536,41,1,1,0,1
2020,147536,41,2,9,2,7
2020,147536,41,3,42,16,26
2020,147536,41,5,4,4,0
2020,147536,42,0,77,17,60
2020,147536,42,1,6,2,4
2020,147536,42,2,9,1,8
2020,147536,42,3,60,12,48
2020,147536,42,5,2,2,0
2020,147536,44,0,56,22,34
2020,147536,44,1,1,0,1
2020,147536,44,2,9,2,7
2020,147536,44,3,42,16,26
2020,147536,44,5,4,4,0
2020,147590,0,0,59,34,25
2020,147590,10,0,57,33,24
2020,147590,10,1,14,8,6
2020,147590,10,2,9,5,4
2020,147590,10,3,15,9,6
2020,147590,10,4,19,11,8
2020,147590,20,0,14,8,6
2020,147590,20,1,10,6,4
2020,147590,20,2,4,2,2
2020,147590,30,0,14,11,3
2020,147590,30,1,1,1,0
2020,147590,30,2,2,2,0
2020,147590,30,3,4,2,2
2020,147590,30,4,7,6,1
2020,147590,40,0,29,14,15
2020,147590,40,1,3,1,2
2020,147590,40,2,3,1,2
2020,147590,40,3,11,7,4
2020,147590,40,4,12,5,7
2020,147590,42,0,29,14,15
2020,147590,42,1,3,1,2
2020,147590,42,2,3,1,2
2020,147590,42,3,11,7,4
2020,147590,42,4,12,5,7
2020,147590,50,0,2,1,1
2020,147660,0,0,160,70,90
2020,147660,10,0,160,70,90
2020,147660,10,1,48,31,17
2020,147660,10,2,51,19,32
2020,147660,10,3,57,18,39
2020,147660,10,4,1,1,0
2020,147660,10,5,3,1,2
2020,147660,20,0,77,41,36
2020,147660,20,1,40,27,13
2020,147660,20,2,34,13,21
2020,147660,20,3,3,1,2
2020,147660,30,0,44,18,26
2020,147660,30,1,2,1,1
2020,147660,30,2,8,4,4
2020,147660,30,3,34,13,21
2020,147660,40,0,39,11,28
2020,147660,40,1,6,3,3
2020,147660,40,2,9,2,7
2020,147660,40,3,20,4,16
2020,147660,40,4,1,1,0
2020,147660,40,5,3,1,2
2020,147660,41,0,30,7,23
2020,147660,41,1,3,2,1
2020,147660,41,2,8,1,7
2020,147660,41,3,15,2,13
2020,147660,41,4,1,1,0
2020,147660,41,5,3,1,2
2020,147660,42,0,9,4,5
2020,147660,42,1,3,1,2
2020,147660,42,2,1,1,0
2020,147660,42,3,5,2,3
2020,147660,44,0,30,7,23
2020,147660,44,1,3,2,1
2020,147660,44,2,8,1,7
2020,147660,44,3,15,2,13
2020,147660,44,4,1,1,0
2020,147660,44,5,3,1,2
2020,147679,0,0,125,58,67
2020,147679,10,0,125,58,67
2020,147679,10,1,59,33,26
2020,147679,10,2,39,16,23
2020,147679,10,3,24,7,17
2020,147679,10,4,1,1,0
2020,147679,10,6,2,1,1
2020,147679,20,0,63,33,30
2020,147679,20,1,51,27,24
2020,147679,20,2,12,6,6
2020,147679,30,0,23,11,12
2020,147679,30,1,5,4,1
2020,147679,30,2,9,3,6
2020,147679,30,3,9,4,5
2020,147679,40,0,39,14,25
2020,147679,40,1,3,2,1
2020,147679,40,2,18,7,11
2020,147679,40,3,15,3,12
2020,147679,40,4,1,1,0
2020,147679,40,6,2,1,1
2020,147679,41,0,33,12,21
2020,147679,41,1,3,2,1
2020,147679,41,2,18,7,11
2020,147679,41,3,11,2,9
2020,147679,41,4,1,1,0
2020,147679,42,0,6,2,4
2020,147679,42,3,4,1,3
2020,147679,42,6,2,1,1
2020,147679,44,0,33,12,21
2020,147679,44,1,3,2,1
2020,147679,44,2,18,7,11
2020,147679,44,3,11,2,9
2020,147679,44,4,1,1,0
2020,147703,0,0,787,406,381
2020,147703,10,0,787,406,381
2020,147703,10,1,222,144,78
2020,147703,10,2,228,110,118
2020,147703,10,3,152,76,76
2020,147703,10,4,153,61,92
2020,147703,10,6,32,15,17
2020,147703,20,0,447,252,195
2020,147703,20,1,222,144,78
2020,147703,20,2,221,106,115
2020,147703,20,3,3,1,2
2020,147703,20,6,1,1,0
2020,147703,30,0,141,73,68
2020,147703,30,2,6,3,3
2020,147703,30,3,128,68,60
2020,147703,30,6,7,2,5
2020,147703,40,0,199,81,118
2020,147703,40,2,1,1,0
2020,147703,40,3,21,7,14
2020,147703,40,4,153,61,92
2020,147703,40,6,24,12,12
2020,147703,41,0,46,20,26
2020,147703,41,2,1,1,0
2020,147703,41,3,21,7,14
2020,147703,41,6,24,12,12
2020,147703,42,0,153,61,92
2020,147703,42,4,153,61,92
2020,147703,44,0,46,20,26
2020,147703,44,2,1,1,0
2020,147703,44,3,21,7,14
2020,147703,44,6,24,12,12
2020,147767,0,0,2325,1355,970
2020,147767,10,0,2325,1355,970
2020,147767,10,1,1013,718,295
2020,147767,10,2,606,331,275
2020,147767,10,3,526,232,294
2020,147767,10,4,19,6,13
2020,147767,10,5,161,68,93
2020,147767,20,0,1063,760,303
2020,147767,20,1,753,571,182
2020,147767,20,2,310,189,121
2020,147767,30,0,301,166,135
2020,147767,30,2,44,28,16
2020,147767,30,3,257,138,119
2020,147767,40,0,961,429,532
2020,147767,40,1,260,147,113
2020,147767,40,2,252,114,138
2020,147767,40,3,269,94,175
2020,147767,40,4,19,6,13
2020,147767,40,5,161,68,93
2020,147767,41,0,956,427,529
2020,147767,41,1,260,147,113
2020,147767,41,2,252,114,138
2020,147767,41,3,269,94,175
2020,147767,41,4,19,6,13
2020,147767,41,5,156,66,90
2020,147767,42,0,5,2,3
2020,147767,42,5,5,2,3
2020,147767,44,0,956,427,529
2020,147767,44,1,260,147,113
2020,147767,44,2,252,114,138
2020,147767,44,3,269,94,175
2020,147767,44,4,19,6,13
2020,147767,44,5,156,66,90
2020,147776,0,0,271,121,150
2020,147776,10,0,271,121,150
2020,147776,10,1,56,28,28
2020,147776,10,2,97,44,53
2020,147776,10,3,50,22,28
2020,147776,10,4,68,27,41
2020,147776,20,0,137,66,71
2020,147776,20,1,55,28,27
2020,147776,20,2,81,37,44
2020,147776,20,3,1,1,0
2020,147776,30,0,66,28,38
2020,147776,30,1,1,0,1
2020,147776,30,2,16,7,9
2020,147776,30,3,49,21,28
2020,147776,40,0,68,27,41
2020,147776,40,4,68,27,41
2020,147776,42,0,68,27,41
2020,147776,42,4,68,27,41
2020,147800,0,0,149,59,90
2020,147800,10,0,149,59,90
2020,147800,10,1,95,42,53
2020,147800,10,2,33,12,21
2020,147800,10,3,13,2,11
2020,147800,10,4,3,1,2
2020,147800,10,6,5,2,3
2020,147800,20,0,128,53,75
2020,147800,20,1,93,41,52
2020,147800,20,2,30,12,18
2020,147800,20,3,5,0,5
2020,147800,30,0,19,5,14
2020,147800,30,1,2,1,1
2020,147800,30,2,3,0,3
2020,147800,30,3,8,2,6
2020,147800,30,4,3,1,2
2020,147800,30,6,3,1,2
2020,147800,40,0,2,1,1
2020,147800,40,6,2,1,1
2020,147800,43,0,2,1,1
2020,147800,43,6,2,1,1
2020,147828,0,0,124,73,51
2020,147828,10,0,124,73,51
2020,147828,10,1,50,35,15
2020,147828,10,2,38,24,14
2020,147828,10,3,35,13,22
2020,147828,10,4,1,1,0
2020,147828,20,0,9,9,0
2020,147828,20,1,9,9,0
2020,147828,40,0,115,64,51
2020,147828,40,1,41,26,15
2020,147828,40,2,38,24,14
2020,147828,40,3,35,13,22
2020,147828,40,4,1,1,0
2020,147828,41,0,47,29,18
2020,147828,41,1,30,20,10
2020,147828,41,2,17,9,8
2020,147828,42,0,68,35,33
2020,147828,42,1,11,6,5
2020,147828,42,2,21,15,6
2020,147828,42,3,35,13,22
2020,147828,42,4,1,1,0
2020,147828,44,0,47,29,18
2020,147828,44,1,30,20,10
2020,147828,44,2,17,9,8
2020,147916,0,0,157,78,79
2020,147916,10,0,157,78,79
2020,147916,10,1,54,31,23
2020,147916,10,2,69,23,46
2020,147916,10,3,8,7,1
2020,147916,10,4,26,17,9
2020,147916,20,0,131,61,70
2020,147916,20,1,54,31,23
2020,147916,20,2,69,23,46
2020,147916,20,3,8,7,1
2020,147916,30,0,8,3,5
2020,147916,30,4,8,3,5
2020,147916,40,0,18,14,4
2020,147916,40,4,18,14,4
2020,147916,42,0,17,14,3
2020,147916,42,4,17,14,3
2020,147916,43,0,1,0,1
2020,147916,43,4,1,0,1
2020,148007,0,0,82,32,50
2020,148007,10,0,82,32,50
2020,148007,10,1,27,16,11
2020,148007,10,2,36,11,25
2020,148007,10,3,19,5,14
2020,148007,20,0,62,27,35
2020,148007,20,1,26,16,10
2020,148007,20,2,36,11,25
2020,148007,30,0,16,2,14
2020,148007,30,1,1,0,1
2020,148007,30,3,15,2,13
2020,148007,40,0,4,3,1
2020,148007,40,3,4,3,1
2020,148007,42,0,4,3,1
2020,148007,42,3,4,3,1
2020,148016,0,0,63,35,28
2020,148016,10,0,63,35,28
2020,148016,10,1,21,13,8
2020,148016,10,2,14,8,6
2020,148016,10,3,25,13,12
2020,148016,10,4,3,1,2
2020,148016,40,0,63,35,28
2020,148016,40,1,21,13,8
2020,148016,40,2,14,8,6
2020,148016,40,3,25,13,12
2020,148016,40,4,3,1,2
2020,148016,42,0,63,35,28
2020,148016,42,1,21,13,8
2020,148016,42,2,14,8,6
2020,148016,42,3,25,13,12
2020,148016,42,4,3,1,2
2020,148131,0,0,53,30,23
2020,148131,10,0,53,30,23
2020,148131,10,1,9,8,1
2020,148131,10,2,15,8,7
2020,148131,10,3,27,13,14
2020,148131,10,4,2,1,1
2020,148131,20,0,22,15,7
2020,148131,20,1,9,8,1
2020,148131,20,2,13,7,6
2020,148131,30,0,14,7,7
2020,148131,30,3,14,7,7
2020,148131,40,0,17,8,9
2020,148131,40,2,2,1,1
2020,148131,40,3,13,6,7
2020,148131,40,4,2,1,1
2020,148131,42,0,17,8,9
2020,148131,42,2,2,1,1
2020,148131,42,3,13,6,7
2020,148131,42,4,2,1,1
2020,148256,0,0,51,24,27
2020,148256,10,0,51,24,27
2020,148256,10,1,30,15,15
2020,148256,10,2,13,6,7
2020,148256,10,4,8,3,5
2020,148256,20,0,43,21,22
2020,148256,20,1,30,15,15
2020,148256,20,2,13,6,7
2020,148256,30,0,8,3,5
2020,148256,30,4,8,3,5
2020,148292,0,0,58,24,34
2020,148292,10,0,58,24,34
2020,148292,10,1,23,7,16
2020,148292,10,2,11,5,6
2020,148292,10,3,11,4,7
2020,148292,10,4,11,7,4
2020,148292,10,6,2,1,1
2020,148292,20,0,49,18,31
2020,148292,20,1,23,7,16
2020,148292,20,2,9,3,6
2020,148292,20,3,11,4,7
2020,148292,20,4,6,4,2
2020,148292,30,0,7,5,2
2020,148292,30,2,2,2,0
2020,148292,30,4,5,3,2
2020,148292,40,0,2,1,1
2020,148292,40,6,2,1,1
2020,148292,42,0,2,1,1
2020,148292,42,6,2,1,1
2020,148380,0,0,123,55,68
2020,148380,10,0,123,55,68
2020,148380,10,1,42,20,22
2020,148380,10,2,60,28,32
2020,148380,10,3,19,7,12
2020,148380,10,4,2,0,2
2020,148380,20,0,105,47,58
2020,148380,20,1,40,18,22
2020,148380,20,2,55,25,30
2020,148380,20,3,9,4,5
2020,148380,20,4,1,0,1
2020,148380,30,0,16,7,9
2020,148380,30,1,2,2,0
2020,148380,30,2,4,2,2
2020,148380,30,3,9,3,6
2020,148380,30,4,1,0,1
2020,148380,40,0,2,1,1
2020,148380,40,2,1,1,0
2020,148380,40,3,1,0,1
2020,148380,41,0,2,1,1
2020,148380,41,2,1,1,0
2020,148380,41,3,1,0,1
2020,148380,44,0,2,1,1
2020,148380,44,2,1,1,0
2020,148380,44,3,1,0,1
2020,148405,0,0,69,28,41
2020,148405,10,0,69,28,41
2020,148405,10,1,12,7,5
2020,148405,10,2,24,16,8
2020,148405,10,3,31,5,26
2020,148405,10,5,2,0,2
2020,148405,20,0,33,20,13
2020,148405,20,1,12,7,5
2020,148405,20,2,16,13,3
2020,148405,20,3,5,0,5
2020,148405,30,0,31,8,23
2020,148405,30,2,6,3,3
2020,148405,30,3,25,5,20
2020,148405,40,0,5,0,5
2020,148405,40,2,2,0,2
2020,148405,40,3,1,0,1
2020,148405,40,5,2,0,2
2020,148405,41,0,5,0,5
2020,148405,41,2,2,0,2
2020,148405,41,3,1,0,1
2020,148405,41,5,2,0,2
2020,148405,44,0,5,0,5
2020,148405,44,2,2,0,2
2020,148405,44,3,1,0,1
2020,148405,44,5,2,0,2
2020,148487,0,0,216,120,96
2020,148487,10,0,216,120,96
2020,148487,10,1,42,29,13
2020,148487,10,2,78,38,40
2020,148487,10,3,69,41,28
2020,148487,10,4,1,0,1
2020,148487,10,5,11,4,7
2020,148487,10,6,15,8,7
2020,148487,20,0,118,65,53
2020,148487,20,1,38,26,12
2020,148487,20,2,76,37,39
2020,148487,20,3,2,1,1
2020,148487,20,6,2,1,1
2020,148487,30,0,19,13,6
2020,148487,30,3,19,13,6
2020,148487,40,0,79,42,37
2020,148487,40,1,4,3,1
2020,148487,40,2,2,1,1
2020,148487,40,3,48,27,21
2020,148487,40,4,1,0,1
2020,148487,40,5,11,4,7
2020,148487,40,6,13,7,6
2020,148487,41,0,27,15,12
2020,148487,41,1,4,3,1
2020,148487,41,2,1,1,0
2020,148487,41,3,12,7,5
2020,148487,41,5,7,3,4
2020,148487,41,6,3,1,2
2020,148487,42,0,48,26,22
2020,148487,42,2,1,0,1
2020,148487,42,3,36,20,16
2020,148487,42,5,4,1,3
2020,148487,42,6,7,5,2
2020,148487,43,0,4,1,3
2020,148487,43,4,1,0,1
2020,148487,43,6,3,1,2
2020,148487,44,0,27,15,12
2020,148487,44,1,4,3,1
2020,148487,44,2,1,1,0
2020,148487,44,3,12,7,5
2020,148487,44,5,7,3,4
2020,148487,44,6,3,1,2
2020,148496,0,0,142,58,84
2020,148496,10,0,142,58,84
2020,148496,10,1,51,22,29
2020,148496,10,2,35,17,18
2020,148496,10,3,38,14,24
2020,148496,10,5,18,5,13
2020,148496,20,0,91,42,49
2020,148496,20,1,49,21,28
2020,148496,20,2,35,17,18
2020,148496,20,3,7,4,3
2020,148496,30,0,25,9,16
2020,148496,30,3,25,9,16
2020,148496,40,0,26,7,19
2020,148496,40,1,2,1,1
2020,148496,40,3,6,1,5
2020,148496,40,5,18,5,13
2020,148496,42,0,26,7,19
2020,148496,42,1,2,1,1
2020,148496,42,3,6,1,5
2020,148496,42,5,18,5,13
2020,148511,0,0,1196,531,665
2020,148511,10,0,1196,531,665
2020,148511,10,1,135,89,46
2020,148511,10,2,193,97,96
2020,148511,10,3,616,269,347
2020,148511,10,4,154,44,110
2020,148511,10,5,21,3,18
2020,148511,10,6,77,29,48
2020,148511,20,0,328,186,142
2020,148511,20,1,135,89,46
2020,148511,20,2,193,97,96
2020,148511,30,0,770,313,457
2020,148511,30,3,616,269,347
2020,148511,30,4,154,44,110
2020,148511,40,0,98,32,66
2020,148511,40,5,21,3,18
2020,148511,40,6,77,29,48
2020,148511,42,0,98,32,66
2020,148511,42,5,21,3,18
2020,148511,42,6,77,29,48
2020,148575,0,0,37,3,34
2020,148575,10,0,37,3,34
2020,148575,10,1,5,0,5
2020,148575,10,2,3,0,3
2020,148575,10,3,25,3,22
2020,148575,10,4,4,0,4
2020,148575,40,0,37,3,34
2020,148575,40,1,5,0,5
2020,148575,40,2,3,0,3
2020,148575,40,3,25,3,22
2020,148575,40,4,4,0,4
2020,148575,43,0,37,3,34
2020,148575,43,1,5,0,5
2020,148575,43,2,3,0,3
2020,148575,43,3,25,3,22
2020,148575,43,4,4,0,4
2020,148584,0,0,96,36,60
2020,148584,10,0,96,36,60
2020,148584,10,1,26,15,11
2020,148584,10,2,23,9,14
2020,148584,10,3,28,4,24
2020,148584,10,4,19,8,11
2020,148584,20,0,45,20,25
2020,148584,20,1,21,11,10
2020,148584,20,2,23,9,14
2020,148584,20,3,1,0,1
2020,148584,30,0,20,3,17
2020,148584,30,3,20,3,17
2020,148584,40,0,31,13,18
2020,148584,40,1,5,4,1
2020,148584,40,3,7,1,6
2020,148584,40,4,19,8,11
2020,148584,42,0,31,13,18
2020,148584,42,1,5,4,1
2020,148584,42,3,7,1,6
2020,148584,42,4,19,8,11
2020,148593,0,0,18,1,17
2020,148593,10,0,18,1,17
2020,148593,10,2,2,0,2
2020,148593,10,3,14,1,13
2020,148593,10,4,2,0,2
2020,148593,40,0,18,1,17
2020,148593,40,2,2,0,2
2020,148593,40,3,14,1,13
2020,148593,40,4,2,0,2
2020,148593,42,0,18,1,17
2020,148593,42,2,2,0,2
2020,148593,42,3,14,1,13
2020,148593,42,4,2,0,2
2020,148627,0,0,130,56,74
2020,148627,10,0,130,56,74
2020,148627,10,1,27,13,14
2020,148627,10,2,39,17,22
2020,148627,10,3,24,12,12
2020,148627,10,4,4,0,4
2020,148627,10,5,29,12,17
2020,148627,10,6,7,2,5
2020,148627,20,0,65,30,35
2020,148627,20,1,27,13,14
2020,148627,20,2,38,17,21
2020,148627,30,0,25,12,13
2020,148627,30,2,1,0,1
2020,148627,30,3,24,12,12
2020,148627,40,0,40,14,26
2020,148627,40,4,4,0,4
2020,148627,40,5,29,12,17
2020,148627,40,6,7,2,5
2020,148627,42,0,40,14,26
2020,148627,42,4,4,0,4
2020,148627,42,5,29,12,17
2020,148627,42,6,7,2,5
2020,148654,0,0,202,112,90
2020,148654,10,0,202,112,90
2020,148654,10,1,23,16,7
2020,148654,10,2,84,44,40
2020,148654,10,3,64,32,32
2020,148654,10,4,28,18,10
2020,148654,10,5,3,2,1
2020,148654,20,0,109,61,48
2020,148654,20,1,23,16,7
2020,148654,20,2,78,41,37
2020,148654,20,3,8,4,4
2020,148654,30,0,51,26,25
2020,148654,30,2,4,2,2
2020,148654,30,3,47,24,23
2020,148654,40,0,42,25,17
2020,148654,40,2,2,1,1
2020,148654,40,3,9,4,5
2020,148654,40,4,28,18,10
2020,148654,40,5,3,2,1
2020,148654,42,0,42,25,17
2020,148654,42,2,2,1,1
2020,148654,42,3,9,4,5
2020,148654,42,4,28,18,10
2020,148654,42,5,3,2,1
2020,148672,0,0,47,24,23
2020,148672,10,0,47,24,23
2020,148672,10,1,12,8,4
2020,148672,10,2,11,6,5
2020,148672,10,3,20,7,13
2020,148672,10,4,4,3,1
2020,148672,20,0,31,17,14
2020,148672,20,1,11,7,4
2020,148672,20,2,10,5,5
2020,148672,20,3,9,4,5
2020,148672,20,4,1,1,0
2020,148672,30,0,16,7,9
2020,148672,30,1,1,1,0
2020,148672,30,2,1,1,0
2020,148672,30,3,11,3,8
2020,148672,30,4,3,2,1
2020,148821,0,0,31,14,17
2020,148821,10,0,31,14,17
2020,148821,10,6,31,14,17
2020,148821,20,0,23,10,13
2020,148821,20,6,23,10,13
2020,148821,30,0,8,4,4
2020,148821,30,6,8,4,4
2020,148876,0,0,11,7,4
2020,148876,10,0,11,7,4
2020,148876,10,2,2,2,0
2020,148876,10,3,5,2,3
2020,148876,10,4,3,2,1
2020,148876,10,6,1,1,0
2020,148876,40,0,11,7,4
2020,148876,40,2,2,2,0
2020,148876,40,3,5,2,3
2020,148876,40,4,3,2,1
2020,148876,40,6,1,1,0
2020,148876,42,0,11,7,4
2020,148876,42,2,2,2,0
2020,148876,42,3,5,2,3
2020,148876,42,4,3,2,1
2020,148876,42,6,1,1,0
2020,148885,0,0,20,16,4
2020,148885,10,0,20,16,4
2020,148885,10,1,5,4,1
2020,148885,10,2,6,6,0
2020,148885,10,3,6,3,3
2020,148885,10,4,3,3,0
2020,148885,40,0,20,16,4
2020,148885,40,1,5,4,1
2020,148885,40,2,6,6,0
2020,148885,40,3,6,3,3
2020,148885,40,4,3,3,0
2020,148885,41,0,20,16,4
2020,148885,41,1,5,4,1
2020,148885,41,2,6,6,0
2020,148885,41,3,6,3,3
2020,148885,41,4,3,3,0
2020,148885,44,0,20,16,4
2020,148885,44,1,5,4,1
2020,148885,44,2,6,6,0
2020,148885,44,3,6,3,3
2020,148885,44,4,3,3,0
2020,148937,0,0,33,16,17
2020,148937,10,0,33,16,17
2020,148937,10,4,33,16,17
2020,148937,20,0,21,13,8
2020,148937,20,4,21,13,8
2020,148937,30,0,11,3,8
2020,148937,30,4,11,3,8
2020,148937,40,0,1,0,1
2020,148937,40,4,1,0,1
2020,148937,42,0,1,0,1
2020,148937,42,4,1,0,1
2020,148982,0,0,2,1,1
2020,148982,10,0,2,1,1
2020,148982,10,1,1,1,0
2020,148982,10,2,1,0,1
2020,148982,40,0,2,1,1
2020,148982,40,1,1,1,0
2020,148982,40,2,1,0,1
2020,148982,41,0,1,1,0
2020,148982,41,1,1,1,0
2020,148982,42,0,1,0,1
2020,148982,42,2,1,0,1
2020,148982,44,0,1,1,0
2020,148982,44,1,1,1,0
2020,148991,0,0,32,13,19
2020,148991,10,0,32,13,19
2020,148991,10,6,32,13,19
2020,148991,20,0,28,13,15
2020,148991,20,6,28,13,15
2020,148991,30,0,4,0,4
2020,148991,30,6,4,0,4
2020,149028,0,0,22,3,19
2020,149028,10,0,22,3,19
2020,149028,10,1,1,1,0
2020,149028,10,2,1,0,1
2020,149028,10,3,13,1,12
2020,149028,10,4,7,1,6
2020,149028,40,0,22,3,19
2020,149028,40,1,1,1,0
2020,149028,40,2,1,0,1
2020,149028,40,3,13,1,12
2020,149028,40,4,7,1,6
2020,149028,41,0,22,3,19
2020,149028,41,1,1,1,0
2020,149028,41,2,1,0,1
2020,149028,41,3,13,1,12
2020,149028,41,4,7,1,6
2020,149028,45,0,22,3,19
2020,149028,45,1,1,1,0
2020,149028,45,2,1,0,1
2020,149028,45,3,13,1,12
2020,149028,45,4,7,1,6
2020,149222,0,0,973,572,401
2020,149222,10,0,973,572,401
2020,149222,10,1,223,158,65
2020,149222,10,2,309,186,123
2020,149222,10,3,314,168,146
2020,149222,10,4,72,37,35
2020,149222,10,5,55,23,32
2020,149222,20,0,373,258,115
2020,149222,20,1,182,137,45
2020,149222,20,2,189,119,70
2020,149222,20,3,2,2,0
2020,149222,30,0,153,92,61
2020,149222,30,2,35,24,11
2020,149222,30,3,118,68,50
2020,149222,40,0,447,222,225
2020,149222,40,1,41,21,20
2020,149222,40,2,85,43,42
2020,149222,40,3,194,98,96
2020,149222,40,4,72,37,35
2020,149222,40,5,55,23,32
2020,149222,41,0,286,143,143
2020,149222,41,1,40,20,20
2020,149222,41,2,84,42,42
2020,149222,41,3,111,62,49
2020,149222,41,4,11,1,10
2020,149222,41,5,40,18,22
2020,149222,42,0,24,15,9
2020,149222,42,1,1,1,0
2020,149222,42,2,1,1,0
2020,149222,42,3,17,10,7
2020,149222,42,4,5,3,2
2020,149222,43,0,137,64,73
2020,149222,43,3,66,26,40
2020,149222,43,4,56,33,23
2020,149222,43,5,15,5,10
2020,149222,44,0,286,143,143
2020,149222,44,1,40,20,20
2020,149222,44,2,84,42,42
2020,149222,44,3,111,62,49
2020,149222,44,4,11,1,10
2020,149222,44,5,40,18,22
2020,149231,0,0,631,308,323
2020,149231,10,0,631,308,323
2020,149231,10,1,179,109,70
2020,149231,10,2,180,99,81
2020,149231,10,3,132,56,76
2020,149231,10,4,137,43,94
2020,149231,10,5,3,1,2
2020,149231,20,0,331,194,137
2020,149231,20,1,173,106,67
2020,149231,20,2,158,88,70
2020,149231,30,0,116,46,70
2020,149231,30,2,6,3,3
2020,149231,30,3,110,43,67
2020,149231,40,0,184,68,116
2020,149231,40,1,6,3,3
2020,149231,40,2,16,8,8
2020,149231,40,3,22,13,9
2020,149231,40,4,137,43,94
2020,149231,40,5,3,1,2
2020,149231,41,0,22,7,15
2020,149231,41,1,3,0,3
2020,149231,41,2,9,1,8
2020,149231,41,3,5,2,3
2020,149231,41,4,5,4,1
2020,149231,42,0,158,60,98
2020,149231,42,1,3,3,0
2020,149231,42,2,6,6,0
2020,149231,42,3,17,11,6
2020,149231,42,4,131,39,92
2020,149231,42,5,1,1,0
2020,149231,43,0,4,1,3
2020,149231,43,2,1,1,0
2020,149231,43,4,1,0,1
2020,149231,43,5,2,0,2
2020,149231,44,0,22,7,15
2020,149231,44,1,3,0,3
2020,149231,44,2,9,1,8
2020,149231,44,3,5,2,3
2020,149231,44,4,5,4,1
2020,149329,0,0,6,6,0
2020,149329,10,0,6,6,0
2020,149329,10,4,6,6,0
2020,149329,40,0,6,6,0
2020,149329,40,4,6,6,0
2020,149329,42,0,6,6,0
2020,149329,42,4,6,6,0
2020,149365,0,0,75,35,40
2020,149365,10,0,75,35,40
2020,149365,10,6,75,35,40
2020,149365,20,0,54,31,23
2020,149365,20,6,54,31,23
2020,149365,30,0,16,3,13
2020,149365,30,6,16,3,13
2020,149365,40,0,5,1,4
2020,149365,40,6,5,1,4
2020,149365,41,0,5,1,4
2020,149365,41,6,5,1,4
2020,149365,44,0,5,1,4
2020,149365,44,6,5,1,4
2020,149505,0,0,67,32,35
2020,149505,10,0,67,32,35
2020,149505,10,1,21,17,4
2020,149505,10,2,16,4,12
2020,149505,10,3,30,11,19
2020,149505,20,0,26,19,7
2020,149505,20,1,20,16,4
2020,149505,20,2,6,3,3
2020,149505,30,0,20,9,11
2020,149505,30,1,1,1,0
2020,149505,30,2,8,1,7
2020,149505,30,3,11,7,4
2020,149505,40,0,21,4,17
2020,149505,40,2,2,0,2
2020,149505,40,3,19,4,15
2020,149505,41,0,3,1,2
2020,149505,41,3,3,1,2
2020,149505,42,0,18,3,15
2020,149505,42,2,2,0,2
2020,149505,42,3,16,3,13
2020,149505,44,0,3,1,2
2020,149505,44,3,3,1,2
2020,149514,0,0,73,54,19
2020,149514,10,0,73,54,19
2020,149514,10,1,24,21,3
2020,149514,10,2,22,14,8
2020,149514,10,3,16,11,5
2020,149514,10,4,4,2,2
2020,149514,10,6,7,6,1
2020,149514,20,0,32,21,11
2020,149514,20,1,17,14,3
2020,149514,20,2,15,7,8
2020,149514,30,0,13,10,3
2020,149514,30,2,5,5,0
2020,149514,30,3,8,5,3
2020,149514,40,0,28,23,5
2020,149514,40,1,7,7,0
2020,149514,40,2,2,2,0
2020,149514,40,3,8,6,2
2020,149514,40,4,4,2,2
2020,149514,40,6,7,6,1
2020,149514,41,0,7,6,1
2020,149514,41,6,7,6,1
2020,149514,42,0,21,17,4
2020,149514,42,1,7,7,0
2020,149514,42,2,2,2,0
2020,149514,42,3,8,6,2
2020,149514,42,4,4,2,2
2020,149514,45,0,7,6,1
2020,149514,45,6,7,6,1
2020,149532,0,0,100,47,53
2020,149532,10,0,100,47,53
2020,149532,10,6,100,47,53
2020,149532,20,0,80,39,41
2020,149532,20,6,80,39,41
2020,149532,30,0,3,1,2
2020,149532,30,6,3,1,2
2020,149532,40,0,17,7,10
2020,149532,40,6,17,7,10
2020,149532,41,0,17,7,10
2020,149532,41,6,17,7,10
2020,149532,44,0,17,7,10
2020,149532,44,6,17,7,10
2020,149639,0,0,10,5,5
2020,149639,10,0,10,5,5
2020,149639,10,1,4,1,3
2020,149639,10,2,4,2,2
2020,149639,10,3,2,2,0
2020,149639,40,0,10,5,5
2020,149639,40,1,4,1,3
2020,149639,40,2,4,2,2
2020,149639,40,3,2,2,0
2020,149639,41,0,10,5,5
2020,149639,41,1,4,1,3
2020,149639,41,2,4,2,2
2020,149639,41,3,2,2,0
2020,149639,45,0,10,5,5
2020,149639,45,1,4,1,3
2020,149639,45,2,4,2,2
2020,149639,45,3,2,2,0
2020,149727,0,0,93,44,49
2020,149727,10,0,93,44,49
2020,149727,10,1,28,15,13
2020,149727,10,2,20,7,13
2020,149727,10,3,36,15,21
2020,149727,10,4,9,7,2
2020,149727,20,0,84,37,47
2020,149727,20,1,28,15,13
2020,149727,20,2,20,7,13
2020,149727,20,3,36,15,21
2020,149727,30,0,9,7,2
2020,149727,30,4,9,7,2
2020,149763,0,0,48,10,38
2020,149763,10,0,48,10,38
2020,149763,10,1,1,0,1
2020,149763,10,2,8,1,7
2020,149763,10,3,14,1,13
2020,149763,10,4,25,8,17
2020,149763,40,0,48,10,38
2020,149763,40,1,1,0,1
2020,149763,40,2,8,1,7
2020,149763,40,3,14,1,13
2020,149763,40,4,25,8,17
2020,149763,41,0,34,5,29
2020,149763,41,1,1,0,1
2020,149763,41,2,6,0,6
2020,149763,41,3,12,1,11
2020,149763,41,4,15,4,11
2020,149763,42,0,14,5,9
2020,149763,42,2,2,1,1
2020,149763,42,3,2,0,2
2020,149763,42,4,10,4,6
2020,149763,44,0,26,5,21
2020,149763,44,2,2,0,2
2020,149763,44,3,9,1,8
2020,149763,44,4,15,4,11
2020,149763,45,0,8,0,8
2020,149763,45,1,1,0,1
2020,149763,45,2,4,0,4
2020,149763,45,3,3,0,3
2020,149772,0,0,441,245,196
2020,149772,10,0,441,245,196
2020,149772,10,1,196,130,66
2020,149772,10,2,93,51,42
2020,149772,10,3,75,40,35
2020,149772,10,4,77,24,53
2020,149772,20,0,286,179,107
2020,149772,20,1,196,130,66
2020,149772,20,2,90,49,41
2020,149772,30,0,78,42,36
2020,149772,30,2,2,2,0
2020,149772,30,3,75,40,35
2020,149772,30,4,1,0,1
2020,149772,40,0,77,24,53
2020,149772,40,2,1,0,1
2020,149772,40,4,76,24,52
2020,149772,41,0,77,24,53
2020,149772,41,2,1,0,1
2020,149772,41,4,76,24,52
2020,149772,45,0,77,24,53
2020,149772,45,2,1,0,1
2020,149772,45,4,76,24,52
2020,149781,0,0,223,139,84
2020,149781,10,0,223,139,84
2020,149781,10,1,66,47,19
2020,149781,10,2,86,56,30
2020,149781,10,3,67,35,32
2020,149781,10,4,4,1,3
2020,149781,20,0,134,94,40
2020,149781,20,1,61,44,17
2020,149781,20,2,73,50,23
2020,149781,30,0,59,31,28
2020,149781,30,1,5,3,2
2020,149781,30,2,9,4,5
2020,149781,30,3,45,24,21
2020,149781,40,0,30,14,16
2020,149781,40,2,4,2,2
2020,149781,40,3,22,11,11
2020,149781,40,4,4,1,3
2020,149781,42,0,30,14,16
2020,149781,42,2,4,2,2
2020,149781,42,3,22,11,11
2020,149781,42,4,4,1,3
2020,149842,0,0,198,79,119
2020,149842,10,0,198,79,119
2020,149842,10,1,70,32,38
2020,149842,10,2,66,26,40
2020,149842,10,3,37,14,23
2020,149842,10,4,22,6,16
2020,149842,10,6,3,1,2
2020,149842,20,0,175,74,101
2020,149842,20,1,70,32,38
2020,149842,20,2,66,26,40
2020,149842,20,3,30,13,17
2020,149842,20,4,9,3,6
2020,149842,30,0,23,5,18
2020,149842,30,3,7,1,6
2020,149842,30,4,13,3,10
2020,149842,30,6,3,1,2
2020,150048,0,0,20,5,15
2020,150048,10,0,20,5,15
2020,150048,10,1,1,1,0
2020,150048,10,2,2,1,1
2020,150048,10,3,6,2,4
2020,150048,10,4,11,1,10
2020,150048,40,0,20,5,15
2020,150048,40,1,1,1,0
2020,150048,40,2,2,1,1
2020,150048,40,3,6,2,4
2020,150048,40,4,11,1,10
2020,150048,42,0,20,5,15
2020,150048,42,1,1,1,0
2020,150048,42,2,2,1,1
2020,150048,42,3,6,2,4
2020,150048,42,4,11,1,10
2020,150066,0,0,104,58,46
2020,150066,10,0,104,58,46
2020,150066,10,1,40,27,13
2020,150066,10,2,20,14,6
2020,150066,10,3,42,16,26
2020,150066,10,4,2,1,1
2020,150066,20,0,53,34,19
2020,150066,20,1,40,27,13
2020,150066,20,2,13,7,6
2020,150066,30,0,30,17,13
2020,150066,30,2,7,7,0
2020,150066,30,3,23,10,13
2020,150066,40,0,21,7,14
2020,150066,40,3,19,6,13
2020,150066,40,4,2,1,1
2020,150066,42,0,21,7,14
2020,150066,42,3,19,6,13
2020,150066,42,4,2,1,1
2020,150136,0,0,1047,528,519
2020,150136,10,0,1044,525,519
2020,150136,10,1,206,135,71
2020,150136,10,2,226,115,111
2020,150136,10,3,234,124,110
2020,150136,10,4,241,95,146
2020,150136,10,5,136,55,81
2020,150136,10,6,1,1,0
2020,150136,20,0,430,250,180
2020,150136,20,1,205,134,71
2020,150136,20,2,210,109,101
2020,150136,20,3,15,7,8
2020,150136,30,0,223,116,107
2020,150136,30,2,16,6,10
2020,150136,30,3,206,109,97
2020,150136,30,4,1,1,0
2020,150136,40,0,391,159,232
2020,150136,40,1,1,1,0
2020,150136,40,3,13,8,5
2020,150136,40,4,240,94,146
2020,150136,40,5,136,55,81
2020,150136,40,6,1,1,0
2020,150136,41,0,1,0,1
2020,150136,41,4,1,0,1
2020,150136,42,0,390,159,231
2020,150136,42,1,1,1,0
2020,150136,42,3,13,8,5
2020,150136,42,4,239,94,145
2020,150136,42,5,136,55,81
2020,150136,42,6,1,1,0
2020,150136,44,0,1,0,1
2020,150136,44,4,1,0,1
2020,150136,50,0,3,3,0
2020,150145,0,0,61,30,31
2020,150145,10,0,61,30,31
2020,150145,10,1,10,7,3
2020,150145,10,2,25,14,11
2020,150145,10,3,25,8,17
2020,150145,10,4,1,1,0
2020,150145,20,0,34,20,14
2020,150145,20,1,9,7,2
2020,150145,20,2,23,12,11
2020,150145,20,3,2,1,1
2020,150145,30,0,20,7,13
2020,150145,30,1,1,0,1
2020,150145,30,2,2,2,0
2020,150145,30,3,17,5,12
2020,150145,40,0,7,3,4
2020,150145,40,3,6,2,4
2020,150145,40,4,1,1,0
2020,150145,42,0,7,3,4
2020,150145,42,3,6,2,4
2020,150145,42,4,1,1,0
2020,150163,0,0,368,184,184
2020,150163,10,0,368,184,184
2020,150163,10,1,116,67,49
2020,150163,10,2,108,55,53
2020,150163,10,3,69,31,38
2020,150163,10,4,39,12,27
2020,150163,10,5,36,19,17
2020,150163,20,0,194,108,86
2020,150163,20,1,111,63,48
2020,150163,20,2,83,45,38
2020,150163,30,0,59,34,25
2020,150163,30,1,1,1,0
2020,150163,30,2,8,7,1
2020,150163,30,3,50,26,24
2020,150163,40,0,115,42,73
2020,150163,40,1,4,3,1
2020,150163,40,2,17,3,14
2020,150163,40,3,19,5,14
2020,150163,40,4,39,12,27
2020,150163,40,5,36,19,17
2020,150163,41,0,115,42,73
2020,150163,41,1,4,3,1
2020,150163,41,2,17,3,14
2020,150163,41,3,19,5,14
2020,150163,41,4,39,12,27
2020,150163,41,5,36,19,17
2020,150163,44,0,115,42,73
2020,150163,44,1,4,3,1
2020,150163,44,2,17,3,14
2020,150163,44,3,19,5,14
2020,150163,44,4,39,12,27
2020,150163,44,5,36,19,17
2020,150172,0,0,23,14,9
2020,150172,10,0,23,14,9
2020,150172,10,1,3,2,1
2020,150172,10,2,7,4,3
2020,150172,10,3,9,6,3
2020,150172,10,4,4,2,2
2020,150172,20,0,11,7,4
2020,150172,20,1,3,2,1
2020,150172,20,2,7,4,3
2020,150172,20,3,1,1,0
2020,150172,30,0,8,5,3
2020,150172,30,3,8,5,3
2020,150172,40,0,4,2,2
2020,150172,40,4,4,2,2
2020,150172,42,0,4,2,2
2020,150172,42,4,4,2,2
2020,150215,0,0,11,4,7
2020,150215,10,0,10,4,6
2020,150215,10,1,2,2,0
2020,150215,10,2,5,2,3
2020,150215,10,3,3,0,3
2020,150215,20,0,7,4,3
2020,150215,20,1,2,2,0
2020,150215,20,2,5,2,3
2020,150215,30,0,3,0,3
2020,150215,30,3,3,0,3
2020,150215,50,0,1,0,1
2020,150288,0,0,23,22,1
2020,150288,10,0,19,19,0
2020,150288,10,1,11,11,0
2020,150288,10,2,3,3,0
2020,150288,10,3,5,5,0
2020,150288,20,0,14,14,0
2020,150288,20,1,11,11,0
2020,150288,20,2,3,3,0
2020,150288,30,0,5,5,0
2020,150288,30,3,5,5,0
2020,150288,50,0,4,3,1
2020,150400,0,0,200,108,92
2020,150400,10,0,200,108,92
2020,150400,10,1,87,50,37
2020,150400,10,2,53,27,26
2020,150400,10,3,56,29,27
2020,150400,10,4,4,2,2
2020,150400,20,0,134,74,60
2020,150400,20,1,83,48,35
2020,150400,20,2,48,25,23
2020,150400,20,3,3,1,2
2020,150400,30,0,20,9,11
2020,150400,30,2,2,1,1
2020,150400,30,3,18,8,10
2020,150400,40,0,46,25,21
2020,150400,40,1,4,2,2
2020,150400,40,2,3,1,2
2020,150400,40,3,35,20,15
2020,150400,40,4,4,2,2
2020,150400,41,0,34,17,17
2020,150400,41,1,3,1,2
2020,150400,41,2,3,1,2
2020,150400,41,3,26,14,12
2020,150400,41,4,2,1,1
2020,150400,42,0,12,8,4
2020,150400,42,1,1,1,0
2020,150400,42,3,9,6,3
2020,150400,42,4,2,1,1
2020,150400,44,0,34,17,17
2020,150400,44,1,3,1,2
2020,150400,44,2,3,1,2
2020,150400,44,3,26,14,12
2020,150400,44,4,2,1,1
2020,150455,0,0,96,53,43
2020,150455,10,0,93,52,41
2020,150455,10,1,29,19,10
2020,150455,10,2,25,12,13
2020,150455,10,3,38,21,17
2020,150455,10,4,1,0,1
2020,150455,20,0,54,31,23
2020,150455,20,1,29,19,10
2020,150455,20,2,25,12,13
2020,150455,30,0,27,15,12
2020,150455,30,3,27,15,12
2020,150455,40,0,12,6,6
2020,150455,40,3,11,6,5
2020,150455,40,4,1,0,1
2020,150455,41,0,1,0,1
2020,150455,41,4,1,0,1
2020,150455,42,0,11,6,5
2020,150455,42,3,11,6,5
2020,150455,44,0,1,0,1
2020,150455,44,4,1,0,1
2020,150455,50,0,3,1,2
2020,150534,0,0,165,89,76
2020,150534,10,0,165,89,76
2020,150534,10,1,48,37,11
2020,150534,10,2,55,32,23
2020,150534,10,3,58,20,38
2020,150534,10,4,1,0,1
2020,150534,10,5,1,0,1
2020,150534,10,6,2,0,2
2020,150534,20,0,100,68,32
2020,150534,20,1,47,36,11
2020,150534,20,2,51,30,21
2020,150534,20,3,2,2,0
2020,150534,30,0,31,11,20
2020,150534,30,2,3,1,2
2020,150534,30,3,28,10,18
2020,150534,40,0,34,10,24
2020,150534,40,1,1,1,0
2020,150534,40,2,1,1,0
2020,150534,40,3,28,8,20
2020,150534,40,4,1,0,1
2020,150534,40,5,1,0,1
2020,150534,40,6,2,0,2
2020,150534,42,0,34,10,24
2020,150534,42,1,1,1,0
2020,150534,42,2,1,1,0
2020,150534,42,3,28,8,20
2020,150534,42,4,1,0,1
2020,150534,42,5,1,0,1
2020,150534,42,6,2,0,2
2020,150604,0,0,75,40,35
2020,150604,10,0,75,40,35
2020,150604,10,1,15,10,5
2020,150604,10,2,15,8,7
2020,150604,10,3,36,16,20
2020,150604,10,4,7,5,2
2020,150604,10,5,2,1,1
2020,150604,20,0,30,18,12
2020,150604,20,1,15,10,5
2020,150604,20,2,15,8,7
2020,150604,30,0,27,15,12
2020,150604,30,3,25,13,12
2020,150604,30,4,2,2,0
2020,150604,40,0,18,7,11
2020,150604,40,3,11,3,8
2020,150604,40,4,5,3,2
2020,150604,40,5,2,1,1
2020,150604,42,0,18,7,11
2020,150604,42,3,11,3,8
2020,150604,42,4,5,3,2
2020,150604,42,5,2,1,1
2020,150668,0,0,63,29,34
2020,150668,10,0,61,29,32
2020,150668,10,1,31,18,13
2020,150668,10,2,18,6,12
2020,150668,10,3,12,5,7
2020,150668,20,0,28,16,12
2020,150668,20,1,24,14,10
2020,150668,20,2,4,2,2
2020,150668,30,0,6,5,1
2020,150668,30,1,2,2,0
2020,150668,30,2,1,1,0
2020,150668,30,3,3,2,1
2020,150668,40,0,27,8,19
2020,150668,40,1,5,2,3
2020,150668,40,2,13,3,10
2020,150668,40,3,9,3,6
2020,150668,42,0,27,8,19
2020,150668,42,1,5,2,3
2020,150668,42,2,13,3,10
2020,150668,42,3,9,3,6
2020,150668,50,0,2,0,2
2020,150677,0,0,49,32,17
2020,150677,10,0,49,32,17
2020,150677,10,1,16,13,3
2020,150677,10,2,5,2,3
2020,150677,10,3,24,14,10
2020,150677,10,4,4,3,1
2020,150677,40,0,49,32,17
2020,150677,40,1,16,13,3
2020,150677,40,2,5,2,3
2020,150677,40,3,24,14,10
2020,150677,40,4,4,3,1
2020,150677,42,0,49,32,17
2020,150677,42,1,16,13,3
2020,150677,42,2,5,2,3
2020,150677,42,3,24,14,10
2020,150677,42,4,4,3,1
2020,150756,0,0,89,55,34
2020,150756,10,0,89,55,34
2020,150756,10,1,47,30,17
2020,150756,10,2,17,11,6
2020,150756,10,3,22,12,10
2020,150756,10,4,3,2,1
2020,150756,20,0,57,37,20
2020,150756,20,1,45,29,16
2020,150756,20,2,12,8,4
2020,150756,30,0,22,11,11
2020,150756,30,2,2,1,1
2020,150756,30,3,18,9,9
2020,150756,30,4,2,1,1
2020,150756,40,0,10,7,3
2020,150756,40,1,2,1,1
2020,150756,40,2,3,2,1
2020,150756,40,3,4,3,1
2020,150756,40,4,1,1,0
2020,150756,41,0,4,2,2
2020,150756,41,1,1,0,1
2020,150756,41,2,2,1,1
2020,150756,41,3,1,1,0
2020,150756,42,0,6,5,1
2020,150756,42,1,1,1,0
2020,150756,42,2,1,1,0
2020,150756,42,3,3,2,1
2020,150756,42,4,1,1,0
2020,150756,44,0,2,0,2
2020,150756,44,1,1,0,1
2020,150756,44,2,1,0,1
2020,150756,45,0,2,2,0
2020,150756,45,2,1,1,0
2020,150756,45,3,1,1,0
2020,150774,0,0,22,11,11
2020,150774,10,0,22,11,11
2020,150774,10,1,2,1,1
2020,150774,10,2,7,4,3
2020,150774,10,3,7,5,2
2020,150774,10,4,5,0,5
2020,150774,10,5,1,1,0
2020,150774,20,0,7,4,3
2020,150774,20,1,2,1,1
2020,150774,20,2,5,3,2
2020,150774,30,0,8,6,2
2020,150774,30,2,2,1,1
2020,150774,30,3,6,5,1
2020,150774,40,0,7,1,6
2020,150774,40,3,1,0,1
2020,150774,40,4,5,0,5
2020,150774,40,5,1,1,0
2020,150774,41,0,3,1,2
2020,150774,41,3,1,0,1
2020,150774,41,4,1,0,1
2020,150774,41,5,1,1,0
2020,150774,42,0,4,0,4
2020,150774,42,4,4,0,4
2020,150774,44,0,3,1,2
2020,150774,44,3,1,0,1
2020,150774,44,4,1,0,1
2020,150774,44,5,1,1,0
2020,150941,0,0,71,38,33
2020,150941,10,0,71,38,33
2020,150941,10,1,21,15,6
2020,150941,10,2,16,9,7
2020,150941,10,3,27,12,15
2020,150941,10,4,6,2,4
2020,150941,10,6,1,0,1
2020,150941,20,0,23,17,6
2020,150941,20,1,16,12,4
2020,150941,20,2,7,5,2
2020,150941,30,0,41,19,22
2020,150941,30,1,4,3,1
2020,150941,30,2,9,4,5
2020,150941,30,3,26,11,15
2020,150941,30,4,2,1,1
2020,150941,40,0,7,2,5
2020,150941,40,1,1,0,1
2020,150941,40,3,1,1,0
2020,150941,40,4,4,1,3
2020,150941,40,6,1,0,1
2020,150941,42,0,7,2,5
2020,150941,42,1,1,0,1
2020,150941,42,3,1,1,0
2020,150941,42,4,4,1,3
2020,150941,42,6,1,0,1
2020,150987,0,0,1175,475,700
2020,150987,10,0,1175,475,700
2020,150987,10,1,86,37,49
2020,150987,10,2,305,103,202
2020,150987,10,3,521,233,288
2020,150987,10,4,262,101,161
2020,150987,10,5,1,1,0
2020,150987,40,0,1175,475,700
2020,150987,40,1,86,37,49
2020,150987,40,2,305,103,202
2020,150987,40,3,521,233,288
2020,150987,40,4,262,101,161
2020,150987,40,5,1,1,0
2020,150987,42,0,1164,474,690
2020,150987,42,1,86,37,49
2020,150987,42,2,305,103,202
2020,150987,42,3,515,233,282
2020,150987,42,4,257,100,157
2020,150987,42,5,1,1,0
2020,150987,43,0,11,1,10
2020,150987,43,3,6,0,6
2020,150987,43,4,5,1,4
2020,151102,0,0,329,193,136
2020,151102,10,0,239,149,90
2020,151102,10,1,57,41,16
2020,151102,10,2,95,56,39
2020,151102,10,3,79,50,29
2020,151102,10,4,8,2,6
2020,151102,20,0,142,90,52
2020,151102,20,1,55,39,16
2020,151102,20,2,85,50,35
2020,151102,20,4,2,1,1
2020,151102,30,0,47,30,17
2020,151102,30,2,10,6,4
2020,151102,30,3,37,24,13
2020,151102,40,0,50,29,21
2020,151102,40,1,2,2,0
2020,151102,40,3,42,26,16
2020,151102,40,4,6,1,5
2020,151102,41,0,37,18,19
2020,151102,41,1,1,1,0
2020,151102,41,3,31,16,15
2020,151102,41,4,5,1,4
2020,151102,42,0,2,2,0
2020,151102,42,3,2,2,0
2020,151102,43,0,11,9,2
2020,151102,43,1,1,1,0
2020,151102,43,3,9,8,1
2020,151102,43,4,1,0,1
2020,151102,44,0,2,0,2
2020,151102,44,3,2,0,2
2020,151102,45,0,35,18,17
2020,151102,45,1,1,1,0
2020,151102,45,3,29,16,13
2020,151102,45,4,5,1,4
2020,151102,50,0,90,44,46
2020,151111,0,0,2636,1474,1162
2020,151111,10,0,2636,1474,1162
2020,151111,10,1,536,377,159
2020,151111,10,2,633,375,258
2020,151111,10,3,1141,588,553
2020,151111,10,5,326,134,192
2020,151111,20,0,855,569,286
2020,151111,20,1,457,332,125
2020,151111,20,2,396,235,161
2020,151111,20,3,2,2,0
2020,151111,30,0,334,184,150
2020,151111,30,1,3,2,1
2020,151111,30,2,32,21,11
2020,151111,30,3,299,161,138
2020,151111,40,0,1447,721,726
2020,151111,40,1,76,43,33
2020,151111,40,2,205,119,86
2020,151111,40,3,840,425,415
2020,151111,40,5,326,134,192
2020,151111,41,0,1362,691,671
2020,151111,41,1,71,40,31
2020,151111,41,2,204,118,86
2020,151111,41,3,812,414,398
2020,151111,41,5,275,119,156
2020,151111,42,0,85,30,55
2020,151111,42,1,5,3,2
2020,151111,42,2,1,1,0
2020,151111,42,3,28,11,17
2020,151111,42,5,51,15,36
2020,151111,44,0,782,401,381
2020,151111,44,1,18,9,9
2020,151111,44,2,76,39,37
2020,151111,44,3,515,265,250
2020,151111,44,5,173,88,85
2020,151111,45,0,580,290,290
2020,151111,45,1,53,31,22
2020,151111,45,2,128,79,49
2020,151111,45,3,297,149,148
2020,151111,45,5,102,31,71
2020,151263,0,0,302,128,174
2020,151263,10,0,302,128,174
2020,151263,10,1,45,20,25
2020,151263,10,2,78,37,41
2020,151263,10,3,151,59,92
2020,151263,10,4,28,12,16
2020,151263,20,0,109,50,59
2020,151263,20,1,43,20,23
2020,151263,20,2,65,30,35
2020,151263,20,3,1,0,1
2020,151263,30,0,104,43,61
2020,151263,30,1,1,0,1
2020,151263,30,2,7,4,3
2020,151263,30,3,96,39,57
2020,151263,40,0,89,35,54
2020,151263,40,1,1,0,1
2020,151263,40,2,6,3,3
2020,151263,40,3,54,20,34
2020,151263,40,4,28,12,16
2020,151263,42,0,89,35,54
2020,151263,42,1,1,0,1
2020,151263,42,2,6,3,3
2020,151263,42,3,54,20,34
2020,151263,42,4,28,12,16
2020,151290,0,0,68,39,29
2020,151290,10,0,68,39,29
2020,151290,10,1,6,5,1
2020,151290,10,2,30,16,14
2020,151290,10,3,29,17,12
2020,151290,10,5,3,1,2
2020,151290,20,0,29,18,11
2020,151290,20,1,6,5,1
2020,151290,20,2,23,13,10
2020,151290,30,0,32,19,13
2020,151290,30,2,5,3,2
2020,151290,30,3,27,16,11
2020,151290,40,0,7,2,5
2020,151290,40,2,2,0,2
2020,151290,40,3,2,1,1
2020,151290,40,5,3,1,2
2020,151290,42,0,7,2,5
2020,151290,42,2,2,0,2
2020,151290,42,3,2,1,1
2020,151290,42,5,3,1,2
2020,151306,0,0,349,153,196
2020,151306,10,0,349,153,196
2020,151306,10,1,48,29,19
2020,151306,10,2,116,59,57
2020,151306,10,3,110,41,69
2020,151306,10,4,75,24,51
2020,151306,20,0,165,91,74
2020,151306,20,1,48,29,19
2020,151306,20,2,112,59,53
2020,151306,20,3,5,3,2
2020,151306,30,0,83,34,49
2020,151306,30,3,83,34,49
2020,151306,40,0,101,28,73
2020,151306,40,2,4,0,4
2020,151306,40,3,22,4,18
2020,151306,40,4,75,24,51
2020,151306,41,0,96,27,69
2020,151306,41,2,4,0,4
2020,151306,41,3,21,4,17
2020,151306,41,4,71,23,48
2020,151306,42,0,5,1,4
2020,151306,42,3,1,0,1
2020,151306,42,4,4,1,3
2020,151306,44,0,10,4,6
2020,151306,44,3,1,0,1
2020,151306,44,4,9,4,5
2020,151306,45,0,86,23,63
2020,151306,45,2,4,0,4
2020,151306,45,3,20,4,16
2020,151306,45,4,62,19,43
2020,151324,0,0,457,242,215
2020,151324,10,0,457,242,215
2020,151324,10,1,134,85,49
2020,151324,10,2,98,47,51
2020,151324,10,3,104,54,50
2020,151324,10,4,110,48,62
2020,151324,10,5,11,8,3
2020,151324,20,0,233,133,100
2020,151324,20,1,134,85,49
2020,151324,20,2,97,46,51
2020,151324,20,3,2,2,0
2020,151324,30,0,103,53,50
2020,151324,30,2,1,1,0
2020,151324,30,3,102,52,50
2020,151324,40,0,121,56,65
2020,151324,40,4,110,48,62
2020,151324,40,5,11,8,3
2020,151324,41,0,110,48,62
2020,151324,41,4,110,48,62
2020,151324,42,0,11,8,3
2020,151324,42,5,11,8,3
2020,151324,44,0,110,48,62
2020,151324,44,4,110,48,62
2020,151333,0,0,125,48,77
2020,151333,10,0,125,48,77
2020,151333,10,1,9,7,2
2020,151333,10,2,29,14,15
2020,151333,10,3,43,16,27
2020,151333,10,5,44,11,33
2020,151333,20,0,25,16,9
2020,151333,20,1,8,7,1
2020,151333,20,2,17,9,8
2020,151333,30,0,44,20,24
2020,151333,30,2,9,5,4
2020,151333,30,3,35,15,20
2020,151333,40,0,56,12,44
2020,151333,40,1,1,0,1
2020,151333,40,2,3,0,3
2020,151333,40,3,8,1,7
2020,151333,40,5,44,11,33
2020,151333,41,0,47,7,40
2020,151333,41,1,1,0,1
2020,151333,41,2,3,0,3
2020,151333,41,3,8,1,7
2020,151333,41,5,35,6,29
2020,151333,42,0,9,5,4
2020,151333,42,5,9,5,4
2020,151333,44,0,12,1,11
2020,151333,44,1,1,0,1
2020,151333,44,2,2,0,2
2020,151333,44,3,2,0,2
2020,151333,44,5,7,1,6
2020,151333,45,0,35,6,29
2020,151333,45,2,1,0,1
2020,151333,45,3,6,1,5
2020,151333,45,5,28,5,23
2020,151342,0,0,234,114,120
2020,151342,10,0,234,114,120
2020,151342,10,1,54,32,22
2020,151342,10,2,72,44,28
2020,151342,10,3,56,22,34
2020,151342,10,5,52,16,36
2020,151342,20,0,124,74,50
2020,151342,20,1,53,31,22
2020,151342,20,2,71,43,28
2020,151342,30,0,27,16,11
2020,151342,30,1,1,1,0
2020,151342,30,3,26,15,11
2020,151342,40,0,83,24,59
2020,151342,40,2,1,1,0
2020,151342,40,3,30,7,23
2020,151342,40,5,52,16,36
2020,151342,41,0,67,15,52
2020,151342,41,2,1,1,0
2020,151342,41,3,21,2,19
2020,151342,41,5,45,12,33
2020,151342,42,0,16,9,7
2020,151342,42,3,9,5,4
2020,151342,42,5,7,4,3
2020,151342,44,0,9,1,8
2020,151342,44,2,1,1,0
2020,151342,44,5,8,0,8
2020,151342,45,0,58,14,44
2020,151342,45,3,21,2,19
2020,151342,45,5,37,12,25
2020,151351,0,0,2081,1238,843
2020,151351,10,0,2081,1238,843
2020,151351,10,1,703,490,213
2020,151351,10,2,524,313,211
2020,151351,10,3,392,212,180
2020,151351,10,5,462,223,239
2020,151351,20,0,1019,685,334
2020,151351,20,1,626,446,180
2020,151351,20,2,393,239,154
2020,151351,30,0,377,218,159
2020,151351,30,1,4,2,2
2020,151351,30,2,75,48,27
2020,151351,30,3,298,168,130
2020,151351,40,0,685,335,350
2020,151351,40,1,73,42,31
2020,151351,40,2,56,26,30
2020,151351,40,3,94,44,50
2020,151351,40,5,462,223,239
2020,151351,41,0,573,278,295
2020,151351,41,1,69,42,27
2020,151351,41,2,54,26,28
2020,151351,41,3,46,16,30
2020,151351,41,5,404,194,210
2020,151351,42,0,112,57,55
2020,151351,42,1,4,0,4
2020,151351,42,2,2,0,2
2020,151351,42,3,48,28,20
2020,151351,42,5,58,29,29
2020,151351,44,0,11,4,7
2020,151351,44,1,4,4,0
2020,151351,44,2,4,0,4
2020,151351,44,5,3,0,3
2020,151351,45,0,562,274,288
2020,151351,45,1,65,38,27
2020,151351,45,2,50,26,24
2020,151351,45,3,46,16,30
2020,151351,45,5,401,194,207
2020,151360,0,0,138,60,78
2020,151360,10,0,138,60,78
2020,151360,10,1,26,17,9
2020,151360,10,2,44,24,20
2020,151360,10,3,50,14,36
2020,151360,10,5,18,5,13
2020,151360,20,0,60,37,23
2020,151360,20,1,25,16,9
2020,151360,20,2,35,21,14
2020,151360,30,0,23,9,14
2020,151360,30,2,5,2,3
2020,151360,30,3,18,7,11
2020,151360,40,0,55,14,41
2020,151360,40,1,1,1,0
2020,151360,40,2,4,1,3
2020,151360,40,3,32,7,25
2020,151360,40,5,18,5,13
2020,151360,41,0,51,12,39
2020,151360,41,2,4,1,3
2020,151360,41,3,31,7,24
2020,151360,41,5,16,4,12
2020,151360,42,0,4,2,2
2020,151360,42,1,1,1,0
2020,151360,42,3,1,0,1
2020,151360,42,5,2,1,1
2020,151360,44,0,4,2,2
2020,151360,44,3,1,1,0
2020,151360,44,5,3,1,2
2020,151360,45,0,47,10,37
2020,151360,45,2,4,1,3
2020,151360,45,3,30,6,24
2020,151360,45,5,13,3,10
2020,151379,0,0,191,83,108
2020,151379,10,0,191,83,108
2020,151379,10,1,43,19,24
2020,151379,10,2,58,29,29
2020,151379,10,3,44,18,26
2020,151379,10,5,46,17,29
2020,151379,20,0,90,46,44
2020,151379,20,1,41,19,22
2020,151379,20,2,49,27,22
2020,151379,30,0,34,15,19
2020,151379,30,2,8,2,6
2020,151379,30,3,26,13,13
2020,151379,40,0,67,22,45
2020,151379,40,1,2,0,2
2020,151379,40,2,1,0,1
2020,151379,40,3,18,5,13
2020,151379,40,5,46,17,29
2020,151379,41,0,57,18,39
2020,151379,41,1,2,0,2
2020,151379,41,2,1,0,1
2020,151379,41,3,9,2,7
2020,151379,41,5,45,16,29
2020,151379,42,0,10,4,6
2020,151379,42,3,9,3,6
2020,151379,42,5,1,1,0
2020,151379,45,0,57,18,39
2020,151379,45,1,2,0,2
2020,151379,45,2,1,0,1
2020,151379,45,3,9,2,7
2020,151379,45,5,45,16,29
2020,151388,0,0,108,38,70
2020,151388,10,0,108,38,70
2020,151388,10,1,8,4,4
2020,151388,10,2,30,12,18
2020,151388,10,3,43,14,29
2020,151388,10,5,27,8,19
2020,151388,20,0,33,13,20
2020,151388,20,1,8,4,4
2020,151388,20,2,25,9,16
2020,151388,30,0,40,16,24
2020,151388,30,2,5,3,2
2020,151388,30,3,35,13,22
2020,151388,40,0,35,9,26
2020,151388,40,3,8,1,7
2020,151388,40,5,27,8,19
2020,151388,41,0,27,7,20
2020,151388,41,3,5,0,5
2020,151388,41,5,22,7,15
2020,151388,42,0,8,2,6
2020,151388,42,3,3,1,2
2020,151388,42,5,5,1,4
2020,151388,44,0,3,0,3
2020,151388,44,3,2,0,2
2020,151388,44,5,1,0,1
2020,151388,45,0,24,7,17
2020,151388,45,3,3,0,3
2020,151388,45,5,21,7,14
2020,151467,0,0,15,3,12
2020,151467,10,0,15,3,12
2020,151467,10,4,15,3,12
2020,151467,40,0,15,3,12
2020,151467,40,4,15,3,12
2020,151467,41,0,15,3,12
2020,151467,41,4,15,3,12
2020,151467,45,0,15,3,12
2020,151467,45,4,15,3,12
2020,151661,0,0,30,30,0
2020,151661,10,0,30,30,0
2020,151661,10,4,30,30,0
2020,151661,40,0,30,30,0
2020,151661,40,4,30,30,0
2020,151661,41,0,30,30,0
2020,151661,41,4,30,30,0
2020,151661,45,0,30,30,0
2020,151661,45,4,30,30,0
2020,151777,0,0,102,46,56
2020,151777,10,0,102,46,56
2020,151777,10,1,28,12,16
2020,151777,10,2,35,18,17
2020,151777,10,3,36,15,21
2020,151777,10,4,3,1,2
2020,151777,20,0,53,25,28
2020,151777,20,1,26,11,15
2020,151777,20,2,26,14,12
2020,151777,20,3,1,0,1
2020,151777,30,0,25,11,14
2020,151777,30,2,5,2,3
2020,151777,30,3,20,9,11
2020,151777,40,0,24,10,14
2020,151777,40,1,2,1,1
2020,151777,40,2,4,2,2
2020,151777,40,3,15,6,9
2020,151777,40,4,3,1,2
2020,151777,42,0,24,10,14
2020,151777,42,1,2,1,1
2020,151777,42,2,4,2,2
2020,151777,42,3,15,6,9
2020,151777,42,4,3,1,2
2020,151786,0,0,184,79,105
2020,151786,10,0,184,79,105
2020,151786,10,1,13,12,1
2020,151786,10,2,35,19,16
2020,151786,10,3,129,45,84
2020,151786,10,4,7,3,4
2020,151786,20,0,31,22,9
2020,151786,20,1,10,9,1
2020,151786,20,2,19,12,7
2020,151786,20,3,2,1,1
2020,151786,30,0,45,22,23
2020,151786,30,1,1,1,0
2020,151786,30,2,6,3,3
2020,151786,30,3,38,18,20
2020,151786,40,0,108,35,73
2020,151786,40,1,2,2,0
2020,151786,40,2,10,4,6
2020,151786,40,3,89,26,63
2020,151786,40,4,7,3,4
2020,151786,41,0,108,35,73
2020,151786,41,1,2,2,0
2020,151786,41,2,10,4,6
2020,151786,41,3,89,26,63
2020,151786,41,4,7,3,4
2020,151786,45,0,108,35,73
2020,151786,45,1,2,2,0
2020,151786,45,2,10,4,6
2020,151786,45,3,89,26,63
2020,151786,45,4,7,3,4
2020,151801,0,0,283,139,144
2020,151801,10,0,283,139,144
2020,151801,10,1,81,55,26
2020,151801,10,2,82,43,39
2020,151801,10,3,118,41,77
2020,151801,10,4,2,0,2
2020,151801,40,0,283,139,144
2020,151801,40,1,81,55,26
2020,151801,40,2,82,43,39
2020,151801,40,3,118,41,77
2020,151801,40,4,2,0,2
2020,151801,41,0,251,128,123
2020,151801,41,1,76,50,26
2020,151801,41,2,78,39,39
2020,151801,41,3,95,39,56
2020,151801,41,4,2,0,2
2020,151801,42,0,32,11,21
2020,151801,42,1,5,5,0
2020,151801,42,2,4,4,0
2020,151801,42,3,23,2,21
2020,151801,44,0,251,128,123
2020,151801,44,1,76,50,26
2020,151801,44,2,78,39,39
2020,151801,44,3,95,39,56
2020,151801,44,4,2,0,2
2020,151810,0,0,6,4,2
2020,151810,10,0,6,4,2
2020,151810,10,1,2,2,0
2020,151810,10,2,3,1,2
2020,151810,10,3,1,1,0
2020,151810,40,0,6,4,2
2020,151810,40,1,2,2,0
2020,151810,40,2,3,1,2
2020,151810,40,3,1,1,0
2020,151810,41,0,6,4,2
2020,151810,41,1,2,2,0
2020,151810,41,2,3,1,2
2020,151810,41,3,1,1,0
2020,151810,45,0,6,4,2
2020,151810,45,1,2,2,0
2020,151810,45,2,3,1,2
2020,151810,45,3,1,1,0
2020,151865,0,0,9,5,4
2020,151865,10,0,9,5,4
2020,151865,10,2,5,4,1
2020,151865,10,3,4,1,3
2020,151865,20,0,5,4,1
2020,151865,20,2,5,4,1
2020,151865,30,0,4,1,3
2020,151865,30,3,4,1,3
2020,152080,0,0,1210,828,382
2020,152080,10,0,1181,809,372
2020,152080,10,1,419,343,76
2020,152080,10,2,281,177,104
2020,152080,10,3,183,120,63
2020,152080,10,4,2,2,0
2020,152080,10,6,296,167,129
2020,152080,20,0,685,510,175
2020,152080,20,1,419,343,76
2020,152080,20,2,266,167,99
2020,152080,30,0,197,131,66
2020,152080,30,2,15,10,5
2020,152080,30,3,180,119,61
2020,152080,30,4,2,2,0
2020,152080,40,0,299,168,131
2020,152080,40,3,3,1,2
2020,152080,40,6,296,167,129
2020,152080,41,0,204,120,84
2020,152080,41,6,204,120,84
2020,152080,42,0,92,48,44
2020,152080,42,3,3,1,2
2020,152080,42,6,89,47,42
2020,152080,43,0,3,0,3
2020,152080,43,6,3,0,3
2020,152080,44,0,204,120,84
2020,152080,44,6,204,120,84
2020,152080,50,0,29,19,10
2020,152099,0,0,34,20,14
2020,152099,10,0,34,20,14
2020,152099,10,1,9,7,2
2020,152099,10,2,8,4,4
2020,152099,10,3,6,4,2
2020,152099,10,4,1,1,0
2020,152099,10,5,10,4,6
2020,152099,40,0,34,20,14
2020,152099,40,1,9,7,2
2020,152099,40,2,8,4,4
2020,152099,40,3,6,4,2
2020,152099,40,4,1,1,0
2020,152099,40,5,10,4,6
2020,152099,42,0,34,20,14
2020,152099,42,1,9,7,2
2020,152099,42,2,8,4,4
2020,152099,42,3,6,4,2
2020,152099,42,4,1,1,0
2020,152099,42,5,10,4,6
2020,152318,0,0,187,137,50
2020,152318,10,0,187,137,50
2020,152318,10,1,72,57,15
2020,152318,10,2,61,47,14
2020,152318,10,3,53,33,20
2020,152318,10,4,1,0,1
2020,152318,20,0,128,99,29
2020,152318,20,1,71,56,15
2020,152318,20,2,57,43,14
2020,152318,30,0,44,31,13
2020,152318,30,1,1,1,0
2020,152318,30,2,3,3,0
2020,152318,30,3,40,27,13
2020,152318,40,0,15,7,8
2020,152318,40,2,1,1,0
2020,152318,40,3,13,6,7
2020,152318,40,4,1,0,1
2020,152318,42,0,15,7,8
2020,152318,42,2,1,1,0
2020,152318,42,3,13,6,7
2020,152318,42,4,1,0,1
2020,152336,0,0,117,44,73
2020,152336,10,0,117,44,73
2020,152336,10,1,14,8,6
2020,152336,10,2,23,13,10
2020,152336,10,3,62,18,44
2020,152336,10,4,18,5,13
2020,152336,20,0,38,22,16
2020,152336,20,1,14,8,6
2020,152336,20,2,18,11,7
2020,152336,20,3,6,3,3
2020,152336,30,0,36,14,22
2020,152336,30,2,4,2,2
2020,152336,30,3,29,11,18
2020,152336,30,4,3,1,2
2020,152336,40,0,43,8,35
2020,152336,40,2,1,0,1
2020,152336,40,3,27,4,23
2020,152336,40,4,15,4,11
2020,152336,42,0,43,8,35
2020,152336,42,2,1,0,1
2020,152336,42,3,27,4,23
2020,152336,42,4,15,4,11
2020,152381,0,0,53,17,36
2020,152381,10,0,53,17,36
2020,152381,10,1,7,4,3
2020,152381,10,2,17,3,14
2020,152381,10,3,14,5,9
2020,152381,10,4,7,2,5
2020,152381,10,5,8,3,5
2020,152381,20,0,19,7,12
2020,152381,20,1,7,4,3
2020,152381,20,2,12,3,9
2020,152381,30,0,18,4,14
2020,152381,30,2,5,0,5
2020,152381,30,3,12,3,9
2020,152381,30,5,1,1,0
2020,152381,40,0,16,6,10
2020,152381,40,3,2,2,0
2020,152381,40,4,7,2,5
2020,152381,40,5,7,2,5
2020,152381,42,0,16,6,10
2020,152381,42,3,2,2,0
2020,152381,42,4,7,2,5
2020,152381,42,5,7,2,5
2020,152390,0,0,142,43,99
2020,152390,10,0,142,43,99
2020,152390,10,1,28,9,19
2020,152390,10,2,41,14,27
2020,152390,10,3,53,15,38
2020,152390,10,5,6,1,5
2020,152390,10,6,14,4,10
2020,152390,20,0,71,24,47
2020,152390,20,1,28,9,19
2020,152390,20,2,40,14,26
2020,152390,20,3,3,1,2
2020,152390,30,0,42,11,31
2020,152390,30,2,1,0,1
2020,152390,30,3,41,11,30
2020,152390,40,0,29,8,21
2020,152390,40,3,9,3,6
2020,152390,40,5,6,1,5
2020,152390,40,6,14,4,10
2020,152390,41,0,7,1,6
2020,152390,41,5,2,0,2
2020,152390,41,6,5,1,4
2020,152390,42,0,16,6,10
2020,152390,42,3,8,3,5
2020,152390,42,5,2,1,1
2020,152390,42,6,6,2,4
2020,152390,43,0,6,1,5
2020,152390,43,3,1,0,1
2020,152390,43,5,2,0,2
2020,152390,43,6,3,1,2
2020,152390,44,0,7,1,6
2020,152390,44,5,2,0,2
2020,152390,44,6,5,1,4
2020,152451,0,0,12,10,2
2020,152451,10,0,11,10,1
2020,152451,10,1,4,4,0
2020,152451,10,2,4,3,1
2020,152451,10,3,3,3,0
2020,152451,20,0,8,7,1
2020,152451,20,1,4,4,0
2020,152451,20,2,4,3,1
2020,152451,30,0,3,3,0
2020,152451,30,3,3,3,0
2020,152451,50,0,1,0,1
2020,152530,0,0,132,86,46
2020,152530,10,0,132,86,46
2020,152530,10,1,47,37,10
2020,152530,10,2,34,22,12
2020,152530,10,3,46,23,23
2020,152530,10,4,5,4,1
2020,152530,20,0,67,51,16
2020,152530,20,1,42,34,8
2020,152530,20,2,25,17,8
2020,152530,30,0,44,24,20
2020,152530,30,1,4,3,1
2020,152530,30,2,7,4,3
2020,152530,30,3,33,17,16
2020,152530,40,0,21,11,10
2020,152530,40,1,1,0,1
2020,152530,40,2,2,1,1
2020,152530,40,3,13,6,7
2020,152530,40,4,5,4,1
2020,152530,42,0,21,11,10
2020,152530,42,1,1,0,1
2020,152530,42,2,2,1,1
2020,152530,42,3,13,6,7
2020,152530,42,4,5,4,1
2020,152567,0,0,126,71,55
2020,152567,10,0,126,71,55
2020,152567,10,1,16,14,2
2020,152567,10,2,37,25,12
2020,152567,10,3,54,23,31
2020,152567,10,4,10,5,5
2020,152567,10,5,9,4,5
2020,152567,40,0,126,71,55
2020,152567,40,1,16,14,2
2020,152567,40,2,37,25,12
2020,152567,40,3,54,23,31
2020,152567,40,4,10,5,5
2020,152567,40,5,9,4,5
2020,152567,42,0,126,71,55
2020,152567,42,1,16,14,2
2020,152567,42,2,37,25,12
2020,152567,42,3,54,23,31
2020,152567,42,4,10,5,5
2020,152567,42,5,9,4,5
2020,152600,0,0,242,128,114
2020,152600,10,0,242,128,114
2020,152600,10,1,57,39,18
2020,152600,10,2,93,47,46
2020,152600,10,3,76,31,45
2020,152600,10,4,2,1,1
2020,152600,10,5,14,10,4
2020,152600,20,0,140,77,63
2020,152600,20,1,57,39,18
2020,152600,20,2,82,37,45
2020,152600,20,3,1,1,0
2020,152600,30,0,71,36,35
2020,152600,30,2,8,7,1
2020,152600,30,3,62,29,33
2020,152600,30,4,1,0,1
2020,152600,40,0,31,15,16
2020,152600,40,2,3,3,0
2020,152600,40,3,13,1,12
2020,152600,40,4,1,1,0
2020,152600,40,5,14,10,4
2020,152600,42,0,31,15,16
2020,152600,42,2,3,3,0
2020,152600,42,3,13,1,12
2020,152600,42,4,1,1,0
2020,152600,42,5,14,10,4
2020,152637,0,0,180,88,92
2020,152637,10,0,180,88,92
2020,152637,10,1,27,6,21
2020,152637,10,2,46,22,24
2020,152637,10,3,73,30,43
2020,152637,10,4,34,30,4
2020,152637,20,0,42,15,27
2020,152637,20,1,21,5,16
2020,152637,20,2,20,9,11
2020,152637,20,4,1,1,0
2020,152637,30,0,16,6,10
2020,152637,30,1,1,0,1
2020,152637,30,2,8,5,3
2020,152637,30,3,7,1,6
2020,152637,40,0,122,67,55
2020,152637,40,1,5,1,4
2020,152637,40,2,18,8,10
2020,152637,40,3,66,29,37
2020,152637,40,4,33,29,4
2020,152637,42,0,122,67,55
2020,152637,42,1,5,1,4
2020,152637,42,2,18,8,10
2020,152637,42,3,66,29,37
2020,152637,42,4,33,29,4
2020,152673,0,0,90,55,35
2020,152673,10,0,90,55,35
2020,152673,10,1,23,17,6
2020,152673,10,2,38,21,17
2020,152673,10,3,27,17,10
2020,152673,10,4,2,0,2
2020,152673,20,0,60,37,23
2020,152673,20,1,23,17,6
2020,152673,20,2,37,20,17
2020,152673,30,0,20,12,8
2020,152673,30,3,20,12,8
2020,152673,40,0,10,6,4
2020,152673,40,2,1,1,0
2020,152673,40,3,7,5,2
2020,152673,40,4,2,0,2
2020,152673,41,0,8,4,4
2020,152673,41,2,1,1,0
2020,152673,41,3,5,3,2
2020,152673,41,4,2,0,2
2020,152673,42,0,2,2,0
2020,152673,42,3,2,2,0
2020,152673,44,0,7,3,4
2020,152673,44,3,5,3,2
2020,152673,44,4,2,0,2
2020,152673,45,0,1,1,0
2020,152673,45,2,1,1,0
2020,152798,0,0,43,5,38
2020,152798,10,0,43,5,38
2020,152798,10,1,9,1,8
2020,152798,10,2,20,2,18
2020,152798,10,3,13,2,11
2020,152798,10,4,1,0,1
2020,152798,40,0,43,5,38
2020,152798,40,1,9,1,8
2020,152798,40,2,20,2,18
2020,152798,40,3,13,2,11
2020,152798,40,4,1,0,1
2020,152798,41,0,5,2,3
2020,152798,41,1,1,1,0
2020,152798,41,2,2,1,1
2020,152798,41,3,2,0,2
2020,152798,42,0,38,3,35
2020,152798,42,1,8,0,8
2020,152798,42,2,18,1,17
2020,152798,42,3,11,2,9
2020,152798,42,4,1,0,1
2020,152798,44,0,5,2,3
2020,152798,44,1,1,1,0
2020,152798,44,2,2,1,1
2020,152798,44,3,2,0,2
2020,152992,0,0,70,34,36
2020,152992,10,0,69,34,35
2020,152992,10,1,13,10,3
2020,152992,10,2,21,13,8
2020,152992,10,3,27,10,17
2020,152992,10,4,8,1,7
2020,152992,20,0,31,22,9
2020,152992,20,1,13,10,3
2020,152992,20,2,17,11,6
2020,152992,20,3,1,1,0
2020,152992,30,0,30,11,19
2020,152992,30,2,4,2,2
2020,152992,30,3,26,9,17
2020,152992,40,0,8,1,7
2020,152992,40,4,8,1,7
2020,152992,42,0,1,1,0
2020,152992,42,4,1,1,0
2020,152992,43,0,7,0,7
2020,152992,43,4,7,0,7
2020,152992,50,0,1,0,1
2020,153001,0,0,61,31,30
2020,153001,10,0,61,31,30
2020,153001,10,1,14,8,6
2020,153001,10,2,16,7,9
2020,153001,10,3,21,11,10
2020,153001,10,4,10,5,5
2020,153001,20,0,29,16,13
2020,153001,20,1,14,8,6
2020,153001,20,2,12,5,7
2020,153001,20,3,3,3,0
2020,153001,30,0,16,8,8
2020,153001,30,2,4,2,2
2020,153001,30,3,12,6,6
2020,153001,40,0,16,7,9
2020,153001,40,3,6,2,4
2020,153001,40,4,10,5,5
2020,153001,42,0,16,7,9
2020,153001,42,3,6,2,4
2020,153001,42,4,10,5,5
2020,153108,0,0,99,50,49
2020,153108,10,0,99,50,49
2020,153108,10,1,32,20,12
2020,153108,10,2,33,14,19
2020,153108,10,3,21,9,12
2020,153108,10,5,13,7,6
2020,153108,20,0,64,33,31
2020,153108,20,1,31,19,12
2020,153108,20,2,33,14,19
2020,153108,30,0,22,10,12
2020,153108,30,1,1,1,0
2020,153108,30,3,21,9,12
2020,153108,40,0,13,7,6
2020,153108,40,5,13,7,6
2020,153108,41,0,13,7,6
2020,153108,41,5,13,7,6
2020,153108,45,0,13,7,6
2020,153108,45,5,13,7,6
2020,153126,0,0,79,23,56
2020,153126,10,0,79,23,56
2020,153126,10,1,18,6,12
2020,153126,10,2,17,8,9
2020,153126,10,3,33,9,24
2020,153126,10,4,11,0,11
2020,153126,20,0,36,15,21
2020,153126,20,1,18,6,12
2020,153126,20,2,17,8,9
2020,153126,20,3,1,1,0
2020,153126,30,0,18,3,15
2020,153126,30,3,18,3,15
2020,153126,40,0,25,5,20
2020,153126,40,3,14,5,9
2020,153126,40,4,11,0,11
2020,153126,41,0,15,4,11
2020,153126,41,3,13,4,9
2020,153126,41,4,2,0,2
2020,153126,42,0,10,1,9
2020,153126,42,3,1,1,0
2020,153126,42,4,9,0,9
2020,153126,44,0,15,4,11
2020,153126,44,3,13,4,9
2020,153126,44,4,2,0,2
2020,153144,0,0,128,59,69
2020,153144,10,0,120,56,64
2020,153144,10,1,28,21,7
2020,153144,10,2,26,10,16
2020,153144,10,3,57,24,33
2020,153144,10,4,9,1,8
2020,153144,20,0,59,33,26
2020,153144,20,1,27,20,7
2020,153144,20,2,26,10,16
2020,153144,20,3,5,3,2
2020,153144,20,4,1,0,1
2020,153144,30,0,32,13,19
2020,153144,30,3,32,13,19
2020,153144,40,0,29,10,19
2020,153144,40,1,1,1,0
2020,153144,40,3,20,8,12
2020,153144,40,4,8,1,7
2020,153144,41,0,15,4,11
2020,153144,41,3,7,3,4
2020,153144,41,4,8,1,7
2020,153144,42,0,14,6,8
2020,153144,42,1,1,1,0
2020,153144,42,3,13,5,8
2020,153144,44,0,15,4,11
2020,153144,44,3,7,3,4
2020,153144,44,4,8,1,7
2020,153144,50,0,8,3,5
2020,153162,0,0,83,40,43
2020,153162,10,0,74,35,39
2020,153162,10,1,42,20,22
2020,153162,10,2,11,3,8
2020,153162,10,3,21,12,9
2020,153162,20,0,53,23,30
2020,153162,20,1,42,20,22
2020,153162,20,2,11,3,8
2020,153162,30,0,21,12,9
2020,153162,30,3,21,12,9
2020,153162,50,0,9,5,4
2020,153214,0,0,357,174,183
2020,153214,10,0,357,174,183
2020,153214,10,1,215,112,103
2020,153214,10,2,56,22,34
2020,153214,10,4,86,40,46
2020,153214,40,0,357,174,183
2020,153214,40,1,215,112,103
2020,153214,40,2,56,22,34
2020,153214,40,4,86,40,46
2020,153214,42,0,357,174,183
2020,153214,42,1,215,112,103
2020,153214,42,2,56,22,34
2020,153214,42,4,86,40,46
2020,153241,0,0,17,8,9
2020,153241,10,0,17,8,9
2020,153241,10,1,1,1,0
2020,153241,10,2,1,1,0
2020,153241,10,3,12,6,6
2020,153241,10,4,3,0,3
2020,153241,40,0,17,8,9
2020,153241,40,1,1,1,0
2020,153241,40,2,1,1,0
2020,153241,40,3,12,6,6
2020,153241,40,4,3,0,3
2020,153241,41,0,14,7,7
2020,153241,41,1,1,1,0
2020,153241,41,2,1,1,0
2020,153241,41,3,9,5,4
2020,153241,41,4,3,0,3
2020,153241,42,0,3,1,2
2020,153241,42,3,3,1,2
2020,153241,44,0,14,7,7
2020,153241,44,1,1,1,0
2020,153241,44,2,1,1,0
2020,153241,44,3,9,5,4
2020,153241,44,4,3,0,3
2020,153250,0,0,89,63,26
2020,153250,10,0,89,63,26
2020,153250,10,1,36,29,7
2020,153250,10,2,27,20,7
2020,153250,10,3,13,8,5
2020,153250,10,4,13,6,7
2020,153250,40,0,89,63,26
2020,153250,40,1,36,29,7
2020,153250,40,2,27,20,7
2020,153250,40,3,13,8,5
2020,153250,40,4,13,6,7
2020,153250,41,0,89,63,26
2020,153250,41,1,36,29,7
2020,153250,41,2,27,20,7
2020,153250,41,3,13,8,5
2020,153250,41,4,13,6,7
2020,153250,44,0,89,63,26
2020,153250,44,1,36,29,7
2020,153250,44,2,27,20,7
2020,153250,44,3,13,8,5
2020,153250,44,4,13,6,7
2020,153269,0,0,300,153,147
2020,153269,10,0,300,153,147
2020,153269,10,1,93,56,37
2020,153269,10,2,126,60,66
2020,153269,10,3,78,35,43
2020,153269,10,4,3,2,1
2020,153269,20,0,176,100,76
2020,153269,20,1,89,55,34
2020,153269,20,2,87,45,42
2020,153269,30,0,66,30,36
2020,153269,30,2,12,5,7
2020,153269,30,3,54,25,29
2020,153269,40,0,58,23,35
2020,153269,40,1,4,1,3
2020,153269,40,2,27,10,17
2020,153269,40,3,24,10,14
2020,153269,40,4,3,2,1
2020,153269,41,0,58,23,35
2020,153269,41,1,4,1,3
2020,153269,41,2,27,10,17
2020,153269,41,3,24,10,14
2020,153269,41,4,3,2,1
2020,153269,45,0,58,23,35
2020,153269,45,1,4,1,3
2020,153269,45,2,27,10,17
2020,153269,45,3,24,10,14
2020,153269,45,4,3,2,1
2020,153278,0,0,106,56,50
2020,153278,10,0,106,56,50
2020,153278,10,1,22,17,5
2020,153278,10,2,29,16,13
2020,153278,10,3,51,21,30
2020,153278,10,4,4,2,2
2020,153278,20,0,20,17,3
2020,153278,20,1,17,15,2
2020,153278,20,2,3,2,1
2020,153278,30,0,15,8,7
2020,153278,30,1,1,0,1
2020,153278,30,2,4,2,2
2020,153278,30,3,10,6,4
2020,153278,40,0,71,31,40
2020,153278,40,1,4,2,2
2020,153278,40,2,22,12,10
2020,153278,40,3,41,15,26
2020,153278,40,4,4,2,2
2020,153278,41,0,67,29,38
2020,153278,41,1,4,2,2
2020,153278,41,2,22,12,10
2020,153278,41,3,41,15,26
2020,153278,42,0,4,2,2
2020,153278,42,4,4,2,2
2020,153278,44,0,67,29,38
2020,153278,44,1,4,2,2
2020,153278,44,2,22,12,10
2020,153278,44,3,41,15,26
2020,153296,0,0,26,16,10
2020,153296,10,0,26,16,10
2020,153296,10,1,10,8,2
2020,153296,10,2,11,6,5
2020,153296,10,3,3,1,2
2020,153296,10,4,2,1,1
2020,153296,40,0,26,16,10
2020,153296,40,1,10,8,2
2020,153296,40,2,11,6,5
2020,153296,40,3,3,1,2
2020,153296,40,4,2,1,1
2020,153296,41,0,26,16,10
2020,153296,41,1,10,8,2
2020,153296,41,2,11,6,5
2020,153296,41,3,3,1,2
2020,153296,41,4,2,1,1
2020,153296,45,0,26,16,10
2020,153296,45,1,10,8,2
2020,153296,45,2,11,6,5
2020,153296,45,3,3,1,2
2020,153296,45,4,2,1,1
2020,153302,0,0,22,18,4
2020,153302,10,0,22,18,4
2020,153302,10,6,22,18,4
2020,153302,40,0,22,18,4
2020,153302,40,6,22,18,4
2020,153302,41,0,22,18,4
2020,153302,41,6,22,18,4
2020,153302,45,0,22,18,4
2020,153302,45,6,22,18,4
2020,153311,0,0,135,56,79
2020,153311,10,0,135,56,79
2020,153311,10,4,135,56,79
2020,153311,40,0,135,56,79
2020,153311,40,4,135,56,79
2020,153311,42,0,135,56,79
2020,153311,42,4,135,56,79
2020,153320,0,0,20,16,4
2020,153320,10,0,20,16,4
2020,153320,10,1,6,6,0
2020,153320,10,2,4,3,1
2020,153320,10,3,9,7,2
2020,153320,10,4,1,0,1
2020,153320,40,0,20,16,4
2020,153320,40,1,6,6,0
2020,153320,40,2,4,3,1
2020,153320,40,3,9,7,2
2020,153320,40,4,1,0,1
2020,153320,42,0,20,16,4
2020,153320,42,1,6,6,0
2020,153320,42,2,4,3,1
2020,153320,42,3,9,7,2
2020,153320,42,4,1,0,1
2020,153366,0,0,61,24,37
2020,153366,10,0,61,24,37
2020,153366,10,1,16,9,7
2020,153366,10,2,14,7,7
2020,153366,10,3,20,7,13
2020,153366,10,4,5,1,4
2020,153366,10,6,6,0,6
2020,153366,20,0,29,16,13
2020,153366,20,1,16,9,7
2020,153366,20,2,13,7,6
2020,153366,30,0,22,7,15
2020,153366,30,2,1,0,1
2020,153366,30,3,20,7,13
2020,153366,30,4,1,0,1
2020,153366,40,0,10,1,9
2020,153366,40,4,4,1,3
2020,153366,40,6,6,0,6
2020,153366,41,0,10,1,9
2020,153366,41,4,4,1,3
2020,153366,41,6,6,0,6
2020,153366,44,0,10,1,9
2020,153366,44,4,4,1,3
2020,153366,44,6,6,0,6
2020,153375,0,0,89,41,48
2020,153375,10,0,89,41,48
2020,153375,10,1,24,19,5
2020,153375,10,2,18,3,15
2020,153375,10,3,36,16,20
2020,153375,10,4,8,3,5
2020,153375,10,6,3,0,3
2020,153375,20,0,33,21,12
2020,153375,20,1,20,17,3
2020,153375,20,2,12,3,9
2020,153375,20,3,1,1,0
2020,153375,30,0,30,9,21
2020,153375,30,1,4,2,2
2020,153375,30,2,6,0,6
2020,153375,30,3,20,7,13
2020,153375,40,0,26,11,15
2020,153375,40,3,15,8,7
2020,153375,40,4,8,3,5
2020,153375,40,6,3,0,3
2020,153375,41,0,7,5,2
2020,153375,41,3,5,4,1
2020,153375,41,4,2,1,1
2020,153375,42,0,19,6,13
2020,153375,42,3,10,4,6
2020,153375,42,4,6,2,4
2020,153375,42,6,3,0,3
2020,153375,44,0,7,5,2
2020,153375,44,3,5,4,1
2020,153375,44,4,2,1,1
2020,153384,0,0,202,102,100
2020,153384,10,0,202,102,100
2020,153384,10,1,53,27,26
2020,153384,10,2,64,37,27
2020,153384,10,3,68,29,39
2020,153384,10,4,4,4,0
2020,153384,10,5,13,5,8
2020,153384,20,0,112,62,50
2020,153384,20,1,53,27,26
2020,153384,20,2,59,35,24
2020,153384,30,0,37,15,22
2020,153384,30,2,1,0,1
2020,153384,30,3,36,15,21
2020,153384,40,0,53,25,28
2020,153384,40,2,4,2,2
2020,153384,40,3,32,14,18
2020,153384,40,4,4,4,0
2020,153384,40,5,13,5,8
2020,153384,41,0,39,17,22
2020,153384,41,2,4,2,2
2020,153384,41,3,21,9,12
2020,153384,41,4,2,2,0
2020,153384,41,5,12,4,8
2020,153384,42,0,14,8,6
2020,153384,42,3,11,5,6
2020,153384,42,4,2,2,0
2020,153384,42,5,1,1,0
2020,153384,44,0,31,15,16
2020,153384,44,2,4,2,2
2020,153384,44,3,21,9,12
2020,153384,44,4,2,2,0
2020,153384,44,5,4,2,2
2020,153384,45,0,8,2,6
2020,153384,45,5,8,2,6
2020,153445,0,0,103,46,57
2020,153445,10,0,103,46,57
2020,153445,10,6,103,46,57
2020,153445,40,0,103,46,57
2020,153445,40,6,103,46,57
2020,153445,42,0,103,46,57
2020,153445,42,6,103,46,57
2020,153472,0,0,129,63,66
2020,153472,10,0,127,63,64
2020,153472,10,1,12,7,5
2020,153472,10,2,16,9,7
2020,153472,10,4,96,44,52
2020,153472,10,6,3,3,0
2020,153472,40,0,127,63,64
2020,153472,40,1,12,7,5
2020,153472,40,2,16,9,7
2020,153472,40,4,96,44,52
2020,153472,40,6,3,3,0
2020,153472,41,0,1,1,0
2020,153472,41,4,1,1,0
2020,153472,42,0,126,62,64
2020,153472,42,1,12,7,5
2020,153472,42,2,16,9,7
2020,153472,42,4,95,43,52
2020,153472,42,6,3,3,0
2020,153472,45,0,1,1,0
2020,153472,45,4,1,1,0
2020,153472,50,0,2,0,2
2020,153524,0,0,88,51,37
2020,153524,10,0,88,51,37
2020,153524,10,1,13,4,9
2020,153524,10,2,7,4,3
2020,153524,10,3,5,3,2
2020,153524,10,4,63,40,23
2020,153524,40,0,88,51,37
2020,153524,40,1,13,4,9
2020,153524,40,2,7,4,3
2020,153524,40,3,5,3,2
2020,153524,40,4,63,40,23
2020,153524,42,0,88,51,37
2020,153524,42,1,13,4,9
2020,153524,42,2,7,4,3
2020,153524,42,3,5,3,2
2020,153524,42,4,63,40,23
2020,153533,0,0,69,33,36
2020,153533,10,0,69,33,36
2020,153533,10,1,25,7,18
2020,153533,10,2,10,4,6
2020,153533,10,3,24,15,9
2020,153533,10,4,10,7,3
2020,153533,40,0,69,33,36
2020,153533,40,1,25,7,18
2020,153533,40,2,10,4,6
2020,153533,40,3,24,15,9
2020,153533,40,4,10,7,3
2020,153533,42,0,69,33,36
2020,153533,42,1,25,7,18
2020,153533,42,2,10,4,6
2020,153533,42,3,24,15,9
2020,153533,42,4,10,7,3
2020,153603,0,0,1519,958,561
2020,153603,10,0,1519,958,561
2020,153603,10,1,563,421,142
2020,153603,10,2,504,284,220
2020,153603,10,3,439,249,190
2020,153603,10,5,13,4,9
2020,153603,20,0,909,630,279
2020,153603,20,1,517,394,123
2020,153603,20,2,391,236,155
2020,153603,20,3,1,0,1
2020,153603,30,0,296,181,115
2020,153603,30,2,10,9,1
2020,153603,30,3,286,172,114
2020,153603,40,0,314,147,167
2020,153603,40,1,46,27,19
2020,153603,40,2,103,39,64
2020,153603,40,3,152,77,75
2020,153603,40,5,13,4,9
2020,153603,41,0,250,117,133
2020,153603,41,1,40,25,15
2020,153603,41,2,83,31,52
2020,153603,41,3,125,61,64
2020,153603,41,5,2,0,2
2020,153603,42,0,24,9,15
2020,153603,42,1,3,1,2
2020,153603,42,2,11,4,7
2020,153603,42,3,7,3,4
2020,153603,42,5,3,1,2
2020,153603,43,0,40,21,19
2020,153603,43,1,3,1,2
2020,153603,43,2,9,4,5
2020,153603,43,3,20,13,7
2020,153603,43,5,8,3,5
2020,153603,44,0,247,116,131
2020,153603,44,1,40,25,15
2020,153603,44,2,83,31,52
2020,153603,44,3,123,60,63
2020,153603,44,5,1,0,1
2020,153603,45,0,3,1,2
2020,153603,45,3,2,1,1
2020,153603,45,5,1,0,1
2020,153621,0,0,37,16,21
2020,153621,10,0,37,16,21
2020,153621,10,1,7,3,4
2020,153621,10,2,8,3,5
2020,153621,10,3,19,8,11
2020,153621,10,4,3,2,1
2020,153621,20,0,13,4,9
2020,153621,20,1,7,3,4
2020,153621,20,2,5,1,4
2020,153621,20,3,1,0,1
2020,153621,30,0,11,4,7
2020,153621,30,2,2,1,1
2020,153621,30,3,9,3,6
2020,153621,40,0,13,8,5
2020,153621,40,2,1,1,0
2020,153621,40,3,9,5,4
2020,153621,40,4,3,2,1
2020,153621,42,0,13,8,5
2020,153621,42,2,1,1,0
2020,153621,42,3,9,5,4
2020,153621,42,4,3,2,1
2020,153630,0,0,103,51,52
2020,153630,10,0,103,51,52
2020,153630,10,1,7,2,5
2020,153630,10,2,6,1,5
2020,153630,10,3,11,4,7
2020,153630,10,4,79,44,35
2020,153630,40,0,103,51,52
2020,153630,40,1,7,2,5
2020,153630,40,2,6,1,5
2020,153630,40,3,11,4,7
2020,153630,40,4,79,44,35
2020,153630,42,0,103,51,52
2020,153630,42,1,7,2,5
2020,153630,42,2,6,1,5
2020,153630,42,3,11,4,7
2020,153630,42,4,79,44,35
2020,153658,0,0,2485,1458,1027
2020,153658,10,0,2485,1458,1027
2020,153658,10,1,762,556,206
2020,153658,10,2,757,424,333
2020,153658,10,3,712,362,350
2020,153658,10,4,4,2,2
2020,153658,10,5,172,70,102
2020,153658,10,6,78,44,34
2020,153658,20,0,1007,696,311
2020,153658,20,1,592,450,142
2020,153658,20,2,415,246,169
2020,153658,30,0,324,178,146
2020,153658,30,1,3,2,1
2020,153658,30,2,22,16,6
2020,153658,30,3,299,160,139
2020,153658,40,0,1154,584,570
2020,153658,40,1,167,104,63
2020,153658,40,2,320,162,158
2020,153658,40,3,413,202,211
2020,153658,40,4,4,2,2
2020,153658,40,5,172,70,102
2020,153658,40,6,78,44,34
2020,153658,41,0,1036,517,519
2020,153658,41,1,165,103,62
2020,153658,41,2,316,159,157
2020,153658,41,3,382,184,198
2020,153658,41,4,2,1,1
2020,153658,41,5,171,70,101
2020,153658,42,0,118,67,51
2020,153658,42,1,2,1,1
2020,153658,42,2,4,3,1
2020,153658,42,3,31,18,13
2020,153658,42,4,2,1,1
2020,153658,42,5,1,0,1
2020,153658,42,6,78,44,34
2020,153658,44,0,1036,517,519
2020,153658,44,1,165,103,62
2020,153658,44,2,316,159,157
2020,153658,44,3,382,184,198
2020,153658,44,4,2,1,1
2020,153658,44,5,171,70,101
2020,153737,0,0,261,144,117
2020,153737,10,0,254,141,113
2020,153737,10,1,104,62,42
2020,153737,10,2,50,25,25
2020,153737,10,3,58,33,25
2020,153737,10,4,40,20,20
2020,153737,10,6,2,1,1
2020,153737,40,0,254,141,113
2020,153737,40,1,104,62,42
2020,153737,40,2,50,25,25
2020,153737,40,3,58,33,25
2020,153737,40,4,40,20,20
2020,153737,40,6,2,1,1
2020,153737,42,0,254,141,113
2020,153737,42,1,104,62,42
2020,153737,42,2,50,25,25
2020,153737,42,3,58,33,25
2020,153737,42,4,40,20,20
2020,153737,42,6,2,1,1
2020,153737,50,0,7,3,4
2020,153825,0,0,99,57,42
2020,153825,10,0,99,57,42
2020,153825,10,1,26,20,6
2020,153825,10,2,44,23,21
2020,153825,10,3,27,14,13
2020,153825,10,4,2,0,2
2020,153825,20,0,68,42,26
2020,153825,20,1,24,19,5
2020,153825,20,2,44,23,21
2020,153825,30,0,23,12,11
2020,153825,30,3,23,12,11
2020,153825,40,0,8,3,5
2020,153825,40,1,2,1,1
2020,153825,40,3,4,2,2
2020,153825,40,4,2,0,2
2020,153825,41,0,3,2,1
2020,153825,41,3,3,2,1
2020,153825,42,0,5,1,4
2020,153825,42,1,2,1,1
2020,153825,42,3,1,0,1
2020,153825,42,4,2,0,2
2020,153825,44,0,3,2,1
2020,153825,44,3,3,2,1
2020,153834,0,0,153,84,69
2020,153834,10,0,153,84,69
2020,153834,10,1,62,41,21
2020,153834,10,2,55,24,31
2020,153834,10,3,17,9,8
2020,153834,10,4,19,10,9
2020,153834,20,0,113,62,51
2020,153834,20,1,61,40,21
2020,153834,20,2,52,22,30
2020,153834,30,0,13,5,8
2020,153834,30,2,2,1,1
2020,153834,30,3,11,4,7
2020,153834,40,0,27,17,10
2020,153834,40,1,1,1,0
2020,153834,40,2,1,1,0
2020,153834,40,3,6,5,1
2020,153834,40,4,19,10,9
2020,153834,42,0,27,17,10
2020,153834,42,1,1,1,0
2020,153834,42,2,1,1,0
2020,153834,42,3,6,5,1
2020,153834,42,4,19,10,9
2020,153861,0,0,100,67,33
2020,153861,10,0,100,67,33
2020,153861,10,1,16,13,3
2020,153861,10,2,17,11,6
2020,153861,10,3,37,22,15
2020,153861,10,4,27,18,9
2020,153861,10,5,2,2,0
2020,153861,10,6,1,1,0
2020,153861,40,0,100,67,33
2020,153861,40,1,16,13,3
2020,153861,40,2,17,11,6
2020,153861,40,3,37,22,15
2020,153861,40,4,27,18,9
2020,153861,40,5,2,2,0
2020,153861,40,6,1,1,0
2020,153861,41,0,100,67,33
2020,153861,41,1,16,13,3
2020,153861,41,2,17,11,6
2020,153861,41,3,37,22,15
2020,153861,41,4,27,18,9
2020,153861,41,5,2,2,0
2020,153861,41,6,1,1,0
2020,153861,45,0,100,67,33
2020,153861,45,1,16,13,3
2020,153861,45,2,17,11,6
2020,153861,45,3,37,22,15
2020,153861,45,4,27,18,9
2020,153861,45,5,2,2,0
2020,153861,45,6,1,1,0
2020,153922,0,0,48,26,22
2020,153922,10,0,48,26,22
2020,153922,10,1,25,13,12
2020,153922,10,2,17,10,7
2020,153922,10,3,4,2,2
2020,153922,10,4,2,1,1
2020,153922,40,0,48,26,22
2020,153922,40,1,25,13,12
2020,153922,40,2,17,10,7
2020,153922,40,3,4,2,2
2020,153922,40,4,2,1,1
2020,153922,41,0,48,26,22
2020,153922,41,1,25,13,12
2020,153922,41,2,17,10,7
2020,153922,41,3,4,2,2
2020,153922,41,4,2,1,1
2020,153922,45,0,48,26,22
2020,153922,45,1,25,13,12
2020,153922,45,2,17,10,7
2020,153922,45,3,4,2,2
2020,153922,45,4,2,1,1
2020,153977,0,0,61,7,54
2020,153977,10,0,61,7,54
2020,153977,10,1,6,2,4
2020,153977,10,2,3,0,3
2020,153977,10,3,46,3,43
2020,153977,10,4,6,2,4
2020,153977,40,0,61,7,54
2020,153977,40,1,6,2,4
2020,153977,40,2,3,0,3
2020,153977,40,3,46,3,43
2020,153977,40,4,6,2,4
2020,153977,41,0,61,7,54
2020,153977,41,1,6,2,4
2020,153977,41,2,3,0,3
2020,153977,41,3,46,3,43
2020,153977,41,4,6,2,4
2020,153977,44,0,61,7,54
2020,153977,44,1,6,2,4
2020,153977,44,2,3,0,3
2020,153977,44,3,46,3,43
2020,153977,44,4,6,2,4
2020,154004,0,0,72,33,39
2020,154004,10,0,72,33,39
2020,154004,10,1,14,7,7
2020,154004,10,2,30,16,14
2020,154004,10,3,24,9,15
2020,154004,10,4,4,1,3
2020,154004,20,0,37,20,17
2020,154004,20,1,14,7,7
2020,154004,20,2,23,13,10
2020,154004,30,0,20,8,12
2020,154004,30,2,4,2,2
2020,154004,30,3,14,5,9
2020,154004,30,4,2,1,1
2020,154004,40,0,15,5,10
2020,154004,40,2,3,1,2
2020,154004,40,3,10,4,6
2020,154004,40,4,2,0,2
2020,154004,41,0,15,5,10
2020,154004,41,2,3,1,2
2020,154004,41,3,10,4,6
2020,154004,41,4,2,0,2
2020,154004,44,0,2,0,2
2020,154004,44,3,1,0,1
2020,154004,44,4,1,0,1
2020,154004,45,0,13,5,8
2020,154004,45,2,3,1,2
2020,154004,45,3,9,4,5
2020,154004,45,4,1,0,1
2020,154013,0,0,84,36,48
2020,154013,10,0,84,36,48
2020,154013,10,1,13,6,7
2020,154013,10,2,22,12,10
2020,154013,10,3,45,17,28
2020,154013,10,5,4,1,3
2020,154013,20,0,34,16,18
2020,154013,20,1,13,6,7
2020,154013,20,2,20,10,10
2020,154013,20,3,1,0,1
2020,154013,30,0,16,10,6
2020,154013,30,2,2,2,0
2020,154013,30,3,14,8,6
2020,154013,40,0,34,10,24
2020,154013,40,3,30,9,21
2020,154013,40,5,4,1,3
2020,154013,41,0,34,10,24
2020,154013,41,3,30,9,21
2020,154013,41,5,4,1,3
2020,154013,44,0,34,10,24
2020,154013,44,3,30,9,21
2020,154013,44,5,4,1,3
2020,154022,0,0,119,42,77
2020,154022,10,0,119,42,77
2020,154022,10,1,28,13,15
2020,154022,10,2,44,13,31
2020,154022,10,3,39,14,25
2020,154022,10,4,8,2,6
2020,154022,40,0,119,42,77
2020,154022,40,1,28,13,15
2020,154022,40,2,44,13,31
2020,154022,40,3,39,14,25
2020,154022,40,4,8,2,6
2020,154022,41,0,119,42,77
2020,154022,41,1,28,13,15
2020,154022,41,2,44,13,31
2020,154022,41,3,39,14,25
2020,154022,41,4,8,2,6
2020,154022,45,0,119,42,77
2020,154022,45,1,28,13,15
2020,154022,45,2,44,13,31
2020,154022,45,3,39,14,25
2020,154022,45,4,8,2,6
2020,154059,0,0,67,37,30
2020,154059,10,0,67,37,30
2020,154059,10,5,67,37,30
2020,154059,40,0,67,37,30
2020,154059,40,5,67,37,30
2020,154059,42,0,67,37,30
2020,154059,42,5,67,37,30
2020,154095,0,0,461,238,223
2020,154095,10,0,461,238,223
2020,154095,10,1,129,80,49
2020,154095,10,2,154,81,73
2020,154095,10,3,100,47,53
2020,154095,10,4,78,30,48
2020,154095,20,0,297,164,133
2020,154095,20,1,129,80,49
2020,154095,20,2,151,80,71
2020,154095,20,3,7,3,4
2020,154095,20,4,10,1,9
2020,154095,30,0,95,44,51
2020,154095,30,2,2,0,2
2020,154095,30,3,92,43,49
2020,154095,30,4,1,1,0
2020,154095,40,0,69,30,39
2020,154095,40,2,1,1,0
2020,154095,40,3,1,1,0
2020,154095,40,4,67,28,39
2020,154095,41,0,60,27,33
2020,154095,41,2,1,1,0
2020,154095,41,3,1,1,0
2020,154095,41,4,58,25,33
2020,154095,43,0,9,3,6
2020,154095,43,4,9,3,6
2020,154095,44,0,60,27,33
2020,154095,44,2,1,1,0
2020,154095,44,3,1,1,0
2020,154095,44,4,58,25,33
2020,154101,0,0,78,42,36
2020,154101,10,0,78,42,36
2020,154101,10,1,29,20,9
2020,154101,10,2,17,9,8
2020,154101,10,3,18,7,11
2020,154101,10,4,6,1,5
2020,154101,10,6,8,5,3
2020,154101,20,0,47,28,19
2020,154101,20,1,29,20,9
2020,154101,20,2,15,8,7
2020,154101,20,3,3,0,3
2020,154101,30,0,27,13,14
2020,154101,30,2,2,1,1
2020,154101,30,3,15,7,8
2020,154101,30,4,3,1,2
2020,154101,30,6,7,4,3
2020,154101,40,0,4,1,3
2020,154101,40,4,3,0,3
2020,154101,40,6,1,1,0
2020,154101,42,0,4,1,3
2020,154101,42,4,3,0,3
2020,154101,42,6,1,1,0
2020,154110,0,0,109,44,65
2020,154110,10,0,104,44,60
2020,154110,10,6,104,44,60
2020,154110,40,0,104,44,60
2020,154110,40,6,104,44,60
2020,154110,42,0,104,44,60
2020,154110,42,6,104,44,60
2020,154110,50,0,5,0,5
2020,154129,0,0,36,24,12
2020,154129,10,0,36,24,12
2020,154129,10,6,36,24,12
2020,154129,40,0,36,24,12
2020,154129,40,6,36,24,12
2020,154129,42,0,36,24,12
2020,154129,42,6,36,24,12
2020,154156,0,0,77,32,45
2020,154156,10,0,77,32,45
2020,154156,10,1,15,10,5
2020,154156,10,2,28,10,18
2020,154156,10,3,32,12,20
2020,154156,10,4,2,0,2
2020,154156,20,0,26,14,12
2020,154156,20,1,10,7,3
2020,154156,20,2,16,7,9
2020,154156,30,0,12,5,7
2020,154156,30,2,3,1,2
2020,154156,30,3,9,4,5
2020,154156,40,0,39,13,26
2020,154156,40,1,5,3,2
2020,154156,40,2,9,2,7
2020,154156,40,3,23,8,15
2020,154156,40,4,2,0,2
2020,154156,42,0,39,13,26
2020,154156,42,1,5,3,2
2020,154156,42,2,9,2,7
2020,154156,42,3,23,8,15
2020,154156,42,4,2,0,2
2020,154174,0,0,130,72,58
2020,154174,10,0,129,72,57
2020,154174,10,1,33,20,13
2020,154174,10,2,55,33,22
2020,154174,10,3,26,13,13
2020,154174,10,4,15,6,9
2020,154174,40,0,129,72,57
2020,154174,40,1,33,20,13
2020,154174,40,2,55,33,22
2020,154174,40,3,26,13,13
2020,154174,40,4,15,6,9
2020,154174,41,0,129,72,57
2020,154174,41,1,33,20,13
2020,154174,41,2,55,33,22
2020,154174,41,3,26,13,13
2020,154174,41,4,15,6,9
2020,154174,45,0,129,72,57
2020,154174,45,1,33,20,13
2020,154174,45,2,55,33,22
2020,154174,45,3,26,13,13
2020,154174,45,4,15,6,9
2020,154174,50,0,1,0,1
2020,154235,0,0,191,87,104
2020,154235,10,0,191,87,104
2020,154235,10,1,79,48,31
2020,154235,10,2,42,17,25
2020,154235,10,3,53,18,35
2020,154235,10,4,11,2,9
2020,154235,10,5,6,2,4
2020,154235,20,0,115,64,51
2020,154235,20,1,78,48,30
2020,154235,20,2,35,16,19
2020,154235,20,3,2,0,2
2020,154235,30,0,42,16,26
2020,154235,30,2,3,1,2
2020,154235,30,3,39,15,24
2020,154235,40,0,34,7,27
2020,154235,40,1,1,0,1
2020,154235,40,2,4,0,4
2020,154235,40,3,12,3,9
2020,154235,40,4,11,2,9
2020,154235,40,5,6,2,4
2020,154235,42,0,34,7,27
2020,154235,42,1,1,0,1
2020,154235,42,2,4,0,4
2020,154235,42,3,12,3,9
2020,154235,42,4,11,2,9
2020,154235,42,5,6,2,4
2020,154262,0,0,21,1,20
2020,154262,10,0,21,1,20
2020,154262,10,2,6,1,5
2020,154262,10,3,10,0,10
2020,154262,10,4,5,0,5
2020,154262,40,0,21,1,20
2020,154262,40,2,6,1,5
2020,154262,40,3,10,0,10
2020,154262,40,4,5,0,5
2020,154262,42,0,21,1,20
2020,154262,42,2,6,1,5
2020,154262,42,3,10,0,10
2020,154262,42,4,5,0,5
2020,154350,0,0,80,40,40
2020,154350,10,0,77,38,39
2020,154350,10,1,35,17,18
2020,154350,10,2,14,8,6
2020,154350,10,3,23,11,12
2020,154350,10,4,5,2,3
2020,154350,20,0,40,18,22
2020,154350,20,1,34,17,17
2020,154350,20,2,2,0,2
2020,154350,20,3,4,1,3
2020,154350,30,0,30,16,14
2020,154350,30,1,1,0,1
2020,154350,30,2,12,8,4
2020,154350,30,3,15,8,7
2020,154350,30,4,2,0,2
2020,154350,40,0,7,4,3
2020,154350,40,3,4,2,2
2020,154350,40,4,3,2,1
2020,154350,42,0,7,4,3
2020,154350,42,3,4,2,2
2020,154350,42,4,3,2,1
2020,154350,50,0,3,2,1
2020,154378,0,0,70,32,38
2020,154378,10,0,62,30,32
2020,154378,10,4,62,30,32
2020,154378,40,0,62,30,32
2020,154378,40,4,62,30,32
2020,154378,41,0,62,30,32
2020,154378,41,4,62,30,32
2020,154378,45,0,62,30,32
2020,154378,45,4,62,30,32
2020,154378,50,0,8,2,6
2020,154396,0,0,39,22,17
2020,154396,10,0,39,22,17
2020,154396,10,4,39,22,17
2020,154396,40,0,39,22,17
2020,154396,40,4,39,22,17
2020,154396,42,0,39,22,17
2020,154396,42,4,39,22,17
2020,154493,0,0,61,23,38
2020,154493,10,0,61,23,38
2020,154493,10,1,11,8,3
2020,154493,10,2,23,8,15
2020,154493,10,3,18,5,13
2020,154493,10,5,9,2,7
2020,154493,20,0,34,16,18
2020,154493,20,1,11,8,3
2020,154493,20,2,23,8,15
2020,154493,30,0,18,5,13
2020,154493,30,3,18,5,13
2020,154493,40,0,9,2,7
2020,154493,40,5,9,2,7
2020,154493,42,0,9,2,7
2020,154493,42,5,9,2,7
2020,154518,0,0,48,27,21
2020,154518,10,0,48,27,21
2020,154518,10,1,8,4,4
2020,154518,10,2,10,5,5
2020,154518,10,3,25,16,9
2020,154518,10,4,5,2,3
2020,154518,20,0,17,9,8
2020,154518,20,1,8,4,4
2020,154518,20,2,9,5,4
2020,154518,30,0,18,11,7
2020,154518,30,2,1,0,1
2020,154518,30,3,17,11,6
2020,154518,40,0,13,7,6
2020,154518,40,3,8,5,3
2020,154518,40,4,5,2,3
2020,154518,42,0,13,7,6
2020,154518,42,3,8,5,3
2020,154518,42,4,5,2,3
2020,154527,0,0,83,45,38
2020,154527,10,0,83,45,38
2020,154527,10,1,27,15,12
2020,154527,10,2,31,17,14
2020,154527,10,3,16,8,8
2020,154527,10,5,6,4,2
2020,154527,10,6,3,1,2
2020,154527,20,0,56,30,26
2020,154527,20,1,26,15,11
2020,154527,20,2,29,15,14
2020,154527,20,3,1,0,1
2020,154527,30,0,18,10,8
2020,154527,30,1,1,0,1
2020,154527,30,2,2,2,0
2020,154527,30,3,15,8,7
2020,154527,40,0,9,5,4
2020,154527,40,5,6,4,2
2020,154527,40,6,3,1,2
2020,154527,42,0,9,5,4
2020,154527,42,5,6,4,2
2020,154527,42,6,3,1,2
2020,154536,0,0,12,7,5
2020,154536,10,0,12,7,5
2020,154536,10,1,6,5,1
2020,154536,10,2,3,2,1
2020,154536,10,3,3,0,3
2020,154536,20,0,9,7,2
2020,154536,20,1,6,5,1
2020,154536,20,2,3,2,1
2020,154536,30,0,3,0,3
2020,154536,30,3,3,0,3
2020,154572,0,0,63,31,32
2020,154572,10,0,63,31,32
2020,154572,10,4,1,0,1
2020,154572,10,6,62,31,31
2020,154572,40,0,63,31,32
2020,154572,40,4,1,0,1
2020,154572,40,6,62,31,31
2020,154572,42,0,63,31,32
2020,154572,42,4,1,0,1
2020,154572,42,6,62,31,31
2020,154590,0,0,47,28,19
2020,154590,10,0,45,28,17
2020,154590,10,1,6,4,2
2020,154590,10,2,7,7,0
2020,154590,10,3,15,8,7
2020,154590,10,4,17,9,8
2020,154590,20,0,12,9,3
2020,154590,20,1,4,3,1
2020,154590,20,2,5,5,0
2020,154590,20,3,3,1,2
2020,154590,30,0,6,3,3
2020,154590,30,2,1,1,0
2020,154590,30,3,5,2,3
2020,154590,40,0,27,16,11
2020,154590,40,1,2,1,1
2020,154590,40,2,1,1,0
2020,154590,40,3,7,5,2
2020,154590,40,4,17,9,8
2020,154590,42,0,27,16,11
2020,154590,42,1,2,1,1
2020,154590,42,2,1,1,0
2020,154590,42,3,7,5,2
2020,154590,42,4,17,9,8
2020,154590,50,0,2,0,2
2020,154642,0,0,31,16,15
2020,154642,10,0,31,16,15
2020,154642,10,4,31,16,15
2020,154642,20,0,23,11,12
2020,154642,20,4,23,11,12
2020,154642,30,0,8,5,3
2020,154642,30,4,8,5,3
2020,154688,0,0,76,34,42
2020,154688,10,0,76,34,42
2020,154688,10,1,23,11,12
2020,154688,10,2,27,14,13
2020,154688,10,3,24,8,16
2020,154688,10,4,2,1,1
2020,154688,20,0,42,22,20
2020,154688,20,1,21,11,10
2020,154688,20,2,21,11,10
2020,154688,30,0,20,8,12
2020,154688,30,2,1,0,1
2020,154688,30,3,19,8,11
2020,154688,40,0,14,4,10
2020,154688,40,1,2,0,2
2020,154688,40,2,5,3,2
2020,154688,40,3,5,0,5
2020,154688,40,4,2,1,1
2020,154688,41,0,12,4,8
2020,154688,41,1,1,0,1
2020,154688,41,2,4,3,1
2020,154688,41,3,5,0,5
2020,154688,41,4,2,1,1
2020,154688,42,0,2,0,2
2020,154688,42,1,1,0,1
2020,154688,42,2,1,0,1
2020,154688,45,0,12,4,8
2020,154688,45,1,1,0,1
2020,154688,45,2,4,3,1
2020,154688,45,3,5,0,5
2020,154688,45,4,2,1,1
2020,154697,0,0,55,25,30
2020,154697,10,0,55,25,30
2020,154697,10,6,55,25,30
2020,154697,20,0,34,15,19
2020,154697,20,6,34,15,19
2020,154697,30,0,21,10,11
2020,154697,30,6,21,10,11
2020,154712,0,0,115,77,38
2020,154712,10,0,114,77,37
2020,154712,10,1,26,21,5
2020,154712,10,2,41,27,14
2020,154712,10,3,44,28,16
2020,154712,10,4,2,1,1
2020,154712,10,6,1,0,1
2020,154712,20,0,58,41,17
2020,154712,20,1,25,20,5
2020,154712,20,2,29,18,11
2020,154712,20,3,4,3,1
2020,154712,30,0,35,24,11
2020,154712,30,1,1,1,0
2020,154712,30,2,6,5,1
2020,154712,30,3,28,18,10
2020,154712,40,0,21,12,9
2020,154712,40,2,6,4,2
2020,154712,40,3,12,7,5
2020,154712,40,4,2,1,1
2020,154712,40,6,1,0,1
2020,154712,42,0,21,12,9
2020,154712,42,2,6,4,2
2020,154712,42,3,12,7,5
2020,154712,42,4,2,1,1
2020,154712,42,6,1,0,1
2020,154712,50,0,1,0,1
2020,154721,0,0,42,26,16
2020,154721,10,0,42,26,16
2020,154721,10,1,11,7,4
2020,154721,10,2,12,8,4
2020,154721,10,3,19,11,8
2020,154721,20,0,17,13,4
2020,154721,20,1,5,4,1
2020,154721,20,2,9,6,3
2020,154721,20,3,3,3,0
2020,154721,30,0,25,13,12
2020,154721,30,1,6,3,3
2020,154721,30,2,3,2,1
2020,154721,30,3,16,8,8
2020,154749,0,0,36,15,21
2020,154749,10,0,36,15,21
2020,154749,10,1,10,6,4
2020,154749,10,2,11,3,8
2020,154749,10,3,10,2,8
2020,154749,10,4,5,4,1
2020,154749,20,0,14,7,7
2020,154749,20,1,7,5,2
2020,154749,20,2,7,2,5
2020,154749,30,0,6,2,4
2020,154749,30,1,1,0,1
2020,154749,30,2,2,1,1
2020,154749,30,3,3,1,2
2020,154749,40,0,16,6,10
2020,154749,40,1,2,1,1
2020,154749,40,2,2,0,2
2020,154749,40,3,7,1,6
2020,154749,40,4,5,4,1
2020,154749,42,0,16,6,10
2020,154749,42,1,2,1,1
2020,154749,42,2,2,0,2
2020,154749,42,3,7,1,6
2020,154749,42,4,5,4,1
2020,154800,0,0,141,64,77
2020,154800,10,0,141,64,77
2020,154800,10,1,79,36,43
2020,154800,10,2,46,22,24
2020,154800,10,3,16,6,10
2020,154800,40,0,141,64,77
2020,154800,40,1,79,36,43
2020,154800,40,2,46,22,24
2020,154800,40,3,16,6,10
2020,154800,42,0,141,64,77
2020,154800,42,1,79,36,43
2020,154800,42,2,46,22,24
2020,154800,42,3,16,6,10
2020,154855,0,0,14,8,6
2020,154855,10,0,14,8,6
2020,154855,10,6,14,8,6
2020,154855,40,0,14,8,6
2020,154855,40,6,14,8,6
2020,154855,42,0,14,8,6
2020,154855,42,6,14,8,6
2020,154907,0,0,36,22,14
2020,154907,10,0,36,22,14
2020,154907,10,4,36,22,14
2020,154907,20,0,23,14,9
2020,154907,20,4,23,14,9
2020,154907,30,0,13,8,5
2020,154907,30,4,13,8,5
2020,154925,0,0,46,29,17
2020,154925,10,0,43,28,15
2020,154925,10,4,43,28,15
2020,154925,20,0,38,25,13
2020,154925,20,4,38,25,13
2020,154925,30,0,5,3,2
2020,154925,30,4,5,3,2
2020,154925,50,0,3,1,2
2020,154934,0,0,48,17,31
2020,154934,10,0,48,17,31
2020,154934,10,4,48,17,31
2020,154934,40,0,48,17,31
2020,154934,40,4,48,17,31
2020,154934,42,0,48,17,31
2020,154934,42,4,48,17,31
2020,154952,0,0,62,34,28
2020,154952,10,0,56,31,25
2020,154952,10,4,56,31,25
2020,154952,20,0,48,26,22
2020,154952,20,4,48,26,22
2020,154952,30,0,8,5,3
2020,154952,30,4,8,5,3
2020,154952,50,0,6,3,3
2020,154998,0,0,40,20,20
2020,154998,10,0,40,20,20
2020,154998,10,1,19,10,9
2020,154998,10,2,10,4,6
2020,154998,10,3,6,2,4
2020,154998,10,4,5,4,1
2020,154998,20,0,26,12,14
2020,154998,20,1,15,8,7
2020,154998,20,2,7,3,4
2020,154998,20,3,4,1,3
2020,154998,30,0,14,8,6
2020,154998,30,1,4,2,2
2020,154998,30,2,3,1,2
2020,154998,30,3,2,1,1
2020,154998,30,4,5,4,1
2020,155007,0,0,13,4,9
2020,155007,10,0,13,4,9
2020,155007,10,3,13,4,9
2020,155007,40,0,13,4,9
2020,155007,40,3,13,4,9
2020,155007,42,0,13,4,9
2020,155007,42,3,13,4,9
2020,155025,0,0,237,117,120
2020,155025,10,0,237,117,120
2020,155025,10,1,66,43,23
2020,155025,10,2,61,26,35
2020,155025,10,3,76,40,36
2020,155025,10,4,34,8,26
2020,155025,20,0,122,66,56
2020,155025,20,1,66,43,23
2020,155025,20,2,55,23,32
2020,155025,20,3,1,0,1
2020,155025,30,0,74,39,35
2020,155025,30,2,6,3,3
2020,155025,30,3,68,36,32
2020,155025,40,0,41,12,29
2020,155025,40,3,7,4,3
2020,155025,40,4,34,8,26
2020,155025,42,0,41,12,29
2020,155025,42,3,7,4,3
2020,155025,42,4,34,8,26
2020,155052,0,0,35,20,15
2020,155052,10,0,35,20,15
2020,155052,10,4,35,20,15
2020,155052,40,0,35,20,15
2020,155052,40,4,35,20,15
2020,155052,42,0,35,20,15
2020,155052,42,4,35,20,15
2020,155061,0,0,371,201,170
2020,155061,10,0,371,201,170
2020,155061,10,1,58,36,22
2020,155061,10,2,69,38,31
2020,155061,10,3,128,72,56
2020,155061,10,4,99,49,50
2020,155061,10,5,17,6,11
2020,155061,20,0,127,74,53
2020,155061,20,1,56,35,21
2020,155061,20,2,59,31,28
2020,155061,20,3,12,8,4
2020,155061,30,0,96,51,45
2020,155061,30,1,1,0,1
2020,155061,30,2,6,4,2
2020,155061,30,3,89,47,42
2020,155061,40,0,148,76,72
2020,155061,40,1,1,1,0
2020,155061,40,2,4,3,1
2020,155061,40,3,27,17,10
2020,155061,40,4,99,49,50
2020,155061,40,5,17,6,11
2020,155061,42,0,148,76,72
2020,155061,42,1,1,1,0
2020,155061,42,2,4,3,1
2020,155061,42,3,27,17,10
2020,155061,42,4,99,49,50
2020,155061,42,5,17,6,11
2020,155070,0,0,11,7,4
2020,155070,10,0,11,7,4
2020,155070,10,1,11,7,4
2020,155070,40,0,11,7,4
2020,155070,40,1,11,7,4
2020,155070,42,0,11,7,4
2020,155070,42,1,11,7,4
2020,155089,0,0,58,32,26
2020,155089,10,0,58,32,26
2020,155089,10,1,17,12,5
2020,155089,10,2,11,6,5
2020,155089,10,3,29,14,15
2020,155089,10,5,1,0,1
2020,155089,20,0,10,5,5
2020,155089,20,1,10,5,5
2020,155089,30,0,41,23,18
2020,155089,30,1,7,7,0
2020,155089,30,2,11,6,5
2020,155089,30,3,23,10,13
2020,155089,40,0,7,4,3
2020,155089,40,3,6,4,2
2020,155089,40,5,1,0,1
2020,155089,43,0,7,4,3
2020,155089,43,3,6,4,2
2020,155089,43,5,1,0,1
2020,155098,0,0,37,18,19
2020,155098,10,0,35,18,17
2020,155098,10,4,35,18,17
2020,155098,20,0,24,11,13
2020,155098,20,4,24,11,13
2020,155098,30,0,11,7,4
2020,155098,30,4,11,7,4
2020,155098,50,0,2,0,2
2020,155104,0,0,65,30,35
2020,155104,10,0,63,28,35
2020,155104,10,4,63,28,35
2020,155104,20,0,48,21,27
2020,155104,20,4,48,21,27
2020,155104,30,0,15,7,8
2020,155104,30,4,15,7,8
2020,155104,50,0,2,2,0
2020,155140,0,0,32,16,16
2020,155140,50,0,32,16,16
2020,155177,0,0,31,17,14
2020,155177,10,0,31,17,14
2020,155177,10,4,31,17,14
2020,155177,40,0,31,17,14
2020,155177,40,4,31,17,14
2020,155177,42,0,31,17,14
2020,155177,42,4,31,17,14
2020,155186,0,0,52,30,22
2020,155186,10,0,52,30,22
2020,155186,10,6,52,30,22
2020,155186,40,0,52,30,22
2020,155186,40,6,52,30,22
2020,155186,42,0,52,30,22
2020,155186,42,6,52,30,22
2020,155195,0,0,140,65,75
2020,155195,10,0,107,51,56
2020,155195,10,4,107,51,56
2020,155195,20,0,85,44,41
2020,155195,20,4,85,44,41
2020,155195,30,0,22,7,15
2020,155195,30,4,22,7,15
2020,155195,50,0,33,14,19
2020,155201,0,0,30,11,19
2020,155201,10,0,30,11,19
2020,155201,10,1,14,4,10
2020,155201,10,2,16,7,9
2020,155201,20,0,18,5,13
2020,155201,20,1,14,4,10
2020,155201,20,2,4,1,3
2020,155201,30,0,12,6,6
2020,155201,30,2,12,6,6
2020,155210,0,0,306,150,156
2020,155210,10,0,306,150,156
2020,155210,10,1,163,83,80
2020,155210,10,2,84,36,48
2020,155210,10,3,54,27,27
2020,155210,10,6,5,4,1
2020,155210,40,0,306,150,156
2020,155210,40,1,163,83,80
2020,155210,40,2,84,36,48
2020,155210,40,3,54,27,27
2020,155210,40,6,5,4,1
2020,155210,42,0,306,150,156
2020,155210,42,1,163,83,80
2020,155210,42,2,84,36,48
2020,155210,42,3,54,27,27
2020,155210,42,6,5,4,1
2020,155283,0,0,12,0,12
2020,155283,10,0,12,0,12
2020,155283,10,4,12,0,12
2020,155283,40,0,12,0,12
2020,155283,40,4,12,0,12
2020,155283,41,0,12,0,12
2020,155283,41,4,12,0,12
2020,155283,45,0,12,0,12
2020,155283,45,4,12,0,12
2020,155292,0,0,152,82,70
2020,155292,10,0,152,82,70
2020,155292,10,1,25,15,10
2020,155292,10,2,18,10,8
2020,155292,10,3,21,9,12
2020,155292,10,4,88,48,40
2020,155292,20,0,135,72,63
2020,155292,20,1,25,15,10
2020,155292,20,2,17,10,7
2020,155292,20,3,18,7,11
2020,155292,20,4,75,40,35
2020,155292,30,0,17,10,7
2020,155292,30,2,1,0,1
2020,155292,30,3,3,2,1
2020,155292,30,4,13,8,5
2020,155308,0,0,5,3,2
2020,155308,10,0,5,3,2
2020,155308,10,1,1,0,1
2020,155308,10,2,4,3,1
2020,155308,40,0,5,3,2
2020,155308,40,1,1,0,1
2020,155308,40,2,4,3,1
2020,155308,42,0,5,3,2
2020,155308,42,1,1,0,1
2020,155308,42,2,4,3,1
2020,155317,0,0,2383,1380,1003
2020,155317,10,0,2383,1380,1003
2020,155317,10,1,606,432,174
2020,155317,10,2,667,375,292
2020,155317,10,3,915,496,419
2020,155317,10,4,66,28,38
2020,155317,10,5,129,49,80
2020,155317,20,0,892,596,296
2020,155317,20,1,517,382,135
2020,155317,20,2,375,214,161
2020,155317,30,0,253,151,102
2020,155317,30,1,1,0,1
2020,155317,30,2,10,6,4
2020,155317,30,3,242,145,97
2020,155317,40,0,1238,633,605
2020,155317,40,1,88,50,38
2020,155317,40,2,282,155,127
2020,155317,40,3,673,351,322
2020,155317,40,4,66,28,38
2020,155317,40,5,129,49,80
2020,155317,41,0,697,411,286
2020,155317,41,1,60,41,19
2020,155317,41,2,211,129,82
2020,155317,41,3,346,211,135
2020,155317,41,4,9,4,5
2020,155317,41,5,71,26,45
2020,155317,42,0,530,219,311
2020,155317,42,1,28,9,19
2020,155317,42,2,71,26,45
2020,155317,42,3,322,138,184
2020,155317,42,4,56,23,33
2020,155317,42,5,53,23,30
2020,155317,43,0,11,3,8
2020,155317,43,3,5,2,3
2020,155317,43,4,1,1,0
2020,155317,43,5,5,0,5
2020,155317,44,0,646,391,255
2020,155317,44,1,60,41,19
2020,155317,44,2,211,129,82
2020,155317,44,3,346,211,135
2020,155317,44,4,9,4,5
2020,155317,44,5,20,6,14
2020,155317,45,0,51,20,31
2020,155317,45,5,51,20,31
2020,155335,0,0,82,33,49
2020,155335,10,0,82,33,49
2020,155335,10,1,13,7,6
2020,155335,10,2,27,17,10
2020,155335,10,3,34,8,26
2020,155335,10,4,8,1,7
2020,155335,20,0,28,15,13
2020,155335,20,1,11,5,6
2020,155335,20,2,17,10,7
2020,155335,30,0,54,18,36
2020,155335,30,1,2,2,0
2020,155335,30,2,10,7,3
2020,155335,30,3,34,8,26
2020,155335,30,4,8,1,7
2020,155399,0,0,996,574,422
2020,155399,10,0,996,574,422
2020,155399,10,1,285,206,79
2020,155399,10,2,311,172,139
2020,155399,10,3,192,104,88
2020,155399,10,4,155,65,90
2020,155399,10,5,53,27,26
2020,155399,20,0,543,350,193
2020,155399,20,1,271,197,74
2020,155399,20,2,270,151,119
2020,155399,20,3,2,2,0
2020,155399,30,0,181,100,81
2020,155399,30,2,5,4,1
2020,155399,30,3,176,96,80
2020,155399,40,0,272,124,148
2020,155399,40,1,14,9,5
2020,155399,40,2,36,17,19
2020,155399,40,3,14,6,8
2020,155399,40,4,155,65,90
2020,155399,40,5,53,27,26
2020,155399,41,0,131,55,76
2020,155399,41,1,7,3,4
2020,155399,41,2,14,6,8
2020,155399,41,3,11,3,8
2020,155399,41,4,79,31,48
2020,155399,41,5,20,12,8
2020,155399,42,0,141,69,72
2020,155399,42,1,7,6,1
2020,155399,42,2,22,11,11
2020,155399,42,3,3,3,0
2020,155399,42,4,76,34,42
2020,155399,42,5,33,15,18
2020,155399,45,0,131,55,76
2020,155399,45,1,7,3,4
2020,155399,45,2,14,6,8
2020,155399,45,3,11,3,8
2020,155399,45,4,79,31,48
2020,155399,45,5,20,12,8
2020,155414,0,0,47,20,27
2020,155414,10,0,47,20,27
2020,155414,10,1,7,5,2
2020,155414,10,2,13,8,5
2020,155414,10,3,25,6,19
2020,155414,10,4,2,1,1
2020,155414,20,0,19,12,7
2020,155414,20,1,7,5,2
2020,155414,20,2,12,7,5
2020,155414,30,0,21,6,15
2020,155414,30,3,21,6,15
2020,155414,40,0,7,2,5
2020,155414,40,2,1,1,0
2020,155414,40,3,4,0,4
2020,155414,40,4,2,1,1
2020,155414,42,0,7,2,5
2020,155414,42,2,1,1,0
2020,155414,42,3,4,0,4
2020,155414,42,4,2,1,1
2020,155450,0,0,34,15,19
2020,155450,10,0,34,15,19
2020,155450,10,1,17,8,9
2020,155450,10,2,5,3,2
2020,155450,10,3,6,2,4
2020,155450,10,4,6,2,4
2020,155450,20,0,25,10,15
2020,155450,20,1,17,8,9
2020,155450,20,2,4,2,2
2020,155450,20,4,4,0,4
2020,155450,30,0,9,5,4
2020,155450,30,2,1,1,0
2020,155450,30,3,6,2,4
2020,155450,30,4,2,2,0
2020,155487,0,0,23,14,9
2020,155487,10,0,23,14,9
2020,155487,10,4,23,14,9
2020,155487,40,0,23,14,9
2020,155487,40,4,23,14,9
2020,155487,42,0,23,14,9
2020,155487,42,4,23,14,9
2020,155496,0,0,9,8,1
2020,155496,10,0,9,8,1
2020,155496,10,1,4,3,1
2020,155496,10,2,3,3,0
2020,155496,10,3,2,2,0
2020,155496,40,0,9,8,1
2020,155496,40,1,4,3,1
2020,155496,40,2,3,3,0
2020,155496,40,3,2,2,0
2020,155496,42,0,9,8,1
2020,155496,42,1,4,3,1
2020,155496,42,2,3,3,0
2020,155496,42,3,2,2,0
2020,155511,0,0,45,28,17
2020,155511,10,0,45,28,17
2020,155511,10,1,14,10,4
2020,155511,10,2,17,11,6
2020,155511,10,3,14,7,7
2020,155511,20,0,27,18,9
2020,155511,20,1,14,10,4
2020,155511,20,2,13,8,5
2020,155511,30,0,15,8,7
2020,155511,30,2,4,3,1
2020,155511,30,3,11,5,6
2020,155511,40,0,3,2,1
2020,155511,40,3,3,2,1
2020,155511,42,0,3,2,1
2020,155511,42,3,3,2,1
2020,155520,0,0,69,33,36
2020,155520,10,0,69,33,36
2020,155520,10,1,29,18,11
2020,155520,10,2,16,9,7
2020,155520,10,3,24,6,18
2020,155520,40,0,69,33,36
2020,155520,40,1,29,18,11
2020,155520,40,2,16,9,7
2020,155520,40,3,24,6,18
2020,155520,42,0,69,33,36
2020,155520,42,1,29,18,11
2020,155520,42,2,16,9,7
2020,155520,42,3,24,6,18
2020,155566,0,0,54,27,27
2020,155566,10,0,54,27,27
2020,155566,10,1,22,11,11
2020,155566,10,2,7,3,4
2020,155566,10,3,15,6,9
2020,155566,10,4,10,7,3
2020,155566,20,0,29,15,14
2020,155566,20,1,17,8,9
2020,155566,20,2,5,2,3
2020,155566,20,3,4,2,2
2020,155566,20,4,3,3,0
2020,155566,30,0,13,5,8
2020,155566,30,2,1,1,0
2020,155566,30,3,8,2,6
2020,155566,30,4,4,2,2
2020,155566,40,0,12,7,5
2020,155566,40,1,5,3,2
2020,155566,40,2,1,0,1
2020,155566,40,3,3,2,1
2020,155566,40,4,3,2,1
2020,155566,42,0,12,7,5
2020,155566,42,1,5,3,2
2020,155566,42,2,1,0,1
2020,155566,42,3,3,2,1
2020,155566,42,4,3,2,1
2020,155593,0,0,54,31,23
2020,155593,10,0,53,30,23
2020,155593,10,4,53,30,23
2020,155593,20,0,36,21,15
2020,155593,20,4,36,21,15
2020,155593,30,0,17,9,8
2020,155593,30,4,17,9,8
2020,155593,50,0,1,1,0
2020,155618,0,0,31,20,11
2020,155618,10,0,30,19,11
2020,155618,10,4,30,19,11
2020,155618,20,0,20,13,7
2020,155618,20,4,20,13,7
2020,155618,30,0,10,6,4
2020,155618,30,4,10,6,4
2020,155618,50,0,1,1,0
2020,155627,0,0,27,19,8
2020,155627,10,0,27,19,8
2020,155627,10,1,6,4,2
2020,155627,10,2,11,7,4
2020,155627,10,3,9,8,1
2020,155627,10,4,1,0,1
2020,155627,20,0,12,7,5
2020,155627,20,1,6,4,2
2020,155627,20,2,6,3,3
2020,155627,30,0,5,4,1
2020,155627,30,2,3,2,1
2020,155627,30,3,2,2,0
2020,155627,40,0,10,8,2
2020,155627,40,2,2,2,0
2020,155627,40,3,7,6,1
2020,155627,40,4,1,0,1
2020,155627,42,0,10,8,2
2020,155627,42,2,2,2,0
2020,155627,42,3,7,6,1
2020,155627,42,4,1,0,1
2020,155636,0,0,4,0,4
2020,155636,10,0,4,0,4
2020,155636,10,1,1,0,1
2020,155636,10,2,1,0,1
2020,155636,10,3,2,0,2
2020,155636,20,0,1,0,1
2020,155636,20,1,1,0,1
2020,155636,40,0,3,0,3
2020,155636,40,2,1,0,1
2020,155636,40,3,2,0,2
2020,155636,42,0,3,0,3
2020,155636,42,2,1,0,1
2020,155636,42,3,2,0,2
2020,155681,0,0,277,156,121
2020,155681,10,0,277,156,121
2020,155681,10,1,114,72,42
2020,155681,10,2,62,41,21
2020,155681,10,3,48,25,23
2020,155681,10,4,53,18,35
2020,155681,20,0,184,116,68
2020,155681,20,1,114,72,42
2020,155681,20,2,62,41,21
2020,155681,20,3,8,3,5
2020,155681,30,0,40,22,18
2020,155681,30,3,40,22,18
2020,155681,40,0,53,18,35
2020,155681,40,4,53,18,35
2020,155681,42,0,53,18,35
2020,155681,42,4,53,18,35
2020,155715,0,0,36,23,13
2020,155715,10,0,36,23,13
2020,155715,10,4,36,23,13
2020,155715,20,0,23,12,11
2020,155715,20,4,23,12,11
2020,155715,30,0,13,11,2
2020,155715,30,4,13,11,2
2020,155812,0,0,72,26,46
2020,155812,10,0,72,26,46
2020,155812,10,1,8,5,3
2020,155812,10,2,21,11,10
2020,155812,10,3,17,3,14
2020,155812,10,4,26,7,19
2020,155812,20,0,26,15,11
2020,155812,20,1,8,5,3
2020,155812,20,2,18,10,8
2020,155812,30,0,19,4,15
2020,155812,30,2,3,1,2
2020,155812,30,3,11,2,9
2020,155812,30,4,5,1,4
2020,155812,40,0,27,7,20
2020,155812,40,3,6,1,5
2020,155812,40,4,21,6,15
2020,155812,42,0,27,7,20
2020,155812,42,3,6,1,5
2020,155812,42,4,21,6,15
2020,155830,0,0,26,14,12
2020,155830,10,0,26,14,12
2020,155830,10,4,26,14,12
2020,155830,20,0,14,12,2
2020,155830,20,4,14,12,2
2020,155830,30,0,12,2,10
2020,155830,30,4,12,2,10
2020,155858,0,0,59,32,27
2020,155858,10,0,59,32,27
2020,155858,10,4,59,32,27
2020,155858,40,0,59,32,27
2020,155858,40,4,59,32,27
2020,155858,42,0,59,32,27
2020,155858,42,4,59,32,27
2020,155900,0,0,42,23,19
2020,155900,10,0,42,23,19
2020,155900,10,1,12,9,3
2020,155900,10,2,16,4,12
2020,155900,10,3,9,6,3
2020,155900,10,4,5,4,1
2020,155900,20,0,26,12,14
2020,155900,20,1,12,9,3
2020,155900,20,2,14,3,11
2020,155900,30,0,5,2,3
2020,155900,30,3,5,2,3
2020,155900,40,0,11,9,2
2020,155900,40,2,2,1,1
2020,155900,40,3,4,4,0
2020,155900,40,4,5,4,1
2020,155900,42,0,11,9,2
2020,155900,42,2,2,1,1
2020,155900,42,3,4,4,0
2020,155900,42,4,5,4,1
2020,155937,0,0,47,25,22
2020,155937,10,0,47,25,22
2020,155937,10,1,5,4,1
2020,155937,10,2,7,5,2
2020,155937,10,3,30,14,16
2020,155937,10,4,5,2,3
2020,155937,20,0,26,14,12
2020,155937,20,1,5,4,1
2020,155937,20,2,5,3,2
2020,155937,20,3,16,7,9
2020,155937,30,0,21,11,10
2020,155937,30,2,2,2,0
2020,155937,30,3,14,7,7
2020,155937,30,4,5,2,3
2020,155973,0,0,37,22,15
2020,155973,10,0,37,22,15
2020,155973,10,1,9,5,4
2020,155973,10,2,9,7,2
2020,155973,10,3,19,10,9
2020,155973,20,0,14,8,6
2020,155973,20,1,8,4,4
2020,155973,20,2,5,4,1
2020,155973,20,3,1,0,1
2020,155973,30,0,19,10,9
2020,155973,30,1,1,1,0
2020,155973,30,2,2,1,1
2020,155973,30,3,16,8,8
2020,155973,40,0,4,4,0
2020,155973,40,2,2,2,0
2020,155973,40,3,2,2,0
2020,155973,42,0,4,4,0
2020,155973,42,2,2,2,0
2020,155973,42,3,2,2,0
2020,156082,0,0,269,120,149
2020,156082,10,0,269,120,149
2020,156082,10,1,70,36,34
2020,156082,10,2,45,22,23
2020,156082,10,3,66,29,37
2020,156082,10,5,85,32,53
2020,156082,10,6,3,1,2
2020,156082,20,0,123,61,62
2020,156082,20,1,68,35,33
2020,156082,20,2,40,21,19
2020,156082,20,3,15,5,10
2020,156082,30,0,55,25,30
2020,156082,30,2,4,1,3
2020,156082,30,3,50,24,26
2020,156082,30,5,1,0,1
2020,156082,40,0,91,34,57
2020,156082,40,1,2,1,1
2020,156082,40,2,1,0,1
2020,156082,40,3,1,0,1
2020,156082,40,5,84,32,52
2020,156082,40,6,3,1,2
2020,156082,42,0,89,33,56
2020,156082,42,1,2,1,1
2020,156082,42,2,1,0,1
2020,156082,42,3,1,0,1
2020,156082,42,5,84,32,52
2020,156082,42,6,1,0,1
2020,156082,43,0,2,1,1
2020,156082,43,6,2,1,1
2020,156107,0,0,85,45,40
2020,156107,10,0,82,43,39
2020,156107,10,4,82,43,39
2020,156107,20,0,49,25,24
2020,156107,20,4,49,25,24
2020,156107,30,0,33,18,15
2020,156107,30,4,33,18,15
2020,156107,50,0,3,2,1
2020,156125,0,0,566,300,266
2020,156125,10,0,566,300,266
2020,156125,10,1,157,103,54
2020,156125,10,2,194,104,90
2020,156125,10,3,193,84,109
2020,156125,10,4,2,1,1
2020,156125,10,6,20,8,12
2020,156125,20,0,272,185,87
2020,156125,20,1,123,90,33
2020,156125,20,2,143,92,51
2020,156125,20,3,4,2,2
2020,156125,20,6,2,1,1
2020,156125,30,0,121,59,62
2020,156125,30,3,117,57,60
2020,156125,30,6,4,2,2
2020,156125,40,0,173,56,117
2020,156125,40,1,34,13,21
2020,156125,40,2,51,12,39
2020,156125,40,3,72,25,47
2020,156125,40,4,2,1,1
2020,156125,40,6,14,5,9
2020,156125,42,0,166,56,110
2020,156125,42,1,34,13,21
2020,156125,42,2,48,12,36
2020,156125,42,3,68,25,43
2020,156125,42,4,2,1,1
2020,156125,42,6,14,5,9
2020,156125,43,0,7,0,7
2020,156125,43,2,3,0,3
2020,156125,43,3,4,0,4
2020,156134,0,0,37,22,15
2020,156134,10,0,36,22,14
2020,156134,10,4,36,22,14
2020,156134,40,0,36,22,14
2020,156134,40,4,36,22,14
2020,156134,41,0,36,22,14
2020,156134,41,4,36,22,14
2020,156134,44,0,36,22,14
2020,156134,44,4,36,22,14
2020,156134,50,0,1,0,1
2020,156189,0,0,29,15,14
2020,156189,10,0,29,15,14
2020,156189,10,1,9,6,3
2020,156189,10,2,4,2,2
2020,156189,10,3,12,6,6
2020,156189,10,4,4,1,3
2020,156189,40,0,29,15,14
2020,156189,40,1,9,6,3
2020,156189,40,2,4,2,2
2020,156189,40,3,12,6,6
2020,156189,40,4,4,1,3
2020,156189,43,0,29,15,14
2020,156189,43,1,9,6,3
2020,156189,43,2,4,2,2
2020,156189,43,3,12,6,6
2020,156189,43,4,4,1,3
2020,156213,0,0,88,52,36
2020,156213,10,0,88,52,36
2020,156213,10,1,31,26,5
2020,156213,10,2,27,18,9
2020,156213,10,3,30,8,22
2020,156213,20,0,48,37,11
2020,156213,20,1,28,24,4
2020,156213,20,2,20,13,7
2020,156213,30,0,30,11,19
2020,156213,30,1,3,2,1
2020,156213,30,2,6,4,2
2020,156213,30,3,21,5,16
2020,156213,40,0,10,4,6
2020,156213,40,2,1,1,0
2020,156213,40,3,9,3,6
2020,156213,41,0,4,3,1
2020,156213,41,2,1,1,0
2020,156213,41,3,3,2,1
2020,156213,42,0,6,1,5
2020,156213,42,3,6,1,5
2020,156213,44,0,4,3,1
2020,156213,44,2,1,1,0
2020,156213,44,3,3,2,1
2020,156222,0,0,45,37,8
2020,156222,10,0,45,37,8
2020,156222,10,1,34,29,5
2020,156222,10,2,9,7,2
2020,156222,10,3,2,1,1
2020,156222,20,0,39,33,6
2020,156222,20,1,34,29,5
2020,156222,20,2,5,4,1
2020,156222,30,0,5,4,1
2020,156222,30,2,3,3,0
2020,156222,30,3,2,1,1
2020,156222,40,0,1,0,1
2020,156222,40,2,1,0,1
2020,156222,42,0,1,0,1
2020,156222,42,2,1,0,1
2020,156231,0,0,70,37,33
2020,156231,10,0,70,37,33
2020,156231,10,1,28,18,10
2020,156231,10,2,13,6,7
2020,156231,10,3,10,4,6
2020,156231,10,4,19,9,10
2020,156231,20,0,19,12,7
2020,156231,20,1,19,12,7
2020,156231,40,0,51,25,26
2020,156231,40,1,9,6,3
2020,156231,40,2,13,6,7
2020,156231,40,3,10,4,6
2020,156231,40,4,19,9,10
2020,156231,42,0,3,1,2
2020,156231,42,1,1,1,0
2020,156231,42,2,2,0,2
2020,156231,43,0,48,24,24
2020,156231,43,1,8,5,3
2020,156231,43,2,11,6,5
2020,156231,43,3,10,4,6
2020,156231,43,4,19,9,10
2020,156286,0,0,177,73,104
2020,156286,10,0,177,73,104
2020,156286,10,1,42,29,13
2020,156286,10,2,60,22,38
2020,156286,10,3,60,16,44
2020,156286,10,4,15,6,9
2020,156286,20,0,90,49,41
2020,156286,20,1,41,28,13
2020,156286,20,2,48,21,27
2020,156286,20,3,1,0,1
2020,156286,30,0,50,13,37
2020,156286,30,1,1,1,0
2020,156286,30,2,7,0,7
2020,156286,30,3,42,12,30
2020,156286,40,0,37,11,26
2020,156286,40,2,5,1,4
2020,156286,40,3,17,4,13
2020,156286,40,4,15,6,9
2020,156286,42,0,37,11,26
2020,156286,42,2,5,1,4
2020,156286,42,3,17,4,13
2020,156286,42,4,15,6,9
2020,156295,0,0,146,71,75
2020,156295,10,0,146,71,75
2020,156295,10,1,32,15,17
2020,156295,10,2,67,37,30
2020,156295,10,3,43,17,26
2020,156295,10,4,4,2,2
2020,156295,20,0,79,44,35
2020,156295,20,1,30,14,16
2020,156295,20,2,49,30,19
2020,156295,30,0,35,11,24
2020,156295,30,1,1,0,1
2020,156295,30,2,6,1,5
2020,156295,30,3,28,10,18
2020,156295,40,0,32,16,16
2020,156295,40,1,1,1,0
2020,156295,40,2,12,6,6
2020,156295,40,3,15,7,8
2020,156295,40,4,4,2,2
2020,156295,41,0,27,14,13
2020,156295,41,1,1,1,0
2020,156295,41,2,11,5,6
2020,156295,41,3,12,6,6
2020,156295,41,4,3,2,1
2020,156295,42,0,5,2,3
2020,156295,42,2,1,1,0
2020,156295,42,3,3,1,2
2020,156295,42,4,1,0,1
2020,156295,44,0,26,14,12
2020,156295,44,1,1,1,0
2020,156295,44,2,10,5,5
2020,156295,44,3,12,6,6
2020,156295,44,4,3,2,1
2020,156295,45,0,1,0,1
2020,156295,45,2,1,0,1
2020,156338,0,0,92,45,47
2020,156338,10,0,92,45,47
2020,156338,10,1,17,12,5
2020,156338,10,2,31,12,19
2020,156338,10,3,21,11,10
2020,156338,10,4,23,10,13
2020,156338,40,0,92,45,47
2020,156338,40,1,17,12,5
2020,156338,40,2,31,12,19
2020,156338,40,3,21,11,10
2020,156338,40,4,23,10,13
2020,156338,42,0,27,13,14
2020,156338,42,1,4,1,3
2020,156338,42,2,8,3,5
2020,156338,42,3,9,6,3
2020,156338,42,4,6,3,3
2020,156338,43,0,65,32,33
2020,156338,43,1,13,11,2
2020,156338,43,2,23,9,14
2020,156338,43,3,12,5,7
2020,156338,43,4,17,7,10
2020,156356,0,0,41,19,22
2020,156356,10,0,41,19,22
2020,156356,10,1,5,3,2
2020,156356,10,2,12,4,8
2020,156356,10,3,20,10,10
2020,156356,10,4,4,2,2
2020,156356,20,0,16,6,10
2020,156356,20,1,5,3,2
2020,156356,20,2,9,2,7
2020,156356,20,3,2,1,1
2020,156356,30,0,14,8,6
2020,156356,30,2,2,1,1
2020,156356,30,3,12,7,5
2020,156356,40,0,11,5,6
2020,156356,40,2,1,1,0
2020,156356,40,3,6,2,4
2020,156356,40,4,4,2,2
2020,156356,42,0,11,5,6
2020,156356,42,2,1,1,0
2020,156356,42,3,6,2,4
2020,156356,42,4,4,2,2
2020,156365,0,0,238,108,130
2020,156365,10,0,216,102,114
2020,156365,10,1,42,26,16
2020,156365,10,2,57,26,31
2020,156365,10,3,66,32,34
2020,156365,10,4,51,18,33
2020,156365,20,0,56,30,26
2020,156365,20,1,29,18,11
2020,156365,20,2,24,11,13
2020,156365,20,3,3,1,2
2020,156365,30,0,108,53,55
2020,156365,30,1,13,8,5
2020,156365,30,2,33,15,18
2020,156365,30,3,62,30,32
2020,156365,40,0,52,19,33
2020,156365,40,3,1,1,0
2020,156365,40,4,51,18,33
2020,156365,42,0,52,19,33
2020,156365,42,3,1,1,0
2020,156365,42,4,51,18,33
2020,156365,50,0,22,6,16
2020,156392,0,0,191,86,105
2020,156392,10,0,191,86,105
2020,156392,10,1,53,23,30
2020,156392,10,2,54,30,24
2020,156392,10,3,26,9,17
2020,156392,10,4,54,21,33
2020,156392,10,5,4,3,1
2020,156392,20,0,73,40,33
2020,156392,20,1,45,21,24
2020,156392,20,2,28,19,9
2020,156392,30,0,28,9,19
2020,156392,30,1,3,1,2
2020,156392,30,2,8,2,6
2020,156392,30,3,5,2,3
2020,156392,30,4,12,4,8
2020,156392,40,0,90,37,53
2020,156392,40,1,5,1,4
2020,156392,40,2,18,9,9
2020,156392,40,3,21,7,14
2020,156392,40,4,42,17,25
2020,156392,40,5,4,3,1
2020,156392,42,0,13,4,9
2020,156392,42,1,1,0,1
2020,156392,42,2,2,1,1
2020,156392,42,3,8,3,5
2020,156392,42,4,2,0,2
2020,156392,43,0,77,33,44
2020,156392,43,1,4,1,3
2020,156392,43,2,16,8,8
2020,156392,43,3,13,4,9
2020,156392,43,4,40,17,23
2020,156392,43,5,4,3,1
2020,156408,0,0,132,75,57
2020,156408,10,0,132,75,57
2020,156408,10,1,34,23,11
2020,156408,10,2,43,25,18
2020,156408,10,3,49,23,26
2020,156408,10,4,5,3,2
2020,156408,10,6,1,1,0
2020,156408,20,0,76,47,29
2020,156408,20,1,33,22,11
2020,156408,20,2,43,25,18
2020,156408,30,0,34,13,21
2020,156408,30,3,34,13,21
2020,156408,40,0,22,15,7
2020,156408,40,1,1,1,0
2020,156408,40,3,15,10,5
2020,156408,40,4,5,3,2
2020,156408,40,6,1,1,0
2020,156408,41,0,20,13,7
2020,156408,41,3,14,9,5
2020,156408,41,4,5,3,2
2020,156408,41,6,1,1,0
2020,156408,42,0,2,2,0
2020,156408,42,1,1,1,0
2020,156408,42,3,1,1,0
2020,156408,44,0,20,13,7
2020,156408,44,3,14,9,5
2020,156408,44,4,5,3,2
2020,156408,44,6,1,1,0
2020,156417,0,0,7,6,1
2020,156417,10,0,7,6,1
2020,156417,10,1,3,3,0
2020,156417,10,2,1,1,0
2020,156417,10,3,2,2,0
2020,156417,10,4,1,0,1
2020,156417,40,0,7,6,1
2020,156417,40,1,3,3,0
2020,156417,40,2,1,1,0
2020,156417,40,3,2,2,0
2020,156417,40,4,1,0,1
2020,156417,41,0,1,1,0
2020,156417,41,1,1,1,0
2020,156417,42,0,6,5,1
2020,156417,42,1,2,2,0
2020,156417,42,2,1,1,0
2020,156417,42,3,2,2,0
2020,156417,42,4,1,0,1
2020,156417,44,0,1,1,0
2020,156417,44,1,1,1,0
2020,156471,0,0,62,6,56
2020,156471,10,0,62,6,56
2020,156471,10,2,2,0,2
2020,156471,10,3,7,0,7
2020,156471,10,4,53,6,47
2020,156471,40,0,62,6,56
2020,156471,40,2,2,0,2
2020,156471,40,3,7,0,7
2020,156471,40,4,53,6,47
2020,156471,41,0,62,6,56
2020,156471,41,2,2,0,2
2020,156471,41,3,7,0,7
2020,156471,41,4,53,6,47
2020,156471,45,0,62,6,56
2020,156471,45,2,2,0,2
2020,156471,45,3,7,0,7
2020,156471,45,4,53,6,47
2020,156541,0,0,242,117,125
2020,156541,10,0,242,117,125
2020,156541,10,1,59,37,22
2020,156541,10,2,99,48,51
2020,156541,10,3,76,28,48
2020,156541,10,4,8,4,4
2020,156541,20,0,38,22,16
2020,156541,20,1,28,18,10
2020,156541,20,2,10,4,6
2020,156541,30,0,124,44,80
2020,156541,30,1,15,9,6
2020,156541,30,2,51,16,35
2020,156541,30,3,56,19,37
2020,156541,30,4,2,0,2
2020,156541,40,0,80,51,29
2020,156541,40,1,16,10,6
2020,156541,40,2,38,28,10
2020,156541,40,3,20,9,11
2020,156541,40,4,6,4,2
2020,156541,42,0,80,51,29
2020,156541,42,1,16,10,6
2020,156541,42,2,38,28,10
2020,156541,42,3,20,9,11
2020,156541,42,4,6,4,2
2020,156620,0,0,563,272,291
2020,156620,10,0,563,272,291
2020,156620,10,1,150,93,57
2020,156620,10,2,159,69,90
2020,156620,10,3,147,65,82
2020,156620,10,4,13,4,9
2020,156620,10,5,58,34,24
2020,156620,10,6,36,7,29
2020,156620,20,0,318,160,158
2020,156620,20,1,148,92,56
2020,156620,20,2,141,58,83
2020,156620,20,3,28,9,19
2020,156620,20,6,1,1,0
2020,156620,30,0,152,71,81
2020,156620,30,2,18,11,7
2020,156620,30,3,117,54,63
2020,156620,30,4,11,3,8
2020,156620,30,6,6,3,3
2020,156620,40,0,93,41,52
2020,156620,40,1,2,1,1
2020,156620,40,3,2,2,0
2020,156620,40,4,2,1,1
2020,156620,40,5,58,34,24
2020,156620,40,6,29,3,26
2020,156620,42,0,91,41,50
2020,156620,42,1,2,1,1
2020,156620,42,3,2,2,0
2020,156620,42,4,2,1,1
2020,156620,42,5,57,34,23
2020,156620,42,6,28,3,25
2020,156620,43,0,2,0,2
2020,156620,43,5,1,0,1
2020,156620,43,6,1,0,1
2020,156648,0,0,111,63,48
2020,156648,10,0,111,63,48
2020,156648,10,1,42,21,21
2020,156648,10,2,38,25,13
2020,156648,10,3,16,9,7
2020,156648,10,4,14,8,6
2020,156648,10,5,1,0,1
2020,156648,20,0,53,27,26
2020,156648,20,1,25,11,14
2020,156648,20,2,28,16,12
2020,156648,40,0,58,36,22
2020,156648,40,1,17,10,7
2020,156648,40,2,10,9,1
2020,156648,40,3,16,9,7
2020,156648,40,4,14,8,6
2020,156648,40,5,1,0,1
2020,156648,42,0,3,3,0
2020,156648,42,1,1,1,0
2020,156648,42,2,1,1,0
2020,156648,42,4,1,1,0
2020,156648,43,0,55,33,22
2020,156648,43,1,16,9,7
2020,156648,43,2,9,8,1
2020,156648,43,3,16,9,7
2020,156648,43,4,13,7,6
2020,156648,43,5,1,0,1
2020,156727,0,0,145,6,139
2020,156727,10,0,145,6,139
2020,156727,10,1,2,0,2
2020,156727,10,2,15,0,15
2020,156727,10,3,39,1,38
2020,156727,10,4,89,5,84
2020,156727,40,0,145,6,139
2020,156727,40,1,2,0,2
2020,156727,40,2,15,0,15
2020,156727,40,3,39,1,38
2020,156727,40,4,89,5,84
2020,156727,42,0,145,6,139
2020,156727,42,1,2,0,2
2020,156727,42,2,15,0,15
2020,156727,42,3,39,1,38
2020,156727,42,4,89,5,84
2020,156745,0,0,77,39,38
2020,156745,10,0,77,39,38
2020,156745,10,1,36,20,16
2020,156745,10,2,18,11,7
2020,156745,10,3,10,3,7
2020,156745,10,4,8,4,4
2020,156745,10,5,5,1,4
2020,156745,20,0,53,30,23
2020,156745,20,1,36,20,16
2020,156745,20,2,16,10,6
2020,156745,20,3,1,0,1
2020,156745,30,0,11,4,7
2020,156745,30,2,2,1,1
2020,156745,30,3,9,3,6
2020,156745,40,0,13,5,8
2020,156745,40,4,8,4,4
2020,156745,40,5,5,1,4
2020,156745,42,0,13,5,8
2020,156745,42,4,8,4,4
2020,156745,42,5,5,1,4
2020,156790,0,0,81,38,43
2020,156790,10,0,81,38,43
2020,156790,10,1,42,22,20
2020,156790,10,2,15,5,10
2020,156790,10,3,12,5,7
2020,156790,10,4,9,5,4
2020,156790,10,5,3,1,2
2020,156790,20,0,29,16,13
2020,156790,20,1,29,16,13
2020,156790,40,0,52,22,30
2020,156790,40,1,13,6,7
2020,156790,40,2,15,5,10
2020,156790,40,3,12,5,7
2020,156790,40,4,9,5,4
2020,156790,40,5,3,1,2
2020,156790,42,0,10,6,4
2020,156790,42,1,4,2,2
2020,156790,42,2,2,1,1
2020,156790,42,3,1,1,0
2020,156790,42,4,3,2,1
2020,156790,43,0,42,16,26
2020,156790,43,1,9,4,5
2020,156790,43,2,13,4,9
2020,156790,43,3,11,4,7
2020,156790,43,4,6,3,3
2020,156790,43,5,3,1,2
2020,156851,0,0,34,13,21
2020,156851,10,0,34,13,21
2020,156851,10,1,14,6,8
2020,156851,10,2,8,3,5
2020,156851,10,3,3,2,1
2020,156851,10,4,9,2,7
2020,156851,20,0,15,7,8
2020,156851,20,1,14,6,8
2020,156851,20,2,1,1,0
2020,156851,30,0,2,0,2
2020,156851,30,2,2,0,2
2020,156851,40,0,17,6,11
2020,156851,40,2,5,2,3
2020,156851,40,3,3,2,1
2020,156851,40,4,9,2,7
2020,156851,42,0,2,1,1
2020,156851,42,2,1,0,1
2020,156851,42,3,1,1,0
2020,156851,43,0,15,5,10
2020,156851,43,2,4,2,2
2020,156851,43,3,2,1,1
2020,156851,43,4,9,2,7
2020,156860,0,0,53,21,32
2020,156860,10,0,53,21,32
2020,156860,10,1,14,7,7
2020,156860,10,2,10,7,3
2020,156860,10,3,6,0,6
2020,156860,10,4,23,7,16
2020,156860,20,0,16,7,9
2020,156860,20,1,13,6,7
2020,156860,20,2,3,1,2
2020,156860,40,0,37,14,23
2020,156860,40,1,1,1,0
2020,156860,40,2,7,6,1
2020,156860,40,3,6,0,6
2020,156860,40,4,23,7,16
2020,156860,43,0,37,14,23
2020,156860,43,1,1,1,0
2020,156860,43,2,7,6,1
2020,156860,43,3,6,0,6
2020,156860,43,4,23,7,16
2020,156921,0,0,175,79,96
2020,156921,10,0,175,79,96
2020,156921,10,1,48,16,32
2020,156921,10,2,49,23,26
2020,156921,10,3,23,12,11
2020,156921,10,4,55,28,27
2020,156921,20,0,72,31,41
2020,156921,20,1,41,15,26
2020,156921,20,2,31,16,15
2020,156921,30,0,8,2,6
2020,156921,30,2,8,2,6
2020,156921,40,0,95,46,49
2020,156921,40,1,7,1,6
2020,156921,40,2,10,5,5
2020,156921,40,3,23,12,11
2020,156921,40,4,55,28,27
2020,156921,42,0,19,7,12
2020,156921,42,1,3,0,3
2020,156921,42,2,2,1,1
2020,156921,42,3,5,3,2
2020,156921,42,4,9,3,6
2020,156921,43,0,76,39,37
2020,156921,43,1,4,1,3
2020,156921,43,2,8,4,4
2020,156921,43,3,18,9,9
2020,156921,43,4,46,25,21
2020,157021,0,0,7,1,6
2020,157021,50,0,7,1,6
2020,157058,0,0,117,69,48
2020,157058,10,0,117,69,48
2020,157058,10,1,27,19,8
2020,157058,10,2,37,23,14
2020,157058,10,3,47,24,23
2020,157058,10,4,6,3,3
2020,157058,20,0,62,39,23
2020,157058,20,1,24,17,7
2020,157058,20,2,28,17,11
2020,157058,20,3,10,5,5
2020,157058,30,0,30,18,12
2020,157058,30,1,3,2,1
2020,157058,30,2,5,4,1
2020,157058,30,3,22,12,10
2020,157058,40,0,25,12,13
2020,157058,40,2,4,2,2
2020,157058,40,3,15,7,8
2020,157058,40,4,6,3,3
2020,157058,42,0,25,12,13
2020,157058,42,2,4,2,2
2020,157058,42,3,15,7,8
2020,157058,42,4,6,3,3
2020,157076,0,0,41,18,23
2020,157076,10,0,41,18,23
2020,157076,10,1,2,1,1
2020,157076,10,2,13,6,7
2020,157076,10,3,25,11,14
2020,157076,10,4,1,0,1
2020,157076,20,0,14,7,7
2020,157076,20,1,2,1,1
2020,157076,20,2,12,6,6
2020,157076,30,0,15,7,8
2020,157076,30,2,1,0,1
2020,157076,30,3,14,7,7
2020,157076,40,0,12,4,8
2020,157076,40,3,11,4,7
2020,157076,40,4,1,0,1
2020,157076,42,0,12,4,8
2020,157076,42,3,11,4,7
2020,157076,42,4,1,0,1
2020,157085,0,0,1754,1013,741
2020,157085,10,0,1754,1013,741
2020,157085,10,1,630,464,166
2020,157085,10,2,498,287,211
2020,157085,10,3,405,173,232
2020,157085,10,4,6,3,3
2020,157085,10,5,215,86,129
2020,157085,20,0,1096,731,365
2020,157085,20,1,627,461,166
2020,157085,20,2,469,270,199
2020,157085,30,0,425,188,237
2020,157085,30,2,27,15,12
2020,157085,30,3,397,172,225
2020,157085,30,4,1,1,0
2020,157085,40,0,233,94,139
2020,157085,40,1,3,3,0
2020,157085,40,2,2,2,0
2020,157085,40,3,8,1,7
2020,157085,40,4,5,2,3
2020,157085,40,5,215,86,129
2020,157085,41,0,166,69,97
2020,157085,41,5,166,69,97
2020,157085,42,0,63,25,38
2020,157085,42,1,3,3,0
2020,157085,42,2,2,2,0
2020,157085,42,3,7,1,6
2020,157085,42,4,4,2,2
2020,157085,42,5,47,17,30
2020,157085,43,0,4,0,4
2020,157085,43,3,1,0,1
2020,157085,43,4,1,0,1
2020,157085,43,5,2,0,2
2020,157085,44,0,166,69,97
2020,157085,44,5,166,69,97
2020,157100,0,0,28,11,17
2020,157100,10,0,27,11,16
2020,157100,10,1,3,2,1
2020,157100,10,2,7,6,1
2020,157100,10,3,17,3,14
2020,157100,40,0,27,11,16
2020,157100,40,1,3,2,1
2020,157100,40,2,7,6,1
2020,157100,40,3,17,3,14
2020,157100,42,0,27,11,16
2020,157100,42,1,3,2,1
2020,157100,42,2,7,6,1
2020,157100,42,3,17,3,14
2020,157100,50,0,1,0,1
2020,157207,0,0,3,1,2
2020,157207,10,0,3,1,2
2020,157207,10,1,1,1,0
2020,157207,10,2,1,0,1
2020,157207,10,3,1,0,1
2020,157207,40,0,3,1,2
2020,157207,40,1,1,1,0
2020,157207,40,2,1,0,1
2020,157207,40,3,1,0,1
2020,157207,41,0,3,1,2
2020,157207,41,1,1,1,0
2020,157207,41,2,1,0,1
2020,157207,41,3,1,0,1
2020,157207,44,0,3,1,2
2020,157207,44,1,1,1,0
2020,157207,44,2,1,0,1
2020,157207,44,3,1,0,1
2020,157216,0,0,101,45,56
2020,157216,10,0,101,45,56
2020,157216,10,1,13,9,4
2020,157216,10,2,25,12,13
2020,157216,10,3,51,18,33
2020,157216,10,4,12,6,6
2020,157216,40,0,101,45,56
2020,157216,40,1,13,9,4
2020,157216,40,2,25,12,13
2020,157216,40,3,51,18,33
2020,157216,40,4,12,6,6
2020,157216,41,0,79,36,43
2020,157216,41,1,13,9,4
2020,157216,41,2,23,11,12
2020,157216,41,3,37,13,24
2020,157216,41,4,6,3,3
2020,157216,42,0,22,9,13
2020,157216,42,2,2,1,1
2020,157216,42,3,14,5,9
2020,157216,42,4,6,3,3
2020,157216,44,0,79,36,43
2020,157216,44,1,13,9,4
2020,157216,44,2,23,11,12
2020,157216,44,3,37,13,24
2020,157216,44,4,6,3,3
2020,157289,0,0,1070,560,510
2020,157289,10,0,1070,560,510
2020,157289,10,1,263,180,83
2020,157289,10,2,313,155,158
2020,157289,10,3,383,182,201
2020,157289,10,4,89,34,55
2020,157289,10,5,1,0,1
2020,157289,10,6,21,9,12
2020,157289,20,0,389,247,142
2020,157289,20,1,206,149,57
2020,157289,20,2,178,95,83
2020,157289,20,3,4,3,1
2020,157289,20,4,1,0,1
2020,157289,30,0,102,52,50
2020,157289,30,1,1,1,0
2020,157289,30,2,4,2,2
2020,157289,30,3,94,48,46
2020,157289,30,4,3,1,2
2020,157289,40,0,579,261,318
2020,157289,40,1,56,30,26
2020,157289,40,2,131,58,73
2020,157289,40,3,285,131,154
2020,157289,40,4,85,33,52
2020,157289,40,5,1,0,1
2020,157289,40,6,21,9,12
2020,157289,41,0,5,1,4
2020,157289,41,2,2,1,1
2020,157289,41,3,3,0,3
2020,157289,42,0,574,260,314
2020,157289,42,1,56,30,26
2020,157289,42,2,129,57,72
2020,157289,42,3,282,131,151
2020,157289,42,4,85,33,52
2020,157289,42,5,1,0,1
2020,157289,42,6,21,9,12
2020,157289,44,0,5,1,4
2020,157289,44,2,2,1,1
2020,157289,44,3,3,0,3
2020,157298,0,0,14,8,6
2020,157298,10,0,14,8,6
2020,157298,10,1,10,6,4
2020,157298,10,2,1,0,1
2020,157298,10,3,2,1,1
2020,157298,10,4,1,1,0
2020,157298,20,0,11,6,5
2020,157298,20,1,10,6,4
2020,157298,20,2,1,0,1
2020,157298,30,0,2,1,1
2020,157298,30,3,2,1,1
2020,157298,40,0,1,1,0
2020,157298,40,4,1,1,0
2020,157298,42,0,1,1,0
2020,157298,42,4,1,1,0
2020,157304,0,0,85,28,57
2020,157304,10,0,85,28,57
2020,157304,10,1,39,12,27
2020,157304,10,2,24,5,19
2020,157304,10,3,5,3,2
2020,157304,10,4,16,8,8
2020,157304,10,5,1,0,1
2020,157304,20,0,29,9,20
2020,157304,20,1,22,8,14
2020,157304,20,2,7,1,6
2020,157304,30,0,6,3,3
2020,157304,30,2,4,1,3
2020,157304,30,3,1,1,0
2020,157304,30,4,1,1,0
2020,157304,40,0,50,16,34
2020,157304,40,1,17,4,13
2020,157304,40,2,13,3,10
2020,157304,40,3,4,2,2
2020,157304,40,4,15,7,8
2020,157304,40,5,1,0,1
2020,157304,42,0,5,3,2
2020,157304,42,1,2,1,1
2020,157304,42,3,1,1,0
2020,157304,42,4,2,1,1
2020,157304,43,0,45,13,32
2020,157304,43,1,15,3,12
2020,157304,43,2,13,3,10
2020,157304,43,3,3,1,2
2020,157304,43,4,13,6,7
2020,157304,43,5,1,0,1
2020,157331,0,0,81,34,47
2020,157331,10,0,81,34,47
2020,157331,10,1,26,11,15
2020,157331,10,2,23,8,15
2020,157331,10,3,10,4,6
2020,157331,10,4,22,11,11
2020,157331,20,0,18,7,11
2020,157331,20,1,15,6,9
2020,157331,20,2,3,1,2
2020,157331,30,0,6,2,4
2020,157331,30,1,1,0,1
2020,157331,30,2,5,2,3
2020,157331,40,0,57,25,32
2020,157331,40,1,10,5,5
2020,157331,40,2,15,5,10
2020,157331,40,3,10,4,6
2020,157331,40,4,22,11,11
2020,157331,42,0,4,3,1
2020,157331,42,1,2,1,1
2020,157331,42,4,2,2,0
2020,157331,43,0,53,22,31
2020,157331,43,1,8,4,4
2020,157331,43,2,15,5,10
2020,157331,43,3,10,4,6
2020,157331,43,4,20,9,11
2020,157377,0,0,32,12,20
2020,157377,10,0,32,12,20
2020,157377,10,1,5,3,2
2020,157377,10,2,4,1,3
2020,157377,10,3,15,6,9
2020,157377,10,4,8,2,6
2020,157377,40,0,32,12,20
2020,157377,40,1,5,3,2
2020,157377,40,2,4,1,3
2020,157377,40,3,15,6,9
2020,157377,40,4,8,2,6
2020,157377,41,0,25,10,15
2020,157377,41,1,4,3,1
2020,157377,41,2,4,1,3
2020,157377,41,3,12,5,7
2020,157377,41,4,5,1,4
2020,157377,42,0,7,2,5
2020,157377,42,1,1,0,1
2020,157377,42,3,3,1,2
2020,157377,42,4,3,1,2
2020,157377,44,0,25,10,15
2020,157377,44,1,4,3,1
2020,157377,44,2,4,1,3
2020,157377,44,3,12,5,7
2020,157377,44,4,5,1,4
2020,157386,0,0,314,161,153
2020,157386,10,0,312,161,151
2020,157386,10,1,76,42,34
2020,157386,10,2,92,50,42
2020,157386,10,3,56,30,26
2020,157386,10,4,88,39,49
2020,157386,20,0,162,90,72
2020,157386,20,1,76,42,34
2020,157386,20,2,86,48,38
2020,157386,30,0,47,24,23
2020,157386,30,2,6,2,4
2020,157386,30,3,41,22,19
2020,157386,40,0,103,47,56
2020,157386,40,3,15,8,7
2020,157386,40,4,88,39,49
2020,157386,42,0,103,47,56
2020,157386,42,3,15,8,7
2020,157386,42,4,88,39,49
2020,157386,50,0,2,0,2
2020,157401,0,0,442,234,208
2020,157401,10,0,442,234,208
2020,157401,10,1,97,65,32
2020,157401,10,2,89,54,35
2020,157401,10,3,158,73,85
2020,157401,10,4,98,42,56
2020,157401,20,0,218,135,83
2020,157401,20,1,92,61,31
2020,157401,20,2,86,53,33
2020,157401,20,3,34,18,16
2020,157401,20,4,6,3,3
2020,157401,30,0,114,51,63
2020,157401,30,1,1,1,0
2020,157401,30,2,2,1,1
2020,157401,30,3,111,49,62
2020,157401,40,0,110,48,62
2020,157401,40,1,4,3,1
2020,157401,40,2,1,0,1
2020,157401,40,3,13,6,7
2020,157401,40,4,92,39,53
2020,157401,41,0,5,2,3
2020,157401,41,1,3,2,1
2020,157401,41,2,1,0,1
2020,157401,41,3,1,0,1
2020,157401,42,0,105,46,59
2020,157401,42,1,1,1,0
2020,157401,42,3,12,6,6
2020,157401,42,4,92,39,53
2020,157401,44,0,5,2,3
2020,157401,44,1,3,2,1
2020,157401,44,2,1,0,1
2020,157401,44,3,1,0,1
2020,157438,0,0,76,43,33
2020,157438,10,0,76,43,33
2020,157438,10,1,5,4,1
2020,157438,10,2,22,11,11
2020,157438,10,3,17,9,8
2020,157438,10,4,31,18,13
2020,157438,10,5,1,1,0
2020,157438,40,0,76,43,33
2020,157438,40,1,5,4,1
2020,157438,40,2,22,11,11
2020,157438,40,3,17,9,8
2020,157438,40,4,31,18,13
2020,157438,40,5,1,1,0
2020,157438,42,0,18,9,9
2020,157438,42,2,6,3,3
2020,157438,42,3,4,2,2
2020,157438,42,4,8,4,4
2020,157438,43,0,58,34,24
2020,157438,43,1,5,4,1
2020,157438,43,2,16,8,8
2020,157438,43,3,13,7,6
2020,157438,43,4,23,14,9
2020,157438,43,5,1,1,0
2020,157447,0,0,610,278,332
2020,157447,10,0,610,278,332
2020,157447,10,1,129,81,48
2020,157447,10,2,138,58,80
2020,157447,10,3,94,40,54
2020,157447,10,5,249,99,150
2020,157447,20,0,266,138,128
2020,157447,20,1,129,81,48
2020,157447,20,2,137,57,80
2020,157447,30,0,95,41,54
2020,157447,30,2,1,1,0
2020,157447,30,3,94,40,54
2020,157447,40,0,249,99,150
2020,157447,40,5,249,99,150
2020,157447,42,0,249,99,150
2020,157447,42,5,249,99,150
2020,157483,0,0,116,41,75
2020,157483,10,0,116,41,75
2020,157483,10,1,40,13,27
2020,157483,10,2,21,13,8
2020,157483,10,3,17,7,10
2020,157483,10,4,38,8,30
2020,157483,20,0,23,7,16
2020,157483,20,1,22,7,15
2020,157483,20,2,1,0,1
2020,157483,40,0,93,34,59
2020,157483,40,1,18,6,12
2020,157483,40,2,20,13,7
2020,157483,40,3,17,7,10
2020,157483,40,4,38,8,30
2020,157483,42,0,24,15,9
2020,157483,42,1,1,1,0
2020,157483,42,2,12,8,4
2020,157483,42,3,7,3,4
2020,157483,42,4,4,3,1
2020,157483,43,0,69,19,50
2020,157483,43,1,17,5,12
2020,157483,43,2,8,5,3
2020,157483,43,3,10,4,6
2020,157483,43,4,34,5,29
2020,157535,0,0,108,52,56
2020,157535,10,0,108,52,56
2020,157535,10,1,30,16,14
2020,157535,10,2,37,17,20
2020,157535,10,3,36,16,20
2020,157535,10,4,5,3,2
2020,157535,40,0,108,52,56
2020,157535,40,1,30,16,14
2020,157535,40,2,37,17,20
2020,157535,40,3,36,16,20
2020,157535,40,4,5,3,2
2020,157535,41,0,33,15,18
2020,157535,41,1,18,10,8
2020,157535,41,2,15,5,10
2020,157535,42,0,75,37,38
2020,157535,42,1,12,6,6
2020,157535,42,2,22,12,10
2020,157535,42,3,36,16,20
2020,157535,42,4,5,3,2
2020,157535,44,0,33,15,18
2020,157535,44,1,18,10,8
2020,157535,44,2,15,5,10
2020,157553,0,0,81,36,45
2020,157553,10,0,81,36,45
2020,157553,10,1,43,18,25
2020,157553,10,2,20,9,11
2020,157553,10,3,7,4,3
2020,157553,10,4,10,4,6
2020,157553,10,5,1,1,0
2020,157553,20,0,19,9,10
2020,157553,20,1,18,8,10
2020,157553,20,2,1,1,0
2020,157553,30,0,1,1,0
2020,157553,30,3,1,1,0
2020,157553,40,0,61,26,35
2020,157553,40,1,25,10,15
2020,157553,40,2,19,8,11
2020,157553,40,3,6,3,3
2020,157553,40,4,10,4,6
2020,157553,40,5,1,1,0
2020,157553,42,0,6,2,4
2020,157553,42,1,4,1,3
2020,157553,42,3,1,0,1
2020,157553,42,4,1,1,0
2020,157553,43,0,55,24,31
2020,157553,43,1,21,9,12
2020,157553,43,2,19,8,11
2020,157553,43,3,5,3,2
2020,157553,43,4,9,3,6
2020,157553,43,5,1,1,0
2020,157711,0,0,132,51,81
2020,157711,10,0,132,51,81
2020,157711,10,1,38,14,24
2020,157711,10,2,46,19,27
2020,157711,10,3,14,5,9
2020,157711,10,4,34,13,21
2020,157711,20,0,34,14,20
2020,157711,20,1,25,9,16
2020,157711,20,2,9,5,4
2020,157711,30,0,4,2,2
2020,157711,30,1,2,1,1
2020,157711,30,2,2,1,1
2020,157711,40,0,94,35,59
2020,157711,40,1,11,4,7
2020,157711,40,2,35,13,22
2020,157711,40,3,14,5,9
2020,157711,40,4,34,13,21
2020,157711,42,0,6,2,4
2020,157711,42,2,1,0,1
2020,157711,42,3,3,1,2
2020,157711,42,4,2,1,1
2020,157711,43,0,88,33,55
2020,157711,43,1,11,4,7
2020,157711,43,2,34,13,21
2020,157711,43,3,11,4,7
2020,157711,43,4,32,12,20
2020,157739,0,0,68,32,36
2020,157739,10,0,68,32,36
2020,157739,10,1,34,22,12
2020,157739,10,2,19,7,12
2020,157739,10,3,8,1,7
2020,157739,10,4,7,2,5
2020,157739,20,0,26,18,8
2020,157739,20,1,19,15,4
2020,157739,20,2,7,3,4
2020,157739,30,0,3,1,2
2020,157739,30,2,2,1,1
2020,157739,30,3,1,0,1
2020,157739,40,0,39,13,26
2020,157739,40,1,15,7,8
2020,157739,40,2,10,3,7
2020,157739,40,3,7,1,6
2020,157739,40,4,7,2,5
2020,157739,42,0,10,6,4
2020,157739,42,1,5,3,2
2020,157739,42,3,2,1,1
2020,157739,42,4,3,2,1
2020,157739,43,0,29,7,22
2020,157739,43,1,10,4,6
2020,157739,43,2,10,3,7
2020,157739,43,3,5,0,5
2020,157739,43,4,4,0,4
2020,157748,0,0,47,45,2
2020,157748,10,0,47,45,2
2020,157748,10,1,23,22,1
2020,157748,10,2,16,15,1
2020,157748,10,3,8,8,0
2020,157748,40,0,47,45,2
2020,157748,40,1,23,22,1
2020,157748,40,2,16,15,1
2020,157748,40,3,8,8,0
2020,157748,41,0,47,45,2
2020,157748,41,1,23,22,1
2020,157748,41,2,16,15,1
2020,157748,41,3,8,8,0
2020,157748,44,0,47,45,2
2020,157748,44,1,23,22,1
2020,157748,44,2,16,15,1
2020,157748,44,3,8,8,0
2020,157757,0,0,94,35,59
2020,157757,10,0,94,35,59
2020,157757,10,1,29,11,18
2020,157757,10,2,25,6,19
2020,157757,10,3,39,18,21
2020,157757,10,5,1,0,1
2020,157757,20,0,43,16,27
2020,157757,20,1,25,11,14
2020,157757,20,2,18,5,13
2020,157757,30,0,22,7,15
2020,157757,30,1,3,0,3
2020,157757,30,2,4,0,4
2020,157757,30,3,15,7,8
2020,157757,40,0,29,12,17
2020,157757,40,1,1,0,1
2020,157757,40,2,3,1,2
2020,157757,40,3,24,11,13
2020,157757,40,5,1,0,1
2020,157757,42,0,7,3,4
2020,157757,42,3,7,3,4
2020,157757,43,0,22,9,13
2020,157757,43,1,1,0,1
2020,157757,43,2,3,1,2
2020,157757,43,3,17,8,9
2020,157757,43,5,1,0,1
2020,157793,0,0,145,60,85
2020,157793,10,0,145,60,85
2020,157793,10,1,28,16,12
2020,157793,10,2,28,13,15
2020,157793,10,3,27,8,19
2020,157793,10,4,61,22,39
2020,157793,10,5,1,1,0
2020,157793,40,0,145,60,85
2020,157793,40,1,28,16,12
2020,157793,40,2,28,13,15
2020,157793,40,3,27,8,19
2020,157793,40,4,61,22,39
2020,157793,40,5,1,1,0
2020,157793,42,0,145,60,85
2020,157793,42,1,28,16,12
2020,157793,42,2,28,13,15
2020,157793,42,3,27,8,19
2020,157793,42,4,61,22,39
2020,157793,42,5,1,1,0
2020,157809,0,0,86,44,42
2020,157809,10,0,86,44,42
2020,157809,10,1,32,21,11
2020,157809,10,2,25,8,17
2020,157809,10,3,29,15,14
2020,157809,20,0,46,26,20
2020,157809,20,1,30,19,11
2020,157809,20,2,15,6,9
2020,157809,20,3,1,1,0
2020,157809,30,0,12,3,9
2020,157809,30,2,7,1,6
2020,157809,30,3,5,2,3
2020,157809,40,0,28,15,13
2020,157809,40,1,2,2,0
2020,157809,40,2,3,1,2
2020,157809,40,3,23,12,11
2020,157809,41,0,2,1,1
2020,157809,41,3,2,1,1
2020,157809,42,0,26,14,12
2020,157809,42,1,2,2,0
2020,157809,42,2,3,1,2
2020,157809,42,3,21,11,10
2020,157809,44,0,2,1,1
2020,157809,44,3,2,1,1
2020,157818,0,0,84,44,40
2020,157818,10,0,84,44,40
2020,157818,10,1,33,23,10
2020,157818,10,2,30,12,18
2020,157818,10,3,15,5,10
2020,157818,10,4,6,4,2
2020,157818,20,0,62,35,27
2020,157818,20,1,33,23,10
2020,157818,20,2,29,12,17
2020,157818,30,0,10,4,6
2020,157818,30,2,1,0,1
2020,157818,30,3,9,4,5
2020,157818,40,0,12,5,7
2020,157818,40,3,6,1,5
2020,157818,40,4,6,4,2
2020,157818,41,0,10,4,6
2020,157818,41,3,6,1,5
2020,157818,41,4,4,3,1
2020,157818,42,0,2,1,1
2020,157818,42,4,2,1,1
2020,157818,44,0,10,4,6
2020,157818,44,3,6,1,5
2020,157818,44,4,4,3,1
2020,157863,0,0,48,26,22
2020,157863,10,0,48,26,22
2020,157863,10,1,13,9,4
2020,157863,10,2,17,11,6
2020,157863,10,3,13,5,8
2020,157863,10,4,5,1,4
2020,157863,20,0,16,12,4
2020,157863,20,1,11,8,3
2020,157863,20,2,5,4,1
2020,157863,30,0,16,8,8
2020,157863,30,1,2,1,1
2020,157863,30,2,6,4,2
2020,157863,30,3,8,3,5
2020,157863,40,0,16,6,10
2020,157863,40,2,6,3,3
2020,157863,40,3,5,2,3
2020,157863,40,4,5,1,4
2020,157863,42,0,2,0,2
2020,157863,42,2,1,0,1
2020,157863,42,3,1,0,1
2020,157863,43,0,14,6,8
2020,157863,43,2,5,3,2
2020,157863,43,3,4,2,2
2020,157863,43,4,5,1,4
2020,157951,0,0,658,321,337
2020,157951,10,0,658,321,337
2020,157951,10,1,203,128,75
2020,157951,10,2,215,97,118
2020,157951,10,3,119,56,63
2020,157951,10,4,110,35,75
2020,157951,10,6,11,5,6
2020,157951,20,0,410,223,187
2020,157951,20,1,203,128,75
2020,157951,20,2,203,94,109
2020,157951,20,3,4,1,3
2020,157951,30,0,114,53,61
2020,157951,30,2,5,2,3
2020,157951,30,3,109,51,58
2020,157951,40,0,134,45,89
2020,157951,40,2,7,1,6
2020,157951,40,3,6,4,2
2020,157951,40,4,110,35,75
2020,157951,40,6,11,5,6
2020,157951,41,0,107,35,72
2020,157951,41,2,7,1,6
2020,157951,41,3,6,4,2
2020,157951,41,4,92,29,63
2020,157951,41,6,2,1,1
2020,157951,42,0,26,10,16
2020,157951,42,4,18,6,12
2020,157951,42,6,8,4,4
2020,157951,43,0,1,0,1
2020,157951,43,6,1,0,1
2020,157951,44,0,107,35,72
2020,157951,44,2,7,1,6
2020,157951,44,3,6,4,2
2020,157951,44,4,92,29,63
2020,157951,44,6,2,1,1
2020,158088,0,0,60,25,35
2020,158088,10,0,60,25,35
2020,158088,10,1,2,1,1
2020,158088,10,4,58,24,34
2020,158088,20,0,2,1,1
2020,158088,20,1,2,1,1
2020,158088,40,0,58,24,34
2020,158088,40,4,58,24,34
2020,158088,42,0,54,23,31
2020,158088,42,4,54,23,31
2020,158088,43,0,4,1,3
2020,158088,43,4,4,1,3
2020,158431,0,0,119,40,79
2020,158431,10,0,119,40,79
2020,158431,10,1,29,7,22
2020,158431,10,2,14,5,9
2020,158431,10,3,29,7,22
2020,158431,10,4,41,20,21
2020,158431,10,6,6,1,5
2020,158431,20,0,15,5,10
2020,158431,20,1,14,4,10
2020,158431,20,2,1,1,0
2020,158431,30,0,1,0,1
2020,158431,30,2,1,0,1
2020,158431,40,0,103,35,68
2020,158431,40,1,15,3,12
2020,158431,40,2,12,4,8
2020,158431,40,3,29,7,22
2020,158431,40,4,41,20,21
2020,158431,40,6,6,1,5
2020,158431,42,0,103,35,68
2020,158431,42,1,15,3,12
2020,158431,42,2,12,4,8
2020,158431,42,3,29,7,22
2020,158431,42,4,41,20,21
2020,158431,42,6,6,1,5
2020,158477,0,0,54,31,23
2020,158477,10,0,54,31,23
2020,158477,10,1,16,10,6
2020,158477,10,2,10,4,6
2020,158477,10,3,27,16,11
2020,158477,10,4,1,1,0
2020,158477,20,0,27,15,12
2020,158477,20,1,16,10,6
2020,158477,20,2,10,4,6
2020,158477,20,3,1,1,0
2020,158477,30,0,21,13,8
2020,158477,30,3,21,13,8
2020,158477,40,0,6,3,3
2020,158477,40,3,5,2,3
2020,158477,40,4,1,1,0
2020,158477,42,0,6,3,3
2020,158477,42,3,5,2,3
2020,158477,42,4,1,1,0
2020,158662,0,0,321,112,209
2020,158662,10,0,321,112,209
2020,158662,10,1,102,29,73
2020,158662,10,2,59,22,37
2020,158662,10,3,67,27,40
2020,158662,10,4,90,34,56
2020,158662,10,6,3,0,3
2020,158662,20,0,15,3,12
2020,158662,20,1,12,2,10
2020,158662,20,2,2,1,1
2020,158662,20,3,1,0,1
2020,158662,30,0,9,3,6
2020,158662,30,1,9,3,6
2020,158662,40,0,297,106,191
2020,158662,40,1,81,24,57
2020,158662,40,2,57,21,36
2020,158662,40,3,66,27,39
2020,158662,40,4,90,34,56
2020,158662,40,6,3,0,3
2020,158662,42,0,293,105,188
2020,158662,42,1,81,24,57
2020,158662,42,2,57,21,36
2020,158662,42,3,66,27,39
2020,158662,42,4,86,33,53
2020,158662,42,6,3,0,3
2020,158662,43,0,4,1,3
2020,158662,43,4,4,1,3
2020,158802,0,0,67,34,33
2020,158802,10,0,67,34,33
2020,158802,10,1,12,8,4
2020,158802,10,2,18,11,7
2020,158802,10,3,27,12,15
2020,158802,10,4,10,3,7
2020,158802,20,0,29,19,10
2020,158802,20,1,12,8,4
2020,158802,20,2,17,11,6
2020,158802,30,0,7,2,5
2020,158802,30,2,1,0,1
2020,158802,30,3,6,2,4
2020,158802,40,0,31,13,18
2020,158802,40,3,21,10,11
2020,158802,40,4,10,3,7
2020,158802,42,0,31,13,18
2020,158802,42,3,21,10,11
2020,158802,42,4,10,3,7
2020,158884,0,0,33,19,14
2020,158884,10,0,33,19,14
2020,158884,10,1,5,3,2
2020,158884,10,2,6,3,3
2020,158884,10,3,6,4,2
2020,158884,10,4,16,9,7
2020,158884,40,0,33,19,14
2020,158884,40,1,5,3,2
2020,158884,40,2,6,3,3
2020,158884,40,3,6,4,2
2020,158884,40,4,16,9,7
2020,158884,42,0,32,19,13
2020,158884,42,1,5,3,2
2020,158884,42,2,6,3,3
2020,158884,42,3,6,4,2
2020,158884,42,4,15,9,6
2020,158884,43,0,1,0,1
2020,158884,43,4,1,0,1
2020,159009,0,0,152,79,73
2020,159009,10,0,107,61,46
2020,159009,10,1,31,23,8
2020,159009,10,2,27,14,13
2020,159009,10,3,39,18,21
2020,159009,10,4,3,2,1
2020,159009,10,5,7,4,3
2020,159009,20,0,76,48,28
2020,159009,20,1,30,22,8
2020,159009,20,2,25,13,12
2020,159009,20,3,21,13,8
2020,159009,30,0,19,6,13
2020,159009,30,1,1,1,0
2020,159009,30,2,1,1,0
2020,159009,30,3,17,4,13
2020,159009,40,0,12,7,5
2020,159009,40,2,1,0,1
2020,159009,40,3,1,1,0
2020,159009,40,4,3,2,1
2020,159009,40,5,7,4,3
2020,159009,42,0,12,7,5
2020,159009,42,2,1,0,1
2020,159009,42,3,1,1,0
2020,159009,42,4,3,2,1
2020,159009,42,5,7,4,3
2020,159009,50,0,45,18,27
2020,159197,0,0,23,19,4
2020,159197,10,0,23,19,4
2020,159197,10,4,23,19,4
2020,159197,40,0,23,19,4
2020,159197,40,4,23,19,4
2020,159197,41,0,23,19,4
2020,159197,41,4,23,19,4
2020,159197,45,0,23,19,4
2020,159197,45,4,23,19,4
2020,159373,0,0,754,396,358
2020,159373,10,0,754,396,358
2020,159373,10,1,124,93,31
2020,159373,10,2,227,128,99
2020,159373,10,3,326,153,173
2020,159373,10,4,77,22,55
2020,159373,20,0,99,72,27
2020,159373,20,1,68,51,17
2020,159373,20,2,31,21,10
2020,159373,30,0,32,20,12
2020,159373,30,1,8,7,1
2020,159373,30,2,7,4,3
2020,159373,30,3,17,9,8
2020,159373,40,0,623,304,319
2020,159373,40,1,48,35,13
2020,159373,40,2,189,103,86
2020,159373,40,3,309,144,165
2020,159373,40,4,77,22,55
2020,159373,42,0,623,304,319
2020,159373,42,1,48,35,13
2020,159373,42,2,189,103,86
2020,159373,42,3,309,144,165
2020,159373,42,4,77,22,55
2020,159382,0,0,86,39,47
2020,159382,10,0,86,39,47
2020,159382,10,1,21,15,6
2020,159382,10,2,23,7,16
2020,159382,10,3,28,8,20
2020,159382,10,4,14,9,5
2020,159382,20,0,46,23,23
2020,159382,20,1,21,15,6
2020,159382,20,2,23,7,16
2020,159382,20,3,1,0,1
2020,159382,20,4,1,1,0
2020,159382,30,0,27,8,19
2020,159382,30,3,27,8,19
2020,159382,40,0,13,8,5
2020,159382,40,4,13,8,5
2020,159382,42,0,13,8,5
2020,159382,42,4,13,8,5
2020,159391,0,0,1342,821,521
2020,159391,10,0,1342,821,521
2020,159391,10,1,426,324,102
2020,159391,10,2,308,197,111
2020,159391,10,3,295,156,139
2020,159391,10,4,278,117,161
2020,159391,10,5,35,27,8
2020,159391,20,0,705,507,198
2020,159391,20,1,419,318,101
2020,159391,20,2,286,189,97
2020,159391,30,0,254,146,108
2020,159391,30,2,5,2,3
2020,159391,30,3,249,144,105
2020,159391,40,0,383,168,215
2020,159391,40,1,7,6,1
2020,159391,40,2,17,6,11
2020,159391,40,3,46,12,34
2020,159391,40,4,278,117,161
2020,159391,40,5,35,27,8
2020,159391,42,0,383,168,215
2020,159391,42,1,7,6,1
2020,159391,42,2,17,6,11
2020,159391,42,3,46,12,34
2020,159391,42,4,278,117,161
2020,159391,42,5,35,27,8
2020,159407,0,0,67,25,42
2020,159407,10,0,67,25,42
2020,159407,10,1,15,10,5
2020,159407,10,2,5,2,3
2020,159407,10,3,14,5,9
2020,159407,10,4,33,8,25
2020,159407,20,0,20,12,8
2020,159407,20,1,15,10,5
2020,159407,20,2,4,2,2
2020,159407,20,3,1,0,1
2020,159407,30,0,14,5,9
2020,159407,30,2,1,0,1
2020,159407,30,3,13,5,8
2020,159407,40,0,33,8,25
2020,159407,40,4,33,8,25
2020,159407,42,0,33,8,25
2020,159407,42,4,33,8,25
2020,159416,0,0,154,89,65
2020,159416,10,0,154,89,65
2020,159416,10,1,39,25,14
2020,159416,10,2,30,15,15
2020,159416,10,3,47,29,18
2020,159416,10,4,21,8,13
2020,159416,10,5,17,12,5
2020,159416,20,0,60,37,23
2020,159416,20,1,38,25,13
2020,159416,20,2,22,12,10
2020,159416,30,0,49,30,19
2020,159416,30,2,6,2,4
2020,159416,30,3,43,28,15
2020,159416,40,0,45,22,23
2020,159416,40,1,1,0,1
2020,159416,40,2,2,1,1
2020,159416,40,3,4,1,3
2020,159416,40,4,21,8,13
2020,159416,40,5,17,12,5
2020,159416,41,0,4,2,2
2020,159416,41,1,1,0,1
2020,159416,41,2,2,1,1
2020,159416,41,5,1,1,0
2020,159416,42,0,41,20,21
2020,159416,42,3,4,1,3
2020,159416,42,4,21,8,13
2020,159416,42,5,16,11,5
2020,159416,44,0,4,2,2
2020,159416,44,1,1,0,1
2020,159416,44,2,2,1,1
2020,159416,44,5,1,1,0
2020,159568,0,0,69,26,43
2020,159568,10,0,69,26,43
2020,159568,10,1,19,9,10
2020,159568,10,2,21,7,14
2020,159568,10,3,26,10,16
2020,159568,10,4,1,0,1
2020,159568,10,5,1,0,1
2020,159568,10,6,1,0,1
2020,159568,20,0,34,11,23
2020,159568,20,1,17,7,10
2020,159568,20,2,16,4,12
2020,159568,20,3,1,0,1
2020,159568,30,0,29,15,14
2020,159568,30,1,2,2,0
2020,159568,30,2,5,3,2
2020,159568,30,3,22,10,12
2020,159568,40,0,6,0,6
2020,159568,40,3,3,0,3
2020,159568,40,4,1,0,1
2020,159568,40,5,1,0,1
2020,159568,40,6,1,0,1
2020,159568,42,0,6,0,6
2020,159568,42,3,3,0,3
2020,159568,42,4,1,0,1
2020,159568,42,5,1,0,1
2020,159568,42,6,1,0,1
2020,159647,0,0,378,226,152
2020,159647,10,0,364,217,147
2020,159647,10,1,65,44,21
2020,159647,10,2,107,66,41
2020,159647,10,3,89,51,38
2020,159647,10,4,59,19,40
2020,159647,10,5,44,37,7
2020,159647,20,0,168,106,62
2020,159647,20,1,62,41,21
2020,159647,20,2,101,61,40
2020,159647,20,3,5,4,1
2020,159647,30,0,86,50,36
2020,159647,30,1,2,2,0
2020,159647,30,2,6,5,1
2020,159647,30,3,78,43,35
2020,159647,40,0,110,61,49
2020,159647,40,1,1,1,0
2020,159647,40,3,6,4,2
2020,159647,40,4,59,19,40
2020,159647,40,5,44,37,7
2020,159647,42,0,110,61,49
2020,159647,42,1,1,1,0
2020,159647,42,3,6,4,2
2020,159647,42,4,59,19,40
2020,159647,42,5,44,37,7
2020,159647,50,0,14,9,5
2020,159656,0,0,233,129,104
2020,159656,10,0,233,129,104
2020,159656,10,1,74,47,27
2020,159656,10,2,51,35,16
2020,159656,10,3,29,10,19
2020,159656,10,5,79,37,42
2020,159656,20,0,125,80,45
2020,159656,20,1,74,47,27
2020,159656,20,2,49,33,16
2020,159656,20,3,2,0,2
2020,159656,30,0,29,12,17
2020,159656,30,2,2,2,0
2020,159656,30,3,27,10,17
2020,159656,40,0,79,37,42
2020,159656,40,5,79,37,42
2020,159656,41,0,12,5,7
2020,159656,41,5,12,5,7
2020,159656,42,0,67,32,35
2020,159656,42,5,67,32,35
2020,159656,44,0,12,5,7
2020,159656,44,5,12,5,7
2020,159717,0,0,258,126,132
2020,159717,10,0,258,126,132
2020,159717,10,1,52,36,16
2020,159717,10,2,45,23,22
2020,159717,10,3,114,51,63
2020,159717,10,4,47,16,31
2020,159717,20,0,123,71,52
2020,159717,20,1,52,36,16
2020,159717,20,2,41,20,21
2020,159717,20,3,30,15,15
2020,159717,30,0,75,34,41
2020,159717,30,2,4,3,1
2020,159717,30,3,71,31,40
2020,159717,40,0,60,21,39
2020,159717,40,3,13,5,8
2020,159717,40,4,47,16,31
2020,159717,42,0,60,21,39
2020,159717,42,3,13,5,8
2020,159717,42,4,47,16,31
2020,159939,0,0,263,165,98
2020,159939,10,0,263,165,98
2020,159939,10,1,83,63,20
2020,159939,10,2,63,41,22
2020,159939,10,3,63,41,22
2020,159939,10,4,54,20,34
2020,159939,20,0,140,99,41
2020,159939,20,1,79,59,20
2020,159939,20,2,61,40,21
2020,159939,30,0,64,43,21
2020,159939,30,1,2,2,0
2020,159939,30,2,1,0,1
2020,159939,30,3,61,41,20
2020,159939,40,0,59,23,36
2020,159939,40,1,2,2,0
2020,159939,40,2,1,1,0
2020,159939,40,3,2,0,2
2020,159939,40,4,54,20,34
2020,159939,42,0,59,23,36
2020,159939,42,1,2,2,0
2020,159939,42,2,1,1,0
2020,159939,42,3,2,0,2
2020,159939,42,4,54,20,34
2020,159948,0,0,53,45,8
2020,159948,10,0,53,45,8
2020,159948,10,1,41,35,6
2020,159948,10,2,6,6,0
2020,159948,10,3,6,4,2
2020,159948,20,0,40,34,6
2020,159948,20,1,36,30,6
2020,159948,20,2,4,4,0
2020,159948,30,0,13,11,2
2020,159948,30,1,5,5,0
2020,159948,30,2,2,2,0
2020,159948,30,3,6,4,2
2020,159966,0,0,268,111,157
2020,159966,10,0,259,108,151
2020,159966,10,1,39,22,17
2020,159966,10,2,50,28,22
2020,159966,10,3,96,39,57
2020,159966,10,4,74,19,55
2020,159966,20,0,102,55,47
2020,159966,20,1,38,22,16
2020,159966,20,2,50,28,22
2020,159966,20,3,14,5,9
2020,159966,30,0,74,34,40
2020,159966,30,1,1,0,1
2020,159966,30,3,73,34,39
2020,159966,40,0,83,19,64
2020,159966,40,3,9,0,9
2020,159966,40,4,74,19,55
2020,159966,42,0,83,19,64
2020,159966,42,3,9,0,9
2020,159966,42,4,74,19,55
2020,159966,50,0,9,3,6
2020,159993,0,0,311,132,179
2020,159993,10,0,308,131,177
2020,159993,10,1,69,37,32
2020,159993,10,2,68,36,32
2020,159993,10,3,113,37,76
2020,159993,10,4,58,21,37
2020,159993,20,0,132,69,63
2020,159993,20,1,60,35,25
2020,159993,20,2,59,32,27
2020,159993,20,3,13,2,11
2020,159993,30,0,92,35,57
2020,159993,30,2,3,2,1
2020,159993,30,3,89,33,56
2020,159993,40,0,84,27,57
2020,159993,40,1,9,2,7
2020,159993,40,2,6,2,4
2020,159993,40,3,11,2,9
2020,159993,40,4,58,21,37
2020,159993,42,0,26,8,18
2020,159993,42,1,9,2,7
2020,159993,42,2,5,2,3
2020,159993,42,3,7,1,6
2020,159993,42,4,5,3,2
2020,159993,43,0,58,19,39
2020,159993,43,2,1,0,1
2020,159993,43,3,4,1,3
2020,159993,43,4,53,18,35
2020,159993,50,0,3,1,2
2020,160010,0,0,34,21,13
2020,160010,10,0,34,21,13
2020,160010,10,1,2,1,1
2020,160010,10,2,1,1,0
2020,160010,10,4,31,19,12
2020,160010,20,0,1,1,0
2020,160010,20,1,1,1,0
2020,160010,40,0,33,20,13
2020,160010,40,1,1,0,1
2020,160010,40,2,1,1,0
2020,160010,40,4,31,19,12
2020,160010,42,0,33,20,13
2020,160010,42,1,1,0,1
2020,160010,42,2,1,1,0
2020,160010,42,4,31,19,12
2020,160038,0,0,320,123,197
2020,160038,10,0,320,123,197
2020,160038,10,1,59,29,30
2020,160038,10,2,77,41,36
2020,160038,10,3,137,43,94
2020,160038,10,4,47,10,37
2020,160038,20,0,153,72,81
2020,160038,20,1,59,29,30
2020,160038,20,2,68,37,31
2020,160038,20,3,26,6,20
2020,160038,30,0,102,38,64
2020,160038,30,2,7,4,3
2020,160038,30,3,94,34,60
2020,160038,30,4,1,0,1
2020,160038,40,0,65,13,52
2020,160038,40,2,2,0,2
2020,160038,40,3,17,3,14
2020,160038,40,4,46,10,36
2020,160038,42,0,14,2,12
2020,160038,42,3,5,1,4
2020,160038,42,4,9,1,8
2020,160038,43,0,51,11,40
2020,160038,43,2,2,0,2
2020,160038,43,3,12,2,10
2020,160038,43,4,37,9,28
2020,160065,0,0,69,25,44
2020,160065,10,0,69,25,44
2020,160065,10,1,18,8,10
2020,160065,10,2,18,7,11
2020,160065,10,3,31,9,22
2020,160065,10,4,2,1,1
2020,160065,40,0,69,25,44
2020,160065,40,1,18,8,10
2020,160065,40,2,18,7,11
2020,160065,40,3,31,9,22
2020,160065,40,4,2,1,1
2020,160065,41,0,61,22,39
2020,160065,41,1,16,7,9
2020,160065,41,2,18,7,11
2020,160065,41,3,27,8,19
2020,160065,42,0,8,3,5
2020,160065,42,1,2,1,1
2020,160065,42,3,4,1,3
2020,160065,42,4,2,1,1
2020,160065,44,0,61,22,39
2020,160065,44,1,16,7,9
2020,160065,44,2,18,7,11
2020,160065,44,3,27,8,19
2020,160074,0,0,89,26,63
2020,160074,10,0,89,26,63
2020,160074,10,1,5,3,2
2020,160074,10,2,23,10,13
2020,160074,10,3,48,10,38
2020,160074,10,4,13,3,10
2020,160074,40,0,89,26,63
2020,160074,40,1,5,3,2
2020,160074,40,2,23,10,13
2020,160074,40,3,48,10,38
2020,160074,40,4,13,3,10
2020,160074,42,0,89,26,63
2020,160074,42,1,5,3,2
2020,160074,42,2,23,10,13
2020,160074,42,3,48,10,38
2020,160074,42,4,13,3,10
2020,160409,0,0,19,17,2
2020,160409,10,0,17,15,2
2020,160409,10,1,17,15,2
2020,160409,40,0,17,15,2
2020,160409,40,1,17,15,2
2020,160409,42,0,17,15,2
2020,160409,42,1,17,15,2
2020,160409,50,0,2,2,0
2020,160481,0,0,60,24,36
2020,160481,10,0,60,24,36
2020,160481,10,1,1,0,1
2020,160481,10,2,2,0,2
2020,160481,10,3,10,3,7
2020,160481,10,4,46,21,25
2020,160481,10,5,1,0,1
2020,160481,20,0,2,2,0
2020,160481,20,4,2,2,0
2020,160481,40,0,58,22,36
2020,160481,40,1,1,0,1
2020,160481,40,2,2,0,2
2020,160481,40,3,10,3,7
2020,160481,40,4,44,19,25
2020,160481,40,5,1,0,1
2020,160481,41,0,1,0,1
2020,160481,41,4,1,0,1
2020,160481,42,0,57,22,35
2020,160481,42,1,1,0,1
2020,160481,42,2,2,0,2
2020,160481,42,3,10,3,7
2020,160481,42,4,43,19,24
2020,160481,42,5,1,0,1
2020,160481,44,0,1,0,1
2020,160481,44,4,1,0,1
2020,160524,0,0,7,1,6
2020,160524,50,0,7,1,6
2020,160579,0,0,90,43,47
2020,160579,10,0,90,43,47
2020,160579,10,1,5,2,3
2020,160579,10,2,3,1,2
2020,160579,10,3,14,4,10
2020,160579,10,4,64,34,30
2020,160579,10,6,4,2,2
2020,160579,20,0,4,2,2
2020,160579,20,1,1,0,1
2020,160579,20,4,3,2,1
2020,160579,40,0,86,41,45
2020,160579,40,1,4,2,2
2020,160579,40,2,3,1,2
2020,160579,40,3,14,4,10
2020,160579,40,4,61,32,29
2020,160579,40,6,4,2,2
2020,160579,42,0,65,34,31
2020,160579,42,1,4,2,2
2020,160579,42,2,3,1,2
2020,160579,42,3,13,4,9
2020,160579,42,4,43,25,18
2020,160579,42,6,2,2,0
2020,160579,43,0,21,7,14
2020,160579,43,3,1,0,1
2020,160579,43,4,18,7,11
2020,160579,43,6,2,0,2
2020,160612,0,0,513,226,287
2020,160612,10,0,513,226,287
2020,160612,10,1,101,71,30
2020,160612,10,2,90,46,44
2020,160612,10,3,73,32,41
2020,160612,10,4,249,77,172
2020,160612,20,0,193,117,76
2020,160612,20,1,101,71,30
2020,160612,20,2,87,44,43
2020,160612,20,3,5,2,3
2020,160612,30,0,71,32,39
2020,160612,30,2,3,2,1
2020,160612,30,3,68,30,38
2020,160612,40,0,249,77,172
2020,160612,40,4,249,77,172
2020,160612,42,0,245,76,169
2020,160612,42,4,245,76,169
2020,160612,43,0,4,1,3
2020,160612,43,4,4,1,3
2020,160621,0,0,308,146,162
2020,160621,10,0,223,112,111
2020,160621,10,1,70,48,22
2020,160621,10,2,51,27,24
2020,160621,10,3,97,36,61
2020,160621,10,4,3,1,2
2020,160621,10,5,2,0,2
2020,160621,20,0,93,62,31
2020,160621,20,1,64,46,18
2020,160621,20,2,22,14,8
2020,160621,20,3,6,2,4
2020,160621,20,4,1,0,1
2020,160621,30,0,82,31,51
2020,160621,30,1,4,2,2
2020,160621,30,2,16,5,11
2020,160621,30,3,61,24,37
2020,160621,30,5,1,0,1
2020,160621,40,0,48,19,29
2020,160621,40,1,2,0,2
2020,160621,40,2,13,8,5
2020,160621,40,3,30,10,20
2020,160621,40,4,2,1,1
2020,160621,40,5,1,0,1
2020,160621,42,0,42,16,26
2020,160621,42,1,2,0,2
2020,160621,42,2,10,6,4
2020,160621,42,3,27,9,18
2020,160621,42,4,2,1,1
2020,160621,42,5,1,0,1
2020,160621,43,0,6,3,3
2020,160621,43,2,3,2,1
2020,160621,43,3,3,1,2
2020,160621,50,0,85,34,51
2020,160630,0,0,78,47,31
2020,160630,10,0,78,47,31
2020,160630,10,1,15,10,5
2020,160630,10,2,17,13,4
2020,160630,10,3,46,24,22
2020,160630,20,0,40,29,11
2020,160630,20,1,15,10,5
2020,160630,20,2,17,13,4
2020,160630,20,3,8,6,2
2020,160630,30,0,38,18,20
2020,160630,30,3,38,18,20
2020,160649,0,0,79,27,52
2020,160649,10,0,74,24,50
2020,160649,10,1,4,2,2
2020,160649,10,2,16,4,12
2020,160649,10,3,21,6,15
2020,160649,10,4,33,12,21
2020,160649,20,0,14,6,8
2020,160649,20,1,4,2,2
2020,160649,20,2,9,4,5
2020,160649,20,3,1,0,1
2020,160649,30,0,29,8,21
2020,160649,30,2,4,0,4
2020,160649,30,3,8,2,6
2020,160649,30,4,17,6,11
2020,160649,40,0,31,10,21
2020,160649,40,2,3,0,3
2020,160649,40,3,12,4,8
2020,160649,40,4,16,6,10
2020,160649,42,0,5,1,4
2020,160649,42,2,1,0,1
2020,160649,42,3,1,0,1
2020,160649,42,4,3,1,2
2020,160649,43,0,26,9,17
2020,160649,43,2,2,0,2
2020,160649,43,3,11,4,7
2020,160649,43,4,13,5,8
2020,160649,50,0,5,3,2
2020,160658,0,0,646,354,292
2020,160658,10,0,646,354,292
2020,160658,10,1,145,109,36
2020,160658,10,2,119,66,53
2020,160658,10,3,148,83,65
2020,160658,10,4,158,62,96
2020,160658,10,5,1,1,0
2020,160658,10,6,75,33,42
2020,160658,20,0,269,180,89
2020,160658,20,1,144,108,36
2020,160658,20,2,109,61,48
2020,160658,20,3,13,8,5
2020,160658,20,6,3,3,0
2020,160658,30,0,123,72,51
2020,160658,30,1,1,1,0
2020,160658,30,2,10,5,5
2020,160658,30,3,111,66,45
2020,160658,30,4,1,0,1
2020,160658,40,0,254,102,152
2020,160658,40,3,24,9,15
2020,160658,40,4,157,62,95
2020,160658,40,5,1,1,0
2020,160658,40,6,72,30,42
2020,160658,41,0,254,102,152
2020,160658,41,3,24,9,15
2020,160658,41,4,157,62,95
2020,160658,41,5,1,1,0
2020,160658,41,6,72,30,42
2020,160658,44,0,254,102,152
2020,160658,44,3,24,9,15
2020,160658,44,4,157,62,95
2020,160658,44,5,1,1,0
2020,160658,44,6,72,30,42
2020,160667,0,0,100,42,58
2020,160667,10,0,100,42,58
2020,160667,10,2,4,1,3
2020,160667,10,3,8,1,7
2020,160667,10,4,88,40,48
2020,160667,40,0,100,42,58
2020,160667,40,2,4,1,3
2020,160667,40,3,8,1,7
2020,160667,40,4,88,40,48
2020,160667,42,0,100,42,58
2020,160667,42,2,4,1,3
2020,160667,42,3,8,1,7
2020,160667,42,4,88,40,48
2020,160755,0,0,1440,788,652
2020,160755,10,0,1440,788,652
2020,160755,10,1,326,248,78
2020,160755,10,2,306,168,138
2020,160755,10,3,501,252,249
2020,160755,10,4,83,25,58
2020,160755,10,5,224,95,129
2020,160755,20,0,481,329,152
2020,160755,20,1,277,211,66
2020,160755,20,2,204,118,86
2020,160755,30,0,181,100,81
2020,160755,30,1,7,5,2
2020,160755,30,2,11,6,5
2020,160755,30,3,163,89,74
2020,160755,40,0,778,359,419
2020,160755,40,1,42,32,10
2020,160755,40,2,91,44,47
2020,160755,40,3,338,163,175
2020,160755,40,4,83,25,58
2020,160755,40,5,224,95,129
2020,160755,42,0,778,359,419
2020,160755,42,1,42,32,10
2020,160755,42,2,91,44,47
2020,160755,42,3,338,163,175
2020,160755,42,4,83,25,58
2020,160755,42,5,224,95,129
2020,160904,0,0,236,127,109
2020,160904,10,0,236,127,109
2020,160904,10,1,50,30,20
2020,160904,10,2,74,42,32
2020,160904,10,3,100,50,50
2020,160904,10,4,7,3,4
2020,160904,10,5,5,2,3
2020,160904,20,0,123,76,47
2020,160904,20,1,43,26,17
2020,160904,20,2,61,37,24
2020,160904,20,3,19,13,6
2020,160904,30,0,45,24,21
2020,160904,30,1,1,0,1
2020,160904,30,2,5,3,2
2020,160904,30,3,39,21,18
2020,160904,40,0,68,27,41
2020,160904,40,1,6,4,2
2020,160904,40,2,8,2,6
2020,160904,40,3,42,16,26
2020,160904,40,4,7,3,4
2020,160904,40,5,5,2,3
2020,160904,42,0,68,27,41
2020,160904,42,1,6,4,2
2020,160904,42,2,8,2,6
2020,160904,42,3,42,16,26
2020,160904,42,4,7,3,4
2020,160904,42,5,5,2,3
2020,160959,0,0,27,15,12
2020,160959,10,0,27,15,12
2020,160959,10,1,27,15,12
2020,160959,40,0,27,15,12
2020,160959,40,1,27,15,12
2020,160959,41,0,27,15,12
2020,160959,41,1,27,15,12
2020,160959,44,0,27,15,12
2020,160959,44,1,27,15,12
2020,160977,0,0,178,86,92
2020,160977,10,0,178,86,92
2020,160977,10,1,51,23,28
2020,160977,10,2,45,22,23
2020,160977,10,3,62,29,33
2020,160977,10,4,5,2,3
2020,160977,10,5,15,10,5
2020,160977,20,0,91,43,48
2020,160977,20,1,49,21,28
2020,160977,20,2,42,22,20
2020,160977,30,0,44,21,23
2020,160977,30,2,1,0,1
2020,160977,30,3,41,19,22
2020,160977,30,5,2,2,0
2020,160977,40,0,43,22,21
2020,160977,40,1,2,2,0
2020,160977,40,2,2,0,2
2020,160977,40,3,21,10,11
2020,160977,40,4,5,2,3
2020,160977,40,5,13,8,5
2020,160977,41,0,22,10,12
2020,160977,41,1,1,1,0
2020,160977,41,2,1,0,1
2020,160977,41,3,8,2,6
2020,160977,41,4,3,1,2
2020,160977,41,5,9,6,3
2020,160977,42,0,21,12,9
2020,160977,42,1,1,1,0
2020,160977,42,2,1,0,1
2020,160977,42,3,13,8,5
2020,160977,42,4,2,1,1
2020,160977,42,5,4,2,2
2020,160977,44,0,22,10,12
2020,160977,44,1,1,1,0
2020,160977,44,2,1,0,1
2020,160977,44,3,8,2,6
2020,160977,44,4,3,1,2
2020,160977,44,5,9,6,3
2020,160995,0,0,13,5,8
2020,160995,50,0,13,5,8
2020,161004,0,0,220,99,121
2020,161004,10,0,220,99,121
2020,161004,10,1,70,35,35
2020,161004,10,2,53,21,32
2020,161004,10,3,72,30,42
2020,161004,10,5,25,13,12
2020,161004,20,0,123,56,67
2020,161004,20,1,70,35,35
2020,161004,20,2,53,21,32
2020,161004,30,0,49,20,29
2020,161004,30,3,49,20,29
2020,161004,40,0,48,23,25
2020,161004,40,3,23,10,13
2020,161004,40,5,25,13,12
2020,161004,41,0,30,16,14
2020,161004,41,3,8,4,4
2020,161004,41,5,22,12,10
2020,161004,42,0,17,7,10
2020,161004,42,3,15,6,9
2020,161004,42,5,2,1,1
2020,161004,43,0,1,0,1
2020,161004,43,5,1,0,1
2020,161004,44,0,30,16,14
2020,161004,44,3,8,4,4
2020,161004,44,5,22,12,10
2020,161022,0,0,12,0,12
2020,161022,10,0,12,0,12
2020,161022,10,4,12,0,12
2020,161022,40,0,12,0,12
2020,161022,40,4,12,0,12
2020,161022,42,0,3,0,3
2020,161022,42,4,3,0,3
2020,161022,43,0,9,0,9
2020,161022,43,4,9,0,9
2020,161077,0,0,52,32,20
2020,161077,10,0,52,32,20
2020,161077,10,4,52,32,20
2020,161077,40,0,52,32,20
2020,161077,40,4,52,32,20
2020,161077,42,0,52,32,20
2020,161077,42,4,52,32,20
2020,161086,0,0,232,111,121
2020,161086,10,0,232,111,121
2020,161086,10,1,65,40,25
2020,161086,10,2,63,31,32
2020,161086,10,3,67,24,43
2020,161086,10,4,37,16,21
2020,161086,20,0,120,66,54
2020,161086,20,1,62,38,24
2020,161086,20,2,58,28,30
2020,161086,30,0,59,23,36
2020,161086,30,3,59,23,36
2020,161086,40,0,53,22,31
2020,161086,40,1,3,2,1
2020,161086,40,2,5,3,2
2020,161086,40,3,8,1,7
2020,161086,40,4,37,16,21
2020,161086,41,0,38,15,23
2020,161086,41,1,3,2,1
2020,161086,41,2,5,3,2
2020,161086,41,3,8,1,7
2020,161086,41,4,22,9,13
2020,161086,42,0,15,7,8
2020,161086,42,4,15,7,8
2020,161086,44,0,36,15,21
2020,161086,44,1,3,2,1
2020,161086,44,2,5,3,2
2020,161086,44,3,6,1,5
2020,161086,44,4,22,9,13
2020,161086,45,0,2,0,2
2020,161086,45,3,2,0,2
2020,161138,0,0,56,29,27
2020,161138,10,0,56,29,27
2020,161138,10,4,56,29,27
2020,161138,40,0,56,29,27
2020,161138,40,4,56,29,27
2020,161138,42,0,56,29,27
2020,161138,42,4,56,29,27
2020,161192,0,0,42,17,25
2020,161192,10,0,42,17,25
2020,161192,10,4,42,17,25
2020,161192,40,0,42,17,25
2020,161192,40,4,42,17,25
2020,161192,42,0,42,17,25
2020,161192,42,4,42,17,25
2020,161208,0,0,7,7,0
2020,161208,10,0,7,7,0
2020,161208,10,4,7,7,0
2020,161208,40,0,7,7,0
2020,161208,40,4,7,7,0
2020,161208,42,0,7,7,0
2020,161208,42,4,7,7,0
2020,161217,0,0,93,37,56
2020,161217,10,0,93,37,56
2020,161217,10,1,26,15,11
2020,161217,10,2,22,8,14
2020,161217,10,3,28,10,18
2020,161217,10,4,1,0,1
2020,161217,10,5,16,4,12
2020,161217,20,0,50,23,27
2020,161217,20,1,26,15,11
2020,161217,20,2,22,8,14
2020,161217,20,3,2,0,2
2020,161217,30,0,25,10,15
2020,161217,30,3,25,10,15
2020,161217,40,0,18,4,14
2020,161217,40,3,1,0,1
2020,161217,40,4,1,0,1
2020,161217,40,5,16,4,12
2020,161217,41,0,6,1,5
2020,161217,41,4,1,0,1
2020,161217,41,5,5,1,4
2020,161217,42,0,12,3,9
2020,161217,42,3,1,0,1
2020,161217,42,5,11,3,8
2020,161217,44,0,6,1,5
2020,161217,44,4,1,0,1
2020,161217,44,5,5,1,4
2020,161226,0,0,118,48,70
2020,161226,10,0,118,48,70
2020,161226,10,1,37,21,16
2020,161226,10,2,39,15,24
2020,161226,10,3,31,12,19
2020,161226,10,4,1,0,1
2020,161226,10,5,10,0,10
2020,161226,20,0,76,37,39
2020,161226,20,1,37,21,16
2020,161226,20,2,38,15,23
2020,161226,20,3,1,1,0
2020,161226,30,0,25,8,17
2020,161226,30,2,1,0,1
2020,161226,30,3,24,8,16
2020,161226,40,0,17,3,14
2020,161226,40,3,6,3,3
2020,161226,40,4,1,0,1
2020,161226,40,5,10,0,10
2020,161226,41,0,10,1,9
2020,161226,41,3,1,1,0
2020,161226,41,4,1,0,1
2020,161226,41,5,8,0,8
2020,161226,42,0,5,1,4
2020,161226,42,3,3,1,2
2020,161226,42,5,2,0,2
2020,161226,43,0,2,1,1
2020,161226,43,3,2,1,1
2020,161226,44,0,10,1,9
2020,161226,44,3,1,1,0
2020,161226,44,4,1,0,1
2020,161226,44,5,8,0,8
2020,161235,0,0,31,17,14
2020,161235,10,0,31,17,14
2020,161235,10,1,7,4,3
2020,161235,10,2,5,4,1
2020,161235,10,3,15,7,8
2020,161235,10,5,4,2,2
2020,161235,20,0,12,8,4
2020,161235,20,1,7,4,3
2020,161235,20,2,5,4,1
2020,161235,30,0,10,5,5
2020,161235,30,3,10,5,5
2020,161235,40,0,9,4,5
2020,161235,40,3,5,2,3
2020,161235,40,5,4,2,2
2020,161235,41,0,3,3,0
2020,161235,41,3,1,1,0
2020,161235,41,5,2,2,0
2020,161235,42,0,6,1,5
2020,161235,42,3,4,1,3
2020,161235,42,5,2,0,2
2020,161235,44,0,3,3,0
2020,161235,44,3,1,1,0
2020,161235,44,5,2,2,0
2020,161244,0,0,25,13,12
2020,161244,10,0,25,13,12
2020,161244,10,1,10,6,4
2020,161244,10,2,8,4,4
2020,161244,10,3,5,1,4
2020,161244,10,4,1,1,0
2020,161244,10,5,1,1,0
2020,161244,20,0,19,10,9
2020,161244,20,1,10,6,4
2020,161244,20,2,8,4,4
2020,161244,20,3,1,0,1
2020,161244,30,0,3,2,1
2020,161244,30,3,2,1,1
2020,161244,30,4,1,1,0
2020,161244,40,0,3,1,2
2020,161244,40,3,2,0,2
2020,161244,40,5,1,1,0
2020,161244,42,0,3,1,2
2020,161244,42,3,2,0,2
2020,161244,42,5,1,1,0
2020,161253,0,0,516,302,214
2020,161253,10,0,516,302,214
2020,161253,10,1,178,124,54
2020,161253,10,2,129,79,50
2020,161253,10,3,130,67,63
2020,161253,10,4,4,1,3
2020,161253,10,5,75,31,44
2020,161253,20,0,298,198,100
2020,161253,20,1,175,122,53
2020,161253,20,2,121,74,47
2020,161253,20,3,1,1,0
2020,161253,20,5,1,1,0
2020,161253,30,0,118,56,62
2020,161253,30,2,8,5,3
2020,161253,30,3,110,51,59
2020,161253,40,0,100,48,52
2020,161253,40,1,3,2,1
2020,161253,40,3,19,15,4
2020,161253,40,4,4,1,3
2020,161253,40,5,74,30,44
2020,161253,41,0,51,21,30
2020,161253,41,1,3,2,1
2020,161253,41,3,7,5,2
2020,161253,41,4,4,1,3
2020,161253,41,5,37,13,24
2020,161253,42,0,49,27,22
2020,161253,42,3,12,10,2
2020,161253,42,5,37,17,20
2020,161253,44,0,48,19,29
2020,161253,44,1,2,1,1
2020,161253,44,3,6,4,2
2020,161253,44,4,4,1,3
2020,161253,44,5,36,13,23
2020,161253,45,0,3,2,1
2020,161253,45,1,1,1,0
2020,161253,45,3,1,1,0
2020,161253,45,5,1,0,1
2020,161299,0,0,84,65,19
2020,161299,10,0,84,65,19
2020,161299,10,1,27,19,8
2020,161299,10,2,18,16,2
2020,161299,10,3,30,22,8
2020,161299,10,4,8,7,1
2020,161299,10,5,1,1,0
2020,161299,40,0,84,65,19
2020,161299,40,1,27,19,8
2020,161299,40,2,18,16,2
2020,161299,40,3,30,22,8
2020,161299,40,4,8,7,1
2020,161299,40,5,1,1,0
2020,161299,41,0,83,65,18
2020,161299,41,1,26,19,7
2020,161299,41,2,18,16,2
2020,161299,41,3,30,22,8
2020,161299,41,4,8,7,1
2020,161299,41,5,1,1,0
2020,161299,43,0,1,0,1
2020,161299,43,1,1,0,1
2020,161299,45,0,83,65,18
2020,161299,45,1,26,19,7
2020,161299,45,2,18,16,2
2020,161299,45,3,30,22,8
2020,161299,45,4,8,7,1
2020,161299,45,5,1,1,0
2020,161341,0,0,33,18,15
2020,161341,10,0,33,18,15
2020,161341,10,1,12,8,4
2020,161341,10,2,14,9,5
2020,161341,10,3,6,1,5
2020,161341,10,4,1,0,1
2020,161341,20,0,24,15,9
2020,161341,20,1,12,8,4
2020,161341,20,2,12,7,5
2020,161341,30,0,8,3,5
2020,161341,30,2,2,2,0
2020,161341,30,3,5,1,4
2020,161341,30,4,1,0,1
2020,161341,40,0,1,0,1
2020,161341,40,3,1,0,1
2020,161341,42,0,1,0,1
2020,161341,42,3,1,0,1
2020,161457,0,0,295,126,169
2020,161457,10,0,295,126,169
2020,161457,10,1,59,37,22
2020,161457,10,2,106,46,60
2020,161457,10,3,75,18,57
2020,161457,10,4,2,1,1
2020,161457,10,5,53,24,29
2020,161457,20,0,100,54,46
2020,161457,20,1,46,31,15
2020,161457,20,2,54,23,31
2020,161457,30,0,22,9,13
2020,161457,30,1,1,1,0
2020,161457,30,2,8,5,3
2020,161457,30,3,13,3,10
2020,161457,40,0,173,63,110
2020,161457,40,1,12,5,7
2020,161457,40,2,44,18,26
2020,161457,40,3,62,15,47
2020,161457,40,4,2,1,1
2020,161457,40,5,53,24,29
2020,161457,42,0,173,63,110
2020,161457,42,1,12,5,7
2020,161457,42,2,44,18,26
2020,161457,42,3,62,15,47
2020,161457,42,4,2,1,1
2020,161457,42,5,53,24,29
2020,161484,0,0,38,21,17
2020,161484,10,0,37,20,17
2020,161484,10,4,37,20,17
2020,161484,40,0,37,20,17
2020,161484,40,4,37,20,17
2020,161484,42,0,37,20,17
2020,161484,42,4,37,20,17
2020,161484,50,0,1,1,0
2020,161509,0,0,27,15,12
2020,161509,10,0,27,15,12
2020,161509,10,1,10,3,7
2020,161509,10,2,3,3,0
2020,161509,10,3,14,9,5
2020,161509,40,0,27,15,12
2020,161509,40,1,10,3,7
2020,161509,40,2,3,3,0
2020,161509,40,3,14,9,5
2020,161509,41,0,22,12,10
2020,161509,41,1,10,3,7
2020,161509,41,2,3,3,0
2020,161509,41,3,9,6,3
2020,161509,42,0,5,3,2
2020,161509,42,3,5,3,2
2020,161509,44,0,22,12,10
2020,161509,44,1,10,3,7
2020,161509,44,2,3,3,0
2020,161509,44,3,9,6,3
2020,161518,0,0,72,33,39
2020,161518,10,0,72,33,39
2020,161518,10,1,9,5,4
2020,161518,10,2,23,13,10
2020,161518,10,3,35,14,21
2020,161518,10,4,5,1,4
2020,161518,20,0,25,16,9
2020,161518,20,1,8,4,4
2020,161518,20,2,15,11,4
2020,161518,20,3,2,1,1
2020,161518,30,0,24,12,12
2020,161518,30,1,1,1,0
2020,161518,30,2,5,2,3
2020,161518,30,3,18,9,9
2020,161518,40,0,23,5,18
2020,161518,40,2,3,0,3
2020,161518,40,3,15,4,11
2020,161518,40,4,5,1,4
2020,161518,42,0,10,1,9
2020,161518,42,2,3,0,3
2020,161518,42,3,6,1,5
2020,161518,42,4,1,0,1
2020,161518,43,0,13,4,9
2020,161518,43,3,9,3,6
2020,161518,43,4,4,1,3
2020,161545,0,0,98,49,49
2020,161545,10,0,98,49,49
2020,161545,10,1,37,22,15
2020,161545,10,2,27,16,11
2020,161545,10,3,16,7,9
2020,161545,10,4,18,4,14
2020,161545,40,0,98,49,49
2020,161545,40,1,37,22,15
2020,161545,40,2,27,16,11
2020,161545,40,3,16,7,9
2020,161545,40,4,18,4,14
2020,161545,42,0,98,49,49
2020,161545,42,1,37,22,15
2020,161545,42,2,27,16,11
2020,161545,42,3,16,7,9
2020,161545,42,4,18,4,14
2020,161554,0,0,289,133,156
2020,161554,10,0,289,133,156
2020,161554,10,1,82,50,32
2020,161554,10,2,66,30,36
2020,161554,10,3,93,38,55
2020,161554,10,4,1,0,1
2020,161554,10,5,47,15,32
2020,161554,20,0,143,77,66
2020,161554,20,1,76,48,28
2020,161554,20,2,63,28,35
2020,161554,20,3,4,1,3
2020,161554,30,0,87,36,51
2020,161554,30,1,1,1,0
2020,161554,30,2,1,1,0
2020,161554,30,3,84,34,50
2020,161554,30,5,1,0,1
2020,161554,40,0,59,20,39
2020,161554,40,1,5,1,4
2020,161554,40,2,2,1,1
2020,161554,40,3,5,3,2
2020,161554,40,4,1,0,1
2020,161554,40,5,46,15,31
2020,161554,41,0,22,8,14
2020,161554,41,1,5,1,4
2020,161554,41,2,2,1,1
2020,161554,41,3,4,2,2
2020,161554,41,4,1,0,1
2020,161554,41,5,10,4,6
2020,161554,42,0,37,12,25
2020,161554,42,3,1,1,0
2020,161554,42,5,36,11,25
2020,161554,44,0,21,7,14
2020,161554,44,1,5,1,4
2020,161554,44,2,1,0,1
2020,161554,44,3,4,2,2
2020,161554,44,4,1,0,1
2020,161554,44,5,10,4,6
2020,161554,45,0,1,1,0
2020,161554,45,2,1,1,0
2020,161563,0,0,35,23,12
2020,161563,10,0,35,23,12
2020,161563,10,1,13,10,3
2020,161563,10,2,10,6,4
2020,161563,10,3,11,6,5
2020,161563,10,4,1,1,0
2020,161563,40,0,35,23,12
2020,161563,40,1,13,10,3
2020,161563,40,2,10,6,4
2020,161563,40,3,11,6,5
2020,161563,40,4,1,1,0
2020,161563,41,0,30,21,9
2020,161563,41,1,13,10,3
2020,161563,41,2,8,5,3
2020,161563,41,3,8,5,3
2020,161563,41,4,1,1,0
2020,161563,42,0,5,2,3
2020,161563,42,2,2,1,1
2020,161563,42,3,3,1,2
2020,161563,44,0,30,21,9
2020,161563,44,1,13,10,3
2020,161563,44,2,8,5,3
2020,161563,44,3,8,5,3
2020,161563,44,4,1,1,0
2020,161572,0,0,47,23,24
2020,161572,10,0,47,23,24
2020,161572,10,1,11,5,6
2020,161572,10,2,11,7,4
2020,161572,10,3,9,4,5
2020,161572,10,4,16,7,9
2020,161572,40,0,47,23,24
2020,161572,40,1,11,5,6
2020,161572,40,2,11,7,4
2020,161572,40,3,9,4,5
2020,161572,40,4,16,7,9
2020,161572,41,0,41,21,20
2020,161572,41,1,10,5,5
2020,161572,41,2,11,7,4
2020,161572,41,3,9,4,5
2020,161572,41,4,11,5,6
2020,161572,43,0,6,2,4
2020,161572,43,1,1,0,1
2020,161572,43,4,5,2,3
2020,161572,44,0,20,11,9
2020,161572,44,1,7,3,4
2020,161572,44,2,6,4,2
2020,161572,44,3,2,1,1
2020,161572,44,4,5,3,2
2020,161572,45,0,21,10,11
2020,161572,45,1,3,2,1
2020,161572,45,2,5,3,2
2020,161572,45,3,7,3,4
2020,161572,45,4,6,2,4
2020,161581,0,0,22,14,8
2020,161581,10,0,22,14,8
2020,161581,10,4,22,14,8
2020,161581,40,0,22,14,8
2020,161581,40,4,22,14,8
2020,161581,42,0,22,14,8
2020,161581,42,4,22,14,8
2020,161688,0,0,93,33,60
2020,161688,10,0,93,33,60
2020,161688,10,1,22,7,15
2020,161688,10,2,31,11,20
2020,161688,10,3,26,10,16
2020,161688,10,4,14,5,9
2020,161688,20,0,57,23,34
2020,161688,20,1,22,7,15
2020,161688,20,2,21,8,13
2020,161688,20,3,11,5,6
2020,161688,20,4,3,3,0
2020,161688,30,0,34,9,25
2020,161688,30,2,10,3,7
2020,161688,30,3,15,5,10
2020,161688,30,4,9,1,8
2020,161688,40,0,2,1,1
2020,161688,40,4,2,1,1
2020,161688,42,0,2,1,1
2020,161688,42,4,2,1,1
2020,161767,0,0,250,92,158
2020,161767,10,0,250,92,158
2020,161767,10,1,66,28,38
2020,161767,10,2,83,31,52
2020,161767,10,3,72,23,49
2020,161767,10,4,13,5,8
2020,161767,10,6,16,5,11
2020,161767,20,0,116,38,78
2020,161767,20,1,59,25,34
2020,161767,20,2,46,12,34
2020,161767,20,3,9,1,8
2020,161767,20,4,2,0,2
2020,161767,30,0,14,6,8
2020,161767,30,1,3,2,1
2020,161767,30,2,6,2,4
2020,161767,30,3,4,1,3
2020,161767,30,4,1,1,0
2020,161767,40,0,120,48,72
2020,161767,40,1,4,1,3
2020,161767,40,2,31,17,14
2020,161767,40,3,59,21,38
2020,161767,40,4,10,4,6
2020,161767,40,6,16,5,11
2020,161767,41,0,50,24,26
2020,161767,41,1,2,0,2
2020,161767,41,2,28,15,13
2020,161767,41,3,17,7,10
2020,161767,41,4,3,2,1
2020,161767,43,0,70,24,46
2020,161767,43,1,2,1,1
2020,161767,43,2,3,2,1
2020,161767,43,3,42,14,28
2020,161767,43,4,7,2,5
2020,161767,43,6,16,5,11
2020,161767,44,0,50,24,26
2020,161767,44,1,2,0,2
2020,161767,44,2,28,15,13
2020,161767,44,3,17,7,10
2020,161767,44,4,3,2,1
2020,161864,0,0,96,41,55
2020,161864,10,0,96,41,55
2020,161864,10,1,23,10,13
2020,161864,10,2,25,13,12
2020,161864,10,3,48,18,30
2020,161864,40,0,96,41,55
2020,161864,40,1,23,10,13
2020,161864,40,2,25,13,12
2020,161864,40,3,48,18,30
2020,161864,43,0,96,41,55
2020,161864,43,1,23,10,13
2020,161864,43,2,25,13,12
2020,161864,43,3,48,18,30
2020,161873,0,0,180,92,88
2020,161873,10,0,180,92,88
2020,161873,10,1,41,27,14
2020,161873,10,2,59,29,30
2020,161873,10,3,45,21,24
2020,161873,10,5,35,15,20
2020,161873,20,0,99,55,44
2020,161873,20,1,40,27,13
2020,161873,20,2,58,28,30
2020,161873,20,3,1,0,1
2020,161873,30,0,46,22,24
2020,161873,30,1,1,0,1
2020,161873,30,2,1,1,0
2020,161873,30,3,44,21,23
2020,161873,40,0,35,15,20
2020,161873,40,5,35,15,20
2020,161873,41,0,21,7,14
2020,161873,41,5,21,7,14
2020,161873,42,0,14,8,6
2020,161873,42,5,14,8,6
2020,161873,44,0,21,7,14
2020,161873,44,5,21,7,14
2020,162007,0,0,227,100,127
2020,162007,10,0,227,100,127
2020,162007,10,1,43,28,15
2020,162007,10,2,58,25,33
2020,162007,10,3,86,31,55
2020,162007,10,4,9,1,8
2020,162007,10,5,31,15,16
2020,162007,20,0,83,51,32
2020,162007,20,1,39,27,12
2020,162007,20,2,29,12,17
2020,162007,20,3,15,12,3
2020,162007,30,0,31,8,23
2020,162007,30,1,1,0,1
2020,162007,30,2,15,7,8
2020,162007,30,3,14,1,13
2020,162007,30,4,1,0,1
2020,162007,40,0,113,41,72
2020,162007,40,1,3,1,2
2020,162007,40,2,14,6,8
2020,162007,40,3,57,18,39
2020,162007,40,4,8,1,7
2020,162007,40,5,31,15,16
2020,162007,41,0,86,28,58
2020,162007,41,1,3,1,2
2020,162007,41,2,14,6,8
2020,162007,41,3,57,18,39
2020,162007,41,4,8,1,7
2020,162007,41,5,4,2,2
2020,162007,42,0,27,13,14
2020,162007,42,5,27,13,14
2020,162007,44,0,86,28,58
2020,162007,44,1,3,1,2
2020,162007,44,2,14,6,8
2020,162007,44,3,57,18,39
2020,162007,44,4,8,1,7
2020,162007,44,5,4,2,2
2020,162061,0,0,6,4,2
2020,162061,10,0,6,4,2
2020,162061,10,1,4,2,2
2020,162061,10,2,1,1,0
2020,162061,10,3,1,1,0
2020,162061,40,0,6,4,2
2020,162061,40,1,4,2,2
2020,162061,40,2,1,1,0
2020,162061,40,3,1,1,0
2020,162061,41,0,6,4,2
2020,162061,41,1,4,2,2
2020,162061,41,2,1,1,0
2020,162061,41,3,1,1,0
2020,162061,44,0,6,4,2
2020,162061,44,1,4,2,2
2020,162061,44,2,1,1,0
2020,162061,44,3,1,1,0
2020,162104,0,0,54,22,32
2020,162104,10,0,54,22,32
2020,162104,10,1,16,3,13
2020,162104,10,2,13,7,6
2020,162104,10,3,21,8,13
2020,162104,10,4,4,4,0
2020,162104,40,0,54,22,32
2020,162104,40,1,16,3,13
2020,162104,40,2,13,7,6
2020,162104,40,3,21,8,13
2020,162104,40,4,4,4,0
2020,162104,42,0,4,0,4
2020,162104,42,1,1,0,1
2020,162104,42,3,3,0,3
2020,162104,43,0,50,22,28
2020,162104,43,1,15,3,12
2020,162104,43,2,13,7,6
2020,162104,43,3,18,8,10
2020,162104,43,4,4,4,0
2020,162122,0,0,121,48,73
2020,162122,10,0,121,48,73
2020,162122,10,1,72,26,46
2020,162122,10,2,15,7,8
2020,162122,10,3,27,10,17
2020,162122,10,4,7,5,2
2020,162122,20,0,54,21,33
2020,162122,20,1,53,21,32
2020,162122,20,2,1,0,1
2020,162122,30,0,4,0,4
2020,162122,30,1,3,0,3
2020,162122,30,3,1,0,1
2020,162122,40,0,63,27,36
2020,162122,40,1,16,5,11
2020,162122,40,2,14,7,7
2020,162122,40,3,26,10,16
2020,162122,40,4,7,5,2
2020,162122,42,0,63,27,36
2020,162122,42,1,16,5,11
2020,162122,42,2,14,7,7
2020,162122,42,3,26,10,16
2020,162122,42,4,7,5,2
2020,162168,0,0,51,15,36
2020,162168,10,0,51,15,36
2020,162168,10,1,12,3,9
2020,162168,10,2,13,7,6
2020,162168,10,3,13,3,10
2020,162168,10,4,13,2,11
2020,162168,40,0,51,15,36
2020,162168,40,1,12,3,9
2020,162168,40,2,13,7,6
2020,162168,40,3,13,3,10
2020,162168,40,4,13,2,11
2020,162168,41,0,24,9,15
2020,162168,41,1,8,2,6
2020,162168,41,2,6,4,2
2020,162168,41,3,7,1,6
2020,162168,41,4,3,2,1
2020,162168,42,0,8,3,5
2020,162168,42,2,3,2,1
2020,162168,42,3,1,1,0
2020,162168,42,4,4,0,4
2020,162168,43,0,19,3,16
2020,162168,43,1,4,1,3
2020,162168,43,2,4,1,3
2020,162168,43,3,5,1,4
2020,162168,43,4,6,0,6
2020,162168,44,0,24,9,15
2020,162168,44,1,8,2,6
2020,162168,44,2,6,4,2
2020,162168,44,3,7,1,6
2020,162168,44,4,3,2,1
2020,162210,0,0,32,18,14
2020,162210,10,0,32,18,14
2020,162210,10,1,11,6,5
2020,162210,10,2,12,6,6
2020,162210,10,3,9,6,3
2020,162210,40,0,32,18,14
2020,162210,40,1,11,6,5
2020,162210,40,2,12,6,6
2020,162210,40,3,9,6,3
2020,162210,42,0,32,18,14
2020,162210,42,1,11,6,5
2020,162210,42,2,12,6,6
2020,162210,42,3,9,6,3
2020,162283,0,0,123,56,67
2020,162283,10,0,123,56,67
2020,162283,10,1,24,12,12
2020,162283,10,2,36,19,17
2020,162283,10,3,56,22,34
2020,162283,10,4,7,3,4
2020,162283,20,0,84,41,43
2020,162283,20,1,23,12,11
2020,162283,20,2,34,18,16
2020,162283,20,3,27,11,16
2020,162283,30,0,31,11,20
2020,162283,30,1,1,0,1
2020,162283,30,2,2,1,1
2020,162283,30,3,28,10,18
2020,162283,40,0,8,4,4
2020,162283,40,3,1,1,0
2020,162283,40,4,7,3,4
2020,162283,42,0,8,4,4
2020,162283,42,3,1,1,0
2020,162283,42,4,7,3,4
2020,162557,0,0,101,37,64
2020,162557,10,0,101,37,64
2020,162557,10,1,30,16,14
2020,162557,10,2,29,9,20
2020,162557,10,3,42,12,30
2020,162557,40,0,101,37,64
2020,162557,40,1,30,16,14
2020,162557,40,2,29,9,20
2020,162557,40,3,42,12,30
2020,162557,43,0,101,37,64
2020,162557,43,1,30,16,14
2020,162557,43,2,29,9,20
2020,162557,43,3,42,12,30
2020,162584,0,0,239,130,109
2020,162584,10,0,239,130,109
2020,162584,10,1,70,47,23
2020,162584,10,2,72,43,29
2020,162584,10,3,57,22,35
2020,162584,10,4,1,0,1
2020,162584,10,5,39,18,21
2020,162584,20,0,136,87,49
2020,162584,20,1,69,46,23
2020,162584,20,2,61,38,23
2020,162584,20,3,6,3,3
2020,162584,30,0,64,25,39
2020,162584,30,1,1,1,0
2020,162584,30,2,11,5,6
2020,162584,30,3,51,19,32
2020,162584,30,4,1,0,1
2020,162584,40,0,39,18,21
2020,162584,40,5,39,18,21
2020,162584,42,0,36,16,20
2020,162584,42,5,36,16,20
2020,162584,43,0,3,2,1
2020,162584,43,5,3,2,1
2020,162609,0,0,22,13,9
2020,162609,10,0,22,13,9
2020,162609,10,1,11,8,3
2020,162609,10,2,5,2,3
2020,162609,10,3,6,3,3
2020,162609,40,0,22,13,9
2020,162609,40,1,11,8,3
2020,162609,40,2,5,2,3
2020,162609,40,3,6,3,3
2020,162609,41,0,8,6,2
2020,162609,41,1,8,6,2
2020,162609,42,0,8,5,3
2020,162609,42,1,3,2,1
2020,162609,42,2,3,1,2
2020,162609,42,3,2,2,0
2020,162609,43,0,6,2,4
2020,162609,43,2,2,1,1
2020,162609,43,3,4,1,3
2020,162609,44,0,8,6,2
2020,162609,44,1,8,6,2
2020,162654,0,0,101,38,63
2020,162654,10,0,98,37,61
2020,162654,10,1,22,8,14
2020,162654,10,2,35,12,23
2020,162654,10,3,31,15,16
2020,162654,10,4,9,2,7
2020,162654,10,5,1,0,1
2020,162654,20,0,56,20,36
2020,162654,20,1,22,8,14
2020,162654,20,2,34,12,22
2020,162654,30,0,14,7,7
2020,162654,30,3,14,7,7
2020,162654,40,0,28,10,18
2020,162654,40,2,1,0,1
2020,162654,40,3,17,8,9
2020,162654,40,4,9,2,7
2020,162654,40,5,1,0,1
2020,162654,41,0,17,4,13
2020,162654,41,2,1,0,1
2020,162654,41,3,10,3,7
2020,162654,41,4,6,1,5
2020,162654,42,0,11,6,5
2020,162654,42,3,7,5,2
2020,162654,42,4,3,1,2
2020,162654,42,5,1,0,1
2020,162654,44,0,17,4,13
2020,162654,44,2,1,0,1
2020,162654,44,3,10,3,7
2020,162654,44,4,6,1,5
2020,162654,50,0,3,1,2
2020,162690,0,0,74,29,45
2020,162690,10,0,74,29,45
2020,162690,10,1,11,5,6
2020,162690,10,2,12,4,8
2020,162690,10,3,38,14,24
2020,162690,10,4,13,6,7
2020,162690,20,0,42,14,28
2020,162690,20,1,11,5,6
2020,162690,20,2,11,4,7
2020,162690,20,3,20,5,15
2020,162690,30,0,32,15,17
2020,162690,30,2,1,0,1
2020,162690,30,3,18,9,9
2020,162690,30,4,13,6,7
2020,162706,0,0,102,40,62
2020,162706,10,0,102,40,62
2020,162706,10,1,15,6,9
2020,162706,10,2,19,6,13
2020,162706,10,3,68,28,40
2020,162706,20,0,38,13,25
2020,162706,20,1,13,5,8
2020,162706,20,2,15,3,12
2020,162706,20,3,10,5,5
2020,162706,30,0,21,7,14
2020,162706,30,2,1,1,0
2020,162706,30,3,20,6,14
2020,162706,40,0,43,20,23
2020,162706,40,1,2,1,1
2020,162706,40,2,3,2,1
2020,162706,40,3,38,17,21
2020,162706,41,0,43,20,23
2020,162706,41,1,2,1,1
2020,162706,41,2,3,2,1
2020,162706,41,3,38,17,21
2020,162706,44,0,43,20,23
2020,162706,44,1,2,1,1
2020,162706,44,2,3,2,1
2020,162706,44,3,38,17,21
2020,162760,0,0,97,40,57
2020,162760,10,0,97,40,57
2020,162760,10,1,23,9,14
2020,162760,10,2,33,14,19
2020,162760,10,3,35,13,22
2020,162760,10,4,1,1,0
2020,162760,10,6,5,3,2
2020,162760,20,0,53,23,30
2020,162760,20,1,23,9,14
2020,162760,20,2,30,14,16
2020,162760,30,0,32,9,23
2020,162760,30,2,3,0,3
2020,162760,30,3,29,9,20
2020,162760,40,0,12,8,4
2020,162760,40,3,6,4,2
2020,162760,40,4,1,1,0
2020,162760,40,6,5,3,2
2020,162760,42,0,12,8,4
2020,162760,42,3,6,4,2
2020,162760,42,4,1,1,0
2020,162760,42,6,5,3,2
2020,162779,0,0,200,71,129
2020,162779,10,0,200,71,129
2020,162779,10,1,73,27,46
2020,162779,10,2,72,23,49
2020,162779,10,3,41,14,27
2020,162779,10,4,14,7,7
2020,162779,40,0,200,71,129
2020,162779,40,1,73,27,46
2020,162779,40,2,72,23,49
2020,162779,40,3,41,14,27
2020,162779,40,4,14,7,7
2020,162779,41,0,200,71,129
2020,162779,41,1,73,27,46
2020,162779,41,2,72,23,49
2020,162779,41,3,41,14,27
2020,162779,41,4,14,7,7
2020,162779,44,0,161,55,106
2020,162779,44,1,72,27,45
2020,162779,44,2,63,19,44
2020,162779,44,3,26,9,17
2020,162779,45,0,39,16,23
2020,162779,45,1,1,0,1
2020,162779,45,2,9,4,5
2020,162779,45,3,15,5,10
2020,162779,45,4,14,7,7
2020,162928,0,0,3856,2212,1644
2020,162928,10,0,3856,2212,1644
2020,162928,10,1,1141,838,303
2020,162928,10,2,825,483,342
2020,162928,10,3,1359,655,704
2020,162928,10,4,205,99,106
2020,162928,10,5,283,106,177
2020,162928,10,6,43,31,12
2020,162928,20,0,1161,844,317
2020,162928,20,1,1063,782,281
2020,162928,20,2,98,62,36
2020,162928,30,0,2001,1033,968
2020,162928,30,1,6,4,2
2020,162928,30,2,676,393,283
2020,162928,30,3,1319,636,683
2020,162928,40,0,694,335,359
2020,162928,40,1,72,52,20
2020,162928,40,2,51,28,23
2020,162928,40,3,40,19,21
2020,162928,40,4,205,99,106
2020,162928,40,5,283,106,177
2020,162928,40,6,43,31,12
2020,162928,41,0,248,140,108
2020,162928,41,1,50,35,15
2020,162928,41,2,35,19,16
2020,162928,41,3,33,17,16
2020,162928,41,4,9,6,3
2020,162928,41,5,104,48,56
2020,162928,41,6,17,15,2
2020,162928,42,0,423,181,242
2020,162928,42,1,15,12,3
2020,162928,42,2,11,7,4
2020,162928,42,3,5,1,4
2020,162928,42,4,194,92,102
2020,162928,42,5,179,58,121
2020,162928,42,6,19,11,8
2020,162928,43,0,23,14,9
2020,162928,43,1,7,5,2
2020,162928,43,2,5,2,3
2020,162928,43,3,2,1,1
2020,162928,43,4,2,1,1
2020,162928,43,6,7,5,2
2020,162928,44,0,248,140,108
2020,162928,44,1,50,35,15
2020,162928,44,2,35,19,16
2020,162928,44,3,33,17,16
2020,162928,44,4,9,6,3
2020,162928,44,5,104,48,56
2020,162928,44,6,17,15,2
2020,163028,0,0,32,28,4
2020,163028,10,0,32,28,4
2020,163028,10,4,32,28,4
2020,163028,40,0,32,28,4
2020,163028,40,4,32,28,4
2020,163028,41,0,32,28,4
2020,163028,41,4,32,28,4
2020,163028,45,0,32,28,4
2020,163028,45,4,32,28,4
2020,163046,0,0,325,153,172
2020,163046,10,0,325,153,172
2020,163046,10,1,63,46,17
2020,163046,10,2,114,48,66
2020,163046,10,3,32,14,18
2020,163046,10,4,31,9,22
2020,163046,10,5,85,36,49
2020,163046,20,0,178,95,83
2020,163046,20,1,62,45,17
2020,163046,20,2,114,48,66
2020,163046,20,3,2,2,0
2020,163046,30,0,23,11,12
2020,163046,30,1,1,1,0
2020,163046,30,3,22,10,12
2020,163046,40,0,124,47,77
2020,163046,40,3,8,2,6
2020,163046,40,4,31,9,22
2020,163046,40,5,85,36,49
2020,163046,42,0,124,47,77
2020,163046,42,3,8,2,6
2020,163046,42,4,31,9,22
2020,163046,42,5,85,36,49
2020,163204,0,0,203,108,95
2020,163204,10,0,203,108,95
2020,163204,10,1,122,63,59
2020,163204,10,2,68,36,32
2020,163204,10,3,13,9,4
2020,163204,40,0,203,108,95
2020,163204,40,1,122,63,59
2020,163204,40,2,68,36,32
2020,163204,40,3,13,9,4
2020,163204,42,0,203,108,95
2020,163204,42,1,122,63,59
2020,163204,42,2,68,36,32
2020,163204,42,3,13,9,4
2020,163259,0,0,1852,974,878
2020,163259,10,0,1852,974,878
2020,163259,10,1,410,296,114
2020,163259,10,2,352,194,158
2020,163259,10,3,902,420,482
2020,163259,10,4,165,53,112
2020,163259,10,5,4,0,4
2020,163259,10,6,19,11,8
2020,163259,20,0,355,240,115
2020,163259,20,1,276,199,77
2020,163259,20,2,74,39,35
2020,163259,20,3,4,2,2
2020,163259,20,6,1,0,1
2020,163259,30,0,101,59,42
2020,163259,30,1,6,6,0
2020,163259,30,2,33,20,13
2020,163259,30,3,62,33,29
2020,163259,40,0,1396,675,721
2020,163259,40,1,128,91,37
2020,163259,40,2,245,135,110
2020,163259,40,3,836,385,451
2020,163259,40,4,165,53,112
2020,163259,40,5,4,0,4
2020,163259,40,6,18,11,7
2020,163259,42,0,1396,675,721
2020,163259,42,1,128,91,37
2020,163259,42,2,245,135,110
2020,163259,42,3,836,385,451
2020,163259,42,4,165,53,112
2020,163259,42,5,4,0,4
2020,163259,42,6,18,11,7
2020,163268,0,0,564,295,269
2020,163268,10,0,564,295,269
2020,163268,10,1,160,112,48
2020,163268,10,2,157,75,82
2020,163268,10,3,117,53,64
2020,163268,10,4,7,1,6
2020,163268,10,5,123,54,69
2020,163268,20,0,289,173,116
2020,163268,20,1,142,100,42
2020,163268,20,2,146,72,74
2020,163268,20,3,1,1,0
2020,163268,30,0,114,53,61
2020,163268,30,1,1,1,0
2020,163268,30,2,5,2,3
2020,163268,30,3,108,50,58
2020,163268,40,0,161,69,92
2020,163268,40,1,17,11,6
2020,163268,40,2,6,1,5
2020,163268,40,3,8,2,6
2020,163268,40,4,7,1,6
2020,163268,40,5,123,54,69
2020,163268,42,0,161,69,92
2020,163268,42,1,17,11,6
2020,163268,42,2,6,1,5
2020,163268,42,3,8,2,6
2020,163268,42,4,7,1,6
2020,163268,42,5,123,54,69
2020,163286,0,0,1849,1100,749
2020,163286,10,0,1849,1100,749
2020,163286,10,1,707,525,182
2020,163286,10,2,462,248,214
2020,163286,10,3,302,140,162
2020,163286,10,4,5,2,3
2020,163286,10,5,373,185,188
2020,163286,20,0,1102,745,357
2020,163286,20,1,678,506,172
2020,163286,20,2,424,239,185
2020,163286,30,0,252,133,119
2020,163286,30,2,1,1,0
2020,163286,30,3,251,132,119
2020,163286,40,0,495,222,273
2020,163286,40,1,29,19,10
2020,163286,40,2,37,8,29
2020,163286,40,3,51,8,43
2020,163286,40,4,5,2,3
2020,163286,40,5,373,185,188
2020,163286,42,0,495,222,273
2020,163286,42,1,29,19,10
2020,163286,42,2,37,8,29
2020,163286,42,3,51,8,43
2020,163286,42,4,5,2,3
2020,163286,42,5,373,185,188
2020,163295,0,0,148,66,82
2020,163295,10,0,148,66,82
2020,163295,10,1,148,66,82
2020,163295,40,0,148,66,82
2020,163295,40,1,148,66,82
2020,163295,41,0,141,62,79
2020,163295,41,1,141,62,79
2020,163295,42,0,7,4,3
2020,163295,42,1,7,4,3
2020,163295,44,0,141,62,79
2020,163295,44,1,141,62,79
2020,163338,0,0,211,121,90
2020,163338,10,0,211,121,90
2020,163338,10,1,48,29,19
2020,163338,10,2,75,49,26
2020,163338,10,3,51,27,24
2020,163338,10,4,1,1,0
2020,163338,10,5,36,15,21
2020,163338,20,0,114,73,41
2020,163338,20,1,47,29,18
2020,163338,20,2,64,42,22
2020,163338,20,3,3,2,1
2020,163338,30,0,44,25,19
2020,163338,30,2,8,5,3
2020,163338,30,3,36,20,16
2020,163338,40,0,53,23,30
2020,163338,40,1,1,0,1
2020,163338,40,2,3,2,1
2020,163338,40,3,12,5,7
2020,163338,40,4,1,1,0
2020,163338,40,5,36,15,21
2020,163338,42,0,22,7,15
2020,163338,42,1,1,0,1
2020,163338,42,2,2,1,1
2020,163338,42,3,9,3,6
2020,163338,42,4,1,1,0
2020,163338,42,5,9,2,7
2020,163338,43,0,31,16,15
2020,163338,43,2,1,1,0
2020,163338,43,3,3,2,1
2020,163338,43,5,27,13,14
2020,163426,0,0,473,185,288
2020,163426,10,0,473,185,288
2020,163426,10,1,346,155,191
2020,163426,10,2,86,22,64
2020,163426,10,3,36,6,30
2020,163426,10,4,1,0,1
2020,163426,10,5,1,0,1
2020,163426,10,6,3,2,1
2020,163426,40,0,473,185,288
2020,163426,40,1,346,155,191
2020,163426,40,2,86,22,64
2020,163426,40,3,36,6,30
2020,163426,40,4,1,0,1
2020,163426,40,5,1,0,1
2020,163426,40,6,3,2,1
2020,163426,42,0,472,185,287
2020,163426,42,1,346,155,191
2020,163426,42,2,86,22,64
2020,163426,42,3,36,6,30
2020,163426,42,4,1,0,1
2020,163426,42,6,3,2,1
2020,163426,43,0,1,0,1
2020,163426,43,5,1,0,1
2020,163453,0,0,428,234,194
2020,163453,10,0,428,234,194
2020,163453,10,1,75,56,19
2020,163453,10,2,169,90,79
2020,163453,10,3,79,38,41
2020,163453,10,4,2,1,1
2020,163453,10,5,103,49,54
2020,163453,20,0,237,141,96
2020,163453,20,1,74,55,19
2020,163453,20,2,156,81,75
2020,163453,20,3,6,4,2
2020,163453,20,4,1,1,0
2020,163453,30,0,86,43,43
2020,163453,30,2,13,9,4
2020,163453,30,3,73,34,39
2020,163453,40,0,105,50,55
2020,163453,40,1,1,1,0
2020,163453,40,4,1,0,1
2020,163453,40,5,103,49,54
2020,163453,41,0,29,12,17
2020,163453,41,1,1,1,0
2020,163453,41,4,1,0,1
2020,163453,41,5,27,11,16
2020,163453,42,0,76,38,38
2020,163453,42,5,76,38,38
2020,163453,44,0,29,12,17
2020,163453,44,1,1,1,0
2020,163453,44,4,1,0,1
2020,163453,44,5,27,11,16
2020,163462,0,0,128,78,50
2020,163462,10,0,128,78,50
2020,163462,10,1,27,13,14
2020,163462,10,2,48,36,12
2020,163462,10,3,31,19,12
2020,163462,10,5,21,10,11
2020,163462,10,6,1,0,1
2020,163462,20,0,67,41,26
2020,163462,20,1,25,11,14
2020,163462,20,2,42,30,12
2020,163462,30,0,22,14,8
2020,163462,30,3,22,14,8
2020,163462,40,0,39,23,16
2020,163462,40,1,2,2,0
2020,163462,40,2,6,6,0
2020,163462,40,3,9,5,4
2020,163462,40,5,21,10,11
2020,163462,40,6,1,0,1
2020,163462,41,0,16,11,5
2020,163462,41,1,1,1,0
2020,163462,41,2,5,5,0
2020,163462,41,3,7,3,4
2020,163462,41,5,3,2,1
2020,163462,42,0,23,12,11
2020,163462,42,1,1,1,0
2020,163462,42,2,1,1,0
2020,163462,42,3,2,2,0
2020,163462,42,5,18,8,10
2020,163462,42,6,1,0,1
2020,163462,44,0,16,11,5
2020,163462,44,1,1,1,0
2020,163462,44,2,5,5,0
2020,163462,44,3,7,3,4
2020,163462,44,5,3,2,1
2020,163532,0,0,13,13,0
2020,163532,10,0,13,13,0
2020,163532,10,1,13,13,0
2020,163532,20,0,13,13,0
2020,163532,20,1,13,13,0
2020,163578,0,0,99,27,72
2020,163578,10,0,99,27,72
2020,163578,10,1,13,7,6
2020,163578,10,2,30,9,21
2020,163578,10,3,56,11,45
2020,163578,20,0,36,13,23
2020,163578,20,1,13,7,6
2020,163578,20,2,16,4,12
2020,163578,20,3,7,2,5
2020,163578,30,0,56,13,43
2020,163578,30,2,14,5,9
2020,163578,30,3,42,8,34
2020,163578,40,0,7,1,6
2020,163578,40,3,7,1,6
2020,163578,42,0,7,1,6
2020,163578,42,3,7,1,6
2020,163657,0,0,230,87,143
2020,163657,10,0,230,87,143
2020,163657,10,1,82,31,51
2020,163657,10,2,118,39,79
2020,163657,10,3,29,16,13
2020,163657,10,4,1,1,0
2020,163657,20,0,83,28,55
2020,163657,20,1,55,19,36
2020,163657,20,2,27,9,18
2020,163657,20,3,1,0,1
2020,163657,30,0,115,45,70
2020,163657,30,1,22,10,12
2020,163657,30,2,72,23,49
2020,163657,30,3,21,12,9
2020,163657,40,0,32,14,18
2020,163657,40,1,5,2,3
2020,163657,40,2,19,7,12
2020,163657,40,3,7,4,3
2020,163657,40,4,1,1,0
2020,163657,42,0,32,14,18
2020,163657,42,1,5,2,3
2020,163657,42,2,19,7,12
2020,163657,42,3,7,4,3
2020,163657,42,4,1,1,0
2020,163851,0,0,439,212,227
2020,163851,10,0,439,212,227
2020,163851,10,1,114,75,39
2020,163851,10,2,122,62,60
2020,163851,10,3,108,55,53
2020,163851,10,4,5,0,5
2020,163851,10,5,90,20,70
2020,163851,20,0,245,142,103
2020,163851,20,1,114,75,39
2020,163851,20,2,121,62,59
2020,163851,20,3,10,5,5
2020,163851,30,0,104,50,54
2020,163851,30,2,1,0,1
2020,163851,30,3,98,50,48
2020,163851,30,4,5,0,5
2020,163851,40,0,90,20,70
2020,163851,40,5,90,20,70
2020,163851,41,0,40,9,31
2020,163851,41,5,40,9,31
2020,163851,43,0,50,11,39
2020,163851,43,5,50,11,39
2020,163851,44,0,39,9,30
2020,163851,44,5,39,9,30
2020,163851,45,0,1,0,1
2020,163851,45,5,1,0,1
2020,163912,0,0,131,66,65
2020,163912,10,0,131,66,65
2020,163912,10,1,50,27,23
2020,163912,10,2,34,20,14
2020,163912,10,3,44,18,26
2020,163912,10,4,1,0,1
2020,163912,10,5,2,1,1
2020,163912,20,0,82,45,37
2020,163912,20,1,50,27,23
2020,163912,20,2,32,18,14
2020,163912,30,0,31,10,21
2020,163912,30,3,31,10,21
2020,163912,40,0,18,11,7
2020,163912,40,2,2,2,0
2020,163912,40,3,13,8,5
2020,163912,40,4,1,0,1
2020,163912,40,5,2,1,1
2020,163912,41,0,18,11,7
2020,163912,41,2,2,2,0
2020,163912,41,3,13,8,5
2020,163912,41,4,1,0,1
2020,163912,41,5,2,1,1
2020,163912,44,0,18,11,7
2020,163912,44,2,2,2,0
2020,163912,44,3,13,8,5
2020,163912,44,4,1,0,1
2020,163912,44,5,2,1,1
2020,163976,0,0,63,48,15
2020,163976,10,0,60,45,15
2020,163976,10,1,60,45,15
2020,163976,20,0,40,30,10
2020,163976,20,1,40,30,10
2020,163976,30,0,10,6,4
2020,163976,30,1,10,6,4
2020,163976,40,0,10,9,1
2020,163976,40,1,10,9,1
2020,163976,42,0,10,9,1
2020,163976,42,1,10,9,1
2020,163976,50,0,3,3,0
2020,164076,0,0,930,390,540
2020,164076,10,0,930,390,540
2020,164076,10,1,249,130,119
2020,164076,10,2,219,101,118
2020,164076,10,3,217,68,149
2020,164076,10,4,14,2,12
2020,164076,10,5,231,89,142
2020,164076,20,0,445,231,214
2020,164076,20,1,242,129,113
2020,164076,20,2,200,100,100
2020,164076,20,3,3,2,1
2020,164076,30,0,172,56,116
2020,164076,30,1,1,0,1
2020,164076,30,3,169,55,114
2020,164076,30,4,2,1,1
2020,164076,40,0,313,103,210
2020,164076,40,1,6,1,5
2020,164076,40,2,19,1,18
2020,164076,40,3,45,11,34
2020,164076,40,4,12,1,11
2020,164076,40,5,231,89,142
2020,164076,42,0,303,95,208
2020,164076,42,1,6,1,5
2020,164076,42,2,19,1,18
2020,164076,42,3,45,11,34
2020,164076,42,4,12,1,11
2020,164076,42,5,221,81,140
2020,164076,43,0,10,8,2
2020,164076,43,5,10,8,2
2020,164085,0,0,10,2,8
2020,164085,10,0,10,2,8
2020,164085,10,1,2,0,2
2020,164085,10,2,3,1,2
2020,164085,10,3,2,0,2
2020,164085,10,4,3,1,2
2020,164085,40,0,10,2,8
2020,164085,40,1,2,0,2
2020,164085,40,2,3,1,2
2020,164085,40,3,2,0,2
2020,164085,40,4,3,1,2
2020,164085,41,0,7,1,6
2020,164085,41,1,2,0,2
2020,164085,41,2,3,1,2
2020,164085,41,3,2,0,2
2020,164085,42,0,3,1,2
2020,164085,42,4,3,1,2
2020,164085,44,0,7,1,6
2020,164085,44,1,2,0,2
2020,164085,44,2,3,1,2
2020,164085,44,3,2,0,2
2020,164155,0,0,331,233,98
2020,164155,10,0,331,233,98
2020,164155,10,1,123,88,35
2020,164155,10,2,102,76,26
2020,164155,10,3,68,37,31
2020,164155,10,4,21,16,5
2020,164155,10,6,17,16,1
2020,164155,20,0,229,166,63
2020,164155,20,1,122,87,35
2020,164155,20,2,102,76,26
2020,164155,20,4,5,3,2
2020,164155,30,0,68,37,31
2020,164155,30,3,68,37,31
2020,164155,40,0,34,30,4
2020,164155,40,1,1,1,0
2020,164155,40,4,16,13,3
2020,164155,40,6,17,16,1
2020,164155,41,0,34,30,4
2020,164155,41,1,1,1,0
2020,164155,41,4,16,13,3
2020,164155,41,6,17,16,1
2020,164155,44,0,34,30,4
2020,164155,44,1,1,1,0
2020,164155,44,4,16,13,3
2020,164155,44,6,17,16,1
2020,164173,0,0,117,48,69
2020,164173,10,0,117,48,69
2020,164173,10,1,49,21,28
2020,164173,10,2,24,12,12
2020,164173,10,3,25,11,14
2020,164173,10,4,2,1,1
2020,164173,10,5,17,3,14
2020,164173,40,0,117,48,69
2020,164173,40,1,49,21,28
2020,164173,40,2,24,12,12
2020,164173,40,3,25,11,14
2020,164173,40,4,2,1,1
2020,164173,40,5,17,3,14
2020,164173,41,0,100,44,56
2020,164173,41,1,47,20,27
2020,164173,41,2,23,11,12
2020,164173,41,3,18,10,8
2020,164173,41,4,2,1,1
2020,164173,41,5,10,2,8
2020,164173,42,0,17,4,13
2020,164173,42,1,2,1,1
2020,164173,42,2,1,1,0
2020,164173,42,3,7,1,6
2020,164173,42,5,7,1,6
2020,164173,44,0,100,44,56
2020,164173,44,1,47,20,27
2020,164173,44,2,23,11,12
2020,164173,44,3,18,10,8
2020,164173,44,4,2,1,1
2020,164173,44,5,10,2,8
2020,164216,0,0,104,47,57
2020,164216,10,0,104,47,57
2020,164216,10,1,13,5,8
2020,164216,10,2,46,21,25
2020,164216,10,3,35,15,20
2020,164216,10,4,10,6,4
2020,164216,20,0,60,26,34
2020,164216,20,1,13,5,8
2020,164216,20,2,46,21,25
2020,164216,20,3,1,0,1
2020,164216,30,0,33,14,19
2020,164216,30,3,33,14,19
2020,164216,40,0,11,7,4
2020,164216,40,3,1,1,0
2020,164216,40,4,10,6,4
2020,164216,41,0,5,2,3
2020,164216,41,3,1,1,0
2020,164216,41,4,4,1,3
2020,164216,42,0,4,3,1
2020,164216,42,4,4,3,1
2020,164216,43,0,2,2,0
2020,164216,43,4,2,2,0
2020,164216,44,0,5,2,3
2020,164216,44,3,1,1,0
2020,164216,44,4,4,1,3
2020,164270,0,0,124,58,66
2020,164270,10,0,124,58,66
2020,164270,10,1,29,17,12
2020,164270,10,2,41,21,20
2020,164270,10,3,20,7,13
2020,164270,10,4,2,1,1
2020,164270,10,5,32,12,20
2020,164270,20,0,70,38,32
2020,164270,20,1,29,17,12
2020,164270,20,2,41,21,20
2020,164270,30,0,19,6,13
2020,164270,30,3,19,6,13
2020,164270,40,0,35,14,21
2020,164270,40,3,1,1,0
2020,164270,40,4,2,1,1
2020,164270,40,5,32,12,20
2020,164270,41,0,10,5,5
2020,164270,41,5,10,5,5
2020,164270,42,0,25,9,16
2020,164270,42,3,1,1,0
2020,164270,42,4,2,1,1
2020,164270,42,5,22,7,15
2020,164270,44,0,10,5,5
2020,164270,44,5,10,5,5
2020,164313,0,0,68,24,44
2020,164313,10,0,68,24,44
2020,164313,10,1,13,3,10
2020,164313,10,2,12,5,7
2020,164313,10,3,30,10,20
2020,164313,10,4,13,6,7
2020,164313,40,0,68,24,44
2020,164313,40,1,13,3,10
2020,164313,40,2,12,5,7
2020,164313,40,3,30,10,20
2020,164313,40,4,13,6,7
2020,164313,41,0,51,16,35
2020,164313,41,1,13,3,10
2020,164313,41,2,11,4,7
2020,164313,41,3,23,7,16
2020,164313,41,4,4,2,2
2020,164313,42,0,17,8,9
2020,164313,42,2,1,1,0
2020,164313,42,3,7,3,4
2020,164313,42,4,9,4,5
2020,164313,44,0,51,16,35
2020,164313,44,1,13,3,10
2020,164313,44,2,11,4,7
2020,164313,44,3,23,7,16
2020,164313,44,4,4,2,2
2020,164368,0,0,31,22,9
2020,164368,10,0,31,22,9
2020,164368,10,1,31,22,9
2020,164368,40,0,31,22,9
2020,164368,40,1,31,22,9
2020,164368,41,0,28,20,8
2020,164368,41,1,28,20,8
2020,164368,42,0,3,2,1
2020,164368,42,1,3,2,1
2020,164368,44,0,28,20,8
2020,164368,44,1,28,20,8
2020,164447,0,0,57,21,36
2020,164447,10,0,57,21,36
2020,164447,10,1,13,4,9
2020,164447,10,2,27,13,14
2020,164447,10,3,14,3,11
2020,164447,10,4,3,1,2
2020,164447,20,0,37,17,20
2020,164447,20,1,13,4,9
2020,164447,20,2,24,13,11
2020,164447,30,0,9,2,7
2020,164447,30,2,3,0,3
2020,164447,30,3,6,2,4
2020,164447,40,0,11,2,9
2020,164447,40,3,8,1,7
2020,164447,40,4,3,1,2
2020,164447,42,0,11,2,9
2020,164447,42,3,8,1,7
2020,164447,42,4,3,1,2
2020,164465,0,0,262,129,133
2020,164465,10,0,262,129,133
2020,164465,10,1,100,57,43
2020,164465,10,2,38,19,19
2020,164465,10,3,85,40,45
2020,164465,10,4,2,0,2
2020,164465,10,5,37,13,24
2020,164465,20,0,130,74,56
2020,164465,20,1,95,56,39
2020,164465,20,2,35,18,17
2020,164465,30,0,66,31,35
2020,164465,30,3,66,31,35
2020,164465,40,0,66,24,42
2020,164465,40,1,5,1,4
2020,164465,40,2,3,1,2
2020,164465,40,3,19,9,10
2020,164465,40,4,2,0,2
2020,164465,40,5,37,13,24
2020,164465,41,0,48,19,29
2020,164465,41,1,4,1,3
2020,164465,41,2,2,1,1
2020,164465,41,3,12,6,6
2020,164465,41,5,30,11,19
2020,164465,42,0,16,4,12
2020,164465,42,1,1,0,1
2020,164465,42,2,1,0,1
2020,164465,42,3,7,3,4
2020,164465,42,4,2,0,2
2020,164465,42,5,5,1,4
2020,164465,43,0,2,1,1
2020,164465,43,5,2,1,1
2020,164465,44,0,48,19,29
2020,164465,44,1,4,1,3
2020,164465,44,2,2,1,1
2020,164465,44,3,12,6,6
2020,164465,44,5,30,11,19
2020,164492,0,0,42,16,26
2020,164492,10,0,42,16,26
2020,164492,10,1,3,1,2
2020,164492,10,2,8,4,4
2020,164492,10,3,28,9,19
2020,164492,10,4,3,2,1
2020,164492,20,0,12,5,7
2020,164492,20,1,3,1,2
2020,164492,20,2,8,4,4
2020,164492,20,3,1,0,1
2020,164492,30,0,7,4,3
2020,164492,30,3,7,4,3
2020,164492,40,0,23,7,16
2020,164492,40,3,20,5,15
2020,164492,40,4,3,2,1
2020,164492,41,0,7,1,6
2020,164492,41,3,5,0,5
2020,164492,41,4,2,1,1
2020,164492,42,0,16,6,10
2020,164492,42,3,15,5,10
2020,164492,42,4,1,1,0
2020,164492,44,0,7,1,6
2020,164492,44,3,5,0,5
2020,164492,44,4,2,1,1
2020,164562,0,0,142,72,70
2020,164562,10,0,142,72,70
2020,164562,10,1,27,18,9
2020,164562,10,2,44,20,24
2020,164562,10,3,39,22,17
2020,164562,10,4,8,3,5
2020,164562,10,6,24,9,15
2020,164562,20,0,78,42,36
2020,164562,20,1,27,18,9
2020,164562,20,2,44,20,24
2020,164562,20,3,7,4,3
2020,164562,30,0,28,16,12
2020,164562,30,3,28,16,12
2020,164562,40,0,36,14,22
2020,164562,40,3,4,2,2
2020,164562,40,4,8,3,5
2020,164562,40,6,24,9,15
2020,164562,41,0,24,9,15
2020,164562,41,6,24,9,15
2020,164562,42,0,12,5,7
2020,164562,42,3,4,2,2
2020,164562,42,4,8,3,5
2020,164562,44,0,24,9,15
2020,164562,44,6,24,9,15
2020,164580,0,0,187,112,75
2020,164580,10,0,187,112,75
2020,164580,10,1,60,38,22
2020,164580,10,2,52,32,20
2020,164580,10,3,24,10,14
2020,164580,10,4,2,2,0
2020,164580,10,5,49,30,19
2020,164580,20,0,111,70,41
2020,164580,20,1,60,38,22
2020,164580,20,2,51,32,19
2020,164580,30,0,25,10,15
2020,164580,30,2,1,0,1
2020,164580,30,3,24,10,14
2020,164580,40,0,51,32,19
2020,164580,40,4,2,2,0
2020,164580,40,5,49,30,19
2020,164580,41,0,31,17,14
2020,164580,41,5,31,17,14
2020,164580,42,0,20,15,5
2020,164580,42,4,2,2,0
2020,164580,42,5,18,13,5
2020,164580,44,0,31,17,14
2020,164580,44,5,31,17,14
2020,164632,0,0,80,14,66
2020,164632,10,0,80,14,66
2020,164632,10,1,17,5,12
2020,164632,10,2,24,4,20
2020,164632,10,3,34,4,30
2020,164632,10,4,5,1,4
2020,164632,40,0,80,14,66
2020,164632,40,1,17,5,12
2020,164632,40,2,24,4,20
2020,164632,40,3,34,4,30
2020,164632,40,4,5,1,4
2020,164632,41,0,59,12,47
2020,164632,41,1,12,4,8
2020,164632,41,2,20,4,16
2020,164632,41,3,22,3,19
2020,164632,41,4,5,1,4
2020,164632,42,0,21,2,19
2020,164632,42,1,5,1,4
2020,164632,42,2,4,0,4
2020,164632,42,3,12,1,11
2020,164632,44,0,59,12,47
2020,164632,44,1,12,4,8
2020,164632,44,2,20,4,16
2020,164632,44,3,22,3,19
2020,164632,44,4,5,1,4
2020,164641,0,0,16,6,10
2020,164641,10,0,16,6,10
2020,164641,10,3,16,6,10
2020,164641,40,0,16,6,10
2020,164641,40,3,16,6,10
2020,164641,43,0,16,6,10
2020,164641,43,3,16,6,10
2020,164720,0,0,45,20,25
2020,164720,10,0,45,20,25
2020,164720,10,1,16,6,10
2020,164720,10,2,12,6,6
2020,164720,10,3,7,5,2
2020,164720,10,4,10,3,7
2020,164720,40,0,45,20,25
2020,164720,40,1,16,6,10
2020,164720,40,2,12,6,6
2020,164720,40,3,7,5,2
2020,164720,40,4,10,3,7
2020,164720,41,0,42,17,25
2020,164720,41,1,15,5,10
2020,164720,41,2,12,6,6
2020,164720,41,3,6,4,2
2020,164720,41,4,9,2,7
2020,164720,42,0,3,3,0
2020,164720,42,1,1,1,0
2020,164720,42,3,1,1,0
2020,164720,42,4,1,1,0
2020,164720,44,0,42,17,25
2020,164720,44,1,15,5,10
2020,164720,44,2,12,6,6
2020,164720,44,3,6,4,2
2020,164720,44,4,9,2,7
2020,164739,0,0,283,159,124
2020,164739,10,0,283,159,124
2020,164739,10,1,91,51,40
2020,164739,10,2,53,31,22
2020,164739,10,3,55,27,28
2020,164739,10,5,84,50,34
2020,164739,20,0,139,79,60
2020,164739,20,1,91,51,40
2020,164739,20,2,48,28,20
2020,164739,30,0,60,30,30
2020,164739,30,2,5,3,2
2020,164739,30,3,55,27,28
2020,164739,40,0,84,50,34
2020,164739,40,5,84,50,34
2020,164739,42,0,84,50,34
2020,164739,42,5,84,50,34
2020,164748,0,0,324,214,110
2020,164748,10,0,324,214,110
2020,164748,10,1,184,126,58
2020,164748,10,2,98,62,36
2020,164748,10,3,42,26,16
2020,164748,40,0,324,214,110
2020,164748,40,1,184,126,58
2020,164748,40,2,98,62,36
2020,164748,40,3,42,26,16
2020,164748,41,0,324,214,110
2020,164748,41,1,184,126,58
2020,164748,41,2,98,62,36
2020,164748,41,3,42,26,16
2020,164748,44,0,324,214,110
2020,164748,44,1,184,126,58
2020,164748,44,2,98,62,36
2020,164748,44,3,42,26,16
2020,164775,0,0,61,18,43
2020,164775,10,0,61,18,43
2020,164775,10,1,33,14,19
2020,164775,10,2,13,2,11
2020,164775,10,3,15,2,13
2020,164775,20,0,41,16,25
2020,164775,20,1,33,14,19
2020,164775,20,2,7,2,5
2020,164775,20,3,1,0,1
2020,164775,30,0,20,2,18
2020,164775,30,2,6,0,6
2020,164775,30,3,14,2,12
2020,164872,0,0,25,16,9
2020,164872,10,0,15,10,5
2020,164872,10,4,15,10,5
2020,164872,40,0,15,10,5
2020,164872,40,4,15,10,5
2020,164872,42,0,15,10,5
2020,164872,42,4,15,10,5
2020,164872,50,0,10,6,4
2020,164924,0,0,882,503,379
2020,164924,10,0,882,503,379
2020,164924,10,1,294,197,97
2020,164924,10,2,297,154,143
2020,164924,10,3,205,109,96
2020,164924,10,4,63,30,33
2020,164924,10,5,23,13,10
2020,164924,20,0,482,294,188
2020,164924,20,1,269,180,89
2020,164924,20,2,213,114,99
2020,164924,30,0,140,78,62
2020,164924,30,2,3,2,1
2020,164924,30,3,137,76,61
2020,164924,40,0,260,131,129
2020,164924,40,1,25,17,8
2020,164924,40,2,81,38,43
2020,164924,40,3,68,33,35
2020,164924,40,4,63,30,33
2020,164924,40,5,23,13,10
2020,164924,41,0,257,129,128
2020,164924,41,1,24,16,8
2020,164924,41,2,81,38,43
2020,164924,41,3,68,33,35
2020,164924,41,4,61,29,32
2020,164924,41,5,23,13,10
2020,164924,42,0,3,2,1
2020,164924,42,1,1,1,0
2020,164924,42,4,2,1,1
2020,164924,44,0,257,129,128
2020,164924,44,1,24,16,8
2020,164924,44,2,81,38,43
2020,164924,44,3,68,33,35
2020,164924,44,4,61,29,32
2020,164924,44,5,23,13,10
2020,164988,0,0,3047,1511,1536
2020,164988,10,0,3032,1509,1523
2020,164988,10,1,627,452,175
2020,164988,10,2,529,301,228
2020,164988,10,3,803,344,459
2020,164988,10,4,268,60,208
2020,164988,10,5,372,172,200
2020,164988,10,6,433,180,253
2020,164988,20,0,695,478,217
2020,164988,20,1,418,317,101
2020,164988,20,2,277,161,116
2020,164988,30,0,204,111,93
2020,164988,30,2,6,4,2
2020,164988,30,3,198,107,91
2020,164988,40,0,2133,920,1213
2020,164988,40,1,209,135,74
2020,164988,40,2,246,136,110
2020,164988,40,3,605,237,368
2020,164988,40,4,268,60,208
2020,164988,40,5,372,172,200
2020,164988,40,6,433,180,253
2020,164988,41,0,1985,836,1149
2020,164988,41,1,199,127,72
2020,164988,41,2,226,123,103
2020,164988,41,3,563,213,350
2020,164988,41,4,255,54,201
2020,164988,41,5,347,154,193
2020,164988,41,6,395,165,230
2020,164988,42,0,145,81,64
2020,164988,42,1,10,8,2
2020,164988,42,2,20,13,7
2020,164988,42,3,42,24,18
2020,164988,42,4,13,6,7
2020,164988,42,5,24,17,7
2020,164988,42,6,36,13,23
2020,164988,43,0,3,3,0
2020,164988,43,5,1,1,0
2020,164988,43,6,2,2,0
2020,164988,44,0,942,442,500
2020,164988,44,1,93,60,33
2020,164988,44,2,113,60,53
2020,164988,44,3,130,63,67
2020,164988,44,4,7,2,5
2020,164988,44,5,347,154,193
2020,164988,44,6,252,103,149
2020,164988,45,0,1043,394,649
2020,164988,45,1,106,67,39
2020,164988,45,2,113,63,50
2020,164988,45,3,433,150,283
2020,164988,45,4,248,52,196
2020,164988,45,6,143,62,81
2020,164988,50,0,15,2,13
2020,165015,0,0,387,210,177
2020,165015,10,0,387,210,177
2020,165015,10,1,148,93,55
2020,165015,10,2,102,53,49
2020,165015,10,3,85,40,45
2020,165015,10,4,2,2,0
2020,165015,10,5,50,22,28
2020,165015,20,0,189,119,70
2020,165015,20,1,117,76,41
2020,165015,20,2,72,43,29
2020,165015,30,0,71,34,37
2020,165015,30,1,1,0,1
2020,165015,30,2,4,0,4
2020,165015,30,3,66,34,32
2020,165015,40,0,127,57,70
2020,165015,40,1,30,17,13
2020,165015,40,2,26,10,16
2020,165015,40,3,19,6,13
2020,165015,40,4,2,2,0
2020,165015,40,5,50,22,28
2020,165015,41,0,119,53,66
2020,165015,41,1,30,17,13
2020,165015,41,2,26,10,16
2020,165015,41,3,17,4,13
2020,165015,41,4,2,2,0
2020,165015,41,5,44,20,24
2020,165015,42,0,8,4,4
2020,165015,42,3,2,2,0
2020,165015,42,5,6,2,4
2020,165015,44,0,119,53,66
2020,165015,44,1,30,17,13
2020,165015,44,2,26,10,16
2020,165015,44,3,17,4,13
2020,165015,44,4,2,2,0
2020,165015,44,5,44,20,24
2020,165024,0,0,337,149,188
2020,165024,10,0,337,149,188
2020,165024,10,1,137,71,66
2020,165024,10,2,107,45,62
2020,165024,10,3,91,33,58
2020,165024,10,4,2,0,2
2020,165024,20,0,245,116,129
2020,165024,20,1,137,71,66
2020,165024,20,2,104,45,59
2020,165024,20,3,4,0,4
2020,165024,30,0,86,32,54
2020,165024,30,2,3,0,3
2020,165024,30,3,83,32,51
2020,165024,40,0,6,1,5
2020,165024,40,3,4,1,3
2020,165024,40,4,2,0,2
2020,165024,42,0,6,1,5
2020,165024,42,3,4,1,3
2020,165024,42,4,2,0,2
2020,165033,0,0,118,41,77
2020,165033,10,0,118,41,77
2020,165033,10,1,47,16,31
2020,165033,10,2,42,17,25
2020,165033,10,3,27,8,19
2020,165033,10,4,2,0,2
2020,165033,20,0,76,27,49
2020,165033,20,1,45,16,29
2020,165033,20,2,30,10,20
2020,165033,20,3,1,1,0
2020,165033,30,0,41,14,27
2020,165033,30,1,2,0,2
2020,165033,30,2,12,7,5
2020,165033,30,3,25,7,18
2020,165033,30,4,2,0,2
2020,165033,40,0,1,0,1
2020,165033,40,3,1,0,1
2020,165033,42,0,1,0,1
2020,165033,42,3,1,0,1
2020,165112,0,0,142,56,86
2020,165112,10,0,142,56,86
2020,165112,10,1,91,32,59
2020,165112,10,2,29,17,12
2020,165112,10,3,22,7,15
2020,165112,20,0,96,40,56
2020,165112,20,1,85,31,54
2020,165112,20,2,8,8,0
2020,165112,20,3,3,1,2
2020,165112,30,0,46,16,30
2020,165112,30,1,6,1,5
2020,165112,30,2,21,9,12
2020,165112,30,3,19,6,13
2020,165167,0,0,17,7,10
2020,165167,10,0,17,7,10
2020,165167,10,1,13,6,7
2020,165167,10,2,1,0,1
2020,165167,10,3,2,1,1
2020,165167,10,5,1,0,1
2020,165167,40,0,17,7,10
2020,165167,40,1,13,6,7
2020,165167,40,2,1,0,1
2020,165167,40,3,2,1,1
2020,165167,40,5,1,0,1
2020,165167,41,0,16,7,9
2020,165167,41,1,13,6,7
2020,165167,41,2,1,0,1
2020,165167,41,3,2,1,1
2020,165167,42,0,1,0,1
2020,165167,42,5,1,0,1
2020,165167,45,0,16,7,9
2020,165167,45,1,13,6,7
2020,165167,45,2,1,0,1
2020,165167,45,3,2,1,1
2020,165194,0,0,65,31,34
2020,165194,10,0,65,31,34
2020,165194,10,1,31,16,15
2020,165194,10,2,26,10,16
2020,165194,10,3,7,4,3
2020,165194,10,4,1,1,0
2020,165194,20,0,41,21,20
2020,165194,20,1,27,15,12
2020,165194,20,2,14,6,8
2020,165194,30,0,24,10,14
2020,165194,30,1,4,1,3
2020,165194,30,2,12,4,8
2020,165194,30,3,7,4,3
2020,165194,30,4,1,1,0
2020,165264,0,0,32,4,28
2020,165264,10,0,32,4,28
2020,165264,10,2,8,2,6
2020,165264,10,3,24,2,22
2020,165264,40,0,32,4,28
2020,165264,40,2,8,2,6
2020,165264,40,3,24,2,22
2020,165264,42,0,32,4,28
2020,165264,42,2,8,2,6
2020,165264,42,3,24,2,22
2020,165334,0,0,207,115,92
2020,165334,10,0,207,115,92
2020,165334,10,1,71,44,27
2020,165334,10,2,68,39,29
2020,165334,10,3,37,18,19
2020,165334,10,4,21,9,12
2020,165334,10,5,10,5,5
2020,165334,20,0,125,73,52
2020,165334,20,1,66,40,26
2020,165334,20,2,59,33,26
2020,165334,30,0,37,18,19
2020,165334,30,2,1,0,1
2020,165334,30,3,36,18,18
2020,165334,40,0,45,24,21
2020,165334,40,1,5,4,1
2020,165334,40,2,8,6,2
2020,165334,40,3,1,0,1
2020,165334,40,4,21,9,12
2020,165334,40,5,10,5,5
2020,165334,41,0,24,15,9
2020,165334,41,1,5,4,1
2020,165334,41,2,8,6,2
2020,165334,41,3,1,0,1
2020,165334,41,5,10,5,5
2020,165334,42,0,21,9,12
2020,165334,42,4,21,9,12
2020,165334,44,0,24,15,9
2020,165334,44,1,5,4,1
2020,165334,44,2,8,6,2
2020,165334,44,3,1,0,1
2020,165334,44,5,10,5,5
2020,165529,0,0,108,26,82
2020,165529,10,0,108,26,82
2020,165529,10,1,45,10,35
2020,165529,10,2,25,6,19
2020,165529,10,3,35,10,25
2020,165529,10,4,3,0,3
2020,165529,40,0,108,26,82
2020,165529,40,1,45,10,35
2020,165529,40,2,25,6,19
2020,165529,40,3,35,10,25
2020,165529,40,4,3,0,3
2020,165529,41,0,80,18,62
2020,165529,41,1,45,10,35
2020,165529,41,2,24,6,18
2020,165529,41,3,11,2,9
2020,165529,42,0,27,8,19
2020,165529,42,2,1,0,1
2020,165529,42,3,23,8,15
2020,165529,42,4,3,0,3
2020,165529,43,0,1,0,1
2020,165529,43,3,1,0,1
2020,165529,44,0,80,18,62
2020,165529,44,1,45,10,35
2020,165529,44,2,24,6,18
2020,165529,44,3,11,2,9
2020,165574,0,0,27,14,13
2020,165574,10,0,27,14,13
2020,165574,10,1,4,2,2
2020,165574,10,2,8,4,4
2020,165574,10,3,14,7,7
2020,165574,10,6,1,1,0
2020,165574,40,0,27,14,13
2020,165574,40,1,4,2,2
2020,165574,40,2,8,4,4
2020,165574,40,3,14,7,7
2020,165574,40,6,1,1,0
2020,165574,42,0,27,14,13
2020,165574,42,1,4,2,2
2020,165574,42,2,8,4,4
2020,165574,42,3,14,7,7
2020,165574,42,6,1,1,0
2020,165644,0,0,33,23,10
2020,165644,10,0,33,23,10
2020,165644,10,1,6,6,0
2020,165644,10,2,5,3,2
2020,165644,10,3,18,12,6
2020,165644,10,4,4,2,2
2020,165644,20,0,8,8,0
2020,165644,20,1,6,6,0
2020,165644,20,2,2,2,0
2020,165644,30,0,11,7,4
2020,165644,30,2,1,0,1
2020,165644,30,3,10,7,3
2020,165644,40,0,14,8,6
2020,165644,40,2,2,1,1
2020,165644,40,3,8,5,3
2020,165644,40,4,4,2,2
2020,165644,41,0,7,5,2
2020,165644,41,2,1,1,0
2020,165644,41,3,3,2,1
2020,165644,41,4,3,2,1
2020,165644,42,0,7,3,4
2020,165644,42,2,1,0,1
2020,165644,42,3,5,3,2
2020,165644,42,4,1,0,1
2020,165644,44,0,7,5,2
2020,165644,44,2,1,1,0
2020,165644,44,3,3,2,1
2020,165644,44,4,3,2,1
2020,165662,0,0,229,110,119
2020,165662,10,0,229,110,119
2020,165662,10,1,39,21,18
2020,165662,10,2,76,43,33
2020,165662,10,3,57,21,36
2020,165662,10,5,57,25,32
2020,165662,20,0,116,65,51
2020,165662,20,1,39,21,18
2020,165662,20,2,76,43,33
2020,165662,20,3,1,1,0
2020,165662,30,0,56,20,36
2020,165662,30,3,56,20,36
2020,165662,40,0,57,25,32
2020,165662,40,5,57,25,32
2020,165662,42,0,57,25,32
2020,165662,42,5,57,25,32
2020,165671,0,0,105,40,65
2020,165671,10,0,105,40,65
2020,165671,10,1,16,3,13
2020,165671,10,2,36,20,16
2020,165671,10,3,32,9,23
2020,165671,10,5,21,8,13
2020,165671,20,0,46,21,25
2020,165671,20,1,15,3,12
2020,165671,20,2,31,18,13
2020,165671,30,0,13,2,11
2020,165671,30,2,1,0,1
2020,165671,30,3,12,2,10
2020,165671,40,0,46,17,29
2020,165671,40,1,1,0,1
2020,165671,40,2,4,2,2
2020,165671,40,3,20,7,13
2020,165671,40,5,21,8,13
2020,165671,42,0,46,17,29
2020,165671,42,1,1,0,1
2020,165671,42,2,4,2,2
2020,165671,42,3,20,7,13
2020,165671,42,5,21,8,13
2020,165699,0,0,115,45,70
2020,165699,10,0,115,45,70
2020,165699,10,1,45,24,21
2020,165699,10,2,31,10,21
2020,165699,10,3,36,10,26
2020,165699,10,4,3,1,2
2020,165699,40,0,115,45,70
2020,165699,40,1,45,24,21
2020,165699,40,2,31,10,21
2020,165699,40,3,36,10,26
2020,165699,40,4,3,1,2
2020,165699,41,0,115,45,70
2020,165699,41,1,45,24,21
2020,165699,41,2,31,10,21
2020,165699,41,3,36,10,26
2020,165699,41,4,3,1,2
2020,165699,45,0,115,45,70
2020,165699,45,1,45,24,21
2020,165699,45,2,31,10,21
2020,165699,45,3,36,10,26
2020,165699,45,4,3,1,2
2020,165802,0,0,33,14,19
2020,165802,10,0,33,14,19
2020,165802,10,1,1,1,0
2020,165802,10,2,12,4,8
2020,165802,10,3,20,9,11
2020,165802,40,0,33,14,19
2020,165802,40,1,1,1,0
2020,165802,40,2,12,4,8
2020,165802,40,3,20,9,11
2020,165802,42,0,33,14,19
2020,165802,42,1,1,1,0
2020,165802,42,2,12,4,8
2020,165802,42,3,20,9,11
2020,165820,0,0,200,97,103
2020,165820,10,0,200,97,103
2020,165820,10,1,68,43,25
2020,165820,10,2,69,34,35
2020,165820,10,3,53,19,34
2020,165820,10,4,10,1,9
2020,165820,20,0,128,74,54
2020,165820,20,1,68,43,25
2020,165820,20,2,60,31,29
2020,165820,30,0,62,22,40
2020,165820,30,2,9,3,6
2020,165820,30,3,53,19,34
2020,165820,40,0,10,1,9
2020,165820,40,4,10,1,9
2020,165820,42,0,9,1,8
2020,165820,42,4,9,1,8
2020,165820,43,0,1,0,1
2020,165820,43,4,1,0,1
2020,165866,0,0,189,77,112
2020,165866,10,0,189,77,112
2020,165866,10,1,64,26,38
2020,165866,10,2,66,32,34
2020,165866,10,3,57,18,39
2020,165866,10,4,2,1,1
2020,165866,20,0,127,59,68
2020,165866,20,1,64,26,38
2020,165866,20,2,61,32,29
2020,165866,20,3,2,1,1
2020,165866,30,0,43,14,29
2020,165866,30,2,5,0,5
2020,165866,30,3,38,14,24
2020,165866,40,0,19,4,15
2020,165866,40,3,17,3,14
2020,165866,40,4,2,1,1
2020,165866,41,0,17,3,14
2020,165866,41,3,17,3,14
2020,165866,42,0,2,1,1
2020,165866,42,4,2,1,1
2020,165866,44,0,17,3,14
2020,165866,44,3,17,3,14
2020,165884,0,0,32,26,6
2020,165884,10,0,32,26,6
2020,165884,10,1,4,2,2
2020,165884,10,2,10,10,0
2020,165884,10,3,9,7,2
2020,165884,10,4,9,7,2
2020,165884,40,0,32,26,6
2020,165884,40,1,4,2,2
2020,165884,40,2,10,10,0
2020,165884,40,3,9,7,2
2020,165884,40,4,9,7,2
2020,165884,42,0,32,26,6
2020,165884,42,1,4,2,2
2020,165884,42,2,10,10,0
2020,165884,42,3,9,7,2
2020,165884,42,4,9,7,2
2020,165936,0,0,73,44,29
2020,165936,10,0,72,44,28
2020,165936,10,1,38,27,11
2020,165936,10,2,14,8,6
2020,165936,10,3,20,9,11
2020,165936,20,0,41,28,13
2020,165936,20,1,36,25,11
2020,165936,20,2,5,3,2
2020,165936,30,0,12,6,6
2020,165936,30,1,2,2,0
2020,165936,30,2,4,2,2
2020,165936,30,3,6,2,4
2020,165936,40,0,19,10,9
2020,165936,40,2,5,3,2
2020,165936,40,3,14,7,7
2020,165936,42,0,19,10,9
2020,165936,42,2,5,3,2
2020,165936,42,3,14,7,7
2020,165936,50,0,1,0,1
2020,165945,0,0,26,16,10
2020,165945,10,0,26,16,10
2020,165945,10,1,13,10,3
2020,165945,10,2,7,4,3
2020,165945,10,3,5,2,3
2020,165945,10,4,1,0,1
2020,165945,20,0,19,13,6
2020,165945,20,1,13,10,3
2020,165945,20,2,6,3,3
2020,165945,30,0,6,3,3
2020,165945,30,2,1,1,0
2020,165945,30,3,5,2,3
2020,165945,40,0,1,0,1
2020,165945,40,4,1,0,1
2020,165945,42,0,1,0,1
2020,165945,42,4,1,0,1
2020,165981,0,0,46,12,34
2020,165981,10,0,46,12,34
2020,165981,10,1,26,8,18
2020,165981,10,2,11,2,9
2020,165981,10,3,8,2,6
2020,165981,10,4,1,0,1
2020,165981,20,0,37,10,27
2020,165981,20,1,26,8,18
2020,165981,20,2,10,2,8
2020,165981,20,3,1,0,1
2020,165981,30,0,9,2,7
2020,165981,30,2,1,0,1
2020,165981,30,3,7,2,5
2020,165981,30,4,1,0,1
2020,166018,0,0,48,20,28
2020,166018,10,0,48,20,28
2020,166018,10,1,15,5,10
2020,166018,10,2,12,4,8
2020,166018,10,3,14,5,9
2020,166018,10,5,7,6,1
2020,166018,40,0,48,20,28
2020,166018,40,1,15,5,10
2020,166018,40,2,12,4,8
2020,166018,40,3,14,5,9
2020,166018,40,5,7,6,1
2020,166018,41,0,42,18,24
2020,166018,41,1,15,5,10
2020,166018,41,2,12,4,8
2020,166018,41,3,8,3,5
2020,166018,41,5,7,6,1
2020,166018,42,0,6,2,4
2020,166018,42,3,6,2,4
2020,166018,44,0,42,18,24
2020,166018,44,1,15,5,10
2020,166018,44,2,12,4,8
2020,166018,44,3,8,3,5
2020,166018,44,5,7,6,1
2020,166027,0,0,2120,1350,770
2020,166027,10,0,2120,1350,770
2020,166027,10,1,1182,860,322
2020,166027,10,2,185,106,79
2020,166027,10,3,260,145,115
2020,166027,10,4,195,89,106
2020,166027,10,5,298,150,148
2020,166027,20,0,1073,789,284
2020,166027,20,1,1073,789,284
2020,166027,30,0,400,230,170
2020,166027,30,2,173,101,72
2020,166027,30,3,227,129,98
2020,166027,40,0,647,331,316
2020,166027,40,1,109,71,38
2020,166027,40,2,12,5,7
2020,166027,40,3,33,16,17
2020,166027,40,4,195,89,106
2020,166027,40,5,298,150,148
2020,166027,41,0,310,177,133
2020,166027,41,1,99,64,35
2020,166027,41,2,8,2,6
2020,166027,41,3,27,15,12
2020,166027,41,4,76,36,40
2020,166027,41,5,100,60,40
2020,166027,42,0,337,154,183
2020,166027,42,1,10,7,3
2020,166027,42,2,4,3,1
2020,166027,42,3,6,1,5
2020,166027,42,4,119,53,66
2020,166027,42,5,198,90,108
2020,166027,44,0,304,173,131
2020,166027,44,1,93,60,33
2020,166027,44,2,8,2,6
2020,166027,44,3,27,15,12
2020,166027,44,4,76,36,40
2020,166027,44,5,100,60,40
2020,166027,45,0,6,4,2
2020,166027,45,1,6,4,2
2020,166045,0,0,9,6,3
2020,166045,10,0,9,6,3
2020,166045,10,1,2,2,0
2020,166045,10,3,3,1,2
2020,166045,10,4,4,3,1
2020,166045,20,0,4,2,2
2020,166045,20,1,1,1,0
2020,166045,20,3,3,1,2
2020,166045,40,0,5,4,1
2020,166045,40,1,1,1,0
2020,166045,40,4,4,3,1
2020,166045,41,0,5,4,1
2020,166045,41,1,1,1,0
2020,166045,41,4,4,3,1
2020,166045,45,0,5,4,1
2020,166045,45,1,1,1,0
2020,166045,45,4,4,3,1
2020,166054,0,0,13,10,3
2020,166054,10,0,13,10,3
2020,166054,10,1,13,10,3
2020,166054,20,0,4,3,1
2020,166054,20,1,4,3,1
2020,166054,30,0,7,5,2
2020,166054,30,1,7,5,2
2020,166054,40,0,2,2,0
2020,166054,40,1,2,2,0
2020,166054,41,0,2,2,0
2020,166054,41,1,2,2,0
2020,166054,44,0,1,1,0
2020,166054,44,1,1,1,0
2020,166054,45,0,1,1,0
2020,166054,45,1,1,1,0
2020,166124,0,0,294,147,147
2020,166124,10,0,294,147,147
2020,166124,10,1,98,54,44
2020,166124,10,2,89,50,39
2020,166124,10,3,79,33,46
2020,166124,10,4,4,3,1
2020,166124,10,5,24,7,17
2020,166124,20,0,185,103,82
2020,166124,20,1,96,53,43
2020,166124,20,2,89,50,39
2020,166124,30,0,44,18,26
2020,166124,30,3,43,18,25
2020,166124,30,4,1,0,1
2020,166124,40,0,65,26,39
2020,166124,40,1,2,1,1
2020,166124,40,3,36,15,21
2020,166124,40,4,3,3,0
2020,166124,40,5,24,7,17
2020,166124,41,0,27,9,18
2020,166124,41,3,3,2,1
2020,166124,41,5,24,7,17
2020,166124,42,0,38,17,21
2020,166124,42,1,2,1,1
2020,166124,42,3,33,13,20
2020,166124,42,4,3,3,0
2020,166124,44,0,3,2,1
2020,166124,44,3,3,2,1
2020,166124,45,0,24,7,17
2020,166124,45,5,24,7,17
2020,166133,0,0,115,37,78
2020,166133,10,0,115,37,78
2020,166133,10,1,74,25,49
2020,166133,10,2,14,5,9
2020,166133,10,3,16,4,12
2020,166133,10,4,11,3,8
2020,166133,20,0,85,29,56
2020,166133,20,1,74,25,49
2020,166133,20,2,11,4,7
2020,166133,30,0,29,8,21
2020,166133,30,2,3,1,2
2020,166133,30,3,16,4,12
2020,166133,30,4,10,3,7
2020,166133,40,0,1,0,1
2020,166133,40,4,1,0,1
2020,166133,42,0,1,0,1
2020,166133,42,4,1,0,1
2020,166391,0,0,76,29,47
2020,166391,10,0,76,29,47
2020,166391,10,1,15,4,11
2020,166391,10,2,35,14,21
2020,166391,10,3,23,8,15
2020,166391,10,4,3,3,0
2020,166391,40,0,76,29,47
2020,166391,40,1,15,4,11
2020,166391,40,2,35,14,21
2020,166391,40,3,23,8,15
2020,166391,40,4,3,3,0
2020,166391,41,0,67,26,41
2020,166391,41,1,14,4,10
2020,166391,41,2,32,13,19
2020,166391,41,3,20,8,12
2020,166391,41,4,1,1,0
2020,166391,42,0,9,3,6
2020,166391,42,1,1,0,1
2020,166391,42,2,3,1,2
2020,166391,42,3,3,0,3
2020,166391,42,4,2,2,0
2020,166391,44,0,67,26,41
2020,166391,44,1,14,4,10
2020,166391,44,2,32,13,19
2020,166391,44,3,20,8,12
2020,166391,44,4,1,1,0
2020,166407,0,0,37,3,34
2020,166407,10,0,37,3,34
2020,166407,10,2,1,0,1
2020,166407,10,3,34,2,32
2020,166407,10,4,2,1,1
2020,166407,40,0,37,3,34
2020,166407,40,2,1,0,1
2020,166407,40,3,34,2,32
2020,166407,40,4,2,1,1
2020,166407,41,0,37,3,34
2020,166407,41,2,1,0,1
2020,166407,41,3,34,2,32
2020,166407,41,4,2,1,1
2020,166407,44,0,37,3,34
2020,166407,44,2,1,0,1
2020,166407,44,3,34,2,32
2020,166407,44,4,2,1,1
2020,166452,0,0,143,52,91
2020,166452,10,0,143,52,91
2020,166452,10,1,42,18,24
2020,166452,10,2,51,18,33
2020,166452,10,3,38,11,27
2020,166452,10,4,12,5,7
2020,166452,40,0,143,52,91
2020,166452,40,1,42,18,24
2020,166452,40,2,51,18,33
2020,166452,40,3,38,11,27
2020,166452,40,4,12,5,7
2020,166452,41,0,133,48,85
2020,166452,41,1,42,18,24
2020,166452,41,2,51,18,33
2020,166452,41,3,36,11,25
2020,166452,41,4,4,1,3
2020,166452,42,0,10,4,6
2020,166452,42,3,2,0,2
2020,166452,42,4,8,4,4
2020,166452,44,0,133,48,85
2020,166452,44,1,42,18,24
2020,166452,44,2,51,18,33
2020,166452,44,3,36,11,25
2020,166452,44,4,4,1,3
2020,166489,0,0,16,8,8
2020,166489,10,0,16,8,8
2020,166489,10,1,16,8,8
2020,166489,40,0,16,8,8
2020,166489,40,1,16,8,8
2020,166489,41,0,16,8,8
2020,166489,41,1,16,8,8
2020,166489,44,0,16,8,8
2020,166489,44,1,16,8,8
2020,166513,0,0,630,344,286
2020,166513,10,0,627,344,283
2020,166513,10,1,148,110,38
2020,166513,10,2,157,80,77
2020,166513,10,3,152,83,69
2020,166513,10,4,10,0,10
2020,166513,10,5,130,57,73
2020,166513,10,6,30,14,16
2020,166513,20,0,281,177,104
2020,166513,20,1,140,105,35
2020,166513,20,2,141,72,69
2020,166513,30,0,162,93,69
2020,166513,30,1,4,4,0
2020,166513,30,2,12,6,6
2020,166513,30,3,146,83,63
2020,166513,40,0,184,74,110
2020,166513,40,1,4,1,3
2020,166513,40,2,4,2,2
2020,166513,40,3,6,0,6
2020,166513,40,4,10,0,10
2020,166513,40,5,130,57,73
2020,166513,40,6,30,14,16
2020,166513,41,0,7,2,5
2020,166513,41,1,4,1,3
2020,166513,41,2,3,1,2
2020,166513,42,0,168,67,101
2020,166513,42,2,1,1,0
2020,166513,42,3,6,0,6
2020,166513,42,4,10,0,10
2020,166513,42,5,130,57,73
2020,166513,42,6,21,9,12
2020,166513,43,0,9,5,4
2020,166513,43,6,9,5,4
2020,166513,45,0,7,2,5
2020,166513,45,1,4,1,3
2020,166513,45,2,3,1,2
2020,166513,50,0,3,0,3
2020,166629,0,0,1452,784,668
2020,166629,10,0,1452,784,668
2020,166629,10,1,457,319,138
2020,166629,10,2,353,172,181
2020,166629,10,3,294,145,149
2020,166629,10,4,5,0,5
2020,166629,10,5,343,148,195
2020,166629,20,0,785,480,305
2020,166629,20,1,453,317,136
2020,166629,20,2,331,162,169
2020,166629,20,3,1,1,0
2020,166629,30,0,293,151,142
2020,166629,30,1,2,1,1
2020,166629,30,2,12,6,6
2020,166629,30,3,279,144,135
2020,166629,40,0,374,153,221
2020,166629,40,1,2,1,1
2020,166629,40,2,10,4,6
2020,166629,40,3,14,0,14
2020,166629,40,4,5,0,5
2020,166629,40,5,343,148,195
2020,166629,41,0,367,150,217
2020,166629,41,1,2,1,1
2020,166629,41,2,10,4,6
2020,166629,41,3,14,0,14
2020,166629,41,4,5,0,5
2020,166629,41,5,336,145,191
2020,166629,42,0,7,3,4
2020,166629,42,5,7,3,4
2020,166629,44,0,367,150,217
2020,166629,44,1,2,1,1
2020,166629,44,2,10,4,6
2020,166629,44,3,14,0,14
2020,166629,44,4,5,0,5
2020,166629,44,5,336,145,191
2020,166638,0,0,684,336,348
2020,166638,10,0,684,336,348
2020,166638,10,1,121,70,51
2020,166638,10,2,233,117,116
2020,166638,10,3,121,55,66
2020,166638,10,5,193,87,106
2020,166638,10,6,16,7,9
2020,166638,20,0,353,186,167
2020,166638,20,1,121,70,51
2020,166638,20,2,231,116,115
2020,166638,20,3,1,0,1
2020,166638,30,0,122,56,66
2020,166638,30,2,2,1,1
2020,166638,30,3,120,55,65
2020,166638,40,0,209,94,115
2020,166638,40,5,193,87,106
2020,166638,40,6,16,7,9
2020,166638,41,0,9,5,4
2020,166638,41,5,7,3,4
2020,166638,41,6,2,2,0
2020,166638,42,0,114,48,66
2020,166638,42,5,105,44,61
2020,166638,42,6,9,4,5
2020,166638,43,0,86,41,45
2020,166638,43,5,81,40,41
2020,166638,43,6,5,1,4
2020,166638,44,0,9,5,4
2020,166638,44,5,7,3,4
2020,166638,44,6,2,2,0
2020,166647,0,0,70,33,37
2020,166647,10,0,70,33,37
2020,166647,10,1,29,11,18
2020,166647,10,2,14,9,5
2020,166647,10,3,27,13,14
2020,166647,20,0,42,19,23
2020,166647,20,1,29,11,18
2020,166647,20,2,10,7,3
2020,166647,20,3,3,1,2
2020,166647,30,0,28,14,14
2020,166647,30,2,4,2,2
2020,166647,30,3,24,12,12
2020,166656,0,0,298,102,196
2020,166656,10,0,298,102,196
2020,166656,10,1,62,25,37
2020,166656,10,2,92,34,58
2020,166656,10,3,117,31,86
2020,166656,10,4,16,6,10
2020,166656,10,6,11,6,5
2020,166656,40,0,298,102,196
2020,166656,40,1,62,25,37
2020,166656,40,2,92,34,58
2020,166656,40,3,117,31,86
2020,166656,40,4,16,6,10
2020,166656,40,6,11,6,5
2020,166656,41,0,285,99,186
2020,166656,41,1,61,25,36
2020,166656,41,2,89,34,55
2020,166656,41,3,109,28,81
2020,166656,41,4,15,6,9
2020,166656,41,6,11,6,5
2020,166656,42,0,13,3,10
2020,166656,42,1,1,0,1
2020,166656,42,2,3,0,3
2020,166656,42,3,8,3,5
2020,166656,42,4,1,0,1
2020,166656,44,0,285,99,186
2020,166656,44,1,61,25,36
2020,166656,44,2,89,34,55
2020,166656,44,3,109,28,81
2020,166656,44,4,15,6,9
2020,166656,44,6,11,6,5
2020,166674,0,0,114,56,58
2020,166674,10,0,114,56,58
2020,166674,10,1,58,30,28
2020,166674,10,2,24,11,13
2020,166674,10,3,32,15,17
2020,166674,20,0,63,31,32
2020,166674,20,1,57,29,28
2020,166674,20,2,6,2,4
2020,166674,30,0,29,13,16
2020,166674,30,1,1,1,0
2020,166674,30,2,15,7,8
2020,166674,30,3,13,5,8
2020,166674,40,0,22,12,10
2020,166674,40,2,3,2,1
2020,166674,40,3,19,10,9
2020,166674,42,0,20,11,9
2020,166674,42,2,3,2,1
2020,166674,42,3,17,9,8
2020,166674,43,0,2,1,1
2020,166674,43,3,2,1,1
2020,166683,0,0,1375,996,379
2020,166683,10,0,1037,784,253
2020,166683,10,1,662,535,127
2020,166683,10,2,218,150,68
2020,166683,10,3,157,99,58
2020,166683,20,0,799,631,168
2020,166683,20,1,662,535,127
2020,166683,20,2,137,96,41
2020,166683,30,0,228,145,83
2020,166683,30,2,75,49,26
2020,166683,30,3,153,96,57
2020,166683,40,0,10,8,2
2020,166683,40,2,6,5,1
2020,166683,40,3,4,3,1
2020,166683,41,0,10,8,2
2020,166683,41,2,6,5,1
2020,166683,41,3,4,3,1
2020,166683,44,0,10,8,2
2020,166683,44,2,6,5,1
2020,166683,44,3,4,3,1
2020,166683,50,0,338,212,126
2020,166692,0,0,96,65,31
2020,166692,10,0,90,59,31
2020,166692,10,1,37,27,10
2020,166692,10,2,20,13,7
2020,166692,10,3,28,17,11
2020,166692,10,4,5,2,3
2020,166692,20,0,55,38,17
2020,166692,20,1,36,27,9
2020,166692,20,2,15,9,6
2020,166692,20,3,4,2,2
2020,166692,30,0,35,21,14
2020,166692,30,1,1,0,1
2020,166692,30,2,5,4,1
2020,166692,30,3,24,15,9
2020,166692,30,4,5,2,3
2020,166692,50,0,6,6,0
2020,166708,0,0,1293,731,562
2020,166708,10,0,1027,589,438
2020,166708,10,1,210,141,69
2020,166708,10,2,216,137,79
2020,166708,10,3,550,287,263
2020,166708,10,4,51,24,27
2020,166708,20,0,130,91,39
2020,166708,20,1,112,79,33
2020,166708,20,2,18,12,6
2020,166708,30,0,58,37,21
2020,166708,30,1,5,2,3
2020,166708,30,2,21,17,4
2020,166708,30,3,32,18,14
2020,166708,40,0,839,461,378
2020,166708,40,1,93,60,33
2020,166708,40,2,177,108,69
2020,166708,40,3,518,269,249
2020,166708,40,4,51,24,27
2020,166708,41,0,836,458,378
2020,166708,41,1,92,59,33
2020,166708,41,2,176,107,69
2020,166708,41,3,517,268,249
2020,166708,41,4,51,24,27
2020,166708,43,0,3,3,0
2020,166708,43,1,1,1,0
2020,166708,43,2,1,1,0
2020,166708,43,3,1,1,0
2020,166708,45,0,836,458,378
2020,166708,45,1,92,59,33
2020,166708,45,2,176,107,69
2020,166708,45,3,517,268,249
2020,166708,45,4,51,24,27
2020,166708,50,0,266,142,124
2020,166717,0,0,68,25,43
2020,166717,10,0,68,25,43
2020,166717,10,1,5,3,2
2020,166717,10,2,24,11,13
2020,166717,10,3,25,8,17
2020,166717,10,4,14,3,11
2020,166717,40,0,68,25,43
2020,166717,40,1,5,3,2
2020,166717,40,2,24,11,13
2020,166717,40,3,25,8,17
2020,166717,40,4,14,3,11
2020,166717,41,0,68,25,43
2020,166717,41,1,5,3,2
2020,166717,41,2,24,11,13
2020,166717,41,3,25,8,17
2020,166717,41,4,14,3,11
2020,166717,44,0,68,25,43
2020,166717,44,1,5,3,2
2020,166717,44,2,24,11,13
2020,166717,44,3,25,8,17
2020,166717,44,4,14,3,11
2020,166823,0,0,106,46,60
2020,166823,10,0,106,46,60
2020,166823,10,1,41,23,18
2020,166823,10,2,38,15,23
2020,166823,10,3,17,6,11
2020,166823,10,4,10,2,8
2020,166823,20,0,83,41,42
2020,166823,20,1,41,23,18
2020,166823,20,2,35,14,21
2020,166823,20,3,7,4,3
2020,166823,30,0,23,5,18
2020,166823,30,2,3,1,2
2020,166823,30,3,10,2,8
2020,166823,30,4,10,2,8
2020,166850,0,0,203,91,112
2020,166850,10,0,203,91,112
2020,166850,10,1,30,20,10
2020,166850,10,2,81,35,46
2020,166850,10,3,70,29,41
2020,166850,10,5,22,7,15
2020,166850,20,0,90,49,41
2020,166850,20,1,27,18,9
2020,166850,20,2,63,31,32
2020,166850,30,0,54,24,30
2020,166850,30,3,54,24,30
2020,166850,40,0,59,18,41
2020,166850,40,1,3,2,1
2020,166850,40,2,18,4,14
2020,166850,40,3,16,5,11
2020,166850,40,5,22,7,15
2020,166850,42,0,59,18,41
2020,166850,42,1,3,2,1
2020,166850,42,2,18,4,14
2020,166850,42,3,16,5,11
2020,166850,42,5,22,7,15
2020,166869,0,0,97,15,82
2020,166869,10,0,97,15,82
2020,166869,10,1,12,1,11
2020,166869,10,2,19,5,14
2020,166869,10,3,47,6,41
2020,166869,10,4,19,3,16
2020,166869,40,0,97,15,82
2020,166869,40,1,12,1,11
2020,166869,40,2,19,5,14
2020,166869,40,3,47,6,41
2020,166869,40,4,19,3,16
2020,166869,41,0,97,15,82
2020,166869,41,1,12,1,11
2020,166869,41,2,19,5,14
2020,166869,41,3,47,6,41
2020,166869,41,4,19,3,16
2020,166869,44,0,97,15,82
2020,166869,44,1,12,1,11
2020,166869,44,2,19,5,14
2020,166869,44,3,47,6,41
2020,166869,44,4,19,3,16
2020,166887,0,0,110,34,76
2020,166887,10,0,110,34,76
2020,166887,10,1,70,24,46
2020,166887,10,2,23,5,18
2020,166887,10,3,17,5,12
2020,166887,20,0,74,25,49
2020,166887,20,1,70,24,46
2020,166887,20,2,4,1,3
2020,166887,30,0,36,9,27
2020,166887,30,2,19,4,15
2020,166887,30,3,17,5,12
2020,166911,0,0,17,9,8
2020,166911,10,0,17,9,8
2020,166911,10,1,11,5,6
2020,166911,10,2,5,4,1
2020,166911,10,3,1,0,1
2020,166911,40,0,17,9,8
2020,166911,40,1,11,5,6
2020,166911,40,2,5,4,1
2020,166911,40,3,1,0,1
2020,166911,41,0,16,8,8
2020,166911,41,1,11,5,6
2020,166911,41,2,4,3,1
2020,166911,41,3,1,0,1
2020,166911,42,0,1,1,0
2020,166911,42,2,1,1,0
2020,166911,44,0,16,8,8
2020,166911,44,1,11,5,6
2020,166911,44,2,4,3,1
2020,166911,44,3,1,0,1
2020,166939,0,0,212,84,128
2020,166939,10,0,212,84,128
2020,166939,10,1,69,33,36
2020,166939,10,2,49,19,30
2020,166939,10,3,47,18,29
2020,166939,10,4,5,1,4
2020,166939,10,5,36,11,25
2020,166939,10,6,6,2,4
2020,166939,20,0,110,51,59
2020,166939,20,1,66,32,34
2020,166939,20,2,43,19,24
2020,166939,20,6,1,0,1
2020,166939,30,0,51,18,33
2020,166939,30,2,4,0,4
2020,166939,30,3,47,18,29
2020,166939,40,0,51,15,36
2020,166939,40,1,3,1,2
2020,166939,40,2,2,0,2
2020,166939,40,4,5,1,4
2020,166939,40,5,36,11,25
2020,166939,40,6,5,2,3
2020,166939,41,0,33,7,26
2020,166939,41,1,2,0,2
2020,166939,41,2,2,0,2
2020,166939,41,4,3,1,2
2020,166939,41,5,23,4,19
2020,166939,41,6,3,2,1
2020,166939,42,0,18,8,10
2020,166939,42,1,1,1,0
2020,166939,42,4,2,0,2
2020,166939,42,5,13,7,6
2020,166939,42,6,2,0,2
2020,166939,44,0,23,5,18
2020,166939,44,1,2,0,2
2020,166939,44,2,2,0,2
2020,166939,44,5,17,4,13
2020,166939,44,6,2,1,1
2020,166939,45,0,10,2,8
2020,166939,45,4,3,1,2
2020,166939,45,5,6,0,6
2020,166939,45,6,1,1,0
2020,166957,0,0,60,21,39
2020,166957,10,0,60,21,39
2020,166957,10,1,26,9,17
2020,166957,10,2,21,6,15
2020,166957,10,3,13,6,7
2020,166957,20,0,39,11,28
2020,166957,20,1,24,7,17
2020,166957,20,2,15,4,11
2020,166957,30,0,21,10,11
2020,166957,30,1,2,2,0
2020,166957,30,2,6,2,4
2020,166957,30,3,13,6,7
2020,167057,0,0,124,80,44
2020,167057,10,0,124,80,44
2020,167057,10,6,124,80,44
2020,167057,40,0,124,80,44
2020,167057,40,6,124,80,44
2020,167057,41,0,101,67,34
2020,167057,41,6,101,67,34
2020,167057,42,0,23,13,10
2020,167057,42,6,23,13,10
2020,167057,44,0,101,67,34
2020,167057,44,6,101,67,34
2020,167093,0,0,49,17,32
2020,167093,10,0,49,17,32
2020,167093,10,1,9,3,6
2020,167093,10,2,14,5,9
2020,167093,10,3,26,9,17
2020,167093,20,0,11,3,8
2020,167093,20,1,8,3,5
2020,167093,20,2,3,0,3
2020,167093,30,0,10,2,8
2020,167093,30,2,4,1,3
2020,167093,30,3,6,1,5
2020,167093,40,0,28,12,16
2020,167093,40,1,1,0,1
2020,167093,40,2,7,4,3
2020,167093,40,3,20,8,12
2020,167093,42,0,28,12,16
2020,167093,42,1,1,0,1
2020,167093,42,2,7,4,3
2020,167093,42,3,20,8,12
2020,167215,0,0,27,17,10
2020,167215,10,0,27,17,10
2020,167215,10,1,23,16,7
2020,167215,10,2,1,0,1
2020,167215,10,4,3,1,2
2020,167215,20,0,19,15,4
2020,167215,20,1,19,15,4
2020,167215,40,0,8,2,6
2020,167215,40,1,4,1,3
2020,167215,40,2,1,0,1
2020,167215,40,4,3,1,2
2020,167215,42,0,8,2,6
2020,167215,42,1,4,1,3
2020,167215,42,2,1,0,1
2020,167215,42,4,3,1,2
2020,167260,0,0,52,26,26
2020,167260,10,0,52,26,26
2020,167260,10,1,6,6,0
2020,167260,10,2,27,13,14
2020,167260,10,3,19,7,12
2020,167260,20,0,11,10,1
2020,167260,20,1,6,6,0
2020,167260,20,2,5,4,1
2020,167260,30,0,9,5,4
2020,167260,30,2,5,2,3
2020,167260,30,3,4,3,1
2020,167260,40,0,32,11,21
2020,167260,40,2,17,7,10
2020,167260,40,3,15,4,11
2020,167260,41,0,32,11,21
2020,167260,41,2,17,7,10
2020,167260,41,3,15,4,11
2020,167260,44,0,32,11,21
2020,167260,44,2,17,7,10
2020,167260,44,3,15,4,11
2020,167288,0,0,87,39,48
2020,167288,10,0,87,39,48
2020,167288,10,1,34,18,16
2020,167288,10,2,22,10,12
2020,167288,10,3,31,11,20
2020,167288,20,0,54,26,28
2020,167288,20,1,34,18,16
2020,167288,20,2,20,8,12
2020,167288,30,0,30,13,17
2020,167288,30,2,2,2,0
2020,167288,30,3,28,11,17
2020,167288,40,0,3,0,3
2020,167288,40,3,3,0,3
2020,167288,42,0,3,0,3
2020,167288,42,3,3,0,3
2020,167312,0,0,120,39,81
2020,167312,10,0,120,39,81
2020,167312,10,1,57,17,40
2020,167312,10,2,33,13,20
2020,167312,10,3,12,2,10
2020,167312,10,4,18,7,11
2020,167312,20,0,80,24,56
2020,167312,20,1,56,17,39
2020,167312,20,2,22,7,15
2020,167312,20,3,2,0,2
2020,167312,30,0,40,15,25
2020,167312,30,1,1,0,1
2020,167312,30,2,11,6,5
2020,167312,30,3,10,2,8
2020,167312,30,4,18,7,11
2020,167358,0,0,1399,804,595
2020,167358,10,0,1399,804,595
2020,167358,10,1,415,279,136
2020,167358,10,2,406,238,168
2020,167358,10,3,326,172,154
2020,167358,10,4,111,68,43
2020,167358,10,5,27,19,8
2020,167358,10,6,114,28,86
2020,167358,20,0,561,384,177
2020,167358,20,1,336,244,92
2020,167358,20,2,225,140,85
2020,167358,30,0,218,121,97
2020,167358,30,1,6,3,3
2020,167358,30,2,30,17,13
2020,167358,30,3,182,101,81
2020,167358,40,0,620,299,321
2020,167358,40,1,73,32,41
2020,167358,40,2,151,81,70
2020,167358,40,3,144,71,73
2020,167358,40,4,111,68,43
2020,167358,40,5,27,19,8
2020,167358,40,6,114,28,86
2020,167358,41,0,97,41,56
2020,167358,41,1,42,18,24
2020,167358,41,2,19,7,12
2020,167358,41,3,1,0,1
2020,167358,41,4,13,9,4
2020,167358,41,5,2,1,1
2020,167358,41,6,20,6,14
2020,167358,42,0,523,258,265
2020,167358,42,1,31,14,17
2020,167358,42,2,132,74,58
2020,167358,42,3,143,71,72
2020,167358,42,4,98,59,39
2020,167358,42,5,25,18,7
2020,167358,42,6,94,22,72
2020,167358,44,0,97,41,56
2020,167358,44,1,42,18,24
2020,167358,44,2,19,7,12
2020,167358,44,3,1,0,1
2020,167358,44,4,13,9,4
2020,167358,44,5,2,1,1
2020,167358,44,6,20,6,14
2020,167376,0,0,78,27,51
2020,167376,10,0,78,27,51
2020,167376,10,1,52,17,35
2020,167376,10,2,14,7,7
2020,167376,10,3,7,3,4
2020,167376,10,4,5,0,5
2020,167376,20,0,57,19,38
2020,167376,20,1,50,17,33
2020,167376,20,2,7,2,5
2020,167376,30,0,21,8,13
2020,167376,30,1,2,0,2
2020,167376,30,2,7,5,2
2020,167376,30,3,7,3,4
2020,167376,30,4,5,0,5
2020,167394,0,0,54,16,38
2020,167394,10,0,54,16,38
2020,167394,10,1,8,4,4
2020,167394,10,2,22,9,13
2020,167394,10,3,19,2,17
2020,167394,10,4,1,0,1
2020,167394,10,5,4,1,3
2020,167394,20,0,26,12,14
2020,167394,20,1,8,4,4
2020,167394,20,2,18,8,10
2020,167394,30,0,15,3,12
2020,167394,30,2,4,1,3
2020,167394,30,3,11,2,9
2020,167394,40,0,13,1,12
2020,167394,40,3,8,0,8
2020,167394,40,4,1,0,1
2020,167394,40,5,4,1,3
2020,167394,42,0,13,1,12
2020,167394,42,3,8,0,8
2020,167394,42,4,1,0,1
2020,167394,42,5,4,1,3
2020,167455,0,0,35,7,28
2020,167455,10,0,22,4,18
2020,167455,10,1,6,1,5
2020,167455,10,2,2,0,2
2020,167455,10,3,14,3,11
2020,167455,20,0,8,1,7
2020,167455,20,1,6,1,5
2020,167455,20,2,2,0,2
2020,167455,30,0,9,3,6
2020,167455,30,3,9,3,6
2020,167455,40,0,5,0,5
2020,167455,40,3,5,0,5
2020,167455,42,0,5,0,5
2020,167455,42,3,5,0,5
2020,167455,50,0,13,3,10
2020,167464,0,0,11,11,0
2020,167464,10,0,7,7,0
2020,167464,10,1,7,7,0
2020,167464,40,0,7,7,0
2020,167464,40,1,7,7,0
2020,167464,41,0,7,7,0
2020,167464,41,1,7,7,0
2020,167464,45,0,7,7,0
2020,167464,45,1,7,7,0
2020,167464,50,0,4,4,0
2020,167525,0,0,38,19,19
2020,167525,10,0,38,19,19
2020,167525,10,1,27,14,13
2020,167525,10,2,2,2,0
2020,167525,10,3,8,3,5
2020,167525,10,4,1,0,1
2020,167525,20,0,32,18,14
2020,167525,20,1,27,14,13
2020,167525,20,2,2,2,0
2020,167525,20,3,3,2,1
2020,167525,30,0,6,1,5
2020,167525,30,3,5,1,4
2020,167525,30,4,1,0,1
2020,167534,0,0,133,43,90
2020,167534,10,0,133,43,90
2020,167534,10,1,79,26,53
2020,167534,10,2,32,11,21
2020,167534,10,3,19,4,15
2020,167534,10,4,3,2,1
2020,167534,20,0,90,29,61
2020,167534,20,1,79,26,53
2020,167534,20,2,8,3,5
2020,167534,20,3,3,0,3
2020,167534,30,0,43,14,29
2020,167534,30,2,24,8,16
2020,167534,30,3,16,4,12
2020,167534,30,4,3,2,1
2020,167598,0,0,124,34,90
2020,167598,10,0,123,33,90
2020,167598,10,1,8,4,4
2020,167598,10,2,50,15,35
2020,167598,10,3,57,13,44
2020,167598,10,5,8,1,7
2020,167598,20,0,16,8,8
2020,167598,20,1,6,3,3
2020,167598,20,2,10,5,5
2020,167598,30,0,5,1,4
2020,167598,30,2,3,1,2
2020,167598,30,3,2,0,2
2020,167598,40,0,102,24,78
2020,167598,40,1,2,1,1
2020,167598,40,2,37,9,28
2020,167598,40,3,55,13,42
2020,167598,40,5,8,1,7
2020,167598,41,0,75,18,57
2020,167598,41,1,2,1,1
2020,167598,41,2,33,6,27
2020,167598,41,3,40,11,29
2020,167598,42,0,27,6,21
2020,167598,42,2,4,3,1
2020,167598,42,3,15,2,13
2020,167598,42,5,8,1,7
2020,167598,44,0,75,18,57
2020,167598,44,1,2,1,1
2020,167598,44,2,33,6,27
2020,167598,44,3,40,11,29
2020,167598,50,0,1,1,0
2020,167631,0,0,39,20,19
2020,167631,10,0,39,20,19
2020,167631,10,1,10,6,4
2020,167631,10,2,6,2,4
2020,167631,10,3,23,12,11
2020,167631,20,0,16,8,8
2020,167631,20,1,10,6,4
2020,167631,20,2,6,2,4
2020,167631,30,0,23,12,11
2020,167631,30,3,23,12,11
2020,167677,0,0,21,18,3
2020,167677,10,0,21,18,3
2020,167677,10,6,21,18,3
2020,167677,40,0,21,18,3
2020,167677,40,6,21,18,3
2020,167677,41,0,16,16,0
2020,167677,41,6,16,16,0
2020,167677,42,0,5,2,3
2020,167677,42,6,5,2,3
2020,167677,44,0,1,1,0
2020,167677,44,6,1,1,0
2020,167677,45,0,15,15,0
2020,167677,45,6,15,15,0
2020,167729,0,0,293,137,156
2020,167729,10,0,293,137,156
2020,167729,10,1,145,72,73
2020,167729,10,2,85,40,45
2020,167729,10,3,55,24,31
2020,167729,10,4,8,1,7
2020,167729,20,0,225,110,115
2020,167729,20,1,143,70,73
2020,167729,20,2,81,39,42
2020,167729,20,3,1,1,0
2020,167729,30,0,53,23,30
2020,167729,30,2,4,1,3
2020,167729,30,3,48,22,26
2020,167729,30,4,1,0,1
2020,167729,40,0,15,4,11
2020,167729,40,1,2,2,0
2020,167729,40,3,6,1,5
2020,167729,40,4,7,1,6
2020,167729,42,0,15,4,11
2020,167729,42,1,2,2,0
2020,167729,42,3,6,1,5
2020,167729,42,4,7,1,6
2020,167783,0,0,224,58,166
2020,167783,10,0,224,58,166
2020,167783,10,1,53,18,35
2020,167783,10,2,98,24,74
2020,167783,10,3,70,14,56
2020,167783,10,5,3,2,1
2020,167783,20,0,92,32,60
2020,167783,20,1,42,15,27
2020,167783,20,2,50,17,33
2020,167783,30,0,40,12,28
2020,167783,30,2,3,2,1
2020,167783,30,3,37,10,27
2020,167783,40,0,92,14,78
2020,167783,40,1,11,3,8
2020,167783,40,2,45,5,40
2020,167783,40,3,33,4,29
2020,167783,40,5,3,2,1
2020,167783,41,0,23,5,18
2020,167783,41,1,3,1,2
2020,167783,41,2,14,3,11
2020,167783,41,3,6,1,5
2020,167783,42,0,69,9,60
2020,167783,42,1,8,2,6
2020,167783,42,2,31,2,29
2020,167783,42,3,27,3,24
2020,167783,42,5,3,2,1
2020,167783,44,0,23,5,18
2020,167783,44,1,3,1,2
2020,167783,44,2,14,3,11
2020,167783,44,3,6,1,5
2020,167792,0,0,49,29,20
2020,167792,10,0,49,29,20
2020,167792,10,6,49,29,20
2020,167792,40,0,49,29,20
2020,167792,40,6,49,29,20
2020,167792,41,0,44,24,20
2020,167792,41,6,44,24,20
2020,167792,42,0,5,5,0
2020,167792,42,6,5,5,0
2020,167792,44,0,44,24,20
2020,167792,44,6,44,24,20
2020,167835,0,0,313,124,189
2020,167835,10,0,313,124,189
2020,167835,10,1,132,56,76
2020,167835,10,2,53,24,29
2020,167835,10,3,52,19,33
2020,167835,10,4,11,5,6
2020,167835,10,5,65,20,45
2020,167835,20,0,184,80,104
2020,167835,20,1,132,56,76
2020,167835,20,2,52,24,28
2020,167835,30,0,53,19,34
2020,167835,30,2,1,0,1
2020,167835,30,3,52,19,33
2020,167835,40,0,76,25,51
2020,167835,40,4,11,5,6
2020,167835,40,5,65,20,45
2020,167835,41,0,51,17,34
2020,167835,41,4,10,4,6
2020,167835,41,5,41,13,28
2020,167835,42,0,25,8,17
2020,167835,42,4,1,1,0
2020,167835,42,5,24,7,17
2020,167835,44,0,51,17,34
2020,167835,44,4,10,4,6
2020,167835,44,5,41,13,28
2020,167899,0,0,190,77,113
2020,167899,10,0,190,77,113
2020,167899,10,1,44,21,23
2020,167899,10,2,48,20,28
2020,167899,10,3,89,34,55
2020,167899,10,4,9,2,7
2020,167899,20,0,74,35,39
2020,167899,20,1,41,19,22
2020,167899,20,2,32,15,17
2020,167899,20,3,1,1,0
2020,167899,30,0,59,18,41
2020,167899,30,1,1,0,1
2020,167899,30,2,4,3,1
2020,167899,30,3,54,15,39
2020,167899,40,0,57,24,33
2020,167899,40,1,2,2,0
2020,167899,40,2,12,2,10
2020,167899,40,3,34,18,16
2020,167899,40,4,9,2,7
2020,167899,41,0,50,21,29
2020,167899,41,1,2,2,0
2020,167899,41,2,12,2,10
2020,167899,41,3,30,15,15
2020,167899,41,4,6,2,4
2020,167899,42,0,7,3,4
2020,167899,42,3,4,3,1
2020,167899,42,4,3,0,3
2020,167899,44,0,50,21,29
2020,167899,44,1,2,2,0
2020,167899,44,2,12,2,10
2020,167899,44,3,30,15,15
2020,167899,44,4,6,2,4
2020,167905,0,0,118,46,72
2020,167905,10,0,118,46,72
2020,167905,10,1,62,25,37
2020,167905,10,2,28,11,17
2020,167905,10,3,25,8,17
2020,167905,10,4,3,2,1
2020,167905,20,0,79,26,53
2020,167905,20,1,24,6,18
2020,167905,20,2,27,10,17
2020,167905,20,3,25,8,17
2020,167905,20,4,3,2,1
2020,167905,30,0,39,20,19
2020,167905,30,1,38,19,19
2020,167905,30,2,1,1,0
2020,167987,0,0,397,209,188
2020,167987,10,0,397,209,188
2020,167987,10,1,123,75,48
2020,167987,10,2,108,62,46
2020,167987,10,3,67,27,40
2020,167987,10,5,99,45,54
2020,167987,20,0,228,137,91
2020,167987,20,1,122,74,48
2020,167987,20,2,103,62,41
2020,167987,20,3,3,1,2
2020,167987,30,0,62,26,36
2020,167987,30,2,4,0,4
2020,167987,30,3,58,26,32
2020,167987,40,0,107,46,61
2020,167987,40,1,1,1,0
2020,167987,40,2,1,0,1
2020,167987,40,3,6,0,6
2020,167987,40,5,99,45,54
2020,167987,41,0,8,1,7
2020,167987,41,1,1,1,0
2020,167987,41,2,1,0,1
2020,167987,41,3,6,0,6
2020,167987,42,0,99,45,54
2020,167987,42,5,99,45,54
2020,167987,44,0,8,1,7
2020,167987,44,1,1,1,0
2020,167987,44,2,1,0,1
2020,167987,44,3,6,0,6
2020,167996,0,0,174,89,85
2020,167996,10,0,174,89,85
2020,167996,10,1,50,35,15
2020,167996,10,2,61,30,31
2020,167996,10,3,53,22,31
2020,167996,10,4,4,0,4
2020,167996,10,5,5,2,3
2020,167996,10,6,1,0,1
2020,167996,20,0,96,57,39
2020,167996,20,1,49,34,15
2020,167996,20,2,47,23,24
2020,167996,30,0,34,12,22
2020,167996,30,2,5,2,3
2020,167996,30,3,27,9,18
2020,167996,30,5,2,1,1
2020,167996,40,0,44,20,24
2020,167996,40,1,1,1,0
2020,167996,40,2,9,5,4
2020,167996,40,3,26,13,13
2020,167996,40,4,4,0,4
2020,167996,40,5,3,1,2
2020,167996,40,6,1,0,1
2020,167996,41,0,33,17,16
2020,167996,41,1,1,1,0
2020,167996,41,2,8,4,4
2020,167996,41,3,23,12,11
2020,167996,41,4,1,0,1
2020,167996,42,0,11,3,8
2020,167996,42,2,1,1,0
2020,167996,42,3,3,1,2
2020,167996,42,4,3,0,3
2020,167996,42,5,3,1,2
2020,167996,42,6,1,0,1
2020,167996,44,0,33,17,16
2020,167996,44,1,1,1,0
2020,167996,44,2,8,4,4
2020,167996,44,3,23,12,11
2020,167996,44,4,1,0,1
2020,168005,0,0,353,176,177
2020,168005,10,0,353,176,177
2020,168005,10,1,94,52,42
2020,168005,10,2,104,50,54
2020,168005,10,3,86,41,45
2020,168005,10,4,69,33,36
2020,168005,20,0,193,100,93
2020,168005,20,1,94,52,42
2020,168005,20,2,99,48,51
2020,168005,30,0,77,38,39
2020,168005,30,2,3,1,2
2020,168005,30,3,74,37,37
2020,168005,40,0,83,38,45
2020,168005,40,2,2,1,1
2020,168005,40,3,12,4,8
2020,168005,40,4,69,33,36
2020,168005,41,0,8,3,5
2020,168005,41,2,2,1,1
2020,168005,41,3,2,0,2
2020,168005,41,4,4,2,2
2020,168005,42,0,75,35,40
2020,168005,42,3,10,4,6
2020,168005,42,4,65,31,34
2020,168005,44,0,8,3,5
2020,168005,44,2,2,1,1
2020,168005,44,3,2,0,2
2020,168005,44,4,4,2,2
2020,168148,0,0,917,472,445
2020,168148,10,0,917,472,445
2020,168148,10,1,292,197,95
2020,168148,10,2,220,122,98
2020,168148,10,3,249,104,145
2020,168148,10,4,2,0,2
2020,168148,10,5,154,49,105
2020,168148,20,0,371,243,128
2020,168148,20,1,228,155,73
2020,168148,20,2,143,88,55
2020,168148,30,0,89,44,45
2020,168148,30,3,89,44,45
2020,168148,40,0,457,185,272
2020,168148,40,1,64,42,22
2020,168148,40,2,77,34,43
2020,168148,40,3,160,60,100
2020,168148,40,4,2,0,2
2020,168148,40,5,154,49,105
2020,168148,41,0,380,158,222
2020,168148,41,1,59,38,21
2020,168148,41,2,71,33,38
2020,168148,41,3,102,40,62
2020,168148,41,5,148,47,101
2020,168148,42,0,73,24,49
2020,168148,42,1,5,4,1
2020,168148,42,2,6,1,5
2020,168148,42,3,55,18,37
2020,168148,42,4,2,0,2
2020,168148,42,5,5,1,4
2020,168148,43,0,4,3,1
2020,168148,43,3,3,2,1
2020,168148,43,5,1,1,0
2020,168148,44,0,343,139,204
2020,168148,44,1,39,26,13
2020,168148,44,2,56,26,30
2020,168148,44,3,100,40,60
2020,168148,44,5,148,47,101
2020,168148,45,0,37,19,18
2020,168148,45,1,20,12,8
2020,168148,45,2,15,7,8
2020,168148,45,3,2,0,2
2020,168218,0,0,329,125,204
2020,168218,10,0,329,125,204
2020,168218,10,1,99,51,48
2020,168218,10,2,72,25,47
2020,168218,10,3,40,15,25
2020,168218,10,5,71,19,52
2020,168218,10,6,47,15,32
2020,168218,20,0,171,76,95
2020,168218,20,1,99,51,48
2020,168218,20,2,72,25,47
2020,168218,30,0,40,15,25
2020,168218,30,3,40,15,25
2020,168218,40,0,118,34,84
2020,168218,40,5,71,19,52
2020,168218,40,6,47,15,32
2020,168218,41,0,93,24,69
2020,168218,41,5,64,16,48
2020,168218,41,6,29,8,21
2020,168218,42,0,25,10,15
2020,168218,42,5,7,3,4
2020,168218,42,6,18,7,11
2020,168218,44,0,92,24,68
2020,168218,44,5,64,16,48
2020,168218,44,6,28,8,20
2020,168218,45,0,1,0,1
2020,168218,45,6,1,0,1
2020,168227,0,0,169,108,61
2020,168227,10,0,169,108,61
2020,168227,10,1,29,23,6
2020,168227,10,2,61,35,26
2020,168227,10,3,78,50,28
2020,168227,10,4,1,0,1
2020,168227,40,0,169,108,61
2020,168227,40,1,29,23,6
2020,168227,40,2,61,35,26
2020,168227,40,3,78,50,28
2020,168227,40,4,1,0,1
2020,168227,41,0,149,99,50
2020,168227,41,1,29,23,6
2020,168227,41,2,61,35,26
2020,168227,41,3,59,41,18
2020,168227,42,0,1,1,0
2020,168227,42,3,1,1,0
2020,168227,43,0,19,8,11
2020,168227,43,3,18,8,10
2020,168227,43,4,1,0,1
2020,168227,44,0,1,1,0
2020,168227,44,3,1,1,0
2020,168227,45,0,148,98,50
2020,168227,45,1,29,23,6
2020,168227,45,2,61,35,26
2020,168227,45,3,58,40,18
2020,168254,0,0,233,127,106
2020,168254,10,0,233,127,106
2020,168254,10,1,85,47,38
2020,168254,10,2,66,39,27
2020,168254,10,3,56,28,28
2020,168254,10,4,26,13,13
2020,168254,20,0,113,67,46
2020,168254,20,1,75,43,32
2020,168254,20,2,37,23,14
2020,168254,20,3,1,1,0
2020,168254,30,0,62,36,26
2020,168254,30,2,19,12,7
2020,168254,30,3,43,24,19
2020,168254,40,0,58,24,34
2020,168254,40,1,10,4,6
2020,168254,40,2,10,4,6
2020,168254,40,3,12,3,9
2020,168254,40,4,26,13,13
2020,168254,41,0,8,1,7
2020,168254,41,2,4,1,3
2020,168254,41,3,2,0,2
2020,168254,41,4,2,0,2
2020,168254,42,0,43,18,25
2020,168254,42,1,9,3,6
2020,168254,42,2,6,3,3
2020,168254,42,3,5,0,5
2020,168254,42,4,23,12,11
2020,168254,43,0,7,5,2
2020,168254,43,1,1,1,0
2020,168254,43,3,5,3,2
2020,168254,43,4,1,1,0
2020,168254,44,0,8,1,7
2020,168254,44,2,4,1,3
2020,168254,44,3,2,0,2
2020,168254,44,4,2,0,2
2020,168263,0,0,226,109,117
2020,168263,10,0,226,109,117
2020,168263,10,1,101,54,47
2020,168263,10,2,62,29,33
2020,168263,10,3,57,25,32
2020,168263,10,4,6,1,5
2020,168263,20,0,162,85,77
2020,168263,20,1,101,54,47
2020,168263,20,2,58,29,29
2020,168263,20,3,3,2,1
2020,168263,30,0,55,22,33
2020,168263,30,2,4,0,4
2020,168263,30,3,51,22,29
2020,168263,40,0,9,2,7
2020,168263,40,3,3,1,2
2020,168263,40,4,6,1,5
2020,168263,42,0,9,2,7
2020,168263,42,3,3,1,2
2020,168263,42,4,6,1,5
2020,168281,0,0,120,56,64
2020,168281,10,0,120,56,64
2020,168281,10,1,50,26,24
2020,168281,10,2,39,18,21
2020,168281,10,3,26,10,16
2020,168281,10,4,5,2,3
2020,168281,20,0,87,44,43
2020,168281,20,1,48,26,22
2020,168281,20,2,39,18,21
2020,168281,30,0,21,8,13
2020,168281,30,3,21,8,13
2020,168281,40,0,12,4,8
2020,168281,40,1,2,0,2
2020,168281,40,3,5,2,3
2020,168281,40,4,5,2,3
2020,168281,41,0,11,4,7
2020,168281,41,1,2,0,2
2020,168281,41,3,4,2,2
2020,168281,41,4,5,2,3
2020,168281,42,0,1,0,1
2020,168281,42,3,1,0,1
2020,168281,44,0,11,4,7
2020,168281,44,1,2,0,2
2020,168281,44,3,4,2,2
2020,168281,44,4,5,2,3
2020,168342,0,0,317,167,150
2020,168342,10,0,316,166,150
2020,168342,10,1,150,88,62
2020,168342,10,2,32,14,18
2020,168342,10,3,85,43,42
2020,168342,10,4,4,3,1
2020,168342,10,5,8,2,6
2020,168342,10,6,37,16,21
2020,168342,20,0,181,102,79
2020,168342,20,1,150,88,62
2020,168342,20,2,31,14,17
2020,168342,30,0,82,41,41
2020,168342,30,3,82,41,41
2020,168342,40,0,53,23,30
2020,168342,40,2,1,0,1
2020,168342,40,3,3,2,1
2020,168342,40,4,4,3,1
2020,168342,40,5,8,2,6
2020,168342,40,6,37,16,21
2020,168342,41,0,33,13,20
2020,168342,41,2,1,0,1
2020,168342,41,3,3,2,1
2020,168342,41,4,4,3,1
2020,168342,41,5,8,2,6
2020,168342,41,6,17,6,11
2020,168342,42,0,20,10,10
2020,168342,42,6,20,10,10
2020,168342,44,0,33,13,20
2020,168342,44,2,1,0,1
2020,168342,44,3,3,2,1
2020,168342,44,4,4,3,1
2020,168342,44,5,8,2,6
2020,168342,44,6,17,6,11
2020,168342,50,0,1,1,0
2020,168421,0,0,408,283,125
2020,168421,10,0,407,282,125
2020,168421,10,1,114,86,28
2020,168421,10,2,83,60,23
2020,168421,10,3,71,39,32
2020,168421,10,4,139,97,42
2020,168421,20,0,186,137,49
2020,168421,20,1,109,82,27
2020,168421,20,2,77,55,22
2020,168421,30,0,77,44,33
2020,168421,30,2,6,5,1
2020,168421,30,3,71,39,32
2020,168421,40,0,144,101,43
2020,168421,40,1,5,4,1
2020,168421,40,4,139,97,42
2020,168421,42,0,10,8,2
2020,168421,42,4,10,8,2
2020,168421,43,0,134,93,41
2020,168421,43,1,5,4,1
2020,168421,43,4,129,89,40
2020,168421,50,0,1,1,0
2020,168430,0,0,203,85,118
2020,168430,10,0,203,85,118
2020,168430,10,1,78,30,48
2020,168430,10,2,52,27,25
2020,168430,10,3,62,26,36
2020,168430,10,4,11,2,9
2020,168430,20,0,125,52,73
2020,168430,20,1,78,30,48
2020,168430,20,2,47,22,25
2020,168430,30,0,65,28,37
2020,168430,30,2,5,5,0
2020,168430,30,3,55,22,33
2020,168430,30,4,5,1,4
2020,168430,40,0,13,5,8
2020,168430,40,3,7,4,3
2020,168430,40,4,6,1,5
2020,168430,42,0,13,5,8
2020,168430,42,3,7,4,3
2020,168430,42,4,6,1,5
2020,168528,0,0,87,47,40
2020,168528,10,0,87,47,40
2020,168528,10,1,34,19,15
2020,168528,10,2,23,13,10
2020,168528,10,3,27,13,14
2020,168528,10,4,3,2,1
2020,168528,20,0,57,32,25
2020,168528,20,1,34,19,15
2020,168528,20,2,22,13,9
2020,168528,20,3,1,0,1
2020,168528,30,0,12,7,5
2020,168528,30,2,1,0,1
2020,168528,30,3,11,7,4
2020,168528,40,0,18,8,10
2020,168528,40,3,15,6,9
2020,168528,40,4,3,2,1
2020,168528,41,0,1,0,1
2020,168528,41,3,1,0,1
2020,168528,42,0,17,8,9
2020,168528,42,3,14,6,8
2020,168528,42,4,3,2,1
2020,168528,44,0,1,0,1
2020,168528,44,3,1,0,1
2020,168546,0,0,123,63,60
2020,168546,10,0,123,63,60
2020,168546,10,1,50,29,21
2020,168546,10,2,24,13,11
2020,168546,10,3,44,19,25
2020,168546,10,4,2,1,1
2020,168546,10,5,3,1,2
2020,168546,20,0,74,42,32
2020,168546,20,1,50,29,21
2020,168546,20,2,24,13,11
2020,168546,30,0,30,12,18
2020,168546,30,3,30,12,18
2020,168546,40,0,19,9,10
2020,168546,40,3,14,7,7
2020,168546,40,4,2,1,1
2020,168546,40,5,3,1,2
2020,168546,42,0,19,9,10
2020,168546,42,3,14,7,7
2020,168546,42,4,2,1,1
2020,168546,42,5,3,1,2
2020,168591,0,0,91,45,46
2020,168591,10,0,91,45,46
2020,168591,10,1,29,17,12
2020,168591,10,2,16,11,5
2020,168591,10,3,31,11,20
2020,168591,10,4,14,5,9
2020,168591,10,5,1,1,0
2020,168591,20,0,44,28,16
2020,168591,20,1,28,16,12
2020,168591,20,2,15,11,4
2020,168591,20,3,1,1,0
2020,168591,30,0,30,11,19
2020,168591,30,1,1,1,0
2020,168591,30,2,1,0,1
2020,168591,30,3,28,10,18
2020,168591,40,0,17,6,11
2020,168591,40,3,2,0,2
2020,168591,40,4,14,5,9
2020,168591,40,5,1,1,0
2020,168591,42,0,17,6,11
2020,168591,42,3,2,0,2
2020,168591,42,4,14,5,9
2020,168591,42,5,1,1,0
2020,168607,0,0,45,28,17
2020,168607,10,0,45,28,17
2020,168607,10,6,45,28,17
2020,168607,40,0,45,28,17
2020,168607,40,6,45,28,17
2020,168607,41,0,45,28,17
2020,168607,41,6,45,28,17
2020,168607,44,0,45,28,17
2020,168607,44,6,45,28,17
2020,168740,0,0,199,114,85
2020,168740,10,0,199,114,85
2020,168740,10,1,70,47,23
2020,168740,10,2,61,30,31
2020,168740,10,3,65,35,30
2020,168740,10,4,3,2,1
2020,168740,20,0,63,38,25
2020,168740,20,1,49,31,18
2020,168740,20,2,13,7,6
2020,168740,20,3,1,0,1
2020,168740,30,0,118,67,51
2020,168740,30,1,18,15,3
2020,168740,30,2,43,20,23
2020,168740,30,3,56,32,24
2020,168740,30,4,1,0,1
2020,168740,40,0,18,9,9
2020,168740,40,1,3,1,2
2020,168740,40,2,5,3,2
2020,168740,40,3,8,3,5
2020,168740,40,4,2,2,0
2020,168740,42,0,18,9,9
2020,168740,42,1,3,1,2
2020,168740,42,2,5,3,2
2020,168740,42,3,8,3,5
2020,168740,42,4,2,2,0
2020,168786,0,0,85,48,37
2020,168786,10,0,85,48,37
2020,168786,10,1,25,15,10
2020,168786,10,2,32,19,13
2020,168786,10,3,20,11,9
2020,168786,10,4,8,3,5
2020,168786,20,0,56,34,22
2020,168786,20,1,25,15,10
2020,168786,20,2,26,16,10
2020,168786,20,3,5,3,2
2020,168786,30,0,21,11,10
2020,168786,30,2,6,3,3
2020,168786,30,3,15,8,7
2020,168786,40,0,8,3,5
2020,168786,40,4,8,3,5
2020,168786,41,0,8,3,5
2020,168786,41,4,8,3,5
2020,168786,45,0,8,3,5
2020,168786,45,4,8,3,5
2020,168847,0,0,126,25,101
2020,168847,10,0,126,25,101
2020,168847,10,1,11,0,11
2020,168847,10,2,25,3,22
2020,168847,10,3,18,2,16
2020,168847,10,4,72,20,52
2020,168847,40,0,126,25,101
2020,168847,40,1,11,0,11
2020,168847,40,2,25,3,22
2020,168847,40,3,18,2,16
2020,168847,40,4,72,20,52
2020,168847,42,0,126,25,101
2020,168847,42,1,11,0,11
2020,168847,42,2,25,3,22
2020,168847,42,3,18,2,16
2020,168847,42,4,72,20,52
2020,168883,0,0,37,17,20
2020,168883,10,0,37,17,20
2020,168883,10,6,37,17,20
2020,168883,20,0,37,17,20
2020,168883,20,6,37,17,20
2020,169080,0,0,204,128,76
2020,169080,10,0,194,125,69
2020,169080,10,1,116,80,36
2020,169080,10,2,44,28,16
2020,169080,10,3,34,17,17
2020,169080,20,0,147,98,49
2020,169080,20,1,111,78,33
2020,169080,20,2,36,20,16
2020,169080,30,0,33,15,18
2020,169080,30,1,5,2,3
2020,169080,30,2,4,4,0
2020,169080,30,3,24,9,15
2020,169080,40,0,14,12,2
2020,169080,40,2,4,4,0
2020,169080,40,3,10,8,2
2020,169080,41,0,14,12,2
2020,169080,41,2,4,4,0
2020,169080,41,3,10,8,2
2020,169080,44,0,14,12,2
2020,169080,44,2,4,4,0
2020,169080,44,3,10,8,2
2020,169080,50,0,10,3,7
2020,169099,0,0,13,10,3
2020,169099,10,0,13,10,3
2020,169099,10,1,10,8,2
2020,169099,10,2,3,2,1
2020,169099,20,0,8,7,1
2020,169099,20,1,8,7,1
2020,169099,30,0,5,3,2
2020,169099,30,1,2,1,1
2020,169099,30,2,3,2,1
2020,169220,0,0,15,8,7
2020,169220,10,0,15,8,7
2020,169220,10,1,14,8,6
2020,169220,10,6,1,0,1
2020,169220,40,0,15,8,7
2020,169220,40,1,14,8,6
2020,169220,40,6,1,0,1
2020,169220,41,0,14,7,7
2020,169220,41,1,13,7,6
2020,169220,41,6,1,0,1
2020,169220,42,0,1,1,0
2020,169220,42,1,1,1,0
2020,169220,44,0,14,7,7
2020,169220,44,1,13,7,6
2020,169220,44,6,1,0,1
2020,169248,0,0,717,396,321
2020,169248,10,0,717,396,321
2020,169248,10,1,322,198,124
2020,169248,10,2,147,73,74
2020,169248,10,3,92,46,46
2020,169248,10,4,1,1,0
2020,169248,10,5,145,75,70
2020,169248,10,6,10,3,7
2020,169248,20,0,449,256,193
2020,169248,20,1,316,194,122
2020,169248,20,2,128,60,68
2020,169248,20,3,5,2,3
2020,169248,30,0,98,55,43
2020,169248,30,1,1,1,0
2020,169248,30,2,16,12,4
2020,169248,30,3,81,42,39
2020,169248,40,0,170,85,85
2020,169248,40,1,5,3,2
2020,169248,40,2,3,1,2
2020,169248,40,3,6,2,4
2020,169248,40,4,1,1,0
2020,169248,40,5,145,75,70
2020,169248,40,6,10,3,7
2020,169248,41,0,128,66,62
2020,169248,41,1,5,3,2
2020,169248,41,2,3,1,2
2020,169248,41,3,6,2,4
2020,169248,41,4,1,1,0
2020,169248,41,5,113,59,54
2020,169248,42,0,42,19,23
2020,169248,42,5,32,16,16
2020,169248,42,6,10,3,7
2020,169248,44,0,128,66,62
2020,169248,44,1,5,3,2
2020,169248,44,2,3,1,2
2020,169248,44,3,6,2,4
2020,169248,44,4,1,1,0
2020,169248,44,5,113,59,54
2020,169275,0,0,137,54,83
2020,169275,10,0,137,54,83
2020,169275,10,6,137,54,83
2020,169275,40,0,137,54,83
2020,169275,40,6,137,54,83
2020,169275,42,0,130,53,77
2020,169275,42,6,130,53,77
2020,169275,43,0,7,1,6
2020,169275,43,6,7,1,6
2020,169327,0,0,6,4,2
2020,169327,10,0,6,4,2
2020,169327,10,2,6,4,2
2020,169327,40,0,6,4,2
2020,169327,40,2,6,4,2
2020,169327,42,0,6,4,2
2020,169327,42,2,6,4,2
2020,169363,0,0,58,30,28
2020,169363,10,0,57,29,28
2020,169363,10,1,11,7,4
2020,169363,10,2,13,5,8
2020,169363,10,3,32,17,15
2020,169363,10,4,1,0,1
2020,169363,40,0,57,29,28
2020,169363,40,1,11,7,4
2020,169363,40,2,13,5,8
2020,169363,40,3,32,17,15
2020,169363,40,4,1,0,1
2020,169363,41,0,46,21,25
2020,169363,41,1,10,6,4
2020,169363,41,2,13,5,8
2020,169363,41,3,23,10,13
2020,169363,42,0,11,8,3
2020,169363,42,1,1,1,0
2020,169363,42,3,9,7,2
2020,169363,42,4,1,0,1
2020,169363,44,0,36,15,21
2020,169363,44,2,13,5,8
2020,169363,44,3,23,10,13
2020,169363,45,0,10,6,4
2020,169363,45,1,10,6,4
2020,169363,50,0,1,1,0
2020,169424,0,0,10,5,5
2020,169424,10,0,10,5,5
2020,169424,10,4,10,5,5
2020,169424,40,0,10,5,5
2020,169424,40,4,10,5,5
2020,169424,42,0,10,5,5
2020,169424,42,4,10,5,5
2020,169442,0,0,53,37,16
2020,169442,10,0,53,37,16
2020,169442,10,1,11,8,3
2020,169442,10,2,22,19,3
2020,169442,10,3,18,9,9
2020,169442,10,4,2,1,1
2020,169442,40,0,53,37,16
2020,169442,40,1,11,8,3
2020,169442,40,2,22,19,3
2020,169442,40,3,18,9,9
2020,169442,40,4,2,1,1
2020,169442,41,0,53,37,16
2020,169442,41,1,11,8,3
2020,169442,41,2,22,19,3
2020,169442,41,3,18,9,9
2020,169442,41,4,2,1,1
2020,169442,44,0,53,37,16
2020,169442,44,1,11,8,3
2020,169442,44,2,22,19,3
2020,169442,44,3,18,9,9
2020,169442,44,4,2,1,1
2020,169479,0,0,115,36,79
2020,169479,10,0,115,36,79
2020,169479,10,1,4,3,1
2020,169479,10,2,25,12,13
2020,169479,10,3,39,13,26
2020,169479,10,4,47,8,39
2020,169479,40,0,115,36,79
2020,169479,40,1,4,3,1
2020,169479,40,2,25,12,13
2020,169479,40,3,39,13,26
2020,169479,40,4,47,8,39
2020,169479,41,0,115,36,79
2020,169479,41,1,4,3,1
2020,169479,41,2,25,12,13
2020,169479,41,3,39,13,26
2020,169479,41,4,47,8,39
2020,169479,45,0,115,36,79
2020,169479,45,1,4,3,1
2020,169479,45,2,25,12,13
2020,169479,45,3,39,13,26
2020,169479,45,4,47,8,39
2020,169521,0,0,176,82,94
2020,169521,10,0,176,82,94
2020,169521,10,1,58,27,31
2020,169521,10,2,74,37,37
2020,169521,10,3,22,8,14
2020,169521,10,4,22,10,12
2020,169521,20,0,141,65,76
2020,169521,20,1,58,27,31
2020,169521,20,2,74,37,37
2020,169521,20,3,9,1,8
2020,169521,30,0,31,14,17
2020,169521,30,3,12,6,6
2020,169521,30,4,19,8,11
2020,169521,40,0,4,3,1
2020,169521,40,3,1,1,0
2020,169521,40,4,3,2,1
2020,169521,42,0,4,3,1
2020,169521,42,3,1,1,0
2020,169521,42,4,3,2,1
2020,169655,0,0,62,51,11
2020,169655,10,0,62,51,11
2020,169655,10,4,62,51,11
2020,169655,40,0,62,51,11
2020,169655,40,4,62,51,11
2020,169655,41,0,62,51,11
2020,169655,41,4,62,51,11
2020,169655,45,0,62,51,11
2020,169655,45,4,62,51,11
2020,169716,0,0,315,151,164
2020,169716,10,0,315,151,164
2020,169716,10,1,67,42,25
2020,169716,10,2,118,52,66
2020,169716,10,3,108,46,62
2020,169716,10,4,14,4,10
2020,169716,10,5,8,7,1
2020,169716,20,0,152,77,75
2020,169716,20,1,67,42,25
2020,169716,20,2,83,35,48
2020,169716,20,3,2,0,2
2020,169716,30,0,77,34,43
2020,169716,30,2,11,5,6
2020,169716,30,3,65,28,37
2020,169716,30,5,1,1,0
2020,169716,40,0,86,40,46
2020,169716,40,2,24,12,12
2020,169716,40,3,41,18,23
2020,169716,40,4,14,4,10
2020,169716,40,5,7,6,1
2020,169716,41,0,22,11,11
2020,169716,41,2,1,0,1
2020,169716,41,3,4,1,3
2020,169716,41,4,10,4,6
2020,169716,41,5,7,6,1
2020,169716,42,0,64,29,35
2020,169716,42,2,23,12,11
2020,169716,42,3,37,17,20
2020,169716,42,4,4,0,4
2020,169716,44,0,22,11,11
2020,169716,44,2,1,0,1
2020,169716,44,3,4,1,3
2020,169716,44,4,10,4,6
2020,169716,44,5,7,6,1
2020,169798,0,0,650,327,323
2020,169798,10,0,650,327,323
2020,169798,10,1,313,174,139
2020,169798,10,2,176,72,104
2020,169798,10,3,84,46,38
2020,169798,10,4,2,1,1
2020,169798,10,5,75,34,41
2020,169798,20,0,491,248,243
2020,169798,20,1,313,174,139
2020,169798,20,2,173,71,102
2020,169798,20,3,4,2,2
2020,169798,20,4,1,1,0
2020,169798,30,0,84,45,39
2020,169798,30,2,3,1,2
2020,169798,30,3,80,44,36
2020,169798,30,4,1,0,1
2020,169798,40,0,75,34,41
2020,169798,40,5,75,34,41
2020,169798,41,0,75,34,41
2020,169798,41,5,75,34,41
2020,169798,44,0,75,34,41
2020,169798,44,5,75,34,41
2020,169910,0,0,485,264,221
2020,169910,10,0,485,264,221
2020,169910,10,1,170,98,72
2020,169910,10,2,149,88,61
2020,169910,10,3,86,43,43
2020,169910,10,4,2,1,1
2020,169910,10,6,78,34,44
2020,169910,20,0,327,187,140
2020,169910,20,1,170,98,72
2020,169910,20,2,137,81,56
2020,169910,20,3,19,7,12
2020,169910,20,4,1,1,0
2020,169910,30,0,79,42,37
2020,169910,30,2,12,7,5
2020,169910,30,3,66,35,31
2020,169910,30,4,1,0,1
2020,169910,40,0,79,35,44
2020,169910,40,3,1,1,0
2020,169910,40,6,78,34,44
2020,169910,41,0,2,1,1
2020,169910,41,6,2,1,1
2020,169910,42,0,59,24,35
2020,169910,42,3,1,1,0
2020,169910,42,6,58,23,35
2020,169910,43,0,18,10,8
2020,169910,43,6,18,10,8
2020,169910,44,0,2,1,1
2020,169910,44,6,2,1,1
2020,169974,0,0,26,14,12
2020,169974,10,0,26,14,12
2020,169974,10,1,17,11,6
2020,169974,10,4,9,3,6
2020,169974,20,0,17,11,6
2020,169974,20,1,17,11,6
2020,169974,30,0,4,0,4
2020,169974,30,4,4,0,4
2020,169974,40,0,5,3,2
2020,169974,40,4,5,3,2
2020,169974,42,0,5,3,2
2020,169974,42,4,5,3,2
2020,169983,0,0,109,83,26
2020,169983,10,0,109,83,26
2020,169983,10,1,33,28,5
2020,169983,10,2,35,24,11
2020,169983,10,3,21,18,3
2020,169983,10,5,20,13,7
2020,169983,20,0,69,53,16
2020,169983,20,1,33,28,5
2020,169983,20,2,35,24,11
2020,169983,20,3,1,1,0
2020,169983,30,0,17,14,3
2020,169983,30,3,17,14,3
2020,169983,40,0,23,16,7
2020,169983,40,3,3,3,0
2020,169983,40,5,20,13,7
2020,169983,41,0,1,1,0
2020,169983,41,5,1,1,0
2020,169983,42,0,22,15,7
2020,169983,42,3,3,3,0
2020,169983,42,5,19,12,7
2020,169983,44,0,1,1,0
2020,169983,44,5,1,1,0
2020,169992,0,0,32,15,17
2020,169992,10,0,32,15,17
2020,169992,10,6,32,15,17
2020,169992,40,0,32,15,17
2020,169992,40,6,32,15,17
2020,169992,42,0,32,15,17
2020,169992,42,6,32,15,17
2020,170000,0,0,20,14,6
2020,170000,10,0,19,13,6
2020,170000,10,1,6,5,1
2020,170000,10,2,6,2,4
2020,170000,10,3,7,6,1
2020,170000,40,0,19,13,6
2020,170000,40,1,6,5,1
2020,170000,40,2,6,2,4
2020,170000,40,3,7,6,1
2020,170000,41,0,17,12,5
2020,170000,41,1,6,5,1
2020,170000,41,2,4,1,3
2020,170000,41,3,7,6,1
2020,170000,42,0,2,1,1
2020,170000,42,2,2,1,1
2020,170000,44,0,17,12,5
2020,170000,44,1,6,5,1
2020,170000,44,2,4,1,3
2020,170000,44,3,7,6,1
2020,170000,50,0,1,1,0
2020,170037,0,0,64,37,27
2020,170037,10,0,64,37,27
2020,170037,10,1,20,17,3
2020,170037,10,2,11,5,6
2020,170037,10,3,32,14,18
2020,170037,10,4,1,1,0
2020,170037,20,0,30,22,8
2020,170037,20,1,20,17,3
2020,170037,20,2,10,5,5
2020,170037,30,0,30,13,17
2020,170037,30,3,30,13,17
2020,170037,40,0,4,2,2
2020,170037,40,2,1,0,1
2020,170037,40,3,2,1,1
2020,170037,40,4,1,1,0
2020,170037,42,0,4,2,2
2020,170037,42,2,1,0,1
2020,170037,42,3,2,1,1
2020,170037,42,4,1,1,0
2020,170055,0,0,211,104,107
2020,170055,10,0,211,104,107
2020,170055,10,1,103,57,46
2020,170055,10,2,18,9,9
2020,170055,10,3,75,34,41
2020,170055,10,4,15,4,11
2020,170055,20,0,174,87,87
2020,170055,20,1,103,57,46
2020,170055,20,2,18,9,9
2020,170055,20,3,48,20,28
2020,170055,20,4,5,1,4
2020,170055,30,0,33,14,19
2020,170055,30,3,25,12,13
2020,170055,30,4,8,2,6
2020,170055,40,0,4,3,1
2020,170055,40,3,2,2,0
2020,170055,40,4,2,1,1
2020,170055,41,0,4,3,1
2020,170055,41,3,2,2,0
2020,170055,41,4,2,1,1
2020,170055,44,0,4,3,1
2020,170055,44,3,2,2,0
2020,170055,44,4,2,1,1
2020,170082,0,0,1101,549,552
2020,170082,10,0,1101,549,552
2020,170082,10,1,311,195,116
2020,170082,10,2,329,165,164
2020,170082,10,3,205,86,119
2020,170082,10,4,7,3,4
2020,170082,10,6,249,100,149
2020,170082,20,0,654,360,294
2020,170082,20,1,308,192,116
2020,170082,20,2,321,159,162
2020,170082,20,3,23,8,15
2020,170082,20,4,2,1,1
2020,170082,30,0,198,89,109
2020,170082,30,1,3,3,0
2020,170082,30,2,8,6,2
2020,170082,30,3,182,78,104
2020,170082,30,4,5,2,3
2020,170082,40,0,249,100,149
2020,170082,40,6,249,100,149
2020,170082,41,0,137,48,89
2020,170082,41,6,137,48,89
2020,170082,42,0,112,52,60
2020,170082,42,6,112,52,60
2020,170082,44,0,137,48,89
2020,170082,44,6,137,48,89
2020,170091,0,0,9,7,2
2020,170091,10,0,9,7,2
2020,170091,10,1,9,7,2
2020,170091,40,0,9,7,2
2020,170091,40,1,9,7,2
2020,170091,42,0,9,7,2
2020,170091,42,1,9,7,2
2020,170240,0,0,164,76,88
2020,170240,10,0,164,76,88
2020,170240,10,4,164,76,88
2020,170240,20,0,135,65,70
2020,170240,20,4,135,65,70
2020,170240,30,0,29,11,18
2020,170240,30,4,29,11,18
2020,170286,0,0,149,112,37
2020,170286,10,0,120,98,22
2020,170286,10,1,48,41,7
2020,170286,10,2,37,32,5
2020,170286,10,3,33,24,9
2020,170286,10,4,1,0,1
2020,170286,10,5,1,1,0
2020,170286,20,0,89,75,14
2020,170286,20,1,48,41,7
2020,170286,20,2,31,26,5
2020,170286,20,3,10,8,2
2020,170286,30,0,21,16,5
2020,170286,30,2,3,3,0
2020,170286,30,3,18,13,5
2020,170286,40,0,10,7,3
2020,170286,40,2,3,3,0
2020,170286,40,3,5,3,2
2020,170286,40,4,1,0,1
2020,170286,40,5,1,1,0
2020,170286,41,0,7,5,2
2020,170286,41,2,3,3,0
2020,170286,41,3,4,2,2
2020,170286,42,0,3,2,1
2020,170286,42,3,1,1,0
2020,170286,42,4,1,0,1
2020,170286,42,5,1,1,0
2020,170286,44,0,7,5,2
2020,170286,44,2,3,3,0
2020,170286,44,3,4,2,2
2020,170286,50,0,29,14,15
2020,170301,0,0,226,110,116
2020,170301,10,0,226,110,116
2020,170301,10,1,70,44,26
2020,170301,10,2,68,34,34
2020,170301,10,3,88,32,56
2020,170301,20,0,130,73,57
2020,170301,20,1,70,44,26
2020,170301,20,2,60,29,31
2020,170301,30,0,44,20,24
2020,170301,30,2,3,1,2
2020,170301,30,3,41,19,22
2020,170301,40,0,52,17,35
2020,170301,40,2,5,4,1
2020,170301,40,3,47,13,34
2020,170301,41,0,1,1,0
2020,170301,41,3,1,1,0
2020,170301,42,0,51,16,35
2020,170301,42,2,5,4,1
2020,170301,42,3,46,12,34
2020,170301,44,0,1,1,0
2020,170301,44,3,1,1,0
2020,170444,0,0,66,31,35
2020,170444,10,0,65,31,34
2020,170444,10,1,25,13,12
2020,170444,10,2,13,4,9
2020,170444,10,3,11,6,5
2020,170444,10,4,13,6,7
2020,170444,10,6,3,2,1
2020,170444,20,0,44,20,24
2020,170444,20,1,19,8,11
2020,170444,20,2,12,4,8
2020,170444,20,3,11,6,5
2020,170444,20,4,1,1,0
2020,170444,20,6,1,1,0
2020,170444,30,0,8,3,5
2020,170444,30,4,8,3,5
2020,170444,40,0,13,8,5
2020,170444,40,1,6,5,1
2020,170444,40,2,1,0,1
2020,170444,40,4,4,2,2
2020,170444,40,6,2,1,1
2020,170444,42,0,13,8,5
2020,170444,42,1,6,5,1
2020,170444,42,2,1,0,1
2020,170444,42,4,4,2,2
2020,170444,42,6,2,1,1
2020,170444,50,0,1,0,1
2020,170532,0,0,114,53,61
2020,170532,10,0,114,53,61
2020,170532,10,1,38,20,18
2020,170532,10,2,29,13,16
2020,170532,10,3,26,12,14
2020,170532,10,4,21,8,13
2020,170532,20,0,67,33,34
2020,170532,20,1,38,20,18
2020,170532,20,2,29,13,16
2020,170532,30,0,22,10,12
2020,170532,30,3,22,10,12
2020,170532,40,0,25,10,15
2020,170532,40,3,4,2,2
2020,170532,40,4,21,8,13
2020,170532,41,0,12,5,7
2020,170532,41,3,2,1,1
2020,170532,41,4,10,4,6
2020,170532,42,0,13,5,8
2020,170532,42,3,2,1,1
2020,170532,42,4,11,4,7
2020,170532,44,0,12,5,7
2020,170532,44,3,2,1,1
2020,170532,44,4,10,4,6
2020,170541,0,0,116,64,52
2020,170541,10,0,116,64,52
2020,170541,10,4,116,64,52
2020,170541,20,0,78,46,32
2020,170541,20,4,78,46,32
2020,170541,30,0,38,18,20
2020,170541,30,4,38,18,20
2020,170550,0,0,83,36,47
2020,170550,10,0,83,36,47
2020,170550,10,1,69,31,38
2020,170550,10,4,14,5,9
2020,170550,20,0,69,31,38
2020,170550,20,1,69,31,38
2020,170550,30,0,13,5,8
2020,170550,30,4,13,5,8
2020,170550,40,0,1,0,1
2020,170550,40,4,1,0,1
2020,170550,43,0,1,0,1
2020,170550,43,4,1,0,1
2020,170587,0,0,22,12,10
2020,170587,10,0,22,12,10
2020,170587,10,4,22,12,10
2020,170587,40,0,22,12,10
2020,170587,40,4,22,12,10
2020,170587,42,0,22,12,10
2020,170587,42,4,22,12,10
2020,170620,0,0,52,27,25
2020,170620,10,0,52,27,25
2020,170620,10,4,45,23,22
2020,170620,10,5,4,2,2
2020,170620,10,6,3,2,1
2020,170620,40,0,52,27,25
2020,170620,40,4,45,23,22
2020,170620,40,5,4,2,2
2020,170620,40,6,3,2,1
2020,170620,41,0,48,25,23
2020,170620,41,4,45,23,22
2020,170620,41,6,3,2,1
2020,170620,42,0,4,2,2
2020,170620,42,5,4,2,2
2020,170620,44,0,48,25,23
2020,170620,44,4,45,23,22
2020,170620,44,6,3,2,1
2020,170639,0,0,93,60,33
2020,170639,10,0,90,57,33
2020,170639,10,1,18,16,2
2020,170639,10,2,23,17,6
2020,170639,10,3,37,15,22
2020,170639,10,4,6,5,1
2020,170639,10,6,6,4,2
2020,170639,20,0,57,36,21
2020,170639,20,1,18,16,2
2020,170639,20,2,22,16,6
2020,170639,20,3,17,4,13
2020,170639,30,0,24,15,9
2020,170639,30,2,1,1,0
2020,170639,30,3,17,10,7
2020,170639,30,6,6,4,2
2020,170639,40,0,9,6,3
2020,170639,40,3,3,1,2
2020,170639,40,4,6,5,1
2020,170639,41,0,1,1,0
2020,170639,41,4,1,1,0
2020,170639,42,0,3,2,1
2020,170639,42,3,1,0,1
2020,170639,42,4,2,2,0
2020,170639,43,0,5,3,2
2020,170639,43,3,2,1,1
2020,170639,43,4,3,2,1
2020,170639,44,0,1,1,0
2020,170639,44,4,1,1,0
2020,170639,50,0,3,3,0
2020,170657,0,0,182,95,87
2020,170657,10,0,182,95,87
2020,170657,10,1,182,95,87
2020,170657,40,0,182,95,87
2020,170657,40,1,182,95,87
2020,170657,42,0,182,95,87
2020,170657,42,1,182,95,87
2020,170675,0,0,108,75,33
2020,170675,10,0,108,75,33
2020,170675,10,1,9,6,3
2020,170675,10,2,24,20,4
2020,170675,10,3,42,28,14
2020,170675,10,5,32,20,12
2020,170675,10,6,1,1,0
2020,170675,20,0,39,33,6
2020,170675,20,1,8,6,2
2020,170675,20,2,24,20,4
2020,170675,20,3,7,7,0
2020,170675,30,0,32,19,13
2020,170675,30,3,30,17,13
2020,170675,30,5,2,2,0
2020,170675,40,0,37,23,14
2020,170675,40,1,1,0,1
2020,170675,40,3,5,4,1
2020,170675,40,5,30,18,12
2020,170675,40,6,1,1,0
2020,170675,42,0,37,23,14
2020,170675,42,1,1,0,1
2020,170675,42,3,5,4,1
2020,170675,42,5,30,18,12
2020,170675,42,6,1,1,0
2020,170790,0,0,196,95,101
2020,170790,10,0,196,95,101
2020,170790,10,1,168,84,84
2020,170790,10,4,25,10,15
2020,170790,10,6,3,1,2
2020,170790,20,0,168,84,84
2020,170790,20,1,168,84,84
2020,170790,30,0,21,8,13
2020,170790,30,4,21,8,13
2020,170790,40,0,7,3,4
2020,170790,40,4,4,2,2
2020,170790,40,6,3,1,2
2020,170790,41,0,7,3,4
2020,170790,41,4,4,2,2
2020,170790,41,6,3,1,2
2020,170790,45,0,7,3,4
2020,170790,45,4,4,2,2
2020,170790,45,6,3,1,2
2020,170806,0,0,91,18,73
2020,170806,10,0,91,18,73
2020,170806,10,1,17,8,9
2020,170806,10,2,19,4,15
2020,170806,10,3,52,6,46
2020,170806,10,4,3,0,3
2020,170806,40,0,91,18,73
2020,170806,40,1,17,8,9
2020,170806,40,2,19,4,15
2020,170806,40,3,52,6,46
2020,170806,40,4,3,0,3
2020,170806,42,0,91,18,73
2020,170806,42,1,17,8,9
2020,170806,42,2,19,4,15
2020,170806,42,3,52,6,46
2020,170806,42,4,3,0,3
2020,170967,0,0,34,16,18
2020,170967,10,0,34,16,18
2020,170967,10,1,12,7,5
2020,170967,10,2,13,6,7
2020,170967,10,3,9,3,6
2020,170967,20,0,13,7,6
2020,170967,20,1,11,6,5
2020,170967,20,2,1,0,1
2020,170967,20,3,1,1,0
2020,170967,30,0,21,9,12
2020,170967,30,1,1,1,0
2020,170967,30,2,12,6,6
2020,170967,30,3,8,2,6
2020,170976,0,0,6678,3897,2781
2020,170976,10,0,6678,3897,2781
2020,170976,10,1,1737,1227,510
2020,170976,10,2,1073,600,473
2020,170976,10,3,1463,768,695
2020,170976,10,4,163,75,88
2020,170976,10,5,725,307,418
2020,170976,10,6,1517,920,597
2020,170976,20,0,2162,1451,711
2020,170976,20,1,1456,1053,403
2020,170976,20,2,706,398,308
2020,170976,30,0,656,353,303
2020,170976,30,1,1,1,0
2020,170976,30,2,15,8,7
2020,170976,30,3,640,344,296
2020,170976,40,0,3860,2093,1767
2020,170976,40,1,280,173,107
2020,170976,40,2,352,194,158
2020,170976,40,3,823,424,399
2020,170976,40,4,163,75,88
2020,170976,40,5,725,307,418
2020,170976,40,6,1517,920,597
2020,170976,41,0,3787,2059,1728
2020,170976,41,1,277,172,105
2020,170976,41,2,349,192,157
2020,170976,41,3,821,423,398
2020,170976,41,4,163,75,88
2020,170976,41,5,660,277,383
2020,170976,41,6,1517,920,597
2020,170976,43,0,73,34,39
2020,170976,43,1,3,1,2
2020,170976,43,2,3,2,1
2020,170976,43,3,2,1,1
2020,170976,43,5,65,30,35
2020,170976,45,0,3787,2059,1728
2020,170976,45,1,277,172,105
2020,170976,45,2,349,192,157
2020,170976,45,3,821,423,398
2020,170976,45,4,163,75,88
2020,170976,45,5,660,277,383
2020,170976,45,6,1517,920,597
2020,171100,0,0,2996,1695,1301
2020,171100,10,0,2758,1590,1168
2020,171100,10,1,898,642,256
2020,171100,10,2,720,406,314
2020,171100,10,3,933,457,476
2020,171100,10,4,202,82,120
2020,171100,10,5,5,3,2
2020,171100,20,0,1405,917,488
2020,171100,20,1,829,596,233
2020,171100,20,2,576,321,255
2020,171100,30,0,449,238,211
2020,171100,30,2,12,7,5
2020,171100,30,3,437,231,206
2020,171100,40,0,904,435,469
2020,171100,40,1,69,46,23
2020,171100,40,2,132,78,54
2020,171100,40,3,496,226,270
2020,171100,40,4,202,82,120
2020,171100,40,5,5,3,2
2020,171100,41,0,334,169,165
2020,171100,41,1,36,25,11
2020,171100,41,2,73,48,25
2020,171100,41,3,194,83,111
2020,171100,41,4,29,11,18
2020,171100,41,5,2,2,0
2020,171100,42,0,525,245,280
2020,171100,42,1,26,17,9
2020,171100,42,2,52,25,27
2020,171100,42,3,282,134,148
2020,171100,42,4,162,68,94
2020,171100,42,5,3,1,2
2020,171100,43,0,45,21,24
2020,171100,43,1,7,4,3
2020,171100,43,2,7,5,2
2020,171100,43,3,20,9,11
2020,171100,43,4,11,3,8
2020,171100,44,0,334,169,165
2020,171100,44,1,36,25,11
2020,171100,44,2,73,48,25
2020,171100,44,3,194,83,111
2020,171100,44,4,29,11,18
2020,171100,44,5,2,2,0
2020,171100,50,0,238,105,133
2020,171128,0,0,396,274,122
2020,171128,10,0,396,274,122
2020,171128,10,1,115,91,24
2020,171128,10,2,117,84,33
2020,171128,10,3,83,52,31
2020,171128,10,4,21,15,6
2020,171128,10,5,60,32,28
2020,171128,20,0,227,171,56
2020,171128,20,1,115,91,24
2020,171128,20,2,112,80,32
2020,171128,30,0,88,56,32
2020,171128,30,2,5,4,1
2020,171128,30,3,83,52,31
2020,171128,40,0,81,47,34
2020,171128,40,4,21,15,6
2020,171128,40,5,60,32,28
2020,171128,41,0,74,43,31
2020,171128,41,4,14,11,3
2020,171128,41,5,60,32,28
2020,171128,42,0,7,4,3
2020,171128,42,4,7,4,3
2020,171128,44,0,25,16,9
2020,171128,44,5,25,16,9
2020,171128,45,0,49,27,22
2020,171128,45,4,14,11,3
2020,171128,45,5,35,16,19
2020,171137,0,0,354,213,141
2020,171137,10,0,354,213,141
2020,171137,10,1,86,59,27
2020,171137,10,2,120,68,52
2020,171137,10,3,65,47,18
2020,171137,10,5,83,39,44
2020,171137,20,0,201,124,77
2020,171137,20,1,85,58,27
2020,171137,20,2,116,66,50
2020,171137,30,0,68,48,20
2020,171137,30,2,3,1,2
2020,171137,30,3,65,47,18
2020,171137,40,0,85,41,44
2020,171137,40,1,1,1,0
2020,171137,40,2,1,1,0
2020,171137,40,5,83,39,44
2020,171137,41,0,81,40,41
2020,171137,41,1,1,1,0
2020,171137,41,5,80,39,41
2020,171137,43,0,4,1,3
2020,171137,43,2,1,1,0
2020,171137,43,5,3,0,3
2020,171137,45,0,81,40,41
2020,171137,45,1,1,1,0
2020,171137,45,5,80,39,41
2020,171146,0,0,273,118,155
2020,171146,10,0,273,118,155
2020,171146,10,1,40,31,9
2020,171146,10,2,99,43,56
2020,171146,10,3,61,19,42
2020,171146,10,4,6,1,5
2020,171146,10,5,67,24,43
2020,171146,20,0,134,73,61
2020,171146,20,1,40,31,9
2020,171146,20,2,94,42,52
2020,171146,30,0,47,17,30
2020,171146,30,2,1,0,1
2020,171146,30,3,45,17,28
2020,171146,30,4,1,0,1
2020,171146,40,0,92,28,64
2020,171146,40,2,4,1,3
2020,171146,40,3,16,2,14
2020,171146,40,4,5,1,4
2020,171146,40,5,67,24,43
2020,171146,41,0,81,26,55
2020,171146,41,2,4,1,3
2020,171146,41,3,16,2,14
2020,171146,41,4,1,0,1
2020,171146,41,5,60,23,37
2020,171146,43,0,11,2,9
2020,171146,43,4,4,1,3
2020,171146,43,5,7,1,6
2020,171146,45,0,81,26,55
2020,171146,45,2,4,1,3
2020,171146,45,3,16,2,14
2020,171146,45,4,1,0,1
2020,171146,45,5,60,23,37
2020,171155,0,0,53,23,30
2020,171155,10,0,53,23,30
2020,171155,10,1,20,10,10
2020,171155,10,2,8,3,5
2020,171155,10,3,9,4,5
2020,171155,10,4,16,6,10
2020,171155,40,0,53,23,30
2020,171155,40,1,20,10,10
2020,171155,40,2,8,3,5
2020,171155,40,3,9,4,5
2020,171155,40,4,16,6,10
2020,171155,42,0,53,23,30
2020,171155,42,1,20,10,10
2020,171155,42,2,8,3,5
2020,171155,42,3,9,4,5
2020,171155,42,4,16,6,10
2020,171225,0,0,44,22,22
2020,171225,10,0,44,22,22
2020,171225,10,1,8,6,2
2020,171225,10,2,8,6,2
2020,171225,10,3,20,5,15
2020,171225,10,4,8,5,3
2020,171225,20,0,34,16,18
2020,171225,20,1,7,5,2
2020,171225,20,2,7,5,2
2020,171225,20,3,15,3,12
2020,171225,20,4,5,3,2
2020,171225,30,0,10,6,4
2020,171225,30,1,1,1,0
2020,171225,30,2,1,1,0
2020,171225,30,3,5,2,3
2020,171225,30,4,3,2,1
2020,171234,0,0,31,12,19
2020,171234,10,0,31,12,19
2020,171234,10,4,31,12,19
2020,171234,20,0,22,7,15
2020,171234,20,4,22,7,15
2020,171234,30,0,9,5,4
2020,171234,30,4,9,5,4
2020,171304,0,0,77,44,33
2020,171304,10,0,77,44,33
2020,171304,10,6,77,44,33
2020,171304,40,0,77,44,33
2020,171304,40,6,77,44,33
2020,171304,42,0,77,44,33
2020,171304,42,6,77,44,33
2020,171395,0,0,30,17,13
2020,171395,10,0,27,14,13
2020,171395,10,1,27,14,13
2020,171395,40,0,27,14,13
2020,171395,40,1,27,14,13
2020,171395,43,0,27,14,13
2020,171395,43,1,27,14,13
2020,171395,50,0,3,3,0
2020,171456,0,0,296,170,126
2020,171456,10,0,296,170,126
2020,171456,10,1,114,72,42
2020,171456,10,2,66,34,32
2020,171456,10,3,69,43,26
2020,171456,10,4,29,10,19
2020,171456,10,6,18,11,7
2020,171456,20,0,170,100,70
2020,171456,20,1,111,70,41
2020,171456,20,2,58,29,29
2020,171456,20,3,1,1,0
2020,171456,30,0,43,30,13
2020,171456,30,2,2,1,1
2020,171456,30,3,40,29,11
2020,171456,30,4,1,0,1
2020,171456,40,0,83,40,43
2020,171456,40,1,3,2,1
2020,171456,40,2,6,4,2
2020,171456,40,3,28,13,15
2020,171456,40,4,28,10,18
2020,171456,40,6,18,11,7
2020,171456,41,0,47,24,23
2020,171456,41,1,3,2,1
2020,171456,41,2,6,4,2
2020,171456,41,3,15,7,8
2020,171456,41,4,16,6,10
2020,171456,41,6,7,5,2
2020,171456,42,0,28,11,17
2020,171456,42,3,13,6,7
2020,171456,42,4,12,4,8
2020,171456,42,6,3,1,2
2020,171456,43,0,8,5,3
2020,171456,43,6,8,5,3
2020,171456,44,0,24,13,11
2020,171456,44,3,10,6,4
2020,171456,44,4,11,4,7
2020,171456,44,6,3,3,0
2020,171456,45,0,23,11,12
2020,171456,45,1,3,2,1
2020,171456,45,2,6,4,2
2020,171456,45,3,5,1,4
2020,171456,45,4,5,2,3
2020,171456,45,6,4,2,2
2020,171483,0,0,80,47,33
2020,171483,10,0,80,47,33
2020,171483,10,6,80,47,33
2020,171483,40,0,80,47,33
2020,171483,40,6,80,47,33
2020,171483,42,0,80,47,33
2020,171483,42,6,80,47,33
2020,171492,0,0,48,30,18
2020,171492,10,0,48,30,18
2020,171492,10,1,3,2,1
2020,171492,10,2,14,8,6
2020,171492,10,3,31,20,11
2020,171492,40,0,48,30,18
2020,171492,40,1,3,2,1
2020,171492,40,2,14,8,6
2020,171492,40,3,31,20,11
2020,171492,42,0,48,30,18
2020,171492,42,1,3,2,1
2020,171492,42,2,14,8,6
2020,171492,42,3,31,20,11
2020,171535,0,0,198,91,107
2020,171535,10,0,198,91,107
2020,171535,10,6,198,91,107
2020,171535,40,0,198,91,107
2020,171535,40,6,198,91,107
2020,171535,41,0,194,90,104
2020,171535,41,6,194,90,104
2020,171535,42,0,2,1,1
2020,171535,42,6,2,1,1
2020,171535,43,0,2,0,2
2020,171535,43,6,2,0,2
2020,171535,44,0,2,0,2
2020,171535,44,6,2,0,2
2020,171535,45,0,192,90,102
2020,171535,45,6,192,90,102
2020,171571,0,0,637,328,309
2020,171571,10,0,637,328,309
2020,171571,10,1,153,102,51
2020,171571,10,2,247,126,121
2020,171571,10,3,172,83,89
2020,171571,10,4,65,17,48
2020,171571,20,0,407,224,183
2020,171571,20,1,150,101,49
2020,171571,20,2,237,120,117
2020,171571,20,4,20,3,17
2020,171571,30,0,176,83,93
2020,171571,30,2,5,3,2
2020,171571,30,3,144,70,74
2020,171571,30,4,27,10,17
2020,171571,40,0,54,21,33
2020,171571,40,1,3,1,2
2020,171571,40,2,5,3,2
2020,171571,40,3,28,13,15
2020,171571,40,4,18,4,14
2020,171571,41,0,25,10,15
2020,171571,41,1,1,1,0
2020,171571,41,2,5,3,2
2020,171571,41,3,4,2,2
2020,171571,41,4,15,4,11
2020,171571,42,0,29,11,18
2020,171571,42,1,2,0,2
2020,171571,42,3,24,11,13
2020,171571,42,4,3,0,3
2020,171571,44,0,25,10,15
2020,171571,44,1,1,1,0
2020,171571,44,2,5,3,2
2020,171571,44,3,4,2,2
2020,171571,44,4,15,4,11
2020,171599,0,0,45,24,21
2020,171599,10,0,45,24,21
2020,171599,10,1,8,5,3
2020,171599,10,2,18,11,7
2020,171599,10,3,19,8,11
2020,171599,20,0,29,17,12
2020,171599,20,1,8,5,3
2020,171599,20,2,17,10,7
2020,171599,20,3,4,2,2
2020,171599,30,0,14,6,8
2020,171599,30,2,1,1,0
2020,171599,30,3,13,5,8
2020,171599,40,0,2,1,1
2020,171599,40,3,2,1,1
2020,171599,42,0,2,1,1
2020,171599,42,3,2,1,1
2020,171881,0,0,10,7,3
2020,171881,10,0,10,7,3
2020,171881,10,1,6,4,2
2020,171881,10,2,2,2,0
2020,171881,10,3,1,0,1
2020,171881,10,4,1,1,0
2020,171881,20,0,6,4,2
2020,171881,20,1,6,4,2
2020,171881,30,0,4,3,1
2020,171881,30,2,2,2,0
2020,171881,30,3,1,0,1
2020,171881,30,4,1,1,0
2020,172033,0,0,14,12,2
2020,172033,10,0,14,12,2
2020,172033,10,1,9,7,2
2020,172033,10,2,2,2,0
2020,172033,10,3,2,2,0
2020,172033,10,4,1,1,0
2020,172033,40,0,14,12,2
2020,172033,40,1,9,7,2
2020,172033,40,2,2,2,0
2020,172033,40,3,2,2,0
2020,172033,40,4,1,1,0
2020,172033,41,0,14,12,2
2020,172033,41,1,9,7,2
2020,172033,41,2,2,2,0
2020,172033,41,3,2,2,0
2020,172033,41,4,1,1,0
2020,172033,44,0,14,12,2
2020,172033,44,1,9,7,2
2020,172033,44,2,2,2,0
2020,172033,44,3,2,2,0
2020,172033,44,4,1,1,0
2020,172051,0,0,271,145,126
2020,172051,10,0,271,145,126
2020,172051,10,1,107,71,36
2020,172051,10,2,93,38,55
2020,172051,10,3,52,25,27
2020,172051,10,4,2,1,1
2020,172051,10,5,17,10,7
2020,172051,20,0,210,113,97
2020,172051,20,1,107,71,36
2020,172051,20,2,93,38,55
2020,172051,20,3,10,4,6
2020,172051,30,0,37,19,18
2020,172051,30,3,37,19,18
2020,172051,40,0,24,13,11
2020,172051,40,3,5,2,3
2020,172051,40,4,2,1,1
2020,172051,40,5,17,10,7
2020,172051,42,0,24,13,11
2020,172051,42,3,5,2,3
2020,172051,42,4,2,1,1
2020,172051,42,5,17,10,7
2020,172200,0,0,87,40,47
2020,172200,10,0,87,40,47
2020,172200,10,6,87,40,47
2020,172200,40,0,87,40,47
2020,172200,40,6,87,40,47
2020,172200,42,0,87,40,47
2020,172200,42,6,87,40,47
2020,172264,0,0,88,45,43
2020,172264,10,0,88,45,43
2020,172264,10,1,20,14,6
2020,172264,10,2,28,11,17
2020,172264,10,3,35,18,17
2020,172264,10,4,5,2,3
2020,172264,40,0,88,45,43
2020,172264,40,1,20,14,6
2020,172264,40,2,28,11,17
2020,172264,40,3,35,18,17
2020,172264,40,4,5,2,3
2020,172264,42,0,88,45,43
2020,172264,42,1,20,14,6
2020,172264,42,2,28,11,17
2020,172264,42,3,35,18,17
2020,172264,42,4,5,2,3
2020,172291,0,0,60,25,35
2020,172291,10,0,60,25,35
2020,172291,10,1,56,25,31
2020,172291,10,4,4,0,4
2020,172291,20,0,56,25,31
2020,172291,20,1,56,25,31
2020,172291,30,0,4,0,4
2020,172291,30,4,4,0,4
2020,172307,0,0,53,25,28
2020,172307,10,0,53,25,28
2020,172307,10,1,21,8,13
2020,172307,10,2,9,5,4
2020,172307,10,3,23,12,11
2020,172307,40,0,53,25,28
2020,172307,40,1,21,8,13
2020,172307,40,2,9,5,4
2020,172307,40,3,23,12,11
2020,172307,41,0,48,22,26
2020,172307,41,1,21,8,13
2020,172307,41,2,9,5,4
2020,172307,41,3,18,9,9
2020,172307,42,0,5,3,2
2020,172307,42,3,5,3,2
2020,172307,44,0,48,22,26
2020,172307,44,1,21,8,13
2020,172307,44,2,9,5,4
2020,172307,44,3,18,9,9
2020,172334,0,0,82,47,35
2020,172334,10,0,82,47,35
2020,172334,10,1,31,23,8
2020,172334,10,2,24,16,8
2020,172334,10,3,27,8,19
2020,172334,20,0,41,32,9
2020,172334,20,1,30,23,7
2020,172334,20,2,11,9,2
2020,172334,30,0,38,14,24
2020,172334,30,1,1,0,1
2020,172334,30,2,13,7,6
2020,172334,30,3,24,7,17
2020,172334,40,0,3,1,2
2020,172334,40,3,3,1,2
2020,172334,42,0,3,1,2
2020,172334,42,3,3,1,2
2020,172440,0,0,26,12,14
2020,172440,10,0,26,12,14
2020,172440,10,1,1,0,1
2020,172440,10,2,9,6,3
2020,172440,10,3,12,4,8
2020,172440,10,4,2,0,2
2020,172440,10,6,2,2,0
2020,172440,20,0,9,5,4
2020,172440,20,1,1,0,1
2020,172440,20,2,8,5,3
2020,172440,30,0,12,5,7
2020,172440,30,2,1,1,0
2020,172440,30,3,11,4,7
2020,172440,40,0,5,2,3
2020,172440,40,3,1,0,1
2020,172440,40,4,2,0,2
2020,172440,40,6,2,2,0
2020,172440,42,0,3,2,1
2020,172440,42,3,1,0,1
2020,172440,42,6,2,2,0
2020,172440,43,0,2,0,2
2020,172440,43,4,2,0,2
2020,172477,0,0,47,26,21
2020,172477,10,0,44,23,21
2020,172477,10,1,34,20,14
2020,172477,10,2,5,2,3
2020,172477,10,3,5,1,4
2020,172477,20,0,34,20,14
2020,172477,20,1,34,20,14
2020,172477,30,0,5,1,4
2020,172477,30,2,4,1,3
2020,172477,30,3,1,0,1
2020,172477,40,0,5,2,3
2020,172477,40,2,1,1,0
2020,172477,40,3,4,1,3
2020,172477,41,0,1,1,0
2020,172477,41,2,1,1,0
2020,172477,42,0,4,1,3
2020,172477,42,3,4,1,3
2020,172477,44,0,1,1,0
2020,172477,44,2,1,1,0
2020,172477,50,0,3,3,0
2020,172608,0,0,19,12,7
2020,172608,10,0,19,12,7
2020,172608,10,1,14,8,6
2020,172608,10,2,5,4,1
2020,172608,40,0,19,12,7
2020,172608,40,1,14,8,6
2020,172608,40,2,5,4,1
2020,172608,41,0,19,12,7
2020,172608,41,1,14,8,6
2020,172608,41,2,5,4,1
2020,172608,44,0,19,12,7
2020,172608,44,1,14,8,6
2020,172608,44,2,5,4,1
2020,172617,0,0,156,74,82
2020,172617,10,0,156,74,82
2020,172617,10,6,156,74,82
2020,172617,40,0,156,74,82
2020,172617,40,6,156,74,82
2020,172617,41,0,156,74,82
2020,172617,41,6,156,74,82
2020,172617,44,0,156,74,82
2020,172617,44,6,156,74,82
2020,172635,0,0,70,31,39
2020,172635,10,0,70,31,39
2020,172635,10,4,70,31,39
2020,172635,40,0,70,31,39
2020,172635,40,4,70,31,39
2020,172635,41,0,70,31,39
2020,172635,41,4,70,31,39
2020,172635,45,0,70,31,39
2020,172635,45,4,70,31,39
2020,172644,0,0,1531,866,665
2020,172644,10,0,1531,866,665
2020,172644,10,1,461,336,125
2020,172644,10,2,463,259,204
2020,172644,10,3,390,185,205
2020,172644,10,4,29,5,24
2020,172644,10,5,184,79,105
2020,172644,10,6,4,2,2
2020,172644,20,0,745,491,254
2020,172644,20,1,387,287,100
2020,172644,20,2,356,202,154
2020,172644,20,3,2,2,0
2020,172644,30,0,180,101,79
2020,172644,30,1,1,1,0
2020,172644,30,2,11,8,3
2020,172644,30,3,168,92,76
2020,172644,40,0,606,274,332
2020,172644,40,1,73,48,25
2020,172644,40,2,96,49,47
2020,172644,40,3,220,91,129
2020,172644,40,4,29,5,24
2020,172644,40,5,184,79,105
2020,172644,40,6,4,2,2
2020,172644,41,0,580,271,309
2020,172644,41,1,73,48,25
2020,172644,41,2,96,49,47
2020,172644,41,3,218,91,127
2020,172644,41,4,5,2,3
2020,172644,41,5,184,79,105
2020,172644,41,6,4,2,2
2020,172644,42,0,26,3,23
2020,172644,42,3,2,0,2
2020,172644,42,4,24,3,21
2020,172644,44,0,580,271,309
2020,172644,44,1,73,48,25
2020,172644,44,2,96,49,47
2020,172644,44,3,218,91,127
2020,172644,44,4,5,2,3
2020,172644,44,5,184,79,105
2020,172644,44,6,4,2,2
2020,172671,0,0,26,17,9
2020,172671,10,0,26,17,9
2020,172671,10,1,19,12,7
2020,172671,10,2,7,5,2
2020,172671,20,0,19,12,7
2020,172671,20,1,19,12,7
2020,172671,30,0,7,5,2
2020,172671,30,2,7,5,2
2020,172699,0,0,752,395,357
2020,172699,10,0,752,395,357
2020,172699,10,1,303,203,100
2020,172699,10,2,218,111,107
2020,172699,10,3,175,62,113
2020,172699,10,4,56,19,37
2020,172699,20,0,524,305,219
2020,172699,20,1,301,201,100
2020,172699,20,2,204,102,102
2020,172699,20,3,19,2,17
2020,172699,30,0,175,70,105
2020,172699,30,1,2,2,0
2020,172699,30,2,12,8,4
2020,172699,30,3,141,54,87
2020,172699,30,4,20,6,14
2020,172699,40,0,53,20,33
2020,172699,40,2,2,1,1
2020,172699,40,3,15,6,9
2020,172699,40,4,36,13,23
2020,172699,42,0,53,20,33
2020,172699,42,2,2,1,1
2020,172699,42,3,15,6,9
2020,172699,42,4,36,13,23
2020,172705,0,0,13,11,2
2020,172705,10,0,13,11,2
2020,172705,10,1,7,6,1
2020,172705,10,2,5,4,1
2020,172705,10,3,1,1,0
2020,172705,20,0,7,6,1
2020,172705,20,1,7,6,1
2020,172705,30,0,5,4,1
2020,172705,30,2,5,4,1
2020,172705,40,0,1,1,0
2020,172705,40,3,1,1,0
2020,172705,41,0,1,1,0
2020,172705,41,3,1,1,0
2020,172705,45,0,1,1,0
2020,172705,45,3,1,1,0
2020,172918,0,0,65,32,33
2020,172918,10,0,65,32,33
2020,172918,10,4,65,32,33
2020,172918,20,0,53,28,25
2020,172918,20,4,53,28,25
2020,172918,30,0,12,4,8
2020,172918,30,4,12,4,8
2020,172954,0,0,57,24,33
2020,172954,10,0,57,24,33
2020,172954,10,4,57,24,33
2020,172954,20,0,47,19,28
2020,172954,20,4,47,19,28
2020,172954,30,0,8,3,5
2020,172954,30,4,8,3,5
2020,172954,40,0,2,2,0
2020,172954,40,4,2,2,0
2020,172954,42,0,2,2,0
2020,172954,42,4,2,2,0
2020,172963,0,0,126,47,79
2020,172963,10,0,126,47,79
2020,172963,10,4,126,47,79
2020,172963,20,0,112,42,70
2020,172963,20,4,112,42,70
2020,172963,30,0,11,4,7
2020,172963,30,4,11,4,7
2020,172963,40,0,3,1,2
2020,172963,40,4,3,1,2
2020,172963,42,0,2,1,1
2020,172963,42,4,2,1,1
2020,172963,43,0,1,0,1
2020,172963,43,4,1,0,1
2020,173045,0,0,170,75,95
2020,173045,10,0,170,75,95
2020,173045,10,1,37,18,19
2020,173045,10,2,53,31,22
2020,173045,10,3,58,20,38
2020,173045,10,4,19,5,14
2020,173045,10,5,3,1,2
2020,173045,20,0,85,47,38
2020,173045,20,1,35,16,19
2020,173045,20,2,50,31,19
2020,173045,30,0,42,14,28
2020,173045,30,2,1,0,1
2020,173045,30,3,41,14,27
2020,173045,40,0,43,14,29
2020,173045,40,1,2,2,0
2020,173045,40,2,2,0,2
2020,173045,40,3,17,6,11
2020,173045,40,4,19,5,14
2020,173045,40,5,3,1,2
2020,173045,42,0,43,14,29
2020,173045,42,1,2,2,0
2020,173045,42,2,2,0,2
2020,173045,42,3,17,6,11
2020,173045,42,4,19,5,14
2020,173045,42,5,3,1,2
2020,173063,0,0,66,32,34
2020,173063,10,0,66,32,34
2020,173063,10,4,66,32,34
2020,173063,20,0,49,25,24
2020,173063,20,4,49,25,24
2020,173063,30,0,17,7,10
2020,173063,30,4,17,7,10
2020,173115,0,0,21,7,14
2020,173115,10,0,21,7,14
2020,173115,10,4,21,7,14
2020,173115,20,0,10,3,7
2020,173115,20,4,10,3,7
2020,173115,30,0,11,4,7
2020,173115,30,4,11,4,7
2020,173124,0,0,162,81,81
2020,173124,10,0,162,81,81
2020,173124,10,1,41,25,16
2020,173124,10,2,49,26,23
2020,173124,10,3,72,30,42
2020,173124,20,0,84,50,34
2020,173124,20,1,40,24,16
2020,173124,20,2,41,23,18
2020,173124,20,3,3,3,0
2020,173124,30,0,56,22,34
2020,173124,30,1,1,1,0
2020,173124,30,2,6,2,4
2020,173124,30,3,49,19,30
2020,173124,40,0,22,9,13
2020,173124,40,2,2,1,1
2020,173124,40,3,20,8,12
2020,173124,42,0,21,9,12
2020,173124,42,2,2,1,1
2020,173124,42,3,19,8,11
2020,173124,43,0,1,0,1
2020,173124,43,3,1,0,1
2020,173142,0,0,42,28,14
2020,173142,10,0,42,28,14
2020,173142,10,1,13,10,3
2020,173142,10,2,16,12,4
2020,173142,10,3,13,6,7
2020,173142,40,0,42,28,14
2020,173142,40,1,13,10,3
2020,173142,40,2,16,12,4
2020,173142,40,3,13,6,7
2020,173142,43,0,42,28,14
2020,173142,43,1,13,10,3
2020,173142,43,2,16,12,4
2020,173142,43,3,13,6,7
2020,173160,0,0,191,84,107
2020,173160,10,0,191,84,107
2020,173160,10,1,67,43,24
2020,173160,10,2,83,33,50
2020,173160,10,3,31,7,24
2020,173160,10,4,10,1,9
2020,173160,20,0,123,66,57
2020,173160,20,1,66,42,24
2020,173160,20,2,51,23,28
2020,173160,20,3,5,1,4
2020,173160,20,4,1,0,1
2020,173160,30,0,46,13,33
2020,173160,30,2,23,6,17
2020,173160,30,3,18,6,12
2020,173160,30,4,5,1,4
2020,173160,40,0,22,5,17
2020,173160,40,1,1,1,0
2020,173160,40,2,9,4,5
2020,173160,40,3,8,0,8
2020,173160,40,4,4,0,4
2020,173160,41,0,12,3,9
2020,173160,41,2,7,3,4
2020,173160,41,3,3,0,3
2020,173160,41,4,2,0,2
2020,173160,42,0,10,2,8
2020,173160,42,1,1,1,0
2020,173160,42,2,2,1,1
2020,173160,42,3,5,0,5
2020,173160,42,4,2,0,2
2020,173160,44,0,12,3,9
2020,173160,44,2,7,3,4
2020,173160,44,3,3,0,3
2020,173160,44,4,2,0,2
2020,173203,0,0,78,45,33
2020,173203,10,0,78,45,33
2020,173203,10,4,78,45,33
2020,173203,20,0,66,39,27
2020,173203,20,4,66,39,27
2020,173203,30,0,9,4,5
2020,173203,30,4,9,4,5
2020,173203,40,0,3,2,1
2020,173203,40,4,3,2,1
2020,173203,42,0,3,2,1
2020,173203,42,4,3,2,1
2020,173258,0,0,221,111,110
2020,173258,10,0,217,108,109
2020,173258,10,1,97,51,46
2020,173258,10,2,52,28,24
2020,173258,10,3,54,25,29
2020,173258,10,4,1,0,1
2020,173258,10,5,12,4,8
2020,173258,10,6,1,0,1
2020,173258,20,0,135,69,66
2020,173258,20,1,87,44,43
2020,173258,20,2,48,25,23
2020,173258,30,0,44,21,23
2020,173258,30,2,1,1,0
2020,173258,30,3,43,20,23
2020,173258,40,0,38,18,20
2020,173258,40,1,10,7,3
2020,173258,40,2,3,2,1
2020,173258,40,3,11,5,6
2020,173258,40,4,1,0,1
2020,173258,40,5,12,4,8
2020,173258,40,6,1,0,1
2020,173258,41,0,29,13,16
2020,173258,41,1,10,7,3
2020,173258,41,2,3,2,1
2020,173258,41,3,2,0,2
2020,173258,41,4,1,0,1
2020,173258,41,5,12,4,8
2020,173258,41,6,1,0,1
2020,173258,42,0,9,5,4
2020,173258,42,3,9,5,4
2020,173258,44,0,29,13,16
2020,173258,44,1,10,7,3
2020,173258,44,2,3,2,1
2020,173258,44,3,2,0,2
2020,173258,44,4,1,0,1
2020,173258,44,5,12,4,8
2020,173258,44,6,1,0,1
2020,173258,50,0,4,3,1
2020,173300,0,0,149,80,69
2020,173300,10,0,148,79,69
2020,173300,10,1,48,31,17
2020,173300,10,2,55,27,28
2020,173300,10,3,39,19,20
2020,173300,10,4,6,2,4
2020,173300,20,0,100,59,41
2020,173300,20,1,47,31,16
2020,173300,20,2,51,26,25
2020,173300,20,3,2,2,0
2020,173300,30,0,25,12,13
2020,173300,30,1,1,0,1
2020,173300,30,3,24,12,12
2020,173300,40,0,23,8,15
2020,173300,40,2,4,1,3
2020,173300,40,3,13,5,8
2020,173300,40,4,6,2,4
2020,173300,41,0,13,4,9
2020,173300,41,2,4,1,3
2020,173300,41,3,8,2,6
2020,173300,41,4,1,1,0
2020,173300,42,0,10,4,6
2020,173300,42,3,5,3,2
2020,173300,42,4,5,1,4
2020,173300,44,0,7,2,5
2020,173300,44,3,6,1,5
2020,173300,44,4,1,1,0
2020,173300,45,0,6,2,4
2020,173300,45,2,4,1,3
2020,173300,45,3,2,1,1
2020,173300,50,0,1,1,0
2020,173328,0,0,99,37,62
2020,173328,10,0,99,37,62
2020,173328,10,1,28,14,14
2020,173328,10,2,30,11,19
2020,173328,10,3,27,8,19
2020,173328,10,4,14,4,10
2020,173328,20,0,19,10,9
2020,173328,20,1,17,10,7
2020,173328,20,2,2,0,2
2020,173328,30,0,34,12,22
2020,173328,30,1,5,1,4
2020,173328,30,2,14,6,8
2020,173328,30,3,12,4,8
2020,173328,30,4,3,1,2
2020,173328,40,0,46,15,31
2020,173328,40,1,6,3,3
2020,173328,40,2,14,5,9
2020,173328,40,3,15,4,11
2020,173328,40,4,11,3,8
2020,173328,41,0,17,9,8
2020,173328,41,1,1,1,0
2020,173328,41,2,3,1,2
2020,173328,41,3,7,4,3
2020,173328,41,4,6,3,3
2020,173328,42,0,22,5,17
2020,173328,42,1,5,2,3
2020,173328,42,2,10,3,7
2020,173328,42,3,6,0,6
2020,173328,42,4,1,0,1
2020,173328,43,0,7,1,6
2020,173328,43,2,1,1,0
2020,173328,43,3,2,0,2
2020,173328,43,4,4,0,4
2020,173328,44,0,17,9,8
2020,173328,44,1,1,1,0
2020,173328,44,2,3,1,2
2020,173328,44,3,7,4,3
2020,173328,44,4,6,3,3
2020,173416,0,0,59,38,21
2020,173416,10,0,59,38,21
2020,173416,10,4,59,38,21
2020,173416,20,0,49,31,18
2020,173416,20,4,49,31,18
2020,173416,30,0,10,7,3
2020,173416,30,4,10,7,3
2020,173452,0,0,83,62,21
2020,173452,10,0,81,62,19
2020,173452,10,1,81,62,19
2020,173452,40,0,81,62,19
2020,173452,40,1,81,62,19
2020,173452,41,0,81,62,19
2020,173452,41,1,81,62,19
2020,173452,45,0,81,62,19
2020,173452,45,1,81,62,19
2020,173452,50,0,2,0,2
2020,173461,0,0,82,43,39
2020,173461,10,0,82,43,39
2020,173461,10,4,82,43,39
2020,173461,20,0,63,33,30
2020,173461,20,4,63,33,30
2020,173461,30,0,19,10,9
2020,173461,30,4,19,10,9
2020,173559,0,0,108,52,56
2020,173559,10,0,108,52,56
2020,173559,10,4,108,52,56
2020,173559,20,0,95,46,49
2020,173559,20,4,95,46,49
2020,173559,30,0,12,6,6
2020,173559,30,4,12,6,6
2020,173559,40,0,1,0,1
2020,173559,40,4,1,0,1
2020,173559,42,0,1,0,1
2020,173559,42,4,1,0,1
2020,173638,0,0,70,40,30
2020,173638,10,0,70,40,30
2020,173638,10,4,70,40,30
2020,173638,20,0,55,32,23
2020,173638,20,4,55,32,23
2020,173638,30,0,15,8,7
2020,173638,30,4,15,8,7
2020,173647,0,0,183,79,104
2020,173647,10,0,183,79,104
2020,173647,10,1,49,27,22
2020,173647,10,2,67,28,39
2020,173647,10,3,57,19,38
2020,173647,10,4,10,5,5
2020,173647,20,0,115,55,60
2020,173647,20,1,49,27,22
2020,173647,20,2,66,28,38
2020,173647,30,0,22,6,16
2020,173647,30,2,1,0,1
2020,173647,30,3,21,6,15
2020,173647,40,0,46,18,28
2020,173647,40,3,36,13,23
2020,173647,40,4,10,5,5
2020,173647,41,0,10,3,7
2020,173647,41,3,7,2,5
2020,173647,41,4,3,1,2
2020,173647,42,0,36,15,21
2020,173647,42,3,29,11,18
2020,173647,42,4,7,4,3
2020,173647,44,0,10,3,7
2020,173647,44,3,7,2,5
2020,173647,44,4,3,1,2
2020,173665,0,0,144,66,78
2020,173665,10,0,128,58,70
2020,173665,10,1,55,24,31
2020,173665,10,2,34,14,20
2020,173665,10,3,21,9,12
2020,173665,10,4,3,2,1
2020,173665,10,5,15,9,6
2020,173665,20,0,86,36,50
2020,173665,20,1,55,24,31
2020,173665,20,2,31,12,19
2020,173665,30,0,21,9,12
2020,173665,30,2,1,1,0
2020,173665,30,3,20,8,12
2020,173665,40,0,21,13,8
2020,173665,40,2,2,1,1
2020,173665,40,3,1,1,0
2020,173665,40,4,3,2,1
2020,173665,40,5,15,9,6
2020,173665,42,0,21,13,8
2020,173665,42,2,2,1,1
2020,173665,42,3,1,1,0
2020,173665,42,4,3,2,1
2020,173665,42,5,15,9,6
2020,173665,50,0,16,8,8
2020,173708,0,0,98,61,37
2020,173708,10,0,98,61,37
2020,173708,10,4,98,61,37
2020,173708,20,0,85,52,33
2020,173708,20,4,85,52,33
2020,173708,30,0,12,8,4
2020,173708,30,4,12,8,4
2020,173708,40,0,1,1,0
2020,173708,40,4,1,1,0
2020,173708,42,0,1,1,0
2020,173708,42,4,1,1,0
2020,173735,0,0,37,23,14
2020,173735,10,0,37,23,14
2020,173735,10,4,37,23,14
2020,173735,20,0,30,21,9
2020,173735,20,4,30,21,9
2020,173735,30,0,7,2,5
2020,173735,30,4,7,2,5
2020,173799,0,0,82,36,46
2020,173799,10,0,82,36,46
2020,173799,10,4,82,36,46
2020,173799,20,0,72,33,39
2020,173799,20,4,72,33,39
2020,173799,30,0,9,2,7
2020,173799,30,4,9,2,7
2020,173799,40,0,1,1,0
2020,173799,40,4,1,1,0
2020,173799,42,0,1,1,0
2020,173799,42,4,1,1,0
2020,173805,0,0,23,11,12
2020,173805,10,0,23,11,12
2020,173805,10,4,23,11,12
2020,173805,20,0,19,8,11
2020,173805,20,4,19,8,11
2020,173805,30,0,4,3,1
2020,173805,30,4,4,3,1
2020,173896,0,0,23,11,12
2020,173896,10,0,23,11,12
2020,173896,10,1,16,8,8
2020,173896,10,2,3,1,2
2020,173896,10,3,2,1,1
2020,173896,10,6,2,1,1
2020,173896,20,0,16,8,8
2020,173896,20,1,15,7,8
2020,173896,20,2,1,1,0
2020,173896,40,0,7,3,4
2020,173896,40,1,1,1,0
2020,173896,40,2,2,0,2
2020,173896,40,3,2,1,1
2020,173896,40,6,2,1,1
2020,173896,41,0,7,3,4
2020,173896,41,1,1,1,0
2020,173896,41,2,2,0,2
2020,173896,41,3,2,1,1
2020,173896,41,6,2,1,1
2020,173896,44,0,6,3,3
2020,173896,44,1,1,1,0
2020,173896,44,2,1,0,1
2020,173896,44,3,2,1,1
2020,173896,44,6,2,1,1
2020,173896,45,0,1,0,1
2020,173896,45,2,1,0,1
2020,173902,0,0,196,89,107
2020,173902,10,0,196,89,107
2020,173902,10,1,78,40,38
2020,173902,10,2,44,24,20
2020,173902,10,3,35,12,23
2020,173902,10,4,33,13,20
2020,173902,10,5,4,0,4
2020,173902,10,6,2,0,2
2020,173902,20,0,122,64,58
2020,173902,20,1,78,40,38
2020,173902,20,2,44,24,20
2020,173902,30,0,35,12,23
2020,173902,30,3,35,12,23
2020,173902,40,0,39,13,26
2020,173902,40,4,33,13,20
2020,173902,40,5,4,0,4
2020,173902,40,6,2,0,2
2020,173902,42,0,39,13,26
2020,173902,42,4,33,13,20
2020,173902,42,5,4,0,4
2020,173902,42,6,2,0,2
2020,173911,0,0,82,42,40
2020,173911,10,0,82,42,40
2020,173911,10,4,82,42,40
2020,173911,20,0,68,38,30
2020,173911,20,4,68,38,30
2020,173911,30,0,13,4,9
2020,173911,30,4,13,4,9
2020,173911,40,0,1,0,1
2020,173911,40,4,1,0,1
2020,173911,42,0,1,0,1
2020,173911,42,4,1,0,1
2020,173920,0,0,494,261,233
2020,173920,10,0,494,261,233
2020,173920,10,1,182,108,74
2020,173920,10,2,151,74,77
2020,173920,10,3,150,70,80
2020,173920,10,4,11,9,2
2020,173920,20,0,334,178,156
2020,173920,20,1,180,107,73
2020,173920,20,2,144,68,76
2020,173920,20,3,10,3,7
2020,173920,30,0,127,66,61
2020,173920,30,1,2,1,1
2020,173920,30,2,5,4,1
2020,173920,30,3,119,61,58
2020,173920,30,4,1,0,1
2020,173920,40,0,33,17,16
2020,173920,40,2,2,2,0
2020,173920,40,3,21,6,15
2020,173920,40,4,10,9,1
2020,173920,42,0,31,16,15
2020,173920,42,2,1,1,0
2020,173920,42,3,20,6,14
2020,173920,42,4,10,9,1
2020,173920,43,0,2,1,1
2020,173920,43,2,1,1,0
2020,173920,43,3,1,0,1
2020,173993,0,0,28,15,13
2020,173993,10,0,28,15,13
2020,173993,10,4,28,15,13
2020,173993,20,0,22,12,10
2020,173993,20,4,22,12,10
2020,173993,30,0,6,3,3
2020,173993,30,4,6,3,3
2020,174020,0,0,144,60,84
2020,174020,10,0,144,60,84
2020,174020,10,1,40,14,26
2020,174020,10,2,58,28,30
2020,174020,10,3,46,18,28
2020,174020,20,0,95,41,54
2020,174020,20,1,40,14,26
2020,174020,20,2,52,25,27
2020,174020,20,3,3,2,1
2020,174020,30,0,43,15,28
2020,174020,30,2,4,2,2
2020,174020,30,3,39,13,26
2020,174020,40,0,6,4,2
2020,174020,40,2,2,1,1
2020,174020,40,3,4,3,1
2020,174020,42,0,6,4,2
2020,174020,42,2,2,1,1
2020,174020,42,3,4,3,1
2020,174066,0,0,3639,2048,1591
2020,174066,10,0,3304,1928,1376
2020,174066,10,1,1213,838,375
2020,174066,10,2,886,488,398
2020,174066,10,3,1155,576,579
2020,174066,10,4,42,21,21
2020,174066,10,6,8,5,3
2020,174066,20,0,1670,1096,574
2020,174066,20,1,1079,755,324
2020,174066,20,2,589,340,249
2020,174066,20,3,2,1,1
2020,174066,30,0,494,256,238
2020,174066,30,1,1,1,0
2020,174066,30,2,28,12,16
2020,174066,30,3,465,243,222
2020,174066,40,0,1140,576,564
2020,174066,40,1,133,82,51
2020,174066,40,2,269,136,133
2020,174066,40,3,688,332,356
2020,174066,40,4,42,21,21
2020,174066,40,6,8,5,3
2020,174066,41,0,34,11,23
2020,174066,41,1,4,3,1
2020,174066,41,2,12,3,9
2020,174066,41,3,16,4,12
2020,174066,41,4,2,1,1
2020,174066,42,0,1101,563,538
2020,174066,42,1,129,79,50
2020,174066,42,2,257,133,124
2020,174066,42,3,668,327,341
2020,174066,42,4,40,20,20
2020,174066,42,6,7,4,3
2020,174066,43,0,5,2,3
2020,174066,43,3,4,1,3
2020,174066,43,6,1,1,0
2020,174066,44,0,34,11,23
2020,174066,44,1,4,3,1
2020,174066,44,2,12,3,9
2020,174066,44,3,16,4,12
2020,174066,44,4,2,1,1
2020,174066,50,0,335,120,215
2020,174075,0,0,62,32,30
2020,174075,10,0,38,22,16
2020,174075,10,1,8,5,3
2020,174075,10,2,12,9,3
2020,174075,10,3,15,7,8
2020,174075,10,4,3,1,2
2020,174075,20,0,20,13,7
2020,174075,20,1,8,5,3
2020,174075,20,2,11,8,3
2020,174075,20,3,1,0,1
2020,174075,30,0,15,8,7
2020,174075,30,2,1,1,0
2020,174075,30,3,14,7,7
2020,174075,40,0,3,1,2
2020,174075,40,4,3,1,2
2020,174075,42,0,3,1,2
2020,174075,42,4,3,1,2
2020,174075,50,0,24,10,14
2020,174127,0,0,37,19,18
2020,174127,10,0,37,19,18
2020,174127,10,1,19,12,7
2020,174127,10,2,9,4,5
2020,174127,10,3,4,1,3
2020,174127,10,6,5,2,3
2020,174127,40,0,37,19,18
2020,174127,40,1,19,12,7
2020,174127,40,2,9,4,5
2020,174127,40,3,4,1,3
2020,174127,40,6,5,2,3
2020,174127,41,0,32,17,15
2020,174127,41,1,19,12,7
2020,174127,41,2,9,4,5
2020,174127,41,3,4,1,3
2020,174127,42,0,5,2,3
2020,174127,42,6,5,2,3
2020,174127,44,0,32,17,15
2020,174127,44,1,19,12,7
2020,174127,44,2,9,4,5
2020,174127,44,3,4,1,3
2020,174136,0,0,110,46,64
2020,174136,10,0,110,46,64
2020,174136,10,4,110,46,64
2020,174136,20,0,94,37,57
2020,174136,20,4,94,37,57
2020,174136,30,0,16,9,7
2020,174136,30,4,16,9,7
2020,174154,0,0,18,1,17
2020,174154,10,0,18,1,17
2020,174154,10,2,3,1,2
2020,174154,10,3,12,0,12
2020,174154,10,4,3,0,3
2020,174154,40,0,18,1,17
2020,174154,40,2,3,1,2
2020,174154,40,3,12,0,12
2020,174154,40,4,3,0,3
2020,174154,41,0,18,1,17
2020,174154,41,2,3,1,2
2020,174154,41,3,12,0,12
2020,174154,41,4,3,0,3
2020,174154,45,0,18,1,17
2020,174154,45,2,3,1,2
2020,174154,45,3,12,0,12
2020,174154,45,4,3,0,3
2020,174233,0,0,485,266,219
2020,174233,10,0,485,266,219
2020,174233,10,1,101,74,27
2020,174233,10,2,153,82,71
2020,174233,10,3,151,77,74
2020,174233,10,4,80,33,47
2020,174233,20,0,253,156,97
2020,174233,20,1,101,74,27
2020,174233,20,2,151,81,70
2020,174233,20,3,1,1,0
2020,174233,30,0,86,47,39
2020,174233,30,2,2,1,1
2020,174233,30,3,84,46,38
2020,174233,40,0,146,63,83
2020,174233,40,3,66,30,36
2020,174233,40,4,80,33,47
2020,174233,41,0,26,14,12
2020,174233,41,3,6,3,3
2020,174233,41,4,20,11,9
2020,174233,42,0,120,49,71
2020,174233,42,3,60,27,33
2020,174233,42,4,60,22,38
2020,174233,44,0,26,14,12
2020,174233,44,3,6,3,3
2020,174233,44,4,20,11,9
2020,174251,0,0,103,57,46
2020,174251,10,0,90,49,41
2020,174251,10,1,24,15,9
2020,174251,10,2,39,20,19
2020,174251,10,3,27,14,13
2020,174251,20,0,62,34,28
2020,174251,20,1,24,15,9
2020,174251,20,2,38,19,19
2020,174251,30,0,26,14,12
2020,174251,30,3,26,14,12
2020,174251,40,0,2,1,1
2020,174251,40,2,1,1,0
2020,174251,40,3,1,0,1
2020,174251,42,0,2,1,1
2020,174251,42,2,1,1,0
2020,174251,42,3,1,0,1
2020,174251,50,0,13,8,5
2020,174358,0,0,209,105,104
2020,174358,10,0,209,105,104
2020,174358,10,1,106,62,44
2020,174358,10,2,46,17,29
2020,174358,10,3,52,25,27
2020,174358,10,4,5,1,4
2020,174358,20,0,149,77,72
2020,174358,20,1,105,61,44
2020,174358,20,2,42,16,26
2020,174358,20,3,2,0,2
2020,174358,30,0,43,23,20
2020,174358,30,1,1,1,0
2020,174358,30,2,4,1,3
2020,174358,30,3,38,21,17
2020,174358,40,0,17,5,12
2020,174358,40,3,12,4,8
2020,174358,40,4,5,1,4
2020,174358,42,0,17,5,12
2020,174358,42,3,12,4,8
2020,174358,42,4,5,1,4
2020,174376,0,0,101,35,66
2020,174376,10,0,101,35,66
2020,174376,10,4,101,35,66
2020,174376,20,0,82,29,53
2020,174376,20,4,82,29,53
2020,174376,30,0,16,6,10
2020,174376,30,4,16,6,10
2020,174376,40,0,3,0,3
2020,174376,40,4,3,0,3
2020,174376,42,0,3,0,3
2020,174376,42,4,3,0,3
2020,174428,0,0,152,70,82
2020,174428,10,0,152,70,82
2020,174428,10,4,152,70,82
2020,174428,20,0,133,62,71
2020,174428,20,4,133,62,71
2020,174428,30,0,19,8,11
2020,174428,30,4,19,8,11
2020,174437,0,0,35,25,10
2020,174437,10,0,35,25,10
2020,174437,10,1,4,2,2
2020,174437,10,2,13,10,3
2020,174437,10,3,16,12,4
2020,174437,10,4,1,0,1
2020,174437,10,6,1,1,0
2020,174437,40,0,35,25,10
2020,174437,40,1,4,2,2
2020,174437,40,2,13,10,3
2020,174437,40,3,16,12,4
2020,174437,40,4,1,0,1
2020,174437,40,6,1,1,0
2020,174437,42,0,35,25,10
2020,174437,42,1,4,2,2
2020,174437,42,2,13,10,3
2020,174437,42,3,16,12,4
2020,174437,42,4,1,0,1
2020,174437,42,6,1,1,0
2020,174473,0,0,81,39,42
2020,174473,10,0,81,39,42
2020,174473,10,4,81,39,42
2020,174473,20,0,68,36,32
2020,174473,20,4,68,36,32
2020,174473,30,0,12,3,9
2020,174473,30,4,12,3,9
2020,174473,40,0,1,0,1
2020,174473,40,4,1,0,1
2020,174473,42,0,1,0,1
2020,174473,42,4,1,0,1
2020,174491,0,0,76,42,34
2020,174491,10,0,76,42,34
2020,174491,10,1,26,17,9
2020,174491,10,2,23,14,9
2020,174491,10,3,25,10,15
2020,174491,10,4,2,1,1
2020,174491,40,0,76,42,34
2020,174491,40,1,26,17,9
2020,174491,40,2,23,14,9
2020,174491,40,3,25,10,15
2020,174491,40,4,2,1,1
2020,174491,42,0,76,42,34
2020,174491,42,1,26,17,9
2020,174491,42,2,23,14,9
2020,174491,42,3,25,10,15
2020,174491,42,4,2,1,1
2020,174507,0,0,62,25,37
2020,174507,10,0,62,25,37
2020,174507,10,1,12,6,6
2020,174507,10,2,16,11,5
2020,174507,10,3,25,7,18
2020,174507,10,4,9,1,8
2020,174507,40,0,62,25,37
2020,174507,40,1,12,6,6
2020,174507,40,2,16,11,5
2020,174507,40,3,25,7,18
2020,174507,40,4,9,1,8
2020,174507,41,0,42,21,21
2020,174507,41,1,12,6,6
2020,174507,41,2,14,10,4
2020,174507,41,3,14,4,10
2020,174507,41,4,2,1,1
2020,174507,42,0,20,4,16
2020,174507,42,2,2,1,1
2020,174507,42,3,11,3,8
2020,174507,42,4,7,0,7
2020,174507,44,0,42,21,21
2020,174507,44,1,12,6,6
2020,174507,44,2,14,10,4
2020,174507,44,3,14,4,10
2020,174507,44,4,2,1,1
2020,174525,0,0,8,6,2
2020,174525,10,0,8,6,2
2020,174525,10,6,8,6,2
2020,174525,40,0,8,6,2
2020,174525,40,6,8,6,2
2020,174525,41,0,8,6,2
2020,174525,41,6,8,6,2
2020,174525,45,0,8,6,2
2020,174525,45,6,8,6,2
2020,174570,0,0,24,11,13
2020,174570,10,0,24,11,13
2020,174570,10,4,24,11,13
2020,174570,20,0,18,7,11
2020,174570,20,4,18,7,11
2020,174570,30,0,6,4,2
2020,174570,30,4,6,4,2
2020,174738,0,0,102,50,52
2020,174738,10,0,102,50,52
2020,174738,10,4,102,50,52
2020,174738,20,0,96,48,48
2020,174738,20,4,96,48,48
2020,174738,30,0,5,1,4
2020,174738,30,4,5,1,4
2020,174738,40,0,1,1,0
2020,174738,40,4,1,1,0
2020,174738,42,0,1,1,0
2020,174738,42,4,1,1,0
2020,174747,0,0,132,54,78
2020,174747,10,0,132,54,78
2020,174747,10,1,47,24,23
2020,174747,10,2,51,16,35
2020,174747,10,3,26,13,13
2020,174747,10,4,8,1,7
2020,174747,20,0,97,38,59
2020,174747,20,1,47,24,23
2020,174747,20,2,49,14,35
2020,174747,20,3,1,0,1
2020,174747,30,0,8,4,4
2020,174747,30,2,1,1,0
2020,174747,30,3,7,3,4
2020,174747,40,0,27,12,15
2020,174747,40,2,1,1,0
2020,174747,40,3,18,10,8
2020,174747,40,4,8,1,7
2020,174747,42,0,27,12,15
2020,174747,42,2,1,1,0
2020,174747,42,3,18,10,8
2020,174747,42,4,8,1,7
2020,174756,0,0,93,50,43
2020,174756,10,0,93,50,43
2020,174756,10,4,93,50,43
2020,174756,20,0,76,44,32
2020,174756,20,4,76,44,32
2020,174756,30,0,17,6,11
2020,174756,30,4,17,6,11
2020,174783,0,0,381,204,177
2020,174783,10,0,381,204,177
2020,174783,10,1,184,112,72
2020,174783,10,2,75,43,32
2020,174783,10,3,108,42,66
2020,174783,10,4,14,7,7
2020,174783,20,0,254,153,101
2020,174783,20,1,184,112,72
2020,174783,20,2,66,39,27
2020,174783,20,3,4,2,2
2020,174783,30,0,69,26,43
2020,174783,30,2,8,4,4
2020,174783,30,3,61,22,39
2020,174783,40,0,58,25,33
2020,174783,40,2,1,0,1
2020,174783,40,3,43,18,25
2020,174783,40,4,14,7,7
2020,174783,42,0,57,25,32
2020,174783,42,2,1,0,1
2020,174783,42,3,42,18,24
2020,174783,42,4,14,7,7
2020,174783,43,0,1,0,1
2020,174783,43,3,1,0,1
2020,174792,0,0,131,75,56
2020,174792,10,0,131,75,56
2020,174792,10,1,40,29,11
2020,174792,10,2,41,25,16
2020,174792,10,3,38,19,19
2020,174792,10,4,12,2,10
2020,174792,20,0,78,53,25
2020,174792,20,1,39,28,11
2020,174792,20,2,39,25,14
2020,174792,30,0,13,5,8
2020,174792,30,2,2,0,2
2020,174792,30,3,11,5,6
2020,174792,40,0,40,17,23
2020,174792,40,1,1,1,0
2020,174792,40,3,27,14,13
2020,174792,40,4,12,2,10
2020,174792,42,0,40,17,23
2020,174792,42,1,1,1,0
2020,174792,42,3,27,14,13
2020,174792,42,4,12,2,10
2020,174817,0,0,98,57,41
2020,174817,10,0,98,57,41
2020,174817,10,1,26,14,12
2020,174817,10,2,38,26,12
2020,174817,10,3,31,16,15
2020,174817,10,4,3,1,2
2020,174817,20,0,54,35,19
2020,174817,20,1,18,10,8
2020,174817,20,2,29,19,10
2020,174817,20,3,7,6,1
2020,174817,30,0,19,10,9
2020,174817,30,1,1,1,0
2020,174817,30,2,2,1,1
2020,174817,30,3,16,8,8
2020,174817,40,0,25,12,13
2020,174817,40,1,7,3,4
2020,174817,40,2,7,6,1
2020,174817,40,3,8,2,6
2020,174817,40,4,3,1,2
2020,174817,42,0,25,12,13
2020,174817,42,1,7,3,4
2020,174817,42,2,7,6,1
2020,174817,42,3,8,2,6
2020,174817,42,4,3,1,2
2020,174844,0,0,211,109,102
2020,174844,10,0,211,109,102
2020,174844,10,1,59,33,26
2020,174844,10,2,74,38,36
2020,174844,10,3,67,32,35
2020,174844,10,4,7,4,3
2020,174844,10,6,4,2,2
2020,174844,20,0,122,68,54
2020,174844,20,1,59,33,26
2020,174844,20,2,63,35,28
2020,174844,30,0,34,13,21
2020,174844,30,3,33,12,21
2020,174844,30,4,1,1,0
2020,174844,40,0,55,28,27
2020,174844,40,2,11,3,8
2020,174844,40,3,34,20,14
2020,174844,40,4,6,3,3
2020,174844,40,6,4,2,2
2020,174844,41,0,26,12,14
2020,174844,41,2,10,3,7
2020,174844,41,3,11,6,5
2020,174844,41,4,1,1,0
2020,174844,41,6,4,2,2
2020,174844,42,0,29,16,13
2020,174844,42,2,1,0,1
2020,174844,42,3,23,14,9
2020,174844,42,4,5,2,3
2020,174844,44,0,26,12,14
2020,174844,44,2,10,3,7
2020,174844,44,3,11,6,5
2020,174844,44,4,1,1,0
2020,174844,44,6,4,2,2
2020,174862,0,0,28,15,13
2020,174862,10,0,28,15,13
2020,174862,10,1,7,4,3
2020,174862,10,2,10,3,7
2020,174862,10,3,11,8,3
2020,174862,20,0,4,2,2
2020,174862,20,1,3,2,1
2020,174862,20,2,1,0,1
2020,174862,30,0,21,10,11
2020,174862,30,1,4,2,2
2020,174862,30,2,9,3,6
2020,174862,30,3,8,5,3
2020,174862,40,0,3,3,0
2020,174862,40,3,3,3,0
2020,174862,41,0,3,3,0
2020,174862,41,3,3,3,0
2020,174862,44,0,3,3,0
2020,174862,44,3,3,3,0
2020,174899,0,0,214,68,146
2020,174899,10,0,214,68,146
2020,174899,10,1,19,10,9
2020,174899,10,2,60,22,38
2020,174899,10,3,107,25,82
2020,174899,10,4,16,7,9
2020,174899,10,5,9,2,7
2020,174899,10,6,3,2,1
2020,174899,20,0,64,29,35
2020,174899,20,1,18,10,8
2020,174899,20,2,43,17,26
2020,174899,20,3,3,2,1
2020,174899,30,0,45,11,34
2020,174899,30,2,6,1,5
2020,174899,30,3,39,10,29
2020,174899,40,0,105,28,77
2020,174899,40,1,1,0,1
2020,174899,40,2,11,4,7
2020,174899,40,3,65,13,52
2020,174899,40,4,16,7,9
2020,174899,40,5,9,2,7
2020,174899,40,6,3,2,1
2020,174899,41,0,14,4,10
2020,174899,41,2,1,1,0
2020,174899,41,3,13,3,10
2020,174899,42,0,91,24,67
2020,174899,42,1,1,0,1
2020,174899,42,2,10,3,7
2020,174899,42,3,52,10,42
2020,174899,42,4,16,7,9
2020,174899,42,5,9,2,7
2020,174899,42,6,3,2,1
2020,174899,44,0,14,4,10
2020,174899,44,2,1,1,0
2020,174899,44,3,13,3,10
2020,174914,0,0,416,241,175
2020,174914,10,0,416,241,175
2020,174914,10,1,133,90,43
2020,174914,10,2,164,83,81
2020,174914,10,3,65,40,25
2020,174914,10,4,6,2,4
2020,174914,10,5,48,26,22
2020,174914,20,0,292,171,121
2020,174914,20,1,129,88,41
2020,174914,20,2,162,82,80
2020,174914,20,3,1,1,0
2020,174914,30,0,63,37,26
2020,174914,30,1,1,0,1
2020,174914,30,2,2,1,1
2020,174914,30,3,55,34,21
2020,174914,30,4,5,2,3
2020,174914,40,0,61,33,28
2020,174914,40,1,3,2,1
2020,174914,40,3,9,5,4
2020,174914,40,4,1,0,1
2020,174914,40,5,48,26,22
2020,174914,42,0,61,33,28
2020,174914,42,1,3,2,1
2020,174914,42,3,9,5,4
2020,174914,42,4,1,0,1
2020,174914,42,5,48,26,22
2020,175005,0,0,250,43,207
2020,175005,10,0,250,43,207
2020,175005,10,1,33,8,25
2020,175005,10,2,88,17,71
2020,175005,10,3,127,16,111
2020,175005,10,4,2,2,0
2020,175005,20,0,78,17,61
2020,175005,20,1,30,8,22
2020,175005,20,2,48,9,39
2020,175005,30,0,49,9,40
2020,175005,30,2,16,3,13
2020,175005,30,3,33,6,27
2020,175005,40,0,123,17,106
2020,175005,40,1,3,0,3
2020,175005,40,2,24,5,19
2020,175005,40,3,94,10,84
2020,175005,40,4,2,2,0
2020,175005,41,0,112,16,96
2020,175005,41,1,3,0,3
2020,175005,41,2,23,5,18
2020,175005,41,3,84,9,75
2020,175005,41,4,2,2,0
2020,175005,42,0,11,1,10
2020,175005,42,2,1,0,1
2020,175005,42,3,10,1,9
2020,175005,44,0,112,16,96
2020,175005,44,1,3,0,3
2020,175005,44,2,23,5,18
2020,175005,44,3,84,9,75
2020,175005,44,4,2,2,0
2020,175014,0,0,90,12,78
2020,175014,10,0,90,12,78
2020,175014,10,4,90,12,78
2020,175014,40,0,90,12,78
2020,175014,40,4,90,12,78
2020,175014,41,0,90,12,78
2020,175014,41,4,90,12,78
2020,175014,45,0,90,12,78
2020,175014,45,4,90,12,78
2020,175041,0,0,119,47,72
2020,175041,10,0,119,47,72
2020,175041,10,4,119,47,72
2020,175041,20,0,94,39,55
2020,175041,20,4,94,39,55
2020,175041,30,0,24,8,16
2020,175041,30,4,24,8,16
2020,175041,40,0,1,0,1
2020,175041,40,4,1,0,1
2020,175041,42,0,1,0,1
2020,175041,42,4,1,0,1
2020,175078,0,0,104,52,52
2020,175078,10,0,104,52,52
2020,175078,10,1,49,28,21
2020,175078,10,2,26,14,12
2020,175078,10,3,28,9,19
2020,175078,10,4,1,1,0
2020,175078,20,0,74,42,32
2020,175078,20,1,49,28,21
2020,175078,20,2,25,14,11
2020,175078,30,0,16,8,8
2020,175078,30,2,1,0,1
2020,175078,30,3,15,8,7
2020,175078,40,0,14,2,12
2020,175078,40,3,13,1,12
2020,175078,40,4,1,1,0
2020,175078,41,0,1,0,1
2020,175078,41,3,1,0,1
2020,175078,42,0,13,2,11
2020,175078,42,3,12,1,11
2020,175078,42,4,1,1,0
2020,175078,44,0,1,0,1
2020,175078,44,3,1,0,1
2020,175139,0,0,8,7,1
2020,175139,10,0,8,7,1
2020,175139,10,1,2,2,0
2020,175139,10,2,2,2,0
2020,175139,10,3,4,3,1
2020,175139,20,0,2,2,0
2020,175139,20,1,2,2,0
2020,175139,30,0,5,4,1
2020,175139,30,2,2,2,0
2020,175139,30,3,3,2,1
2020,175139,40,0,1,1,0
2020,175139,40,3,1,1,0
2020,175139,41,0,1,1,0
2020,175139,41,3,1,1,0
2020,175139,44,0,1,1,0
2020,175139,44,3,1,1,0
2020,175157,0,0,14,9,5
2020,175157,10,0,14,9,5
2020,175157,10,4,14,9,5
2020,175157,20,0,10,6,4
2020,175157,20,4,10,6,4
2020,175157,30,0,4,3,1
2020,175157,30,4,4,3,1
2020,175227,0,0,93,70,23
2020,175227,10,0,93,70,23
2020,175227,10,1,2,1,1
2020,175227,10,2,21,12,9
2020,175227,10,3,24,18,6
2020,175227,10,4,46,39,7
2020,175227,40,0,93,70,23
2020,175227,40,1,2,1,1
2020,175227,40,2,21,12,9
2020,175227,40,3,24,18,6
2020,175227,40,4,46,39,7
2020,175227,41,0,93,70,23
2020,175227,41,1,2,1,1
2020,175227,41,2,21,12,9
2020,175227,41,3,24,18,6
2020,175227,41,4,46,39,7
2020,175227,45,0,93,70,23
2020,175227,45,1,2,1,1
2020,175227,45,2,21,12,9
2020,175227,45,3,24,18,6
2020,175227,45,4,46,39,7
2020,175236,0,0,93,50,43
2020,175236,10,0,93,50,43
2020,175236,10,4,93,50,43
2020,175236,20,0,78,44,34
2020,175236,20,4,78,44,34
2020,175236,30,0,15,6,9
2020,175236,30,4,15,6,9
2020,175263,0,0,49,26,23
2020,175263,10,0,49,26,23
2020,175263,10,4,49,26,23
2020,175263,20,0,38,19,19
2020,175263,20,4,38,19,19
2020,175263,30,0,10,7,3
2020,175263,30,4,10,7,3
2020,175263,40,0,1,0,1
2020,175263,40,4,1,0,1
2020,175263,43,0,1,0,1
2020,175263,43,4,1,0,1
2020,175272,0,0,303,150,153
2020,175272,10,0,303,150,153
2020,175272,10,1,123,70,53
2020,175272,10,2,78,41,37
2020,175272,10,3,91,35,56
2020,175272,10,4,11,4,7
2020,175272,20,0,201,113,88
2020,175272,20,1,122,70,52
2020,175272,20,2,75,39,36
2020,175272,20,3,4,4,0
2020,175272,30,0,64,26,38
2020,175272,30,1,1,0,1
2020,175272,30,2,2,2,0
2020,175272,30,3,61,24,37
2020,175272,40,0,38,11,27
2020,175272,40,2,1,0,1
2020,175272,40,3,26,7,19
2020,175272,40,4,11,4,7
2020,175272,42,0,37,11,26
2020,175272,42,3,26,7,19
2020,175272,42,4,11,4,7
2020,175272,43,0,1,0,1
2020,175272,43,2,1,0,1
2020,175281,0,0,42,21,21
2020,175281,10,0,42,21,21
2020,175281,10,1,32,19,13
2020,175281,10,2,3,0,3
2020,175281,10,3,3,1,2
2020,175281,10,6,4,1,3
2020,175281,20,0,29,17,12
2020,175281,20,1,29,17,12
2020,175281,40,0,13,4,9
2020,175281,40,1,3,2,1
2020,175281,40,2,3,0,3
2020,175281,40,3,3,1,2
2020,175281,40,6,4,1,3
2020,175281,41,0,9,3,6
2020,175281,41,1,3,2,1
2020,175281,41,2,3,0,3
2020,175281,41,3,3,1,2
2020,175281,42,0,4,1,3
2020,175281,42,6,4,1,3
2020,175281,44,0,1,1,0
2020,175281,44,3,1,1,0
2020,175281,45,0,8,2,6
2020,175281,45,1,3,2,1
2020,175281,45,2,3,0,3
2020,175281,45,3,2,0,2
2020,175315,0,0,150,67,83
2020,175315,10,0,150,67,83
2020,175315,10,4,150,67,83
2020,175315,20,0,139,63,76
2020,175315,20,4,139,63,76
2020,175315,30,0,5,2,3
2020,175315,30,4,5,2,3
2020,175315,40,0,6,2,4
2020,175315,40,4,6,2,4
2020,175315,42,0,4,1,3
2020,175315,42,4,4,1,3
2020,175315,43,0,2,1,1
2020,175315,43,4,2,1,1
2020,175342,0,0,148,79,69
2020,175342,10,0,148,79,69
2020,175342,10,1,25,21,4
2020,175342,10,2,27,13,14
2020,175342,10,3,53,25,28
2020,175342,10,4,43,20,23
2020,175342,20,0,44,30,14
2020,175342,20,1,25,21,4
2020,175342,20,2,15,7,8
2020,175342,20,3,4,2,2
2020,175342,30,0,27,13,14
2020,175342,30,2,7,4,3
2020,175342,30,3,20,9,11
2020,175342,40,0,77,36,41
2020,175342,40,2,5,2,3
2020,175342,40,3,29,14,15
2020,175342,40,4,43,20,23
2020,175342,42,0,74,35,39
2020,175342,42,2,5,2,3
2020,175342,42,3,29,14,15
2020,175342,42,4,40,19,21
2020,175342,43,0,3,1,2
2020,175342,43,4,3,1,2
2020,175421,0,0,75,39,36
2020,175421,10,0,75,39,36
2020,175421,10,1,24,14,10
2020,175421,10,2,18,7,11
2020,175421,10,3,24,13,11
2020,175421,10,4,9,5,4
2020,175421,20,0,33,17,16
2020,175421,20,1,22,13,9
2020,175421,20,2,11,4,7
2020,175421,30,0,29,14,15
2020,175421,30,2,7,3,4
2020,175421,30,3,22,11,11
2020,175421,40,0,13,8,5
2020,175421,40,1,2,1,1
2020,175421,40,3,2,2,0
2020,175421,40,4,9,5,4
2020,175421,42,0,12,7,5
2020,175421,42,1,2,1,1
2020,175421,42,3,2,2,0
2020,175421,42,4,8,4,4
2020,175421,43,0,1,1,0
2020,175421,43,4,1,1,0
2020,175430,0,0,38,18,20
2020,175430,10,0,38,18,20
2020,175430,10,1,7,4,3
2020,175430,10,2,13,7,6
2020,175430,10,3,11,4,7
2020,175430,10,4,7,3,4
2020,175430,40,0,38,18,20
2020,175430,40,1,7,4,3
2020,175430,40,2,13,7,6
2020,175430,40,3,11,4,7
2020,175430,40,4,7,3,4
2020,175430,42,0,38,18,20
2020,175430,42,1,7,4,3
2020,175430,42,2,13,7,6
2020,175430,42,3,11,4,7
2020,175430,42,4,7,3,4
2020,175519,0,0,76,33,43
2020,175519,10,0,76,33,43
2020,175519,10,4,76,33,43
2020,175519,40,0,76,33,43
2020,175519,40,4,76,33,43
2020,175519,42,0,76,33,43
2020,175519,42,4,76,33,43
2020,175573,0,0,100,41,59
2020,175573,10,0,100,41,59
2020,175573,10,4,100,41,59
2020,175573,40,0,100,41,59
2020,175573,40,4,100,41,59
2020,175573,42,0,100,41,59
2020,175573,42,4,100,41,59
2020,175616,0,0,146,61,85
2020,175616,10,0,146,61,85
2020,175616,10,1,14,9,5
2020,175616,10,2,43,24,19
2020,175616,10,3,52,20,32
2020,175616,10,4,37,8,29
2020,175616,20,0,53,29,24
2020,175616,20,1,10,5,5
2020,175616,20,2,42,23,19
2020,175616,20,3,1,1,0
2020,175616,30,0,49,18,31
2020,175616,30,3,49,18,31
2020,175616,40,0,44,14,30
2020,175616,40,1,4,4,0
2020,175616,40,2,1,1,0
2020,175616,40,3,2,1,1
2020,175616,40,4,37,8,29
2020,175616,42,0,44,14,30
2020,175616,42,1,4,4,0
2020,175616,42,2,1,1,0
2020,175616,42,3,2,1,1
2020,175616,42,4,37,8,29
2020,175643,0,0,85,33,52
2020,175643,10,0,78,32,46
2020,175643,10,4,78,32,46
2020,175643,40,0,78,32,46
2020,175643,40,4,78,32,46
2020,175643,42,0,7,1,6
2020,175643,42,4,7,1,6
2020,175643,43,0,71,31,40
2020,175643,43,4,71,31,40
2020,175643,50,0,7,1,6
2020,175652,0,0,94,46,48
2020,175652,10,0,94,46,48
2020,175652,10,4,94,46,48
2020,175652,40,0,94,46,48
2020,175652,40,4,94,46,48
2020,175652,42,0,94,46,48
2020,175652,42,4,94,46,48
2020,175786,0,0,426,152,274
2020,175786,10,0,411,149,262
2020,175786,10,4,411,149,262
2020,175786,40,0,411,149,262
2020,175786,40,4,411,149,262
2020,175786,42,0,411,149,262
2020,175786,42,4,411,149,262
2020,175786,50,0,15,3,12
2020,175810,0,0,136,48,88
2020,175810,10,0,136,48,88
2020,175810,10,6,136,48,88
2020,175810,40,0,136,48,88
2020,175810,40,6,136,48,88
2020,175810,42,0,136,48,88
2020,175810,42,6,136,48,88
2020,175829,0,0,133,46,87
2020,175829,10,0,133,46,87
2020,175829,10,4,133,46,87
2020,175829,40,0,133,46,87
2020,175829,40,4,133,46,87
2020,175829,42,0,131,46,85
2020,175829,42,4,131,46,85
2020,175829,43,0,2,0,2
2020,175829,43,4,2,0,2
2020,175856,0,0,327,159,168
2020,175856,10,0,327,159,168
2020,175856,10,1,84,53,31
2020,175856,10,2,84,43,41
2020,175856,10,3,86,39,47
2020,175856,10,4,68,23,45
2020,175856,10,5,5,1,4
2020,175856,20,0,153,89,64
2020,175856,20,1,80,52,28
2020,175856,20,2,66,33,33
2020,175856,20,3,7,4,3
2020,175856,30,0,54,26,28
2020,175856,30,1,2,0,2
2020,175856,30,2,12,7,5
2020,175856,30,3,40,19,21
2020,175856,40,0,120,44,76
2020,175856,40,1,2,1,1
2020,175856,40,2,6,3,3
2020,175856,40,3,39,16,23
2020,175856,40,4,68,23,45
2020,175856,40,5,5,1,4
2020,175856,42,0,120,44,76
2020,175856,42,1,2,1,1
2020,175856,42,2,6,3,3
2020,175856,42,3,39,16,23
2020,175856,42,4,68,23,45
2020,175856,42,5,5,1,4
2020,175883,0,0,124,51,73
2020,175883,10,0,124,51,73
2020,175883,10,4,124,51,73
2020,175883,40,0,124,51,73
2020,175883,40,4,124,51,73
2020,175883,42,0,119,47,72
2020,175883,42,4,119,47,72
2020,175883,43,0,5,4,1
2020,175883,43,4,5,4,1
2020,175935,0,0,121,33,88
2020,175935,10,0,121,33,88
2020,175935,10,4,121,33,88
2020,175935,40,0,121,33,88
2020,175935,40,4,121,33,88
2020,175935,42,0,121,33,88
2020,175935,42,4,121,33,88
2020,175980,0,0,75,39,36
2020,175980,10,0,74,39,35
2020,175980,10,1,25,17,8
2020,175980,10,2,26,10,16
2020,175980,10,3,13,7,6
2020,175980,10,4,7,4,3
2020,175980,10,6,3,1,2
2020,175980,20,0,49,27,22
2020,175980,20,1,25,17,8
2020,175980,20,2,23,9,14
2020,175980,20,3,1,1,0
2020,175980,30,0,13,7,6
2020,175980,30,2,3,1,2
2020,175980,30,3,10,6,4
2020,175980,40,0,12,5,7
2020,175980,40,3,2,0,2
2020,175980,40,4,7,4,3
2020,175980,40,6,3,1,2
2020,175980,41,0,1,1,0
2020,175980,41,6,1,1,0
2020,175980,42,0,11,4,7
2020,175980,42,3,2,0,2
2020,175980,42,4,7,4,3
2020,175980,42,6,2,0,2
2020,175980,45,0,1,1,0
2020,175980,45,6,1,1,0
2020,175980,50,0,1,0,1
2020,176008,0,0,97,32,65
2020,176008,10,0,97,32,65
2020,176008,10,4,97,32,65
2020,176008,40,0,97,32,65
2020,176008,40,4,97,32,65
2020,176008,42,0,97,32,65
2020,176008,42,4,97,32,65
2020,176017,0,0,1869,1007,862
2020,176017,10,0,1869,1007,862
2020,176017,10,1,466,316,150
2020,176017,10,2,498,285,213
2020,176017,10,3,615,308,307
2020,176017,10,4,235,76,159
2020,176017,10,5,55,22,33
2020,176017,20,0,636,412,224
2020,176017,20,1,351,238,113
2020,176017,20,2,282,173,109
2020,176017,20,3,3,1,2
2020,176017,30,0,276,164,112
2020,176017,30,1,15,12,3
2020,176017,30,2,40,24,16
2020,176017,30,3,221,128,93
2020,176017,40,0,957,431,526
2020,176017,40,1,100,66,34
2020,176017,40,2,176,88,88
2020,176017,40,3,391,179,212
2020,176017,40,4,235,76,159
2020,176017,40,5,55,22,33
2020,176017,42,0,946,428,518
2020,176017,42,1,100,66,34
2020,176017,42,2,176,88,88
2020,176017,42,3,387,177,210
2020,176017,42,4,228,75,153
2020,176017,42,5,55,22,33
2020,176017,43,0,11,3,8
2020,176017,43,3,4,2,2
2020,176017,43,4,7,1,6
2020,176035,0,0,143,45,98
2020,176035,10,0,143,45,98
2020,176035,10,1,41,14,27
2020,176035,10,2,21,11,10
2020,176035,10,3,41,12,29
2020,176035,10,4,40,8,32
2020,176035,20,0,53,22,31
2020,176035,20,1,40,13,27
2020,176035,20,2,13,9,4
2020,176035,30,0,45,13,32
2020,176035,30,1,1,1,0
2020,176035,30,2,8,2,6
2020,176035,30,3,36,10,26
2020,176035,40,0,45,10,35
2020,176035,40,3,5,2,3
2020,176035,40,4,40,8,32
2020,176035,42,0,45,10,35
2020,176035,42,3,5,2,3
2020,176035,42,4,40,8,32
2020,176044,0,0,105,50,55
2020,176044,10,0,105,50,55
2020,176044,10,1,21,13,8
2020,176044,10,2,20,11,9
2020,176044,10,3,37,13,24
2020,176044,10,4,27,13,14
2020,176044,20,0,51,27,24
2020,176044,20,1,21,13,8
2020,176044,20,2,17,9,8
2020,176044,20,3,13,5,8
2020,176044,30,0,27,10,17
2020,176044,30,2,3,2,1
2020,176044,30,3,24,8,16
2020,176044,40,0,27,13,14
2020,176044,40,4,27,13,14
2020,176044,42,0,27,13,14
2020,176044,42,4,27,13,14
2020,176053,0,0,200,108,92
2020,176053,10,0,200,108,92
2020,176053,10,1,63,48,15
2020,176053,10,2,53,28,25
2020,176053,10,3,51,22,29
2020,176053,10,4,33,10,23
2020,176053,20,0,102,67,35
2020,176053,20,1,59,44,15
2020,176053,20,2,42,22,20
2020,176053,20,3,1,1,0
2020,176053,30,0,41,22,19
2020,176053,30,1,1,1,0
2020,176053,30,2,7,4,3
2020,176053,30,3,33,17,16
2020,176053,40,0,57,19,38
2020,176053,40,1,3,3,0
2020,176053,40,2,4,2,2
2020,176053,40,3,17,4,13
2020,176053,40,4,33,10,23
2020,176053,42,0,57,19,38
2020,176053,42,1,3,3,0
2020,176053,42,2,4,2,2
2020,176053,42,3,17,4,13
2020,176053,42,4,33,10,23
2020,176071,0,0,272,108,164
2020,176071,10,0,272,108,164
2020,176071,10,4,272,108,164
2020,176071,40,0,272,108,164
2020,176071,40,4,272,108,164
2020,176071,42,0,272,108,164
2020,176071,42,4,272,108,164
2020,176080,0,0,970,573,397
2020,176080,10,0,970,573,397
2020,176080,10,1,227,177,50
2020,176080,10,2,254,169,85
2020,176080,10,3,264,156,108
2020,176080,10,4,164,51,113
2020,176080,10,5,61,20,41
2020,176080,20,0,466,333,133
2020,176080,20,1,226,176,50
2020,176080,20,2,240,157,83
2020,176080,30,0,273,163,110
2020,176080,30,1,1,1,0
2020,176080,30,2,14,12,2
2020,176080,30,3,257,150,107
2020,176080,30,4,1,0,1
2020,176080,40,0,231,77,154
2020,176080,40,3,7,6,1
2020,176080,40,4,163,51,112
2020,176080,40,5,61,20,41
2020,176080,42,0,17,5,12
2020,176080,42,4,17,5,12
2020,176080,43,0,214,72,142
2020,176080,43,3,7,6,1
2020,176080,43,4,146,46,100
2020,176080,43,5,61,20,41
2020,176169,0,0,122,41,81
2020,176169,10,0,122,41,81
2020,176169,10,6,122,41,81
2020,176169,40,0,122,41,81
2020,176169,40,6,122,41,81
2020,176169,42,0,122,41,81
2020,176169,42,6,122,41,81
2020,176178,0,0,210,86,124
2020,176178,10,0,202,85,117
2020,176178,10,4,202,85,117
2020,176178,40,0,202,85,117
2020,176178,40,4,202,85,117
2020,176178,42,0,202,85,117
2020,176178,42,4,202,85,117
2020,176178,50,0,8,1,7
2020,176239,0,0,172,64,108
2020,176239,10,0,172,64,108
2020,176239,10,6,172,64,108
2020,176239,40,0,172,64,108
2020,176239,40,6,172,64,108
2020,176239,42,0,172,64,108
2020,176239,42,6,172,64,108
2020,176318,0,0,44,18,26
2020,176318,10,0,44,18,26
2020,176318,10,1,5,5,0
2020,176318,10,2,6,3,3
2020,176318,10,3,12,5,7
2020,176318,10,4,7,5,2
2020,176318,10,6,14,0,14
2020,176318,40,0,44,18,26
2020,176318,40,1,5,5,0
2020,176318,40,2,6,3,3
2020,176318,40,3,12,5,7
2020,176318,40,4,7,5,2
2020,176318,40,6,14,0,14
2020,176318,42,0,44,18,26
2020,176318,42,1,5,5,0
2020,176318,42,2,6,3,3
2020,176318,42,3,12,5,7
2020,176318,42,4,7,5,2
2020,176318,42,6,14,0,14
2020,176354,0,0,66,20,46
2020,176354,10,0,66,20,46
2020,176354,10,4,66,20,46
2020,176354,40,0,66,20,46
2020,176354,40,4,66,20,46
2020,176354,42,0,66,20,46
2020,176354,42,4,66,20,46
2020,176372,0,0,629,319,310
2020,176372,10,0,629,319,310
2020,176372,10,1,153,104,49
2020,176372,10,2,191,110,81
2020,176372,10,3,185,79,106
2020,176372,10,4,78,24,54
2020,176372,10,5,22,2,20
2020,176372,20,0,319,198,121
2020,176372,20,1,150,101,49
2020,176372,20,2,167,97,70
2020,176372,20,3,2,0,2
2020,176372,30,0,136,66,70
2020,176372,30,1,1,1,0
2020,176372,30,2,8,5,3
2020,176372,30,3,127,60,67
2020,176372,40,0,174,55,119
2020,176372,40,1,2,2,0
2020,176372,40,2,16,8,8
2020,176372,40,3,56,19,37
2020,176372,40,4,78,24,54
2020,176372,40,5,22,2,20
2020,176372,42,0,174,55,119
2020,176372,42,1,2,2,0
2020,176372,42,2,16,8,8
2020,176372,42,3,56,19,37
2020,176372,42,4,78,24,54
2020,176372,42,5,22,2,20
2020,176406,0,0,60,28,32
2020,176406,10,0,60,28,32
2020,176406,10,1,10,6,4
2020,176406,10,2,22,14,8
2020,176406,10,3,18,6,12
2020,176406,10,4,10,2,8
2020,176406,20,0,32,19,13
2020,176406,20,1,10,6,4
2020,176406,20,2,21,13,8
2020,176406,20,3,1,0,1
2020,176406,30,0,14,4,10
2020,176406,30,3,14,4,10
2020,176406,40,0,14,5,9
2020,176406,40,2,1,1,0
2020,176406,40,3,3,2,1
2020,176406,40,4,10,2,8
2020,176406,43,0,14,5,9
2020,176406,43,2,1,1,0
2020,176406,43,3,3,2,1
2020,176406,43,4,10,2,8
2020,176451,0,0,4,4,0
2020,176451,10,0,4,4,0
2020,176451,10,1,2,2,0
2020,176451,10,2,2,2,0
2020,176451,40,0,4,4,0
2020,176451,40,1,2,2,0
2020,176451,40,2,2,2,0
2020,176451,41,0,2,2,0
2020,176451,41,1,2,2,0
2020,176451,42,0,2,2,0
2020,176451,42,2,2,2,0
2020,176451,44,0,2,2,0
2020,176451,44,1,2,2,0
2020,176479,0,0,209,95,114
2020,176479,10,0,209,95,114
2020,176479,10,1,25,17,8
2020,176479,10,2,59,27,32
2020,176479,10,3,103,39,64
2020,176479,10,4,22,12,10
2020,176479,20,0,9,3,6
2020,176479,20,1,8,3,5
2020,176479,20,2,1,0,1
2020,176479,30,0,200,92,108
2020,176479,30,1,17,14,3
2020,176479,30,2,58,27,31
2020,176479,30,3,103,39,64
2020,176479,30,4,22,12,10
2020,176600,0,0,10,6,4
2020,176600,10,0,10,6,4
2020,176600,10,1,3,2,1
2020,176600,10,2,2,0,2
2020,176600,10,3,5,4,1
2020,176600,40,0,10,6,4
2020,176600,40,1,3,2,1
2020,176600,40,2,2,0,2
2020,176600,40,3,5,4,1
2020,176600,42,0,10,6,4
2020,176600,42,1,3,2,1
2020,176600,42,2,2,0,2
2020,176600,42,3,5,4,1
2020,176628,0,0,64,26,38
2020,176628,10,0,62,25,37
2020,176628,10,1,9,5,4
2020,176628,10,2,21,10,11
2020,176628,10,3,25,7,18
2020,176628,10,4,7,3,4
2020,176628,20,0,38,18,20
2020,176628,20,1,9,5,4
2020,176628,20,2,21,10,11
2020,176628,20,3,7,2,5
2020,176628,20,4,1,1,0
2020,176628,30,0,20,5,15
2020,176628,30,3,18,5,13
2020,176628,30,4,2,0,2
2020,176628,40,0,4,2,2
2020,176628,40,4,4,2,2
2020,176628,42,0,4,2,2
2020,176628,42,4,4,2,2
2020,176628,50,0,2,1,1
2020,176664,0,0,9,7,2
2020,176664,10,0,9,7,2
2020,176664,10,6,9,7,2
2020,176664,40,0,9,7,2
2020,176664,40,6,9,7,2
2020,176664,42,0,9,7,2
2020,176664,42,6,9,7,2
2020,176770,0,0,59,6,53
2020,176770,10,0,59,6,53
2020,176770,10,1,4,0,4
2020,176770,10,2,10,2,8
2020,176770,10,3,44,4,40
2020,176770,10,4,1,0,1
2020,176770,40,0,59,6,53
2020,176770,40,1,4,0,4
2020,176770,40,2,10,2,8
2020,176770,40,3,44,4,40
2020,176770,40,4,1,0,1
2020,176770,42,0,59,6,53
2020,176770,42,1,4,0,4
2020,176770,42,2,10,2,8
2020,176770,42,3,44,4,40
2020,176770,42,4,1,0,1
2020,176789,0,0,21,13,8
2020,176789,10,0,21,13,8
2020,176789,10,1,6,5,1
2020,176789,10,2,4,3,1
2020,176789,10,3,7,5,2
2020,176789,10,6,4,0,4
2020,176789,40,0,21,13,8
2020,176789,40,1,6,5,1
2020,176789,40,2,4,3,1
2020,176789,40,3,7,5,2
2020,176789,40,6,4,0,4
2020,176789,41,0,21,13,8
2020,176789,41,1,6,5,1
2020,176789,41,2,4,3,1
2020,176789,41,3,7,5,2
2020,176789,41,6,4,0,4
2020,176789,45,0,21,13,8
2020,176789,45,1,6,5,1
2020,176789,45,2,4,3,1
2020,176789,45,3,7,5,2
2020,176789,45,6,4,0,4
2020,176910,0,0,15,12,3
2020,176910,10,0,15,12,3
2020,176910,10,1,15,12,3
2020,176910,40,0,15,12,3
2020,176910,40,1,15,12,3
2020,176910,42,0,15,12,3
2020,176910,42,1,15,12,3
2020,176947,0,0,79,38,41
2020,176947,10,0,79,38,41
2020,176947,10,1,21,15,6
2020,176947,10,2,25,10,15
2020,176947,10,3,32,13,19
2020,176947,10,4,1,0,1
2020,176947,20,0,30,18,12
2020,176947,20,1,18,14,4
2020,176947,20,2,12,4,8
2020,176947,30,0,16,10,6
2020,176947,30,1,1,1,0
2020,176947,30,2,1,0,1
2020,176947,30,3,14,9,5
2020,176947,40,0,33,10,23
2020,176947,40,1,2,0,2
2020,176947,40,2,12,6,6
2020,176947,40,3,18,4,14
2020,176947,40,4,1,0,1
2020,176947,42,0,33,10,23
2020,176947,42,1,2,0,2
2020,176947,42,2,12,6,6
2020,176947,42,3,18,4,14
2020,176947,42,4,1,0,1
2020,176965,0,0,424,213,211
2020,176965,10,0,424,213,211
2020,176965,10,1,108,65,43
2020,176965,10,2,56,32,24
2020,176965,10,3,81,42,39
2020,176965,10,4,33,10,23
2020,176965,10,6,146,64,82
2020,176965,20,0,210,123,87
2020,176965,20,1,108,65,43
2020,176965,20,2,55,31,24
2020,176965,20,3,36,19,17
2020,176965,20,6,11,8,3
2020,176965,30,0,95,47,48
2020,176965,30,3,29,16,13
2020,176965,30,4,2,0,2
2020,176965,30,6,64,31,33
2020,176965,40,0,119,43,76
2020,176965,40,2,1,1,0
2020,176965,40,3,16,7,9
2020,176965,40,4,31,10,21
2020,176965,40,6,71,25,46
2020,176965,41,0,1,0,1
2020,176965,41,3,1,0,1
2020,176965,42,0,118,43,75
2020,176965,42,2,1,1,0
2020,176965,42,3,15,7,8
2020,176965,42,4,31,10,21
2020,176965,42,6,71,25,46
2020,176965,44,0,1,0,1
2020,176965,44,3,1,0,1
2020,177038,0,0,40,22,18
2020,177038,10,0,40,22,18
2020,177038,10,1,7,5,2
2020,177038,10,2,7,3,4
2020,177038,10,3,6,1,5
2020,177038,10,4,20,13,7
2020,177038,40,0,40,22,18
2020,177038,40,1,7,5,2
2020,177038,40,2,7,3,4
2020,177038,40,3,6,1,5
2020,177038,40,4,20,13,7
2020,177038,41,0,8,5,3
2020,177038,41,1,5,4,1
2020,177038,41,2,2,1,1
2020,177038,41,3,1,0,1
2020,177038,42,0,27,14,13
2020,177038,42,1,1,0,1
2020,177038,42,2,4,2,2
2020,177038,42,3,5,1,4
2020,177038,42,4,17,11,6
2020,177038,43,0,5,3,2
2020,177038,43,1,1,1,0
2020,177038,43,2,1,0,1
2020,177038,43,4,3,2,1
2020,177038,44,0,8,5,3
2020,177038,44,1,5,4,1
2020,177038,44,2,2,1,1
2020,177038,44,3,1,0,1
2020,177065,0,0,68,33,35
2020,177065,10,0,68,33,35
2020,177065,10,1,17,7,10
2020,177065,10,2,23,16,7
2020,177065,10,3,19,9,10
2020,177065,10,4,7,1,6
2020,177065,10,6,2,0,2
2020,177065,20,0,41,23,18
2020,177065,20,1,16,6,10
2020,177065,20,2,22,16,6
2020,177065,20,3,3,1,2
2020,177065,30,0,14,6,8
2020,177065,30,2,1,0,1
2020,177065,30,3,13,6,7
2020,177065,40,0,13,4,9
2020,177065,40,1,1,1,0
2020,177065,40,3,3,2,1
2020,177065,40,4,7,1,6
2020,177065,40,6,2,0,2
2020,177065,42,0,13,4,9
2020,177065,42,1,1,1,0
2020,177065,42,3,3,2,1
2020,177065,42,4,7,1,6
2020,177065,42,6,2,0,2
2020,177092,0,0,30,30,0
2020,177092,10,0,30,30,0
2020,177092,10,1,15,15,0
2020,177092,10,2,12,12,0
2020,177092,10,3,3,3,0
2020,177092,40,0,30,30,0
2020,177092,40,1,15,15,0
2020,177092,40,2,12,12,0
2020,177092,40,3,3,3,0
2020,177092,41,0,26,26,0
2020,177092,41,1,14,14,0
2020,177092,41,2,10,10,0
2020,177092,41,3,2,2,0
2020,177092,42,0,4,4,0
2020,177092,42,1,1,1,0
2020,177092,42,2,2,2,0
2020,177092,42,3,1,1,0
2020,177092,44,0,26,26,0
2020,177092,44,1,14,14,0
2020,177092,44,2,10,10,0
2020,177092,44,3,2,2,0
2020,177117,0,0,42,9,33
2020,177117,10,0,42,9,33
2020,177117,10,1,15,3,12
2020,177117,10,2,9,2,7
2020,177117,10,3,18,4,14
2020,177117,20,0,24,5,19
2020,177117,20,1,15,3,12
2020,177117,20,2,9,2,7
2020,177117,30,0,16,3,13
2020,177117,30,3,16,3,13
2020,177117,40,0,2,1,1
2020,177117,40,3,2,1,1
2020,177117,42,0,2,1,1
2020,177117,42,3,2,1,1
2020,177126,0,0,15,13,2
2020,177126,10,0,15,13,2
2020,177126,10,1,9,8,1
2020,177126,10,2,3,3,0
2020,177126,10,3,3,2,1
2020,177126,40,0,15,13,2
2020,177126,40,1,9,8,1
2020,177126,40,2,3,3,0
2020,177126,40,3,3,2,1
2020,177126,41,0,12,11,1
2020,177126,41,1,9,8,1
2020,177126,41,2,3,3,0
2020,177126,42,0,3,2,1
2020,177126,42,3,3,2,1
2020,177126,44,0,12,11,1
2020,177126,44,1,9,8,1
2020,177126,44,2,3,3,0
2020,177135,0,0,138,58,80
2020,177135,10,0,138,58,80
2020,177135,10,6,138,58,80
2020,177135,40,0,138,58,80
2020,177135,40,6,138,58,80
2020,177135,42,0,138,58,80
2020,177135,42,6,138,58,80
2020,177144,0,0,48,25,23
2020,177144,10,0,48,25,23
2020,177144,10,1,9,6,3
2020,177144,10,2,11,5,6
2020,177144,10,3,15,8,7
2020,177144,10,5,13,6,7
2020,177144,20,0,20,11,9
2020,177144,20,1,9,6,3
2020,177144,20,2,11,5,6
2020,177144,30,0,14,7,7
2020,177144,30,3,13,7,6
2020,177144,30,5,1,0,1
2020,177144,40,0,14,7,7
2020,177144,40,3,2,1,1
2020,177144,40,5,12,6,6
2020,177144,43,0,14,7,7
2020,177144,43,3,2,1,1
2020,177144,43,5,12,6,6
2020,177214,0,0,105,58,47
2020,177214,10,0,105,58,47
2020,177214,10,1,41,21,20
2020,177214,10,2,32,21,11
2020,177214,10,3,25,13,12
2020,177214,10,4,7,3,4
2020,177214,20,0,72,42,30
2020,177214,20,1,41,21,20
2020,177214,20,2,31,21,10
2020,177214,30,0,17,8,9
2020,177214,30,2,1,0,1
2020,177214,30,3,16,8,8
2020,177214,40,0,16,8,8
2020,177214,40,3,9,5,4
2020,177214,40,4,7,3,4
2020,177214,42,0,16,8,8
2020,177214,42,3,9,5,4
2020,177214,42,4,7,3,4
2020,177250,0,0,65,30,35
2020,177250,10,0,65,30,35
2020,177250,10,1,3,1,2
2020,177250,10,2,9,5,4
2020,177250,10,3,16,7,9
2020,177250,10,4,37,17,20
2020,177250,20,0,38,20,18
2020,177250,20,1,3,1,2
2020,177250,20,2,9,5,4
2020,177250,20,3,15,6,9
2020,177250,20,4,11,8,3
2020,177250,30,0,27,10,17
2020,177250,30,3,1,1,0
2020,177250,30,4,26,9,17
2020,177278,0,0,8,4,4
2020,177278,10,0,8,4,4
2020,177278,10,1,3,1,2
2020,177278,10,2,2,1,1
2020,177278,10,3,2,2,0
2020,177278,10,4,1,0,1
2020,177278,20,0,5,2,3
2020,177278,20,1,3,1,2
2020,177278,20,2,2,1,1
2020,177278,30,0,2,2,0
2020,177278,30,3,2,2,0
2020,177278,40,0,1,0,1
2020,177278,40,4,1,0,1
2020,177278,41,0,1,0,1
2020,177278,41,4,1,0,1
2020,177278,44,0,1,0,1
2020,177278,44,4,1,0,1
2020,177302,0,0,8,4,4
2020,177302,10,0,8,4,4
2020,177302,10,4,8,4,4
2020,177302,40,0,8,4,4
2020,177302,40,4,8,4,4
2020,177302,41,0,8,4,4
2020,177302,41,4,8,4,4
2020,177302,45,0,8,4,4
2020,177302,45,4,8,4,4
2020,177339,0,0,84,48,36
2020,177339,10,0,84,48,36
2020,177339,10,1,32,21,11
2020,177339,10,2,30,20,10
2020,177339,10,3,20,6,14
2020,177339,10,4,2,1,1
2020,177339,20,0,42,28,14
2020,177339,20,1,25,19,6
2020,177339,20,2,15,9,6
2020,177339,20,3,2,0,2
2020,177339,30,0,38,17,21
2020,177339,30,1,7,2,5
2020,177339,30,2,14,10,4
2020,177339,30,3,17,5,12
2020,177339,40,0,4,3,1
2020,177339,40,2,1,1,0
2020,177339,40,3,1,1,0
2020,177339,40,4,2,1,1
2020,177339,42,0,4,3,1
2020,177339,42,2,1,1,0
2020,177339,42,3,1,1,0
2020,177339,42,4,2,1,1
2020,177418,0,0,54,17,37
2020,177418,10,0,54,17,37
2020,177418,10,1,15,6,9
2020,177418,10,2,17,6,11
2020,177418,10,3,16,2,14
2020,177418,10,4,6,3,3
2020,177418,20,0,30,11,19
2020,177418,20,1,15,6,9
2020,177418,20,2,15,5,10
2020,177418,30,0,15,3,12
2020,177418,30,2,2,1,1
2020,177418,30,3,13,2,11
2020,177418,40,0,9,3,6
2020,177418,40,3,3,0,3
2020,177418,40,4,6,3,3
2020,177418,42,0,9,3,6
2020,177418,42,3,3,0,3
2020,177418,42,4,6,3,3
2020,177472,0,0,215,89,126
2020,177472,10,0,215,89,126
2020,177472,10,6,215,89,126
2020,177472,40,0,215,89,126
2020,177472,40,6,215,89,126
2020,177472,42,0,214,89,125
2020,177472,42,6,214,89,125
2020,177472,43,0,1,0,1
2020,177472,43,6,1,0,1
2020,177542,0,0,49,25,24
2020,177542,10,0,49,25,24
2020,177542,10,1,9,6,3
2020,177542,10,2,6,4,2
2020,177542,10,3,22,9,13
2020,177542,10,4,12,6,6
2020,177542,40,0,49,25,24
2020,177542,40,1,9,6,3
2020,177542,40,2,6,4,2
2020,177542,40,3,22,9,13
2020,177542,40,4,12,6,6
2020,177542,42,0,49,25,24
2020,177542,42,1,9,6,3
2020,177542,42,2,6,4,2
2020,177542,42,3,22,9,13
2020,177542,42,4,12,6,6
2020,177551,0,0,40,23,17
2020,177551,10,0,40,23,17
2020,177551,10,1,3,1,2
2020,177551,10,2,18,13,5
2020,177551,10,3,14,5,9
2020,177551,10,4,5,4,1
2020,177551,20,0,17,10,7
2020,177551,20,1,3,1,2
2020,177551,20,2,14,9,5
2020,177551,30,0,15,7,8
2020,177551,30,2,4,4,0
2020,177551,30,3,11,3,8
2020,177551,40,0,8,6,2
2020,177551,40,3,3,2,1
2020,177551,40,4,5,4,1
2020,177551,42,0,8,6,2
2020,177551,42,3,3,2,1
2020,177551,42,4,5,4,1
2020,177676,0,0,88,39,49
2020,177676,10,0,88,39,49
2020,177676,10,1,33,19,14
2020,177676,10,2,21,6,15
2020,177676,10,3,21,9,12
2020,177676,10,4,10,4,6
2020,177676,10,6,3,1,2
2020,177676,20,0,57,28,29
2020,177676,20,1,33,19,14
2020,177676,20,2,19,6,13
2020,177676,20,3,5,3,2
2020,177676,30,0,28,10,18
2020,177676,30,2,2,0,2
2020,177676,30,3,16,6,10
2020,177676,30,4,10,4,6
2020,177676,40,0,3,1,2
2020,177676,40,6,3,1,2
2020,177676,42,0,3,1,2
2020,177676,42,6,3,1,2
2020,177719,0,0,51,6,45
2020,177719,10,0,51,6,45
2020,177719,10,1,1,0,1
2020,177719,10,2,5,0,5
2020,177719,10,3,35,6,29
2020,177719,10,4,10,0,10
2020,177719,40,0,51,6,45
2020,177719,40,1,1,0,1
2020,177719,40,2,5,0,5
2020,177719,40,3,35,6,29
2020,177719,40,4,10,0,10
2020,177719,41,0,1,0,1
2020,177719,41,1,1,0,1
2020,177719,42,0,50,6,44
2020,177719,42,2,5,0,5
2020,177719,42,3,35,6,29
2020,177719,42,4,10,0,10
2020,177719,44,0,1,0,1
2020,177719,44,1,1,0,1
2020,177746,0,0,57,32,25
2020,177746,10,0,57,32,25
2020,177746,10,1,18,9,9
2020,177746,10,2,20,12,8
2020,177746,10,3,19,11,8
2020,177746,20,0,34,19,15
2020,177746,20,1,18,9,9
2020,177746,20,2,16,10,6
2020,177746,30,0,10,6,4
2020,177746,30,2,2,1,1
2020,177746,30,3,8,5,3
2020,177746,40,0,13,7,6
2020,177746,40,2,2,1,1
2020,177746,40,3,11,6,5
2020,177746,42,0,13,7,6
2020,177746,42,2,2,1,1
2020,177746,42,3,11,6,5
2020,177816,0,0,14,13,1
2020,177816,10,0,14,13,1
2020,177816,10,1,6,5,1
2020,177816,10,2,4,4,0
2020,177816,10,3,4,4,0
2020,177816,40,0,14,13,1
2020,177816,40,1,6,5,1
2020,177816,40,2,4,4,0
2020,177816,40,3,4,4,0
2020,177816,41,0,8,7,1
2020,177816,41,1,5,4,1
2020,177816,41,2,2,2,0
2020,177816,41,3,1,1,0
2020,177816,42,0,6,6,0
2020,177816,42,1,1,1,0
2020,177816,42,2,2,2,0
2020,177816,42,3,3,3,0
2020,177816,44,0,8,7,1
2020,177816,44,1,5,4,1
2020,177816,44,2,2,2,0
2020,177816,44,3,1,1,0
2020,177834,0,0,253,119,134
2020,177834,10,0,253,119,134
2020,177834,10,1,40,27,13
2020,177834,10,2,70,33,37
2020,177834,10,3,125,57,68
2020,177834,10,4,18,2,16
2020,177834,40,0,253,119,134
2020,177834,40,1,40,27,13
2020,177834,40,2,70,33,37
2020,177834,40,3,125,57,68
2020,177834,40,4,18,2,16
2020,177834,42,0,253,119,134
2020,177834,42,1,40,27,13
2020,177834,42,2,70,33,37
2020,177834,42,3,125,57,68
2020,177834,42,4,18,2,16
2020,177940,0,0,96,52,44
2020,177940,10,0,96,52,44
2020,177940,10,1,28,19,9
2020,177940,10,2,20,14,6
2020,177940,10,3,34,13,21
2020,177940,10,4,14,6,8
2020,177940,20,0,41,28,13
2020,177940,20,1,28,19,9
2020,177940,20,2,11,9,2
2020,177940,20,3,2,0,2
2020,177940,30,0,27,14,13
2020,177940,30,2,5,2,3
2020,177940,30,3,22,12,10
2020,177940,40,0,28,10,18
2020,177940,40,2,4,3,1
2020,177940,40,3,10,1,9
2020,177940,40,4,14,6,8
2020,177940,42,0,28,10,18
2020,177940,42,2,4,3,1
2020,177940,42,3,10,1,9
2020,177940,42,4,14,6,8
2020,177968,0,0,200,93,107
2020,177968,10,0,200,93,107
2020,177968,10,1,66,31,35
2020,177968,10,2,71,35,36
2020,177968,10,3,45,19,26
2020,177968,10,4,18,8,10
2020,177968,40,0,200,93,107
2020,177968,40,1,66,31,35
2020,177968,40,2,71,35,36
2020,177968,40,3,45,19,26
2020,177968,40,4,18,8,10
2020,177968,42,0,200,93,107
2020,177968,42,1,66,31,35
2020,177968,42,2,71,35,36
2020,177968,42,3,45,19,26
2020,177968,42,4,18,8,10
2020,177977,0,0,97,67,30
2020,177977,10,0,97,67,30
2020,177977,10,4,97,67,30
2020,177977,40,0,97,67,30
2020,177977,40,4,97,67,30
2020,177977,42,0,97,67,30
2020,177977,42,4,97,67,30
2020,177986,0,0,49,26,23
2020,177986,10,0,49,26,23
2020,177986,10,1,11,7,4
2020,177986,10,2,5,4,1
2020,177986,10,3,21,7,14
2020,177986,10,4,12,8,4
2020,177986,40,0,49,26,23
2020,177986,40,1,11,7,4
2020,177986,40,2,5,4,1
2020,177986,40,3,21,7,14
2020,177986,40,4,12,8,4
2020,177986,41,0,23,14,9
2020,177986,41,1,10,6,4
2020,177986,41,2,3,2,1
2020,177986,41,3,6,3,3
2020,177986,41,4,4,3,1
2020,177986,42,0,26,12,14
2020,177986,42,1,1,1,0
2020,177986,42,2,2,2,0
2020,177986,42,3,15,4,11
2020,177986,42,4,8,5,3
2020,177986,44,0,23,14,9
2020,177986,44,1,10,6,4
2020,177986,44,2,3,2,1
2020,177986,44,3,6,3,3
2020,177986,44,4,4,3,1
2020,177995,0,0,245,108,137
2020,177995,10,0,245,108,137
2020,177995,10,6,245,108,137
2020,177995,40,0,245,108,137
2020,177995,40,6,245,108,137
2020,177995,42,0,245,108,137
2020,177995,42,6,245,108,137
2020,178059,0,0,165,62,103
2020,178059,10,0,165,62,103
2020,178059,10,1,27,16,11
2020,178059,10,2,41,14,27
2020,178059,10,3,84,23,61
2020,178059,10,4,12,9,3
2020,178059,10,6,1,0,1
2020,178059,20,0,61,29,32
2020,178059,20,1,26,15,11
2020,178059,20,2,35,14,21
2020,178059,30,0,52,15,37
2020,178059,30,2,5,0,5
2020,178059,30,3,47,15,32
2020,178059,40,0,52,18,34
2020,178059,40,1,1,1,0
2020,178059,40,2,1,0,1
2020,178059,40,3,37,8,29
2020,178059,40,4,12,9,3
2020,178059,40,6,1,0,1
2020,178059,41,0,1,0,1
2020,178059,41,6,1,0,1
2020,178059,42,0,51,18,33
2020,178059,42,1,1,1,0
2020,178059,42,2,1,0,1
2020,178059,42,3,37,8,29
2020,178059,42,4,12,9,3
2020,178059,44,0,1,0,1
2020,178059,44,6,1,0,1
2020,178183,0,0,7,1,6
2020,178183,10,0,7,1,6
2020,178183,10,4,7,1,6
2020,178183,40,0,7,1,6
2020,178183,40,4,7,1,6
2020,178183,41,0,7,1,6
2020,178183,41,4,7,1,6
2020,178183,44,0,7,1,6
2020,178183,44,4,7,1,6
2020,178208,0,0,38,38,0
2020,178208,10,0,38,38,0
2020,178208,10,1,9,9,0
2020,178208,10,2,14,14,0
2020,178208,10,3,15,15,0
2020,178208,40,0,38,38,0
2020,178208,40,1,9,9,0
2020,178208,40,2,14,14,0
2020,178208,40,3,15,15,0
2020,178208,41,0,38,38,0
2020,178208,41,1,9,9,0
2020,178208,41,2,14,14,0
2020,178208,41,3,15,15,0
2020,178208,44,0,38,38,0
2020,178208,44,1,9,9,0
2020,178208,44,2,14,14,0
2020,178208,44,3,15,15,0
2020,178217,0,0,49,21,28
2020,178217,10,0,49,21,28
2020,178217,10,1,12,6,6
2020,178217,10,2,11,6,5
2020,178217,10,3,12,3,9
2020,178217,10,4,14,6,8
2020,178217,40,0,49,21,28
2020,178217,40,1,12,6,6
2020,178217,40,2,11,6,5
2020,178217,40,3,12,3,9
2020,178217,40,4,14,6,8
2020,178217,42,0,49,21,28
2020,178217,42,1,12,6,6
2020,178217,42,2,11,6,5
2020,178217,42,3,12,3,9
2020,178217,42,4,14,6,8
2020,178244,0,0,69,33,36
2020,178244,10,0,69,33,36
2020,178244,10,1,15,9,6
2020,178244,10,2,10,5,5
2020,178244,10,3,40,17,23
2020,178244,10,4,4,2,2
2020,178244,40,0,69,33,36
2020,178244,40,1,15,9,6
2020,178244,40,2,10,5,5
2020,178244,40,3,40,17,23
2020,178244,40,4,4,2,2
2020,178244,42,0,69,33,36
2020,178244,42,1,15,9,6
2020,178244,42,2,10,5,5
2020,178244,42,3,40,17,23
2020,178244,42,4,4,2,2
2020,178341,0,0,190,94,96
2020,178341,10,0,190,94,96
2020,178341,10,1,39,29,10
2020,178341,10,2,42,19,23
2020,178341,10,3,65,31,34
2020,178341,10,4,32,8,24
2020,178341,10,5,12,7,5
2020,178341,20,0,75,45,30
2020,178341,20,1,38,28,10
2020,178341,20,2,29,12,17
2020,178341,20,3,8,5,3
2020,178341,30,0,59,28,31
2020,178341,30,2,12,6,6
2020,178341,30,3,47,22,25
2020,178341,40,0,56,21,35
2020,178341,40,1,1,1,0
2020,178341,40,2,1,1,0
2020,178341,40,3,10,4,6
2020,178341,40,4,32,8,24
2020,178341,40,5,12,7,5
2020,178341,41,0,1,1,0
2020,178341,41,1,1,1,0
2020,178341,42,0,54,20,34
2020,178341,42,2,1,1,0
2020,178341,42,3,10,4,6
2020,178341,42,4,31,8,23
2020,178341,42,5,12,7,5
2020,178341,43,0,1,0,1
2020,178341,43,4,1,0,1
2020,178341,44,0,1,1,0
2020,178341,44,1,1,1,0
2020,178369,0,0,91,43,48
2020,178369,10,0,86,40,46
2020,178369,10,1,8,4,4
2020,178369,10,2,29,14,15
2020,178369,10,3,32,11,21
2020,178369,10,4,16,11,5
2020,178369,10,6,1,0,1
2020,178369,40,0,86,40,46
2020,178369,40,1,8,4,4
2020,178369,40,2,29,14,15
2020,178369,40,3,32,11,21
2020,178369,40,4,16,11,5
2020,178369,40,6,1,0,1
2020,178369,41,0,3,2,1
2020,178369,41,1,1,0,1
2020,178369,41,3,2,2,0
2020,178369,42,0,83,38,45
2020,178369,42,1,7,4,3
2020,178369,42,2,29,14,15
2020,178369,42,3,30,9,21
2020,178369,42,4,16,11,5
2020,178369,42,6,1,0,1
2020,178369,44,0,3,2,1
2020,178369,44,1,1,0,1
2020,178369,44,3,2,2,0
2020,178369,50,0,5,3,2
2020,178387,0,0,172,95,77
2020,178387,10,0,172,95,77
2020,178387,10,1,51,38,13
2020,178387,10,2,48,23,25
2020,178387,10,3,55,26,29
2020,178387,10,4,18,8,10
2020,178387,20,0,105,66,39
2020,178387,20,1,51,38,13
2020,178387,20,2,48,23,25
2020,178387,20,3,6,5,1
2020,178387,30,0,49,21,28
2020,178387,30,3,49,21,28
2020,178387,40,0,18,8,10
2020,178387,40,4,18,8,10
2020,178387,42,0,18,8,10
2020,178387,42,4,18,8,10
2020,178396,0,0,1933,1093,840
2020,178396,10,0,1933,1093,840
2020,178396,10,1,521,371,150
2020,178396,10,2,579,341,238
2020,178396,10,3,639,314,325
2020,178396,10,4,189,64,125
2020,178396,10,5,5,3,2
2020,178396,20,0,757,527,230
2020,178396,20,1,419,316,103
2020,178396,20,2,338,211,127
2020,178396,30,0,260,135,125
2020,178396,30,2,9,8,1
2020,178396,30,3,251,127,124
2020,178396,40,0,916,431,485
2020,178396,40,1,102,55,47
2020,178396,40,2,232,122,110
2020,178396,40,3,388,187,201
2020,178396,40,4,189,64,125
2020,178396,40,5,5,3,2
2020,178396,42,0,913,429,484
2020,178396,42,1,102,55,47
2020,178396,42,2,232,122,110
2020,178396,42,3,388,187,201
2020,178396,42,4,186,62,124
2020,178396,42,5,5,3,2
2020,178396,43,0,3,2,1
2020,178396,43,4,3,2,1
2020,178402,0,0,589,308,281
2020,178402,10,0,589,308,281
2020,178402,10,1,157,96,61
2020,178402,10,2,225,123,102
2020,178402,10,3,163,69,94
2020,178402,10,4,25,13,12
2020,178402,10,5,15,6,9
2020,178402,10,6,4,1,3
2020,178402,20,0,262,168,94
2020,178402,20,1,129,85,44
2020,178402,20,2,133,83,50
2020,178402,30,0,77,37,40
2020,178402,30,1,2,1,1
2020,178402,30,2,12,6,6
2020,178402,30,3,63,30,33
2020,178402,40,0,250,103,147
2020,178402,40,1,26,10,16
2020,178402,40,2,80,34,46
2020,178402,40,3,100,39,61
2020,178402,40,4,25,13,12
2020,178402,40,5,15,6,9
2020,178402,40,6,4,1,3
2020,178402,42,0,246,102,144
2020,178402,42,1,26,10,16
2020,178402,42,2,80,34,46
2020,178402,42,3,100,39,61
2020,178402,42,4,25,13,12
2020,178402,42,5,15,6,9
2020,178402,43,0,4,1,3
2020,178402,43,6,4,1,3
2020,178411,0,0,338,238,100
2020,178411,10,0,338,238,100
2020,178411,10,1,127,100,27
2020,178411,10,2,111,73,38
2020,178411,10,3,95,62,33
2020,178411,10,5,5,3,2
2020,178411,20,0,203,152,51
2020,178411,20,1,118,97,21
2020,178411,20,2,85,55,30
2020,178411,30,0,68,50,18
2020,178411,30,2,3,3,0
2020,178411,30,3,65,47,18
2020,178411,40,0,67,36,31
2020,178411,40,1,9,3,6
2020,178411,40,2,23,15,8
2020,178411,40,3,30,15,15
2020,178411,40,5,5,3,2
2020,178411,42,0,67,36,31
2020,178411,42,1,9,3,6
2020,178411,42,2,23,15,8
2020,178411,42,3,30,15,15
2020,178411,42,5,5,3,2
2020,178420,0,0,384,167,217
2020,178420,10,0,384,167,217
2020,178420,10,1,117,65,52
2020,178420,10,2,126,57,69
2020,178420,10,3,141,45,96
2020,178420,20,0,165,93,72
2020,178420,20,1,93,58,35
2020,178420,20,2,72,35,37
2020,178420,30,0,70,25,45
2020,178420,30,2,8,4,4
2020,178420,30,3,62,21,41
2020,178420,40,0,149,49,100
2020,178420,40,1,24,7,17
2020,178420,40,2,46,18,28
2020,178420,40,3,79,24,55
2020,178420,42,0,149,49,100
2020,178420,42,1,24,7,17
2020,178420,42,2,46,18,28
2020,178420,42,3,79,24,55
2020,178448,0,0,72,30,42
2020,178448,10,0,72,30,42
2020,178448,10,1,14,6,8
2020,178448,10,2,21,7,14
2020,178448,10,3,8,3,5
2020,178448,10,4,29,14,15
2020,178448,40,0,72,30,42
2020,178448,40,1,14,6,8
2020,178448,40,2,21,7,14
2020,178448,40,3,8,3,5
2020,178448,40,4,29,14,15
2020,178448,41,0,33,14,19
2020,178448,41,1,14,6,8
2020,178448,41,2,12,3,9
2020,178448,41,3,4,2,2
2020,178448,41,4,3,3,0
2020,178448,42,0,39,16,23
2020,178448,42,2,9,4,5
2020,178448,42,3,4,1,3
2020,178448,42,4,26,11,15
2020,178448,44,0,33,14,19
2020,178448,44,1,14,6,8
2020,178448,44,2,12,3,9
2020,178448,44,3,4,2,2
2020,178448,44,4,3,3,0
2020,178518,0,0,10,7,3
2020,178518,10,0,10,7,3
2020,178518,10,1,6,6,0
2020,178518,10,2,3,1,2
2020,178518,10,3,1,0,1
2020,178518,40,0,10,7,3
2020,178518,40,1,6,6,0
2020,178518,40,2,3,1,2
2020,178518,40,3,1,0,1
2020,178518,41,0,10,7,3
2020,178518,41,1,6,6,0
2020,178518,41,2,3,1,2
2020,178518,41,3,1,0,1
2020,178518,44,0,10,7,3
2020,178518,44,1,6,6,0
2020,178518,44,2,3,1,2
2020,178518,44,3,1,0,1
2020,178615,0,0,278,157,121
2020,178615,10,0,278,157,121
2020,178615,10,1,131,87,44
2020,178615,10,2,35,19,16
2020,178615,10,3,83,41,42
2020,178615,10,4,25,10,15
2020,178615,10,5,4,0,4
2020,178615,20,0,166,105,61
2020,178615,20,1,131,87,44
2020,178615,20,2,33,17,16
2020,178615,20,3,2,1,1
2020,178615,30,0,53,26,27
2020,178615,30,2,1,1,0
2020,178615,30,3,52,25,27
2020,178615,40,0,59,26,33
2020,178615,40,2,1,1,0
2020,178615,40,3,29,15,14
2020,178615,40,4,25,10,15
2020,178615,40,5,4,0,4
2020,178615,42,0,59,26,33
2020,178615,42,2,1,1,0
2020,178615,42,3,29,15,14
2020,178615,42,4,25,10,15
2020,178615,42,5,4,0,4
2020,178624,0,0,231,121,110
2020,178624,10,0,231,121,110
2020,178624,10,1,35,25,10
2020,178624,10,2,61,36,25
2020,178624,10,3,80,40,40
2020,178624,10,4,52,17,35
2020,178624,10,5,3,3,0
2020,178624,20,0,93,58,35
2020,178624,20,1,35,25,10
2020,178624,20,2,57,32,25
2020,178624,20,3,1,1,0
2020,178624,30,0,78,39,39
2020,178624,30,2,3,3,0
2020,178624,30,3,73,36,37
2020,178624,30,4,2,0,2
2020,178624,40,0,60,24,36
2020,178624,40,2,1,1,0
2020,178624,40,3,6,3,3
2020,178624,40,4,50,17,33
2020,178624,40,5,3,3,0
2020,178624,42,0,60,24,36
2020,178624,42,2,1,1,0
2020,178624,42,3,6,3,3
2020,178624,42,4,50,17,33
2020,178624,42,5,3,3,0
2020,178679,0,0,24,21,3
2020,178679,10,0,24,21,3
2020,178679,10,1,24,21,3
2020,178679,40,0,24,21,3
2020,178679,40,1,24,21,3
2020,178679,42,0,24,21,3
2020,178679,42,1,24,21,3
2020,178697,0,0,96,55,41
2020,178697,10,0,96,55,41
2020,178697,10,1,23,15,8
2020,178697,10,2,36,20,16
2020,178697,10,3,34,17,17
2020,178697,10,4,3,3,0
2020,178697,40,0,96,55,41
2020,178697,40,1,23,15,8
2020,178697,40,2,36,20,16
2020,178697,40,3,34,17,17
2020,178697,40,4,3,3,0
2020,178697,42,0,96,55,41
2020,178697,42,1,23,15,8
2020,178697,42,2,36,20,16
2020,178697,42,3,34,17,17
2020,178697,42,4,3,3,0
2020,178721,0,0,112,52,60
2020,178721,10,0,112,52,60
2020,178721,10,1,20,12,8
2020,178721,10,2,36,21,15
2020,178721,10,3,39,13,26
2020,178721,10,4,2,0,2
2020,178721,10,5,15,6,9
2020,178721,20,0,48,30,18
2020,178721,20,1,20,12,8
2020,178721,20,2,28,18,10
2020,178721,30,0,33,13,20
2020,178721,30,2,5,2,3
2020,178721,30,3,28,11,17
2020,178721,40,0,31,9,22
2020,178721,40,2,3,1,2
2020,178721,40,3,11,2,9
2020,178721,40,4,2,0,2
2020,178721,40,5,15,6,9
2020,178721,42,0,31,9,22
2020,178721,42,2,3,1,2
2020,178721,42,3,11,2,9
2020,178721,42,4,2,0,2
2020,178721,42,5,15,6,9
2020,178891,0,0,108,102,6
2020,178891,10,0,108,102,6
2020,178891,10,4,108,102,6
2020,178891,40,0,108,102,6
2020,178891,40,4,108,102,6
2020,178891,41,0,108,102,6
2020,178891,41,4,108,102,6
2020,178891,45,0,108,102,6
2020,178891,45,4,108,102,6
2020,178989,0,0,34,0,34
2020,178989,10,0,34,0,34
2020,178989,10,1,5,0,5
2020,178989,10,2,4,0,4
2020,178989,10,3,19,0,19
2020,178989,10,4,6,0,6
2020,178989,40,0,34,0,34
2020,178989,40,1,5,0,5
2020,178989,40,2,4,0,4
2020,178989,40,3,19,0,19
2020,178989,40,4,6,0,6
2020,178989,41,0,24,0,24
2020,178989,41,1,4,0,4
2020,178989,41,2,3,0,3
2020,178989,41,3,17,0,17
2020,178989,42,0,10,0,10
2020,178989,42,1,1,0,1
2020,178989,42,2,1,0,1
2020,178989,42,3,2,0,2
2020,178989,42,4,6,0,6
2020,178989,44,0,24,0,24
2020,178989,44,1,4,0,4
2020,178989,44,2,3,0,3
2020,178989,44,3,17,0,17
2020,179043,0,0,147,55,92
2020,179043,10,0,147,55,92
2020,179043,10,1,37,19,18
2020,179043,10,2,34,14,20
2020,179043,10,3,61,16,45
2020,179043,10,4,8,2,6
2020,179043,10,5,7,4,3
2020,179043,20,0,71,34,37
2020,179043,20,1,35,19,16
2020,179043,20,2,32,14,18
2020,179043,20,3,3,1,2
2020,179043,20,5,1,0,1
2020,179043,30,0,27,10,17
2020,179043,30,2,1,0,1
2020,179043,30,3,26,10,16
2020,179043,40,0,49,11,38
2020,179043,40,1,2,0,2
2020,179043,40,2,1,0,1
2020,179043,40,3,32,5,27
2020,179043,40,4,8,2,6
2020,179043,40,5,6,4,2
2020,179043,42,0,44,8,36
2020,179043,42,1,2,0,2
2020,179043,42,2,1,0,1
2020,179043,42,3,31,4,27
2020,179043,42,4,6,2,4
2020,179043,42,5,4,2,2
2020,179043,43,0,5,3,2
2020,179043,43,3,1,1,0
2020,179043,43,4,2,0,2
2020,179043,43,5,2,2,0
2020,179159,0,0,1246,665,581
2020,179159,10,0,1241,662,579
2020,179159,10,1,345,234,111
2020,179159,10,2,382,203,179
2020,179159,10,3,457,203,254
2020,179159,10,4,55,21,34
2020,179159,10,6,2,1,1
2020,179159,20,0,469,300,169
2020,179159,20,1,258,184,74
2020,179159,20,2,211,116,95
2020,179159,30,0,136,69,67
2020,179159,30,1,1,1,0
2020,179159,30,2,16,9,7
2020,179159,30,3,119,59,60
2020,179159,40,0,636,293,343
2020,179159,40,1,86,49,37
2020,179159,40,2,155,78,77
2020,179159,40,3,338,144,194
2020,179159,40,4,55,21,34
2020,179159,40,6,2,1,1
2020,179159,41,0,15,3,12
2020,179159,41,1,4,0,4
2020,179159,41,2,3,1,2
2020,179159,41,3,7,1,6
2020,179159,41,4,1,1,0
2020,179159,42,0,621,290,331
2020,179159,42,1,82,49,33
2020,179159,42,2,152,77,75
2020,179159,42,3,331,143,188
2020,179159,42,4,54,20,34
2020,179159,42,6,2,1,1
2020,179159,44,0,15,3,12
2020,179159,44,1,4,0,4
2020,179159,44,2,3,1,2
2020,179159,44,3,7,1,6
2020,179159,44,4,1,1,0
2020,179159,50,0,5,3,2
2020,179256,0,0,6,5,1
2020,179256,10,0,6,5,1
2020,179256,10,1,6,5,1
2020,179256,40,0,6,5,1
2020,179256,40,1,6,5,1
2020,179256,42,0,6,5,1
2020,179256,42,1,6,5,1
2020,179265,0,0,64,29,35
2020,179265,10,0,64,29,35
2020,179265,10,1,17,11,6
2020,179265,10,2,19,8,11
2020,179265,10,3,28,10,18
2020,179265,20,0,14,7,7
2020,179265,20,1,9,6,3
2020,179265,20,2,5,1,4
2020,179265,30,0,22,12,10
2020,179265,30,1,2,1,1
2020,179265,30,2,6,4,2
2020,179265,30,3,14,7,7
2020,179265,40,0,28,10,18
2020,179265,40,1,6,4,2
2020,179265,40,2,8,3,5
2020,179265,40,3,14,3,11
2020,179265,42,0,28,10,18
2020,179265,42,1,6,4,2
2020,179265,42,2,8,3,5
2020,179265,42,3,14,3,11
2020,179308,0,0,321,135,186
2020,179308,10,0,321,135,186
2020,179308,10,1,138,65,73
2020,179308,10,2,74,32,42
2020,179308,10,3,74,27,47
2020,179308,10,4,25,8,17
2020,179308,10,5,10,3,7
2020,179308,40,0,321,135,186
2020,179308,40,1,138,65,73
2020,179308,40,2,74,32,42
2020,179308,40,3,74,27,47
2020,179308,40,4,25,8,17
2020,179308,40,5,10,3,7
2020,179308,42,0,306,132,174
2020,179308,42,1,138,65,73
2020,179308,42,2,74,32,42
2020,179308,42,3,71,26,45
2020,179308,42,4,21,8,13
2020,179308,42,5,2,1,1
2020,179308,43,0,15,3,12
2020,179308,43,3,3,1,2
2020,179308,43,4,4,0,4
2020,179308,43,5,8,2,6
2020,179317,0,0,8,3,5
2020,179317,10,0,8,3,5
2020,179317,10,1,7,3,4
2020,179317,10,3,1,0,1
2020,179317,20,0,7,3,4
2020,179317,20,1,7,3,4
2020,179317,40,0,1,0,1
2020,179317,40,3,1,0,1
2020,179317,41,0,1,0,1
2020,179317,41,3,1,0,1
2020,179317,44,0,1,0,1
2020,179317,44,3,1,0,1
2020,179326,0,0,142,72,70
2020,179326,10,0,142,72,70
2020,179326,10,1,45,33,12
2020,179326,10,2,16,10,6
2020,179326,10,3,36,19,17
2020,179326,10,4,44,10,34
2020,179326,10,6,1,0,1
2020,179326,20,0,67,43,24
2020,179326,20,1,43,32,11
2020,179326,20,2,13,7,6
2020,179326,20,3,9,4,5
2020,179326,20,4,2,0,2
2020,179326,30,0,33,19,14
2020,179326,30,1,2,1,1
2020,179326,30,2,3,3,0
2020,179326,30,3,27,15,12
2020,179326,30,6,1,0,1
2020,179326,40,0,42,10,32
2020,179326,40,4,42,10,32
2020,179326,42,0,8,3,5
2020,179326,42,4,8,3,5
2020,179326,43,0,34,7,27
2020,179326,43,4,34,7,27
2020,179344,0,0,34,16,18
2020,179344,10,0,34,16,18
2020,179344,10,1,7,5,2
2020,179344,10,2,9,7,2
2020,179344,10,3,12,3,9
2020,179344,10,4,5,1,4
2020,179344,10,5,1,0,1
2020,179344,20,0,28,15,13
2020,179344,20,1,7,5,2
2020,179344,20,2,9,7,2
2020,179344,20,3,11,2,9
2020,179344,20,4,1,1,0
2020,179344,30,0,5,1,4
2020,179344,30,3,1,1,0
2020,179344,30,4,4,0,4
2020,179344,40,0,1,0,1
2020,179344,40,5,1,0,1
2020,179344,42,0,1,0,1
2020,179344,42,5,1,0,1
2020,179511,0,0,5,1,4
2020,179511,10,0,5,1,4
2020,179511,10,4,5,1,4
2020,179511,40,0,5,1,4
2020,179511,40,4,5,1,4
2020,179511,41,0,5,1,4
2020,179511,41,4,5,1,4
2020,179511,45,0,5,1,4
2020,179511,45,4,5,1,4
2020,179539,0,0,78,25,53
2020,179539,10,0,78,25,53
2020,179539,10,4,74,22,52
2020,179539,10,6,4,3,1
2020,179539,40,0,78,25,53
2020,179539,40,4,74,22,52
2020,179539,40,6,4,3,1
2020,179539,42,0,78,25,53
2020,179539,42,4,74,22,52
2020,179539,42,6,4,3,1
2020,179548,0,0,37,13,24
2020,179548,10,0,37,13,24
2020,179548,10,1,2,0,2
2020,179548,10,2,8,5,3
2020,179548,10,3,27,8,19
2020,179548,20,0,7,2,5
2020,179548,20,1,2,0,2
2020,179548,20,2,5,2,3
2020,179548,30,0,6,3,3
2020,179548,30,2,2,2,0
2020,179548,30,3,4,1,3
2020,179548,40,0,24,8,16
2020,179548,40,2,1,1,0
2020,179548,40,3,23,7,16
2020,179548,42,0,2,0,2
2020,179548,42,3,2,0,2
2020,179548,43,0,22,8,14
2020,179548,43,2,1,1,0
2020,179548,43,3,21,7,14
2020,179557,0,0,381,180,201
2020,179557,10,0,378,179,199
2020,179557,10,1,105,64,41
2020,179557,10,2,68,30,38
2020,179557,10,3,89,39,50
2020,179557,10,4,116,46,70
2020,179557,20,0,173,94,79
2020,179557,20,1,105,64,41
2020,179557,20,2,68,30,38
2020,179557,30,0,89,39,50
2020,179557,30,3,89,39,50
2020,179557,40,0,116,46,70
2020,179557,40,4,116,46,70
2020,179557,41,0,106,41,65
2020,179557,41,4,106,41,65
2020,179557,42,0,10,5,5
2020,179557,42,4,10,5,5
2020,179557,44,0,106,41,65
2020,179557,44,4,106,41,65
2020,179557,50,0,3,1,2
2020,179566,0,0,739,363,376
2020,179566,10,0,739,363,376
2020,179566,10,1,224,147,77
2020,179566,10,2,153,84,69
2020,179566,10,3,218,83,135
2020,179566,10,4,138,45,93
2020,179566,10,6,6,4,2
2020,179566,20,0,371,229,142
2020,179566,20,1,221,147,74
2020,179566,20,2,144,80,64
2020,179566,20,3,6,2,4
2020,179566,30,0,183,78,105
2020,179566,30,2,2,2,0
2020,179566,30,3,181,76,105
2020,179566,40,0,185,56,129
2020,179566,40,1,3,0,3
2020,179566,40,2,7,2,5
2020,179566,40,3,31,5,26
2020,179566,40,4,138,45,93
2020,179566,40,6,6,4,2
2020,179566,42,0,185,56,129
2020,179566,42,1,3,0,3
2020,179566,42,2,7,2,5
2020,179566,42,3,31,5,26
2020,179566,42,4,138,45,93
2020,179566,42,6,6,4,2
2020,179645,0,0,62,27,35
2020,179645,10,0,62,27,35
2020,179645,10,1,10,5,5
2020,179645,10,2,10,5,5
2020,179645,10,3,13,5,8
2020,179645,10,4,26,9,17
2020,179645,10,6,3,3,0
2020,179645,20,0,12,6,6
2020,179645,20,1,9,4,5
2020,179645,20,2,3,2,1
2020,179645,30,0,1,0,1
2020,179645,30,2,1,0,1
2020,179645,40,0,49,21,28
2020,179645,40,1,1,1,0
2020,179645,40,2,6,3,3
2020,179645,40,3,13,5,8
2020,179645,40,4,26,9,17
2020,179645,40,6,3,3,0
2020,179645,42,0,49,21,28
2020,179645,42,1,1,1,0
2020,179645,42,2,6,3,3
2020,179645,42,3,13,5,8
2020,179645,42,4,26,9,17
2020,179645,42,6,3,3,0
2020,179715,0,0,37,10,27
2020,179715,10,0,37,10,27
2020,179715,10,6,37,10,27
2020,179715,20,0,23,6,17
2020,179715,20,6,23,6,17
2020,179715,30,0,14,4,10
2020,179715,30,6,14,4,10
2020,179812,0,0,49,28,21
2020,179812,10,0,46,28,18
2020,179812,10,1,8,6,2
2020,179812,10,2,13,9,4
2020,179812,10,3,25,13,12
2020,179812,40,0,46,28,18
2020,179812,40,1,8,6,2
2020,179812,40,2,13,9,4
2020,179812,40,3,25,13,12
2020,179812,41,0,46,28,18
2020,179812,41,1,8,6,2
2020,179812,41,2,13,9,4
2020,179812,41,3,25,13,12
2020,179812,44,0,46,28,18
2020,179812,44,1,8,6,2
2020,179812,44,2,13,9,4
2020,179812,44,3,25,13,12
2020,179812,50,0,3,0,3
2020,179867,0,0,1717,1130,587
2020,179867,10,0,1717,1130,587
2020,179867,10,1,704,545,159
2020,179867,10,2,315,209,106
2020,179867,10,3,354,206,148
2020,179867,10,4,129,74,55
2020,179867,10,5,212,95,117
2020,179867,10,6,3,1,2
2020,179867,20,0,969,725,244
2020,179867,20,1,693,539,154
2020,179867,20,2,276,186,90
2020,179867,30,0,398,231,167
2020,179867,30,1,9,5,4
2020,179867,30,2,36,21,15
2020,179867,30,3,353,205,148
2020,179867,40,0,350,174,176
2020,179867,40,1,2,1,1
2020,179867,40,2,3,2,1
2020,179867,40,3,1,1,0
2020,179867,40,4,129,74,55
2020,179867,40,5,212,95,117
2020,179867,40,6,3,1,2
2020,179867,42,0,342,168,174
2020,179867,42,1,2,1,1
2020,179867,42,2,3,2,1
2020,179867,42,3,1,1,0
2020,179867,42,4,127,72,55
2020,179867,42,5,206,91,115
2020,179867,42,6,3,1,2
2020,179867,43,0,8,6,2
2020,179867,43,4,2,2,0
2020,179867,43,5,6,4,2
2020,179894,0,0,198,103,95
2020,179894,10,0,194,102,92
2020,179894,10,1,72,40,32
2020,179894,10,2,71,36,35
2020,179894,10,3,41,24,17
2020,179894,10,4,9,2,7
2020,179894,10,5,1,0,1
2020,179894,20,0,133,71,62
2020,179894,20,1,72,40,32
2020,179894,20,2,60,30,30
2020,179894,20,3,1,1,0
2020,179894,30,0,39,22,17
2020,179894,30,2,11,6,5
2020,179894,30,3,28,16,12
2020,179894,40,0,22,9,13
2020,179894,40,3,12,7,5
2020,179894,40,4,9,2,7
2020,179894,40,5,1,0,1
2020,179894,42,0,22,9,13
2020,179894,42,3,12,7,5
2020,179894,42,4,9,2,7
2020,179894,42,5,1,0,1
2020,179894,50,0,4,1,3
2020,179946,0,0,47,28,19
2020,179946,10,0,47,28,19
2020,179946,10,1,14,9,5
2020,179946,10,2,16,9,7
2020,179946,10,3,15,9,6
2020,179946,10,4,2,1,1
2020,179946,20,0,30,18,12
2020,179946,20,1,14,9,5
2020,179946,20,2,16,9,7
2020,179946,30,0,9,6,3
2020,179946,30,3,9,6,3
2020,179946,40,0,8,4,4
2020,179946,40,3,6,3,3
2020,179946,40,4,2,1,1
2020,179946,42,0,7,3,4
2020,179946,42,3,5,2,3
2020,179946,42,4,2,1,1
2020,179946,43,0,1,1,0
2020,179946,43,3,1,1,0
2020,179955,0,0,70,39,31
2020,179955,10,0,70,39,31
2020,179955,10,1,26,13,13
2020,179955,10,2,21,14,7
2020,179955,10,3,20,11,9
2020,179955,10,4,3,1,2
2020,179955,20,0,40,22,18
2020,179955,20,1,25,13,12
2020,179955,20,2,14,8,6
2020,179955,20,3,1,1,0
2020,179955,30,0,17,12,5
2020,179955,30,1,1,0,1
2020,179955,30,2,7,6,1
2020,179955,30,3,9,6,3
2020,179955,40,0,13,5,8
2020,179955,40,3,10,4,6
2020,179955,40,4,3,1,2
2020,179955,41,0,11,4,7
2020,179955,41,3,8,3,5
2020,179955,41,4,3,1,2
2020,179955,42,0,2,1,1
2020,179955,42,3,2,1,1
2020,179955,44,0,11,4,7
2020,179955,44,3,8,3,5
2020,179955,44,4,3,1,2
2020,179964,0,0,64,31,33
2020,179964,10,0,64,31,33
2020,179964,10,1,9,3,6
2020,179964,10,2,16,11,5
2020,179964,10,3,35,15,20
2020,179964,10,4,4,2,2
2020,179964,20,0,8,3,5
2020,179964,20,1,7,2,5
2020,179964,20,2,1,1,0
2020,179964,30,0,56,28,28
2020,179964,30,1,2,1,1
2020,179964,30,2,15,10,5
2020,179964,30,3,35,15,20
2020,179964,30,4,4,2,2
2020,180054,0,0,41,12,29
2020,180054,10,0,41,12,29
2020,180054,10,4,41,12,29
2020,180054,40,0,41,12,29
2020,180054,40,4,41,12,29
2020,180054,41,0,25,8,17
2020,180054,41,4,25,8,17
2020,180054,43,0,16,4,12
2020,180054,43,4,16,4,12
2020,180054,45,0,25,8,17
2020,180054,45,4,25,8,17
2020,180106,0,0,79,37,42
2020,180106,10,0,79,37,42
2020,180106,10,1,18,14,4
2020,180106,10,2,39,18,21
2020,180106,10,3,18,3,15
2020,180106,10,4,4,2,2
2020,180106,20,0,48,28,20
2020,180106,20,1,18,14,4
2020,180106,20,2,28,13,15
2020,180106,20,3,2,1,1
2020,180106,30,0,23,7,16
2020,180106,30,2,10,5,5
2020,180106,30,3,13,2,11
2020,180106,40,0,8,2,6
2020,180106,40,2,1,0,1
2020,180106,40,3,3,0,3
2020,180106,40,4,4,2,2
2020,180106,42,0,8,2,6
2020,180106,42,2,1,0,1
2020,180106,42,3,3,0,3
2020,180106,42,4,4,2,2
2020,180151,0,0,13,6,7
2020,180151,10,0,13,6,7
2020,180151,10,4,13,6,7
2020,180151,20,0,4,2,2
2020,180151,20,4,4,2,2
2020,180151,30,0,9,4,5
2020,180151,30,4,9,4,5
2020,180160,0,0,14,10,4
2020,180160,10,0,12,9,3
2020,180160,10,4,12,9,3
2020,180160,40,0,12,9,3
2020,180160,40,4,12,9,3
2020,180160,42,0,12,9,3
2020,180160,42,4,12,9,3
2020,180160,50,0,2,1,1
2020,180179,0,0,142,75,67
2020,180179,10,0,142,75,67
2020,180179,10,1,28,15,13
2020,180179,10,2,29,17,12
2020,180179,10,3,40,18,22
2020,180179,10,4,7,5,2
2020,180179,10,5,38,20,18
2020,180179,20,0,68,39,29
2020,180179,20,1,27,14,13
2020,180179,20,2,28,17,11
2020,180179,20,3,3,1,2
2020,180179,20,5,10,7,3
2020,180179,30,0,40,21,19
2020,180179,30,3,29,12,17
2020,180179,30,4,2,2,0
2020,180179,30,5,9,7,2
2020,180179,40,0,34,15,19
2020,180179,40,1,1,1,0
2020,180179,40,2,1,0,1
2020,180179,40,3,8,5,3
2020,180179,40,4,5,3,2
2020,180179,40,5,19,6,13
2020,180179,42,0,34,15,19
2020,180179,42,1,1,1,0
2020,180179,42,2,1,0,1
2020,180179,42,3,8,5,3
2020,180179,42,4,5,3,2
2020,180179,42,5,19,6,13
2020,180197,0,0,67,36,31
2020,180197,10,0,49,22,27
2020,180197,10,1,14,7,7
2020,180197,10,2,24,11,13
2020,180197,10,3,11,4,7
2020,180197,20,0,44,19,25
2020,180197,20,1,14,7,7
2020,180197,20,2,24,11,13
2020,180197,20,3,6,1,5
2020,180197,30,0,4,2,2
2020,180197,30,3,4,2,2
2020,180197,40,0,1,1,0
2020,180197,40,3,1,1,0
2020,180197,42,0,1,1,0
2020,180197,42,3,1,1,0
2020,180197,50,0,18,14,4
2020,180203,0,0,14,6,8
2020,180203,10,0,14,6,8
2020,180203,10,4,14,6,8
2020,180203,40,0,14,6,8
2020,180203,40,4,14,6,8
2020,180203,42,0,8,3,5
2020,180203,42,4,8,3,5
2020,180203,43,0,6,3,3
2020,180203,43,4,6,3,3
2020,180212,0,0,20,13,7
2020,180212,10,0,20,13,7
2020,180212,10,4,20,13,7
2020,180212,40,0,20,13,7
2020,180212,40,4,20,13,7
2020,180212,42,0,20,13,7
2020,180212,42,4,20,13,7
2020,180249,0,0,39,16,23
2020,180249,10,0,39,16,23
2020,180249,10,4,39,16,23
2020,180249,20,0,23,11,12
2020,180249,20,4,23,11,12
2020,180249,30,0,10,1,9
2020,180249,30,4,10,1,9
2020,180249,40,0,6,4,2
2020,180249,40,4,6,4,2
2020,180249,42,0,6,4,2
2020,180249,42,4,6,4,2
2020,180258,0,0,46,19,27
2020,180258,10,0,46,19,27
2020,180258,10,1,11,6,5
2020,180258,10,2,11,3,8
2020,180258,10,3,10,5,5
2020,180258,10,4,4,0,4
2020,180258,10,5,1,0,1
2020,180258,10,6,9,5,4
2020,180258,20,0,14,8,6
2020,180258,20,1,10,6,4
2020,180258,20,2,2,1,1
2020,180258,20,6,2,1,1
2020,180258,30,0,19,11,8
2020,180258,30,2,5,2,3
2020,180258,30,3,8,5,3
2020,180258,30,6,6,4,2
2020,180258,40,0,13,0,13
2020,180258,40,1,1,0,1
2020,180258,40,2,4,0,4
2020,180258,40,3,2,0,2
2020,180258,40,4,4,0,4
2020,180258,40,5,1,0,1
2020,180258,40,6,1,0,1
2020,180258,42,0,13,0,13
2020,180258,42,1,1,0,1
2020,180258,42,2,4,0,4
2020,180258,42,3,2,0,2
2020,180258,42,4,4,0,4
2020,180258,42,5,1,0,1
2020,180258,42,6,1,0,1
2020,180276,0,0,30,21,9
2020,180276,10,0,30,21,9
2020,180276,10,4,30,21,9
2020,180276,20,0,14,10,4
2020,180276,20,4,14,10,4
2020,180276,30,0,15,10,5
2020,180276,30,4,15,10,5
2020,180276,40,0,1,1,0
2020,180276,40,4,1,1,0
2020,180276,42,0,1,1,0
2020,180276,42,4,1,1,0
2020,180328,0,0,12,3,9
2020,180328,10,0,12,3,9
2020,180328,10,4,12,3,9
2020,180328,40,0,12,3,9
2020,180328,40,4,12,3,9
2020,180328,42,0,12,3,9
2020,180328,42,4,12,3,9
2020,180373,0,0,20,9,11
2020,180373,10,0,20,9,11
2020,180373,10,4,20,9,11
2020,180373,40,0,20,9,11
2020,180373,40,4,20,9,11
2020,180373,42,0,20,9,11
2020,180373,42,4,20,9,11
2020,180416,0,0,129,83,46
2020,180416,10,0,129,83,46
2020,180416,10,1,37,26,11
2020,180416,10,2,32,18,14
2020,180416,10,3,28,21,7
2020,180416,10,4,32,18,14
2020,180416,20,0,61,36,25
2020,180416,20,1,36,25,11
2020,180416,20,2,14,7,7
2020,180416,20,3,1,1,0
2020,180416,20,4,10,3,7
2020,180416,30,0,55,37,18
2020,180416,30,1,1,1,0
2020,180416,30,2,17,10,7
2020,180416,30,3,23,17,6
2020,180416,30,4,14,9,5
2020,180416,40,0,13,10,3
2020,180416,40,2,1,1,0
2020,180416,40,3,4,3,1
2020,180416,40,4,8,6,2
2020,180416,42,0,13,10,3
2020,180416,42,2,1,1,0
2020,180416,42,3,4,3,1
2020,180416,42,4,8,6,2
2020,180461,0,0,736,379,357
2020,180461,10,0,736,379,357
2020,180461,10,1,219,152,67
2020,180461,10,2,195,101,94
2020,180461,10,3,162,67,95
2020,180461,10,4,35,16,19
2020,180461,10,6,125,43,82
2020,180461,20,0,414,254,160
2020,180461,20,1,217,150,67
2020,180461,20,2,188,99,89
2020,180461,20,4,9,5,4
2020,180461,30,0,168,71,97
2020,180461,30,1,1,1,0
2020,180461,30,2,5,1,4
2020,180461,30,3,155,65,90
2020,180461,30,4,7,4,3
2020,180461,40,0,154,54,100
2020,180461,40,1,1,1,0
2020,180461,40,2,2,1,1
2020,180461,40,3,7,2,5
2020,180461,40,4,19,7,12
2020,180461,40,6,125,43,82
2020,180461,42,0,62,18,44
2020,180461,42,3,3,1,2
2020,180461,42,4,7,4,3
2020,180461,42,6,52,13,39
2020,180461,43,0,92,36,56
2020,180461,43,1,1,1,0
2020,180461,43,2,2,1,1
2020,180461,43,3,4,1,3
2020,180461,43,4,12,3,9
2020,180461,43,6,73,30,43
2020,180489,0,0,423,246,177
2020,180489,10,0,423,246,177
2020,180489,10,1,209,134,75
2020,180489,10,2,104,62,42
2020,180489,10,3,77,34,43
2020,180489,10,4,20,12,8
2020,180489,10,5,13,4,9
2020,180489,20,0,293,187,106
2020,180489,20,1,205,132,73
2020,180489,20,2,88,55,33
2020,180489,30,0,77,39,38
2020,180489,30,1,1,1,0
2020,180489,30,2,15,7,8
2020,180489,30,3,59,30,29
2020,180489,30,4,2,1,1
2020,180489,40,0,53,20,33
2020,180489,40,1,3,1,2
2020,180489,40,2,1,0,1
2020,180489,40,3,18,4,14
2020,180489,40,4,18,11,7
2020,180489,40,5,13,4,9
2020,180489,42,0,53,20,33
2020,180489,42,1,3,1,2
2020,180489,42,2,1,0,1
2020,180489,42,3,18,4,14
2020,180489,42,4,18,11,7
2020,180489,42,5,13,4,9
2020,180522,0,0,51,34,17
2020,180522,10,0,51,34,17
2020,180522,10,1,14,11,3
2020,180522,10,2,6,4,2
2020,180522,10,3,27,15,12
2020,180522,10,4,4,4,0
2020,180522,20,0,16,13,3
2020,180522,20,1,14,11,3
2020,180522,20,2,1,1,0
2020,180522,20,3,1,1,0
2020,180522,30,0,25,13,12
2020,180522,30,2,4,2,2
2020,180522,30,3,21,11,10
2020,180522,40,0,10,8,2
2020,180522,40,2,1,1,0
2020,180522,40,3,5,3,2
2020,180522,40,4,4,4,0
2020,180522,42,0,10,8,2
2020,180522,42,2,1,1,0
2020,180522,42,3,5,3,2
2020,180522,42,4,4,4,0
2020,180595,0,0,69,35,34
2020,180595,10,0,69,35,34
2020,180595,10,1,21,15,6
2020,180595,10,2,18,7,11
2020,180595,10,3,21,7,14
2020,180595,10,4,9,6,3
2020,180595,20,0,39,22,17
2020,180595,20,1,21,15,6
2020,180595,20,2,17,6,11
2020,180595,20,3,1,1,0
2020,180595,30,0,10,3,7
2020,180595,30,3,10,3,7
2020,180595,40,0,20,10,10
2020,180595,40,2,1,1,0
2020,180595,40,3,10,3,7
2020,180595,40,4,9,6,3
2020,180595,42,0,20,10,10
2020,180595,42,2,1,1,0
2020,180595,42,3,10,3,7
2020,180595,42,4,9,6,3
2020,180647,0,0,71,26,45
2020,180647,10,0,71,26,45
2020,180647,10,4,71,26,45
2020,180647,40,0,71,26,45
2020,180647,40,4,71,26,45
2020,180647,41,0,71,26,45
2020,180647,41,4,71,26,45
2020,180647,44,0,71,26,45
2020,180647,44,4,71,26,45
2020,180692,0,0,68,35,33
2020,180692,10,0,68,35,33
2020,180692,10,1,28,18,10
2020,180692,10,2,14,6,8
2020,180692,10,3,12,6,6
2020,180692,10,4,14,5,9
2020,180692,20,0,37,23,14
2020,180692,20,1,28,18,10
2020,180692,20,2,9,5,4
2020,180692,30,0,16,6,10
2020,180692,30,2,5,1,4
2020,180692,30,3,11,5,6
2020,180692,40,0,15,6,9
2020,180692,40,3,1,1,0
2020,180692,40,4,14,5,9
2020,180692,42,0,15,6,9
2020,180692,42,3,1,1,0
2020,180692,42,4,14,5,9
2020,180814,0,0,105,53,52
2020,180814,10,0,105,53,52
2020,180814,10,1,22,12,10
2020,180814,10,2,33,17,16
2020,180814,10,3,32,17,15
2020,180814,10,4,18,7,11
2020,180814,40,0,105,53,52
2020,180814,40,1,22,12,10
2020,180814,40,2,33,17,16
2020,180814,40,3,32,17,15
2020,180814,40,4,18,7,11
2020,180814,41,0,87,46,41
2020,180814,41,1,22,12,10
2020,180814,41,2,33,17,16
2020,180814,41,3,32,17,15
2020,180814,42,0,18,7,11
2020,180814,42,4,18,7,11
2020,180814,44,0,87,46,41
2020,180814,44,1,22,12,10
2020,180814,44,2,33,17,16
2020,180814,44,3,32,17,15
2020,180832,0,0,69,7,62
2020,180832,10,0,69,7,62
2020,180832,10,1,4,0,4
2020,180832,10,2,23,3,20
2020,180832,10,3,19,3,16
2020,180832,10,4,23,1,22
2020,180832,40,0,69,7,62
2020,180832,40,1,4,0,4
2020,180832,40,2,23,3,20
2020,180832,40,3,19,3,16
2020,180832,40,4,23,1,22
2020,180832,42,0,69,7,62
2020,180832,42,1,4,0,4
2020,180832,42,2,23,3,20
2020,180832,42,3,19,3,16
2020,180832,42,4,23,1,22
2020,180878,0,0,42,7,35
2020,180878,10,0,42,7,35
2020,180878,10,1,4,1,3
2020,180878,10,2,17,5,12
2020,180878,10,3,20,1,19
2020,180878,10,4,1,0,1
2020,180878,40,0,42,7,35
2020,180878,40,1,4,1,3
2020,180878,40,2,17,5,12
2020,180878,40,3,20,1,19
2020,180878,40,4,1,0,1
2020,180878,42,0,42,7,35
2020,180878,42,1,4,1,3
2020,180878,42,2,17,5,12
2020,180878,42,3,20,1,19
2020,180878,42,4,1,0,1
2020,180902,0,0,164,81,83
2020,180902,10,0,164,81,83
2020,180902,10,6,164,81,83
2020,180902,40,0,164,81,83
2020,180902,40,6,164,81,83
2020,180902,42,0,164,81,83
2020,180902,42,6,164,81,83
2020,180948,0,0,86,48,38
2020,180948,10,0,86,48,38
2020,180948,10,1,38,22,16
2020,180948,10,2,13,8,5
2020,180948,10,3,28,14,14
2020,180948,10,4,6,4,2
2020,180948,10,5,1,0,1
2020,180948,20,0,41,25,16
2020,180948,20,1,34,21,13
2020,180948,20,2,7,4,3
2020,180948,30,0,31,15,16
2020,180948,30,2,4,3,1
2020,180948,30,3,25,11,14
2020,180948,30,4,2,1,1
2020,180948,40,0,14,8,6
2020,180948,40,1,4,1,3
2020,180948,40,2,2,1,1
2020,180948,40,3,3,3,0
2020,180948,40,4,4,3,1
2020,180948,40,5,1,0,1
2020,180948,42,0,14,8,6
2020,180948,42,1,4,1,3
2020,180948,42,2,2,1,1
2020,180948,42,3,3,3,0
2020,180948,42,4,4,3,1
2020,180948,42,5,1,0,1
2020,180984,0,0,62,39,23
2020,180984,10,0,62,39,23
2020,180984,10,1,28,21,7
2020,180984,10,2,12,6,6
2020,180984,10,3,21,12,9
2020,180984,10,4,1,0,1
2020,180984,40,0,62,39,23
2020,180984,40,1,28,21,7
2020,180984,40,2,12,6,6
2020,180984,40,3,21,12,9
2020,180984,40,4,1,0,1
2020,180984,41,0,61,39,22
2020,180984,41,1,28,21,7
2020,180984,41,2,12,6,6
2020,180984,41,3,21,12,9
2020,180984,43,0,1,0,1
2020,180984,43,4,1,0,1
2020,180984,44,0,32,19,13
2020,180984,44,1,3,1,2
2020,180984,44,2,8,6,2
2020,180984,44,3,21,12,9
2020,180984,45,0,29,20,9
2020,180984,45,1,25,20,5
2020,180984,45,2,4,0,4
2020,181002,0,0,647,337,310
2020,181002,10,0,647,337,310
2020,181002,10,1,178,118,60
2020,181002,10,2,187,103,84
2020,181002,10,3,230,97,133
2020,181002,10,4,50,17,33
2020,181002,10,5,2,2,0
2020,181002,20,0,339,215,124
2020,181002,20,1,171,114,57
2020,181002,20,2,147,87,60
2020,181002,20,3,20,13,7
2020,181002,20,5,1,1,0
2020,181002,30,0,127,50,77
2020,181002,30,1,2,1,1
2020,181002,30,2,15,7,8
2020,181002,30,3,110,42,68
2020,181002,40,0,181,72,109
2020,181002,40,1,5,3,2
2020,181002,40,2,25,9,16
2020,181002,40,3,100,42,58
2020,181002,40,4,50,17,33
2020,181002,40,5,1,1,0
2020,181002,42,0,181,72,109
2020,181002,42,1,5,3,2
2020,181002,42,2,25,9,16
2020,181002,42,3,100,42,58
2020,181002,42,4,50,17,33
2020,181002,42,5,1,1,0
2020,181020,0,0,101,48,53
2020,181020,10,0,101,48,53
2020,181020,10,1,28,20,8
2020,181020,10,2,29,12,17
2020,181020,10,3,42,16,26
2020,181020,10,4,2,0,2
2020,181020,20,0,41,25,16
2020,181020,20,1,25,17,8
2020,181020,20,2,16,8,8
2020,181020,30,0,24,11,13
2020,181020,30,2,4,2,2
2020,181020,30,3,20,9,11
2020,181020,40,0,36,12,24
2020,181020,40,1,3,3,0
2020,181020,40,2,9,2,7
2020,181020,40,3,22,7,15
2020,181020,40,4,2,0,2
2020,181020,42,0,36,12,24
2020,181020,42,1,3,3,0
2020,181020,42,2,9,2,7
2020,181020,42,3,22,7,15
2020,181020,42,4,2,0,2
2020,181127,0,0,61,38,23
2020,181127,10,0,61,38,23
2020,181127,10,1,22,15,7
2020,181127,10,2,10,5,5
2020,181127,10,3,26,16,10
2020,181127,10,4,3,2,1
2020,181127,20,0,31,19,12
2020,181127,20,1,22,15,7
2020,181127,20,2,9,4,5
2020,181127,30,0,20,12,8
2020,181127,30,2,1,1,0
2020,181127,30,3,19,11,8
2020,181127,40,0,10,7,3
2020,181127,40,3,7,5,2
2020,181127,40,4,3,2,1
2020,181127,42,0,8,6,2
2020,181127,42,3,5,4,1
2020,181127,42,4,3,2,1
2020,181127,43,0,2,1,1
2020,181127,43,3,2,1,1
2020,181215,0,0,315,162,153
2020,181215,10,0,315,162,153
2020,181215,10,1,97,55,42
2020,181215,10,2,89,48,41
2020,181215,10,3,67,38,29
2020,181215,10,4,2,1,1
2020,181215,10,5,60,20,40
2020,181215,20,0,174,95,79
2020,181215,20,1,97,55,42
2020,181215,20,2,76,39,37
2020,181215,20,3,1,1,0
2020,181215,30,0,73,42,31
2020,181215,30,2,13,9,4
2020,181215,30,3,60,33,27
2020,181215,40,0,68,25,43
2020,181215,40,3,6,4,2
2020,181215,40,4,2,1,1
2020,181215,40,5,60,20,40
2020,181215,42,0,68,25,43
2020,181215,42,3,6,4,2
2020,181215,42,4,2,1,1
2020,181215,42,5,60,20,40
2020,181297,0,0,70,2,68
2020,181297,10,0,70,2,68
2020,181297,10,1,11,1,10
2020,181297,10,2,13,0,13
2020,181297,10,3,42,1,41
2020,181297,10,4,4,0,4
2020,181297,40,0,70,2,68
2020,181297,40,1,11,1,10
2020,181297,40,2,13,0,13
2020,181297,40,3,42,1,41
2020,181297,40,4,4,0,4
2020,181297,42,0,70,2,68
2020,181297,42,1,11,1,10
2020,181297,42,2,13,0,13
2020,181297,42,3,42,1,41
2020,181297,42,4,4,0,4
2020,181303,0,0,230,110,120
2020,181303,10,0,230,110,120
2020,181303,10,4,230,110,120
2020,181303,40,0,230,110,120
2020,181303,40,4,230,110,120
2020,181303,42,0,82,58,24
2020,181303,42,4,82,58,24
2020,181303,43,0,148,52,96
2020,181303,43,4,148,52,96
2020,181312,0,0,64,26,38
2020,181312,10,0,64,26,38
2020,181312,10,4,64,26,38
2020,181312,40,0,64,26,38
2020,181312,40,4,64,26,38
2020,181312,42,0,64,26,38
2020,181312,42,4,64,26,38
2020,181330,0,0,36,15,21
2020,181330,10,0,36,15,21
2020,181330,10,1,11,6,5
2020,181330,10,2,16,4,12
2020,181330,10,3,9,5,4
2020,181330,20,0,14,7,7
2020,181330,20,1,11,6,5
2020,181330,20,2,3,1,2
2020,181330,30,0,22,8,14
2020,181330,30,2,13,3,10
2020,181330,30,3,9,5,4
2020,181394,0,0,540,274,266
2020,181394,10,0,540,274,266
2020,181394,10,1,121,81,40
2020,181394,10,2,146,69,77
2020,181394,10,3,135,64,71
2020,181394,10,4,99,41,58
2020,181394,10,5,37,17,20
2020,181394,10,6,2,2,0
2020,181394,20,0,264,146,118
2020,181394,20,1,121,81,40
2020,181394,20,2,142,65,77
2020,181394,20,3,1,0,1
2020,181394,30,0,136,66,70
2020,181394,30,2,3,3,0
2020,181394,30,3,133,63,70
2020,181394,40,0,140,62,78
2020,181394,40,2,1,1,0
2020,181394,40,3,1,1,0
2020,181394,40,4,99,41,58
2020,181394,40,5,37,17,20
2020,181394,40,6,2,2,0
2020,181394,42,0,140,62,78
2020,181394,42,2,1,1,0
2020,181394,42,3,1,1,0
2020,181394,42,4,99,41,58
2020,181394,42,5,37,17,20
2020,181394,42,6,2,2,0
2020,181419,0,0,16,6,10
2020,181419,10,0,13,6,7
2020,181419,10,4,13,6,7
2020,181419,40,0,13,6,7
2020,181419,40,4,13,6,7
2020,181419,42,0,13,6,7
2020,181419,42,4,13,6,7
2020,181419,50,0,3,0,3
2020,181428,0,0,596,252,344
2020,181428,10,0,575,246,329
2020,181428,10,1,92,63,29
2020,181428,10,2,139,61,78
2020,181428,10,3,245,97,148
2020,181428,10,4,99,25,74
2020,181428,20,0,100,57,43
2020,181428,20,1,64,44,20
2020,181428,20,2,36,13,23
2020,181428,30,0,239,125,114
2020,181428,30,1,24,16,8
2020,181428,30,2,82,42,40
2020,181428,30,3,133,67,66
2020,181428,40,0,236,64,172
2020,181428,40,1,4,3,1
2020,181428,40,2,21,6,15
2020,181428,40,3,112,30,82
2020,181428,40,4,99,25,74
2020,181428,42,0,235,64,171
2020,181428,42,1,4,3,1
2020,181428,42,2,21,6,15
2020,181428,42,3,111,30,81
2020,181428,42,4,99,25,74
2020,181428,43,0,1,0,1
2020,181428,43,3,1,0,1
2020,181428,50,0,21,6,15
2020,181446,0,0,104,48,56
2020,181446,10,0,104,48,56
2020,181446,10,1,41,19,22
2020,181446,10,2,23,12,11
2020,181446,10,3,31,13,18
2020,181446,10,4,9,4,5
2020,181446,20,0,60,29,31
2020,181446,20,1,40,18,22
2020,181446,20,2,20,11,9
2020,181446,30,0,28,12,16
2020,181446,30,2,1,0,1
2020,181446,30,3,26,12,14
2020,181446,30,4,1,0,1
2020,181446,40,0,16,7,9
2020,181446,40,1,1,1,0
2020,181446,40,2,2,1,1
2020,181446,40,3,5,1,4
2020,181446,40,4,8,4,4
2020,181446,41,0,12,5,7
2020,181446,41,1,1,1,0
2020,181446,41,2,2,1,1
2020,181446,41,3,5,1,4
2020,181446,41,4,4,2,2
2020,181446,42,0,4,2,2
2020,181446,42,4,4,2,2
2020,181446,44,0,12,5,7
2020,181446,44,1,1,1,0
2020,181446,44,2,2,1,1
2020,181446,44,3,5,1,4
2020,181446,44,4,4,2,2
2020,181464,0,0,1321,817,504
2020,181464,10,0,1321,817,504
2020,181464,10,1,432,333,99
2020,181464,10,2,393,241,152
2020,181464,10,3,397,209,188
2020,181464,10,5,96,32,64
2020,181464,10,6,3,2,1
2020,181464,20,0,743,530,213
2020,181464,20,1,415,323,92
2020,181464,20,2,328,207,121
2020,181464,30,0,284,169,115
2020,181464,30,1,1,0,1
2020,181464,30,2,11,10,1
2020,181464,30,3,272,159,113
2020,181464,40,0,294,118,176
2020,181464,40,1,16,10,6
2020,181464,40,2,54,24,30
2020,181464,40,3,125,50,75
2020,181464,40,5,96,32,64
2020,181464,40,6,3,2,1
2020,181464,41,0,195,84,111
2020,181464,41,1,16,10,6
2020,181464,41,2,54,24,30
2020,181464,41,3,125,50,75
2020,181464,42,0,99,34,65
2020,181464,42,5,96,32,64
2020,181464,42,6,3,2,1
2020,181464,44,0,194,83,111
2020,181464,44,1,15,9,6
2020,181464,44,2,54,24,30
2020,181464,44,3,125,50,75
2020,181464,45,0,1,1,0
2020,181464,45,1,1,1,0
2020,181491,0,0,129,76,53
2020,181491,10,0,124,71,53
2020,181491,10,4,124,71,53
2020,181491,40,0,124,71,53
2020,181491,40,4,124,71,53
2020,181491,42,0,124,71,53
2020,181491,42,4,124,71,53
2020,181491,50,0,5,5,0
2020,181534,0,0,52,26,26
2020,181534,10,0,52,26,26
2020,181534,10,1,10,5,5
2020,181534,10,2,10,5,5
2020,181534,10,3,21,11,10
2020,181534,10,4,11,5,6
2020,181534,20,0,18,9,9
2020,181534,20,1,10,5,5
2020,181534,20,2,8,4,4
2020,181534,30,0,21,10,11
2020,181534,30,2,1,0,1
2020,181534,30,3,20,10,10
2020,181534,40,0,13,7,6
2020,181534,40,2,1,1,0
2020,181534,40,3,1,1,0
2020,181534,40,4,11,5,6
2020,181534,41,0,13,7,6
2020,181534,41,2,1,1,0
2020,181534,41,3,1,1,0
2020,181534,41,4,11,5,6
2020,181534,44,0,13,7,6
2020,181534,44,2,1,1,0
2020,181534,44,3,1,1,0
2020,181534,44,4,11,5,6
2020,181604,0,0,85,12,73
2020,181604,10,0,85,12,73
2020,181604,10,1,15,3,12
2020,181604,10,2,14,2,12
2020,181604,10,3,39,7,32
2020,181604,10,4,17,0,17
2020,181604,40,0,85,12,73
2020,181604,40,1,15,3,12
2020,181604,40,2,14,2,12
2020,181604,40,3,39,7,32
2020,181604,40,4,17,0,17
2020,181604,41,0,21,4,17
2020,181604,41,1,11,2,9
2020,181604,41,2,10,2,8
2020,181604,42,0,63,7,56
2020,181604,42,1,4,1,3
2020,181604,42,2,4,0,4
2020,181604,42,3,38,6,32
2020,181604,42,4,17,0,17
2020,181604,43,0,1,1,0
2020,181604,43,3,1,1,0
2020,181604,44,0,21,4,17
2020,181604,44,1,11,2,9
2020,181604,44,2,10,2,8
2020,181640,0,0,359,186,173
2020,181640,10,0,359,186,173
2020,181640,10,6,359,186,173
2020,181640,40,0,359,186,173
2020,181640,40,6,359,186,173
2020,181640,42,0,359,186,173
2020,181640,42,6,359,186,173
2020,181738,0,0,57,26,31
2020,181738,10,0,57,26,31
2020,181738,10,1,16,9,7
2020,181738,10,2,17,4,13
2020,181738,10,3,22,13,9
2020,181738,10,4,1,0,1
2020,181738,10,5,1,0,1
2020,181738,20,0,10,5,5
2020,181738,20,1,10,5,5
2020,181738,30,0,46,21,25
2020,181738,30,1,6,4,2
2020,181738,30,2,17,4,13
2020,181738,30,3,22,13,9
2020,181738,30,4,1,0,1
2020,181738,40,0,1,0,1
2020,181738,40,5,1,0,1
2020,181738,42,0,1,0,1
2020,181738,42,5,1,0,1
2020,181765,0,0,14,7,7
2020,181765,10,0,14,7,7
2020,181765,10,1,1,0,1
2020,181765,10,2,6,4,2
2020,181765,10,3,4,1,3
2020,181765,10,5,3,2,1
2020,181765,40,0,14,7,7
2020,181765,40,1,1,0,1
2020,181765,40,2,6,4,2
2020,181765,40,3,4,1,3
2020,181765,40,5,3,2,1
2020,181765,42,0,14,7,7
2020,181765,42,1,1,0,1
2020,181765,42,2,6,4,2
2020,181765,42,3,4,1,3
2020,181765,42,5,3,2,1
2020,181783,0,0,124,67,57
2020,181783,10,0,124,67,57
2020,181783,10,1,51,29,22
2020,181783,10,2,31,13,18
2020,181783,10,3,28,17,11
2020,181783,10,4,12,7,5
2020,181783,10,5,2,1,1
2020,181783,20,0,65,37,28
2020,181783,20,1,51,29,22
2020,181783,20,2,13,7,6
2020,181783,20,3,1,1,0
2020,181783,30,0,43,20,23
2020,181783,30,2,18,6,12
2020,181783,30,3,25,14,11
2020,181783,40,0,16,10,6
2020,181783,40,3,2,2,0
2020,181783,40,4,12,7,5
2020,181783,40,5,2,1,1
2020,181783,42,0,16,10,6
2020,181783,42,3,2,2,0
2020,181783,42,4,12,7,5
2020,181783,42,5,2,1,1
2020,181817,0,0,64,32,32
2020,181817,10,0,64,32,32
2020,181817,10,6,64,32,32
2020,181817,20,0,56,29,27
2020,181817,20,6,56,29,27
2020,181817,30,0,8,3,5
2020,181817,30,6,8,3,5
2020,181853,0,0,26,18,8
2020,181853,10,0,26,18,8
2020,181853,10,1,6,6,0
2020,181853,10,2,9,8,1
2020,181853,10,3,11,4,7
2020,181853,20,0,9,8,1
2020,181853,20,1,4,4,0
2020,181853,20,2,5,4,1
2020,181853,30,0,3,3,0
2020,181853,30,2,3,3,0
2020,181853,40,0,14,7,7
2020,181853,40,1,2,2,0
2020,181853,40,2,1,1,0
2020,181853,40,3,11,4,7
2020,181853,42,0,14,7,7
2020,181853,42,1,2,2,0
2020,181853,42,2,1,1,0
2020,181853,42,3,11,4,7
2020,181941,0,0,21,12,9
2020,181941,10,0,21,12,9
2020,181941,10,4,21,12,9
2020,181941,40,0,21,12,9
2020,181941,40,4,21,12,9
2020,181941,41,0,21,12,9
2020,181941,41,4,21,12,9
2020,181941,45,0,21,12,9
2020,181941,45,4,21,12,9
2020,182005,0,0,513,270,243
2020,182005,10,0,513,270,243
2020,182005,10,1,379,203,176
2020,182005,10,4,80,43,37
2020,182005,10,6,54,24,30
2020,182005,20,0,381,204,177
2020,182005,20,1,379,203,176
2020,182005,20,6,2,1,1
2020,182005,30,0,89,40,49
2020,182005,30,4,51,26,25
2020,182005,30,6,38,14,24
2020,182005,40,0,43,26,17
2020,182005,40,4,29,17,12
2020,182005,40,6,14,9,5
2020,182005,42,0,43,26,17
2020,182005,42,4,29,17,12
2020,182005,42,6,14,9,5
2020,182148,0,0,17,3,14
2020,182148,10,0,17,3,14
2020,182148,10,6,17,3,14
2020,182148,40,0,17,3,14
2020,182148,40,6,17,3,14
2020,182148,41,0,17,3,14
2020,182148,41,6,17,3,14
2020,182148,45,0,17,3,14
2020,182148,45,6,17,3,14
2020,182281,0,0,1143,668,475
2020,182281,10,0,1143,668,475
2020,182281,10,1,310,228,82
2020,182281,10,2,248,145,103
2020,182281,10,3,166,91,75
2020,182281,10,4,10,9,1
2020,182281,10,5,107,47,60
2020,182281,10,6,302,148,154
2020,182281,20,0,547,370,177
2020,182281,20,1,310,228,82
2020,182281,20,2,234,139,95
2020,182281,20,3,3,3,0
2020,182281,30,0,177,94,83
2020,182281,30,2,14,6,8
2020,182281,30,3,163,88,75
2020,182281,40,0,419,204,215
2020,182281,40,4,10,9,1
2020,182281,40,5,107,47,60
2020,182281,40,6,302,148,154
2020,182281,42,0,419,204,215
2020,182281,42,4,10,9,1
2020,182281,42,5,107,47,60
2020,182281,42,6,302,148,154
2020,182290,0,0,953,547,406
2020,182290,10,0,953,547,406
2020,182290,10,1,200,143,57
2020,182290,10,2,214,134,80
2020,182290,10,3,264,153,111
2020,182290,10,5,180,74,106
2020,182290,10,6,95,43,52
2020,182290,20,0,402,266,136
2020,182290,20,1,199,142,57
2020,182290,20,2,201,124,77
2020,182290,20,3,2,0,2
2020,182290,30,0,276,164,112
2020,182290,30,1,1,1,0
2020,182290,30,2,13,10,3
2020,182290,30,3,262,153,109
2020,182290,40,0,275,117,158
2020,182290,40,5,180,74,106
2020,182290,40,6,95,43,52
2020,182290,42,0,275,117,158
2020,182290,42,5,180,74,106
2020,182290,42,6,95,43,52
2020,182306,0,0,71,44,27
2020,182306,10,0,71,44,27
2020,182306,10,1,36,20,16
2020,182306,10,4,34,23,11
2020,182306,10,6,1,1,0
2020,182306,20,0,36,20,16
2020,182306,20,1,36,20,16
2020,182306,30,0,21,12,9
2020,182306,30,4,21,12,9
2020,182306,40,0,14,12,2
2020,182306,40,4,13,11,2
2020,182306,40,6,1,1,0
2020,182306,42,0,14,12,2
2020,182306,42,4,13,11,2
2020,182306,42,6,1,1,0
2020,182458,0,0,33,18,15
2020,182458,10,0,33,18,15
2020,182458,10,1,7,3,4
2020,182458,10,2,9,4,5
2020,182458,10,3,15,10,5
2020,182458,10,4,2,1,1
2020,182458,40,0,33,18,15
2020,182458,40,1,7,3,4
2020,182458,40,2,9,4,5
2020,182458,40,3,15,10,5
2020,182458,40,4,2,1,1
2020,182458,42,0,33,18,15
2020,182458,42,1,7,3,4
2020,182458,42,2,9,4,5
2020,182458,42,3,15,10,5
2020,182458,42,4,2,1,1
2020,182500,0,0,156,76,80
2020,182500,10,0,156,76,80
2020,182500,10,1,102,52,50
2020,182500,10,4,54,24,30
2020,182500,20,0,102,52,50
2020,182500,20,1,102,52,50
2020,182500,30,0,39,17,22
2020,182500,30,4,39,17,22
2020,182500,40,0,15,7,8
2020,182500,40,4,15,7,8
2020,182500,42,0,15,7,8
2020,182500,42,4,15,7,8
2020,182564,0,0,51,25,26
2020,182564,10,0,51,25,26
2020,182564,10,1,32,15,17
2020,182564,10,4,19,10,9
2020,182564,20,0,32,15,17
2020,182564,20,1,32,15,17
2020,182564,30,0,13,8,5
2020,182564,30,4,13,8,5
2020,182564,40,0,6,2,4
2020,182564,40,4,6,2,4
2020,182564,42,0,6,2,4
2020,182564,42,4,6,2,4
2020,182634,0,0,46,17,29
2020,182634,10,0,46,17,29
2020,182634,10,1,17,8,9
2020,182634,10,2,11,4,7
2020,182634,10,3,18,5,13
2020,182634,20,0,28,12,16
2020,182634,20,1,17,8,9
2020,182634,20,2,11,4,7
2020,182634,30,0,5,1,4
2020,182634,30,3,5,1,4
2020,182634,40,0,13,4,9
2020,182634,40,3,13,4,9
2020,182634,42,0,13,4,9
2020,182634,42,3,13,4,9
2020,182670,0,0,718,450,268
2020,182670,10,0,718,450,268
2020,182670,10,1,312,223,89
2020,182670,10,2,184,108,76
2020,182670,10,3,132,76,56
2020,182670,10,4,10,5,5
2020,182670,10,5,73,35,38
2020,182670,10,6,7,3,4
2020,182670,20,0,437,300,137
2020,182670,20,1,287,208,79
2020,182670,20,2,150,92,58
2020,182670,30,0,161,87,74
2020,182670,30,1,4,2,2
2020,182670,30,2,29,13,16
2020,182670,30,3,128,72,56
2020,182670,40,0,120,63,57
2020,182670,40,1,21,13,8
2020,182670,40,2,5,3,2
2020,182670,40,3,4,4,0
2020,182670,40,4,10,5,5
2020,182670,40,5,73,35,38
2020,182670,40,6,7,3,4
2020,182670,41,0,120,63,57
2020,182670,41,1,21,13,8
2020,182670,41,2,5,3,2
2020,182670,41,3,4,4,0
2020,182670,41,4,10,5,5
2020,182670,41,5,73,35,38
2020,182670,41,6,7,3,4
2020,182670,44,0,120,63,57
2020,182670,44,1,21,13,8
2020,182670,44,2,5,3,2
2020,182670,44,3,4,4,0
2020,182670,44,4,10,5,5
2020,182670,44,5,73,35,38
2020,182670,44,6,7,3,4
2020,182795,0,0,88,40,48
2020,182795,10,0,88,40,48
2020,182795,10,1,17,12,5
2020,182795,10,2,28,16,12
2020,182795,10,3,40,12,28
2020,182795,10,4,3,0,3
2020,182795,40,0,88,40,48
2020,182795,40,1,17,12,5
2020,182795,40,2,28,16,12
2020,182795,40,3,40,12,28
2020,182795,40,4,3,0,3
2020,182795,42,0,88,40,48
2020,182795,42,1,17,12,5
2020,182795,42,2,28,16,12
2020,182795,42,3,40,12,28
2020,182795,42,4,3,0,3
2020,182829,0,0,25,13,12
2020,182829,10,0,25,13,12
2020,182829,10,1,19,11,8
2020,182829,10,2,1,0,1
2020,182829,10,5,5,2,3
2020,182829,20,0,14,10,4
2020,182829,20,1,14,10,4
2020,182829,40,0,11,3,8
2020,182829,40,1,5,1,4
2020,182829,40,2,1,0,1
2020,182829,40,5,5,2,3
2020,182829,41,0,11,3,8
2020,182829,41,1,5,1,4
2020,182829,41,2,1,0,1
2020,182829,41,5,5,2,3
2020,182829,44,0,11,3,8
2020,182829,44,1,5,1,4
2020,182829,44,2,1,0,1
2020,182829,44,5,5,2,3
2020,182980,0,0,70,39,31
2020,182980,10,0,70,39,31
2020,182980,10,1,24,10,14
2020,182980,10,2,20,14,6
2020,182980,10,3,22,14,8
2020,182980,10,4,4,1,3
2020,182980,40,0,70,39,31
2020,182980,40,1,24,10,14
2020,182980,40,2,20,14,6
2020,182980,40,3,22,14,8
2020,182980,40,4,4,1,3
2020,182980,41,0,55,31,24
2020,182980,41,1,22,9,13
2020,182980,41,2,16,12,4
2020,182980,41,3,14,9,5
2020,182980,41,4,3,1,2
2020,182980,42,0,15,8,7
2020,182980,42,1,2,1,1
2020,182980,42,2,4,2,2
2020,182980,42,3,8,5,3
2020,182980,42,4,1,0,1
2020,182980,44,0,55,31,24
2020,182980,44,1,22,9,13
2020,182980,44,2,16,12,4
2020,182980,44,3,14,9,5
2020,182980,44,4,3,1,2
2020,183026,0,0,139,71,68
2020,183026,10,0,135,69,66
2020,183026,10,1,36,22,14
2020,183026,10,2,44,17,27
2020,183026,10,3,48,23,25
2020,183026,10,4,7,7,0
2020,183026,40,0,135,69,66
2020,183026,40,1,36,22,14
2020,183026,40,2,44,17,27
2020,183026,40,3,48,23,25
2020,183026,40,4,7,7,0
2020,183026,41,0,72,39,33
2020,183026,41,1,35,22,13
2020,183026,41,2,29,12,17
2020,183026,41,3,5,2,3
2020,183026,41,4,3,3,0
2020,183026,42,0,63,30,33
2020,183026,42,1,1,0,1
2020,183026,42,2,15,5,10
2020,183026,42,3,43,21,22
2020,183026,42,4,4,4,0
2020,183026,44,0,72,39,33
2020,183026,44,1,35,22,13
2020,183026,44,2,29,12,17
2020,183026,44,3,5,2,3
2020,183026,44,4,3,3,0
2020,183026,50,0,4,2,2
2020,183044,0,0,734,355,379
2020,183044,10,0,734,355,379
2020,183044,10,1,190,126,64
2020,183044,10,2,211,93,118
2020,183044,10,3,178,67,111
2020,183044,10,5,155,69,86
2020,183044,20,0,371,212,159
2020,183044,20,1,187,124,63
2020,183044,20,2,184,88,96
2020,183044,30,0,137,64,73
2020,183044,30,1,1,1,0
2020,183044,30,2,3,2,1
2020,183044,30,3,133,61,72
2020,183044,40,0,226,79,147
2020,183044,40,1,2,1,1
2020,183044,40,2,24,3,21
2020,183044,40,3,45,6,39
2020,183044,40,5,155,69,86
2020,183044,41,0,226,79,147
2020,183044,41,1,2,1,1
2020,183044,41,2,24,3,21
2020,183044,41,3,45,6,39
2020,183044,41,5,155,69,86
2020,183044,44,0,226,79,147
2020,183044,44,1,2,1,1
2020,183044,44,2,24,3,21
2020,183044,44,3,45,6,39
2020,183044,44,5,155,69,86
2020,183062,0,0,172,88,84
2020,183062,10,0,172,88,84
2020,183062,10,1,73,41,32
2020,183062,10,2,55,28,27
2020,183062,10,3,39,17,22
2020,183062,10,5,3,1,2
2020,183062,10,6,2,1,1
2020,183062,20,0,122,67,55
2020,183062,20,1,73,41,32
2020,183062,20,2,47,25,22
2020,183062,20,3,2,1,1
2020,183062,30,0,35,16,19
2020,183062,30,2,5,2,3
2020,183062,30,3,30,14,16
2020,183062,40,0,15,5,10
2020,183062,40,2,3,1,2
2020,183062,40,3,7,2,5
2020,183062,40,5,3,1,2
2020,183062,40,6,2,1,1
2020,183062,41,0,15,5,10
2020,183062,41,2,3,1,2
2020,183062,41,3,7,2,5
2020,183062,41,5,3,1,2
2020,183062,41,6,2,1,1
2020,183062,44,0,15,5,10
2020,183062,44,2,3,1,2
2020,183062,44,3,7,2,5
2020,183062,44,5,3,1,2
2020,183062,44,6,2,1,1
2020,183071,0,0,42,24,18
2020,183071,10,0,42,24,18
2020,183071,10,1,3,2,1
2020,183071,10,2,16,9,7
2020,183071,10,3,12,7,5
2020,183071,10,5,11,6,5
2020,183071,20,0,18,10,8
2020,183071,20,1,3,2,1
2020,183071,20,2,15,8,7
2020,183071,30,0,13,8,5
2020,183071,30,2,1,1,0
2020,183071,30,3,12,7,5
2020,183071,40,0,11,6,5
2020,183071,40,5,11,6,5
2020,183071,41,0,11,6,5
2020,183071,41,5,11,6,5
2020,183071,44,0,11,6,5
2020,183071,44,5,11,6,5
2020,183080,0,0,184,92,92
2020,183080,10,0,184,92,92
2020,183080,10,1,69,39,30
2020,183080,10,2,49,21,28
2020,183080,10,3,36,16,20
2020,183080,10,5,30,16,14
2020,183080,20,0,114,60,54
2020,183080,20,1,69,39,30
2020,183080,20,2,45,21,24
2020,183080,30,0,31,15,16
2020,183080,30,2,1,0,1
2020,183080,30,3,30,15,15
2020,183080,40,0,39,17,22
2020,183080,40,2,3,0,3
2020,183080,40,3,6,1,5
2020,183080,40,5,30,16,14
2020,183080,41,0,39,17,22
2020,183080,41,2,3,0,3
2020,183080,41,3,6,1,5
2020,183080,41,5,30,16,14
2020,183080,44,0,39,17,22
2020,183080,44,2,3,0,3
2020,183080,44,3,6,1,5
2020,183080,44,5,30,16,14
2020,183099,0,0,76,26,50
2020,183099,10,0,76,26,50
2020,183099,10,1,63,23,40
2020,183099,10,2,10,1,9
2020,183099,10,3,1,0,1
2020,183099,10,4,2,2,0
2020,183099,40,0,76,26,50
2020,183099,40,1,63,23,40
2020,183099,40,2,10,1,9
2020,183099,40,3,1,0,1
2020,183099,40,4,2,2,0
2020,183099,42,0,76,26,50
2020,183099,42,1,63,23,40
2020,183099,42,2,10,1,9
2020,183099,42,3,1,0,1
2020,183099,42,4,2,2,0
2020,183105,0,0,22,11,11
2020,183105,10,0,22,11,11
2020,183105,10,1,11,2,9
2020,183105,10,2,8,6,2
2020,183105,10,3,2,2,0
2020,183105,10,4,1,1,0
2020,183105,40,0,22,11,11
2020,183105,40,1,11,2,9
2020,183105,40,2,8,6,2
2020,183105,40,3,2,2,0
2020,183105,40,4,1,1,0
2020,183105,42,0,22,11,11
2020,183105,42,1,11,2,9
2020,183105,42,2,8,6,2
2020,183105,42,3,2,2,0
2020,183105,42,4,1,1,0
2020,183114,0,0,27,3,24
2020,183114,10,0,27,3,24
2020,183114,10,1,15,2,13
2020,183114,10,2,10,1,9
2020,183114,10,3,2,0,2
2020,183114,40,0,27,3,24
2020,183114,40,1,15,2,13
2020,183114,40,2,10,1,9
2020,183114,40,3,2,0,2
2020,183114,42,0,27,3,24
2020,183114,42,1,15,2,13
2020,183114,42,2,10,1,9
2020,183114,42,3,2,0,2
2020,183123,0,0,24,15,9
2020,183123,10,0,24,15,9
2020,183123,10,1,11,4,7
2020,183123,10,2,6,4,2
2020,183123,10,3,5,5,0
2020,183123,10,4,2,2,0
2020,183123,40,0,24,15,9
2020,183123,40,1,11,4,7
2020,183123,40,2,6,4,2
2020,183123,40,3,5,5,0
2020,183123,40,4,2,2,0
2020,183123,42,0,24,15,9
2020,183123,42,1,11,4,7
2020,183123,42,2,6,4,2
2020,183123,42,3,5,5,0
2020,183123,42,4,2,2,0
2020,183132,0,0,49,23,26
2020,183132,10,0,49,23,26
2020,183132,10,1,30,11,19
2020,183132,10,2,17,10,7
2020,183132,10,3,1,1,0
2020,183132,10,4,1,1,0
2020,183132,40,0,49,23,26
2020,183132,40,1,30,11,19
2020,183132,40,2,17,10,7
2020,183132,40,3,1,1,0
2020,183132,40,4,1,1,0
2020,183132,42,0,49,23,26
2020,183132,42,1,30,11,19
2020,183132,42,2,17,10,7
2020,183132,42,3,1,1,0
2020,183132,42,4,1,1,0
2020,183141,0,0,29,15,14
2020,183141,10,0,29,15,14
2020,183141,10,1,24,10,14
2020,183141,10,2,5,5,0
2020,183141,40,0,29,15,14
2020,183141,40,1,24,10,14
2020,183141,40,2,5,5,0
2020,183141,42,0,29,15,14
2020,183141,42,1,24,10,14
2020,183141,42,2,5,5,0
2020,183150,0,0,34,10,24
2020,183150,10,0,34,10,24
2020,183150,10,1,26,8,18
2020,183150,10,2,6,1,5
2020,183150,10,3,1,0,1
2020,183150,10,4,1,1,0
2020,183150,40,0,34,10,24
2020,183150,40,1,26,8,18
2020,183150,40,2,6,1,5
2020,183150,40,3,1,0,1
2020,183150,40,4,1,1,0
2020,183150,42,0,34,10,24
2020,183150,42,1,26,8,18
2020,183150,42,2,6,1,5
2020,183150,42,3,1,0,1
2020,183150,42,4,1,1,0
2020,183211,0,0,58,14,44
2020,183211,10,0,58,14,44
2020,183211,10,1,8,5,3
2020,183211,10,2,12,3,9
2020,183211,10,3,26,5,21
2020,183211,10,4,12,1,11
2020,183211,20,0,11,7,4
2020,183211,20,1,8,5,3
2020,183211,20,2,3,2,1
2020,183211,30,0,4,0,4
2020,183211,30,2,2,0,2
2020,183211,30,3,2,0,2
2020,183211,40,0,43,7,36
2020,183211,40,2,7,1,6
2020,183211,40,3,24,5,19
2020,183211,40,4,12,1,11
2020,183211,42,0,43,7,36
2020,183211,42,2,7,1,6
2020,183211,42,3,24,5,19
2020,183211,42,4,12,1,11
2020,183239,0,0,147,65,82
2020,183239,10,0,147,65,82
2020,183239,10,1,48,29,19
2020,183239,10,2,47,20,27
2020,183239,10,3,30,14,16
2020,183239,10,4,8,2,6
2020,183239,10,5,2,0,2
2020,183239,10,6,12,0,12
2020,183239,20,0,89,45,44
2020,183239,20,1,48,29,19
2020,183239,20,2,41,16,25
2020,183239,30,0,26,12,14
2020,183239,30,2,6,4,2
2020,183239,30,3,19,8,11
2020,183239,30,4,1,0,1
2020,183239,40,0,32,8,24
2020,183239,40,3,11,6,5
2020,183239,40,4,7,2,5
2020,183239,40,5,2,0,2
2020,183239,40,6,12,0,12
2020,183239,42,0,32,8,24
2020,183239,42,3,11,6,5
2020,183239,42,4,7,2,5
2020,183239,42,5,2,0,2
2020,183239,42,6,12,0,12
2020,183248,0,0,18,1,17
2020,183248,10,0,18,1,17
2020,183248,10,4,18,1,17
2020,183248,40,0,18,1,17
2020,183248,40,4,18,1,17
2020,183248,41,0,18,1,17
2020,183248,41,4,18,1,17
2020,183248,45,0,18,1,17
2020,183248,45,4,18,1,17
2020,183257,0,0,18,2,16
2020,183257,10,0,18,2,16
2020,183257,10,5,18,2,16
2020,183257,40,0,18,2,16
2020,183257,40,5,18,2,16
2020,183257,41,0,18,2,16
2020,183257,41,5,18,2,16
2020,183257,44,0,18,2,16
2020,183257,44,5,18,2,16
2020,183275,0,0,6,5,1
2020,183275,10,0,6,5,1
2020,183275,10,6,6,5,1
2020,183275,40,0,6,5,1
2020,183275,40,6,6,5,1
2020,183275,42,0,6,5,1
2020,183275,42,6,6,5,1
2020,183488,0,0,8,3,5
2020,183488,10,0,8,3,5
2020,183488,10,1,2,1,1
2020,183488,10,4,6,2,4
2020,183488,40,0,8,3,5
2020,183488,40,1,2,1,1
2020,183488,40,4,6,2,4
2020,183488,41,0,8,3,5
2020,183488,41,1,2,1,1
2020,183488,41,4,6,2,4
2020,183488,45,0,8,3,5
2020,183488,45,1,2,1,1
2020,183488,45,4,6,2,4
2020,183655,0,0,71,29,42
2020,183655,10,0,68,29,39
2020,183655,10,1,26,12,14
2020,183655,10,2,20,6,14
2020,183655,10,3,18,9,9
2020,183655,10,6,4,2,2
2020,183655,20,0,54,22,32
2020,183655,20,1,26,12,14
2020,183655,20,2,20,6,14
2020,183655,20,3,8,4,4
2020,183655,30,0,10,5,5
2020,183655,30,3,10,5,5
2020,183655,40,0,4,2,2
2020,183655,40,6,4,2,2
2020,183655,42,0,4,2,2
2020,183655,42,6,4,2,2
2020,183655,50,0,3,0,3
2020,183743,0,0,205,94,111
2020,183743,10,0,205,94,111
2020,183743,10,1,66,42,24
2020,183743,10,2,58,25,33
2020,183743,10,3,52,19,33
2020,183743,10,4,18,5,13
2020,183743,10,5,10,3,7
2020,183743,10,6,1,0,1
2020,183743,20,0,166,78,88
2020,183743,20,1,66,42,24
2020,183743,20,2,56,24,32
2020,183743,20,3,40,11,29
2020,183743,20,4,4,1,3
2020,183743,30,0,25,13,12
2020,183743,30,2,2,1,1
2020,183743,30,3,12,8,4
2020,183743,30,4,10,4,6
2020,183743,30,6,1,0,1
2020,183743,40,0,14,3,11
2020,183743,40,4,4,0,4
2020,183743,40,5,10,3,7
2020,183743,42,0,4,0,4
2020,183743,42,4,4,0,4
2020,183743,43,0,10,3,7
2020,183743,43,5,10,3,7
2020,183789,0,0,76,38,38
2020,183789,10,0,76,38,38
2020,183789,10,6,76,38,38
2020,183789,40,0,76,38,38
2020,183789,40,6,76,38,38
2020,183789,42,0,76,38,38
2020,183789,42,6,76,38,38
2020,183804,0,0,15,15,0
2020,183804,10,0,15,15,0
2020,183804,10,1,14,14,0
2020,183804,10,3,1,1,0
2020,183804,40,0,15,15,0
2020,183804,40,1,14,14,0
2020,183804,40,3,1,1,0
2020,183804,41,0,15,15,0
2020,183804,41,1,14,14,0
2020,183804,41,3,1,1,0
2020,183804,45,0,15,15,0
2020,183804,45,1,14,14,0
2020,183804,45,3,1,1,0
2020,183822,0,0,60,23,37
2020,183822,10,0,60,23,37
2020,183822,10,1,29,12,17
2020,183822,10,2,18,8,10
2020,183822,10,3,12,2,10
2020,183822,10,4,1,1,0
2020,183822,20,0,41,17,24
2020,183822,20,1,29,12,17
2020,183822,20,2,12,5,7
2020,183822,30,0,17,4,13
2020,183822,30,2,5,2,3
2020,183822,30,3,12,2,10
2020,183822,40,0,2,2,0
2020,183822,40,2,1,1,0
2020,183822,40,4,1,1,0
2020,183822,41,0,1,1,0
2020,183822,41,2,1,1,0
2020,183822,42,0,1,1,0
2020,183822,42,4,1,1,0
2020,183822,45,0,1,1,0
2020,183822,45,2,1,1,0
2020,183859,0,0,192,80,112
2020,183859,10,0,192,80,112
2020,183859,10,1,80,40,40
2020,183859,10,2,43,14,29
2020,183859,10,3,38,19,19
2020,183859,10,4,31,7,24
2020,183859,20,0,161,73,88
2020,183859,20,1,80,40,40
2020,183859,20,2,43,14,29
2020,183859,20,3,38,19,19
2020,183859,30,0,26,7,19
2020,183859,30,4,26,7,19
2020,183859,40,0,5,0,5
2020,183859,40,4,5,0,5
2020,183859,42,0,2,0,2
2020,183859,42,4,2,0,2
2020,183859,43,0,3,0,3
2020,183859,43,4,3,0,3
2020,183877,0,0,64,25,39
2020,183877,10,0,64,25,39
2020,183877,10,1,2,1,1
2020,183877,10,2,3,0,3
2020,183877,10,3,28,12,16
2020,183877,10,4,29,12,17
2020,183877,10,6,2,0,2
2020,183877,20,0,35,13,22
2020,183877,20,1,2,1,1
2020,183877,20,2,3,0,3
2020,183877,20,3,28,12,16
2020,183877,20,4,2,0,2
2020,183877,30,0,29,12,17
2020,183877,30,4,27,12,15
2020,183877,30,6,2,0,2
2020,183910,0,0,80,30,50
2020,183910,10,0,79,30,49
2020,183910,10,1,34,16,18
2020,183910,10,2,17,4,13
2020,183910,10,3,23,10,13
2020,183910,10,4,5,0,5
2020,183910,20,0,43,20,23
2020,183910,20,1,34,16,18
2020,183910,20,2,8,4,4
2020,183910,20,3,1,0,1
2020,183910,30,0,33,10,23
2020,183910,30,2,9,0,9
2020,183910,30,3,22,10,12
2020,183910,30,4,2,0,2
2020,183910,40,0,3,0,3
2020,183910,40,4,3,0,3
2020,183910,42,0,3,0,3
2020,183910,42,4,3,0,3
2020,183910,50,0,1,0,1
2020,183938,0,0,112,48,64
2020,183938,10,0,97,39,58
2020,183938,10,1,25,14,11
2020,183938,10,2,14,6,8
2020,183938,10,3,58,19,39
2020,183938,20,0,89,35,54
2020,183938,20,1,25,14,11
2020,183938,20,2,14,6,8
2020,183938,20,3,50,15,35
2020,183938,30,0,8,4,4
2020,183938,30,3,8,4,4
2020,183938,50,0,15,9,6
2020,183974,0,0,66,30,36
2020,183974,10,0,66,30,36
2020,183974,10,1,11,3,8
2020,183974,10,2,19,9,10
2020,183974,10,3,34,16,18
2020,183974,10,4,2,2,0
2020,183974,20,0,14,7,7
2020,183974,20,1,5,2,3
2020,183974,20,2,9,5,4
2020,183974,30,0,8,3,5
2020,183974,30,2,1,0,1
2020,183974,30,3,7,3,4
2020,183974,40,0,44,20,24
2020,183974,40,1,6,1,5
2020,183974,40,2,9,4,5
2020,183974,40,3,27,13,14
2020,183974,40,4,2,2,0
2020,183974,42,0,10,4,6
2020,183974,42,1,3,0,3
2020,183974,42,2,1,1,0
2020,183974,42,3,6,3,3
2020,183974,43,0,34,16,18
2020,183974,43,1,3,1,2
2020,183974,43,2,8,3,5
2020,183974,43,3,21,10,11
2020,183974,43,4,2,2,0
2020,184180,0,0,155,71,84
2020,184180,10,0,155,71,84
2020,184180,10,1,38,21,17
2020,184180,10,2,41,15,26
2020,184180,10,3,66,29,37
2020,184180,10,4,10,6,4
2020,184180,20,0,105,48,57
2020,184180,20,1,38,21,17
2020,184180,20,2,38,14,24
2020,184180,20,3,29,13,16
2020,184180,30,0,50,23,27
2020,184180,30,2,3,1,2
2020,184180,30,3,37,16,21
2020,184180,30,4,10,6,4
2020,184205,0,0,36,16,20
2020,184205,10,0,36,16,20
2020,184205,10,1,4,2,2
2020,184205,10,2,13,5,8
2020,184205,10,3,6,3,3
2020,184205,10,4,10,4,6
2020,184205,10,6,3,2,1
2020,184205,30,0,33,14,19
2020,184205,30,1,4,2,2
2020,184205,30,2,13,5,8
2020,184205,30,3,6,3,3
2020,184205,30,4,10,4,6
2020,184205,40,0,3,2,1
2020,184205,40,6,3,2,1
2020,184205,42,0,3,2,1
2020,184205,42,6,3,2,1
2020,184348,0,0,130,68,62
2020,184348,10,0,130,68,62
2020,184348,10,1,50,27,23
2020,184348,10,2,45,24,21
2020,184348,10,3,34,17,17
2020,184348,10,4,1,0,1
2020,184348,20,0,92,50,42
2020,184348,20,1,50,27,23
2020,184348,20,2,42,23,19
2020,184348,30,0,14,7,7
2020,184348,30,3,14,7,7
2020,184348,40,0,24,11,13
2020,184348,40,2,3,1,2
2020,184348,40,3,20,10,10
2020,184348,40,4,1,0,1
2020,184348,41,0,14,7,7
2020,184348,41,2,3,1,2
2020,184348,41,3,10,6,4
2020,184348,41,4,1,0,1
2020,184348,42,0,10,4,6
2020,184348,42,3,10,4,6
2020,184348,44,0,14,7,7
2020,184348,44,2,3,1,2
2020,184348,44,3,10,6,4
2020,184348,44,4,1,0,1
2020,184481,0,0,87,45,42
2020,184481,10,0,87,45,42
2020,184481,10,1,19,13,6
2020,184481,10,2,25,11,14
2020,184481,10,3,27,14,13
2020,184481,10,4,15,7,8
2020,184481,10,5,1,0,1
2020,184481,20,0,79,44,35
2020,184481,20,1,19,13,6
2020,184481,20,2,25,11,14
2020,184481,20,3,24,14,10
2020,184481,20,4,11,6,5
2020,184481,30,0,7,1,6
2020,184481,30,3,3,0,3
2020,184481,30,4,4,1,3
2020,184481,40,0,1,0,1
2020,184481,40,5,1,0,1
2020,184481,42,0,1,0,1
2020,184481,42,5,1,0,1
2020,184603,0,0,150,82,68
2020,184603,10,0,150,82,68
2020,184603,10,1,47,32,15
2020,184603,10,2,29,15,14
2020,184603,10,3,42,21,21
2020,184603,10,4,4,0,4
2020,184603,10,5,28,14,14
2020,184603,20,0,73,46,27
2020,184603,20,1,47,32,15
2020,184603,20,2,21,10,11
2020,184603,20,3,5,4,1
2020,184603,30,0,38,22,16
2020,184603,30,2,7,5,2
2020,184603,30,3,31,17,14
2020,184603,40,0,39,14,25
2020,184603,40,2,1,0,1
2020,184603,40,3,6,0,6
2020,184603,40,4,4,0,4
2020,184603,40,5,28,14,14
2020,184603,42,0,39,14,25
2020,184603,42,2,1,0,1
2020,184603,42,3,6,0,6
2020,184603,42,4,4,0,4
2020,184603,42,5,28,14,14
2020,184612,0,0,80,29,51
2020,184612,10,0,80,29,51
2020,184612,10,1,15,7,8
2020,184612,10,2,26,14,12
2020,184612,10,3,26,8,18
2020,184612,10,4,13,0,13
2020,184612,40,0,80,29,51
2020,184612,40,1,15,7,8
2020,184612,40,2,26,14,12
2020,184612,40,3,26,8,18
2020,184612,40,4,13,0,13
2020,184612,42,0,80,29,51
2020,184612,42,1,15,7,8
2020,184612,42,2,26,14,12
2020,184612,42,3,26,8,18
2020,184612,42,4,13,0,13
2020,184694,0,0,163,75,88
2020,184694,10,0,163,75,88
2020,184694,10,1,46,30,16
2020,184694,10,2,43,20,23
2020,184694,10,3,52,17,35
2020,184694,10,4,1,0,1
2020,184694,10,5,21,8,13
2020,184694,20,0,78,48,30
2020,184694,20,1,45,30,15
2020,184694,20,2,31,16,15
2020,184694,20,3,2,2,0
2020,184694,30,0,43,16,27
2020,184694,30,1,1,0,1
2020,184694,30,2,9,3,6
2020,184694,30,3,33,13,20
2020,184694,40,0,42,11,31
2020,184694,40,2,3,1,2
2020,184694,40,3,17,2,15
2020,184694,40,4,1,0,1
2020,184694,40,5,21,8,13
2020,184694,42,0,42,11,31
2020,184694,42,2,3,1,2
2020,184694,42,3,17,2,15
2020,184694,42,4,1,0,1
2020,184694,42,5,21,8,13
2020,184773,0,0,90,31,59
2020,184773,10,0,90,31,59
2020,184773,10,1,24,9,15
2020,184773,10,2,27,8,19
2020,184773,10,3,32,12,20
2020,184773,10,4,1,0,1
2020,184773,10,5,5,2,3
2020,184773,10,6,1,0,1
2020,184773,20,0,51,18,33
2020,184773,20,1,24,9,15
2020,184773,20,2,26,8,18
2020,184773,20,3,1,1,0
2020,184773,30,0,32,11,21
2020,184773,30,2,1,0,1
2020,184773,30,3,31,11,20
2020,184773,40,0,7,2,5
2020,184773,40,4,1,0,1
2020,184773,40,5,5,2,3
2020,184773,40,6,1,0,1
2020,184773,42,0,7,2,5
2020,184773,42,4,1,0,1
2020,184773,42,5,5,2,3
2020,184773,42,6,1,0,1
2020,184782,0,0,826,425,401
2020,184782,10,0,826,425,401
2020,184782,10,1,150,98,52
2020,184782,10,2,175,92,83
2020,184782,10,3,273,141,132
2020,184782,10,4,56,21,35
2020,184782,10,5,127,56,71
2020,184782,10,6,45,17,28
2020,184782,20,0,274,164,110
2020,184782,20,1,133,87,46
2020,184782,20,2,113,64,49
2020,184782,20,3,18,10,8
2020,184782,20,4,10,3,7
2020,184782,30,0,229,120,109
2020,184782,30,1,7,4,3
2020,184782,30,2,35,18,17
2020,184782,30,3,177,92,85
2020,184782,30,4,5,3,2
2020,184782,30,5,2,2,0
2020,184782,30,6,3,1,2
2020,184782,40,0,323,141,182
2020,184782,40,1,10,7,3
2020,184782,40,2,27,10,17
2020,184782,40,3,78,39,39
2020,184782,40,4,41,15,26
2020,184782,40,5,125,54,71
2020,184782,40,6,42,16,26
2020,184782,41,0,130,57,73
2020,184782,41,2,2,1,1
2020,184782,41,3,3,2,1
2020,184782,41,5,125,54,71
2020,184782,42,0,181,79,102
2020,184782,42,1,8,6,2
2020,184782,42,2,22,8,14
2020,184782,42,3,69,35,34
2020,184782,42,4,40,14,26
2020,184782,42,6,42,16,26
2020,184782,43,0,12,5,7
2020,184782,43,1,2,1,1
2020,184782,43,2,3,1,2
2020,184782,43,3,6,2,4
2020,184782,43,4,1,1,0
2020,184782,44,0,130,57,73
2020,184782,44,2,2,1,1
2020,184782,44,3,3,2,1
2020,184782,44,5,125,54,71
2020,184791,0,0,80,26,54
2020,184791,10,0,78,24,54
2020,184791,10,1,9,2,7
2020,184791,10,2,13,5,8
2020,184791,10,3,28,13,15
2020,184791,10,4,28,4,24
2020,184791,20,0,49,20,29
2020,184791,20,1,9,2,7
2020,184791,20,2,13,5,8
2020,184791,20,3,27,13,14
2020,184791,30,0,29,4,25
2020,184791,30,3,1,0,1
2020,184791,30,4,28,4,24
2020,184791,50,0,2,2,0
2020,184959,0,0,8,6,2
2020,184959,10,0,8,6,2
2020,184959,10,1,3,3,0
2020,184959,10,2,1,1,0
2020,184959,10,4,4,2,2
2020,184959,40,0,8,6,2
2020,184959,40,1,3,3,0
2020,184959,40,2,1,1,0
2020,184959,40,4,4,2,2
2020,184959,41,0,8,6,2
2020,184959,41,1,3,3,0
2020,184959,41,2,1,1,0
2020,184959,41,4,4,2,2
2020,184959,45,0,8,6,2
2020,184959,45,1,3,3,0
2020,184959,45,2,1,1,0
2020,184959,45,4,4,2,2
2020,184995,0,0,103,48,55
2020,184995,10,0,103,48,55
2020,184995,10,1,16,10,6
2020,184995,10,2,13,5,8
2020,184995,10,3,33,16,17
2020,184995,10,4,28,13,15
2020,184995,10,5,13,4,9
2020,184995,20,0,62,31,31
2020,184995,20,1,16,10,6
2020,184995,20,2,13,5,8
2020,184995,20,3,33,16,17
2020,184995,30,0,17,8,9
2020,184995,30,4,17,8,9
2020,184995,40,0,24,9,15
2020,184995,40,4,11,5,6
2020,184995,40,5,13,4,9
2020,184995,42,0,24,9,15
2020,184995,42,4,11,5,6
2020,184995,42,5,13,4,9
2020,185129,0,0,240,126,114
2020,185129,10,0,240,126,114
2020,185129,10,1,79,39,40
2020,185129,10,2,87,48,39
2020,185129,10,3,74,39,35
2020,185129,20,0,167,83,84
2020,185129,20,1,77,37,40
2020,185129,20,2,73,42,31
2020,185129,20,3,17,4,13
2020,185129,30,0,68,38,30
2020,185129,30,1,2,2,0
2020,185129,30,2,13,5,8
2020,185129,30,3,53,31,22
2020,185129,40,0,5,5,0
2020,185129,40,2,1,1,0
2020,185129,40,3,4,4,0
2020,185129,41,0,5,5,0
2020,185129,41,2,1,1,0
2020,185129,41,3,4,4,0
2020,185129,45,0,5,5,0
2020,185129,45,2,1,1,0
2020,185129,45,3,4,4,0
2020,185262,0,0,327,140,187
2020,185262,10,0,327,140,187
2020,185262,10,1,47,22,25
2020,185262,10,2,63,30,33
2020,185262,10,3,89,45,44
2020,185262,10,5,128,43,85
2020,185262,20,0,158,74,84
2020,185262,20,1,47,22,25
2020,185262,20,2,62,30,32
2020,185262,20,3,49,22,27
2020,185262,30,0,41,23,18
2020,185262,30,2,1,0,1
2020,185262,30,3,40,23,17
2020,185262,40,0,128,43,85
2020,185262,40,5,128,43,85
2020,185262,42,0,128,43,85
2020,185262,42,5,128,43,85
2020,185509,0,0,101,49,52
2020,185509,10,0,101,49,52
2020,185509,10,1,60,31,29
2020,185509,10,2,15,3,12
2020,185509,10,3,24,15,9
2020,185509,10,4,2,0,2
2020,185509,20,0,81,40,41
2020,185509,20,1,60,31,29
2020,185509,20,2,14,3,11
2020,185509,20,3,7,6,1
2020,185509,30,0,20,9,11
2020,185509,30,2,1,0,1
2020,185509,30,3,17,9,8
2020,185509,30,4,2,0,2
2020,185536,0,0,141,68,73
2020,185536,10,0,141,68,73
2020,185536,10,1,41,20,21
2020,185536,10,2,32,12,20
2020,185536,10,3,37,18,19
2020,185536,10,4,31,18,13
2020,185536,20,0,110,50,60
2020,185536,20,1,41,20,21
2020,185536,20,2,32,12,20
2020,185536,20,3,37,18,19
2020,185536,30,0,28,17,11
2020,185536,30,4,28,17,11
2020,185536,40,0,3,1,2
2020,185536,40,4,3,1,2
2020,185536,42,0,2,0,2
2020,185536,42,4,2,0,2
2020,185536,43,0,1,1,0
2020,185536,43,4,1,1,0
2020,185572,0,0,311,139,172
2020,185572,10,0,311,139,172
2020,185572,10,1,40,22,18
2020,185572,10,2,100,46,54
2020,185572,10,3,70,33,37
2020,185572,10,4,11,7,4
2020,185572,10,5,90,31,59
2020,185572,20,0,140,68,72
2020,185572,20,1,40,22,18
2020,185572,20,2,100,46,54
2020,185572,30,0,70,33,37
2020,185572,30,3,70,33,37
2020,185572,40,0,101,38,63
2020,185572,40,4,11,7,4
2020,185572,40,5,90,31,59
2020,185572,41,0,90,31,59
2020,185572,41,5,90,31,59
2020,185572,42,0,11,7,4
2020,185572,42,4,11,7,4
2020,185572,44,0,90,31,59
2020,185572,44,5,90,31,59
2020,185590,0,0,619,313,306
2020,185590,10,0,619,313,306
2020,185590,10,1,202,103,99
2020,185590,10,2,214,116,98
2020,185590,10,3,130,64,66
2020,185590,10,6,73,30,43
2020,185590,20,0,420,220,200
2020,185590,20,1,200,102,98
2020,185590,20,2,205,111,94
2020,185590,20,3,15,7,8
2020,185590,30,0,120,58,62
2020,185590,30,1,2,1,1
2020,185590,30,2,9,5,4
2020,185590,30,3,109,52,57
2020,185590,40,0,79,35,44
2020,185590,40,3,6,5,1
2020,185590,40,6,73,30,43
2020,185590,41,0,73,30,43
2020,185590,41,6,73,30,43
2020,185590,42,0,6,5,1
2020,185590,42,3,6,5,1
2020,185590,44,0,73,30,43
2020,185590,44,6,73,30,43
2020,185721,0,0,7,3,4
2020,185721,10,0,7,3,4
2020,185721,10,4,7,3,4
2020,185721,40,0,7,3,4
2020,185721,40,4,7,3,4
2020,185721,41,0,7,3,4
2020,185721,41,4,7,3,4
2020,185721,45,0,7,3,4
2020,185721,45,4,7,3,4
2020,185758,0,0,8,5,3
2020,185758,10,0,8,5,3
2020,185758,10,1,1,0,1
2020,185758,10,2,4,3,1
2020,185758,10,3,3,2,1
2020,185758,20,0,4,2,2
2020,185758,20,1,1,0,1
2020,185758,20,2,3,2,1
2020,185758,30,0,3,2,1
2020,185758,30,3,3,2,1
2020,185758,40,0,1,1,0
2020,185758,40,2,1,1,0
2020,185758,42,0,1,1,0
2020,185758,42,2,1,1,0
2020,185828,0,0,469,349,120
2020,185828,10,0,444,334,110
2020,185828,10,1,135,118,17
2020,185828,10,2,98,75,23
2020,185828,10,3,81,53,28
2020,185828,10,4,1,0,1
2020,185828,10,5,129,88,41
2020,185828,20,0,224,185,39
2020,185828,20,1,134,117,17
2020,185828,20,2,90,68,22
2020,185828,30,0,89,60,29
2020,185828,30,1,1,1,0
2020,185828,30,2,8,7,1
2020,185828,30,3,80,52,28
2020,185828,40,0,131,89,42
2020,185828,40,3,1,1,0
2020,185828,40,4,1,0,1
2020,185828,40,5,129,88,41
2020,185828,41,0,46,29,17
2020,185828,41,5,46,29,17
2020,185828,42,0,85,60,25
2020,185828,42,3,1,1,0
2020,185828,42,4,1,0,1
2020,185828,42,5,83,59,24
2020,185828,44,0,46,29,17
2020,185828,44,5,46,29,17
2020,185828,50,0,25,15,10
2020,185873,0,0,113,50,63
2020,185873,10,0,40,17,23
2020,185873,10,1,11,3,8
2020,185873,10,2,11,6,5
2020,185873,10,3,11,4,7
2020,185873,10,4,7,4,3
2020,185873,20,0,39,17,22
2020,185873,20,1,11,3,8
2020,185873,20,2,11,6,5
2020,185873,20,3,11,4,7
2020,185873,20,4,6,4,2
2020,185873,30,0,1,0,1
2020,185873,30,4,1,0,1
2020,185873,50,0,73,33,40
2020,186034,0,0,81,31,50
2020,186034,10,0,81,31,50
2020,186034,10,1,13,8,5
2020,186034,10,2,24,7,17
2020,186034,10,3,31,13,18
2020,186034,10,4,13,3,10
2020,186034,20,0,68,28,40
2020,186034,20,1,13,8,5
2020,186034,20,2,24,7,17
2020,186034,20,3,31,13,18
2020,186034,30,0,13,3,10
2020,186034,30,4,13,3,10
2020,186122,0,0,51,36,15
2020,186122,10,0,50,36,14
2020,186122,10,1,22,17,5
2020,186122,10,2,14,7,7
2020,186122,10,3,5,4,1
2020,186122,10,4,8,8,0
2020,186122,10,5,1,0,1
2020,186122,20,0,36,24,12
2020,186122,20,1,22,17,5
2020,186122,20,2,14,7,7
2020,186122,30,0,3,2,1
2020,186122,30,3,3,2,1
2020,186122,40,0,11,10,1
2020,186122,40,3,2,2,0
2020,186122,40,4,8,8,0
2020,186122,40,5,1,0,1
2020,186122,41,0,3,2,1
2020,186122,41,3,2,2,0
2020,186122,41,5,1,0,1
2020,186122,43,0,8,8,0
2020,186122,43,4,8,8,0
2020,186122,44,0,3,2,1
2020,186122,44,3,2,2,0
2020,186122,44,5,1,0,1
2020,186122,50,0,1,0,1
2020,186131,0,0,997,634,363
2020,186131,10,0,997,634,363
2020,186131,10,1,495,365,130
2020,186131,10,2,123,72,51
2020,186131,10,3,181,107,74
2020,186131,10,4,18,16,2
2020,186131,10,5,180,74,106
2020,186131,20,0,618,437,181
2020,186131,20,1,495,365,130
2020,186131,20,2,123,72,51
2020,186131,30,0,181,107,74
2020,186131,30,3,181,107,74
2020,186131,40,0,198,90,108
2020,186131,40,4,18,16,2
2020,186131,40,5,180,74,106
2020,186131,41,0,65,30,35
2020,186131,41,4,3,2,1
2020,186131,41,5,62,28,34
2020,186131,42,0,133,60,73
2020,186131,42,4,15,14,1
2020,186131,42,5,118,46,72
2020,186131,44,0,65,30,35
2020,186131,44,4,3,2,1
2020,186131,44,5,62,28,34
2020,186186,0,0,18,18,0
2020,186186,10,0,18,18,0
2020,186186,10,4,18,18,0
2020,186186,40,0,18,18,0
2020,186186,40,4,18,18,0
2020,186186,42,0,18,18,0
2020,186186,42,4,18,18,0
2020,186201,0,0,215,101,114
2020,186201,10,0,215,101,114
2020,186201,10,1,67,34,33
2020,186201,10,2,91,41,50
2020,186201,10,3,56,26,30
2020,186201,10,4,1,0,1
2020,186201,20,0,168,79,89
2020,186201,20,1,67,34,33
2020,186201,20,2,88,39,49
2020,186201,20,3,13,6,7
2020,186201,30,0,37,17,20
2020,186201,30,2,3,2,1
2020,186201,30,3,34,15,19
2020,186201,40,0,10,5,5
2020,186201,40,3,9,5,4
2020,186201,40,4,1,0,1
2020,186201,43,0,10,5,5
2020,186201,43,3,9,5,4
2020,186201,43,4,1,0,1
2020,186283,0,0,194,98,96
2020,186283,10,0,194,98,96
2020,186283,10,1,73,44,29
2020,186283,10,2,79,37,42
2020,186283,10,3,35,14,21
2020,186283,10,5,7,3,4
2020,186283,20,0,142,78,64
2020,186283,20,1,70,44,26
2020,186283,20,2,71,34,37
2020,186283,20,3,1,0,1
2020,186283,30,0,41,16,25
2020,186283,30,1,2,0,2
2020,186283,30,2,8,3,5
2020,186283,30,3,30,12,18
2020,186283,30,5,1,1,0
2020,186283,40,0,11,4,7
2020,186283,40,1,1,0,1
2020,186283,40,3,4,2,2
2020,186283,40,5,6,2,4
2020,186283,41,0,6,2,4
2020,186283,41,3,1,0,1
2020,186283,41,5,5,2,3
2020,186283,42,0,3,1,2
2020,186283,42,1,1,0,1
2020,186283,42,3,2,1,1
2020,186283,43,0,2,1,1
2020,186283,43,3,1,1,0
2020,186283,43,5,1,0,1
2020,186283,44,0,4,1,3
2020,186283,44,3,1,0,1
2020,186283,44,5,3,1,2
2020,186283,45,0,2,1,1
2020,186283,45,5,2,1,1
2020,186371,0,0,310,163,147
2020,186371,10,0,310,163,147
2020,186371,10,1,108,67,41
2020,186371,10,2,94,52,42
2020,186371,10,3,99,37,62
2020,186371,10,4,8,6,2
2020,186371,10,5,1,1,0
2020,186371,20,0,174,109,65
2020,186371,20,1,96,65,31
2020,186371,20,2,78,44,34
2020,186371,30,0,61,22,39
2020,186371,30,1,1,0,1
2020,186371,30,2,4,3,1
2020,186371,30,3,56,19,37
2020,186371,40,0,75,32,43
2020,186371,40,1,11,2,9
2020,186371,40,2,12,5,7
2020,186371,40,3,43,18,25
2020,186371,40,4,8,6,2
2020,186371,40,5,1,1,0
2020,186371,41,0,75,32,43
2020,186371,41,1,11,2,9
2020,186371,41,2,12,5,7
2020,186371,41,3,43,18,25
2020,186371,41,4,8,6,2
2020,186371,41,5,1,1,0
2020,186371,44,0,75,32,43
2020,186371,44,1,11,2,9
2020,186371,44,2,12,5,7
2020,186371,44,3,43,18,25
2020,186371,44,4,8,6,2
2020,186371,44,5,1,1,0
2020,186380,0,0,3456,1863,1593
2020,186380,10,0,3456,1863,1593
2020,186380,10,1,1113,775,338
2020,186380,10,2,831,419,412
2020,186380,10,3,1215,562,653
2020,186380,10,4,241,92,149
2020,186380,10,5,56,15,41
2020,186380,20,0,1279,827,452
2020,186380,20,1,889,629,260
2020,186380,20,2,390,198,192
2020,186380,30,0,410,219,191
2020,186380,30,1,31,22,9
2020,186380,30,2,48,21,27
2020,186380,30,3,331,176,155
2020,186380,40,0,1767,817,950
2020,186380,40,1,193,124,69
2020,186380,40,2,393,200,193
2020,186380,40,3,884,386,498
2020,186380,40,4,241,92,149
2020,186380,40,5,56,15,41
2020,186380,41,0,1767,817,950
2020,186380,41,1,193,124,69
2020,186380,41,2,393,200,193
2020,186380,41,3,884,386,498
2020,186380,41,4,241,92,149
2020,186380,41,5,56,15,41
2020,186380,44,0,1767,817,950
2020,186380,44,1,193,124,69
2020,186380,44,2,393,200,193
2020,186380,44,3,884,386,498
2020,186380,44,4,241,92,149
2020,186380,44,5,56,15,41
2020,186399,0,0,587,353,234
2020,186399,10,0,587,353,234
2020,186399,10,1,209,141,68
2020,186399,10,2,151,90,61
2020,186399,10,3,194,112,82
2020,186399,10,4,29,9,20
2020,186399,10,5,4,1,3
2020,186399,20,0,304,201,103
2020,186399,20,1,186,131,55
2020,186399,20,2,118,70,48
2020,186399,30,0,105,56,49
2020,186399,30,1,4,1,3
2020,186399,30,2,5,3,2
2020,186399,30,3,96,52,44
2020,186399,40,0,178,96,82
2020,186399,40,1,19,9,10
2020,186399,40,2,28,17,11
2020,186399,40,3,98,60,38
2020,186399,40,4,29,9,20
2020,186399,40,5,4,1,3
2020,186399,41,0,178,96,82
2020,186399,41,1,19,9,10
2020,186399,41,2,28,17,11
2020,186399,41,3,98,60,38
2020,186399,41,4,29,9,20
2020,186399,41,5,4,1,3
2020,186399,44,0,178,96,82
2020,186399,44,1,19,9,10
2020,186399,44,2,28,17,11
2020,186399,44,3,98,60,38
2020,186399,44,4,29,9,20
2020,186399,44,5,4,1,3
2020,186432,0,0,109,52,57
2020,186432,10,0,109,52,57
2020,186432,10,1,28,16,12
2020,186432,10,2,34,17,17
2020,186432,10,3,32,13,19
2020,186432,10,4,7,3,4
2020,186432,10,5,6,3,3
2020,186432,10,6,2,0,2
2020,186432,20,0,66,35,31
2020,186432,20,1,28,16,12
2020,186432,20,2,32,15,17
2020,186432,20,3,5,4,1
2020,186432,20,5,1,0,1
2020,186432,30,0,25,10,15
2020,186432,30,2,2,2,0
2020,186432,30,3,22,8,14
2020,186432,30,4,1,0,1
2020,186432,40,0,18,7,11
2020,186432,40,3,5,1,4
2020,186432,40,4,6,3,3
2020,186432,40,5,5,3,2
2020,186432,40,6,2,0,2
2020,186432,42,0,18,7,11
2020,186432,42,3,5,1,4
2020,186432,42,4,6,3,3
2020,186432,42,5,5,3,2
2020,186432,42,6,2,0,2
2020,186469,0,0,14,5,9
2020,186469,10,0,14,5,9
2020,186469,10,2,7,3,4
2020,186469,10,3,4,1,3
2020,186469,10,4,2,0,2
2020,186469,10,6,1,1,0
2020,186469,20,0,10,4,6
2020,186469,20,2,6,3,3
2020,186469,20,3,4,1,3
2020,186469,30,0,3,0,3
2020,186469,30,2,1,0,1
2020,186469,30,4,2,0,2
2020,186469,40,0,1,1,0
2020,186469,40,6,1,1,0
2020,186469,42,0,1,1,0
2020,186469,42,6,1,1,0
2020,186584,0,0,465,236,229
2020,186584,10,0,465,236,229
2020,186584,10,1,117,69,48
2020,186584,10,2,141,76,65
2020,186584,10,3,86,30,56
2020,186584,10,4,23,2,21
2020,186584,10,5,17,9,8
2020,186584,10,6,81,50,31
2020,186584,20,0,217,125,92
2020,186584,20,1,111,65,46
2020,186584,20,2,105,59,46
2020,186584,20,3,1,1,0
2020,186584,30,0,58,26,32
2020,186584,30,1,1,1,0
2020,186584,30,2,8,4,4
2020,186584,30,3,49,21,28
2020,186584,40,0,190,85,105
2020,186584,40,1,5,3,2
2020,186584,40,2,28,13,15
2020,186584,40,3,36,8,28
2020,186584,40,4,23,2,21
2020,186584,40,5,17,9,8
2020,186584,40,6,81,50,31
2020,186584,41,0,89,40,49
2020,186584,41,1,5,3,2
2020,186584,41,2,19,10,9
2020,186584,41,3,25,7,18
2020,186584,41,4,11,2,9
2020,186584,41,6,29,18,11
2020,186584,42,0,101,45,56
2020,186584,42,2,9,3,6
2020,186584,42,3,11,1,10
2020,186584,42,4,12,0,12
2020,186584,42,5,17,9,8
2020,186584,42,6,52,32,20
2020,186584,44,0,29,18,11
2020,186584,44,6,29,18,11
2020,186584,45,0,60,22,38
2020,186584,45,1,5,3,2
2020,186584,45,2,19,10,9
2020,186584,45,3,25,7,18
2020,186584,45,4,11,2,9
2020,186618,0,0,58,12,46
2020,186618,10,0,58,12,46
2020,186618,10,1,15,6,9
2020,186618,10,2,8,2,6
2020,186618,10,3,29,4,25
2020,186618,10,4,6,0,6
2020,186618,20,0,19,6,13
2020,186618,20,1,15,6,9
2020,186618,20,2,4,0,4
2020,186618,30,0,4,1,3
2020,186618,30,2,2,1,1
2020,186618,30,3,2,0,2
2020,186618,40,0,35,5,30
2020,186618,40,2,2,1,1
2020,186618,40,3,27,4,23
2020,186618,40,4,6,0,6
2020,186618,42,0,35,5,30
2020,186618,42,2,2,1,1
2020,186618,42,3,27,4,23
2020,186618,42,4,6,0,6
2020,186645,0,0,123,53,70
2020,186645,10,0,123,53,70
2020,186645,10,1,40,16,24
2020,186645,10,2,35,13,22
2020,186645,10,3,34,17,17
2020,186645,10,4,14,7,7
2020,186645,20,0,97,41,56
2020,186645,20,1,40,16,24
2020,186645,20,2,35,13,22
2020,186645,20,3,19,11,8
2020,186645,20,4,3,1,2
2020,186645,30,0,23,10,13
2020,186645,30,3,15,6,9
2020,186645,30,4,8,4,4
2020,186645,40,0,3,2,1
2020,186645,40,4,3,2,1
2020,186645,42,0,3,2,1
2020,186645,42,4,3,2,1
2020,186867,0,0,298,211,87
2020,186867,10,0,298,211,87
2020,186867,10,1,72,63,9
2020,186867,10,2,100,70,30
2020,186867,10,3,106,66,40
2020,186867,10,5,20,12,8
2020,186867,20,0,98,75,23
2020,186867,20,1,47,43,4
2020,186867,20,2,51,32,19
2020,186867,30,0,97,63,34
2020,186867,30,1,1,1,0
2020,186867,30,2,9,7,2
2020,186867,30,3,87,55,32
2020,186867,40,0,103,73,30
2020,186867,40,1,24,19,5
2020,186867,40,2,40,31,9
2020,186867,40,3,19,11,8
2020,186867,40,5,20,12,8
2020,186867,41,0,103,73,30
2020,186867,41,1,24,19,5
2020,186867,41,2,40,31,9
2020,186867,41,3,19,11,8
2020,186867,41,5,20,12,8
2020,186867,44,0,103,73,30
2020,186867,44,1,24,19,5
2020,186867,44,2,40,31,9
2020,186867,44,3,19,11,8
2020,186867,44,5,20,12,8
2020,186876,0,0,335,150,185
2020,186876,10,0,335,150,185
2020,186876,10,1,86,39,47
2020,186876,10,2,122,55,67
2020,186876,10,3,109,49,60
2020,186876,10,4,10,5,5
2020,186876,10,6,8,2,6
2020,186876,20,0,213,98,115
2020,186876,20,1,86,39,47
2020,186876,20,2,119,53,66
2020,186876,20,3,6,4,2
2020,186876,20,4,2,2,0
2020,186876,30,0,107,46,61
2020,186876,30,2,3,2,1
2020,186876,30,3,98,42,56
2020,186876,30,4,6,2,4
2020,186876,40,0,15,6,9
2020,186876,40,3,5,3,2
2020,186876,40,4,2,1,1
2020,186876,40,6,8,2,6
2020,186876,42,0,15,6,9
2020,186876,42,3,5,3,2
2020,186876,42,4,2,1,1
2020,186876,42,6,8,2,6
2020,187134,0,0,375,174,201
2020,187134,10,0,375,174,201
2020,187134,10,1,146,67,79
2020,187134,10,2,135,62,73
2020,187134,10,3,91,44,47
2020,187134,10,5,3,1,2
2020,187134,20,0,258,117,141
2020,187134,20,1,145,67,78
2020,187134,20,2,102,46,56
2020,187134,20,3,11,4,7
2020,187134,30,0,94,44,50
2020,187134,30,1,1,0,1
2020,187134,30,2,32,15,17
2020,187134,30,3,61,29,32
2020,187134,40,0,23,13,10
2020,187134,40,2,1,1,0
2020,187134,40,3,19,11,8
2020,187134,40,5,3,1,2
2020,187134,42,0,23,13,10
2020,187134,42,2,1,1,0
2020,187134,42,3,19,11,8
2020,187134,42,5,3,1,2
2020,187198,0,0,89,36,53
2020,187198,10,0,89,36,53
2020,187198,10,1,40,20,20
2020,187198,10,2,35,10,25
2020,187198,10,3,14,6,8
2020,187198,20,0,89,36,53
2020,187198,20,1,40,20,20
2020,187198,20,2,35,10,25
2020,187198,20,3,14,6,8
2020,187444,0,0,377,180,197
2020,187444,10,0,377,180,197
2020,187444,10,1,203,110,93
2020,187444,10,2,90,33,57
2020,187444,10,3,77,33,44
2020,187444,10,4,7,4,3
2020,187444,20,0,294,142,152
2020,187444,20,1,202,109,93
2020,187444,20,2,86,31,55
2020,187444,20,3,6,2,4
2020,187444,30,0,70,31,39
2020,187444,30,1,1,1,0
2020,187444,30,2,4,2,2
2020,187444,30,3,65,28,37
2020,187444,40,0,13,7,6
2020,187444,40,3,6,3,3
2020,187444,40,4,7,4,3
2020,187444,42,0,13,7,6
2020,187444,42,3,6,3,3
2020,187444,42,4,7,4,3
2020,187532,0,0,315,126,189
2020,187532,10,0,315,126,189
2020,187532,10,4,315,126,189
2020,187532,40,0,315,126,189
2020,187532,40,4,315,126,189
2020,187532,42,0,158,56,102
2020,187532,42,4,158,56,102
2020,187532,43,0,157,70,87
2020,187532,43,4,157,70,87
2020,187596,0,0,89,56,33
2020,187596,10,0,82,52,30
2020,187596,10,1,3,2,1
2020,187596,10,2,17,12,5
2020,187596,10,3,35,17,18
2020,187596,10,4,20,15,5
2020,187596,10,5,7,6,1
2020,187596,40,0,82,52,30
2020,187596,40,1,3,2,1
2020,187596,40,2,17,12,5
2020,187596,40,3,35,17,18
2020,187596,40,4,20,15,5
2020,187596,40,5,7,6,1
2020,187596,42,0,5,1,4
2020,187596,42,1,1,0,1
2020,187596,42,2,1,0,1
2020,187596,42,3,2,0,2
2020,187596,42,4,1,1,0
2020,187596,43,0,77,51,26
2020,187596,43,1,2,2,0
2020,187596,43,2,16,12,4
2020,187596,43,3,33,17,16
2020,187596,43,4,19,14,5
2020,187596,43,5,7,6,1
2020,187596,50,0,7,4,3
2020,187620,0,0,125,62,63
2020,187620,10,0,125,62,63
2020,187620,10,1,35,16,19
2020,187620,10,2,27,14,13
2020,187620,10,3,34,13,21
2020,187620,10,4,29,19,10
2020,187620,20,0,72,35,37
2020,187620,20,1,35,16,19
2020,187620,20,2,25,12,13
2020,187620,20,3,12,7,5
2020,187620,30,0,48,24,24
2020,187620,30,2,1,1,0
2020,187620,30,3,22,6,16
2020,187620,30,4,25,17,8
2020,187620,40,0,5,3,2
2020,187620,40,2,1,1,0
2020,187620,40,4,4,2,2
2020,187620,41,0,2,1,1
2020,187620,41,4,2,1,1
2020,187620,42,0,3,2,1
2020,187620,42,2,1,1,0
2020,187620,42,4,2,1,1
2020,187620,44,0,2,1,1
2020,187620,44,4,2,1,1
2020,187639,0,0,53,16,37
2020,187639,10,0,53,16,37
2020,187639,10,4,53,16,37
2020,187639,40,0,53,16,37
2020,187639,40,4,53,16,37
2020,187639,42,0,53,16,37
2020,187639,42,4,53,16,37
2020,187648,0,0,164,87,77
2020,187648,10,0,164,87,77
2020,187648,10,1,31,20,11
2020,187648,10,2,23,12,11
2020,187648,10,3,66,40,26
2020,187648,10,4,44,15,29
2020,187648,20,0,55,33,22
2020,187648,20,1,30,19,11
2020,187648,20,2,22,12,10
2020,187648,20,4,3,2,1
2020,187648,30,0,67,40,27
2020,187648,30,2,1,0,1
2020,187648,30,3,65,40,25
2020,187648,30,4,1,0,1
2020,187648,40,0,42,14,28
2020,187648,40,1,1,1,0
2020,187648,40,3,1,0,1
2020,187648,40,4,40,13,27
2020,187648,41,0,1,1,0
2020,187648,41,1,1,1,0
2020,187648,42,0,41,13,28
2020,187648,42,3,1,0,1
2020,187648,42,4,40,13,27
2020,187648,44,0,1,1,0
2020,187648,44,1,1,1,0
2020,187666,0,0,45,24,21
2020,187666,10,0,45,24,21
2020,187666,10,4,45,24,21
2020,187666,20,0,26,16,10
2020,187666,20,4,26,16,10
2020,187666,30,0,19,8,11
2020,187666,30,4,19,8,11
2020,187745,0,0,27,15,12
2020,187745,10,0,27,15,12
2020,187745,10,2,5,3,2
2020,187745,10,3,22,12,10
2020,187745,40,0,27,15,12
2020,187745,40,2,5,3,2
2020,187745,40,3,22,12,10
2020,187745,41,0,27,15,12
2020,187745,41,2,5,3,2
2020,187745,41,3,22,12,10
2020,187745,44,0,27,15,12
2020,187745,44,2,5,3,2
2020,187745,44,3,22,12,10
2020,187897,0,0,126,63,63
2020,187897,10,0,126,63,63
2020,187897,10,1,25,13,12
2020,187897,10,2,29,16,13
2020,187897,10,3,48,24,24
2020,187897,10,4,24,10,14
2020,187897,20,0,50,26,24
2020,187897,20,1,25,13,12
2020,187897,20,2,24,12,12
2020,187897,20,3,1,1,0
2020,187897,30,0,40,20,20
2020,187897,30,2,5,4,1
2020,187897,30,3,35,16,19
2020,187897,40,0,36,17,19
2020,187897,40,3,12,7,5
2020,187897,40,4,24,10,14
2020,187897,42,0,36,17,19
2020,187897,42,3,12,7,5
2020,187897,42,4,24,10,14
2020,187903,0,0,63,24,39
2020,187903,10,0,63,24,39
2020,187903,10,1,63,24,39
2020,187903,40,0,63,24,39
2020,187903,40,1,63,24,39
2020,187903,42,0,63,24,39
2020,187903,42,1,63,24,39
2020,187912,0,0,76,44,32
2020,187912,10,0,76,44,32
2020,187912,10,1,11,6,5
2020,187912,10,2,22,12,10
2020,187912,10,3,21,10,11
2020,187912,10,4,22,16,6
2020,187912,20,0,42,20,22
2020,187912,20,1,11,6,5
2020,187912,20,2,18,10,8
2020,187912,20,3,13,4,9
2020,187912,30,0,16,9,7
2020,187912,30,2,4,2,2
2020,187912,30,3,8,6,2
2020,187912,30,4,4,1,3
2020,187912,40,0,18,15,3
2020,187912,40,4,18,15,3
2020,187912,42,0,18,15,3
2020,187912,42,4,18,15,3
2020,187958,0,0,64,32,32
2020,187958,10,0,62,32,30
2020,187958,10,1,6,4,2
2020,187958,10,2,13,6,7
2020,187958,10,3,15,9,6
2020,187958,10,5,28,13,15
2020,187958,20,0,19,10,9
2020,187958,20,1,6,4,2
2020,187958,20,2,13,6,7
2020,187958,30,0,13,8,5
2020,187958,30,3,13,8,5
2020,187958,40,0,30,14,16
2020,187958,40,3,2,1,1
2020,187958,40,5,28,13,15
2020,187958,42,0,30,14,16
2020,187958,42,3,2,1,1
2020,187958,42,5,28,13,15
2020,187958,50,0,2,0,2
2020,187967,0,0,135,101,34
2020,187967,10,0,133,100,33
2020,187967,10,1,39,30,9
2020,187967,10,2,41,35,6
2020,187967,10,3,40,30,10
2020,187967,10,4,13,5,8
2020,187967,20,0,77,62,15
2020,187967,20,1,39,30,9
2020,187967,20,2,38,32,6
2020,187967,30,0,40,30,10
2020,187967,30,2,2,2,0
2020,187967,30,3,38,28,10
2020,187967,40,0,16,8,8
2020,187967,40,2,1,1,0
2020,187967,40,3,2,2,0
2020,187967,40,4,13,5,8
2020,187967,41,0,16,8,8
2020,187967,41,2,1,1,0
2020,187967,41,3,2,2,0
2020,187967,41,4,13,5,8
2020,187967,45,0,16,8,8
2020,187967,45,2,1,1,0
2020,187967,45,3,2,2,0
2020,187967,45,4,13,5,8
2020,187967,50,0,2,1,1
2020,187976,0,0,4,3,1
2020,187976,10,0,4,3,1
2020,187976,10,5,4,3,1
2020,187976,40,0,4,3,1
2020,187976,40,5,4,3,1
2020,187976,42,0,4,3,1
2020,187976,42,5,4,3,1
2020,187985,0,0,1935,958,977
2020,187985,10,0,1935,958,977
2020,187985,10,1,481,290,191
2020,187985,10,2,534,264,270
2020,187985,10,3,641,302,339
2020,187985,10,4,48,17,31
2020,187985,10,5,209,72,137
2020,187985,10,6,22,13,9
2020,187985,20,0,652,372,280
2020,187985,20,1,343,211,132
2020,187985,20,2,308,160,148
2020,187985,20,3,1,1,0
2020,187985,30,0,268,132,136
2020,187985,30,1,6,5,1
2020,187985,30,2,16,8,8
2020,187985,30,3,245,118,127
2020,187985,30,6,1,1,0
2020,187985,40,0,1015,454,561
2020,187985,40,1,132,74,58
2020,187985,40,2,210,96,114
2020,187985,40,3,395,183,212
2020,187985,40,4,48,17,31
2020,187985,40,5,209,72,137
2020,187985,40,6,21,12,9
2020,187985,42,0,1015,454,561
2020,187985,42,1,132,74,58
2020,187985,42,2,210,96,114
2020,187985,42,3,395,183,212
2020,187985,42,4,48,17,31
2020,187985,42,5,209,72,137
2020,187985,42,6,21,12,9
2020,187994,0,0,31,14,17
2020,187994,10,0,31,14,17
2020,187994,10,1,19,8,11
2020,187994,10,2,6,2,4
2020,187994,10,3,4,2,2
2020,187994,10,4,1,1,0
2020,187994,10,6,1,1,0
2020,187994,20,0,20,9,11
2020,187994,20,1,16,7,9
2020,187994,20,2,3,2,1
2020,187994,20,3,1,0,1
2020,187994,30,0,2,1,1
2020,187994,30,2,1,0,1
2020,187994,30,3,1,1,0
2020,187994,40,0,9,4,5
2020,187994,40,1,3,1,2
2020,187994,40,2,2,0,2
2020,187994,40,3,2,1,1
2020,187994,40,4,1,1,0
2020,187994,40,6,1,1,0
2020,187994,41,0,1,1,0
2020,187994,41,6,1,1,0
2020,187994,42,0,8,3,5
2020,187994,42,1,3,1,2
2020,187994,42,2,2,0,2
2020,187994,42,3,2,1,1
2020,187994,42,4,1,1,0
2020,187994,44,0,1,1,0
2020,187994,44,6,1,1,0
2020,188003,0,0,32,17,15
2020,188003,10,0,32,17,15
2020,188003,10,1,10,8,2
2020,188003,10,2,4,2,2
2020,188003,10,3,7,3,4
2020,188003,10,4,11,4,7
2020,188003,20,0,13,9,4
2020,188003,20,1,10,8,2
2020,188003,20,2,2,0,2
2020,188003,20,3,1,1,0
2020,188003,30,0,10,3,7
2020,188003,30,2,2,2,0
2020,188003,30,3,4,1,3
2020,188003,30,4,4,0,4
2020,188003,40,0,9,5,4
2020,188003,40,3,2,1,1
2020,188003,40,4,7,4,3
2020,188003,42,0,9,5,4
2020,188003,42,3,2,1,1
2020,188003,42,4,7,4,3
2020,188021,0,0,13,6,7
2020,188021,10,0,13,6,7
2020,188021,10,1,3,1,2
2020,188021,10,2,5,3,2
2020,188021,10,3,1,0,1
2020,188021,10,4,3,1,2
2020,188021,10,6,1,1,0
2020,188021,20,0,7,4,3
2020,188021,20,1,3,1,2
2020,188021,20,2,4,3,1
2020,188021,30,0,1,0,1
2020,188021,30,3,1,0,1
2020,188021,40,0,5,2,3
2020,188021,40,2,1,0,1
2020,188021,40,4,3,1,2
2020,188021,40,6,1,1,0
2020,188021,41,0,1,1,0
2020,188021,41,6,1,1,0
2020,188021,42,0,4,1,3
2020,188021,42,2,1,0,1
2020,188021,42,4,3,1,2
2020,188021,44,0,1,1,0
2020,188021,44,6,1,1,0
2020,188030,0,0,637,354,283
2020,188030,10,0,637,354,283
2020,188030,10,1,206,141,65
2020,188030,10,2,180,92,88
2020,188030,10,3,226,109,117
2020,188030,10,4,4,2,2
2020,188030,10,6,21,10,11
2020,188030,20,0,332,215,117
2020,188030,20,1,182,129,53
2020,188030,20,2,147,85,62
2020,188030,20,3,3,1,2
2020,188030,30,0,168,90,78
2020,188030,30,2,4,2,2
2020,188030,30,3,164,88,76
2020,188030,40,0,137,49,88
2020,188030,40,1,24,12,12
2020,188030,40,2,29,5,24
2020,188030,40,3,59,20,39
2020,188030,40,4,4,2,2
2020,188030,40,6,21,10,11
2020,188030,41,0,22,10,12
2020,188030,41,3,1,0,1
2020,188030,41,6,21,10,11
2020,188030,42,0,115,39,76
2020,188030,42,1,24,12,12
2020,188030,42,2,29,5,24
2020,188030,42,3,58,20,38
2020,188030,42,4,4,2,2
2020,188030,44,0,22,10,12
2020,188030,44,3,1,0,1
2020,188030,44,6,21,10,11
2020,188049,0,0,38,15,23
2020,188049,10,0,38,15,23
2020,188049,10,1,2,0,2
2020,188049,10,2,5,1,4
2020,188049,10,3,15,8,7
2020,188049,10,4,1,0,1
2020,188049,10,5,15,6,9
2020,188049,20,0,7,1,6
2020,188049,20,1,2,0,2
2020,188049,20,2,5,1,4
2020,188049,30,0,15,8,7
2020,188049,30,3,15,8,7
2020,188049,40,0,16,6,10
2020,188049,40,4,1,0,1
2020,188049,40,5,15,6,9
2020,188049,42,0,16,6,10
2020,188049,42,4,1,0,1
2020,188049,42,5,15,6,9
2020,188058,0,0,47,17,30
2020,188058,10,0,47,17,30
2020,188058,10,2,19,7,12
2020,188058,10,3,17,6,11
2020,188058,10,4,11,4,7
2020,188058,20,0,19,7,12
2020,188058,20,2,19,7,12
2020,188058,30,0,17,6,11
2020,188058,30,3,17,6,11
2020,188058,40,0,11,4,7
2020,188058,40,4,11,4,7
2020,188058,43,0,11,4,7
2020,188058,43,4,11,4,7
2020,188100,0,0,151,73,78
2020,188100,10,0,151,73,78
2020,188100,10,1,24,14,10
2020,188100,10,2,24,8,16
2020,188100,10,3,64,33,31
2020,188100,10,4,39,18,21
2020,188100,40,0,151,73,78
2020,188100,40,1,24,14,10
2020,188100,40,2,24,8,16
2020,188100,40,3,64,33,31
2020,188100,40,4,39,18,21
2020,188100,42,0,151,73,78
2020,188100,42,1,24,14,10
2020,188100,42,2,24,8,16
2020,188100,42,3,64,33,31
2020,188100,42,4,39,18,21
2020,188137,0,0,67,36,31
2020,188137,10,0,67,36,31
2020,188137,10,1,2,1,1
2020,188137,10,2,10,6,4
2020,188137,10,3,55,29,26
2020,188137,40,0,67,36,31
2020,188137,40,1,2,1,1
2020,188137,40,2,10,6,4
2020,188137,40,3,55,29,26
2020,188137,41,0,54,32,22
2020,188137,41,1,2,1,1
2020,188137,41,2,8,5,3
2020,188137,41,3,44,26,18
2020,188137,42,0,13,4,9
2020,188137,42,2,2,1,1
2020,188137,42,3,11,3,8
2020,188137,45,0,54,32,22
2020,188137,45,1,2,1,1
2020,188137,45,2,8,5,3
2020,188137,45,3,44,26,18
2020,188182,0,0,32,13,19
2020,188182,10,0,32,13,19
2020,188182,10,1,2,1,1
2020,188182,10,2,6,2,4
2020,188182,10,3,17,8,9
2020,188182,10,4,6,1,5
2020,188182,10,5,1,1,0
2020,188182,40,0,32,13,19
2020,188182,40,1,2,1,1
2020,188182,40,2,6,2,4
2020,188182,40,3,17,8,9
2020,188182,40,4,6,1,5
2020,188182,40,5,1,1,0
2020,188182,42,0,32,13,19
2020,188182,42,1,2,1,1
2020,188182,42,2,6,2,4
2020,188182,42,3,17,8,9
2020,188182,42,4,6,1,5
2020,188182,42,5,1,1,0
2020,188207,0,0,5,0,5
2020,188207,10,0,5,0,5
2020,188207,10,4,5,0,5
2020,188207,40,0,5,0,5
2020,188207,40,4,5,0,5
2020,188207,41,0,5,0,5
2020,188207,41,4,5,0,5
2020,188207,45,0,5,0,5
2020,188207,45,4,5,0,5
2020,188216,0,0,18,12,6
2020,188216,10,0,17,11,6
2020,188216,10,4,17,11,6
2020,188216,40,0,17,11,6
2020,188216,40,4,17,11,6
2020,188216,41,0,17,11,6
2020,188216,41,4,17,11,6
2020,188216,45,0,17,11,6
2020,188216,45,4,17,11,6
2020,188216,50,0,1,1,0
2020,188225,0,0,23,8,15
2020,188225,10,0,23,8,15
2020,188225,10,2,4,3,1
2020,188225,10,3,2,1,1
2020,188225,10,4,5,3,2
2020,188225,10,5,12,1,11
2020,188225,20,0,4,3,1
2020,188225,20,2,4,3,1
2020,188225,30,0,2,1,1
2020,188225,30,3,2,1,1
2020,188225,40,0,17,4,13
2020,188225,40,4,5,3,2
2020,188225,40,5,12,1,11
2020,188225,42,0,17,4,13
2020,188225,42,4,5,3,2
2020,188225,42,5,12,1,11
2020,188261,0,0,15,10,5
2020,188261,10,0,15,10,5
2020,188261,10,4,15,10,5
2020,188261,40,0,15,10,5
2020,188261,40,4,15,10,5
2020,188261,42,0,15,10,5
2020,188261,42,4,15,10,5
2020,188304,0,0,100,47,53
2020,188304,10,0,95,44,51
2020,188304,10,1,21,11,10
2020,188304,10,2,32,15,17
2020,188304,10,3,39,17,22
2020,188304,10,4,3,1,2
2020,188304,20,0,44,23,21
2020,188304,20,1,21,11,10
2020,188304,20,2,23,12,11
2020,188304,30,0,47,21,26
2020,188304,30,2,9,3,6
2020,188304,30,3,35,17,18
2020,188304,30,4,3,1,2
2020,188304,40,0,4,0,4
2020,188304,40,3,4,0,4
2020,188304,42,0,4,0,4
2020,188304,42,3,4,0,4
2020,188304,50,0,5,3,2
2020,188340,0,0,36,26,10
2020,188340,10,0,36,26,10
2020,188340,10,1,8,5,3
2020,188340,10,2,9,7,2
2020,188340,10,3,15,10,5
2020,188340,10,4,4,4,0
2020,188340,20,0,13,9,4
2020,188340,20,1,8,5,3
2020,188340,20,2,5,4,1
2020,188340,30,0,9,5,4
2020,188340,30,2,2,1,1
2020,188340,30,3,7,4,3
2020,188340,40,0,14,12,2
2020,188340,40,2,2,2,0
2020,188340,40,3,8,6,2
2020,188340,40,4,4,4,0
2020,188340,42,0,14,12,2
2020,188340,42,2,2,2,0
2020,188340,42,3,8,6,2
2020,188340,42,4,4,4,0
2020,188429,0,0,348,162,186
2020,188429,10,0,348,162,186
2020,188429,10,1,95,50,45
2020,188429,10,2,130,63,67
2020,188429,10,3,63,29,34
2020,188429,10,4,8,2,6
2020,188429,10,5,19,7,12
2020,188429,10,6,33,11,22
2020,188429,20,0,224,112,112
2020,188429,20,1,95,50,45
2020,188429,20,2,127,61,66
2020,188429,20,3,2,1,1
2020,188429,30,0,64,30,34
2020,188429,30,2,3,2,1
2020,188429,30,3,61,28,33
2020,188429,40,0,60,20,40
2020,188429,40,4,8,2,6
2020,188429,40,5,19,7,12
2020,188429,40,6,33,11,22
2020,188429,41,0,52,18,34
2020,188429,41,5,19,7,12
2020,188429,41,6,33,11,22
2020,188429,42,0,8,2,6
2020,188429,42,4,8,2,6
2020,188429,44,0,52,18,34
2020,188429,44,5,19,7,12
2020,188429,44,6,33,11,22
2020,188438,0,0,94,47,47
2020,188438,10,0,94,47,47
2020,188438,10,1,36,19,17
2020,188438,10,2,20,13,7
2020,188438,10,3,23,9,14
2020,188438,10,4,13,6,7
2020,188438,10,6,2,0,2
2020,188438,20,0,71,40,31
2020,188438,20,1,35,18,17
2020,188438,20,2,19,13,6
2020,188438,20,3,13,6,7
2020,188438,20,4,4,3,1
2020,188438,30,0,20,7,13
2020,188438,30,1,1,1,0
2020,188438,30,2,1,0,1
2020,188438,30,3,10,3,7
2020,188438,30,4,8,3,5
2020,188438,40,0,3,0,3
2020,188438,40,4,1,0,1
2020,188438,40,6,2,0,2
2020,188438,42,0,1,0,1
2020,188438,42,4,1,0,1
2020,188438,43,0,2,0,2
2020,188438,43,6,2,0,2
2020,188517,0,0,6,4,2
2020,188517,10,0,6,4,2
2020,188517,10,4,6,4,2
2020,188517,40,0,6,4,2
2020,188517,40,4,6,4,2
2020,188517,41,0,6,4,2
2020,188517,41,4,6,4,2
2020,188517,45,0,6,4,2
2020,188517,45,4,6,4,2
2020,188526,0,0,92,47,45
2020,188526,10,0,92,47,45
2020,188526,10,1,8,4,4
2020,188526,10,2,37,24,13
2020,188526,10,3,31,12,19
2020,188526,10,4,16,7,9
2020,188526,20,0,28,18,10
2020,188526,20,1,4,3,1
2020,188526,20,2,24,15,9
2020,188526,30,0,9,7,2
2020,188526,30,2,1,0,1
2020,188526,30,3,8,7,1
2020,188526,40,0,55,22,33
2020,188526,40,1,4,1,3
2020,188526,40,2,12,9,3
2020,188526,40,3,23,5,18
2020,188526,40,4,16,7,9
2020,188526,41,0,40,15,25
2020,188526,41,1,4,1,3
2020,188526,41,2,10,7,3
2020,188526,41,3,17,3,14
2020,188526,41,4,9,4,5
2020,188526,42,0,15,7,8
2020,188526,42,2,2,2,0
2020,188526,42,3,6,2,4
2020,188526,42,4,7,3,4
2020,188526,44,0,40,15,25
2020,188526,44,1,4,1,3
2020,188526,44,2,10,7,3
2020,188526,44,3,17,3,14
2020,188526,44,4,9,4,5
2020,188535,0,0,38,20,18
2020,188535,10,0,38,20,18
2020,188535,10,1,24,13,11
2020,188535,10,2,5,3,2
2020,188535,10,3,9,4,5
2020,188535,20,0,21,13,8
2020,188535,20,1,20,12,8
2020,188535,20,2,1,1,0
2020,188535,30,0,6,3,3
2020,188535,30,2,3,1,2
2020,188535,30,3,3,2,1
2020,188535,40,0,11,4,7
2020,188535,40,1,4,1,3
2020,188535,40,2,1,1,0
2020,188535,40,3,6,2,4
2020,188535,41,0,5,1,4
2020,188535,41,1,3,1,2
2020,188535,41,3,2,0,2
2020,188535,42,0,5,3,2
2020,188535,42,1,1,0,1
2020,188535,42,2,1,1,0
2020,188535,42,3,3,2,1
2020,188535,43,0,1,0,1
2020,188535,43,3,1,0,1
2020,188535,44,0,5,1,4
2020,188535,44,1,3,1,2
2020,188535,44,3,2,0,2
2020,188580,0,0,607,341,266
2020,188580,10,0,547,308,239
2020,188580,10,1,102,77,25
2020,188580,10,2,121,72,49
2020,188580,10,3,207,115,92
2020,188580,10,4,40,21,19
2020,188580,10,6,77,23,54
2020,188580,30,0,154,101,53
2020,188580,30,1,61,47,14
2020,188580,30,2,45,28,17
2020,188580,30,3,42,23,19
2020,188580,30,6,6,3,3
2020,188580,40,0,393,207,186
2020,188580,40,1,41,30,11
2020,188580,40,2,76,44,32
2020,188580,40,3,165,92,73
2020,188580,40,4,40,21,19
2020,188580,40,6,71,20,51
2020,188580,41,0,290,170,120
2020,188580,41,1,41,30,11
2020,188580,41,2,76,44,32
2020,188580,41,3,162,92,70
2020,188580,41,6,11,4,7
2020,188580,42,0,103,37,66
2020,188580,42,3,3,0,3
2020,188580,42,4,40,21,19
2020,188580,42,6,60,16,44
2020,188580,44,0,290,170,120
2020,188580,44,1,41,30,11
2020,188580,44,2,76,44,32
2020,188580,44,3,162,92,70
2020,188580,44,6,11,4,7
2020,188580,50,0,60,33,27
2020,188641,0,0,149,80,69
2020,188641,10,0,149,80,69
2020,188641,10,1,55,32,23
2020,188641,10,2,33,19,14
2020,188641,10,3,53,26,27
2020,188641,10,4,2,2,0
2020,188641,10,5,2,0,2
2020,188641,10,6,4,1,3
2020,188641,20,0,84,50,34
2020,188641,20,1,54,32,22
2020,188641,20,2,29,18,11
2020,188641,20,3,1,0,1
2020,188641,30,0,50,26,24
2020,188641,30,1,1,0,1
2020,188641,30,2,2,0,2
2020,188641,30,3,47,26,21
2020,188641,40,0,15,4,11
2020,188641,40,2,2,1,1
2020,188641,40,3,5,0,5
2020,188641,40,4,2,2,0
2020,188641,40,5,2,0,2
2020,188641,40,6,4,1,3
2020,188641,41,0,9,3,6
2020,188641,41,2,2,1,1
2020,188641,41,3,3,0,3
2020,188641,41,4,2,2,0
2020,188641,41,5,2,0,2
2020,188641,42,0,2,0,2
2020,188641,42,3,1,0,1
2020,188641,42,6,1,0,1
2020,188641,43,0,4,1,3
2020,188641,43,3,1,0,1
2020,188641,43,6,3,1,2
2020,188641,44,0,8,2,6
2020,188641,44,2,2,1,1
2020,188641,44,3,3,0,3
2020,188641,44,4,1,1,0
2020,188641,44,5,2,0,2
2020,188641,45,0,1,1,0
2020,188641,45,4,1,1,0
2020,188678,0,0,10,4,6
2020,188678,10,0,10,4,6
2020,188678,10,6,10,4,6
2020,188678,40,0,10,4,6
2020,188678,40,6,10,4,6
2020,188678,43,0,10,4,6
2020,188678,43,6,10,4,6
2020,188854,0,0,126,81,45
2020,188854,10,0,126,81,45
2020,188854,10,4,126,81,45
2020,188854,40,0,126,81,45
2020,188854,40,4,126,81,45
2020,188854,41,0,126,81,45
2020,188854,41,4,126,81,45
2020,188854,45,0,126,81,45
2020,188854,45,4,126,81,45
2020,189015,0,0,23,5,18
2020,189015,10,0,23,5,18
2020,189015,10,6,23,5,18
2020,189015,40,0,23,5,18
2020,189015,40,6,23,5,18
2020,189015,42,0,23,5,18
2020,189015,42,6,23,5,18
2020,189088,0,0,193,111,82
2020,189088,10,0,193,111,82
2020,189088,10,1,53,38,15
2020,189088,10,2,69,35,34
2020,189088,10,3,69,38,31
2020,189088,10,4,2,0,2
2020,189088,20,0,100,59,41
2020,189088,20,1,44,31,13
2020,189088,20,2,56,28,28
2020,189088,30,0,54,29,25
2020,189088,30,2,4,1,3
2020,189088,30,3,50,28,22
2020,189088,40,0,39,23,16
2020,189088,40,1,9,7,2
2020,189088,40,2,9,6,3
2020,189088,40,3,19,10,9
2020,189088,40,4,2,0,2
2020,189088,41,0,39,23,16
2020,189088,41,1,9,7,2
2020,189088,41,2,9,6,3
2020,189088,41,3,19,10,9
2020,189088,41,4,2,0,2
2020,189088,44,0,39,23,16
2020,189088,44,1,9,7,2
2020,189088,44,2,9,6,3
2020,189088,44,3,19,10,9
2020,189088,44,4,2,0,2
2020,189097,0,0,253,88,165
2020,189097,10,0,253,88,165
2020,189097,10,1,102,43,59
2020,189097,10,2,28,8,20
2020,189097,10,3,47,21,26
2020,189097,10,4,37,10,27
2020,189097,10,5,39,6,33
2020,189097,20,0,117,49,68
2020,189097,20,1,95,41,54
2020,189097,20,2,22,8,14
2020,189097,30,0,45,20,25
2020,189097,30,3,45,20,25
2020,189097,40,0,91,19,72
2020,189097,40,1,7,2,5
2020,189097,40,2,6,0,6
2020,189097,40,3,2,1,1
2020,189097,40,4,37,10,27
2020,189097,40,5,39,6,33
2020,189097,41,0,69,15,54
2020,189097,41,1,7,2,5
2020,189097,41,2,4,0,4
2020,189097,41,3,2,1,1
2020,189097,41,4,20,6,14
2020,189097,41,5,36,6,30
2020,189097,42,0,22,4,18
2020,189097,42,2,2,0,2
2020,189097,42,4,17,4,13
2020,189097,42,5,3,0,3
2020,189097,44,0,68,15,53
2020,189097,44,1,7,2,5
2020,189097,44,2,4,0,4
2020,189097,44,3,2,1,1
2020,189097,44,4,19,6,13
2020,189097,44,5,36,6,30
2020,189097,45,0,1,0,1
2020,189097,45,4,1,0,1
2020,189228,0,0,48,23,25
2020,189228,10,0,48,23,25
2020,189228,10,6,48,23,25
2020,189228,40,0,48,23,25
2020,189228,40,6,48,23,25
2020,189228,42,0,48,23,25
2020,189228,42,6,48,23,25
2020,189282,0,0,6,1,5
2020,189282,10,0,6,1,5
2020,189282,10,1,1,0,1
2020,189282,10,2,1,0,1
2020,189282,10,3,4,1,3
2020,189282,40,0,6,1,5
2020,189282,40,1,1,0,1
2020,189282,40,2,1,0,1
2020,189282,40,3,4,1,3
2020,189282,41,0,6,1,5
2020,189282,41,1,1,0,1
2020,189282,41,2,1,0,1
2020,189282,41,3,4,1,3
2020,189282,44,0,6,1,5
2020,189282,44,1,1,0,1
2020,189282,44,2,1,0,1
2020,189282,44,3,4,1,3
2020,189413,0,0,32,13,19
2020,189413,10,0,32,13,19
2020,189413,10,1,2,1,1
2020,189413,10,2,6,3,3
2020,189413,10,3,17,7,10
2020,189413,10,4,7,2,5
2020,189413,40,0,32,13,19
2020,189413,40,1,2,1,1
2020,189413,40,2,6,3,3
2020,189413,40,3,17,7,10
2020,189413,40,4,7,2,5
2020,189413,41,0,1,0,1
2020,189413,41,1,1,0,1
2020,189413,42,0,31,13,18
2020,189413,42,1,1,1,0
2020,189413,42,2,6,3,3
2020,189413,42,3,17,7,10
2020,189413,42,4,7,2,5
2020,189413,44,0,1,0,1
2020,189413,44,1,1,0,1
2020,189501,0,0,65,24,41
2020,189501,10,0,65,24,41
2020,189501,10,1,34,18,16
2020,189501,10,2,9,2,7
2020,189501,10,3,22,4,18
2020,189501,20,0,33,19,14
2020,189501,20,1,31,17,14
2020,189501,20,3,2,2,0
2020,189501,30,0,8,3,5
2020,189501,30,1,2,1,1
2020,189501,30,2,2,0,2
2020,189501,30,3,4,2,2
2020,189501,40,0,24,2,22
2020,189501,40,1,1,0,1
2020,189501,40,2,7,2,5
2020,189501,40,3,16,0,16
2020,189501,41,0,12,1,11
2020,189501,41,1,1,0,1
2020,189501,41,2,5,1,4
2020,189501,41,3,6,0,6
2020,189501,42,0,12,1,11
2020,189501,42,2,2,1,1
2020,189501,42,3,10,0,10
2020,189501,44,0,12,1,11
2020,189501,44,1,1,0,1
2020,189501,44,2,5,1,4
2020,189501,44,3,6,0,6
2020,189547,0,0,153,63,90
2020,189547,10,0,153,63,90
2020,189547,10,1,62,30,32
2020,189547,10,2,44,18,26
2020,189547,10,3,26,7,19
2020,189547,10,4,2,0,2
2020,189547,10,6,19,8,11
2020,189547,20,0,114,52,62
2020,189547,20,1,61,30,31
2020,189547,20,2,44,18,26
2020,189547,20,3,9,4,5
2020,189547,30,0,19,3,16
2020,189547,30,1,1,0,1
2020,189547,30,3,16,3,13
2020,189547,30,4,2,0,2
2020,189547,40,0,20,8,12
2020,189547,40,3,1,0,1
2020,189547,40,6,19,8,11
2020,189547,43,0,20,8,12
2020,189547,43,3,1,0,1
2020,189547,43,6,19,8,11
2020,189565,0,0,28,11,17
2020,189565,10,0,28,11,17
2020,189565,10,4,28,11,17
2020,189565,40,0,28,11,17
2020,189565,40,4,28,11,17
2020,189565,41,0,28,11,17
2020,189565,41,4,28,11,17
2020,189565,45,0,28,11,17
2020,189565,45,4,28,11,17
2020,189583,0,0,33,12,21
2020,189583,10,0,32,12,20
2020,189583,10,4,32,12,20
2020,189583,40,0,32,12,20
2020,189583,40,4,32,12,20
2020,189583,41,0,32,12,20
2020,189583,41,4,32,12,20
2020,189583,45,0,32,12,20
2020,189583,45,4,32,12,20
2020,189583,50,0,1,0,1
2020,189592,0,0,12,6,6
2020,189592,10,0,12,6,6
2020,189592,10,4,12,6,6
2020,189592,40,0,12,6,6
2020,189592,40,4,12,6,6
2020,189592,41,0,12,6,6
2020,189592,41,4,12,6,6
2020,189592,45,0,12,6,6
2020,189592,45,4,12,6,6
2020,189705,0,0,139,77,62
2020,189705,10,0,135,76,59
2020,189705,10,1,51,34,17
2020,189705,10,2,50,27,23
2020,189705,10,3,29,14,15
2020,189705,10,5,4,1,3
2020,189705,10,6,1,0,1
2020,189705,20,0,98,60,38
2020,189705,20,1,49,32,17
2020,189705,20,2,48,27,21
2020,189705,20,3,1,1,0
2020,189705,30,0,24,11,13
2020,189705,30,2,2,0,2
2020,189705,30,3,22,11,11
2020,189705,40,0,13,5,8
2020,189705,40,1,2,2,0
2020,189705,40,3,6,2,4
2020,189705,40,5,4,1,3
2020,189705,40,6,1,0,1
2020,189705,41,0,1,0,1
2020,189705,41,6,1,0,1
2020,189705,42,0,10,5,5
2020,189705,42,1,2,2,0
2020,189705,42,3,5,2,3
2020,189705,42,5,3,1,2
2020,189705,43,0,2,0,2
2020,189705,43,3,1,0,1
2020,189705,43,5,1,0,1
2020,189705,44,0,1,0,1
2020,189705,44,6,1,0,1
2020,189705,50,0,4,1,3
2020,189811,0,0,17,2,15
2020,189811,10,0,17,2,15
2020,189811,10,4,17,2,15
2020,189811,40,0,17,2,15
2020,189811,40,4,17,2,15
2020,189811,41,0,17,2,15
2020,189811,41,4,17,2,15
2020,189811,45,0,17,2,15
2020,189811,45,4,17,2,15
2020,189839,0,0,43,20,23
2020,189839,10,0,43,20,23
2020,189839,10,1,31,17,14
2020,189839,10,2,3,0,3
2020,189839,10,3,7,2,5
2020,189839,10,4,2,1,1
2020,189839,20,0,35,18,17
2020,189839,20,1,31,17,14
2020,189839,20,2,3,0,3
2020,189839,20,3,1,1,0
2020,189839,30,0,8,2,6
2020,189839,30,3,6,1,5
2020,189839,30,4,2,1,1
2020,189848,0,0,57,19,38
2020,189848,10,0,57,19,38
2020,189848,10,1,21,8,13
2020,189848,10,2,15,3,12
2020,189848,10,3,9,3,6
2020,189848,10,4,12,5,7
2020,189848,20,0,37,11,26
2020,189848,20,1,21,8,13
2020,189848,20,2,14,3,11
2020,189848,20,3,2,0,2
2020,189848,30,0,8,3,5
2020,189848,30,2,1,0,1
2020,189848,30,3,7,3,4
2020,189848,40,0,12,5,7
2020,189848,40,4,12,5,7
2020,189848,41,0,1,1,0
2020,189848,41,4,1,1,0
2020,189848,42,0,11,4,7
2020,189848,42,4,11,4,7
2020,189848,44,0,1,1,0
2020,189848,44,4,1,1,0
2020,189857,0,0,17,17,0
2020,189857,10,0,17,17,0
2020,189857,10,4,17,17,0
2020,189857,40,0,17,17,0
2020,189857,40,4,17,17,0
2020,189857,42,0,17,17,0
2020,189857,42,4,17,17,0
2020,190044,0,0,241,155,86
2020,190044,10,0,241,155,86
2020,190044,10,1,57,45,12
2020,190044,10,2,64,46,18
2020,190044,10,3,101,53,48
2020,190044,10,4,11,5,6
2020,190044,10,6,8,6,2
2020,190044,20,0,109,85,24
2020,190044,20,1,56,45,11
2020,190044,20,2,53,40,13
2020,190044,30,0,74,39,35
2020,190044,30,2,2,1,1
2020,190044,30,3,72,38,34
2020,190044,40,0,58,31,27
2020,190044,40,1,1,0,1
2020,190044,40,2,9,5,4
2020,190044,40,3,29,15,14
2020,190044,40,4,11,5,6
2020,190044,40,6,8,6,2
2020,190044,41,0,49,24,25
2020,190044,41,1,1,0,1
2020,190044,41,2,9,5,4
2020,190044,41,3,29,15,14
2020,190044,41,4,10,4,6
2020,190044,42,0,7,6,1
2020,190044,42,4,1,1,0
2020,190044,42,6,6,5,1
2020,190044,43,0,2,1,1
2020,190044,43,6,2,1,1
2020,190044,45,0,49,24,25
2020,190044,45,1,1,0,1
2020,190044,45,2,9,5,4
2020,190044,45,3,29,15,14
2020,190044,45,4,10,4,6
2020,190053,0,0,33,13,20
2020,190053,10,0,33,13,20
2020,190053,10,1,13,3,10
2020,190053,10,2,7,3,4
2020,190053,10,3,12,6,6
2020,190053,10,4,1,1,0
2020,190053,20,0,29,12,17
2020,190053,20,1,13,3,10
2020,190053,20,2,7,3,4
2020,190053,20,3,9,6,3
2020,190053,30,0,4,1,3
2020,190053,30,3,3,0,3
2020,190053,30,4,1,1,0
2020,190071,0,0,8,1,7
2020,190071,10,0,7,1,6
2020,190071,10,4,7,1,6
2020,190071,40,0,7,1,6
2020,190071,40,4,7,1,6
2020,190071,41,0,7,1,6
2020,190071,41,4,7,1,6
2020,190071,44,0,7,1,6
2020,190071,44,4,7,1,6
2020,190071,50,0,1,0,1
2020,190080,0,0,5,2,3
2020,190080,10,0,5,2,3
2020,190080,10,1,3,1,2
2020,190080,10,2,1,1,0
2020,190080,10,3,1,0,1
2020,190080,20,0,3,1,2
2020,190080,20,1,3,1,2
2020,190080,30,0,2,1,1
2020,190080,30,2,1,1,0
2020,190080,30,3,1,0,1
2020,190099,0,0,325,177,148
2020,190099,10,0,319,177,142
2020,190099,10,1,99,63,36
2020,190099,10,2,82,43,39
2020,190099,10,3,103,57,46
2020,190099,10,4,13,6,7
2020,190099,10,5,22,8,14
2020,190099,20,0,179,106,73
2020,190099,20,1,97,63,34
2020,190099,20,2,82,43,39
2020,190099,30,0,74,40,34
2020,190099,30,3,74,40,34
2020,190099,40,0,66,31,35
2020,190099,40,1,2,0,2
2020,190099,40,3,29,17,12
2020,190099,40,4,13,6,7
2020,190099,40,5,22,8,14
2020,190099,42,0,66,31,35
2020,190099,42,1,2,0,2
2020,190099,42,3,29,17,12
2020,190099,42,4,13,6,7
2020,190099,42,5,22,8,14
2020,190099,50,0,6,0,6
2020,190114,0,0,21,10,11
2020,190114,10,0,21,10,11
2020,190114,10,1,10,5,5
2020,190114,10,2,8,5,3
2020,190114,10,3,3,0,3
2020,190114,40,0,21,10,11
2020,190114,40,1,10,5,5
2020,190114,40,2,8,5,3
2020,190114,40,3,3,0,3
2020,190114,41,0,21,10,11
2020,190114,41,1,10,5,5
2020,190114,41,2,8,5,3
2020,190114,41,3,3,0,3
2020,190114,44,0,21,10,11
2020,190114,44,1,10,5,5
2020,190114,44,2,8,5,3
2020,190114,44,3,3,0,3
2020,190150,0,0,4327,2345,1982
2020,190150,10,0,4327,2345,1982
2020,190150,10,1,1416,991,425
2020,190150,10,2,714,400,314
2020,190150,10,3,1610,692,918
2020,190150,10,4,153,64,89
2020,190150,10,5,434,198,236
2020,190150,20,0,1189,846,343
2020,190150,20,1,979,712,267
2020,190150,20,2,210,134,76
2020,190150,30,0,515,294,221
2020,190150,30,1,25,15,10
2020,190150,30,2,88,56,32
2020,190150,30,3,400,222,178
2020,190150,30,4,2,1,1
2020,190150,40,0,2623,1205,1418
2020,190150,40,1,412,264,148
2020,190150,40,2,416,210,206
2020,190150,40,3,1210,470,740
2020,190150,40,4,151,63,88
2020,190150,40,5,434,198,236
2020,190150,41,0,20,18,2
2020,190150,41,1,19,17,2
2020,190150,41,2,1,1,0
2020,190150,42,0,2448,1125,1323
2020,190150,42,1,388,243,145
2020,190150,42,2,407,205,202
2020,190150,42,3,1128,443,685
2020,190150,42,4,128,52,76
2020,190150,42,5,397,182,215
2020,190150,43,0,155,62,93
2020,190150,43,1,5,4,1
2020,190150,43,2,8,4,4
2020,190150,43,3,82,27,55
2020,190150,43,4,23,11,12
2020,190150,43,5,37,16,21
2020,190150,44,0,20,18,2
2020,190150,44,1,19,17,2
2020,190150,44,2,1,1,0
2020,190169,0,0,41,16,25
2020,190169,10,0,41,16,25
2020,190169,10,1,13,7,6
2020,190169,10,2,15,4,11
2020,190169,10,3,12,5,7
2020,190169,10,4,1,0,1
2020,190169,20,0,33,13,20
2020,190169,20,1,13,7,6
2020,190169,20,2,15,4,11
2020,190169,20,3,4,2,2
2020,190169,20,4,1,0,1
2020,190169,30,0,7,3,4
2020,190169,30,3,7,3,4
2020,190169,40,0,1,0,1
2020,190169,40,3,1,0,1
2020,190169,42,0,1,0,1
2020,190169,42,3,1,0,1
2020,190248,0,0,43,12,31
2020,190248,10,0,43,12,31
2020,190248,10,1,9,4,5
2020,190248,10,2,9,1,8
2020,190248,10,3,23,6,17
2020,190248,10,4,2,1,1
2020,190248,40,0,43,12,31
2020,190248,40,1,9,4,5
2020,190248,40,2,9,1,8
2020,190248,40,3,23,6,17
2020,190248,40,4,2,1,1
2020,190248,41,0,38,10,28
2020,190248,41,1,8,3,5
2020,190248,41,2,9,1,8
2020,190248,41,3,19,5,14
2020,190248,41,4,2,1,1
2020,190248,42,0,5,2,3
2020,190248,42,1,1,1,0
2020,190248,42,3,4,1,3
2020,190248,44,0,38,10,28
2020,190248,44,1,8,3,5
2020,190248,44,2,9,1,8
2020,190248,44,3,19,5,14
2020,190248,44,4,2,1,1
2020,190372,0,0,53,33,20
2020,190372,10,0,53,33,20
2020,190372,10,1,29,22,7
2020,190372,10,2,7,5,2
2020,190372,10,3,17,6,11
2020,190372,20,0,29,22,7
2020,190372,20,1,26,20,6
2020,190372,20,2,3,2,1
2020,190372,30,0,21,9,12
2020,190372,30,2,4,3,1
2020,190372,30,3,17,6,11
2020,190372,40,0,3,2,1
2020,190372,40,1,3,2,1
2020,190372,41,0,1,1,0
2020,190372,41,1,1,1,0
2020,190372,42,0,2,1,1
2020,190372,42,1,2,1,1
2020,190372,44,0,1,1,0
2020,190372,44,1,1,1,0
2020,190415,0,0,1858,1131,727
2020,190415,10,0,1858,1131,727
2020,190415,10,1,744,539,205
2020,190415,10,2,395,225,170
2020,190415,10,3,353,201,152
2020,190415,10,4,52,25,27
2020,190415,10,5,314,141,173
2020,190415,20,0,1057,728,329
2020,190415,20,1,699,519,180
2020,190415,20,2,358,209,149
2020,190415,30,0,354,197,157
2020,190415,30,1,6,0,6
2020,190415,30,2,21,13,8
2020,190415,30,3,327,184,143
2020,190415,40,0,447,206,241
2020,190415,40,1,39,20,19
2020,190415,40,2,16,3,13
2020,190415,40,3,26,17,9
2020,190415,40,4,52,25,27
2020,190415,40,5,314,141,173
2020,190415,41,0,359,166,193
2020,190415,41,1,38,19,19
2020,190415,41,2,15,3,12
2020,190415,41,3,20,13,7
2020,190415,41,4,21,11,10
2020,190415,41,5,265,120,145
2020,190415,42,0,69,27,42
2020,190415,42,2,1,0,1
2020,190415,42,3,6,4,2
2020,190415,42,4,23,8,15
2020,190415,42,5,39,15,24
2020,190415,43,0,19,13,6
2020,190415,43,1,1,1,0
2020,190415,43,4,8,6,2
2020,190415,43,5,10,6,4
2020,190415,44,0,359,166,193
2020,190415,44,1,38,19,19
2020,190415,44,2,15,3,12
2020,190415,44,3,20,13,7
2020,190415,44,4,21,11,10
2020,190415,44,5,265,120,145
2020,190424,0,0,1950,1041,909
2020,190424,10,0,1950,1041,909
2020,190424,10,1,273,197,76
2020,190424,10,2,296,184,112
2020,190424,10,3,1165,563,602
2020,190424,10,4,214,97,117
2020,190424,10,5,2,0,2
2020,190424,20,0,118,91,27
2020,190424,20,1,108,84,24
2020,190424,20,2,7,5,2
2020,190424,20,3,3,2,1
2020,190424,30,0,297,151,146
2020,190424,30,1,3,3,0
2020,190424,30,2,26,15,11
2020,190424,30,3,107,56,51
2020,190424,30,4,161,77,84
2020,190424,40,0,1535,799,736
2020,190424,40,1,162,110,52
2020,190424,40,2,263,164,99
2020,190424,40,3,1055,505,550
2020,190424,40,4,53,20,33
2020,190424,40,5,2,0,2
2020,190424,42,0,1535,799,736
2020,190424,42,1,162,110,52
2020,190424,42,2,263,164,99
2020,190424,42,3,1055,505,550
2020,190424,42,4,53,20,33
2020,190424,42,5,2,0,2
2020,190442,0,0,69,34,35
2020,190442,10,0,69,34,35
2020,190442,10,1,32,16,16
2020,190442,10,2,18,13,5
2020,190442,10,3,7,3,4
2020,190442,10,4,12,2,10
2020,190442,20,0,55,32,23
2020,190442,20,1,32,16,16
2020,190442,20,2,18,13,5
2020,190442,20,3,4,2,2
2020,190442,20,4,1,1,0
2020,190442,30,0,13,2,11
2020,190442,30,3,3,1,2
2020,190442,30,4,10,1,9
2020,190442,40,0,1,0,1
2020,190442,40,4,1,0,1
2020,190442,42,0,1,0,1
2020,190442,42,4,1,0,1
2020,190451,0,0,16,0,16
2020,190451,10,0,16,0,16
2020,190451,10,2,4,0,4
2020,190451,10,3,6,0,6
2020,190451,10,4,6,0,6
2020,190451,40,0,16,0,16
2020,190451,40,2,4,0,4
2020,190451,40,3,6,0,6
2020,190451,40,4,6,0,6
2020,190451,41,0,16,0,16
2020,190451,41,2,4,0,4
2020,190451,41,3,6,0,6
2020,190451,41,4,6,0,6
2020,190451,45,0,16,0,16
2020,190451,45,2,4,0,4
2020,190451,45,3,6,0,6
2020,190451,45,4,6,0,6
2020,190503,0,0,130,89,41
2020,190503,10,0,130,89,41
2020,190503,10,1,33,23,10
2020,190503,10,2,50,34,16
2020,190503,10,3,20,14,6
2020,190503,10,4,27,18,9
2020,190503,40,0,130,89,41
2020,190503,40,1,33,23,10
2020,190503,40,2,50,34,16
2020,190503,40,3,20,14,6
2020,190503,40,4,27,18,9
2020,190503,41,0,130,89,41
2020,190503,41,1,33,23,10
2020,190503,41,2,50,34,16
2020,190503,41,3,20,14,6
2020,190503,41,4,27,18,9
2020,190503,44,0,130,89,41
2020,190503,44,1,33,23,10
2020,190503,44,2,50,34,16
2020,190503,44,3,20,14,6
2020,190503,44,4,27,18,9
2020,190512,0,0,477,300,177
2020,190512,10,0,477,300,177
2020,190512,10,1,183,123,60
2020,190512,10,2,140,83,57
2020,190512,10,3,105,62,43
2020,190512,10,5,49,32,17
2020,190512,20,0,331,212,119
2020,190512,20,1,170,113,57
2020,190512,20,2,133,77,56
2020,190512,20,3,4,4,0
2020,190512,20,5,24,18,6
2020,190512,30,0,125,72,53
2020,190512,30,2,7,6,1
2020,190512,30,3,98,57,41
2020,190512,30,5,20,9,11
2020,190512,40,0,21,16,5
2020,190512,40,1,13,10,3
2020,190512,40,3,3,1,2
2020,190512,40,5,5,5,0
2020,190512,42,0,21,16,5
2020,190512,42,1,13,10,3
2020,190512,42,3,3,1,2
2020,190512,42,5,5,5,0
2020,190521,0,0,550,256,294
2020,190521,10,0,550,256,294
2020,190521,10,1,122,68,54
2020,190521,10,2,169,63,106
2020,190521,10,3,166,74,92
2020,190521,10,4,21,14,7
2020,190521,10,5,72,37,35
2020,190521,20,0,350,163,187
2020,190521,20,1,122,68,54
2020,190521,20,2,129,52,77
2020,190521,20,3,45,18,27
2020,190521,20,5,54,25,29
2020,190521,30,0,170,73,97
2020,190521,30,2,40,11,29
2020,190521,30,3,112,50,62
2020,190521,30,5,18,12,6
2020,190521,40,0,30,20,10
2020,190521,40,3,9,6,3
2020,190521,40,4,21,14,7
2020,190521,42,0,30,20,10
2020,190521,42,3,9,6,3
2020,190521,42,4,21,14,7
2020,190530,0,0,260,140,120
2020,190530,10,0,260,140,120
2020,190530,10,1,77,46,31
2020,190530,10,2,86,43,43
2020,190530,10,3,59,28,31
2020,190530,10,5,38,23,15
2020,190530,20,0,181,96,85
2020,190530,20,1,77,46,31
2020,190530,20,2,60,29,31
2020,190530,20,3,16,7,9
2020,190530,20,5,28,14,14
2020,190530,30,0,77,44,33
2020,190530,30,2,25,14,11
2020,190530,30,3,43,21,22
2020,190530,30,5,9,9,0
2020,190530,40,0,2,0,2
2020,190530,40,2,1,0,1
2020,190530,40,5,1,0,1
2020,190530,42,0,2,0,2
2020,190530,42,2,1,0,1
2020,190530,42,5,1,0,1
2020,190549,0,0,471,251,220
2020,190549,10,0,471,251,220
2020,190549,10,1,201,124,77
2020,190549,10,2,141,71,70
2020,190549,10,3,85,36,49
2020,190549,10,5,44,20,24
2020,190549,20,0,366,206,160
2020,190549,20,1,193,121,72
2020,190549,20,2,135,68,67
2020,190549,20,3,17,8,9
2020,190549,20,5,21,9,12
2020,190549,30,0,82,35,47
2020,190549,30,1,1,0,1
2020,190549,30,2,5,3,2
2020,190549,30,3,68,28,40
2020,190549,30,5,8,4,4
2020,190549,40,0,23,10,13
2020,190549,40,1,7,3,4
2020,190549,40,2,1,0,1
2020,190549,40,5,15,7,8
2020,190549,42,0,23,10,13
2020,190549,42,1,7,3,4
2020,190549,42,2,1,0,1
2020,190549,42,5,15,7,8
2020,190558,0,0,333,177,156
2020,190558,10,0,333,177,156
2020,190558,10,1,134,84,50
2020,190558,10,2,105,50,55
2020,190558,10,3,58,30,28
2020,190558,10,5,36,13,23
2020,190558,20,0,263,145,118
2020,190558,20,1,131,83,48
2020,190558,20,2,103,50,53
2020,190558,20,3,10,6,4
2020,190558,20,5,19,6,13
2020,190558,30,0,61,29,32
2020,190558,30,1,1,1,0
2020,190558,30,2,2,0,2
2020,190558,30,3,48,24,24
2020,190558,30,5,10,4,6
2020,190558,40,0,9,3,6
2020,190558,40,1,2,0,2
2020,190558,40,5,7,3,4
2020,190558,42,0,9,3,6
2020,190558,42,1,2,0,2
2020,190558,42,5,7,3,4
2020,190567,0,0,553,339,214
2020,190567,10,0,553,339,214
2020,190567,10,1,259,175,84
2020,190567,10,2,158,93,65
2020,190567,10,3,82,45,37
2020,190567,10,5,54,26,28
2020,190567,20,0,427,274,153
2020,190567,20,1,232,165,67
2020,190567,20,2,150,88,62
2020,190567,20,3,9,4,5
2020,190567,20,5,36,17,19
2020,190567,30,0,89,50,39
2020,190567,30,1,2,0,2
2020,190567,30,2,7,4,3
2020,190567,30,3,71,40,31
2020,190567,30,5,9,6,3
2020,190567,40,0,37,15,22
2020,190567,40,1,25,10,15
2020,190567,40,2,1,1,0
2020,190567,40,3,2,1,1
2020,190567,40,5,9,3,6
2020,190567,42,0,37,15,22
2020,190567,42,1,25,10,15
2020,190567,42,2,1,1,0
2020,190567,42,3,2,1,1
2020,190567,42,5,9,3,6
2020,190576,0,0,230,121,109
2020,190576,10,0,230,121,109
2020,190576,10,1,150,86,64
2020,190576,10,2,50,21,29
2020,190576,10,3,25,12,13
2020,190576,10,5,5,2,3
2020,190576,20,0,158,84,74
2020,190576,20,1,119,68,51
2020,190576,20,2,36,14,22
2020,190576,20,3,2,1,1
2020,190576,20,5,1,1,0
2020,190576,30,0,40,19,21
2020,190576,30,1,2,2,0
2020,190576,30,2,13,6,7
2020,190576,30,3,23,11,12
2020,190576,30,5,2,0,2
2020,190576,40,0,32,18,14
2020,190576,40,1,29,16,13
2020,190576,40,2,1,1,0
2020,190576,40,5,2,1,1
2020,190576,42,0,32,18,14
2020,190576,42,1,29,16,13
2020,190576,42,2,1,1,0
2020,190576,42,5,2,1,1
2020,190585,0,0,171,81,90
2020,190585,10,0,171,81,90
2020,190585,10,1,40,20,20
2020,190585,10,2,39,15,24
2020,190585,10,3,61,30,31
2020,190585,10,4,3,2,1
2020,190585,10,5,28,14,14
2020,190585,20,0,119,57,62
2020,190585,20,1,40,20,20
2020,190585,20,2,39,15,24
2020,190585,20,3,17,10,7
2020,190585,20,5,23,12,11
2020,190585,30,0,48,21,27
2020,190585,30,3,44,20,24
2020,190585,30,5,4,1,3
2020,190585,40,0,4,3,1
2020,190585,40,4,3,2,1
2020,190585,40,5,1,1,0
2020,190585,42,0,4,3,1
2020,190585,42,4,3,2,1
2020,190585,42,5,1,1,0
2020,190594,0,0,612,281,331
2020,190594,10,0,612,281,331
2020,190594,10,1,275,136,139
2020,190594,10,2,184,92,92
2020,190594,10,3,85,28,57
2020,190594,10,5,68,25,43
2020,190594,20,0,464,236,228
2020,190594,20,1,239,128,111
2020,190594,20,2,176,88,88
2020,190594,20,3,11,4,7
2020,190594,20,5,38,16,22
2020,190594,30,0,113,37,76
2020,190594,30,1,2,1,1
2020,190594,30,2,8,4,4
2020,190594,30,3,74,24,50
2020,190594,30,5,29,8,21
2020,190594,40,0,35,8,27
2020,190594,40,1,34,7,27
2020,190594,40,5,1,1,0
2020,190594,42,0,35,8,27
2020,190594,42,1,34,7,27
2020,190594,42,5,1,1,0
2020,190600,0,0,398,207,191
2020,190600,10,0,398,207,191
2020,190600,10,1,104,60,44
2020,190600,10,2,167,89,78
2020,190600,10,3,60,22,38
2020,190600,10,5,67,36,31
2020,190600,20,0,313,168,145
2020,190600,20,1,102,59,43
2020,190600,20,2,161,85,76
2020,190600,20,3,20,9,11
2020,190600,20,5,30,15,15
2020,190600,30,0,59,23,36
2020,190600,30,2,5,3,2
2020,190600,30,3,37,12,25
2020,190600,30,5,17,8,9
2020,190600,40,0,26,16,10
2020,190600,40,1,2,1,1
2020,190600,40,2,1,1,0
2020,190600,40,3,3,1,2
2020,190600,40,5,20,13,7
2020,190600,42,0,26,16,10
2020,190600,42,1,2,1,1
2020,190600,42,2,1,1,0
2020,190600,42,3,3,1,2
2020,190600,42,5,20,13,7
2020,190619,0,0,312,149,163
2020,190619,10,0,312,149,163
2020,190619,10,1,74,43,31
2020,190619,10,2,67,22,45
2020,190619,10,3,86,42,44
2020,190619,10,4,1,0,1
2020,190619,10,5,84,42,42
2020,190619,20,0,224,108,116
2020,190619,20,1,74,43,31
2020,190619,20,2,61,19,42
2020,190619,20,3,31,18,13
2020,190619,20,5,58,28,30
2020,190619,30,0,73,33,40
2020,190619,30,2,6,3,3
2020,190619,30,3,49,20,29
2020,190619,30,5,18,10,8
2020,190619,40,0,15,8,7
2020,190619,40,3,6,4,2
2020,190619,40,4,1,0,1
2020,190619,40,5,8,4,4
2020,190619,42,0,15,8,7
2020,190619,42,3,6,4,2
2020,190619,42,4,1,0,1
2020,190619,42,5,8,4,4
2020,190628,0,0,352,152,200
2020,190628,10,0,352,152,200
2020,190628,10,1,128,63,65
2020,190628,10,2,135,49,86
2020,190628,10,3,48,20,28
2020,190628,10,4,1,0,1
2020,190628,10,5,40,20,20
2020,190628,20,0,228,109,119
2020,190628,20,1,128,63,65
2020,190628,20,2,65,29,36
2020,190628,20,3,2,1,1
2020,190628,20,5,33,16,17
2020,190628,30,0,116,40,76
2020,190628,30,2,70,20,50
2020,190628,30,3,42,18,24
2020,190628,30,5,4,2,2
2020,190628,40,0,8,3,5
2020,190628,40,3,4,1,3
2020,190628,40,4,1,0,1
2020,190628,40,5,3,2,1
2020,190628,42,0,8,3,5
2020,190628,42,3,4,1,3
2020,190628,42,4,1,0,1
2020,190628,42,5,3,2,1
2020,190637,0,0,372,163,209
2020,190637,10,0,372,163,209
2020,190637,10,1,95,54,41
2020,190637,10,2,114,45,69
2020,190637,10,3,96,44,52
2020,190637,10,4,1,1,0
2020,190637,10,5,66,19,47
2020,190637,20,0,247,114,133
2020,190637,20,1,91,53,38
2020,190637,20,2,108,43,65
2020,190637,20,3,8,5,3
2020,190637,20,5,40,13,27
2020,190637,30,0,110,45,65
2020,190637,30,2,6,2,4
2020,190637,30,3,85,38,47
2020,190637,30,5,19,5,14
2020,190637,40,0,15,4,11
2020,190637,40,1,4,1,3
2020,190637,40,3,3,1,2
2020,190637,40,4,1,1,0
2020,190637,40,5,7,1,6
2020,190637,42,0,15,4,11
2020,190637,42,1,4,1,3
2020,190637,42,3,3,1,2
2020,190637,42,4,1,1,0
2020,190637,42,5,7,1,6
2020,190646,0,0,145,77,68
2020,190646,10,0,145,77,68
2020,190646,10,1,38,22,16
2020,190646,10,2,32,15,17
2020,190646,10,3,41,20,21
2020,190646,10,4,2,1,1
2020,190646,10,5,32,19,13
2020,190646,20,0,88,52,36
2020,190646,20,1,37,21,16
2020,190646,20,2,21,9,12
2020,190646,20,3,9,6,3
2020,190646,20,5,21,16,5
2020,190646,30,0,45,18,27
2020,190646,30,1,1,1,0
2020,190646,30,2,11,6,5
2020,190646,30,3,28,11,17
2020,190646,30,4,1,0,1
2020,190646,30,5,4,0,4
2020,190646,40,0,12,7,5
2020,190646,40,3,4,3,1
2020,190646,40,4,1,1,0
2020,190646,40,5,7,3,4
2020,190646,42,0,12,7,5
2020,190646,42,3,4,3,1
2020,190646,42,4,1,1,0
2020,190646,42,5,7,3,4
2020,190655,0,0,367,188,179
2020,190655,10,0,367,188,179
2020,190655,10,1,88,46,42
2020,190655,10,2,143,75,68
2020,190655,10,3,117,57,60
2020,190655,10,5,19,10,9
2020,190655,20,0,285,152,133
2020,190655,20,1,87,45,42
2020,190655,20,2,127,67,60
2020,190655,20,3,54,32,22
2020,190655,20,5,17,8,9
2020,190655,30,0,81,35,46
2020,190655,30,2,16,8,8
2020,190655,30,3,63,25,38
2020,190655,30,5,2,2,0
2020,190655,40,0,1,1,0
2020,190655,40,1,1,1,0
2020,190655,42,0,1,1,0
2020,190655,42,1,1,1,0
2020,190664,0,0,553,291,262
2020,190664,10,0,553,291,262
2020,190664,10,1,201,131,70
2020,190664,10,2,160,69,91
2020,190664,10,3,96,51,45
2020,190664,10,5,96,40,56
2020,190664,20,0,416,218,198
2020,190664,20,1,191,126,65
2020,190664,20,2,153,64,89
2020,190664,20,3,11,5,6
2020,190664,20,5,61,23,38
2020,190664,30,0,118,63,55
2020,190664,30,1,2,0,2
2020,190664,30,2,7,5,2
2020,190664,30,3,82,45,37
2020,190664,30,5,27,13,14
2020,190664,40,0,19,10,9
2020,190664,40,1,8,5,3
2020,190664,40,3,3,1,2
2020,190664,40,5,8,4,4
2020,190664,42,0,19,10,9
2020,190664,42,1,8,5,3
2020,190664,42,3,3,1,2
2020,190664,42,5,8,4,4
2020,190673,0,0,378,181,197
2020,190673,10,0,378,181,197
2020,190673,10,1,77,32,45
2020,190673,10,2,134,70,64
2020,190673,10,3,95,43,52
2020,190673,10,4,1,1,0
2020,190673,10,5,71,35,36
2020,190673,20,0,261,133,128
2020,190673,20,1,77,32,45
2020,190673,20,2,134,70,64
2020,190673,20,3,5,4,1
2020,190673,20,5,45,27,18
2020,190673,30,0,116,47,69
2020,190673,30,3,90,39,51
2020,190673,30,5,26,8,18
2020,190673,40,0,1,1,0
2020,190673,40,4,1,1,0
2020,190673,42,0,1,1,0
2020,190673,42,4,1,1,0
2020,190682,0,0,56,20,36
2020,190682,10,0,56,20,36
2020,190682,10,1,32,14,18
2020,190682,10,2,13,4,9
2020,190682,10,3,5,1,4
2020,190682,10,4,6,1,5
2020,190682,20,0,29,13,16
2020,190682,20,1,28,12,16
2020,190682,20,2,1,1,0
2020,190682,30,0,15,4,11
2020,190682,30,1,1,0,1
2020,190682,30,2,12,3,9
2020,190682,30,3,2,1,1
2020,190682,40,0,12,3,9
2020,190682,40,1,3,2,1
2020,190682,40,3,3,0,3
2020,190682,40,4,6,1,5
2020,190682,42,0,12,3,9
2020,190682,42,1,3,2,1
2020,190682,42,3,3,0,3
2020,190682,42,4,6,1,5
2020,190691,0,0,184,90,94
2020,190691,10,0,184,90,94
2020,190691,10,1,52,27,25
2020,190691,10,2,59,29,30
2020,190691,10,3,50,21,29
2020,190691,10,5,23,13,10
2020,190691,20,0,125,68,57
2020,190691,20,1,46,26,20
2020,190691,20,2,55,28,27
2020,190691,20,3,9,6,3
2020,190691,20,5,15,8,7
2020,190691,30,0,48,18,30
2020,190691,30,2,4,1,3
2020,190691,30,3,39,14,25
2020,190691,30,5,5,3,2
2020,190691,40,0,11,4,7
2020,190691,40,1,6,1,5
2020,190691,40,3,2,1,1
2020,190691,40,5,3,2,1
2020,190691,42,0,11,4,7
2020,190691,42,1,6,1,5
2020,190691,42,3,2,1,1
2020,190691,42,5,3,2,1
2020,190716,0,0,168,59,109
2020,190716,10,0,168,59,109
2020,190716,10,1,21,9,12
2020,190716,10,2,86,33,53
2020,190716,10,3,59,17,42
2020,190716,10,4,2,0,2
2020,190716,20,0,78,35,43
2020,190716,20,1,20,9,11
2020,190716,20,2,56,26,30
2020,190716,20,3,2,0,2
2020,190716,30,0,17,10,7
2020,190716,30,2,2,1,1
2020,190716,30,3,15,9,6
2020,190716,40,0,73,14,59
2020,190716,40,1,1,0,1
2020,190716,40,2,28,6,22
2020,190716,40,3,42,8,34
2020,190716,40,4,2,0,2
2020,190716,41,0,63,11,52
2020,190716,41,1,1,0,1
2020,190716,41,2,28,6,22
2020,190716,41,3,33,5,28
2020,190716,41,4,1,0,1
2020,190716,42,0,10,3,7
2020,190716,42,3,9,3,6
2020,190716,42,4,1,0,1
2020,190716,44,0,62,11,51
2020,190716,44,1,1,0,1
2020,190716,44,2,28,6,22
2020,190716,44,3,32,5,27
2020,190716,44,4,1,0,1
2020,190716,45,0,1,0,1
2020,190716,45,3,1,0,1
2020,190725,0,0,147,52,95
2020,190725,10,0,147,52,95
2020,190725,10,1,13,6,7
2020,190725,10,2,55,23,32
2020,190725,10,3,58,16,42
2020,190725,10,4,10,5,5
2020,190725,10,6,11,2,9
2020,190725,20,0,65,28,37
2020,190725,20,1,13,6,7
2020,190725,20,2,50,22,28
2020,190725,20,3,1,0,1
2020,190725,20,6,1,0,1
2020,190725,30,0,47,14,33
2020,190725,30,2,5,1,4
2020,190725,30,3,42,13,29
2020,190725,40,0,35,10,25
2020,190725,40,3,15,3,12
2020,190725,40,4,10,5,5
2020,190725,40,6,10,2,8
2020,190725,42,0,20,5,15
2020,190725,42,3,11,2,9
2020,190725,42,4,3,1,2
2020,190725,42,6,6,2,4
2020,190725,43,0,15,5,10
2020,190725,43,3,4,1,3
2020,190725,43,4,7,4,3
2020,190725,43,6,4,0,4
2020,190761,0,0,73,26,47
2020,190761,10,0,73,26,47
2020,190761,10,1,5,1,4
2020,190761,10,2,16,8,8
2020,190761,10,3,45,17,28
2020,190761,10,4,7,0,7
2020,190761,20,0,39,14,25
2020,190761,20,1,5,1,4
2020,190761,20,2,16,8,8
2020,190761,20,3,18,5,13
2020,190761,30,0,15,6,9
2020,190761,30,3,13,6,7
2020,190761,30,4,2,0,2
2020,190761,40,0,19,6,13
2020,190761,40,3,14,6,8
2020,190761,40,4,5,0,5
2020,190761,42,0,19,6,13
2020,190761,42,3,14,6,8
2020,190761,42,4,5,0,5
2020,190840,0,0,107,49,58
2020,190840,10,0,107,49,58
2020,190840,10,1,25,14,11
2020,190840,10,2,22,6,16
2020,190840,10,3,38,18,20
2020,190840,10,4,20,11,9
2020,190840,10,6,2,0,2
2020,190840,20,0,77,40,37
2020,190840,20,1,25,14,11
2020,190840,20,2,19,6,13
2020,190840,20,3,29,16,13
2020,190840,20,4,4,4,0
2020,190840,30,0,29,8,21
2020,190840,30,2,3,0,3
2020,190840,30,3,9,2,7
2020,190840,30,4,15,6,9
2020,190840,30,6,2,0,2
2020,190840,40,0,1,1,0
2020,190840,40,4,1,1,0
2020,190840,42,0,1,1,0
2020,190840,42,4,1,1,0
2020,190956,0,0,14,0,14
2020,190956,10,0,14,0,14
2020,190956,10,4,14,0,14
2020,190956,40,0,14,0,14
2020,190956,40,4,14,0,14
2020,190956,41,0,14,0,14
2020,190956,41,4,14,0,14
2020,190956,45,0,14,0,14
2020,190956,45,4,14,0,14
2020,190983,0,0,60,28,32
2020,190983,10,0,60,28,32
2020,190983,10,1,5,3,2
2020,190983,10,2,19,9,10
2020,190983,10,3,25,11,14
2020,190983,10,4,3,1,2
2020,190983,10,5,4,3,1
2020,190983,10,6,4,1,3
2020,190983,20,0,26,12,14
2020,190983,20,1,5,3,2
2020,190983,20,2,19,9,10
2020,190983,20,3,1,0,1
2020,190983,20,6,1,0,1
2020,190983,30,0,24,11,13
2020,190983,30,3,23,11,12
2020,190983,30,4,1,0,1
2020,190983,40,0,10,5,5
2020,190983,40,3,1,0,1
2020,190983,40,4,2,1,1
2020,190983,40,5,4,3,1
2020,190983,40,6,3,1,2
2020,190983,42,0,10,5,5
2020,190983,42,3,1,0,1
2020,190983,42,4,2,1,1
2020,190983,42,5,4,3,1
2020,190983,42,6,3,1,2
2020,191083,0,0,265,131,134
2020,191083,10,0,265,131,134
2020,191083,10,1,101,49,52
2020,191083,10,2,47,24,23
2020,191083,10,3,29,17,12
2020,191083,10,4,88,41,47
2020,191083,20,0,220,107,113
2020,191083,20,1,101,49,52
2020,191083,20,2,47,24,23
2020,191083,20,3,29,17,12
2020,191083,20,4,43,17,26
2020,191083,30,0,45,24,21
2020,191083,30,4,45,24,21
2020,191126,0,0,212,90,122
2020,191126,10,0,212,90,122
2020,191126,10,1,67,30,37
2020,191126,10,2,65,32,33
2020,191126,10,3,79,28,51
2020,191126,10,6,1,0,1
2020,191126,20,0,185,82,103
2020,191126,20,1,66,30,36
2020,191126,20,2,59,29,30
2020,191126,20,3,59,23,36
2020,191126,20,6,1,0,1
2020,191126,30,0,27,8,19
2020,191126,30,1,1,0,1
2020,191126,30,2,6,3,3
2020,191126,30,3,20,5,15
2020,191199,0,0,107,56,51
2020,191199,10,0,107,56,51
2020,191199,10,1,36,21,15
2020,191199,10,2,27,14,13
2020,191199,10,3,29,17,12
2020,191199,10,4,15,4,11
2020,191199,20,0,69,39,30
2020,191199,20,1,36,21,15
2020,191199,20,2,23,12,11
2020,191199,20,3,10,6,4
2020,191199,30,0,38,17,21
2020,191199,30,2,4,2,2
2020,191199,30,3,19,11,8
2020,191199,30,4,15,4,11
2020,191205,0,0,25,12,13
2020,191205,10,0,25,12,13
2020,191205,10,1,4,1,3
2020,191205,10,2,6,3,3
2020,191205,10,3,9,7,2
2020,191205,10,4,6,1,5
2020,191205,40,0,25,12,13
2020,191205,40,1,4,1,3
2020,191205,40,2,6,3,3
2020,191205,40,3,9,7,2
2020,191205,40,4,6,1,5
2020,191205,42,0,25,12,13
2020,191205,42,1,4,1,3
2020,191205,42,2,6,3,3
2020,191205,42,3,9,7,2
2020,191205,42,4,6,1,5
2020,191241,0,0,747,404,343
2020,191241,10,0,590,330,260
2020,191241,10,1,244,158,86
2020,191241,10,2,206,112,94
2020,191241,10,3,126,52,74
2020,191241,10,4,14,8,6
2020,191241,20,0,456,273,183
2020,191241,20,1,244,158,86
2020,191241,20,2,195,106,89
2020,191241,20,3,17,9,8
2020,191241,30,0,120,49,71
2020,191241,30,2,11,6,5
2020,191241,30,3,109,43,66
2020,191241,40,0,14,8,6
2020,191241,40,4,14,8,6
2020,191241,41,0,5,4,1
2020,191241,41,4,5,4,1
2020,191241,42,0,9,4,5
2020,191241,42,4,9,4,5
2020,191241,44,0,5,4,1
2020,191241,44,4,5,4,1
2020,191241,50,0,157,74,83
2020,191302,0,0,37,20,17
2020,191302,10,0,37,20,17
2020,191302,10,1,7,6,1
2020,191302,10,2,5,3,2
2020,191302,10,3,21,10,11
2020,191302,10,4,4,1,3
2020,191302,20,0,33,19,14
2020,191302,20,1,7,6,1
2020,191302,20,2,5,3,2
2020,191302,20,3,21,10,11
2020,191302,30,0,4,1,3
2020,191302,30,4,4,1,3
2020,191320,0,0,5,3,2
2020,191320,10,0,5,3,2
2020,191320,10,1,2,2,0
2020,191320,10,2,2,1,1
2020,191320,10,3,1,0,1
2020,191320,40,0,5,3,2
2020,191320,40,1,2,2,0
2020,191320,40,2,2,1,1
2020,191320,40,3,1,0,1
2020,191320,41,0,5,3,2
2020,191320,41,1,2,2,0
2020,191320,41,2,2,1,1
2020,191320,41,3,1,0,1
2020,191320,44,0,5,3,2
2020,191320,44,1,2,2,0
2020,191320,44,2,2,1,1
2020,191320,44,3,1,0,1
2020,191339,0,0,81,32,49
2020,191339,10,0,81,32,49
2020,191339,10,1,23,6,17
2020,191339,10,2,21,10,11
2020,191339,10,3,13,7,6
2020,191339,10,4,24,9,15
2020,191339,40,0,81,32,49
2020,191339,40,1,23,6,17
2020,191339,40,2,21,10,11
2020,191339,40,3,13,7,6
2020,191339,40,4,24,9,15
2020,191339,41,0,63,27,36
2020,191339,41,1,23,6,17
2020,191339,41,2,21,10,11
2020,191339,41,3,12,7,5
2020,191339,41,4,7,4,3
2020,191339,42,0,18,5,13
2020,191339,42,3,1,0,1
2020,191339,42,4,17,5,12
2020,191339,44,0,63,27,36
2020,191339,44,1,23,6,17
2020,191339,44,2,21,10,11
2020,191339,44,3,12,7,5
2020,191339,44,4,7,4,3
2020,191515,0,0,207,98,109
2020,191515,10,0,207,98,109
2020,191515,10,1,75,42,33
2020,191515,10,2,38,21,17
2020,191515,10,3,45,16,29
2020,191515,10,4,2,1,1
2020,191515,10,6,47,18,29
2020,191515,20,0,112,63,49
2020,191515,20,1,75,42,33
2020,191515,20,2,37,21,16
2020,191515,30,0,48,17,31
2020,191515,30,2,1,0,1
2020,191515,30,3,45,16,29
2020,191515,30,4,2,1,1
2020,191515,40,0,47,18,29
2020,191515,40,6,47,18,29
2020,191515,41,0,23,10,13
2020,191515,41,6,23,10,13
2020,191515,42,0,24,8,16
2020,191515,42,6,24,8,16
2020,191515,44,0,19,7,12
2020,191515,44,6,19,7,12
2020,191515,45,0,4,3,1
2020,191515,45,6,4,3,1
2020,191533,0,0,103,49,54
2020,191533,10,0,103,49,54
2020,191533,10,1,36,22,14
2020,191533,10,2,21,9,12
2020,191533,10,3,46,18,28
2020,191533,20,0,50,31,19
2020,191533,20,1,35,22,13
2020,191533,20,2,15,9,6
2020,191533,30,0,31,11,20
2020,191533,30,2,4,0,4
2020,191533,30,3,27,11,16
2020,191533,40,0,22,7,15
2020,191533,40,1,1,0,1
2020,191533,40,2,2,0,2
2020,191533,40,3,19,7,12
2020,191533,42,0,22,7,15
2020,191533,42,1,1,0,1
2020,191533,42,2,2,0,2
2020,191533,42,3,19,7,12
2020,191597,0,0,16,4,12
2020,191597,10,0,16,4,12
2020,191597,10,2,4,1,3
2020,191597,10,3,12,3,9
2020,191597,40,0,16,4,12
2020,191597,40,2,4,1,3
2020,191597,40,3,12,3,9
2020,191597,42,0,16,4,12
2020,191597,42,2,4,1,3
2020,191597,42,3,12,3,9
2020,191612,0,0,46,24,22
2020,191612,10,0,46,24,22
2020,191612,10,1,10,6,4
2020,191612,10,2,11,3,8
2020,191612,10,3,22,13,9
2020,191612,10,4,3,2,1
2020,191612,20,0,40,21,19
2020,191612,20,1,10,6,4
2020,191612,20,2,11,3,8
2020,191612,20,3,16,10,6
2020,191612,20,4,3,2,1
2020,191612,30,0,6,3,3
2020,191612,30,3,6,3,3
2020,191621,0,0,41,23,18
2020,191621,10,0,41,23,18
2020,191621,10,1,9,6,3
2020,191621,10,2,12,5,7
2020,191621,10,3,19,12,7
2020,191621,10,4,1,0,1
2020,191621,20,0,4,2,2
2020,191621,20,1,3,2,1
2020,191621,20,2,1,0,1
2020,191621,30,0,12,8,4
2020,191621,30,2,2,2,0
2020,191621,30,3,10,6,4
2020,191621,40,0,25,13,12
2020,191621,40,1,6,4,2
2020,191621,40,2,9,3,6
2020,191621,40,3,9,6,3
2020,191621,40,4,1,0,1
2020,191621,41,0,12,7,5
2020,191621,41,1,6,4,2
2020,191621,41,2,4,1,3
2020,191621,41,3,2,2,0
2020,191621,42,0,13,6,7
2020,191621,42,2,5,2,3
2020,191621,42,3,7,4,3
2020,191621,42,4,1,0,1
2020,191621,44,0,12,7,5
2020,191621,44,1,6,4,2
2020,191621,44,2,4,1,3
2020,191621,44,3,2,2,0
2020,191630,0,0,194,98,96
2020,191630,10,0,191,97,94
2020,191630,10,1,49,30,19
2020,191630,10,2,89,42,47
2020,191630,10,3,46,21,25
2020,191630,10,4,4,1,3
2020,191630,10,6,3,3,0
2020,191630,20,0,143,74,69
2020,191630,20,1,49,30,19
2020,191630,20,2,89,42,47
2020,191630,20,3,5,2,3
2020,191630,30,0,29,10,19
2020,191630,30,3,29,10,19
2020,191630,40,0,19,13,6
2020,191630,40,3,12,9,3
2020,191630,40,4,4,1,3
2020,191630,40,6,3,3,0
2020,191630,41,0,7,4,3
2020,191630,41,4,4,1,3
2020,191630,41,6,3,3,0
2020,191630,42,0,12,9,3
2020,191630,42,3,12,9,3
2020,191630,44,0,4,1,3
2020,191630,44,4,4,1,3
2020,191630,45,0,3,3,0
2020,191630,45,6,3,3,0
2020,191630,50,0,3,1,2
2020,191649,0,0,492,262,230
2020,191649,10,0,492,262,230
2020,191649,10,1,214,124,90
2020,191649,10,2,163,95,68
2020,191649,10,3,113,42,71
2020,191649,10,4,2,1,1
2020,191649,20,0,330,191,139
2020,191649,20,1,196,117,79
2020,191649,20,2,134,74,60
2020,191649,30,0,94,50,44
2020,191649,30,1,3,2,1
2020,191649,30,2,12,10,2
2020,191649,30,3,79,38,41
2020,191649,40,0,68,21,47
2020,191649,40,1,15,5,10
2020,191649,40,2,17,11,6
2020,191649,40,3,34,4,30
2020,191649,40,4,2,1,1
2020,191649,41,0,55,18,37
2020,191649,41,1,15,5,10
2020,191649,41,2,13,10,3
2020,191649,41,3,25,2,23
2020,191649,41,4,2,1,1
2020,191649,42,0,13,3,10
2020,191649,42,2,4,1,3
2020,191649,42,3,9,2,7
2020,191649,44,0,27,6,21
2020,191649,44,1,11,4,7
2020,191649,44,3,16,2,14
2020,191649,45,0,28,12,16
2020,191649,45,1,4,1,3
2020,191649,45,2,13,10,3
2020,191649,45,3,9,0,9
2020,191649,45,4,2,1,1
2020,191676,0,0,63,36,27
2020,191676,10,0,63,36,27
2020,191676,10,1,23,18,5
2020,191676,10,2,11,5,6
2020,191676,10,3,29,13,16
2020,191676,20,0,28,18,10
2020,191676,20,1,20,15,5
2020,191676,20,2,8,3,5
2020,191676,30,0,21,12,9
2020,191676,30,1,3,3,0
2020,191676,30,2,1,1,0
2020,191676,30,3,17,8,9
2020,191676,40,0,14,6,8
2020,191676,40,2,2,1,1
2020,191676,40,3,12,5,7
2020,191676,42,0,14,6,8
2020,191676,42,2,2,1,1
2020,191676,42,3,12,5,7
2020,191719,0,0,211,99,112
2020,191719,10,0,211,99,112
2020,191719,10,1,33,16,17
2020,191719,10,2,32,9,23
2020,191719,10,3,87,48,39
2020,191719,10,4,59,26,33
2020,191719,20,0,152,73,79
2020,191719,20,1,33,16,17
2020,191719,20,2,32,9,23
2020,191719,20,3,87,48,39
2020,191719,30,0,59,26,33
2020,191719,30,4,59,26,33
2020,191931,0,0,163,86,77
2020,191931,10,0,163,86,77
2020,191931,10,1,41,29,12
2020,191931,10,2,52,27,25
2020,191931,10,3,52,20,32
2020,191931,10,4,2,1,1
2020,191931,10,5,16,9,7
2020,191931,20,0,90,55,35
2020,191931,20,1,39,28,11
2020,191931,20,2,50,27,23
2020,191931,20,3,1,0,1
2020,191931,30,0,51,19,32
2020,191931,30,2,2,0,2
2020,191931,30,3,49,19,30
2020,191931,40,0,22,12,10
2020,191931,40,1,2,1,1
2020,191931,40,3,2,1,1
2020,191931,40,4,2,1,1
2020,191931,40,5,16,9,7
2020,191931,43,0,22,12,10
2020,191931,43,1,2,1,1
2020,191931,43,3,2,1,1
2020,191931,43,4,2,1,1
2020,191931,43,5,16,9,7
2020,191968,0,0,509,257,252
2020,191968,10,0,509,257,252
2020,191968,10,1,124,67,57
2020,191968,10,2,172,91,81
2020,191968,10,3,186,84,102
2020,191968,10,4,23,13,10
2020,191968,10,6,4,2,2
2020,191968,20,0,277,148,129
2020,191968,20,1,117,62,55
2020,191968,20,2,160,86,74
2020,191968,30,0,96,44,52
2020,191968,30,2,2,1,1
2020,191968,30,3,94,43,51
2020,191968,40,0,136,65,71
2020,191968,40,1,7,5,2
2020,191968,40,2,10,4,6
2020,191968,40,3,92,41,51
2020,191968,40,4,23,13,10
2020,191968,40,6,4,2,2
2020,191968,41,0,109,47,62
2020,191968,41,1,6,4,2
2020,191968,41,2,10,4,6
2020,191968,41,3,78,33,45
2020,191968,41,4,14,6,8
2020,191968,41,6,1,0,1
2020,191968,42,0,27,18,9
2020,191968,42,1,1,1,0
2020,191968,42,3,14,8,6
2020,191968,42,4,9,7,2
2020,191968,42,6,3,2,1
2020,191968,44,0,109,47,62
2020,191968,44,1,6,4,2
2020,191968,44,2,10,4,6
2020,191968,44,3,78,33,45
2020,191968,44,4,14,6,8
2020,191968,44,6,1,0,1
2020,191986,0,0,57,28,29
2020,191986,10,0,57,28,29
2020,191986,10,1,18,8,10
2020,191986,10,2,12,5,7
2020,191986,10,3,21,11,10
2020,191986,10,4,6,4,2
2020,191986,20,0,49,22,27
2020,191986,20,1,18,8,10
2020,191986,20,2,12,5,7
2020,191986,20,3,19,9,10
2020,191986,30,0,8,6,2
2020,191986,30,3,2,2,0
2020,191986,30,4,6,4,2
2020,192022,0,0,66,32,34
2020,192022,10,0,66,32,34
2020,192022,10,1,18,10,8
2020,192022,10,2,16,8,8
2020,192022,10,3,26,12,14
2020,192022,10,4,6,2,4
2020,192022,20,0,56,29,27
2020,192022,20,1,18,10,8
2020,192022,20,2,16,8,8
2020,192022,20,3,21,10,11
2020,192022,20,4,1,1,0
2020,192022,30,0,10,3,7
2020,192022,30,3,5,2,3
2020,192022,30,4,5,1,4
2020,192040,0,0,32,21,11
2020,192040,10,0,32,21,11
2020,192040,10,1,17,15,2
2020,192040,10,2,6,4,2
2020,192040,10,3,7,2,5
2020,192040,10,5,2,0,2
2020,192040,20,0,23,19,4
2020,192040,20,1,17,15,2
2020,192040,20,2,6,4,2
2020,192040,30,0,2,1,1
2020,192040,30,3,2,1,1
2020,192040,40,0,7,1,6
2020,192040,40,3,5,1,4
2020,192040,40,5,2,0,2
2020,192040,41,0,4,0,4
2020,192040,41,3,3,0,3
2020,192040,41,5,1,0,1
2020,192040,42,0,2,0,2
2020,192040,42,3,1,0,1
2020,192040,42,5,1,0,1
2020,192040,43,0,1,1,0
2020,192040,43,3,1,1,0
2020,192040,44,0,4,0,4
2020,192040,44,3,3,0,3
2020,192040,44,5,1,0,1
2020,192110,0,0,120,70,50
2020,192110,10,0,120,70,50
2020,192110,10,6,120,70,50
2020,192110,40,0,120,70,50
2020,192110,40,6,120,70,50
2020,192110,41,0,81,50,31
2020,192110,41,6,81,50,31
2020,192110,42,0,39,20,19
2020,192110,42,6,39,20,19
2020,192110,44,0,81,50,31
2020,192110,44,6,81,50,31
2020,192192,0,0,72,26,46
2020,192192,10,0,72,26,46
2020,192192,10,1,17,9,8
2020,192192,10,2,27,8,19
2020,192192,10,3,25,8,17
2020,192192,10,4,3,1,2
2020,192192,20,0,44,17,27
2020,192192,20,1,17,9,8
2020,192192,20,2,27,8,19
2020,192192,30,0,23,7,16
2020,192192,30,3,23,7,16
2020,192192,40,0,5,2,3
2020,192192,40,3,2,1,1
2020,192192,40,4,3,1,2
2020,192192,42,0,5,2,3
2020,192192,42,3,2,1,1
2020,192192,42,4,3,1,2
2020,192271,0,0,16,6,10
2020,192271,10,0,16,6,10
2020,192271,10,2,4,1,3
2020,192271,10,3,5,2,3
2020,192271,10,4,1,1,0
2020,192271,10,5,6,2,4
2020,192271,40,0,16,6,10
2020,192271,40,2,4,1,3
2020,192271,40,3,5,2,3
2020,192271,40,4,1,1,0
2020,192271,40,5,6,2,4
2020,192271,41,0,16,6,10
2020,192271,41,2,4,1,3
2020,192271,41,3,5,2,3
2020,192271,41,4,1,1,0
2020,192271,41,5,6,2,4
2020,192271,45,0,16,6,10
2020,192271,45,2,4,1,3
2020,192271,45,3,5,2,3
2020,192271,45,4,1,1,0
2020,192271,45,5,6,2,4
2020,192323,0,0,172,95,77
2020,192323,10,0,172,95,77
2020,192323,10,1,51,32,19
2020,192323,10,2,60,31,29
2020,192323,10,3,27,17,10
2020,192323,10,4,34,15,19
2020,192323,20,0,109,62,47
2020,192323,20,1,51,32,19
2020,192323,20,2,58,30,28
2020,192323,30,0,26,15,11
2020,192323,30,2,2,1,1
2020,192323,30,3,24,14,10
2020,192323,40,0,37,18,19
2020,192323,40,3,3,3,0
2020,192323,40,4,34,15,19
2020,192323,41,0,34,15,19
2020,192323,41,4,34,15,19
2020,192323,42,0,3,3,0
2020,192323,42,3,3,3,0
2020,192323,44,0,34,15,19
2020,192323,44,4,34,15,19
2020,192448,0,0,438,202,236
2020,192448,10,0,438,202,236
2020,192448,10,1,140,80,60
2020,192448,10,2,153,76,77
2020,192448,10,3,135,42,93
2020,192448,10,4,8,2,6
2020,192448,10,6,2,2,0
2020,192448,20,0,238,134,104
2020,192448,20,1,124,74,50
2020,192448,20,2,112,58,54
2020,192448,20,6,2,2,0
2020,192448,30,0,60,25,35
2020,192448,30,1,2,1,1
2020,192448,30,2,14,9,5
2020,192448,30,3,43,14,29
2020,192448,30,4,1,1,0
2020,192448,40,0,140,43,97
2020,192448,40,1,14,5,9
2020,192448,40,2,27,9,18
2020,192448,40,3,92,28,64
2020,192448,40,4,7,1,6
2020,192448,41,0,4,0,4
2020,192448,41,2,3,0,3
2020,192448,41,4,1,0,1
2020,192448,42,0,136,43,93
2020,192448,42,1,14,5,9
2020,192448,42,2,24,9,15
2020,192448,42,3,92,28,64
2020,192448,42,4,6,1,5
2020,192448,44,0,4,0,4
2020,192448,44,2,3,0,3
2020,192448,44,4,1,0,1
2020,192509,0,0,14,3,11
2020,192509,10,0,14,3,11
2020,192509,10,4,14,3,11
2020,192509,40,0,14,3,11
2020,192509,40,4,14,3,11
2020,192509,41,0,14,3,11
2020,192509,41,4,14,3,11
2020,192509,45,0,14,3,11
2020,192509,45,4,14,3,11
2020,192688,0,0,13,7,6
2020,192688,10,0,13,7,6
2020,192688,10,1,13,7,6
2020,192688,40,0,13,7,6
2020,192688,40,1,13,7,6
2020,192688,41,0,13,7,6
2020,192688,41,1,13,7,6
2020,192688,45,0,13,7,6
2020,192688,45,1,13,7,6
2020,192703,0,0,242,133,109
2020,192703,10,0,242,133,109
2020,192703,10,1,69,42,27
2020,192703,10,2,72,40,32
2020,192703,10,3,98,51,47
2020,192703,10,4,3,0,3
2020,192703,20,0,146,81,65
2020,192703,20,1,62,38,24
2020,192703,20,2,60,33,27
2020,192703,20,3,24,10,14
2020,192703,30,0,70,34,36
2020,192703,30,1,2,1,1
2020,192703,30,2,10,6,4
2020,192703,30,3,56,27,29
2020,192703,30,4,2,0,2
2020,192703,40,0,26,18,8
2020,192703,40,1,5,3,2
2020,192703,40,2,2,1,1
2020,192703,40,3,18,14,4
2020,192703,40,4,1,0,1
2020,192703,42,0,26,18,8
2020,192703,42,1,5,3,2
2020,192703,42,2,2,1,1
2020,192703,42,3,18,14,4
2020,192703,42,4,1,0,1
2020,192712,0,0,90,59,31
2020,192712,10,0,90,59,31
2020,192712,10,4,90,59,31
2020,192712,40,0,90,59,31
2020,192712,40,4,90,59,31
2020,192712,41,0,90,59,31
2020,192712,41,4,90,59,31
2020,192712,44,0,90,59,31
2020,192712,44,4,90,59,31
2020,192749,0,0,112,53,59
2020,192749,10,0,112,53,59
2020,192749,10,1,47,29,18
2020,192749,10,2,35,13,22
2020,192749,10,3,14,3,11
2020,192749,10,4,1,1,0
2020,192749,10,5,15,7,8
2020,192749,20,0,72,35,37
2020,192749,20,1,45,28,17
2020,192749,20,2,26,7,19
2020,192749,20,3,1,0,1
2020,192749,30,0,17,8,9
2020,192749,30,2,6,4,2
2020,192749,30,3,10,3,7
2020,192749,30,4,1,1,0
2020,192749,40,0,23,10,13
2020,192749,40,1,2,1,1
2020,192749,40,2,3,2,1
2020,192749,40,3,3,0,3
2020,192749,40,5,15,7,8
2020,192749,41,0,2,1,1
2020,192749,41,5,2,1,1
2020,192749,42,0,20,9,11
2020,192749,42,1,2,1,1
2020,192749,42,2,3,2,1
2020,192749,42,3,3,0,3
2020,192749,42,5,12,6,6
2020,192749,43,0,1,0,1
2020,192749,43,5,1,0,1
2020,192749,44,0,2,1,1
2020,192749,44,5,2,1,1
2020,192785,0,0,33,10,23
2020,192785,10,0,33,10,23
2020,192785,10,1,2,1,1
2020,192785,10,2,4,2,2
2020,192785,10,3,7,4,3
2020,192785,10,4,20,3,17
2020,192785,40,0,33,10,23
2020,192785,40,1,2,1,1
2020,192785,40,2,4,2,2
2020,192785,40,3,7,4,3
2020,192785,40,4,20,3,17
2020,192785,42,0,10,3,7
2020,192785,42,1,1,0,1
2020,192785,42,4,9,3,6
2020,192785,43,0,23,7,16
2020,192785,43,1,1,1,0
2020,192785,43,2,4,2,2
2020,192785,43,3,7,4,3
2020,192785,43,4,11,0,11
2020,192819,0,0,240,113,127
2020,192819,10,0,240,113,127
2020,192819,10,1,24,14,10
2020,192819,10,2,64,34,30
2020,192819,10,3,58,26,32
2020,192819,10,4,7,3,4
2020,192819,10,5,72,30,42
2020,192819,10,6,15,6,9
2020,192819,20,0,95,52,43
2020,192819,20,1,24,14,10
2020,192819,20,2,60,31,29
2020,192819,20,3,11,7,4
2020,192819,30,0,46,20,26
2020,192819,30,2,3,2,1
2020,192819,30,3,43,18,25
2020,192819,40,0,99,41,58
2020,192819,40,2,1,1,0
2020,192819,40,3,4,1,3
2020,192819,40,4,7,3,4
2020,192819,40,5,72,30,42
2020,192819,40,6,15,6,9
2020,192819,42,0,99,41,58
2020,192819,42,2,1,1,0
2020,192819,42,3,4,1,3
2020,192819,42,4,7,3,4
2020,192819,42,5,72,30,42
2020,192819,42,6,15,6,9
2020,192864,0,0,88,28,60
2020,192864,10,0,88,28,60
2020,192864,10,1,27,9,18
2020,192864,10,2,39,14,25
2020,192864,10,3,22,5,17
2020,192864,20,0,66,23,43
2020,192864,20,1,27,9,18
2020,192864,20,2,39,14,25
2020,192864,30,0,20,4,16
2020,192864,30,3,20,4,16
2020,192864,40,0,2,1,1
2020,192864,40,3,2,1,1
2020,192864,42,0,2,1,1
2020,192864,42,3,2,1,1
2020,192925,0,0,67,27,40
2020,192925,10,0,67,27,40
2020,192925,10,1,9,8,1
2020,192925,10,2,17,8,9
2020,192925,10,3,40,11,29
2020,192925,10,4,1,0,1
2020,192925,20,0,19,11,8
2020,192925,20,1,9,8,1
2020,192925,20,2,10,3,7
2020,192925,40,0,48,16,32
2020,192925,40,2,7,5,2
2020,192925,40,3,40,11,29
2020,192925,40,4,1,0,1
2020,192925,42,0,48,16,32
2020,192925,42,2,7,5,2
2020,192925,42,3,40,11,29
2020,192925,42,4,1,0,1
2020,193016,0,0,225,84,141
2020,193016,10,0,225,84,141
2020,193016,10,1,28,12,16
2020,193016,10,2,68,28,40
2020,193016,10,3,112,37,75
2020,193016,10,4,17,7,10
2020,193016,20,0,68,28,40
2020,193016,20,1,23,12,11
2020,193016,20,2,38,14,24
2020,193016,20,3,7,2,5
2020,193016,30,0,25,11,14
2020,193016,30,1,2,0,2
2020,193016,30,2,3,2,1
2020,193016,30,3,20,9,11
2020,193016,40,0,132,45,87
2020,193016,40,1,3,0,3
2020,193016,40,2,27,12,15
2020,193016,40,3,85,26,59
2020,193016,40,4,17,7,10
2020,193016,41,0,118,37,81
2020,193016,41,1,3,0,3
2020,193016,41,2,27,12,15
2020,193016,41,3,75,21,54
2020,193016,41,4,13,4,9
2020,193016,42,0,14,8,6
2020,193016,42,3,10,5,5
2020,193016,42,4,4,3,1
2020,193016,44,0,118,37,81
2020,193016,44,1,3,0,3
2020,193016,44,2,27,12,15
2020,193016,44,3,75,21,54
2020,193016,44,4,13,4,9
2020,193201,0,0,9,2,7
2020,193201,50,0,9,2,7
2020,193247,0,0,16,16,0
2020,193247,10,0,16,16,0
2020,193247,10,1,3,3,0
2020,193247,10,2,4,4,0
2020,193247,10,3,3,3,0
2020,193247,10,5,6,6,0
2020,193247,20,0,16,16,0
2020,193247,20,1,3,3,0
2020,193247,20,2,4,4,0
2020,193247,20,3,3,3,0
2020,193247,20,5,6,6,0
2020,193283,0,0,122,71,51
2020,193283,10,0,122,71,51
2020,193283,10,1,21,12,9
2020,193283,10,2,36,23,13
2020,193283,10,3,32,16,16
2020,193283,10,4,33,20,13
2020,193283,20,0,91,54,37
2020,193283,20,1,21,12,9
2020,193283,20,2,36,23,13
2020,193283,20,3,30,16,14
2020,193283,20,4,4,3,1
2020,193283,30,0,27,15,12
2020,193283,30,3,2,0,2
2020,193283,30,4,25,15,10
2020,193283,40,0,4,2,2
2020,193283,40,4,4,2,2
2020,193283,42,0,3,2,1
2020,193283,42,4,3,2,1
2020,193283,43,0,1,0,1
2020,193283,43,4,1,0,1
2020,193292,0,0,187,52,135
2020,193292,10,0,187,52,135
2020,193292,10,1,52,13,39
2020,193292,10,2,52,14,38
2020,193292,10,3,71,18,53
2020,193292,10,4,12,7,5
2020,193292,20,0,123,30,93
2020,193292,20,1,52,13,39
2020,193292,20,2,48,13,35
2020,193292,20,3,23,4,19
2020,193292,30,0,64,22,42
2020,193292,30,2,4,1,3
2020,193292,30,3,48,14,34
2020,193292,30,4,12,7,5
2020,193308,0,0,250,97,153
2020,193308,10,0,250,97,153
2020,193308,10,4,250,97,153
2020,193308,40,0,250,97,153
2020,193308,40,4,250,97,153
2020,193308,41,0,250,97,153
2020,193308,41,4,250,97,153
2020,193308,45,0,250,97,153
2020,193308,45,4,250,97,153
2020,193326,0,0,245,108,137
2020,193326,10,0,245,108,137
2020,193326,10,1,79,28,51
2020,193326,10,2,86,40,46
2020,193326,10,3,51,24,27
2020,193326,10,4,19,9,10
2020,193326,10,5,10,7,3
2020,193326,20,0,196,82,114
2020,193326,20,1,76,28,48
2020,193326,20,2,80,36,44
2020,193326,20,3,40,18,22
2020,193326,30,0,32,14,18
2020,193326,30,1,3,0,3
2020,193326,30,2,4,3,1
2020,193326,30,3,10,5,5
2020,193326,30,4,14,5,9
2020,193326,30,5,1,1,0
2020,193326,40,0,17,12,5
2020,193326,40,2,2,1,1
2020,193326,40,3,1,1,0
2020,193326,40,4,5,4,1
2020,193326,40,5,9,6,3
2020,193326,42,0,17,12,5
2020,193326,42,2,2,1,1
2020,193326,42,3,1,1,0
2020,193326,42,4,5,4,1
2020,193326,42,5,9,6,3
2020,193353,0,0,86,37,49
2020,193353,10,0,86,37,49
2020,193353,10,1,23,13,10
2020,193353,10,2,29,12,17
2020,193353,10,3,22,10,12
2020,193353,10,4,10,1,9
2020,193353,10,5,2,1,1
2020,193353,20,0,50,25,25
2020,193353,20,1,23,13,10
2020,193353,20,2,27,12,15
2020,193353,30,0,34,11,23
2020,193353,30,2,2,0,2
2020,193353,30,3,22,10,12
2020,193353,30,4,10,1,9
2020,193353,40,0,2,1,1
2020,193353,40,5,2,1,1
2020,193353,42,0,2,1,1
2020,193353,42,5,2,1,1
2020,193399,0,0,76,34,42
2020,193399,10,0,76,34,42
2020,193399,10,1,13,8,5
2020,193399,10,2,32,13,19
2020,193399,10,3,24,12,12
2020,193399,10,4,7,1,6
2020,193399,20,0,42,22,20
2020,193399,20,1,13,8,5
2020,193399,20,2,27,13,14
2020,193399,20,3,2,1,1
2020,193399,30,0,24,9,15
2020,193399,30,2,5,0,5
2020,193399,30,3,18,9,9
2020,193399,30,4,1,0,1
2020,193399,40,0,10,3,7
2020,193399,40,3,4,2,2
2020,193399,40,4,6,1,5
2020,193399,42,0,10,3,7
2020,193399,42,3,4,2,2
2020,193399,42,4,6,1,5
2020,193405,0,0,3415,1825,1590
2020,193405,10,0,3415,1825,1590
2020,193405,10,1,470,326,144
2020,193405,10,2,584,363,221
2020,193405,10,3,1990,967,1023
2020,193405,10,4,371,169,202
2020,193405,20,0,248,165,83
2020,193405,20,1,223,149,74
2020,193405,20,2,25,16,9
2020,193405,30,0,2033,1096,937
2020,193405,30,1,198,141,57
2020,193405,30,2,399,245,154
2020,193405,30,3,1402,700,702
2020,193405,30,4,34,10,24
2020,193405,40,0,1134,564,570
2020,193405,40,1,49,36,13
2020,193405,40,2,160,102,58
2020,193405,40,3,588,267,321
2020,193405,40,4,337,159,178
2020,193405,42,0,1134,564,570
2020,193405,42,1,49,36,13
2020,193405,42,2,160,102,58
2020,193405,42,3,588,267,321
2020,193405,42,4,337,159,178
2020,193478,0,0,355,134,221
2020,193478,10,0,355,134,221
2020,193478,10,1,139,53,86
2020,193478,10,2,93,31,62
2020,193478,10,3,71,39,32
2020,193478,10,4,33,11,22
2020,193478,10,5,11,0,11
2020,193478,10,6,8,0,8
2020,193478,20,0,315,122,193
2020,193478,20,1,138,52,86
2020,193478,20,2,93,31,62
2020,193478,20,3,71,39,32
2020,193478,20,5,11,0,11
2020,193478,20,6,2,0,2
2020,193478,30,0,27,9,18
2020,193478,30,1,1,1,0
2020,193478,30,4,26,8,18
2020,193478,40,0,13,3,10
2020,193478,40,4,7,3,4
2020,193478,40,6,6,0,6
2020,193478,42,0,13,3,10
2020,193478,42,4,7,3,4
2020,193478,42,6,6,0,6
2020,193584,0,0,183,71,112
2020,193584,10,0,183,71,112
2020,193584,10,1,68,31,37
2020,193584,10,2,45,18,27
2020,193584,10,3,68,21,47
2020,193584,10,4,2,1,1
2020,193584,20,0,105,47,58
2020,193584,20,1,68,31,37
2020,193584,20,2,32,14,18
2020,193584,20,3,5,2,3
2020,193584,30,0,29,9,20
2020,193584,30,2,1,1,0
2020,193584,30,3,28,8,20
2020,193584,40,0,49,15,34
2020,193584,40,2,12,3,9
2020,193584,40,3,35,11,24
2020,193584,40,4,2,1,1
2020,193584,42,0,49,15,34
2020,193584,42,2,12,3,9
2020,193584,42,3,35,11,24
2020,193584,42,4,2,1,1
2020,193654,0,0,406,197,209
2020,193654,10,0,397,192,205
2020,193654,10,1,93,52,41
2020,193654,10,2,148,74,74
2020,193654,10,3,154,65,89
2020,193654,10,4,1,1,0
2020,193654,10,5,1,0,1
2020,193654,20,0,139,73,66
2020,193654,20,1,68,39,29
2020,193654,20,2,71,34,37
2020,193654,30,0,38,17,21
2020,193654,30,2,3,3,0
2020,193654,30,3,35,14,21
2020,193654,40,0,220,102,118
2020,193654,40,1,25,13,12
2020,193654,40,2,74,37,37
2020,193654,40,3,119,51,68
2020,193654,40,4,1,1,0
2020,193654,40,5,1,0,1
2020,193654,41,0,202,93,109
2020,193654,41,1,22,12,10
2020,193654,41,2,73,36,37
2020,193654,41,3,106,45,61
2020,193654,41,5,1,0,1
2020,193654,42,0,16,8,8
2020,193654,42,1,3,1,2
2020,193654,42,2,1,1,0
2020,193654,42,3,11,5,6
2020,193654,42,4,1,1,0
2020,193654,43,0,2,1,1
2020,193654,43,3,2,1,1
2020,193654,44,0,202,93,109
2020,193654,44,1,22,12,10
2020,193654,44,2,73,36,37
2020,193654,44,3,106,45,61
2020,193654,44,5,1,0,1
2020,193654,50,0,9,5,4
2020,193751,0,0,43,25,18
2020,193751,10,0,40,23,17
2020,193751,10,1,10,6,4
2020,193751,10,2,13,7,6
2020,193751,10,3,11,7,4
2020,193751,10,4,6,3,3
2020,193751,40,0,40,23,17
2020,193751,40,1,10,6,4
2020,193751,40,2,13,7,6
2020,193751,40,3,11,7,4
2020,193751,40,4,6,3,3
2020,193751,41,0,38,22,16
2020,193751,41,1,10,6,4
2020,193751,41,2,13,7,6
2020,193751,41,3,11,7,4
2020,193751,41,4,4,2,2
2020,193751,42,0,2,1,1
2020,193751,42,4,2,1,1
2020,193751,44,0,38,22,16
2020,193751,44,1,10,6,4
2020,193751,44,2,13,7,6
2020,193751,44,3,11,7,4
2020,193751,44,4,4,2,2
2020,193751,50,0,3,2,1
2020,193821,0,0,45,24,21
2020,193821,10,0,45,24,21
2020,193821,10,1,32,19,13
2020,193821,10,2,7,2,5
2020,193821,10,3,2,0,2
2020,193821,10,4,4,3,1
2020,193821,20,0,29,17,12
2020,193821,20,1,29,17,12
2020,193821,30,0,1,1,0
2020,193821,30,2,1,1,0
2020,193821,40,0,15,6,9
2020,193821,40,1,3,2,1
2020,193821,40,2,6,1,5
2020,193821,40,3,2,0,2
2020,193821,40,4,4,3,1
2020,193821,41,0,1,0,1
2020,193821,41,2,1,0,1
2020,193821,42,0,14,6,8
2020,193821,42,1,3,2,1
2020,193821,42,2,5,1,4
2020,193821,42,3,2,0,2
2020,193821,42,4,4,3,1
2020,193821,44,0,1,0,1
2020,193821,44,2,1,0,1
2020,193830,0,0,337,239,98
2020,193830,10,0,337,239,98
2020,193830,10,1,117,99,18
2020,193830,10,2,64,47,17
2020,193830,10,3,132,78,54
2020,193830,10,4,24,15,9
2020,193830,20,0,72,61,11
2020,193830,20,1,63,55,8
2020,193830,20,2,9,6,3
2020,193830,30,0,265,178,87
2020,193830,30,1,54,44,10
2020,193830,30,2,55,41,14
2020,193830,30,3,132,78,54
2020,193830,30,4,24,15,9
2020,193858,0,0,2,1,1
2020,193858,10,0,2,1,1
2020,193858,10,4,2,1,1
2020,193858,40,0,2,1,1
2020,193858,40,4,2,1,1
2020,193858,43,0,2,1,1
2020,193858,43,4,2,1,1
2020,193894,0,0,11,7,4
2020,193894,10,0,11,7,4
2020,193894,10,1,5,4,1
2020,193894,10,2,4,2,2
2020,193894,10,3,2,1,1
2020,193894,40,0,11,7,4
2020,193894,40,1,5,4,1
2020,193894,40,2,4,2,2
2020,193894,40,3,2,1,1
2020,193894,41,0,9,5,4
2020,193894,41,1,3,2,1
2020,193894,41,2,4,2,2
2020,193894,41,3,2,1,1
2020,193894,42,0,2,2,0
2020,193894,42,1,2,2,0
2020,193894,44,0,9,5,4
2020,193894,44,1,3,2,1
2020,193894,44,2,4,2,2
2020,193894,44,3,2,1,1
2020,193900,0,0,5908,3335,2573
2020,193900,10,0,5908,3335,2573
2020,193900,10,1,1484,1036,448
2020,193900,10,2,1032,606,426
2020,193900,10,3,1624,793,831
2020,193900,10,4,508,287,221
2020,193900,10,5,1178,584,594
2020,193900,10,6,82,29,53
2020,193900,20,0,1531,1014,517
2020,193900,20,1,1048,743,305
2020,193900,20,2,458,260,198
2020,193900,20,3,1,0,1
2020,193900,20,6,24,11,13
2020,193900,30,0,421,217,204
2020,193900,30,1,15,8,7
2020,193900,30,2,62,41,21
2020,193900,30,3,310,158,152
2020,193900,30,6,34,10,24
2020,193900,40,0,3956,2104,1852
2020,193900,40,1,421,285,136
2020,193900,40,2,512,305,207
2020,193900,40,3,1313,635,678
2020,193900,40,4,508,287,221
2020,193900,40,5,1178,584,594
2020,193900,40,6,24,8,16
2020,193900,41,0,3956,2104,1852
2020,193900,41,1,421,285,136
2020,193900,41,2,512,305,207
2020,193900,41,3,1313,635,678
2020,193900,41,4,508,287,221
2020,193900,41,5,1178,584,594
2020,193900,41,6,24,8,16
2020,193900,45,0,3956,2104,1852
2020,193900,45,1,421,285,136
2020,193900,45,2,512,305,207
2020,193900,45,3,1313,635,678
2020,193900,45,4,508,287,221
2020,193900,45,5,1178,584,594
2020,193900,45,6,24,8,16
2020,193946,0,0,88,39,49
2020,193946,10,0,88,39,49
2020,193946,10,1,46,20,26
2020,193946,10,2,18,9,9
2020,193946,10,3,9,3,6
2020,193946,10,4,15,7,8
2020,193946,20,0,71,31,40
2020,193946,20,1,46,20,26
2020,193946,20,2,18,9,9
2020,193946,20,3,7,2,5
2020,193946,30,0,17,8,9
2020,193946,30,3,2,1,1
2020,193946,30,4,15,7,8
2020,193973,0,0,159,88,71
2020,193973,10,0,159,88,71
2020,193973,10,1,46,29,17
2020,193973,10,2,62,36,26
2020,193973,10,3,30,15,15
2020,193973,10,4,7,2,5
2020,193973,10,6,14,6,8
2020,193973,20,0,106,63,43
2020,193973,20,1,46,29,17
2020,193973,20,2,60,34,26
2020,193973,30,0,33,18,15
2020,193973,30,2,2,2,0
2020,193973,30,3,30,15,15
2020,193973,30,4,1,1,0
2020,193973,40,0,20,7,13
2020,193973,40,4,6,1,5
2020,193973,40,6,14,6,8
2020,193973,41,0,9,3,6
2020,193973,41,6,9,3,6
2020,193973,42,0,11,4,7
2020,193973,42,4,6,1,5
2020,193973,42,6,5,3,2
2020,193973,44,0,9,3,6
2020,193973,44,6,9,3,6
2020,194028,0,0,48,18,30
2020,194028,10,0,40,14,26
2020,194028,10,1,4,0,4
2020,194028,10,2,7,2,5
2020,194028,10,3,7,4,3
2020,194028,10,4,22,8,14
2020,194028,20,0,20,5,15
2020,194028,20,1,4,0,4
2020,194028,20,2,7,2,5
2020,194028,20,3,5,2,3
2020,194028,20,4,4,1,3
2020,194028,30,0,11,5,6
2020,194028,30,3,2,2,0
2020,194028,30,4,9,3,6
2020,194028,40,0,9,4,5
2020,194028,40,4,9,4,5
2020,194028,41,0,9,4,5
2020,194028,41,4,9,4,5
2020,194028,45,0,9,4,5
2020,194028,45,4,9,4,5
2020,194028,50,0,8,4,4
2020,194073,0,0,30,16,14
2020,194073,10,0,30,16,14
2020,194073,10,1,10,8,2
2020,194073,10,2,8,4,4
2020,194073,10,3,3,1,2
2020,194073,10,4,9,3,6
2020,194073,40,0,30,16,14
2020,194073,40,1,10,8,2
2020,194073,40,2,8,4,4
2020,194073,40,3,3,1,2
2020,194073,40,4,9,3,6
2020,194073,42,0,30,16,14
2020,194073,42,1,10,8,2
2020,194073,42,2,8,4,4
2020,194073,42,3,3,1,2
2020,194073,42,4,9,3,6
2020,194091,0,0,342,201,141
2020,194091,10,0,339,198,141
2020,194091,10,1,60,45,15
2020,194091,10,2,151,82,69
2020,194091,10,3,119,63,56
2020,194091,10,4,8,8,0
2020,194091,10,6,1,0,1
2020,194091,20,0,144,90,54
2020,194091,20,1,51,38,13
2020,194091,20,2,91,50,41
2020,194091,20,3,2,2,0
2020,194091,30,0,64,35,29
2020,194091,30,1,1,0,1
2020,194091,30,2,8,5,3
2020,194091,30,3,54,29,25
2020,194091,30,4,1,1,0
2020,194091,40,0,131,73,58
2020,194091,40,1,8,7,1
2020,194091,40,2,52,27,25
2020,194091,40,3,63,32,31
2020,194091,40,4,7,7,0
2020,194091,40,6,1,0,1
2020,194091,41,0,131,73,58
2020,194091,41,1,8,7,1
2020,194091,41,2,52,27,25
2020,194091,41,3,63,32,31
2020,194091,41,4,7,7,0
2020,194091,41,6,1,0,1
2020,194091,44,0,131,73,58
2020,194091,44,1,8,7,1
2020,194091,44,2,52,27,25
2020,194091,44,3,63,32,31
2020,194091,44,4,7,7,0
2020,194091,44,6,1,0,1
2020,194091,50,0,3,3,0
2020,194161,0,0,54,29,25
2020,194161,10,0,54,29,25
2020,194161,10,1,22,10,12
2020,194161,10,2,14,9,5
2020,194161,10,3,13,7,6
2020,194161,10,5,5,3,2
2020,194161,20,0,14,8,6
2020,194161,20,1,13,7,6
2020,194161,20,2,1,1,0
2020,194161,30,0,35,18,17
2020,194161,30,1,9,3,6
2020,194161,30,2,13,8,5
2020,194161,30,3,13,7,6
2020,194161,40,0,5,3,2
2020,194161,40,5,5,3,2
2020,194161,42,0,5,3,2
2020,194161,42,5,5,3,2
2020,194222,0,0,173,77,96
2020,194222,10,0,173,77,96
2020,194222,10,1,81,31,50
2020,194222,10,2,49,18,31
2020,194222,10,3,31,20,11
2020,194222,10,4,5,3,2
2020,194222,10,6,7,5,2
2020,194222,20,0,142,60,82
2020,194222,20,1,81,31,50
2020,194222,20,2,48,18,30
2020,194222,20,3,8,8,0
2020,194222,20,4,5,3,2
2020,194222,30,0,22,10,12
2020,194222,30,2,1,0,1
2020,194222,30,3,21,10,11
2020,194222,40,0,9,7,2
2020,194222,40,3,2,2,0
2020,194222,40,6,7,5,2
2020,194222,41,0,8,7,1
2020,194222,41,3,2,2,0
2020,194222,41,6,6,5,1
2020,194222,42,0,1,0,1
2020,194222,42,6,1,0,1
2020,194222,44,0,8,7,1
2020,194222,44,3,2,2,0
2020,194222,44,6,6,5,1
2020,194240,0,0,127,56,71
2020,194240,10,0,127,56,71
2020,194240,10,1,43,21,22
2020,194240,10,2,32,13,19
2020,194240,10,3,27,12,15
2020,194240,10,4,25,10,15
2020,194240,20,0,107,48,59
2020,194240,20,1,43,21,22
2020,194240,20,2,31,13,18
2020,194240,20,3,27,12,15
2020,194240,20,4,6,2,4
2020,194240,30,0,16,7,9
2020,194240,30,4,16,7,9
2020,194240,40,0,4,1,3
2020,194240,40,2,1,0,1
2020,194240,40,4,3,1,2
2020,194240,42,0,4,1,3
2020,194240,42,2,1,0,1
2020,194240,42,4,3,1,2
2020,194310,0,0,479,207,272
2020,194310,10,0,479,207,272
2020,194310,10,1,191,101,90
2020,194310,10,2,139,54,85
2020,194310,10,3,110,39,71
2020,194310,10,4,1,1,0
2020,194310,10,5,38,12,26
2020,194310,20,0,288,136,152
2020,194310,20,1,175,89,86
2020,194310,20,2,105,43,62
2020,194310,20,3,8,4,4
2020,194310,30,0,71,23,48
2020,194310,30,2,5,2,3
2020,194310,30,3,66,21,45
2020,194310,40,0,120,48,72
2020,194310,40,1,16,12,4
2020,194310,40,2,29,9,20
2020,194310,40,3,36,14,22
2020,194310,40,4,1,1,0
2020,194310,40,5,38,12,26
2020,194310,42,0,120,48,72
2020,194310,42,1,16,12,4
2020,194310,42,2,29,9,20
2020,194310,42,3,36,14,22
2020,194310,42,4,1,1,0
2020,194310,42,5,38,12,26
2020,194392,0,0,51,27,24
2020,194392,10,0,45,24,21
2020,194392,10,1,19,10,9
2020,194392,10,2,10,6,4
2020,194392,10,3,9,5,4
2020,194392,10,4,6,3,3
2020,194392,10,6,1,0,1
2020,194392,40,0,45,24,21
2020,194392,40,1,19,10,9
2020,194392,40,2,10,6,4
2020,194392,40,3,9,5,4
2020,194392,40,4,6,3,3
2020,194392,40,6,1,0,1
2020,194392,41,0,26,13,13
2020,194392,41,1,12,7,5
2020,194392,41,2,8,4,4
2020,194392,41,3,6,2,4
2020,194392,42,0,11,8,3
2020,194392,42,2,2,2,0
2020,194392,42,3,3,3,0
2020,194392,42,4,6,3,3
2020,194392,43,0,8,3,5
2020,194392,43,1,7,3,4
2020,194392,43,6,1,0,1
2020,194392,44,0,26,13,13
2020,194392,44,1,12,7,5
2020,194392,44,2,8,4,4
2020,194392,44,3,6,2,4
2020,194392,50,0,6,3,3
2020,194499,0,0,20,5,15
2020,194499,10,0,20,5,15
2020,194499,10,6,20,5,15
2020,194499,40,0,20,5,15
2020,194499,40,6,20,5,15
2020,194499,43,0,20,5,15
2020,194499,43,6,20,5,15
2020,194578,0,0,169,83,86
2020,194578,10,0,169,83,86
2020,194578,10,1,86,44,42
2020,194578,10,2,52,28,24
2020,194578,10,3,31,11,20
2020,194578,20,0,114,58,56
2020,194578,20,1,78,40,38
2020,194578,20,2,34,18,16
2020,194578,20,3,2,0,2
2020,194578,30,0,50,23,27
2020,194578,30,1,8,4,4
2020,194578,30,2,17,10,7
2020,194578,30,3,25,9,16
2020,194578,40,0,5,2,3
2020,194578,40,2,1,0,1
2020,194578,40,3,4,2,2
2020,194578,41,0,5,2,3
2020,194578,41,2,1,0,1
2020,194578,41,3,4,2,2
2020,194578,44,0,5,2,3
2020,194578,44,2,1,0,1
2020,194578,44,3,4,2,2
2020,194666,0,0,11,11,0
2020,194666,10,0,11,11,0
2020,194666,10,4,11,11,0
2020,194666,40,0,11,11,0
2020,194666,40,4,11,11,0
2020,194666,41,0,11,11,0
2020,194666,41,4,11,11,0
2020,194666,45,0,11,11,0
2020,194666,45,4,11,11,0
2020,194736,0,0,8,8,0
2020,194736,10,0,8,8,0
2020,194736,10,4,8,8,0
2020,194736,40,0,8,8,0
2020,194736,40,4,8,8,0
2020,194736,42,0,8,8,0
2020,194736,42,4,8,8,0
2020,194763,0,0,13,13,0
2020,194763,10,0,13,13,0
2020,194763,10,1,3,3,0
2020,194763,10,2,6,6,0
2020,194763,10,3,4,4,0
2020,194763,20,0,13,13,0
2020,194763,20,1,3,3,0
2020,194763,20,2,6,6,0
2020,194763,20,3,4,4,0
2020,194824,0,0,414,309,105
2020,194824,10,0,409,307,102
2020,194824,10,1,173,146,27
2020,194824,10,2,76,50,26
2020,194824,10,3,57,41,16
2020,194824,10,5,103,70,33
2020,194824,20,0,233,182,51
2020,194824,20,1,158,133,25
2020,194824,20,2,75,49,26
2020,194824,30,0,58,42,16
2020,194824,30,2,1,1,0
2020,194824,30,3,57,41,16
2020,194824,40,0,118,83,35
2020,194824,40,1,15,13,2
2020,194824,40,5,103,70,33
2020,194824,41,0,118,83,35
2020,194824,41,1,15,13,2
2020,194824,41,5,103,70,33
2020,194824,44,0,118,83,35
2020,194824,44,1,15,13,2
2020,194824,44,5,103,70,33
2020,194824,50,0,5,2,3
2020,194958,0,0,86,31,55
2020,194958,10,0,86,31,55
2020,194958,10,1,38,21,17
2020,194958,10,2,24,5,19
2020,194958,10,3,21,5,16
2020,194958,10,5,3,0,3
2020,194958,20,0,52,22,30
2020,194958,20,1,36,20,16
2020,194958,20,2,15,2,13
2020,194958,20,3,1,0,1
2020,194958,30,0,28,9,19
2020,194958,30,1,2,1,1
2020,194958,30,2,9,3,6
2020,194958,30,3,17,5,12
2020,194958,40,0,6,0,6
2020,194958,40,3,3,0,3
2020,194958,40,5,3,0,3
2020,194958,42,0,6,0,6
2020,194958,42,3,3,0,3
2020,194958,42,5,3,0,3
2020,195003,0,0,1012,637,375
2020,195003,10,0,1012,637,375
2020,195003,10,1,254,187,67
2020,195003,10,2,259,163,96
2020,195003,10,3,176,101,75
2020,195003,10,5,323,186,137
2020,195003,20,0,517,353,164
2020,195003,20,1,251,185,66
2020,195003,20,2,257,163,94
2020,195003,20,3,9,5,4
2020,195003,30,0,155,92,63
2020,195003,30,1,1,0,1
2020,195003,30,2,2,0,2
2020,195003,30,3,152,92,60
2020,195003,40,0,340,192,148
2020,195003,40,1,2,2,0
2020,195003,40,3,15,4,11
2020,195003,40,5,323,186,137
2020,195003,41,0,164,89,75
2020,195003,41,3,1,1,0
2020,195003,41,5,163,88,75
2020,195003,42,0,176,103,73
2020,195003,42,1,2,2,0
2020,195003,42,3,14,3,11
2020,195003,42,5,160,98,62
2020,195003,44,0,164,89,75
2020,195003,44,3,1,1,0
2020,195003,44,5,163,88,75
2020,195030,0,0,2492,1483,1009
2020,195030,10,0,2492,1483,1009
2020,195030,10,1,687,513,174
2020,195030,10,2,653,389,264
2020,195030,10,3,809,436,373
2020,195030,10,4,231,106,125
2020,195030,10,5,30,15,15
2020,195030,10,6,82,24,58
2020,195030,20,0,591,433,158
2020,195030,20,1,423,326,97
2020,195030,20,2,168,107,61
2020,195030,30,0,770,425,345
2020,195030,30,1,91,65,26
2020,195030,30,2,132,76,56
2020,195030,30,3,461,249,212
2020,195030,30,4,86,35,51
2020,195030,40,0,1131,625,506
2020,195030,40,1,173,122,51
2020,195030,40,2,353,206,147
2020,195030,40,3,348,187,161
2020,195030,40,4,145,71,74
2020,195030,40,5,30,15,15
2020,195030,40,6,82,24,58
2020,195030,41,0,1093,613,480
2020,195030,41,1,173,122,51
2020,195030,41,2,352,206,146
2020,195030,41,3,347,186,161
2020,195030,41,4,140,68,72
2020,195030,41,5,15,8,7
2020,195030,41,6,66,23,43
2020,195030,42,0,36,11,25
2020,195030,42,2,1,0,1
2020,195030,42,3,1,1,0
2020,195030,42,4,3,2,1
2020,195030,42,5,15,7,8
2020,195030,42,6,16,1,15
2020,195030,43,0,2,1,1
2020,195030,43,4,2,1,1
2020,195030,44,0,1093,613,480
2020,195030,44,1,173,122,51
2020,195030,44,2,352,206,146
2020,195030,44,3,347,186,161
2020,195030,44,4,140,68,72
2020,195030,44,5,15,8,7
2020,195030,44,6,66,23,43
2020,195049,0,0,72,51,21
2020,195049,10,0,72,51,21
2020,195049,10,1,35,31,4
2020,195049,10,2,16,7,9
2020,195049,10,3,19,11,8
2020,195049,10,6,2,2,0
2020,195049,20,0,34,31,3
2020,195049,20,1,34,31,3
2020,195049,30,0,17,10,7
2020,195049,30,2,5,3,2
2020,195049,30,3,12,7,5
2020,195049,40,0,21,10,11
2020,195049,40,1,1,0,1
2020,195049,40,2,11,4,7
2020,195049,40,3,7,4,3
2020,195049,40,6,2,2,0
2020,195049,41,0,19,8,11
2020,195049,41,1,1,0,1
2020,195049,41,2,11,4,7
2020,195049,41,3,7,4,3
2020,195049,42,0,2,2,0
2020,195049,42,6,2,2,0
2020,195049,44,0,19,8,11
2020,195049,44,1,1,0,1
2020,195049,44,2,11,4,7
2020,195049,44,3,7,4,3
2020,195058,0,0,89,37,52
2020,195058,10,0,89,37,52
2020,195058,10,1,21,6,15
2020,195058,10,2,20,9,11
2020,195058,10,3,25,8,17
2020,195058,10,4,10,7,3
2020,195058,10,5,13,7,6
2020,195058,20,0,59,22,37
2020,195058,20,1,21,6,15
2020,195058,20,2,20,9,11
2020,195058,20,3,18,7,11
2020,195058,30,0,21,12,9
2020,195058,30,3,7,1,6
2020,195058,30,4,10,7,3
2020,195058,30,5,4,4,0
2020,195058,40,0,9,3,6
2020,195058,40,5,9,3,6
2020,195058,42,0,9,3,6
2020,195058,42,5,9,3,6
2020,195128,0,0,115,26,89
2020,195128,10,0,115,26,89
2020,195128,10,1,14,5,9
2020,195128,10,2,39,9,30
2020,195128,10,3,47,10,37
2020,195128,10,4,1,0,1
2020,195128,10,5,14,2,12
2020,195128,20,0,45,14,31
2020,195128,20,1,14,5,9
2020,195128,20,2,31,9,22
2020,195128,30,0,14,5,9
2020,195128,30,3,14,5,9
2020,195128,40,0,56,7,49
2020,195128,40,2,8,0,8
2020,195128,40,3,33,5,28
2020,195128,40,4,1,0,1
2020,195128,40,5,14,2,12
2020,195128,41,0,43,4,39
2020,195128,41,2,8,0,8
2020,195128,41,3,32,4,28
2020,195128,41,5,3,0,3
2020,195128,42,0,13,3,10
2020,195128,42,3,1,1,0
2020,195128,42,4,1,0,1
2020,195128,42,5,11,2,9
2020,195128,44,0,43,4,39
2020,195128,44,2,8,0,8
2020,195128,44,3,32,4,28
2020,195128,44,5,3,0,3
2020,195164,0,0,149,78,71
2020,195164,10,0,149,78,71
2020,195164,10,1,25,18,7
2020,195164,10,2,33,22,11
2020,195164,10,3,64,24,40
2020,195164,10,5,21,14,7
2020,195164,10,6,6,0,6
2020,195164,20,0,66,41,25
2020,195164,20,1,25,18,7
2020,195164,20,2,29,19,10
2020,195164,20,3,12,4,8
2020,195164,30,0,52,22,30
2020,195164,30,2,4,3,1
2020,195164,30,3,48,19,29
2020,195164,40,0,31,15,16
2020,195164,40,3,4,1,3
2020,195164,40,5,21,14,7
2020,195164,40,6,6,0,6
2020,195164,42,0,31,15,16
2020,195164,42,3,4,1,3
2020,195164,42,5,21,14,7
2020,195164,42,6,6,0,6
2020,195173,0,0,97,44,53
2020,195173,10,0,97,44,53
2020,195173,10,1,24,13,11
2020,195173,10,2,20,9,11
2020,195173,10,3,37,12,25
2020,195173,10,5,16,10,6
2020,195173,20,0,45,22,23
2020,195173,20,1,24,13,11
2020,195173,20,2,20,9,11
2020,195173,20,3,1,0,1
2020,195173,30,0,36,12,24
2020,195173,30,3,36,12,24
2020,195173,40,0,16,10,6
2020,195173,40,5,16,10,6
2020,195173,42,0,16,10,6
2020,195173,42,5,16,10,6
2020,195191,0,0,22,6,16
2020,195191,10,0,22,6,16
2020,195191,10,1,1,0,1
2020,195191,10,2,5,1,4
2020,195191,10,3,11,2,9
2020,195191,10,4,5,3,2
2020,195191,40,0,22,6,16
2020,195191,40,1,1,0,1
2020,195191,40,2,5,1,4
2020,195191,40,3,11,2,9
2020,195191,40,4,5,3,2
2020,195191,41,0,22,6,16
2020,195191,41,1,1,0,1
2020,195191,41,2,5,1,4
2020,195191,41,3,11,2,9
2020,195191,41,4,5,3,2
2020,195191,45,0,22,6,16
2020,195191,45,1,1,0,1
2020,195191,45,2,5,1,4
2020,195191,45,3,11,2,9
2020,195191,45,4,5,3,2
2020,195216,0,0,178,82,96
2020,195216,10,0,178,82,96
2020,195216,10,1,44,21,23
2020,195216,10,2,75,36,39
2020,195216,10,3,56,25,31
2020,195216,10,4,3,0,3
2020,195216,20,0,118,57,61
2020,195216,20,1,43,21,22
2020,195216,20,2,75,36,39
2020,195216,30,0,42,18,24
2020,195216,30,3,42,18,24
2020,195216,40,0,18,7,11
2020,195216,40,1,1,0,1
2020,195216,40,3,14,7,7
2020,195216,40,4,3,0,3
2020,195216,42,0,18,7,11
2020,195216,42,1,1,0,1
2020,195216,42,3,14,7,7
2020,195216,42,4,3,0,3
2020,195234,0,0,163,68,95
2020,195234,10,0,163,68,95
2020,195234,10,1,40,15,25
2020,195234,10,2,66,32,34
2020,195234,10,3,50,19,31
2020,195234,10,4,7,2,5
2020,195234,20,0,112,50,62
2020,195234,20,1,40,15,25
2020,195234,20,2,65,31,34
2020,195234,20,3,7,4,3
2020,195234,30,0,33,12,21
2020,195234,30,2,1,1,0
2020,195234,30,3,32,11,21
2020,195234,40,0,18,6,12
2020,195234,40,3,11,4,7
2020,195234,40,4,7,2,5
2020,195234,42,0,18,6,12
2020,195234,42,3,11,4,7
2020,195234,42,4,7,2,5
2020,195243,0,0,50,18,32
2020,195243,10,0,50,18,32
2020,195243,10,1,18,7,11
2020,195243,10,2,12,6,6
2020,195243,10,3,17,3,14
2020,195243,10,4,3,2,1
2020,195243,20,0,29,12,17
2020,195243,20,1,18,7,11
2020,195243,20,2,10,5,5
2020,195243,20,3,1,0,1
2020,195243,30,0,17,4,13
2020,195243,30,2,2,1,1
2020,195243,30,3,15,3,12
2020,195243,40,0,4,2,2
2020,195243,40,3,1,0,1
2020,195243,40,4,3,2,1
2020,195243,42,0,4,2,2
2020,195243,42,3,1,0,1
2020,195243,42,4,3,2,1
2020,195304,0,0,89,50,39
2020,195304,10,0,89,50,39
2020,195304,10,6,89,50,39
2020,195304,20,0,65,38,27
2020,195304,20,6,65,38,27
2020,195304,30,0,16,8,8
2020,195304,30,6,16,8,8
2020,195304,40,0,8,4,4
2020,195304,40,6,8,4,4
2020,195304,42,0,8,4,4
2020,195304,42,6,8,4,4
2020,195322,0,0,44,18,26
2020,195322,10,0,44,18,26
2020,195322,10,1,20,8,12
2020,195322,10,2,11,5,6
2020,195322,10,3,7,4,3
2020,195322,10,4,5,0,5
2020,195322,10,5,1,1,0
2020,195322,20,0,20,6,14
2020,195322,20,1,13,4,9
2020,195322,20,2,6,1,5
2020,195322,20,3,1,1,0
2020,195322,30,0,24,12,12
2020,195322,30,1,7,4,3
2020,195322,30,2,5,4,1
2020,195322,30,3,6,3,3
2020,195322,30,4,5,0,5
2020,195322,30,5,1,1,0
2020,195438,0,0,23,23,0
2020,195438,10,0,23,23,0
2020,195438,10,4,23,23,0
2020,195438,40,0,23,23,0
2020,195438,40,4,23,23,0
2020,195438,42,0,23,23,0
2020,195438,42,4,23,23,0
2020,195474,0,0,209,105,104
2020,195474,10,0,209,105,104
2020,195474,10,1,62,34,28
2020,195474,10,2,76,44,32
2020,195474,10,3,57,23,34
2020,195474,10,4,14,4,10
2020,195474,20,0,138,78,60
2020,195474,20,1,62,34,28
2020,195474,20,2,72,41,31
2020,195474,20,3,4,3,1
2020,195474,30,0,39,19,20
2020,195474,30,2,4,3,1
2020,195474,30,3,35,16,19
2020,195474,40,0,32,8,24
2020,195474,40,3,18,4,14
2020,195474,40,4,14,4,10
2020,195474,42,0,32,8,24
2020,195474,42,3,18,4,14
2020,195474,42,4,14,4,10
2020,195526,0,0,288,130,158
2020,195526,10,0,288,130,158
2020,195526,10,1,65,41,24
2020,195526,10,2,79,30,49
2020,195526,10,3,88,40,48
2020,195526,10,4,10,1,9
2020,195526,10,5,13,3,10
2020,195526,10,6,33,15,18
2020,195526,20,0,134,65,69
2020,195526,20,1,64,40,24
2020,195526,20,2,70,25,45
2020,195526,30,0,59,28,31
2020,195526,30,2,7,3,4
2020,195526,30,3,52,25,27
2020,195526,40,0,95,37,58
2020,195526,40,1,1,1,0
2020,195526,40,2,2,2,0
2020,195526,40,3,36,15,21
2020,195526,40,4,10,1,9
2020,195526,40,5,13,3,10
2020,195526,40,6,33,15,18
2020,195526,41,0,74,26,48
2020,195526,41,1,1,1,0
2020,195526,41,2,2,2,0
2020,195526,41,3,20,6,14
2020,195526,41,4,10,1,9
2020,195526,41,5,10,2,8
2020,195526,41,6,31,14,17
2020,195526,42,0,21,11,10
2020,195526,42,3,16,9,7
2020,195526,42,5,3,1,2
2020,195526,42,6,2,1,1
2020,195526,44,0,72,26,46
2020,195526,44,1,1,1,0
2020,195526,44,2,2,2,0
2020,195526,44,3,20,6,14
2020,195526,44,4,10,1,9
2020,195526,44,5,9,2,7
2020,195526,44,6,30,14,16
2020,195526,45,0,2,0,2
2020,195526,45,5,1,0,1
2020,195526,45,6,1,0,1
2020,195544,0,0,161,67,94
2020,195544,10,0,161,67,94
2020,195544,10,1,33,15,18
2020,195544,10,2,54,20,34
2020,195544,10,3,73,31,42
2020,195544,10,4,1,1,0
2020,195544,20,0,69,30,39
2020,195544,20,1,33,15,18
2020,195544,20,2,36,15,21
2020,195544,30,0,65,26,39
2020,195544,30,2,18,5,13
2020,195544,30,3,46,20,26
2020,195544,30,4,1,1,0
2020,195544,40,0,27,11,16
2020,195544,40,3,27,11,16
2020,195544,42,0,27,11,16
2020,195544,42,3,27,11,16
2020,195580,0,0,6,6,0
2020,195580,10,0,6,6,0
2020,195580,10,1,3,3,0
2020,195580,10,3,2,2,0
2020,195580,10,4,1,1,0
2020,195580,20,0,2,2,0
2020,195580,20,1,2,2,0
2020,195580,30,0,3,3,0
2020,195580,30,1,1,1,0
2020,195580,30,3,2,2,0
2020,195580,40,0,1,1,0
2020,195580,40,4,1,1,0
2020,195580,42,0,1,1,0
2020,195580,42,4,1,1,0
2020,195702,0,0,16,2,14
2020,195702,10,0,16,2,14
2020,195702,10,2,16,2,14
2020,195702,20,0,10,1,9
2020,195702,20,2,10,1,9
2020,195702,30,0,6,1,5
2020,195702,30,2,6,1,5
2020,195720,0,0,216,92,124
2020,195720,10,0,212,91,121
2020,195720,10,1,38,24,14
2020,195720,10,2,105,45,60
2020,195720,10,3,60,20,40
2020,195720,10,4,8,2,6
2020,195720,10,5,1,0,1
2020,195720,20,0,138,67,71
2020,195720,20,1,38,24,14
2020,195720,20,2,96,42,54
2020,195720,20,3,4,1,3
2020,195720,30,0,24,6,18
2020,195720,30,2,4,0,4
2020,195720,30,3,20,6,14
2020,195720,40,0,50,18,32
2020,195720,40,2,5,3,2
2020,195720,40,3,36,13,23
2020,195720,40,4,8,2,6
2020,195720,40,5,1,0,1
2020,195720,41,0,32,11,21
2020,195720,41,2,5,3,2
2020,195720,41,3,24,8,16
2020,195720,41,4,3,0,3
2020,195720,42,0,18,7,11
2020,195720,42,3,12,5,7
2020,195720,42,4,5,2,3
2020,195720,42,5,1,0,1
2020,195720,44,0,30,10,20
2020,195720,44,2,5,3,2
2020,195720,44,3,22,7,15
2020,195720,44,4,3,0,3
2020,195720,45,0,2,1,1
2020,195720,45,3,2,1,1
2020,195720,50,0,4,1,3
2020,195784,0,0,17,6,11
2020,195784,10,0,17,6,11
2020,195784,10,4,17,6,11
2020,195784,40,0,17,6,11
2020,195784,40,4,17,6,11
2020,195784,41,0,17,6,11
2020,195784,41,4,17,6,11
2020,195784,45,0,17,6,11
2020,195784,45,4,17,6,11
2020,195809,0,0,607,322,285
2020,195809,10,0,607,322,285
2020,195809,10,1,198,113,85
2020,195809,10,2,279,150,129
2020,195809,10,3,129,59,70
2020,195809,10,4,1,0,1
2020,195809,20,0,451,253,198
2020,195809,20,1,183,108,75
2020,195809,20,2,268,145,123
2020,195809,30,0,117,53,64
2020,195809,30,1,1,1,0
2020,195809,30,2,6,3,3
2020,195809,30,3,110,49,61
2020,195809,40,0,39,16,23
2020,195809,40,1,14,4,10
2020,195809,40,2,5,2,3
2020,195809,40,3,19,10,9
2020,195809,40,4,1,0,1
2020,195809,42,0,39,16,23
2020,195809,42,1,14,4,10
2020,195809,42,2,5,2,3
2020,195809,42,3,19,10,9
2020,195809,42,4,1,0,1
2020,195988,0,0,33,16,17
2020,195988,10,0,33,16,17
2020,195988,10,1,19,9,10
2020,195988,10,2,10,5,5
2020,195988,10,3,4,2,2
2020,195988,20,0,27,13,14
2020,195988,20,1,19,9,10
2020,195988,20,2,8,4,4
2020,195988,30,0,5,2,3
2020,195988,30,2,1,0,1
2020,195988,30,3,4,2,2
2020,195988,40,0,1,1,0
2020,195988,40,2,1,1,0
2020,195988,42,0,1,1,0
2020,195988,42,2,1,1,0
2020,196006,0,0,178,126,52
2020,196006,10,0,178,126,52
2020,196006,10,1,20,13,7
2020,196006,10,2,34,22,12
2020,196006,10,3,73,47,26
2020,196006,10,4,25,23,2
2020,196006,10,5,26,21,5
2020,196006,20,0,60,42,18
2020,196006,20,1,20,13,7
2020,196006,20,2,28,20,8
2020,196006,20,3,11,8,3
2020,196006,20,4,1,1,0
2020,196006,30,0,89,61,28
2020,196006,30,2,5,2,3
2020,196006,30,3,61,38,23
2020,196006,30,4,23,21,2
2020,196006,40,0,29,23,6
2020,196006,40,2,1,0,1
2020,196006,40,3,1,1,0
2020,196006,40,4,1,1,0
2020,196006,40,5,26,21,5
2020,196006,42,0,13,11,2
2020,196006,42,2,1,0,1
2020,196006,42,3,1,1,0
2020,196006,42,5,11,10,1
2020,196006,43,0,16,12,4
2020,196006,43,4,1,1,0
2020,196006,43,5,15,11,4
2020,196015,0,0,123,68,55
2020,196015,10,0,123,68,55
2020,196015,10,1,25,14,11
2020,196015,10,2,33,19,14
2020,196015,10,3,20,10,10
2020,196015,10,4,4,3,1
2020,196015,10,5,41,22,19
2020,196015,20,0,54,31,23
2020,196015,20,1,25,14,11
2020,196015,20,2,28,17,11
2020,196015,20,3,1,0,1
2020,196015,30,0,28,15,13
2020,196015,30,2,5,2,3
2020,196015,30,3,19,10,9
2020,196015,30,4,4,3,1
2020,196015,40,0,41,22,19
2020,196015,40,5,41,22,19
2020,196015,41,0,38,21,17
2020,196015,41,5,38,21,17
2020,196015,42,0,3,1,2
2020,196015,42,5,3,1,2
2020,196015,44,0,38,21,17
2020,196015,44,5,38,21,17
2020,196024,0,0,144,74,70
2020,196024,10,0,144,74,70
2020,196024,10,1,35,21,14
2020,196024,10,2,44,14,30
2020,196024,10,3,37,21,16
2020,196024,10,4,28,18,10
2020,196024,20,0,72,38,34
2020,196024,20,1,34,20,14
2020,196024,20,2,26,8,18
2020,196024,20,3,10,8,2
2020,196024,20,4,2,2,0
2020,196024,30,0,67,33,34
2020,196024,30,1,1,1,0
2020,196024,30,2,18,6,12
2020,196024,30,3,27,13,14
2020,196024,30,4,21,13,8
2020,196024,40,0,5,3,2
2020,196024,40,4,5,3,2
2020,196024,42,0,4,2,2
2020,196024,42,4,4,2,2
2020,196024,43,0,1,1,0
2020,196024,43,4,1,1,0
2020,196033,0,0,102,63,39
2020,196033,10,0,102,63,39
2020,196033,10,1,29,19,10
2020,196033,10,2,36,20,16
2020,196033,10,3,22,13,9
2020,196033,10,4,12,8,4
2020,196033,10,5,3,3,0
2020,196033,20,0,58,37,21
2020,196033,20,1,28,18,10
2020,196033,20,2,30,19,11
2020,196033,30,0,27,13,14
2020,196033,30,1,1,1,0
2020,196033,30,2,6,1,5
2020,196033,30,3,18,10,8
2020,196033,30,4,2,1,1
2020,196033,40,0,17,13,4
2020,196033,40,3,4,3,1
2020,196033,40,4,10,7,3
2020,196033,40,5,3,3,0
2020,196033,42,0,17,13,4
2020,196033,42,3,4,3,1
2020,196033,42,4,10,7,3
2020,196033,42,5,3,3,0
2020,196042,0,0,268,138,130
2020,196042,10,0,268,138,130
2020,196042,10,1,56,27,29
2020,196042,10,2,52,29,23
2020,196042,10,3,147,76,71
2020,196042,10,5,13,6,7
2020,196042,20,0,106,57,49
2020,196042,20,1,54,26,28
2020,196042,20,2,46,28,18
2020,196042,20,3,6,3,3
2020,196042,30,0,129,62,67
2020,196042,30,1,2,1,1
2020,196042,30,2,5,0,5
2020,196042,30,3,122,61,61
2020,196042,40,0,33,19,14
2020,196042,40,2,1,1,0
2020,196042,40,3,19,12,7
2020,196042,40,5,13,6,7
2020,196042,42,0,33,19,14
2020,196042,42,2,1,1,0
2020,196042,42,3,19,12,7
2020,196042,42,5,13,6,7
2020,196051,0,0,131,71,60
2020,196051,10,0,131,71,60
2020,196051,10,1,23,17,6
2020,196051,10,2,62,30,32
2020,196051,10,3,40,22,18
2020,196051,10,4,6,2,4
2020,196051,20,0,89,50,39
2020,196051,20,1,23,17,6
2020,196051,20,2,62,30,32
2020,196051,20,3,4,3,1
2020,196051,30,0,40,20,20
2020,196051,30,3,36,19,17
2020,196051,30,4,4,1,3
2020,196051,40,0,2,1,1
2020,196051,40,4,2,1,1
2020,196051,42,0,1,0,1
2020,196051,42,4,1,0,1
2020,196051,43,0,1,1,0
2020,196051,43,4,1,1,0
2020,196060,0,0,649,382,267
2020,196060,10,0,649,382,267
2020,196060,10,1,159,109,50
2020,196060,10,2,242,140,102
2020,196060,10,3,152,87,65
2020,196060,10,5,96,46,50
2020,196060,20,0,398,247,151
2020,196060,20,1,158,108,50
2020,196060,20,2,240,139,101
2020,196060,30,0,140,79,61
2020,196060,30,2,1,0,1
2020,196060,30,3,139,79,60
2020,196060,40,0,111,56,55
2020,196060,40,1,1,1,0
2020,196060,40,2,1,1,0
2020,196060,40,3,13,8,5
2020,196060,40,5,96,46,50
2020,196060,41,0,61,28,33
2020,196060,41,3,4,3,1
2020,196060,41,5,57,25,32
2020,196060,42,0,44,24,20
2020,196060,42,1,1,1,0
2020,196060,42,2,1,1,0
2020,196060,42,3,5,2,3
2020,196060,42,5,37,20,17
2020,196060,43,0,6,4,2
2020,196060,43,3,4,3,1
2020,196060,43,5,2,1,1
2020,196060,44,0,61,28,33
2020,196060,44,3,4,3,1
2020,196060,44,5,57,25,32
2020,196079,0,0,748,417,331
2020,196079,10,0,748,417,331
2020,196079,10,1,181,127,54
2020,196079,10,2,231,136,95
2020,196079,10,3,222,114,108
2020,196079,10,4,23,10,13
2020,196079,10,5,91,30,61
2020,196079,20,0,402,261,141
2020,196079,20,1,178,127,51
2020,196079,20,2,219,133,86
2020,196079,20,3,1,0,1
2020,196079,20,4,4,1,3
2020,196079,30,0,178,96,82
2020,196079,30,2,2,1,1
2020,196079,30,3,165,88,77
2020,196079,30,4,11,7,4
2020,196079,40,0,168,60,108
2020,196079,40,1,3,0,3
2020,196079,40,2,10,2,8
2020,196079,40,3,56,26,30
2020,196079,40,4,8,2,6
2020,196079,40,5,91,30,61
2020,196079,41,0,89,26,63
2020,196079,41,2,7,0,7
2020,196079,41,3,28,11,17
2020,196079,41,4,6,1,5
2020,196079,41,5,48,14,34
2020,196079,42,0,76,34,42
2020,196079,42,1,2,0,2
2020,196079,42,2,3,2,1
2020,196079,42,3,27,15,12
2020,196079,42,4,2,1,1
2020,196079,42,5,42,16,26
2020,196079,43,0,3,0,3
2020,196079,43,1,1,0,1
2020,196079,43,3,1,0,1
2020,196079,43,5,1,0,1
2020,196079,44,0,89,26,63
2020,196079,44,2,7,0,7
2020,196079,44,3,28,11,17
2020,196079,44,4,6,1,5
2020,196079,44,5,48,14,34
2020,196088,0,0,1672,1024,648
2020,196088,10,0,1672,1024,648
2020,196088,10,1,543,396,147
2020,196088,10,2,536,316,220
2020,196088,10,3,503,268,235
2020,196088,10,4,19,9,10
2020,196088,10,5,71,35,36
2020,196088,20,0,834,572,262
2020,196088,20,1,469,346,123
2020,196088,20,2,365,226,139
2020,196088,30,0,278,159,119
2020,196088,30,1,19,13,6
2020,196088,30,2,18,9,9
2020,196088,30,3,237,133,104
2020,196088,30,4,4,4,0
2020,196088,40,0,560,293,267
2020,196088,40,1,55,37,18
2020,196088,40,2,153,81,72
2020,196088,40,3,266,135,131
2020,196088,40,4,15,5,10
2020,196088,40,5,71,35,36
2020,196088,41,0,260,109,151
2020,196088,41,1,15,6,9
2020,196088,41,2,61,23,38
2020,196088,41,3,128,56,72
2020,196088,41,4,9,2,7
2020,196088,41,5,47,22,25
2020,196088,42,0,300,184,116
2020,196088,42,1,40,31,9
2020,196088,42,2,92,58,34
2020,196088,42,3,138,79,59
2020,196088,42,4,6,3,3
2020,196088,42,5,24,13,11
2020,196088,44,0,260,109,151
2020,196088,44,1,15,6,9
2020,196088,44,2,61,23,38
2020,196088,44,3,128,56,72
2020,196088,44,4,9,2,7
2020,196088,44,5,47,22,25
2020,196097,0,0,1986,1091,895
2020,196097,10,0,1986,1091,895
2020,196097,10,1,510,378,132
2020,196097,10,2,490,300,190
2020,196097,10,3,670,323,347
2020,196097,10,4,186,35,151
2020,196097,10,5,130,55,75
2020,196097,20,0,753,537,216
2020,196097,20,1,454,342,112
2020,196097,20,2,298,195,103
2020,196097,20,3,1,0,1
2020,196097,30,0,196,120,76
2020,196097,30,1,12,11,1
2020,196097,30,2,9,5,4
2020,196097,30,3,175,104,71
2020,196097,40,0,1037,434,603
2020,196097,40,1,44,25,19
2020,196097,40,2,183,100,83
2020,196097,40,3,494,219,275
2020,196097,40,4,186,35,151
2020,196097,40,5,130,55,75
2020,196097,41,0,120,38,82
2020,196097,41,1,5,1,4
2020,196097,41,2,40,6,34
2020,196097,41,3,47,12,35
2020,196097,41,4,4,1,3
2020,196097,41,5,24,18,6
2020,196097,42,0,917,396,521
2020,196097,42,1,39,24,15
2020,196097,42,2,143,94,49
2020,196097,42,3,447,207,240
2020,196097,42,4,182,34,148
2020,196097,42,5,106,37,69
2020,196097,44,0,120,38,82
2020,196097,44,1,5,1,4
2020,196097,44,2,40,6,34
2020,196097,44,3,47,12,35
2020,196097,44,4,4,1,3
2020,196097,44,5,24,18,6
2020,196103,0,0,134,87,47
2020,196103,10,0,134,87,47
2020,196103,10,1,49,38,11
2020,196103,10,2,32,22,10
2020,196103,10,3,37,19,18
2020,196103,10,4,9,5,4
2020,196103,10,5,7,3,4
2020,196103,20,0,87,63,24
2020,196103,20,1,49,38,11
2020,196103,20,2,31,21,10
2020,196103,20,3,3,2,1
2020,196103,20,4,4,2,2
2020,196103,30,0,38,19,19
2020,196103,30,2,1,1,0
2020,196103,30,3,32,15,17
2020,196103,30,4,5,3,2
2020,196103,40,0,9,5,4
2020,196103,40,3,2,2,0
2020,196103,40,5,7,3,4
2020,196103,41,0,3,2,1
2020,196103,41,5,3,2,1
2020,196103,42,0,4,2,2
2020,196103,42,3,1,1,0
2020,196103,42,5,3,1,2
2020,196103,43,0,2,1,1
2020,196103,43,3,1,1,0
2020,196103,43,5,1,0,1
2020,196103,44,0,3,2,1
2020,196103,44,5,3,2,1
2020,196112,0,0,135,93,42
2020,196112,10,0,135,93,42
2020,196112,10,1,30,22,8
2020,196112,10,2,50,38,12
2020,196112,10,3,31,19,12
2020,196112,10,4,2,0,2
2020,196112,10,5,22,14,8
2020,196112,20,0,71,53,18
2020,196112,20,1,28,20,8
2020,196112,20,2,43,33,10
2020,196112,30,0,34,23,11
2020,196112,30,2,5,4,1
2020,196112,30,3,29,19,10
2020,196112,40,0,30,17,13
2020,196112,40,1,2,2,0
2020,196112,40,2,2,1,1
2020,196112,40,3,2,0,2
2020,196112,40,4,2,0,2
2020,196112,40,5,22,14,8
2020,196112,41,0,24,13,11
2020,196112,41,1,2,2,0
2020,196112,41,3,2,0,2
2020,196112,41,4,2,0,2
2020,196112,41,5,18,11,7
2020,196112,42,0,4,3,1
2020,196112,42,2,2,1,1
2020,196112,42,5,2,2,0
2020,196112,43,0,2,1,1
2020,196112,43,5,2,1,1
2020,196112,44,0,24,13,11
2020,196112,44,1,2,2,0
2020,196112,44,3,2,0,2
2020,196112,44,4,2,0,2
2020,196112,44,5,18,11,7
2020,196121,0,0,345,164,181
2020,196121,10,0,345,164,181
2020,196121,10,1,66,39,27
2020,196121,10,2,135,63,72
2020,196121,10,3,85,43,42
2020,196121,10,4,18,1,17
2020,196121,10,5,41,18,23
2020,196121,20,0,186,97,89
2020,196121,20,1,66,39,27
2020,196121,20,2,118,58,60
2020,196121,20,3,2,0,2
2020,196121,30,0,114,48,66
2020,196121,30,2,16,5,11
2020,196121,30,3,81,42,39
2020,196121,30,4,17,1,16
2020,196121,40,0,45,19,26
2020,196121,40,2,1,0,1
2020,196121,40,3,2,1,1
2020,196121,40,4,1,0,1
2020,196121,40,5,41,18,23
2020,196121,41,0,38,15,23
2020,196121,41,2,1,0,1
2020,196121,41,3,2,1,1
2020,196121,41,4,1,0,1
2020,196121,41,5,34,14,20
2020,196121,42,0,7,4,3
2020,196121,42,5,7,4,3
2020,196121,44,0,38,15,23
2020,196121,44,2,1,0,1
2020,196121,44,3,2,1,1
2020,196121,44,4,1,0,1
2020,196121,44,5,34,14,20
2020,196130,0,0,347,169,178
2020,196130,10,0,347,169,178
2020,196130,10,1,90,58,32
2020,196130,10,2,144,67,77
2020,196130,10,3,66,30,36
2020,196130,10,4,1,0,1
2020,196130,10,5,46,14,32
2020,196130,20,0,229,121,108
2020,196130,20,1,89,57,32
2020,196130,20,2,138,63,75
2020,196130,20,3,2,1,1
2020,196130,30,0,70,33,37
2020,196130,30,2,6,4,2
2020,196130,30,3,64,29,35
2020,196130,40,0,48,15,33
2020,196130,40,1,1,1,0
2020,196130,40,4,1,0,1
2020,196130,40,5,46,14,32
2020,196130,41,0,26,13,13
2020,196130,41,1,1,1,0
2020,196130,41,5,25,12,13
2020,196130,42,0,6,0,6
2020,196130,42,4,1,0,1
2020,196130,42,5,5,0,5
2020,196130,43,0,16,2,14
2020,196130,43,5,16,2,14
2020,196130,44,0,26,13,13
2020,196130,44,1,1,1,0
2020,196130,44,5,25,12,13
2020,196149,0,0,326,153,173
2020,196149,10,0,326,153,173
2020,196149,10,1,72,40,32
2020,196149,10,2,97,43,54
2020,196149,10,3,89,40,49
2020,196149,10,4,14,5,9
2020,196149,10,5,54,25,29
2020,196149,20,0,162,78,84
2020,196149,20,1,72,40,32
2020,196149,20,2,82,33,49
2020,196149,20,3,3,3,0
2020,196149,20,4,5,2,3
2020,196149,30,0,102,46,56
2020,196149,30,2,15,10,5
2020,196149,30,3,80,34,46
2020,196149,30,4,7,2,5
2020,196149,40,0,62,29,33
2020,196149,40,3,6,3,3
2020,196149,40,4,2,1,1
2020,196149,40,5,54,25,29
2020,196149,41,0,53,24,29
2020,196149,41,5,53,24,29
2020,196149,42,0,2,2,0
2020,196149,42,3,1,1,0
2020,196149,42,5,1,1,0
2020,196149,43,0,7,3,4
2020,196149,43,3,5,2,3
2020,196149,43,4,2,1,1
2020,196149,44,0,53,24,29
2020,196149,44,5,53,24,29
2020,196158,0,0,235,135,100
2020,196158,10,0,235,135,100
2020,196158,10,1,68,43,25
2020,196158,10,2,82,42,40
2020,196158,10,3,41,28,13
2020,196158,10,4,1,1,0
2020,196158,10,5,43,21,22
2020,196158,20,0,147,84,63
2020,196158,20,1,68,43,25
2020,196158,20,2,77,39,38
2020,196158,20,3,2,2,0
2020,196158,30,0,44,29,15
2020,196158,30,2,5,3,2
2020,196158,30,3,39,26,13
2020,196158,40,0,44,22,22
2020,196158,40,4,1,1,0
2020,196158,40,5,43,21,22
2020,196158,41,0,11,3,8
2020,196158,41,5,11,3,8
2020,196158,42,0,33,19,14
2020,196158,42,4,1,1,0
2020,196158,42,5,32,18,14
2020,196158,44,0,11,3,8
2020,196158,44,5,11,3,8
2020,196167,0,0,240,129,111
2020,196167,10,0,240,129,111
2020,196167,10,1,70,47,23
2020,196167,10,2,73,44,29
2020,196167,10,3,63,20,43
2020,196167,10,4,1,1,0
2020,196167,10,5,33,17,16
2020,196167,20,0,138,83,55
2020,196167,20,1,70,47,23
2020,196167,20,2,62,36,26
2020,196167,20,3,6,0,6
2020,196167,30,0,61,24,37
2020,196167,30,2,11,8,3
2020,196167,30,3,50,16,34
2020,196167,40,0,41,22,19
2020,196167,40,3,7,4,3
2020,196167,40,4,1,1,0
2020,196167,40,5,33,17,16
2020,196167,41,0,33,19,14
2020,196167,41,3,1,1,0
2020,196167,41,4,1,1,0
2020,196167,41,5,31,17,14
2020,196167,42,0,8,3,5
2020,196167,42,3,6,3,3
2020,196167,42,5,2,0,2
2020,196167,44,0,33,19,14
2020,196167,44,3,1,1,0
2020,196167,44,4,1,1,0
2020,196167,44,5,31,17,14
2020,196176,0,0,343,162,181
2020,196176,10,0,343,162,181
2020,196176,10,1,57,37,20
2020,196176,10,2,142,65,77
2020,196176,10,3,72,35,37
2020,196176,10,4,10,1,9
2020,196176,10,5,62,24,38
2020,196176,20,0,193,102,91
2020,196176,20,1,57,37,20
2020,196176,20,2,127,62,65
2020,196176,20,3,4,3,1
2020,196176,20,4,5,0,5
2020,196176,30,0,84,35,49
2020,196176,30,2,15,3,12
2020,196176,30,3,64,31,33
2020,196176,30,4,5,1,4
2020,196176,40,0,66,25,41
2020,196176,40,3,4,1,3
2020,196176,40,5,62,24,38
2020,196176,41,0,43,16,27
2020,196176,41,5,43,16,27
2020,196176,42,0,22,9,13
2020,196176,42,3,3,1,2
2020,196176,42,5,19,8,11
2020,196176,43,0,1,0,1
2020,196176,43,3,1,0,1
2020,196176,44,0,43,16,27
2020,196176,44,5,43,16,27
2020,196185,0,0,286,149,137
2020,196185,10,0,286,149,137
2020,196185,10,1,60,37,23
2020,196185,10,2,98,52,46
2020,196185,10,3,88,40,48
2020,196185,10,5,40,20,20
2020,196185,20,0,162,92,70
2020,196185,20,1,59,36,23
2020,196185,20,2,93,50,43
2020,196185,20,3,10,6,4
2020,196185,30,0,81,35,46
2020,196185,30,2,5,2,3
2020,196185,30,3,76,33,43
2020,196185,40,0,43,22,21
2020,196185,40,1,1,1,0
2020,196185,40,3,2,1,1
2020,196185,40,5,40,20,20
2020,196185,41,0,9,5,4
2020,196185,41,5,9,5,4
2020,196185,42,0,28,15,13
2020,196185,42,1,1,1,0
2020,196185,42,3,2,1,1
2020,196185,42,5,25,13,12
2020,196185,43,0,6,2,4
2020,196185,43,5,6,2,4
2020,196185,44,0,9,5,4
2020,196185,44,5,9,5,4
2020,196194,0,0,358,189,169
2020,196194,10,0,358,189,169
2020,196194,10,1,81,51,30
2020,196194,10,2,102,49,53
2020,196194,10,3,155,77,78
2020,196194,10,4,13,7,6
2020,196194,10,5,7,5,2
2020,196194,20,0,177,101,76
2020,196194,20,1,80,51,29
2020,196194,20,2,87,44,43
2020,196194,20,3,10,6,4
2020,196194,30,0,109,45,64
2020,196194,30,1,1,0,1
2020,196194,30,2,15,5,10
2020,196194,30,3,90,39,51
2020,196194,30,4,3,1,2
2020,196194,40,0,72,43,29
2020,196194,40,3,55,32,23
2020,196194,40,4,10,6,4
2020,196194,40,5,7,5,2
2020,196194,41,0,1,1,0
2020,196194,41,3,1,1,0
2020,196194,42,0,40,21,19
2020,196194,42,3,31,16,15
2020,196194,42,4,2,0,2
2020,196194,42,5,7,5,2
2020,196194,43,0,31,21,10
2020,196194,43,3,23,15,8
2020,196194,43,4,8,6,2
2020,196194,44,0,1,1,0
2020,196194,44,3,1,1,0
2020,196200,0,0,234,114,120
2020,196200,10,0,234,114,120
2020,196200,10,1,59,36,23
2020,196200,10,2,73,38,35
2020,196200,10,3,63,24,39
2020,196200,10,4,21,8,13
2020,196200,10,5,18,8,10
2020,196200,20,0,136,75,61
2020,196200,20,1,59,36,23
2020,196200,20,2,71,38,33
2020,196200,20,3,1,0,1
2020,196200,20,4,5,1,4
2020,196200,30,0,58,19,39
2020,196200,30,2,2,0,2
2020,196200,30,3,51,16,35
2020,196200,30,4,5,3,2
2020,196200,40,0,40,20,20
2020,196200,40,3,11,8,3
2020,196200,40,4,11,4,7
2020,196200,40,5,18,8,10
2020,196200,41,0,14,6,8
2020,196200,41,4,1,0,1
2020,196200,41,5,13,6,7
2020,196200,42,0,26,14,12
2020,196200,42,3,11,8,3
2020,196200,42,4,10,4,6
2020,196200,42,5,5,2,3
2020,196200,44,0,14,6,8
2020,196200,44,4,1,0,1
2020,196200,44,5,13,6,7
2020,196219,0,0,180,85,95
2020,196219,10,0,180,85,95
2020,196219,10,1,32,16,16
2020,196219,10,2,66,33,33
2020,196219,10,3,78,34,44
2020,196219,10,5,4,2,2
2020,196219,20,0,91,45,46
2020,196219,20,1,32,16,16
2020,196219,20,2,59,29,30
2020,196219,30,0,54,28,26
2020,196219,30,2,4,3,1
2020,196219,30,3,50,25,25
2020,196219,40,0,35,12,23
2020,196219,40,2,3,1,2
2020,196219,40,3,28,9,19
2020,196219,40,5,4,2,2
2020,196219,41,0,11,4,7
2020,196219,41,2,3,1,2
2020,196219,41,3,6,2,4
2020,196219,41,5,2,1,1
2020,196219,42,0,24,8,16
2020,196219,42,3,22,7,15
2020,196219,42,5,2,1,1
2020,196219,44,0,11,4,7
2020,196219,44,2,3,1,2
2020,196219,44,3,6,2,4
2020,196219,44,5,2,1,1
2020,196228,0,0,71,27,44
2020,196228,10,0,71,27,44
2020,196228,10,1,15,12,3
2020,196228,10,2,23,7,16
2020,196228,10,3,32,7,25
2020,196228,10,4,1,1,0
2020,196228,20,0,18,15,3
2020,196228,20,1,14,12,2
2020,196228,20,2,4,3,1
2020,196228,30,0,2,0,2
2020,196228,30,2,1,0,1
2020,196228,30,3,1,0,1
2020,196228,40,0,51,12,39
2020,196228,40,1,1,0,1
2020,196228,40,2,18,4,14
2020,196228,40,3,31,7,24
2020,196228,40,4,1,1,0
2020,196228,41,0,1,1,0
2020,196228,41,3,1,1,0
2020,196228,42,0,50,11,39
2020,196228,42,1,1,0,1
2020,196228,42,2,18,4,14
2020,196228,42,3,30,6,24
2020,196228,42,4,1,1,0
2020,196228,44,0,1,1,0
2020,196228,44,3,1,1,0
2020,196237,0,0,172,81,91
2020,196237,10,0,172,81,91
2020,196237,10,1,25,11,14
2020,196237,10,2,65,34,31
2020,196237,10,3,55,24,31
2020,196237,10,4,1,1,0
2020,196237,10,5,26,11,15
2020,196237,20,0,91,46,45
2020,196237,20,1,25,11,14
2020,196237,20,2,65,34,31
2020,196237,20,4,1,1,0
2020,196237,30,0,55,24,31
2020,196237,30,3,55,24,31
2020,196237,40,0,26,11,15
2020,196237,40,5,26,11,15
2020,196237,42,0,26,11,15
2020,196237,42,5,26,11,15
2020,196246,0,0,252,137,115
2020,196246,10,0,252,137,115
2020,196246,10,1,62,41,21
2020,196246,10,2,86,50,36
2020,196246,10,3,60,26,34
2020,196246,10,4,1,0,1
2020,196246,10,5,43,20,23
2020,196246,20,0,138,84,54
2020,196246,20,1,62,41,21
2020,196246,20,2,73,42,31
2020,196246,20,3,3,1,2
2020,196246,30,0,70,33,37
2020,196246,30,2,13,8,5
2020,196246,30,3,57,25,32
2020,196246,40,0,44,20,24
2020,196246,40,4,1,0,1
2020,196246,40,5,43,20,23
2020,196246,41,0,31,12,19
2020,196246,41,5,31,12,19
2020,196246,42,0,13,8,5
2020,196246,42,4,1,0,1
2020,196246,42,5,12,8,4
2020,196246,44,0,31,12,19
2020,196246,44,5,31,12,19
2020,196255,0,0,484,283,201
2020,196255,10,0,484,283,201
2020,196255,10,1,133,97,36
2020,196255,10,2,101,55,46
2020,196255,10,3,239,129,110
2020,196255,10,4,9,2,7
2020,196255,10,5,2,0,2
2020,196255,20,0,160,107,53
2020,196255,20,1,103,74,29
2020,196255,20,2,55,31,24
2020,196255,20,3,2,2,0
2020,196255,30,0,118,61,57
2020,196255,30,1,16,11,5
2020,196255,30,2,8,4,4
2020,196255,30,3,94,46,48
2020,196255,40,0,206,115,91
2020,196255,40,1,14,12,2
2020,196255,40,2,38,20,18
2020,196255,40,3,143,81,62
2020,196255,40,4,9,2,7
2020,196255,40,5,2,0,2
2020,196255,41,0,23,12,11
2020,196255,41,1,1,0,1
2020,196255,41,2,5,2,3
2020,196255,41,3,16,10,6
2020,196255,41,4,1,0,1
2020,196255,42,0,183,103,80
2020,196255,42,1,13,12,1
2020,196255,42,2,33,18,15
2020,196255,42,3,127,71,56
2020,196255,42,4,8,2,6
2020,196255,42,5,2,0,2
2020,196255,44,0,23,12,11
2020,196255,44,1,1,0,1
2020,196255,44,2,5,2,3
2020,196255,44,3,16,10,6
2020,196255,44,4,1,0,1
2020,196264,0,0,155,51,104
2020,196264,10,0,155,51,104
2020,196264,10,1,35,12,23
2020,196264,10,2,93,36,57
2020,196264,10,3,24,3,21
2020,196264,10,4,1,0,1
2020,196264,10,5,2,0,2
2020,196264,20,0,129,47,82
2020,196264,20,1,34,11,23
2020,196264,20,2,86,34,52
2020,196264,20,3,9,2,7
2020,196264,30,0,19,2,17
2020,196264,30,2,4,1,3
2020,196264,30,3,14,1,13
2020,196264,30,4,1,0,1
2020,196264,40,0,7,2,5
2020,196264,40,1,1,1,0
2020,196264,40,2,3,1,2
2020,196264,40,3,1,0,1
2020,196264,40,5,2,0,2
2020,196264,41,0,1,0,1
2020,196264,41,5,1,0,1
2020,196264,42,0,6,2,4
2020,196264,42,1,1,1,0
2020,196264,42,2,3,1,2
2020,196264,42,3,1,0,1
2020,196264,42,5,1,0,1
2020,196264,44,0,1,0,1
2020,196264,44,5,1,0,1
2020,196291,0,0,88,68,20
2020,196291,10,0,88,68,20
2020,196291,10,1,20,15,5
2020,196291,10,2,17,11,6
2020,196291,10,3,16,11,5
2020,196291,10,4,6,5,1
2020,196291,10,5,29,26,3
2020,196291,20,0,36,25,11
2020,196291,20,1,20,15,5
2020,196291,20,2,13,7,6
2020,196291,20,3,3,3,0
2020,196291,30,0,16,11,5
2020,196291,30,2,3,3,0
2020,196291,30,3,13,8,5
2020,196291,40,0,36,32,4
2020,196291,40,2,1,1,0
2020,196291,40,4,6,5,1
2020,196291,40,5,29,26,3
2020,196291,41,0,21,20,1
2020,196291,41,2,1,1,0
2020,196291,41,5,20,19,1
2020,196291,42,0,15,12,3
2020,196291,42,4,6,5,1
2020,196291,42,5,9,7,2
2020,196291,44,0,21,20,1
2020,196291,44,2,1,1,0
2020,196291,44,5,20,19,1
2020,196307,0,0,609,379,230
2020,196307,10,0,609,379,230
2020,196307,10,1,121,97,24
2020,196307,10,2,142,87,55
2020,196307,10,3,326,184,142
2020,196307,10,4,20,11,9
2020,196307,20,0,154,116,38
2020,196307,20,1,90,74,16
2020,196307,20,2,62,41,21
2020,196307,20,3,2,1,1
2020,196307,30,0,50,32,18
2020,196307,30,2,6,4,2
2020,196307,30,3,44,28,16
2020,196307,40,0,405,231,174
2020,196307,40,1,31,23,8
2020,196307,40,2,74,42,32
2020,196307,40,3,280,155,125
2020,196307,40,4,20,11,9
2020,196307,41,0,291,168,123
2020,196307,41,1,26,19,7
2020,196307,41,2,62,38,24
2020,196307,41,3,188,105,83
2020,196307,41,4,15,6,9
2020,196307,42,0,114,63,51
2020,196307,42,1,5,4,1
2020,196307,42,2,12,4,8
2020,196307,42,3,92,50,42
2020,196307,42,4,5,5,0
2020,196307,44,0,291,168,123
2020,196307,44,1,26,19,7
2020,196307,44,2,62,38,24
2020,196307,44,3,188,105,83
2020,196307,44,4,15,6,9
2020,196389,0,0,58,25,33
2020,196389,10,0,58,25,33
2020,196389,10,4,58,25,33
2020,196389,40,0,58,25,33
2020,196389,40,4,58,25,33
2020,196389,41,0,58,25,33
2020,196389,41,4,58,25,33
2020,196389,44,0,52,23,29
2020,196389,44,4,52,23,29
2020,196389,45,0,6,2,4
2020,196389,45,4,6,2,4
2020,196413,0,0,1121,626,495
2020,196413,10,0,1121,626,495
2020,196413,10,1,425,283,142
2020,196413,10,2,344,180,164
2020,196413,10,3,352,163,189
2020,196413,20,0,646,399,247
2020,196413,20,1,338,233,105
2020,196413,20,2,303,164,139
2020,196413,20,3,5,2,3
2020,196413,30,0,239,119,120
2020,196413,30,2,3,2,1
2020,196413,30,3,236,117,119
2020,196413,40,0,236,108,128
2020,196413,40,1,87,50,37
2020,196413,40,2,38,14,24
2020,196413,40,3,111,44,67
2020,196413,41,0,146,63,83
2020,196413,41,1,60,32,28
2020,196413,41,2,24,8,16
2020,196413,41,3,62,23,39
2020,196413,42,0,7,2,5
2020,196413,42,1,1,1,0
2020,196413,42,2,3,1,2
2020,196413,42,3,3,0,3
2020,196413,43,0,83,43,40
2020,196413,43,1,26,17,9
2020,196413,43,2,11,5,6
2020,196413,43,3,46,21,25
2020,196413,44,0,146,63,83
2020,196413,44,1,60,32,28
2020,196413,44,2,24,8,16
2020,196413,44,3,62,23,39
2020,196431,0,0,21,21,0
2020,196431,10,0,21,21,0
2020,196431,10,4,21,21,0
2020,196431,40,0,21,21,0
2020,196431,40,4,21,21,0
2020,196431,42,0,21,21,0
2020,196431,42,4,21,21,0
2020,196468,0,0,226,81,145
2020,196468,10,0,226,81,145
2020,196468,10,1,89,40,49
2020,196468,10,2,61,21,40
2020,196468,10,3,12,6,6
2020,196468,10,4,7,1,6
2020,196468,10,5,56,13,43
2020,196468,10,6,1,0,1
2020,196468,20,0,149,61,88
2020,196468,20,1,88,40,48
2020,196468,20,2,60,20,40
2020,196468,20,3,1,1,0
2020,196468,30,0,11,5,6
2020,196468,30,3,11,5,6
2020,196468,40,0,66,15,51
2020,196468,40,1,1,0,1
2020,196468,40,2,1,1,0
2020,196468,40,4,7,1,6
2020,196468,40,5,56,13,43
2020,196468,40,6,1,0,1
2020,196468,41,0,34,8,26
2020,196468,41,4,1,0,1
2020,196468,41,5,32,8,24
2020,196468,41,6,1,0,1
2020,196468,42,0,30,6,24
2020,196468,42,4,6,1,5
2020,196468,42,5,24,5,19
2020,196468,43,0,2,1,1
2020,196468,43,1,1,0,1
2020,196468,43,2,1,1,0
2020,196468,44,0,34,8,26
2020,196468,44,4,1,0,1
2020,196468,44,5,32,8,24
2020,196468,44,6,1,0,1
2020,196565,0,0,54,19,35
2020,196565,10,0,54,19,35
2020,196565,10,1,39,15,24
2020,196565,10,2,7,0,7
2020,196565,10,3,5,2,3
2020,196565,10,4,3,2,1
2020,196565,20,0,45,15,30
2020,196565,20,1,39,15,24
2020,196565,20,2,6,0,6
2020,196565,30,0,9,4,5
2020,196565,30,2,1,0,1
2020,196565,30,3,5,2,3
2020,196565,30,4,3,2,1
2020,196592,0,0,453,228,225
2020,196592,10,0,453,228,225
2020,196592,10,1,54,35,19
2020,196592,10,2,122,65,57
2020,196592,10,3,185,81,104
2020,196592,10,4,83,42,41
2020,196592,10,5,9,5,4
2020,196592,20,0,27,19,8
2020,196592,20,1,20,13,7
2020,196592,20,2,6,5,1
2020,196592,20,4,1,1,0
2020,196592,30,0,3,0,3
2020,196592,30,3,3,0,3
2020,196592,40,0,423,209,214
2020,196592,40,1,34,22,12
2020,196592,40,2,116,60,56
2020,196592,40,3,182,81,101
2020,196592,40,4,82,41,41
2020,196592,40,5,9,5,4
2020,196592,41,0,84,28,56
2020,196592,41,1,16,9,7
2020,196592,41,2,32,10,22
2020,196592,41,3,34,9,25
2020,196592,41,4,2,0,2
2020,196592,42,0,339,181,158
2020,196592,42,1,18,13,5
2020,196592,42,2,84,50,34
2020,196592,42,3,148,72,76
2020,196592,42,4,80,41,39
2020,196592,42,5,9,5,4
2020,196592,44,0,84,28,56
2020,196592,44,1,16,9,7
2020,196592,44,2,32,10,22
2020,196592,44,3,34,9,25
2020,196592,44,4,2,0,2
2020,196653,0,0,32,8,24
2020,196653,10,0,32,8,24
2020,196653,10,1,10,3,7
2020,196653,10,2,3,2,1
2020,196653,10,3,13,2,11
2020,196653,10,4,6,1,5
2020,196653,40,0,32,8,24
2020,196653,40,1,10,3,7
2020,196653,40,2,3,2,1
2020,196653,40,3,13,2,11
2020,196653,40,4,6,1,5
2020,196653,41,0,27,8,19
2020,196653,41,1,10,3,7
2020,196653,41,2,3,2,1
2020,196653,41,3,10,2,8
2020,196653,41,4,4,1,3
2020,196653,42,0,5,0,5
2020,196653,42,3,3,0,3
2020,196653,42,4,2,0,2
2020,196653,44,0,14,3,11
2020,196653,44,1,1,0,1
2020,196653,44,2,1,0,1
2020,196653,44,3,8,2,6
2020,196653,44,4,4,1,3
2020,196653,45,0,13,5,8
2020,196653,45,1,9,3,6
2020,196653,45,2,2,2,0
2020,196653,45,3,2,0,2
2020,196699,0,0,60,26,34
2020,196699,10,0,60,26,34
2020,196699,10,1,21,12,9
2020,196699,10,2,15,4,11
2020,196699,10,3,20,9,11
2020,196699,10,4,4,1,3
2020,196699,20,0,44,21,23
2020,196699,20,1,21,12,9
2020,196699,20,2,15,4,11
2020,196699,20,3,8,5,3
2020,196699,30,0,11,3,8
2020,196699,30,3,10,3,7
2020,196699,30,4,1,0,1
2020,196699,40,0,5,2,3
2020,196699,40,3,2,1,1
2020,196699,40,4,3,1,2
2020,196699,42,0,5,2,3
2020,196699,42,3,2,1,1
2020,196699,42,4,3,1,2
2020,196866,0,0,216,122,94
2020,196866,10,0,216,122,94
2020,196866,10,1,77,47,30
2020,196866,10,2,59,34,25
2020,196866,10,3,32,14,18
2020,196866,10,4,28,16,12
2020,196866,10,5,20,11,9
2020,196866,20,0,136,81,55
2020,196866,20,1,77,47,30
2020,196866,20,2,59,34,25
2020,196866,30,0,32,14,18
2020,196866,30,3,32,14,18
2020,196866,40,0,48,27,21
2020,196866,40,4,28,16,12
2020,196866,40,5,20,11,9
2020,196866,41,0,43,24,19
2020,196866,41,4,23,13,10
2020,196866,41,5,20,11,9
2020,196866,42,0,5,3,2
2020,196866,42,4,5,3,2
2020,196866,44,0,43,24,19
2020,196866,44,4,23,13,10
2020,196866,44,5,20,11,9
2020,196884,0,0,20,9,11
2020,196884,10,0,20,9,11
2020,196884,10,1,8,3,5
2020,196884,10,2,10,5,5
2020,196884,10,3,2,1,1
2020,196884,20,0,14,6,8
2020,196884,20,1,8,3,5
2020,196884,20,2,6,3,3
2020,196884,30,0,4,1,3
2020,196884,30,2,2,0,2
2020,196884,30,3,2,1,1
2020,196884,40,0,2,2,0
2020,196884,40,2,2,2,0
2020,196884,41,0,2,2,0
2020,196884,41,2,2,2,0
2020,196884,44,0,2,2,0
2020,196884,44,2,2,2,0
2020,197018,0,0,102,102,0
2020,197018,10,0,65,65,0
2020,197018,10,1,16,16,0
2020,197018,10,2,7,7,0
2020,197018,10,3,14,14,0
2020,197018,10,4,15,15,0
2020,197018,10,5,13,13,0
2020,197018,40,0,65,65,0
2020,197018,40,1,16,16,0
2020,197018,40,2,7,7,0
2020,197018,40,3,14,14,0
2020,197018,40,4,15,15,0
2020,197018,40,5,13,13,0
2020,197018,43,0,65,65,0
2020,197018,43,1,16,16,0
2020,197018,43,2,7,7,0
2020,197018,43,3,14,14,0
2020,197018,43,4,15,15,0
2020,197018,43,5,13,13,0
2020,197018,50,0,37,37,0
2020,197027,0,0,112,94,18
2020,197027,10,0,107,89,18
2020,197027,10,1,25,20,5
2020,197027,10,2,28,25,3
2020,197027,10,3,21,16,5
2020,197027,10,4,33,28,5
2020,197027,20,0,58,48,10
2020,197027,20,1,25,20,5
2020,197027,20,2,25,22,3
2020,197027,20,3,8,6,2
2020,197027,30,0,16,13,3
2020,197027,30,2,3,3,0
2020,197027,30,3,13,10,3
2020,197027,40,0,33,28,5
2020,197027,40,4,33,28,5
2020,197027,41,0,1,0,1
2020,197027,41,4,1,0,1
2020,197027,42,0,32,28,4
2020,197027,42,4,32,28,4
2020,197027,45,0,1,0,1
2020,197027,45,4,1,0,1
2020,197027,50,0,5,5,0
2020,197036,0,0,282,195,87
2020,197036,10,0,282,195,87
2020,197036,10,1,53,39,14
2020,197036,10,2,54,41,13
2020,197036,10,3,113,76,37
2020,197036,10,4,40,28,12
2020,197036,10,5,16,5,11
2020,197036,10,6,6,6,0
2020,197036,20,0,92,68,24
2020,197036,20,1,49,36,13
2020,197036,20,2,43,32,11
2020,197036,30,0,29,21,8
2020,197036,30,1,1,1,0
2020,197036,30,2,2,2,0
2020,197036,30,3,26,18,8
2020,197036,40,0,161,106,55
2020,197036,40,1,3,2,1
2020,197036,40,2,9,7,2
2020,197036,40,3,87,58,29
2020,197036,40,4,40,28,12
2020,197036,40,5,16,5,11
2020,197036,40,6,6,6,0
2020,197036,41,0,99,71,28
2020,197036,41,1,1,1,0
2020,197036,41,2,5,4,1
2020,197036,41,3,43,37,6
2020,197036,41,4,32,22,10
2020,197036,41,5,15,4,11
2020,197036,41,6,3,3,0
2020,197036,42,0,62,35,27
2020,197036,42,1,2,1,1
2020,197036,42,2,4,3,1
2020,197036,42,3,44,21,23
2020,197036,42,4,8,6,2
2020,197036,42,5,1,1,0
2020,197036,42,6,3,3,0
2020,197036,44,0,82,65,17
2020,197036,44,1,1,1,0
2020,197036,44,2,5,4,1
2020,197036,44,3,43,37,6
2020,197036,44,4,32,22,10
2020,197036,44,6,1,1,0
2020,197036,45,0,17,6,11
2020,197036,45,5,15,4,11
2020,197036,45,6,2,2,0
2020,197045,0,0,168,82,86
2020,197045,10,0,168,82,86
2020,197045,10,1,37,25,12
2020,197045,10,2,47,25,22
2020,197045,10,3,43,15,28
2020,197045,10,6,41,17,24
2020,197045,20,0,78,45,33
2020,197045,20,1,37,25,12
2020,197045,20,2,40,20,20
2020,197045,20,3,1,0,1
2020,197045,30,0,49,20,29
2020,197045,30,2,7,5,2
2020,197045,30,3,42,15,27
2020,197045,40,0,41,17,24
2020,197045,40,6,41,17,24
2020,197045,41,0,36,14,22
2020,197045,41,6,36,14,22
2020,197045,42,0,5,3,2
2020,197045,42,6,5,3,2
2020,197045,44,0,36,14,22
2020,197045,44,6,36,14,22
2020,197133,0,0,291,151,140
2020,197133,10,0,291,151,140
2020,197133,10,1,95,51,44
2020,197133,10,2,69,36,33
2020,197133,10,3,53,24,29
2020,197133,10,5,13,7,6
2020,197133,10,6,61,33,28
2020,197133,20,0,169,89,80
2020,197133,20,1,95,51,44
2020,197133,20,2,69,36,33
2020,197133,20,6,5,2,3
2020,197133,30,0,53,24,29
2020,197133,30,3,53,24,29
2020,197133,40,0,69,38,31
2020,197133,40,5,13,7,6
2020,197133,40,6,56,31,25
2020,197133,41,0,38,24,14
2020,197133,41,5,13,7,6
2020,197133,41,6,25,17,8
2020,197133,42,0,22,10,12
2020,197133,42,6,22,10,12
2020,197133,43,0,9,4,5
2020,197133,43,6,9,4,5
2020,197133,44,0,38,24,14
2020,197133,44,5,13,7,6
2020,197133,44,6,25,17,8
2020,197142,0,0,26,12,14
2020,197142,10,0,26,12,14
2020,197142,10,1,6,2,4
2020,197142,10,2,8,3,5
2020,197142,10,3,8,5,3
2020,197142,10,4,4,2,2
2020,197142,40,0,26,12,14
2020,197142,40,1,6,2,4
2020,197142,40,2,8,3,5
2020,197142,40,3,8,5,3
2020,197142,40,4,4,2,2
2020,197142,42,0,26,12,14
2020,197142,42,1,6,2,4
2020,197142,42,2,8,3,5
2020,197142,42,3,8,5,3
2020,197142,42,4,4,2,2
2020,197151,0,0,188,112,76
2020,197151,10,0,188,112,76
2020,197151,10,6,188,112,76
2020,197151,40,0,188,112,76
2020,197151,40,6,188,112,76
2020,197151,42,0,188,112,76
2020,197151,42,6,188,112,76
2020,197197,0,0,133,55,78
2020,197197,10,0,128,54,74
2020,197197,10,1,36,17,19
2020,197197,10,2,36,15,21
2020,197197,10,3,30,12,18
2020,197197,10,6,26,10,16
2020,197197,20,0,55,23,32
2020,197197,20,1,35,17,18
2020,197197,20,2,16,5,11
2020,197197,20,3,4,1,3
2020,197197,30,0,22,9,13
2020,197197,30,2,5,1,4
2020,197197,30,3,17,8,9
2020,197197,40,0,51,22,29
2020,197197,40,1,1,0,1
2020,197197,40,2,15,9,6
2020,197197,40,3,9,3,6
2020,197197,40,6,26,10,16
2020,197197,41,0,43,19,24
2020,197197,41,1,1,0,1
2020,197197,41,2,15,9,6
2020,197197,41,3,9,3,6
2020,197197,41,6,18,7,11
2020,197197,42,0,1,1,0
2020,197197,42,6,1,1,0
2020,197197,43,0,7,2,5
2020,197197,43,6,7,2,5
2020,197197,44,0,36,17,19
2020,197197,44,1,1,0,1
2020,197197,44,2,15,9,6
2020,197197,44,3,9,3,6
2020,197197,44,6,11,5,6
2020,197197,45,0,7,2,5
2020,197197,45,6,7,2,5
2020,197197,50,0,5,1,4
2020,197221,0,0,9,8,1
2020,197221,10,0,9,8,1
2020,197221,10,1,5,4,1
2020,197221,10,2,1,1,0
2020,197221,10,3,3,3,0
2020,197221,40,0,9,8,1
2020,197221,40,1,5,4,1
2020,197221,40,2,1,1,0
2020,197221,40,3,3,3,0
2020,197221,41,0,9,8,1
2020,197221,41,1,5,4,1
2020,197221,41,2,1,1,0
2020,197221,41,3,3,3,0
2020,197221,44,0,9,8,1
2020,197221,44,1,5,4,1
2020,197221,44,2,1,1,0
2020,197221,44,3,3,3,0
2020,197230,0,0,31,16,15
2020,197230,10,0,31,16,15
2020,197230,10,1,13,7,6
2020,197230,10,2,4,4,0
2020,197230,10,3,12,5,7
2020,197230,10,4,1,0,1
2020,197230,10,5,1,0,1
2020,197230,20,0,17,11,6
2020,197230,20,1,13,7,6
2020,197230,20,2,4,4,0
2020,197230,30,0,7,2,5
2020,197230,30,3,7,2,5
2020,197230,40,0,7,3,4
2020,197230,40,3,5,3,2
2020,197230,40,4,1,0,1
2020,197230,40,5,1,0,1
2020,197230,42,0,7,3,4
2020,197230,42,3,5,3,2
2020,197230,42,4,1,0,1
2020,197230,42,5,1,0,1
2020,197285,0,0,18,9,9
2020,197285,10,0,18,9,9
2020,197285,10,1,3,1,2
2020,197285,10,2,3,2,1
2020,197285,10,3,9,4,5
2020,197285,10,4,3,2,1
2020,197285,40,0,18,9,9
2020,197285,40,1,3,1,2
2020,197285,40,2,3,2,1
2020,197285,40,3,9,4,5
2020,197285,40,4,3,2,1
2020,197285,41,0,18,9,9
2020,197285,41,1,3,1,2
2020,197285,41,2,3,2,1
2020,197285,41,3,9,4,5
2020,197285,41,4,3,2,1
2020,197285,45,0,18,9,9
2020,197285,45,1,3,1,2
2020,197285,45,2,3,2,1
2020,197285,45,3,9,4,5
2020,197285,45,4,3,2,1
2020,197294,0,0,168,79,89
2020,197294,10,0,168,79,89
2020,197294,10,1,47,21,26
2020,197294,10,2,27,15,12
2020,197294,10,3,59,27,32
2020,197294,10,4,35,16,19
2020,197294,20,0,129,62,67
2020,197294,20,1,47,21,26
2020,197294,20,2,27,15,12
2020,197294,20,3,55,26,29
2020,197294,30,0,39,17,22
2020,197294,30,3,4,1,3
2020,197294,30,4,35,16,19
2020,197647,0,0,9,9,0
2020,197647,10,0,9,9,0
2020,197647,10,4,9,9,0
2020,197647,40,0,9,9,0
2020,197647,40,4,9,9,0
2020,197647,42,0,9,9,0
2020,197647,42,4,9,9,0
2020,197674,0,0,14,14,0
2020,197674,10,0,14,14,0
2020,197674,10,1,4,4,0
2020,197674,10,4,10,10,0
2020,197674,20,0,9,9,0
2020,197674,20,1,4,4,0
2020,197674,20,4,5,5,0
2020,197674,40,0,5,5,0
2020,197674,40,4,5,5,0
2020,197674,42,0,5,5,0
2020,197674,42,4,5,5,0
2020,197708,0,0,356,217,139
2020,197708,10,0,356,217,139
2020,197708,10,1,96,72,24
2020,197708,10,2,64,34,30
2020,197708,10,3,43,20,23
2020,197708,10,4,153,91,62
2020,197708,20,0,146,99,47
2020,197708,20,1,91,68,23
2020,197708,20,2,52,28,24
2020,197708,20,3,3,3,0
2020,197708,30,0,33,12,21
2020,197708,30,2,4,0,4
2020,197708,30,3,29,12,17
2020,197708,40,0,177,106,71
2020,197708,40,1,5,4,1
2020,197708,40,2,8,6,2
2020,197708,40,3,11,5,6
2020,197708,40,4,153,91,62
2020,197708,42,0,177,106,71
2020,197708,42,1,5,4,1
2020,197708,42,2,8,6,2
2020,197708,42,3,11,5,6
2020,197708,42,4,153,91,62
2020,197735,0,0,74,74,0
2020,197735,10,0,74,74,0
2020,197735,10,4,74,74,0
2020,197735,40,0,74,74,0
2020,197735,40,4,74,74,0
2020,197735,42,0,74,74,0
2020,197735,42,4,74,74,0
2020,197814,0,0,79,30,49
2020,197814,10,0,79,30,49
2020,197814,10,6,79,30,49
2020,197814,40,0,79,30,49
2020,197814,40,6,79,30,49
2020,197814,42,0,79,30,49
2020,197814,42,6,79,30,49
2020,197850,0,0,78,39,39
2020,197850,10,0,62,26,36
2020,197850,10,6,62,26,36
2020,197850,40,0,62,26,36
2020,197850,40,6,62,26,36
2020,197850,42,0,62,26,36
2020,197850,42,6,62,26,36
2020,197850,50,0,16,13,3
2020,197869,0,0,1037,518,519
2020,197869,10,0,1037,518,519
2020,197869,10,1,331,189,142
2020,197869,10,2,227,119,108
2020,197869,10,3,225,106,119
2020,197869,10,4,13,2,11
2020,197869,10,5,220,89,131
2020,197869,10,6,21,13,8
2020,197869,20,0,548,304,244
2020,197869,20,1,330,188,142
2020,197869,20,2,218,116,102
2020,197869,30,0,209,100,109
2020,197869,30,2,8,2,6
2020,197869,30,3,200,98,102
2020,197869,30,4,1,0,1
2020,197869,40,0,280,114,166
2020,197869,40,1,1,1,0
2020,197869,40,2,1,1,0
2020,197869,40,3,25,8,17
2020,197869,40,4,12,2,10
2020,197869,40,5,220,89,131
2020,197869,40,6,21,13,8
2020,197869,41,0,119,56,63
2020,197869,41,1,1,1,0
2020,197869,41,3,10,4,6
2020,197869,41,4,5,1,4
2020,197869,41,5,94,44,50
2020,197869,41,6,9,6,3
2020,197869,42,0,154,57,97
2020,197869,42,2,1,1,0
2020,197869,42,3,15,4,11
2020,197869,42,4,7,1,6
2020,197869,42,5,121,44,77
2020,197869,42,6,10,7,3
2020,197869,43,0,7,1,6
2020,197869,43,5,5,1,4
2020,197869,43,6,2,0,2
2020,197869,44,0,119,56,63
2020,197869,44,1,1,1,0
2020,197869,44,3,10,4,6
2020,197869,44,4,5,1,4
2020,197869,44,5,94,44,50
2020,197869,44,6,9,6,3
2020,197887,0,0,167,64,103
2020,197887,10,0,167,64,103
2020,197887,10,6,167,64,103
2020,197887,40,0,167,64,103
2020,197887,40,6,167,64,103
2020,197887,42,0,167,64,103
2020,197887,42,6,167,64,103
2020,197911,0,0,65,31,34
2020,197911,10,0,61,31,30
2020,197911,10,1,14,6,8
2020,197911,10,2,13,8,5
2020,197911,10,3,32,17,15
2020,197911,10,4,2,0,2
2020,197911,20,0,26,13,13
2020,197911,20,1,14,6,8
2020,197911,20,2,11,7,4
2020,197911,20,3,1,0,1
2020,197911,30,0,25,16,9
2020,197911,30,2,2,1,1
2020,197911,30,3,23,15,8
2020,197911,40,0,10,2,8
2020,197911,40,3,8,2,6
2020,197911,40,4,2,0,2
2020,197911,42,0,10,2,8
2020,197911,42,3,8,2,6
2020,197911,42,4,2,0,2
2020,197911,50,0,4,0,4
2020,197966,0,0,49,17,32
2020,197966,10,0,49,17,32
2020,197966,10,6,49,17,32
2020,197966,40,0,49,17,32
2020,197966,40,6,49,17,32
2020,197966,42,0,49,17,32
2020,197966,42,6,49,17,32
2020,197984,0,0,77,41,36
2020,197984,10,0,77,41,36
2020,197984,10,1,8,5,3
2020,197984,10,2,32,19,13
2020,197984,10,3,23,12,11
2020,197984,10,4,3,1,2
2020,197984,10,5,11,4,7
2020,197984,20,0,32,20,12
2020,197984,20,1,8,5,3
2020,197984,20,2,24,15,9
2020,197984,30,0,19,8,11
2020,197984,30,2,3,0,3
2020,197984,30,3,16,8,8
2020,197984,40,0,26,13,13
2020,197984,40,2,5,4,1
2020,197984,40,3,7,4,3
2020,197984,40,4,3,1,2
2020,197984,40,5,11,4,7
2020,197984,42,0,26,13,13
2020,197984,42,2,5,4,1
2020,197984,42,3,7,4,3
2020,197984,42,4,3,1,2
2020,197984,42,5,11,4,7
2020,197993,0,0,25,7,18
2020,197993,10,0,25,7,18
2020,197993,10,1,1,1,0
2020,197993,10,2,8,3,5
2020,197993,10,3,14,3,11
2020,197993,10,4,2,0,2
2020,197993,20,0,12,4,8
2020,197993,20,1,1,1,0
2020,197993,20,2,7,3,4
2020,197993,20,3,4,0,4
2020,197993,30,0,4,0,4
2020,197993,30,3,3,0,3
2020,197993,30,4,1,0,1
2020,197993,40,0,9,3,6
2020,197993,40,2,1,0,1
2020,197993,40,3,7,3,4
2020,197993,40,4,1,0,1
2020,197993,42,0,9,3,6
2020,197993,42,2,1,0,1
2020,197993,42,3,7,3,4
2020,197993,42,4,1,0,1
2020,198011,0,0,42,19,23
2020,198011,10,0,42,19,23
2020,198011,10,6,42,19,23
2020,198011,40,0,42,19,23
2020,198011,40,6,42,19,23
2020,198011,42,0,42,19,23
2020,198011,42,6,42,19,23
2020,198039,0,0,64,32,32
2020,198039,10,0,64,32,32
2020,198039,10,6,64,32,32
2020,198039,40,0,64,32,32
2020,198039,40,6,64,32,32
2020,198039,42,0,64,32,32
2020,198039,42,6,64,32,32
2020,198066,0,0,52,29,23
2020,198066,10,0,52,29,23
2020,198066,10,1,11,3,8
2020,198066,10,2,14,11,3
2020,198066,10,3,27,15,12
2020,198066,20,0,22,11,11
2020,198066,20,1,11,3,8
2020,198066,20,2,11,8,3
2020,198066,30,0,22,12,10
2020,198066,30,2,1,1,0
2020,198066,30,3,21,11,10
2020,198066,40,0,8,6,2
2020,198066,40,2,2,2,0
2020,198066,40,3,6,4,2
2020,198066,42,0,8,6,2
2020,198066,42,2,2,2,0
2020,198066,42,3,6,4,2
2020,198084,0,0,46,17,29
2020,198084,10,0,46,17,29
2020,198084,10,6,46,17,29
2020,198084,40,0,46,17,29
2020,198084,40,6,46,17,29
2020,198084,42,0,45,17,28
2020,198084,42,6,45,17,28
2020,198084,43,0,1,0,1
2020,198084,43,6,1,0,1
2020,198109,0,0,32,4,28
2020,198109,10,0,32,4,28
2020,198109,10,2,11,1,10
2020,198109,10,3,9,2,7
2020,198109,10,4,11,1,10
2020,198109,10,6,1,0,1
2020,198109,40,0,32,4,28
2020,198109,40,2,11,1,10
2020,198109,40,3,9,2,7
2020,198109,40,4,11,1,10
2020,198109,40,6,1,0,1
2020,198109,41,0,32,4,28
2020,198109,41,2,11,1,10
2020,198109,41,3,9,2,7
2020,198109,41,4,11,1,10
2020,198109,41,6,1,0,1
2020,198109,45,0,32,4,28
2020,198109,45,2,11,1,10
2020,198109,45,3,9,2,7
2020,198109,45,4,11,1,10
2020,198109,45,6,1,0,1
2020,198118,0,0,94,38,56
2020,198118,10,0,94,38,56
2020,198118,10,6,94,38,56
2020,198118,40,0,94,38,56
2020,198118,40,6,94,38,56
2020,198118,42,0,94,38,56
2020,198118,42,6,94,38,56
2020,198136,0,0,261,141,120
2020,198136,10,0,259,141,118
2020,198136,10,1,42,27,15
2020,198136,10,2,105,57,48
2020,198136,10,3,86,46,40
2020,198136,10,4,24,11,13
2020,198136,10,5,1,0,1
2020,198136,10,6,1,0,1
2020,198136,20,0,56,30,26
2020,198136,20,1,28,19,9
2020,198136,20,2,28,11,17
2020,198136,30,0,168,91,77
2020,198136,30,1,13,8,5
2020,198136,30,2,76,46,30
2020,198136,30,3,67,34,33
2020,198136,30,4,11,3,8
2020,198136,30,6,1,0,1
2020,198136,40,0,35,20,15
2020,198136,40,1,1,0,1
2020,198136,40,2,1,0,1
2020,198136,40,3,19,12,7
2020,198136,40,4,13,8,5
2020,198136,40,5,1,0,1
2020,198136,42,0,35,20,15
2020,198136,42,1,1,0,1
2020,198136,42,2,1,0,1
2020,198136,42,3,19,12,7
2020,198136,42,4,13,8,5
2020,198136,42,5,1,0,1
2020,198136,50,0,2,0,2
2020,198154,0,0,267,125,142
2020,198154,10,0,267,125,142
2020,198154,10,6,267,125,142
2020,198154,40,0,267,125,142
2020,198154,40,6,267,125,142
2020,198154,42,0,266,125,141
2020,198154,42,6,266,125,141
2020,198154,43,0,1,0,1
2020,198154,43,6,1,0,1
2020,198206,0,0,63,28,35
2020,198206,10,0,63,28,35
2020,198206,10,6,63,28,35
2020,198206,40,0,63,28,35
2020,198206,40,6,63,28,35
2020,198206,42,0,63,28,35
2020,198206,42,6,63,28,35
2020,198215,0,0,76,33,43
2020,198215,10,0,75,32,43
2020,198215,10,1,16,10,6
2020,198215,10,2,23,12,11
2020,198215,10,3,34,10,24
2020,198215,10,4,2,0,2
2020,198215,20,0,33,20,13
2020,198215,20,1,16,10,6
2020,198215,20,2,12,8,4
2020,198215,20,3,5,2,3
2020,198215,30,0,30,11,19
2020,198215,30,2,11,4,7
2020,198215,30,3,19,7,12
2020,198215,40,0,12,1,11
2020,198215,40,3,10,1,9
2020,198215,40,4,2,0,2
2020,198215,41,0,4,1,3
2020,198215,41,3,4,1,3
2020,198215,43,0,8,0,8
2020,198215,43,3,6,0,6
2020,198215,43,4,2,0,2
2020,198215,44,0,4,1,3
2020,198215,44,3,4,1,3
2020,198215,50,0,1,1,0
2020,198233,0,0,143,67,76
2020,198233,10,0,142,67,75
2020,198233,10,6,142,67,75
2020,198233,40,0,142,67,75
2020,198233,40,6,142,67,75
2020,198233,42,0,142,67,75
2020,198233,42,6,142,67,75
2020,198233,50,0,1,0,1
2020,198251,0,0,169,69,100
2020,198251,10,0,169,69,100
2020,198251,10,6,169,69,100
2020,198251,40,0,169,69,100
2020,198251,40,6,169,69,100
2020,198251,42,0,169,69,100
2020,198251,42,6,169,69,100
2020,198260,0,0,376,167,209
2020,198260,10,0,376,167,209
2020,198260,10,6,376,167,209
2020,198260,40,0,376,167,209
2020,198260,40,6,376,167,209
2020,198260,42,0,376,167,209
2020,198260,42,6,376,167,209
2020,198303,0,0,48,25,23
2020,198303,10,0,48,25,23
2020,198303,10,1,14,8,6
2020,198303,10,2,18,10,8
2020,198303,10,3,14,7,7
2020,198303,10,4,2,0,2
2020,198303,20,0,28,17,11
2020,198303,20,1,14,8,6
2020,198303,20,2,14,9,5
2020,198303,30,0,14,7,7
2020,198303,30,2,2,1,1
2020,198303,30,3,11,6,5
2020,198303,30,4,1,0,1
2020,198303,40,0,6,1,5
2020,198303,40,2,2,0,2
2020,198303,40,3,3,1,2
2020,198303,40,4,1,0,1
2020,198303,42,0,6,1,5
2020,198303,42,2,2,0,2
2020,198303,42,3,3,1,2
2020,198303,42,4,1,0,1
2020,198321,0,0,67,27,40
2020,198321,10,0,67,27,40
2020,198321,10,6,67,27,40
2020,198321,40,0,67,27,40
2020,198321,40,6,67,27,40
2020,198321,42,0,12,7,5
2020,198321,42,6,12,7,5
2020,198321,43,0,55,20,35
2020,198321,43,6,55,20,35
2020,198330,0,0,134,59,75
2020,198330,10,0,134,59,75
2020,198330,10,6,134,59,75
2020,198330,40,0,134,59,75
2020,198330,40,6,134,59,75
2020,198330,42,0,134,59,75
2020,198330,42,6,134,59,75
2020,198367,0,0,66,32,34
2020,198367,10,0,66,32,34
2020,198367,10,6,66,32,34
2020,198367,40,0,66,32,34
2020,198367,40,6,66,32,34
2020,198367,42,0,66,32,34
2020,198367,42,6,66,32,34
2020,198376,0,0,86,42,44
2020,198376,10,0,86,42,44
2020,198376,10,6,86,42,44
2020,198376,40,0,86,42,44
2020,198376,40,6,86,42,44
2020,198376,42,0,86,42,44
2020,198376,42,6,86,42,44
2020,198385,0,0,222,109,113
2020,198385,10,0,219,107,112
2020,198385,10,1,87,49,38
2020,198385,10,2,41,23,18
2020,198385,10,3,85,35,50
2020,198385,10,4,1,0,1
2020,198385,10,5,5,0,5
2020,198385,20,0,120,69,51
2020,198385,20,1,82,47,35
2020,198385,20,2,38,22,16
2020,198385,30,0,42,11,31
2020,198385,30,1,1,0,1
2020,198385,30,2,1,0,1
2020,198385,30,3,39,11,28
2020,198385,30,4,1,0,1
2020,198385,40,0,57,27,30
2020,198385,40,1,4,2,2
2020,198385,40,2,2,1,1
2020,198385,40,3,46,24,22
2020,198385,40,5,5,0,5
2020,198385,41,0,55,27,28
2020,198385,41,1,3,2,1
2020,198385,41,2,2,1,1
2020,198385,41,3,45,24,21
2020,198385,41,5,5,0,5
2020,198385,42,0,2,0,2
2020,198385,42,1,1,0,1
2020,198385,42,3,1,0,1
2020,198385,44,0,50,25,25
2020,198385,44,1,2,1,1
2020,198385,44,2,1,1,0
2020,198385,44,3,42,23,19
2020,198385,44,5,5,0,5
2020,198385,45,0,5,2,3
2020,198385,45,1,1,1,0
2020,198385,45,2,1,0,1
2020,198385,45,3,3,1,2
2020,198385,50,0,3,2,1
2020,198419,0,0,4074,2375,1699
2020,198419,10,0,4074,2375,1699
2020,198419,10,1,1384,997,387
2020,198419,10,2,929,529,400
2020,198419,10,3,1260,634,626
2020,198419,10,4,353,160,193
2020,198419,10,5,148,55,93
2020,198419,20,0,1375,998,377
2020,198419,20,1,1022,778,244
2020,198419,20,2,353,220,133
2020,198419,30,0,286,165,121
2020,198419,30,2,103,58,45
2020,198419,30,3,183,107,76
2020,198419,40,0,2413,1212,1201
2020,198419,40,1,362,219,143
2020,198419,40,2,473,251,222
2020,198419,40,3,1077,527,550
2020,198419,40,4,353,160,193
2020,198419,40,5,148,55,93
2020,198419,41,0,2044,1040,1004
2020,198419,41,1,344,207,137
2020,198419,41,2,464,245,219
2020,198419,41,3,1063,519,544
2020,198419,41,4,135,58,77
2020,198419,41,5,38,11,27
2020,198419,42,0,369,172,197
2020,198419,42,1,18,12,6
2020,198419,42,2,9,6,3
2020,198419,42,3,14,8,6
2020,198419,42,4,218,102,116
2020,198419,42,5,110,44,66
2020,198419,44,0,2044,1040,1004
2020,198419,44,1,344,207,137
2020,198419,44,2,464,245,219
2020,198419,44,3,1063,519,544
2020,198419,44,4,135,58,77
2020,198419,44,5,38,11,27
2020,198455,0,0,134,37,97
2020,198455,10,0,128,35,93
2020,198455,10,4,5,3,2
2020,198455,10,6,123,32,91
2020,198455,40,0,128,35,93
2020,198455,40,4,5,3,2
2020,198455,40,6,123,32,91
2020,198455,42,0,128,35,93
2020,198455,42,4,5,3,2
2020,198455,42,6,123,32,91
2020,198455,50,0,6,2,4
2020,198464,0,0,1357,694,663
2020,198464,10,0,1338,685,653
2020,198464,10,1,298,197,101
2020,198464,10,2,467,247,220
2020,198464,10,3,385,173,212
2020,198464,10,4,170,63,107
2020,198464,10,6,18,5,13
2020,198464,20,0,668,400,268
2020,198464,20,1,280,194,86
2020,198464,20,2,385,204,181
2020,198464,20,3,3,2,1
2020,198464,30,0,212,103,109
2020,198464,30,2,7,4,3
2020,198464,30,3,205,99,106
2020,198464,40,0,458,182,276
2020,198464,40,1,18,3,15
2020,198464,40,2,75,39,36
2020,198464,40,3,177,72,105
2020,198464,40,4,170,63,107
2020,198464,40,6,18,5,13
2020,198464,41,0,165,69,96
2020,198464,41,1,10,2,8
2020,198464,41,2,46,24,22
2020,198464,41,3,90,39,51
2020,198464,41,4,13,3,10
2020,198464,41,6,6,1,5
2020,198464,42,0,24,10,14
2020,198464,42,1,1,1,0
2020,198464,42,3,4,3,1
2020,198464,42,4,9,2,7
2020,198464,42,6,10,4,6
2020,198464,43,0,269,103,166
2020,198464,43,1,7,0,7
2020,198464,43,2,29,15,14
2020,198464,43,3,83,30,53
2020,198464,43,4,148,58,90
2020,198464,43,6,2,0,2
2020,198464,44,0,165,69,96
2020,198464,44,1,10,2,8
2020,198464,44,2,46,24,22
2020,198464,44,3,90,39,51
2020,198464,44,4,13,3,10
2020,198464,44,6,6,1,5
2020,198464,50,0,19,9,10
2020,198491,0,0,70,19,51
2020,198491,10,0,70,19,51
2020,198491,10,6,70,19,51
2020,198491,40,0,70,19,51
2020,198491,40,6,70,19,51
2020,198491,42,0,70,19,51
2020,198491,42,6,70,19,51
2020,198507,0,0,88,55,33
2020,198507,10,0,88,55,33
2020,198507,10,1,22,17,5
2020,198507,10,2,27,16,11
2020,198507,10,3,24,15,9
2020,198507,10,5,14,7,7
2020,198507,10,6,1,0,1
2020,198507,20,0,43,29,14
2020,198507,20,1,20,16,4
2020,198507,20,2,22,12,10
2020,198507,20,3,1,1,0
2020,198507,30,0,24,14,10
2020,198507,30,1,2,1,1
2020,198507,30,2,2,2,0
2020,198507,30,3,17,10,7
2020,198507,30,5,3,1,2
2020,198507,40,0,21,12,9
2020,198507,40,2,3,2,1
2020,198507,40,3,6,4,2
2020,198507,40,5,11,6,5
2020,198507,40,6,1,0,1
2020,198507,41,0,4,4,0
2020,198507,41,2,1,1,0
2020,198507,41,3,2,2,0
2020,198507,41,5,1,1,0
2020,198507,42,0,16,8,8
2020,198507,42,2,2,1,1
2020,198507,42,3,4,2,2
2020,198507,42,5,10,5,5
2020,198507,43,0,1,0,1
2020,198507,43,6,1,0,1
2020,198507,44,0,4,4,0
2020,198507,44,2,1,1,0
2020,198507,44,3,2,2,0
2020,198507,44,5,1,1,0
2020,198516,0,0,447,224,223
2020,198516,10,0,447,224,223
2020,198516,10,1,87,46,41
2020,198516,10,2,150,76,74
2020,198516,10,3,150,72,78
2020,198516,10,4,3,1,2
2020,198516,10,5,57,29,28
2020,198516,20,0,213,113,100
2020,198516,20,1,83,44,39
2020,198516,20,2,130,69,61
2020,198516,30,0,112,51,61
2020,198516,30,1,1,1,0
2020,198516,30,2,3,0,3
2020,198516,30,3,107,50,57
2020,198516,30,4,1,0,1
2020,198516,40,0,122,60,62
2020,198516,40,1,3,1,2
2020,198516,40,2,17,7,10
2020,198516,40,3,43,22,21
2020,198516,40,4,2,1,1
2020,198516,40,5,57,29,28
2020,198516,42,0,122,60,62
2020,198516,42,1,3,1,2
2020,198516,42,2,17,7,10
2020,198516,42,3,43,22,21
2020,198516,42,4,2,1,1
2020,198516,42,5,57,29,28
2020,198534,0,0,328,149,179
2020,198534,10,0,328,149,179
2020,198534,10,6,328,149,179
2020,198534,40,0,328,149,179
2020,198534,40,6,328,149,179
2020,198534,42,0,319,146,173
2020,198534,42,6,319,146,173
2020,198534,43,0,9,3,6
2020,198534,43,6,9,3,6
2020,198543,0,0,266,144,122
2020,198543,10,0,263,141,122
2020,198543,10,1,84,60,24
2020,198543,10,2,75,34,41
2020,198543,10,3,41,15,26
2020,198543,10,4,3,2,1
2020,198543,10,5,45,21,24
2020,198543,10,6,15,9,6
2020,198543,20,0,147,88,59
2020,198543,20,1,78,55,23
2020,198543,20,2,62,31,31
2020,198543,20,3,6,2,4
2020,198543,20,6,1,0,1
2020,198543,30,0,45,18,27
2020,198543,30,1,5,4,1
2020,198543,30,2,11,3,8
2020,198543,30,3,29,11,18
2020,198543,40,0,71,35,36
2020,198543,40,1,1,1,0
2020,198543,40,2,2,0,2
2020,198543,40,3,6,2,4
2020,198543,40,4,3,2,1
2020,198543,40,5,45,21,24
2020,198543,40,6,14,9,5
2020,198543,41,0,5,3,2
2020,198543,41,4,1,0,1
2020,198543,41,5,4,3,1
2020,198543,42,0,65,31,34
2020,198543,42,1,1,1,0
2020,198543,42,2,2,0,2
2020,198543,42,3,6,2,4
2020,198543,42,4,2,2,0
2020,198543,42,5,41,18,23
2020,198543,42,6,13,8,5
2020,198543,43,0,1,1,0
2020,198543,43,6,1,1,0
2020,198543,44,0,5,3,2
2020,198543,44,4,1,0,1
2020,198543,44,5,4,3,1
2020,198543,50,0,3,3,0
2020,198552,0,0,219,85,134
2020,198552,10,0,219,85,134
2020,198552,10,1,31,7,24
2020,198552,10,2,19,5,14
2020,198552,10,3,5,2,3
2020,198552,10,4,164,71,93
2020,198552,40,0,219,85,134
2020,198552,40,1,31,7,24
2020,198552,40,2,19,5,14
2020,198552,40,3,5,2,3
2020,198552,40,4,164,71,93
2020,198552,41,0,219,85,134
2020,198552,41,1,31,7,24
2020,198552,41,2,19,5,14
2020,198552,41,3,5,2,3
2020,198552,41,4,164,71,93
2020,198552,45,0,219,85,134
2020,198552,45,1,31,7,24
2020,198552,45,2,19,5,14
2020,198552,45,3,5,2,3
2020,198552,45,4,164,71,93
2020,198561,0,0,149,68,81
2020,198561,10,0,149,68,81
2020,198561,10,1,57,36,21
2020,198561,10,2,27,12,15
2020,198561,10,3,46,14,32
2020,198561,10,4,18,6,12
2020,198561,10,5,1,0,1
2020,198561,20,0,66,38,28
2020,198561,20,1,50,30,20
2020,198561,20,2,15,7,8
2020,198561,20,3,1,1,0
2020,198561,30,0,19,4,15
2020,198561,30,2,5,2,3
2020,198561,30,3,14,2,12
2020,198561,40,0,64,26,38
2020,198561,40,1,7,6,1
2020,198561,40,2,7,3,4
2020,198561,40,3,31,11,20
2020,198561,40,4,18,6,12
2020,198561,40,5,1,0,1
2020,198561,42,0,64,26,38
2020,198561,42,1,7,6,1
2020,198561,42,2,7,3,4
2020,198561,42,3,31,11,20
2020,198561,42,4,18,6,12
2020,198561,42,5,1,0,1
2020,198570,0,0,142,48,94
2020,198570,10,0,142,48,94
2020,198570,10,6,142,48,94
2020,198570,40,0,142,48,94
2020,198570,40,6,142,48,94
2020,198570,42,0,36,19,17
2020,198570,42,6,36,19,17
2020,198570,43,0,106,29,77
2020,198570,43,6,106,29,77
2020,198598,0,0,47,23,24
2020,198598,10,0,46,22,24
2020,198598,10,1,20,11,9
2020,198598,10,2,11,7,4
2020,198598,10,3,11,3,8
2020,198598,10,4,4,1,3
2020,198598,20,0,11,6,5
2020,198598,20,1,9,5,4
2020,198598,20,2,2,1,1
2020,198598,30,0,2,1,1
2020,198598,30,2,1,1,0
2020,198598,30,3,1,0,1
2020,198598,40,0,33,15,18
2020,198598,40,1,11,6,5
2020,198598,40,2,8,5,3
2020,198598,40,3,10,3,7
2020,198598,40,4,4,1,3
2020,198598,41,0,12,7,5
2020,198598,41,1,10,6,4
2020,198598,41,2,2,1,1
2020,198598,42,0,21,8,13
2020,198598,42,1,1,0,1
2020,198598,42,2,6,4,2
2020,198598,42,3,10,3,7
2020,198598,42,4,4,1,3
2020,198598,44,0,12,7,5
2020,198598,44,1,10,6,4
2020,198598,44,2,2,1,1
2020,198598,50,0,1,1,0
2020,198613,0,0,86,40,46
2020,198613,10,0,86,40,46
2020,198613,10,1,36,17,19
2020,198613,10,2,28,13,15
2020,198613,10,3,6,2,4
2020,198613,10,4,16,8,8
2020,198613,20,0,65,30,35
2020,198613,20,1,36,17,19
2020,198613,20,2,28,13,15
2020,198613,20,3,1,0,1
2020,198613,30,0,5,2,3
2020,198613,30,3,5,2,3
2020,198613,40,0,16,8,8
2020,198613,40,4,16,8,8
2020,198613,42,0,16,8,8
2020,198613,42,4,16,8,8
2020,198622,0,0,287,154,133
2020,198622,10,0,287,154,133
2020,198622,10,6,287,154,133
2020,198622,40,0,287,154,133
2020,198622,40,6,287,154,133
2020,198622,42,0,287,154,133
2020,198622,42,6,287,154,133
2020,198640,0,0,37,20,17
2020,198640,10,0,37,20,17
2020,198640,10,6,37,20,17
2020,198640,40,0,37,20,17
2020,198640,40,6,37,20,17
2020,198640,42,0,37,20,17
2020,198640,42,6,37,20,17
2020,198668,0,0,56,28,28
2020,198668,10,0,55,28,27
2020,198668,10,6,55,28,27
2020,198668,40,0,55,28,27
2020,198668,40,6,55,28,27
2020,198668,42,0,55,28,27
2020,198668,42,6,55,28,27
2020,198668,50,0,1,0,1
2020,198695,0,0,298,159,139
2020,198695,10,0,298,159,139
2020,198695,10,1,31,21,10
2020,198695,10,2,93,54,39
2020,198695,10,3,141,71,70
2020,198695,10,4,33,13,20
2020,198695,20,0,90,53,37
2020,198695,20,1,25,19,6
2020,198695,20,2,65,34,31
2020,198695,30,0,109,59,50
2020,198695,30,1,2,1,1
2020,198695,30,2,19,12,7
2020,198695,30,3,88,46,42
2020,198695,40,0,99,47,52
2020,198695,40,1,4,1,3
2020,198695,40,2,9,8,1
2020,198695,40,3,53,25,28
2020,198695,40,4,33,13,20
2020,198695,42,0,99,47,52
2020,198695,42,1,4,1,3
2020,198695,42,2,9,8,1
2020,198695,42,3,53,25,28
2020,198695,42,4,33,13,20
2020,198710,0,0,58,22,36
2020,198710,10,0,58,22,36
2020,198710,10,6,58,22,36
2020,198710,40,0,58,22,36
2020,198710,40,6,58,22,36
2020,198710,42,0,58,22,36
2020,198710,42,6,58,22,36
2020,198729,0,0,36,12,24
2020,198729,10,0,36,12,24
2020,198729,10,6,36,12,24
2020,198729,40,0,36,12,24
2020,198729,40,6,36,12,24
2020,198729,42,0,36,12,24
2020,198729,42,6,36,12,24
2020,198756,0,0,85,38,47
2020,198756,10,0,85,38,47
2020,198756,10,1,13,5,8
2020,198756,10,2,24,11,13
2020,198756,10,3,39,17,22
2020,198756,10,4,9,5,4
2020,198756,20,0,37,15,22
2020,198756,20,1,12,4,8
2020,198756,20,2,20,7,13
2020,198756,20,3,5,4,1
2020,198756,30,0,16,6,10
2020,198756,30,2,3,3,0
2020,198756,30,3,13,3,10
2020,198756,40,0,32,17,15
2020,198756,40,1,1,1,0
2020,198756,40,2,1,1,0
2020,198756,40,3,21,10,11
2020,198756,40,4,9,5,4
2020,198756,42,0,32,17,15
2020,198756,42,1,1,1,0
2020,198756,42,2,1,1,0
2020,198756,42,3,21,10,11
2020,198756,42,4,9,5,4
2020,198774,0,0,136,61,75
2020,198774,10,0,136,61,75
2020,198774,10,6,136,61,75
2020,198774,40,0,136,61,75
2020,198774,40,6,136,61,75
2020,198774,42,0,136,61,75
2020,198774,42,6,136,61,75
2020,198808,0,0,60,24,36
2020,198808,10,0,60,24,36
2020,198808,10,1,11,5,6
2020,198808,10,2,20,9,11
2020,198808,10,3,17,6,11
2020,198808,10,4,12,4,8
2020,198808,40,0,60,24,36
2020,198808,40,1,11,5,6
2020,198808,40,2,20,9,11
2020,198808,40,3,17,6,11
2020,198808,40,4,12,4,8
2020,198808,41,0,47,18,29
2020,198808,41,1,11,5,6
2020,198808,41,2,19,9,10
2020,198808,41,3,11,3,8
2020,198808,41,4,6,1,5
2020,198808,42,0,12,5,7
2020,198808,42,2,1,0,1
2020,198808,42,3,6,3,3
2020,198808,42,4,5,2,3
2020,198808,43,0,1,1,0
2020,198808,43,4,1,1,0
2020,198808,44,0,47,18,29
2020,198808,44,1,11,5,6
2020,198808,44,2,19,9,10
2020,198808,44,3,11,3,8
2020,198808,44,4,6,1,5
2020,198817,0,0,108,38,70
2020,198817,10,0,108,38,70
2020,198817,10,6,108,38,70
2020,198817,40,0,108,38,70
2020,198817,40,6,108,38,70
2020,198817,42,0,108,38,70
2020,198817,42,6,108,38,70
2020,198835,0,0,140,59,81
2020,198835,10,0,140,59,81
2020,198835,10,1,43,25,18
2020,198835,10,2,29,15,14
2020,198835,10,3,46,14,32
2020,198835,10,4,22,5,17
2020,198835,20,0,60,35,25
2020,198835,20,1,43,25,18
2020,198835,20,2,17,10,7
2020,198835,30,0,32,11,21
2020,198835,30,2,5,2,3
2020,198835,30,3,27,9,18
2020,198835,40,0,48,13,35
2020,198835,40,2,7,3,4
2020,198835,40,3,19,5,14
2020,198835,40,4,22,5,17
2020,198835,42,0,48,13,35
2020,198835,42,2,7,3,4
2020,198835,42,3,19,5,14
2020,198835,42,4,22,5,17
2020,198862,0,0,62,30,32
2020,198862,10,0,62,30,32
2020,198862,10,1,13,4,9
2020,198862,10,2,7,4,3
2020,198862,10,3,19,8,11
2020,198862,10,4,23,14,9
2020,198862,20,0,10,4,6
2020,198862,20,1,8,3,5
2020,198862,20,2,1,0,1
2020,198862,20,3,1,1,0
2020,198862,30,0,11,6,5
2020,198862,30,1,1,0,1
2020,198862,30,2,4,2,2
2020,198862,30,3,5,3,2
2020,198862,30,4,1,1,0
2020,198862,40,0,41,20,21
2020,198862,40,1,4,1,3
2020,198862,40,2,2,2,0
2020,198862,40,3,13,4,9
2020,198862,40,4,22,13,9
2020,198862,42,0,41,20,21
2020,198862,42,1,4,1,3
2020,198862,42,2,2,2,0
2020,198862,42,3,13,4,9
2020,198862,42,4,22,13,9
2020,198871,0,0,29,11,18
2020,198871,10,0,29,11,18
2020,198871,10,1,2,1,1
2020,198871,10,2,3,2,1
2020,198871,10,3,9,6,3
2020,198871,10,4,15,2,13
2020,198871,40,0,29,11,18
2020,198871,40,1,2,1,1
2020,198871,40,2,3,2,1
2020,198871,40,3,9,6,3
2020,198871,40,4,15,2,13
2020,198871,42,0,29,11,18
2020,198871,42,1,2,1,1
2020,198871,42,2,3,2,1
2020,198871,42,3,9,6,3
2020,198871,42,4,15,2,13
2020,198899,0,0,83,35,48
2020,198899,10,0,83,35,48
2020,198899,10,1,18,9,9
2020,198899,10,2,29,11,18
2020,198899,10,3,25,12,13
2020,198899,10,4,9,3,6
2020,198899,10,5,2,0,2
2020,198899,20,0,47,21,26
2020,198899,20,1,18,9,9
2020,198899,20,2,26,10,16
2020,198899,20,3,3,2,1
2020,198899,30,0,25,11,14
2020,198899,30,2,2,0,2
2020,198899,30,3,20,10,10
2020,198899,30,4,2,1,1
2020,198899,30,5,1,0,1
2020,198899,40,0,11,3,8
2020,198899,40,2,1,1,0
2020,198899,40,3,2,0,2
2020,198899,40,4,7,2,5
2020,198899,40,5,1,0,1
2020,198899,42,0,11,3,8
2020,198899,42,2,1,1,0
2020,198899,42,3,2,0,2
2020,198899,42,4,7,2,5
2020,198899,42,5,1,0,1
2020,198905,0,0,28,11,17
2020,198905,10,0,27,11,16
2020,198905,10,6,27,11,16
2020,198905,40,0,27,11,16
2020,198905,40,6,27,11,16
2020,198905,42,0,27,11,16
2020,198905,42,6,27,11,16
2020,198905,50,0,1,0,1
2020,198914,0,0,30,13,17
2020,198914,10,0,30,13,17
2020,198914,10,6,30,13,17
2020,198914,40,0,30,13,17
2020,198914,40,6,30,13,17
2020,198914,42,0,30,13,17
2020,198914,42,6,30,13,17
2020,198923,0,0,40,19,21
2020,198923,10,0,40,19,21
2020,198923,10,4,40,19,21
2020,198923,40,0,40,19,21
2020,198923,40,4,40,19,21
2020,198923,42,0,40,19,21
2020,198923,42,4,40,19,21
2020,198950,0,0,130,42,88
2020,198950,10,0,130,42,88
2020,198950,10,1,52,16,36
2020,198950,10,2,30,11,19
2020,198950,10,3,42,11,31
2020,198950,10,4,4,3,1
2020,198950,10,6,2,1,1
2020,198950,20,0,74,25,49
2020,198950,20,1,48,15,33
2020,198950,20,2,26,10,16
2020,198950,30,0,27,7,20
2020,198950,30,1,1,0,1
2020,198950,30,2,2,0,2
2020,198950,30,3,24,7,17
2020,198950,40,0,29,10,19
2020,198950,40,1,3,1,2
2020,198950,40,2,2,1,1
2020,198950,40,3,18,4,14
2020,198950,40,4,4,3,1
2020,198950,40,6,2,1,1
2020,198950,41,0,10,1,9
2020,198950,41,1,2,0,2
2020,198950,41,2,1,0,1
2020,198950,41,3,6,1,5
2020,198950,41,4,1,0,1
2020,198950,42,0,19,9,10
2020,198950,42,1,1,1,0
2020,198950,42,2,1,1,0
2020,198950,42,3,12,3,9
2020,198950,42,4,3,3,0
2020,198950,42,6,2,1,1
2020,198950,44,0,10,1,9
2020,198950,44,1,2,0,2
2020,198950,44,2,1,0,1
2020,198950,44,3,6,1,5
2020,198950,44,4,1,0,1
2020,198969,0,0,144,76,68
2020,198969,10,0,144,76,68
2020,198969,10,1,41,25,16
2020,198969,10,2,45,29,16
2020,198969,10,3,42,18,24
2020,198969,10,4,16,4,12
2020,198969,20,0,66,40,26
2020,198969,20,1,41,25,16
2020,198969,20,2,25,15,10
2020,198969,30,0,41,21,20
2020,198969,30,2,10,8,2
2020,198969,30,3,31,13,18
2020,198969,40,0,37,15,22
2020,198969,40,2,10,6,4
2020,198969,40,3,11,5,6
2020,198969,40,4,16,4,12
2020,198969,42,0,37,15,22
2020,198969,42,2,10,6,4
2020,198969,42,3,11,5,6
2020,198969,42,4,16,4,12
2020,198978,0,0,3,0,3
2020,198978,10,0,3,0,3
2020,198978,10,4,3,0,3
2020,198978,40,0,3,0,3
2020,198978,40,4,3,0,3
2020,198978,41,0,3,0,3
2020,198978,41,4,3,0,3
2020,198978,45,0,3,0,3
2020,198978,45,4,3,0,3
2020,198987,0,0,79,27,52
2020,198987,10,0,79,27,52
2020,198987,10,6,79,27,52
2020,198987,40,0,79,27,52
2020,198987,40,6,79,27,52
2020,198987,42,0,79,27,52
2020,198987,42,6,79,27,52
2020,199023,0,0,40,21,19
2020,199023,10,0,40,21,19
2020,199023,10,6,40,21,19
2020,199023,40,0,40,21,19
2020,199023,40,6,40,21,19
2020,199023,42,0,40,21,19
2020,199023,42,6,40,21,19
2020,199032,0,0,38,25,13
2020,199032,10,0,38,25,13
2020,199032,10,1,13,10,3
2020,199032,10,2,8,5,3
2020,199032,10,3,17,10,7
2020,199032,20,0,17,13,4
2020,199032,20,1,10,9,1
2020,199032,20,2,4,2,2
2020,199032,20,3,3,2,1
2020,199032,30,0,3,2,1
2020,199032,30,2,3,2,1
2020,199032,40,0,18,10,8
2020,199032,40,1,3,1,2
2020,199032,40,2,1,1,0
2020,199032,40,3,14,8,6
2020,199032,42,0,18,10,8
2020,199032,42,1,3,1,2
2020,199032,42,2,1,1,0
2020,199032,42,3,14,8,6
2020,199069,0,0,70,41,29
2020,199069,10,0,70,41,29
2020,199069,10,1,14,10,4
2020,199069,10,2,24,13,11
2020,199069,10,3,30,17,13
2020,199069,10,4,2,1,1
2020,199069,40,0,70,41,29
2020,199069,40,1,14,10,4
2020,199069,40,2,24,13,11
2020,199069,40,3,30,17,13
2020,199069,40,4,2,1,1
2020,199069,41,0,62,37,25
2020,199069,41,1,13,9,4
2020,199069,41,2,24,13,11
2020,199069,41,3,23,14,9
2020,199069,41,4,2,1,1
2020,199069,42,0,8,4,4
2020,199069,42,1,1,1,0
2020,199069,42,3,7,3,4
2020,199069,44,0,62,37,25
2020,199069,44,1,13,9,4
2020,199069,44,2,24,13,11
2020,199069,44,3,23,14,9
2020,199069,44,4,2,1,1
2020,199087,0,0,110,43,67
2020,199087,10,0,110,43,67
2020,199087,10,6,110,43,67
2020,199087,40,0,110,43,67
2020,199087,40,6,110,43,67
2020,199087,42,0,110,43,67
2020,199087,42,6,110,43,67
2020,199102,0,0,473,272,201
2020,199102,10,0,473,272,201
2020,199102,10,1,112,85,27
2020,199102,10,2,172,92,80
2020,199102,10,3,120,58,62
2020,199102,10,4,5,2,3
2020,199102,10,5,24,14,10
2020,199102,10,6,40,21,19
2020,199102,20,0,243,158,85
2020,199102,20,1,104,78,26
2020,199102,20,2,138,80,58
2020,199102,20,3,1,0,1
2020,199102,30,0,154,75,79
2020,199102,30,1,7,6,1
2020,199102,30,2,34,12,22
2020,199102,30,3,109,54,55
2020,199102,30,5,4,3,1
2020,199102,40,0,76,39,37
2020,199102,40,1,1,1,0
2020,199102,40,3,10,4,6
2020,199102,40,4,5,2,3
2020,199102,40,5,20,11,9
2020,199102,40,6,40,21,19
2020,199102,41,0,3,3,0
2020,199102,41,5,3,3,0
2020,199102,42,0,56,27,29
2020,199102,42,1,1,1,0
2020,199102,42,3,9,3,6
2020,199102,42,4,5,2,3
2020,199102,42,5,10,5,5
2020,199102,42,6,31,16,15
2020,199102,43,0,17,9,8
2020,199102,43,3,1,1,0
2020,199102,43,5,7,3,4
2020,199102,43,6,9,5,4
2020,199102,44,0,3,3,0
2020,199102,44,5,3,3,0
2020,199111,0,0,224,113,111
2020,199111,10,0,224,113,111
2020,199111,10,1,68,42,26
2020,199111,10,2,57,27,30
2020,199111,10,3,44,21,23
2020,199111,10,4,1,0,1
2020,199111,10,5,54,23,31
2020,199111,20,0,122,66,56
2020,199111,20,1,66,40,26
2020,199111,20,2,56,26,30
2020,199111,30,0,41,20,21
2020,199111,30,2,1,1,0
2020,199111,30,3,40,19,21
2020,199111,40,0,61,27,34
2020,199111,40,1,2,2,0
2020,199111,40,3,4,2,2
2020,199111,40,4,1,0,1
2020,199111,40,5,54,23,31
2020,199111,41,0,23,11,12
2020,199111,41,4,1,0,1
2020,199111,41,5,22,11,11
2020,199111,42,0,38,16,22
2020,199111,42,1,2,2,0
2020,199111,42,3,4,2,2
2020,199111,42,5,32,12,20
2020,199111,44,0,23,11,12
2020,199111,44,4,1,0,1
2020,199111,44,5,22,11,11
2020,199120,0,0,1910,985,925
2020,199120,10,0,1910,985,925
2020,199120,10,1,733,459,274
2020,199120,10,2,512,257,255
2020,199120,10,3,399,163,236
2020,199120,10,4,47,11,36
2020,199120,10,5,214,93,121
2020,199120,10,6,5,2,3
2020,199120,20,0,1026,634,392
2020,199120,20,1,650,422,228
2020,199120,20,2,374,212,162
2020,199120,20,3,2,0,2
2020,199120,30,0,260,129,131
2020,199120,30,2,17,6,11
2020,199120,30,3,243,123,120
2020,199120,40,0,624,222,402
2020,199120,40,1,83,37,46
2020,199120,40,2,121,39,82
2020,199120,40,3,154,40,114
2020,199120,40,4,47,11,36
2020,199120,40,5,214,93,121
2020,199120,40,6,5,2,3
2020,199120,41,0,379,135,244
2020,199120,41,1,61,23,38
2020,199120,41,2,85,27,58
2020,199120,41,3,75,19,56
2020,199120,41,4,3,2,1
2020,199120,41,5,155,64,91
2020,199120,42,0,215,71,144
2020,199120,42,1,20,12,8
2020,199120,42,2,34,10,24
2020,199120,42,3,77,21,56
2020,199120,42,4,42,8,34
2020,199120,42,5,37,18,19
2020,199120,42,6,5,2,3
2020,199120,43,0,30,16,14
2020,199120,43,1,2,2,0
2020,199120,43,2,2,2,0
2020,199120,43,3,2,0,2
2020,199120,43,4,2,1,1
2020,199120,43,5,22,11,11
2020,199120,44,0,379,135,244
2020,199120,44,1,61,23,38
2020,199120,44,2,85,27,58
2020,199120,44,3,75,19,56
2020,199120,44,4,3,2,1
2020,199120,44,5,155,64,91
2020,199139,0,0,1095,550,545
2020,199139,10,0,1094,550,544
2020,199139,10,1,299,198,101
2020,199139,10,2,292,151,141
2020,199139,10,3,261,114,147
2020,199139,10,5,242,87,155
2020,199139,20,0,536,326,210
2020,199139,20,1,266,183,83
2020,199139,20,2,270,143,127
2020,199139,30,0,204,91,113
2020,199139,30,2,1,0,1
2020,199139,30,3,203,91,112
2020,199139,40,0,354,133,221
2020,199139,40,1,33,15,18
2020,199139,40,2,21,8,13
2020,199139,40,3,58,23,35
2020,199139,40,5,242,87,155
2020,199139,41,0,335,126,209
2020,199139,41,1,32,14,18
2020,199139,41,2,20,8,12
2020,199139,41,3,54,21,33
2020,199139,41,5,229,83,146
2020,199139,42,0,17,7,10
2020,199139,42,1,1,1,0
2020,199139,42,2,1,0,1
2020,199139,42,3,4,2,2
2020,199139,42,5,11,4,7
2020,199139,43,0,2,0,2
2020,199139,43,5,2,0,2
2020,199139,44,0,335,126,209
2020,199139,44,1,32,14,18
2020,199139,44,2,20,8,12
2020,199139,44,3,54,21,33
2020,199139,44,5,229,83,146
2020,199139,50,0,1,0,1
2020,199148,0,0,887,405,482
2020,199148,10,0,860,388,472
2020,199148,10,1,210,119,91
2020,199148,10,2,221,97,124
2020,199148,10,3,250,96,154
2020,199148,10,4,8,2,6
2020,199148,10,5,169,72,97
2020,199148,10,6,2,2,0
2020,199148,20,0,391,205,186
2020,199148,20,1,195,113,82
2020,199148,20,2,195,91,104
2020,199148,20,3,1,1,0
2020,199148,30,0,179,76,103
2020,199148,30,3,179,76,103
2020,199148,40,0,290,107,183
2020,199148,40,1,15,6,9
2020,199148,40,2,26,6,20
2020,199148,40,3,70,19,51
2020,199148,40,4,8,2,6
2020,199148,40,5,169,72,97
2020,199148,40,6,2,2,0
2020,199148,41,0,260,96,164
2020,199148,41,1,12,6,6
2020,199148,41,2,25,6,19
2020,199148,41,3,63,16,47
2020,199148,41,4,7,2,5
2020,199148,41,5,151,64,87
2020,199148,41,6,2,2,0
2020,199148,42,0,30,11,19
2020,199148,42,1,3,0,3
2020,199148,42,2,1,0,1
2020,199148,42,3,7,3,4
2020,199148,42,4,1,0,1
2020,199148,42,5,18,8,10
2020,199148,44,0,260,96,164
2020,199148,44,1,12,6,6
2020,199148,44,2,25,6,19
2020,199148,44,3,63,16,47
2020,199148,44,4,7,2,5
2020,199148,44,5,151,64,87
2020,199148,44,6,2,2,0
2020,199148,50,0,27,17,10
2020,199157,0,0,367,172,195
2020,199157,10,0,367,172,195
2020,199157,10,1,79,48,31
2020,199157,10,2,113,56,57
2020,199157,10,3,88,35,53
2020,199157,10,4,17,8,9
2020,199157,10,5,52,17,35
2020,199157,10,6,18,8,10
2020,199157,20,0,168,97,71
2020,199157,20,1,70,44,26
2020,199157,20,2,94,52,42
2020,199157,20,3,4,1,3
2020,199157,30,0,77,32,45
2020,199157,30,1,2,1,1
2020,199157,30,2,10,2,8
2020,199157,30,3,65,29,36
2020,199157,40,0,122,43,79
2020,199157,40,1,7,3,4
2020,199157,40,2,9,2,7
2020,199157,40,3,19,5,14
2020,199157,40,4,17,8,9
2020,199157,40,5,52,17,35
2020,199157,40,6,18,8,10
2020,199157,41,0,20,7,13
2020,199157,41,2,1,0,1
2020,199157,41,3,2,0,2
2020,199157,41,4,5,2,3
2020,199157,41,5,10,5,5
2020,199157,41,6,2,0,2
2020,199157,42,0,97,33,64
2020,199157,42,1,7,3,4
2020,199157,42,2,8,2,6
2020,199157,42,3,17,5,12
2020,199157,42,4,12,6,6
2020,199157,42,5,41,12,29
2020,199157,42,6,12,5,7
2020,199157,43,0,5,3,2
2020,199157,43,5,1,0,1
2020,199157,43,6,4,3,1
2020,199157,44,0,20,7,13
2020,199157,44,2,1,0,1
2020,199157,44,3,2,0,2
2020,199157,44,4,5,2,3
2020,199157,44,5,10,5,5
2020,199157,44,6,2,0,2
2020,199184,0,0,150,96,54
2020,199184,10,0,150,96,54
2020,199184,10,1,35,27,8
2020,199184,10,2,52,27,25
2020,199184,10,3,35,26,9
2020,199184,10,6,28,16,12
2020,199184,40,0,150,96,54
2020,199184,40,1,35,27,8
2020,199184,40,2,52,27,25
2020,199184,40,3,35,26,9
2020,199184,40,6,28,16,12
2020,199184,41,0,138,87,51
2020,199184,41,1,35,27,8
2020,199184,41,2,52,27,25
2020,199184,41,3,35,26,9
2020,199184,41,6,16,7,9
2020,199184,42,0,12,9,3
2020,199184,42,6,12,9,3
2020,199184,44,0,138,87,51
2020,199184,44,1,35,27,8
2020,199184,44,2,52,27,25
2020,199184,44,3,35,26,9
2020,199184,44,6,16,7,9
2020,199193,0,0,1842,1133,709
2020,199193,10,0,1832,1129,703
2020,199193,10,1,752,558,194
2020,199193,10,2,467,270,197
2020,199193,10,3,437,230,207
2020,199193,10,4,1,1,0
2020,199193,10,5,175,70,105
2020,199193,20,0,1091,774,317
2020,199193,20,1,713,540,173
2020,199193,20,2,378,234,144
2020,199193,30,0,348,194,154
2020,199193,30,2,16,8,8
2020,199193,30,3,332,186,146
2020,199193,40,0,393,161,232
2020,199193,40,1,39,18,21
2020,199193,40,2,73,28,45
2020,199193,40,3,105,44,61
2020,199193,40,4,1,1,0
2020,199193,40,5,175,70,105
2020,199193,41,0,298,126,172
2020,199193,41,1,31,15,16
2020,199193,41,2,69,25,44
2020,199193,41,3,80,34,46
2020,199193,41,5,118,52,66
2020,199193,42,0,30,11,19
2020,199193,42,1,3,1,2
2020,199193,42,2,1,1,0
2020,199193,42,3,12,5,7
2020,199193,42,4,1,1,0
2020,199193,42,5,13,3,10
2020,199193,43,0,65,24,41
2020,199193,43,1,5,2,3
2020,199193,43,2,3,2,1
2020,199193,43,3,13,5,8
2020,199193,43,5,44,15,29
2020,199193,44,0,298,126,172
2020,199193,44,1,31,15,16
2020,199193,44,2,69,25,44
2020,199193,44,3,80,34,46
2020,199193,44,5,118,52,66
2020,199193,50,0,10,4,6
2020,199209,0,0,60,29,31
2020,199209,10,0,60,29,31
2020,199209,10,1,14,9,5
2020,199209,10,2,20,11,9
2020,199209,10,3,20,6,14
2020,199209,10,4,6,3,3
2020,199209,20,0,35,20,15
2020,199209,20,1,14,9,5
2020,199209,20,2,19,10,9
2020,199209,20,3,2,1,1
2020,199209,30,0,17,6,11
2020,199209,30,2,1,1,0
2020,199209,30,3,15,4,11
2020,199209,30,4,1,1,0
2020,199209,40,0,8,3,5
2020,199209,40,3,3,1,2
2020,199209,40,4,5,2,3
2020,199209,42,0,8,3,5
2020,199209,42,3,3,1,2
2020,199209,42,4,5,2,3
2020,199218,0,0,725,342,383
2020,199218,10,0,725,342,383
2020,199218,10,1,186,118,68
2020,199218,10,2,188,97,91
2020,199218,10,3,194,85,109
2020,199218,10,5,157,42,115
2020,199218,20,0,366,214,152
2020,199218,20,1,186,118,68
2020,199218,20,2,179,96,83
2020,199218,20,3,1,0,1
2020,199218,30,0,196,83,113
2020,199218,30,2,7,1,6
2020,199218,30,3,189,82,107
2020,199218,40,0,163,45,118
2020,199218,40,2,2,0,2
2020,199218,40,3,4,3,1
2020,199218,40,5,157,42,115
2020,199218,42,0,163,45,118
2020,199218,42,2,2,0,2
2020,199218,42,3,4,3,1
2020,199218,42,5,157,42,115
2020,199263,0,0,28,18,10
2020,199263,10,0,28,18,10
2020,199263,10,4,28,18,10
2020,199263,40,0,28,18,10
2020,199263,40,4,28,18,10
2020,199263,42,0,28,18,10
2020,199263,42,4,28,18,10
2020,199272,0,0,37,13,24
2020,199272,10,0,37,13,24
2020,199272,10,1,5,2,3
2020,199272,10,2,9,3,6
2020,199272,10,3,23,8,15
2020,199272,20,0,8,3,5
2020,199272,20,1,5,2,3
2020,199272,20,2,3,1,2
2020,199272,40,0,29,10,19
2020,199272,40,2,6,2,4
2020,199272,40,3,23,8,15
2020,199272,41,0,25,7,18
2020,199272,41,2,6,2,4
2020,199272,41,3,19,5,14
2020,199272,42,0,4,3,1
2020,199272,42,3,4,3,1
2020,199272,44,0,25,7,18
2020,199272,44,2,6,2,4
2020,199272,44,3,19,5,14
2020,199281,0,0,315,140,175
2020,199281,10,0,315,140,175
2020,199281,10,1,73,45,28
2020,199281,10,2,69,31,38
2020,199281,10,3,98,38,60
2020,199281,10,4,1,0,1
2020,199281,10,5,74,26,48
2020,199281,20,0,139,72,67
2020,199281,20,1,71,43,28
2020,199281,20,2,64,27,37
2020,199281,20,3,4,2,2
2020,199281,30,0,84,36,48
2020,199281,30,2,5,4,1
2020,199281,30,3,79,32,47
2020,199281,40,0,92,32,60
2020,199281,40,1,2,2,0
2020,199281,40,3,15,4,11
2020,199281,40,4,1,0,1
2020,199281,40,5,74,26,48
2020,199281,41,0,10,5,5
2020,199281,41,1,2,2,0
2020,199281,41,3,1,0,1
2020,199281,41,5,7,3,4
2020,199281,42,0,82,27,55
2020,199281,42,3,14,4,10
2020,199281,42,4,1,0,1
2020,199281,42,5,67,23,44
2020,199281,44,0,10,5,5
2020,199281,44,1,2,2,0
2020,199281,44,3,1,0,1
2020,199281,44,5,7,3,4
2020,199306,0,0,88,40,48
2020,199306,10,0,88,40,48
2020,199306,10,1,14,8,6
2020,199306,10,2,33,14,19
2020,199306,10,3,40,17,23
2020,199306,10,4,1,1,0
2020,199306,40,0,88,40,48
2020,199306,40,1,14,8,6
2020,199306,40,2,33,14,19
2020,199306,40,3,40,17,23
2020,199306,40,4,1,1,0
2020,199306,41,0,36,19,17
2020,199306,41,1,11,6,5
2020,199306,41,2,22,11,11
2020,199306,41,3,3,2,1
2020,199306,42,0,18,5,13
2020,199306,42,1,2,1,1
2020,199306,42,2,2,0,2
2020,199306,42,3,14,4,10
2020,199306,43,0,34,16,18
2020,199306,43,1,1,1,0
2020,199306,43,2,9,3,6
2020,199306,43,3,23,11,12
2020,199306,43,4,1,1,0
2020,199306,44,0,36,19,17
2020,199306,44,1,11,6,5
2020,199306,44,2,22,11,11
2020,199306,44,3,3,2,1
2020,199324,0,0,46,18,28
2020,199324,10,0,46,18,28
2020,199324,10,6,46,18,28
2020,199324,40,0,46,18,28
2020,199324,40,6,46,18,28
2020,199324,42,0,46,18,28
2020,199324,42,6,46,18,28
2020,199333,0,0,185,69,116
2020,199333,10,0,185,69,116
2020,199333,10,6,185,69,116
2020,199333,40,0,185,69,116
2020,199333,40,6,185,69,116
2020,199333,42,0,185,69,116
2020,199333,42,6,185,69,116
2020,199412,0,0,131,49,82
2020,199412,10,0,131,49,82
2020,199412,10,1,34,20,14
2020,199412,10,2,34,12,22
2020,199412,10,3,44,12,32
2020,199412,10,4,16,3,13
2020,199412,10,5,3,2,1
2020,199412,20,0,63,30,33
2020,199412,20,1,33,19,14
2020,199412,20,2,30,11,19
2020,199412,30,0,27,10,17
2020,199412,30,2,2,1,1
2020,199412,30,3,25,9,16
2020,199412,40,0,41,9,32
2020,199412,40,1,1,1,0
2020,199412,40,2,2,0,2
2020,199412,40,3,19,3,16
2020,199412,40,4,16,3,13
2020,199412,40,5,3,2,1
2020,199412,42,0,41,9,32
2020,199412,42,1,1,1,0
2020,199412,42,2,2,0,2
2020,199412,42,3,19,3,16
2020,199412,42,4,16,3,13
2020,199412,42,5,3,2,1
2020,199421,0,0,84,38,46
2020,199421,10,0,83,38,45
2020,199421,10,6,83,38,45
2020,199421,40,0,83,38,45
2020,199421,40,6,83,38,45
2020,199421,42,0,83,38,45
2020,199421,42,6,83,38,45
2020,199421,50,0,1,0,1
2020,199449,0,0,99,42,57
2020,199449,10,0,99,42,57
2020,199449,10,6,99,42,57
2020,199449,40,0,99,42,57
2020,199449,40,6,99,42,57
2020,199449,42,0,99,42,57
2020,199449,42,6,99,42,57
2020,199458,0,0,14,11,3
2020,199458,10,0,14,11,3
2020,199458,10,1,5,5,0
2020,199458,10,2,4,4,0
2020,199458,10,3,3,1,2
2020,199458,10,4,2,1,1
2020,199458,40,0,14,11,3
2020,199458,40,1,5,5,0
2020,199458,40,2,4,4,0
2020,199458,40,3,3,1,2
2020,199458,40,4,2,1,1
2020,199458,42,0,14,11,3
2020,199458,42,1,5,5,0
2020,199458,42,2,4,4,0
2020,199458,42,3,3,1,2
2020,199458,42,4,2,1,1
2020,199467,0,0,22,9,13
2020,199467,10,0,22,9,13
2020,199467,10,6,22,9,13
2020,199467,40,0,22,9,13
2020,199467,40,6,22,9,13
2020,199467,42,0,22,9,13
2020,199467,42,6,22,9,13
2020,199476,0,0,78,29,49
2020,199476,10,0,78,29,49
2020,199476,10,4,78,29,49
2020,199476,40,0,78,29,49
2020,199476,40,4,78,29,49
2020,199476,42,0,38,19,19
2020,199476,42,4,38,19,19
2020,199476,43,0,40,10,30
2020,199476,43,4,40,10,30
2020,199485,0,0,58,23,35
2020,199485,10,0,58,23,35
2020,199485,10,6,58,23,35
2020,199485,40,0,58,23,35
2020,199485,40,6,58,23,35
2020,199485,42,0,58,23,35
2020,199485,42,6,58,23,35
2020,199494,0,0,171,61,110
2020,199494,10,0,171,61,110
2020,199494,10,6,171,61,110
2020,199494,40,0,171,61,110
2020,199494,40,6,171,61,110
2020,199494,42,0,170,61,109
2020,199494,42,6,170,61,109
2020,199494,43,0,1,0,1
2020,199494,43,6,1,0,1
2020,199582,0,0,62,32,30
2020,199582,10,0,60,32,28
2020,199582,10,1,4,2,2
2020,199582,10,2,13,9,4
2020,199582,10,3,40,19,21
2020,199582,10,4,3,2,1
2020,199582,20,0,9,4,5
2020,199582,20,1,4,2,2
2020,199582,20,2,5,2,3
2020,199582,40,0,51,28,23
2020,199582,40,2,8,7,1
2020,199582,40,3,40,19,21
2020,199582,40,4,3,2,1
2020,199582,42,0,51,28,23
2020,199582,42,2,8,7,1
2020,199582,42,3,40,19,21
2020,199582,42,4,3,2,1
2020,199582,50,0,2,0,2
2020,199607,0,0,43,7,36
2020,199607,10,0,40,6,34
2020,199607,10,1,8,1,7
2020,199607,10,2,21,4,17
2020,199607,10,3,10,1,9
2020,199607,10,6,1,0,1
2020,199607,20,0,24,6,18
2020,199607,20,1,8,1,7
2020,199607,20,2,15,4,11
2020,199607,20,3,1,1,0
2020,199607,30,0,2,0,2
2020,199607,30,2,1,0,1
2020,199607,30,3,1,0,1
2020,199607,40,0,14,0,14
2020,199607,40,2,5,0,5
2020,199607,40,3,8,0,8
2020,199607,40,6,1,0,1
2020,199607,41,0,5,0,5
2020,199607,41,2,5,0,5
2020,199607,42,0,9,0,9
2020,199607,42,3,8,0,8
2020,199607,42,6,1,0,1
2020,199607,44,0,5,0,5
2020,199607,44,2,5,0,5
2020,199607,50,0,3,1,2
2020,199625,0,0,67,17,50
2020,199625,10,0,65,16,49
2020,199625,10,4,65,16,49
2020,199625,40,0,65,16,49
2020,199625,40,4,65,16,49
2020,199625,42,0,53,15,38
2020,199625,42,4,53,15,38
2020,199625,43,0,12,1,11
2020,199625,43,4,12,1,11
2020,199625,50,0,2,1,1
2020,199634,0,0,115,36,79
2020,199634,10,0,115,36,79
2020,199634,10,6,115,36,79
2020,199634,40,0,115,36,79
2020,199634,40,6,115,36,79
2020,199634,42,0,115,36,79
2020,199634,42,6,115,36,79
2020,199643,0,0,61,26,35
2020,199643,10,0,61,26,35
2020,199643,10,1,2,1,1
2020,199643,10,2,11,6,5
2020,199643,10,3,37,12,25
2020,199643,10,4,11,7,4
2020,199643,40,0,61,26,35
2020,199643,40,1,2,1,1
2020,199643,40,2,11,6,5
2020,199643,40,3,37,12,25
2020,199643,40,4,11,7,4
2020,199643,42,0,61,26,35
2020,199643,42,1,2,1,1
2020,199643,42,2,11,6,5
2020,199643,42,3,37,12,25
2020,199643,42,4,11,7,4
2020,199698,0,0,50,23,27
2020,199698,10,0,50,23,27
2020,199698,10,1,6,2,4
2020,199698,10,2,14,8,6
2020,199698,10,3,26,12,14
2020,199698,10,4,4,1,3
2020,199698,20,0,4,3,1
2020,199698,20,2,4,3,1
2020,199698,40,0,46,20,26
2020,199698,40,1,6,2,4
2020,199698,40,2,10,5,5
2020,199698,40,3,26,12,14
2020,199698,40,4,4,1,3
2020,199698,42,0,4,3,1
2020,199698,42,3,4,3,1
2020,199698,43,0,42,17,25
2020,199698,43,1,6,2,4
2020,199698,43,2,10,5,5
2020,199698,43,3,22,9,13
2020,199698,43,4,4,1,3
2020,199722,0,0,60,23,37
2020,199722,10,0,60,23,37
2020,199722,10,6,60,23,37
2020,199722,40,0,60,23,37
2020,199722,40,6,60,23,37
2020,199722,42,0,59,23,36
2020,199722,42,6,59,23,36
2020,199722,43,0,1,0,1
2020,199722,43,6,1,0,1
2020,199731,0,0,81,36,45
2020,199731,10,0,81,36,45
2020,199731,10,6,81,36,45
2020,199731,40,0,81,36,45
2020,199731,40,6,81,36,45
2020,199731,42,0,81,36,45
2020,199731,42,6,81,36,45
2020,199740,0,0,78,31,47
2020,199740,10,0,78,31,47
2020,199740,10,6,78,31,47
2020,199740,40,0,78,31,47
2020,199740,40,6,78,31,47
2020,199740,42,0,75,30,45
2020,199740,42,6,75,30,45
2020,199740,43,0,3,1,2
2020,199740,43,6,3,1,2
2020,199759,0,0,53,50,3
2020,199759,10,0,53,50,3
2020,199759,10,1,28,27,1
2020,199759,10,2,8,8,0
2020,199759,10,3,15,13,2
2020,199759,10,4,2,2,0
2020,199759,40,0,53,50,3
2020,199759,40,1,28,27,1
2020,199759,40,2,8,8,0
2020,199759,40,3,15,13,2
2020,199759,40,4,2,2,0
2020,199759,41,0,53,50,3
2020,199759,41,1,28,27,1
2020,199759,41,2,8,8,0
2020,199759,41,3,15,13,2
2020,199759,41,4,2,2,0
2020,199759,44,0,53,50,3
2020,199759,44,1,28,27,1
2020,199759,44,2,8,8,0
2020,199759,44,3,15,13,2
2020,199759,44,4,2,2,0
2020,199768,0,0,95,33,62
2020,199768,10,0,95,33,62
2020,199768,10,6,95,33,62
2020,199768,40,0,95,33,62
2020,199768,40,6,95,33,62
2020,199768,42,0,95,33,62
2020,199768,42,6,95,33,62
2020,199786,0,0,113,46,67
2020,199786,10,0,113,46,67
2020,199786,10,6,113,46,67
2020,199786,40,0,113,46,67
2020,199786,40,6,113,46,67
2020,199786,42,0,110,45,65
2020,199786,42,6,110,45,65
2020,199786,43,0,3,1,2
2020,199786,43,6,3,1,2
2020,199795,0,0,37,14,23
2020,199795,10,0,37,14,23
2020,199795,10,6,37,14,23
2020,199795,40,0,37,14,23
2020,199795,40,6,37,14,23
2020,199795,42,0,37,14,23
2020,199795,42,6,37,14,23
2020,199838,0,0,96,42,54
2020,199838,10,0,96,42,54
2020,199838,10,4,96,42,54
2020,199838,40,0,96,42,54
2020,199838,40,4,96,42,54
2020,199838,42,0,96,42,54
2020,199838,42,4,96,42,54
2020,199847,0,0,1919,1117,802
2020,199847,10,0,1919,1117,802
2020,199847,10,1,481,333,148
2020,199847,10,2,485,288,197
2020,199847,10,3,743,375,368
2020,199847,10,4,103,52,51
2020,199847,10,5,45,23,22
2020,199847,10,6,62,46,16
2020,199847,20,0,525,335,190
2020,199847,20,1,303,198,105
2020,199847,20,2,191,112,79
2020,199847,20,4,5,3,2
2020,199847,20,6,26,22,4
2020,199847,30,0,181,83,98
2020,199847,30,1,3,2,1
2020,199847,30,2,14,9,5
2020,199847,30,3,160,72,88
2020,199847,30,4,4,0,4
2020,199847,40,0,1213,699,514
2020,199847,40,1,175,133,42
2020,199847,40,2,280,167,113
2020,199847,40,3,583,303,280
2020,199847,40,4,94,49,45
2020,199847,40,5,45,23,22
2020,199847,40,6,36,24,12
2020,199847,41,0,152,82,70
2020,199847,41,1,34,22,12
2020,199847,41,2,48,24,24
2020,199847,41,3,46,22,24
2020,199847,41,4,8,3,5
2020,199847,41,5,5,3,2
2020,199847,41,6,11,8,3
2020,199847,42,0,1061,617,444
2020,199847,42,1,141,111,30
2020,199847,42,2,232,143,89
2020,199847,42,3,537,281,256
2020,199847,42,4,86,46,40
2020,199847,42,5,40,20,20
2020,199847,42,6,25,16,9
2020,199847,44,0,135,71,64
2020,199847,44,1,34,22,12
2020,199847,44,2,48,24,24
2020,199847,44,3,44,21,23
2020,199847,44,4,3,2,1
2020,199847,44,5,4,2,2
2020,199847,44,6,2,0,2
2020,199847,45,0,17,11,6
2020,199847,45,3,2,1,1
2020,199847,45,4,5,1,4
2020,199847,45,5,1,1,0
2020,199847,45,6,9,8,1
2020,199856,0,0,600,237,363
2020,199856,10,0,600,237,363
2020,199856,10,6,600,237,363
2020,199856,40,0,600,237,363
2020,199856,40,6,600,237,363
2020,199856,42,0,569,224,345
2020,199856,42,6,569,224,345
2020,199856,43,0,31,13,18
2020,199856,43,6,31,13,18
2020,199865,0,0,54,20,34
2020,199865,10,0,54,20,34
2020,199865,10,6,54,20,34
2020,199865,40,0,54,20,34
2020,199865,40,6,54,20,34
2020,199865,41,0,42,16,26
2020,199865,41,6,42,16,26
2020,199865,42,0,12,4,8
2020,199865,42,6,12,4,8
2020,199865,44,0,42,16,26
2020,199865,44,6,42,16,26
2020,199892,0,0,122,54,68
2020,199892,10,0,122,54,68
2020,199892,10,6,122,54,68
2020,199892,40,0,122,54,68
2020,199892,40,6,122,54,68
2020,199892,42,0,122,54,68
2020,199892,42,6,122,54,68
2020,199908,0,0,67,29,38
2020,199908,10,0,67,29,38
2020,199908,10,6,67,29,38
2020,199908,40,0,67,29,38
2020,199908,40,6,67,29,38
2020,199908,42,0,67,29,38
2020,199908,42,6,67,29,38
2020,199926,0,0,103,49,54
2020,199926,10,0,101,48,53
2020,199926,10,6,101,48,53
2020,199926,40,0,101,48,53
2020,199926,40,6,101,48,53
2020,199926,41,0,1,0,1
2020,199926,41,6,1,0,1
2020,199926,42,0,100,48,52
2020,199926,42,6,100,48,52
2020,199926,45,0,1,0,1
2020,199926,45,6,1,0,1
2020,199926,50,0,2,1,1
2020,199953,0,0,45,17,28
2020,199953,10,0,45,17,28
2020,199953,10,6,45,17,28
2020,199953,40,0,45,17,28
2020,199953,40,6,45,17,28
2020,199953,42,0,32,12,20
2020,199953,42,6,32,12,20
2020,199953,43,0,13,5,8
2020,199953,43,6,13,5,8
2020,199962,0,0,185,73,112
2020,199962,10,0,185,73,112
2020,199962,10,1,30,13,17
2020,199962,10,2,81,37,44
2020,199962,10,3,59,19,40
2020,199962,10,4,15,4,11
2020,199962,40,0,185,73,112
2020,199962,40,1,30,13,17
2020,199962,40,2,81,37,44
2020,199962,40,3,59,19,40
2020,199962,40,4,15,4,11
2020,199962,42,0,185,73,112
2020,199962,42,1,30,13,17
2020,199962,42,2,81,37,44
2020,199962,42,3,59,19,40
2020,199962,42,4,15,4,11
2020,199999,0,0,250,105,145
2020,199999,10,0,250,105,145
2020,199999,10,1,47,30,17
2020,199999,10,2,104,50,54
2020,199999,10,3,61,16,45
2020,199999,10,4,27,4,23
2020,199999,10,5,10,5,5
2020,199999,10,6,1,0,1
2020,199999,20,0,149,80,69
2020,199999,20,1,47,30,17
2020,199999,20,2,102,50,52
2020,199999,30,0,42,13,29
2020,199999,30,2,2,0,2
2020,199999,30,3,40,13,27
2020,199999,40,0,59,12,47
2020,199999,40,3,21,3,18
2020,199999,40,4,27,4,23
2020,199999,40,5,10,5,5
2020,199999,40,6,1,0,1
2020,199999,41,0,40,7,33
2020,199999,41,3,15,2,13
2020,199999,41,4,22,4,18
2020,199999,41,5,3,1,2
2020,199999,42,0,10,4,6
2020,199999,42,3,3,1,2
2020,199999,42,4,1,0,1
2020,199999,42,5,5,3,2
2020,199999,42,6,1,0,1
2020,199999,43,0,9,1,8
2020,199999,43,3,3,0,3
2020,199999,43,4,4,0,4
2020,199999,43,5,2,1,1
2020,199999,44,0,40,7,33
2020,199999,44,3,15,2,13
2020,199999,44,4,22,4,18
2020,199999,44,5,3,1,2
2020,200004,0,0,544,266,278
2020,200004,10,0,544,266,278
2020,200004,10,1,109,70,39
2020,200004,10,2,136,71,65
2020,200004,10,3,209,86,123
2020,200004,10,4,86,36,50
2020,200004,10,5,4,3,1
2020,200004,20,0,228,131,97
2020,200004,20,1,99,64,35
2020,200004,20,2,128,67,61
2020,200004,20,3,1,0,1
2020,200004,30,0,140,69,71
2020,200004,30,1,6,3,3
2020,200004,30,2,6,4,2
2020,200004,30,3,128,62,66
2020,200004,40,0,176,66,110
2020,200004,40,1,4,3,1
2020,200004,40,2,2,0,2
2020,200004,40,3,80,24,56
2020,200004,40,4,86,36,50
2020,200004,40,5,4,3,1
2020,200004,41,0,15,8,7
2020,200004,41,1,3,3,0
2020,200004,41,2,1,0,1
2020,200004,41,3,4,2,2
2020,200004,41,4,7,3,4
2020,200004,42,0,152,56,96
2020,200004,42,1,1,0,1
2020,200004,42,2,1,0,1
2020,200004,42,3,71,21,50
2020,200004,42,4,75,32,43
2020,200004,42,5,4,3,1
2020,200004,43,0,9,2,7
2020,200004,43,3,5,1,4
2020,200004,43,4,4,1,3
2020,200004,44,0,15,8,7
2020,200004,44,1,3,3,0
2020,200004,44,2,1,0,1
2020,200004,44,3,4,2,2
2020,200004,44,4,7,3,4
2020,200013,0,0,19,1,18
2020,200013,10,0,19,1,18
2020,200013,10,4,19,1,18
2020,200013,40,0,19,1,18
2020,200013,40,4,19,1,18
2020,200013,41,0,19,1,18
2020,200013,41,4,19,1,18
2020,200013,45,0,19,1,18
2020,200013,45,4,19,1,18
2020,200022,0,0,121,70,51
2020,200022,10,0,121,70,51
2020,200022,10,1,10,5,5
2020,200022,10,2,63,36,27
2020,200022,10,3,48,29,19
2020,200022,20,0,74,41,33
2020,200022,20,1,10,5,5
2020,200022,20,2,63,36,27
2020,200022,20,3,1,0,1
2020,200022,30,0,37,22,15
2020,200022,30,3,37,22,15
2020,200022,40,0,10,7,3
2020,200022,40,3,10,7,3
2020,200022,42,0,10,7,3
2020,200022,42,3,10,7,3
2020,200059,0,0,62,33,29
2020,200059,10,0,62,33,29
2020,200059,10,1,9,8,1
2020,200059,10,2,17,9,8
2020,200059,10,3,25,13,12
2020,200059,10,4,11,3,8
2020,200059,20,0,37,25,12
2020,200059,20,1,9,8,1
2020,200059,20,2,14,8,6
2020,200059,20,3,14,9,5
2020,200059,30,0,11,3,8
2020,200059,30,2,3,1,2
2020,200059,30,3,7,2,5
2020,200059,30,4,1,0,1
2020,200059,40,0,14,5,9
2020,200059,40,3,4,2,2
2020,200059,40,4,10,3,7
2020,200059,42,0,14,5,9
2020,200059,42,3,4,2,2
2020,200059,42,4,10,3,7
2020,200086,0,0,26,10,16
2020,200086,10,0,26,10,16
2020,200086,10,6,26,10,16
2020,200086,40,0,26,10,16
2020,200086,40,6,26,10,16
2020,200086,42,0,26,10,16
2020,200086,42,6,26,10,16
2020,200156,0,0,82,37,45
2020,200156,10,0,82,37,45
2020,200156,10,1,19,13,6
2020,200156,10,2,23,5,18
2020,200156,10,3,34,17,17
2020,200156,10,4,6,2,4
2020,200156,40,0,82,37,45
2020,200156,40,1,19,13,6
2020,200156,40,2,23,5,18
2020,200156,40,3,34,17,17
2020,200156,40,4,6,2,4
2020,200156,41,0,82,37,45
2020,200156,41,1,19,13,6
2020,200156,41,2,23,5,18
2020,200156,41,3,34,17,17
2020,200156,41,4,6,2,4
2020,200156,44,0,82,37,45
2020,200156,44,1,19,13,6
2020,200156,44,2,23,5,18
2020,200156,44,3,34,17,17
2020,200156,44,4,6,2,4
2020,200192,0,0,38,15,23
2020,200192,10,0,37,14,23
2020,200192,10,1,5,3,2
2020,200192,10,2,9,2,7
2020,200192,10,3,10,5,5
2020,200192,10,4,13,4,9
2020,200192,20,0,12,6,6
2020,200192,20,1,5,3,2
2020,200192,20,2,4,1,3
2020,200192,20,3,3,2,1
2020,200192,30,0,11,5,6
2020,200192,30,2,3,1,2
2020,200192,30,3,3,2,1
2020,200192,30,4,5,2,3
2020,200192,40,0,14,3,11
2020,200192,40,2,2,0,2
2020,200192,40,3,4,1,3
2020,200192,40,4,8,2,6
2020,200192,42,0,14,3,11
2020,200192,42,2,2,0,2
2020,200192,42,3,4,1,3
2020,200192,42,4,8,2,6
2020,200192,50,0,1,1,0
2020,200208,0,0,22,12,10
2020,200208,10,0,22,12,10
2020,200208,10,4,22,12,10
2020,200208,40,0,22,12,10
2020,200208,40,4,22,12,10
2020,200208,42,0,22,12,10
2020,200208,42,4,22,12,10
2020,200217,0,0,162,76,86
2020,200217,10,0,162,76,86
2020,200217,10,1,17,9,8
2020,200217,10,2,40,16,24
2020,200217,10,3,95,46,49
2020,200217,10,4,8,4,4
2020,200217,10,6,2,1,1
2020,200217,40,0,162,76,86
2020,200217,40,1,17,9,8
2020,200217,40,2,40,16,24
2020,200217,40,3,95,46,49
2020,200217,40,4,8,4,4
2020,200217,40,6,2,1,1
2020,200217,42,0,162,76,86
2020,200217,42,1,17,9,8
2020,200217,42,2,40,16,24
2020,200217,42,3,95,46,49
2020,200217,42,4,8,4,4
2020,200217,42,6,2,1,1
2020,200226,0,0,50,22,28
2020,200226,10,0,42,20,22
2020,200226,10,1,7,5,2
2020,200226,10,2,15,9,6
2020,200226,10,3,10,4,6
2020,200226,10,4,10,2,8
2020,200226,20,0,19,14,5
2020,200226,20,1,6,5,1
2020,200226,20,2,12,8,4
2020,200226,20,3,1,1,0
2020,200226,30,0,13,4,9
2020,200226,30,1,1,0,1
2020,200226,30,2,3,1,2
2020,200226,30,3,7,2,5
2020,200226,30,4,2,1,1
2020,200226,40,0,10,2,8
2020,200226,40,3,2,1,1
2020,200226,40,4,8,1,7
2020,200226,42,0,10,2,8
2020,200226,42,3,2,1,1
2020,200226,42,4,8,1,7
2020,200226,50,0,8,2,6
2020,200253,0,0,144,60,84
2020,200253,10,0,144,60,84
2020,200253,10,1,33,18,15
2020,200253,10,2,29,15,14
2020,200253,10,3,60,24,36
2020,200253,10,4,22,3,19
2020,200253,20,0,71,38,33
2020,200253,20,1,33,18,15
2020,200253,20,2,26,14,12
2020,200253,20,3,12,6,6
2020,200253,30,0,39,11,28
2020,200253,30,2,3,1,2
2020,200253,30,3,28,10,18
2020,200253,30,4,8,0,8
2020,200253,40,0,34,11,23
2020,200253,40,3,20,8,12
2020,200253,40,4,14,3,11
2020,200253,42,0,34,11,23
2020,200253,42,3,20,8,12
2020,200253,42,4,14,3,11
2020,200280,0,0,712,415,297
2020,200280,10,0,632,367,265
2020,200280,10,1,153,103,50
2020,200280,10,2,182,117,65
2020,200280,10,3,184,90,94
2020,200280,10,4,65,29,36
2020,200280,10,5,35,22,13
2020,200280,10,6,13,6,7
2020,200280,20,0,302,206,96
2020,200280,20,1,146,99,47
2020,200280,20,2,143,100,43
2020,200280,20,3,13,7,6
2020,200280,30,0,69,43,26
2020,200280,30,2,1,1,0
2020,200280,30,3,68,42,26
2020,200280,40,0,261,118,143
2020,200280,40,1,7,4,3
2020,200280,40,2,38,16,22
2020,200280,40,3,103,41,62
2020,200280,40,4,65,29,36
2020,200280,40,5,35,22,13
2020,200280,40,6,13,6,7
2020,200280,42,0,261,118,143
2020,200280,42,1,7,4,3
2020,200280,42,2,38,16,22
2020,200280,42,3,103,41,62
2020,200280,42,4,65,29,36
2020,200280,42,5,35,22,13
2020,200280,42,6,13,6,7
2020,200280,50,0,80,48,32
2020,200305,0,0,108,59,49
2020,200305,10,0,105,58,47
2020,200305,10,1,1,0,1
2020,200305,10,2,67,43,24
2020,200305,10,3,15,5,10
2020,200305,10,4,22,10,12
2020,200305,20,0,66,42,24
2020,200305,20,1,1,0,1
2020,200305,20,2,65,42,23
2020,200305,30,0,37,16,21
2020,200305,30,2,2,1,1
2020,200305,30,3,13,5,8
2020,200305,30,4,22,10,12
2020,200305,40,0,2,0,2
2020,200305,40,3,2,0,2
2020,200305,42,0,2,0,2
2020,200305,42,3,2,0,2
2020,200305,50,0,3,1,2
2020,200314,0,0,27,8,19
2020,200314,10,0,27,8,19
2020,200314,10,1,2,2,0
2020,200314,10,2,7,2,5
2020,200314,10,3,3,2,1
2020,200314,10,4,15,2,13
2020,200314,20,0,6,2,4
2020,200314,20,1,1,1,0
2020,200314,20,2,5,1,4
2020,200314,30,0,4,1,3
2020,200314,30,3,1,1,0
2020,200314,30,4,3,0,3
2020,200314,40,0,17,5,12
2020,200314,40,1,1,1,0
2020,200314,40,2,2,1,1
2020,200314,40,3,2,1,1
2020,200314,40,4,12,2,10
2020,200314,42,0,4,1,3
2020,200314,42,3,2,1,1
2020,200314,42,4,2,0,2
2020,200314,43,0,13,4,9
2020,200314,43,1,1,1,0
2020,200314,43,2,2,1,1
2020,200314,43,4,10,2,8
2020,200332,0,0,534,293,241
2020,200332,10,0,534,293,241
2020,200332,10,1,129,91,38
2020,200332,10,2,167,94,73
2020,200332,10,3,170,80,90
2020,200332,10,4,2,2,0
2020,200332,10,5,66,26,40
2020,200332,20,0,265,173,92
2020,200332,20,1,127,90,37
2020,200332,20,2,138,83,55
2020,200332,30,0,122,69,53
2020,200332,30,1,1,0,1
2020,200332,30,2,10,3,7
2020,200332,30,3,111,66,45
2020,200332,40,0,147,51,96
2020,200332,40,1,1,1,0
2020,200332,40,2,19,8,11
2020,200332,40,3,59,14,45
2020,200332,40,4,2,2,0
2020,200332,40,5,66,26,40
2020,200332,42,0,147,51,96
2020,200332,42,1,1,1,0
2020,200332,42,2,19,8,11
2020,200332,42,3,59,14,45
2020,200332,42,4,2,2,0
2020,200332,42,5,66,26,40
2020,200341,0,0,30,16,14
2020,200341,10,0,28,14,14
2020,200341,10,1,3,1,2
2020,200341,10,2,15,8,7
2020,200341,10,3,3,1,2
2020,200341,10,4,7,4,3
2020,200341,20,0,18,9,9
2020,200341,20,1,3,1,2
2020,200341,20,2,15,8,7
2020,200341,30,0,3,1,2
2020,200341,30,3,3,1,2
2020,200341,40,0,7,4,3
2020,200341,40,4,7,4,3
2020,200341,42,0,7,4,3
2020,200341,42,4,7,4,3
2020,200341,50,0,2,2,0
2020,200466,0,0,28,15,13
2020,200466,10,0,28,15,13
2020,200466,10,6,28,15,13
2020,200466,40,0,28,15,13
2020,200466,40,6,28,15,13
2020,200466,43,0,28,15,13
2020,200466,43,6,28,15,13
2020,200484,0,0,13,10,3
2020,200484,10,0,13,10,3
2020,200484,10,2,6,5,1
2020,200484,10,3,6,4,2
2020,200484,10,6,1,1,0
2020,200484,40,0,13,10,3
2020,200484,40,2,6,5,1
2020,200484,40,3,6,4,2
2020,200484,40,6,1,1,0
2020,200484,41,0,1,1,0
2020,200484,41,6,1,1,0
2020,200484,42,0,12,9,3
2020,200484,42,2,6,5,1
2020,200484,42,3,6,4,2
2020,200484,44,0,1,1,0
2020,200484,44,6,1,1,0
2020,200527,0,0,47,22,25
2020,200527,10,0,47,22,25
2020,200527,10,4,47,22,25
2020,200527,40,0,47,22,25
2020,200527,40,4,47,22,25
2020,200527,43,0,47,22,25
2020,200527,43,4,47,22,25
2020,200554,0,0,37,21,16
2020,200554,10,0,37,21,16
2020,200554,10,4,37,21,16
2020,200554,40,0,37,21,16
2020,200554,40,4,37,21,16
2020,200554,42,0,1,1,0
2020,200554,42,4,1,1,0
2020,200554,43,0,36,20,16
2020,200554,43,4,36,20,16
2020,200572,0,0,68,34,34
2020,200572,10,0,68,34,34
2020,200572,10,1,12,7,5
2020,200572,10,2,19,7,12
2020,200572,10,3,37,20,17
2020,200572,20,0,34,15,19
2020,200572,20,1,12,7,5
2020,200572,20,2,17,7,10
2020,200572,20,3,5,1,4
2020,200572,30,0,26,16,10
2020,200572,30,2,2,0,2
2020,200572,30,3,24,16,8
2020,200572,40,0,8,3,5
2020,200572,40,3,8,3,5
2020,200572,41,0,7,3,4
2020,200572,41,3,7,3,4
2020,200572,42,0,1,0,1
2020,200572,42,3,1,0,1
2020,200572,44,0,7,3,4
2020,200572,44,3,7,3,4
2020,200590,0,0,10,5,5
2020,200590,10,0,10,5,5
2020,200590,10,4,10,5,5
2020,200590,40,0,10,5,5
2020,200590,40,4,10,5,5
2020,200590,41,0,10,5,5
2020,200590,41,4,10,5,5
2020,200590,45,0,10,5,5
2020,200590,45,4,10,5,5
2020,200785,0,0,9,1,8
2020,200785,10,0,9,1,8
2020,200785,10,2,4,0,4
2020,200785,10,3,5,1,4
2020,200785,40,0,9,1,8
2020,200785,40,2,4,0,4
2020,200785,40,3,5,1,4
2020,200785,41,0,9,1,8
2020,200785,41,2,4,0,4
2020,200785,41,3,5,1,4
2020,200785,45,0,9,1,8
2020,200785,45,2,4,0,4
2020,200785,45,3,5,1,4
2020,200800,0,0,476,293,183
2020,200800,10,0,476,293,183
2020,200800,10,1,169,128,41
2020,200800,10,2,132,73,59
2020,200800,10,3,55,31,24
2020,200800,10,4,79,30,49
2020,200800,10,5,41,31,10
2020,200800,20,0,292,198,94
2020,200800,20,1,168,127,41
2020,200800,20,2,124,71,53
2020,200800,30,0,51,27,24
2020,200800,30,2,5,1,4
2020,200800,30,3,46,26,20
2020,200800,40,0,133,68,65
2020,200800,40,1,1,1,0
2020,200800,40,2,3,1,2
2020,200800,40,3,9,5,4
2020,200800,40,4,79,30,49
2020,200800,40,5,41,31,10
2020,200800,42,0,133,68,65
2020,200800,42,1,1,1,0
2020,200800,42,2,3,1,2
2020,200800,42,3,9,5,4
2020,200800,42,4,79,30,49
2020,200800,42,5,41,31,10
2020,200846,0,0,3,1,2
2020,200846,10,0,3,1,2
2020,200846,10,2,3,1,2
2020,200846,20,0,3,1,2
2020,200846,20,2,3,1,2
2020,200873,0,0,3,2,1
2020,200873,10,0,3,2,1
2020,200873,10,1,3,2,1
2020,200873,40,0,3,2,1
2020,200873,40,1,3,2,1
2020,200873,41,0,3,2,1
2020,200873,41,1,3,2,1
2020,200873,44,0,3,2,1
2020,200873,44,1,3,2,1
2020,201061,0,0,11,7,4
2020,201061,10,0,11,7,4
2020,201061,10,1,2,2,0
2020,201061,10,2,4,3,1
2020,201061,10,3,5,2,3
2020,201061,40,0,11,7,4
2020,201061,40,1,2,2,0
2020,201061,40,2,4,3,1
2020,201061,40,3,5,2,3
2020,201061,41,0,11,7,4
2020,201061,41,1,2,2,0
2020,201061,41,2,4,3,1
2020,201061,41,3,5,2,3
2020,201061,45,0,11,7,4
2020,201061,45,1,2,2,0
2020,201061,45,2,4,3,1
2020,201061,45,3,5,2,3
2020,201104,0,0,174,96,78
2020,201104,10,0,174,96,78
2020,201104,10,1,46,37,9
2020,201104,10,2,44,24,20
2020,201104,10,3,41,20,21
2020,201104,10,4,43,15,28
2020,201104,20,0,95,64,31
2020,201104,20,1,46,37,9
2020,201104,20,2,43,24,19
2020,201104,20,3,6,3,3
2020,201104,30,0,29,14,15
2020,201104,30,2,1,0,1
2020,201104,30,3,28,14,14
2020,201104,40,0,50,18,32
2020,201104,40,3,7,3,4
2020,201104,40,4,43,15,28
2020,201104,41,0,1,1,0
2020,201104,41,4,1,1,0
2020,201104,42,0,49,17,32
2020,201104,42,3,7,3,4
2020,201104,42,4,42,14,28
2020,201104,44,0,1,1,0
2020,201104,44,4,1,1,0
2020,201140,0,0,6,6,0
2020,201140,10,0,6,6,0
2020,201140,10,1,1,1,0
2020,201140,10,2,3,3,0
2020,201140,10,3,2,2,0
2020,201140,40,0,6,6,0
2020,201140,40,1,1,1,0
2020,201140,40,2,3,3,0
2020,201140,40,3,2,2,0
2020,201140,41,0,4,4,0
2020,201140,41,1,1,1,0
2020,201140,41,2,2,2,0
2020,201140,41,3,1,1,0
2020,201140,42,0,2,2,0
2020,201140,42,2,1,1,0
2020,201140,42,3,1,1,0
2020,201140,44,0,4,4,0
2020,201140,44,1,1,1,0
2020,201140,44,2,2,2,0
2020,201140,44,3,1,1,0
2020,201177,0,0,12,2,10
2020,201177,10,0,12,2,10
2020,201177,10,2,2,1,1
2020,201177,10,3,8,1,7
2020,201177,10,4,2,0,2
2020,201177,40,0,12,2,10
2020,201177,40,2,2,1,1
2020,201177,40,3,8,1,7
2020,201177,40,4,2,0,2
2020,201177,41,0,12,2,10
2020,201177,41,2,2,1,1
2020,201177,41,3,8,1,7
2020,201177,41,4,2,0,2
2020,201177,44,0,12,2,10
2020,201177,44,2,2,1,1
2020,201177,44,3,8,1,7
2020,201177,44,4,2,0,2
2020,201195,0,0,218,103,115
2020,201195,10,0,217,103,114
2020,201195,10,1,78,41,37
2020,201195,10,2,70,35,35
2020,201195,10,3,67,27,40
2020,201195,10,4,2,0,2
2020,201195,20,0,115,60,55
2020,201195,20,1,71,37,34
2020,201195,20,2,43,23,20
2020,201195,20,3,1,0,1
2020,201195,30,0,72,31,41
2020,201195,30,1,5,2,3
2020,201195,30,2,20,8,12
2020,201195,30,3,47,21,26
2020,201195,40,0,30,12,18
2020,201195,40,1,2,2,0
2020,201195,40,2,7,4,3
2020,201195,40,3,19,6,13
2020,201195,40,4,2,0,2
2020,201195,41,0,16,6,10
2020,201195,41,1,2,2,0
2020,201195,41,2,2,1,1
2020,201195,41,3,11,3,8
2020,201195,41,4,1,0,1
2020,201195,42,0,14,6,8
2020,201195,42,2,5,3,2
2020,201195,42,3,8,3,5
2020,201195,42,4,1,0,1
2020,201195,44,0,16,6,10
2020,201195,44,1,2,2,0
2020,201195,44,2,2,1,1
2020,201195,44,3,11,3,8
2020,201195,44,4,1,0,1
2020,201195,50,0,1,0,1
2020,201283,0,0,28,9,19
2020,201283,10,0,26,9,17
2020,201283,10,1,13,5,8
2020,201283,10,2,6,1,5
2020,201283,10,3,3,2,1
2020,201283,10,4,4,1,3
2020,201283,40,0,26,9,17
2020,201283,40,1,13,5,8
2020,201283,40,2,6,1,5
2020,201283,40,3,3,2,1
2020,201283,40,4,4,1,3
2020,201283,41,0,26,9,17
2020,201283,41,1,13,5,8
2020,201283,41,2,6,1,5
2020,201283,41,3,3,2,1
2020,201283,41,4,4,1,3
2020,201283,44,0,26,9,17
2020,201283,44,1,13,5,8
2020,201283,44,2,6,1,5
2020,201283,44,3,3,2,1
2020,201283,44,4,4,1,3
2020,201283,50,0,2,0,2
2020,201371,0,0,50,26,24
2020,201371,10,0,50,26,24
2020,201371,10,1,17,11,6
2020,201371,10,2,10,5,5
2020,201371,10,3,23,10,13
2020,201371,20,0,24,16,8
2020,201371,20,1,17,11,6
2020,201371,20,2,6,4,2
2020,201371,20,3,1,1,0
2020,201371,30,0,9,3,6
2020,201371,30,2,2,1,1
2020,201371,30,3,7,2,5
2020,201371,40,0,17,7,10
2020,201371,40,2,2,0,2
2020,201371,40,3,15,7,8
2020,201371,41,0,17,7,10
2020,201371,41,2,2,0,2
2020,201371,41,3,15,7,8
2020,201371,44,0,17,7,10
2020,201371,44,2,2,0,2
2020,201371,44,3,15,7,8
2020,201432,0,0,46,19,27
2020,201432,10,0,46,19,27
2020,201432,10,1,14,7,7
2020,201432,10,2,20,8,12
2020,201432,10,3,12,4,8
2020,201432,20,0,18,10,8
2020,201432,20,1,6,4,2
2020,201432,20,2,12,6,6
2020,201432,30,0,1,0,1
2020,201432,30,3,1,0,1
2020,201432,40,0,27,9,18
2020,201432,40,1,8,3,5
2020,201432,40,2,8,2,6
2020,201432,40,3,11,4,7
2020,201432,42,0,27,9,18
2020,201432,42,1,8,3,5
2020,201432,42,2,8,2,6
2020,201432,42,3,11,4,7
2020,201441,0,0,715,358,357
2020,201441,10,0,715,358,357
2020,201441,10,1,272,145,127
2020,201441,10,2,255,123,132
2020,201441,10,3,188,90,98
2020,201441,20,0,390,214,176
2020,201441,20,1,191,117,74
2020,201441,20,2,197,96,101
2020,201441,20,3,2,1,1
2020,201441,30,0,92,48,44
2020,201441,30,3,92,48,44
2020,201441,40,0,233,96,137
2020,201441,40,1,81,28,53
2020,201441,40,2,58,27,31
2020,201441,40,3,94,41,53
2020,201441,42,0,233,96,137
2020,201441,42,1,81,28,53
2020,201441,42,2,58,27,31
2020,201441,42,3,94,41,53
2020,201469,0,0,35,7,28
2020,201469,10,0,35,7,28
2020,201469,10,4,35,7,28
2020,201469,40,0,35,7,28
2020,201469,40,4,35,7,28
2020,201469,41,0,35,7,28
2020,201469,41,4,35,7,28
2020,201469,45,0,35,7,28
2020,201469,45,4,35,7,28
2020,201548,0,0,153,72,81
2020,201548,10,0,153,72,81
2020,201548,10,1,59,34,25
2020,201548,10,2,28,13,15
2020,201548,10,3,24,10,14
2020,201548,10,4,42,15,27
2020,201548,20,0,86,47,39
2020,201548,20,1,58,34,24
2020,201548,20,2,27,13,14
2020,201548,20,3,1,0,1
2020,201548,30,0,18,7,11
2020,201548,30,3,18,7,11
2020,201548,40,0,49,18,31
2020,201548,40,1,1,0,1
2020,201548,40,2,1,0,1
2020,201548,40,3,5,3,2
2020,201548,40,4,42,15,27
2020,201548,41,0,8,2,6
2020,201548,41,4,8,2,6
2020,201548,42,0,41,16,25
2020,201548,42,1,1,0,1
2020,201548,42,2,1,0,1
2020,201548,42,3,5,3,2
2020,201548,42,4,34,13,21
2020,201548,44,0,8,2,6
2020,201548,44,4,8,2,6
2020,201645,0,0,1206,710,496
2020,201645,10,0,1206,710,496
2020,201645,10,1,465,349,116
2020,201645,10,2,287,163,124
2020,201645,10,3,240,117,123
2020,201645,10,4,105,40,65
2020,201645,10,5,85,29,56
2020,201645,10,6,24,12,12
2020,201645,20,0,574,414,160
2020,201645,20,1,386,296,90
2020,201645,20,2,188,118,70
2020,201645,30,0,133,69,64
2020,201645,30,1,1,1,0
2020,201645,30,2,19,11,8
2020,201645,30,3,113,57,56
2020,201645,40,0,499,227,272
2020,201645,40,1,78,52,26
2020,201645,40,2,80,34,46
2020,201645,40,3,127,60,67
2020,201645,40,4,105,40,65
2020,201645,40,5,85,29,56
2020,201645,40,6,24,12,12
2020,201645,41,0,390,186,204
2020,201645,41,1,78,52,26
2020,201645,41,2,80,34,46
2020,201645,41,3,127,60,67
2020,201645,41,4,105,40,65
2020,201645,42,0,105,40,65
2020,201645,42,5,81,28,53
2020,201645,42,6,24,12,12
2020,201645,43,0,4,1,3
2020,201645,43,5,4,1,3
2020,201645,45,0,390,186,204
2020,201645,45,1,78,52,26
2020,201645,45,2,80,34,46
2020,201645,45,3,127,60,67
2020,201645,45,4,105,40,65
2020,201654,0,0,227,146,81
2020,201654,10,0,227,146,81
2020,201654,10,1,66,58,8
2020,201654,10,2,81,56,25
2020,201654,10,3,74,31,43
2020,201654,10,4,6,1,5
2020,201654,20,0,95,73,22
2020,201654,20,1,56,49,7
2020,201654,20,2,39,24,15
2020,201654,30,0,49,36,13
2020,201654,30,1,8,7,1
2020,201654,30,2,22,19,3
2020,201654,30,3,19,10,9
2020,201654,40,0,83,37,46
2020,201654,40,1,2,2,0
2020,201654,40,2,20,13,7
2020,201654,40,3,55,21,34
2020,201654,40,4,6,1,5
2020,201654,42,0,83,37,46
2020,201654,42,1,2,2,0
2020,201654,42,2,20,13,7
2020,201654,42,3,55,21,34
2020,201654,42,4,6,1,5
2020,201672,0,0,58,23,35
2020,201672,10,0,58,23,35
2020,201672,10,1,12,4,8
2020,201672,10,2,9,4,5
2020,201672,10,3,18,8,10
2020,201672,10,4,19,7,12
2020,201672,20,0,2,1,1
2020,201672,20,1,2,1,1
2020,201672,40,0,56,22,34
2020,201672,40,1,10,3,7
2020,201672,40,2,9,4,5
2020,201672,40,3,18,8,10
2020,201672,40,4,19,7,12
2020,201672,41,0,23,11,12
2020,201672,41,1,3,1,2
2020,201672,41,2,7,3,4
2020,201672,41,3,8,4,4
2020,201672,41,4,5,3,2
2020,201672,42,0,33,11,22
2020,201672,42,1,7,2,5
2020,201672,42,2,2,1,1
2020,201672,42,3,10,4,6
2020,201672,42,4,14,4,10
2020,201672,44,0,23,11,12
2020,201672,44,1,3,1,2
2020,201672,44,2,7,3,4
2020,201672,44,3,8,4,4
2020,201672,44,4,5,3,2
2020,201690,0,0,103,66,37
2020,201690,10,0,103,66,37
2020,201690,10,1,21,14,7
2020,201690,10,2,37,24,13
2020,201690,10,3,42,27,15
2020,201690,10,4,3,1,2
2020,201690,20,0,56,37,19
2020,201690,20,1,21,14,7
2020,201690,20,2,28,19,9
2020,201690,20,3,7,4,3
2020,201690,30,0,39,24,15
2020,201690,30,2,8,4,4
2020,201690,30,3,31,20,11
2020,201690,40,0,8,5,3
2020,201690,40,2,1,1,0
2020,201690,40,3,4,3,1
2020,201690,40,4,3,1,2
2020,201690,41,0,8,5,3
2020,201690,41,2,1,1,0
2020,201690,41,3,4,3,1
2020,201690,41,4,3,1,2
2020,201690,44,0,8,5,3
2020,201690,44,2,1,1,0
2020,201690,44,3,4,3,1
2020,201690,44,4,3,1,2
2020,201751,0,0,2,1,1
2020,201751,10,0,2,1,1
2020,201751,10,4,2,1,1
2020,201751,40,0,2,1,1
2020,201751,40,4,2,1,1
2020,201751,41,0,2,1,1
2020,201751,41,4,2,1,1
2020,201751,45,0,2,1,1
2020,201751,45,4,2,1,1
2020,201821,0,0,43,4,39
2020,201821,10,0,42,4,38
2020,201821,10,2,2,0,2
2020,201821,10,3,30,3,27
2020,201821,10,4,10,1,9
2020,201821,40,0,42,4,38
2020,201821,40,2,2,0,2
2020,201821,40,3,30,3,27
2020,201821,40,4,10,1,9
2020,201821,41,0,42,4,38
2020,201821,41,2,2,0,2
2020,201821,41,3,30,3,27
2020,201821,41,4,10,1,9
2020,201821,45,0,42,4,38
2020,201821,45,2,2,0,2
2020,201821,45,3,30,3,27
2020,201821,45,4,10,1,9
2020,201821,50,0,1,0,1
2020,201885,0,0,2225,1243,982
2020,201885,10,0,2225,1243,982
2020,201885,10,1,583,395,188
2020,201885,10,2,666,372,294
2020,201885,10,3,823,406,417
2020,201885,10,4,149,66,83
2020,201885,10,6,4,4,0
2020,201885,20,0,737,476,261
2020,201885,20,1,423,300,123
2020,201885,20,2,311,175,136
2020,201885,20,3,3,1,2
2020,201885,30,0,214,120,94
2020,201885,30,1,3,2,1
2020,201885,30,2,14,7,7
2020,201885,30,3,197,111,86
2020,201885,40,0,1274,647,627
2020,201885,40,1,157,93,64
2020,201885,40,2,341,190,151
2020,201885,40,3,623,294,329
2020,201885,40,4,149,66,83
2020,201885,40,6,4,4,0
2020,201885,41,0,1252,639,613
2020,201885,41,1,156,93,63
2020,201885,41,2,340,190,150
2020,201885,41,3,607,288,319
2020,201885,41,4,145,64,81
2020,201885,41,6,4,4,0
2020,201885,42,0,22,8,14
2020,201885,42,1,1,0,1
2020,201885,42,2,1,0,1
2020,201885,42,3,16,6,10
2020,201885,42,4,4,2,2
2020,201885,44,0,1252,639,613
2020,201885,44,1,156,93,63
2020,201885,44,2,340,190,150
2020,201885,44,3,607,288,319
2020,201885,44,4,145,64,81
2020,201885,44,6,4,4,0
2020,201928,0,0,153,56,97
2020,201928,10,0,153,56,97
2020,201928,10,6,153,56,97
2020,201928,20,0,118,49,69
2020,201928,20,6,118,49,69
2020,201928,30,0,27,6,21
2020,201928,30,6,27,6,21
2020,201928,40,0,8,1,7
2020,201928,40,6,8,1,7
2020,201928,42,0,8,1,7
2020,201928,42,6,8,1,7
2020,201946,0,0,71,34,37
2020,201946,10,0,71,34,37
2020,201946,10,1,32,16,16
2020,201946,10,2,29,12,17
2020,201946,10,3,9,6,3
2020,201946,10,4,1,0,1
2020,201946,20,0,56,25,31
2020,201946,20,1,32,16,16
2020,201946,20,2,24,9,15
2020,201946,30,0,5,3,2
2020,201946,30,3,5,3,2
2020,201946,40,0,10,6,4
2020,201946,40,2,5,3,2
2020,201946,40,3,4,3,1
2020,201946,40,4,1,0,1
2020,201946,41,0,10,6,4
2020,201946,41,2,5,3,2
2020,201946,41,3,4,3,1
2020,201946,41,4,1,0,1
2020,201946,44,0,10,6,4
2020,201946,44,2,5,3,2
2020,201946,44,3,4,3,1
2020,201946,44,4,1,0,1
2020,201955,0,0,172,67,105
2020,201955,10,0,172,67,105
2020,201955,10,1,34,8,26
2020,201955,10,2,83,35,48
2020,201955,10,3,48,21,27
2020,201955,10,4,7,3,4
2020,201955,20,0,111,41,70
2020,201955,20,1,33,8,25
2020,201955,20,2,77,33,44
2020,201955,20,3,1,0,1
2020,201955,30,0,38,16,22
2020,201955,30,3,38,16,22
2020,201955,40,0,23,10,13
2020,201955,40,1,1,0,1
2020,201955,40,2,6,2,4
2020,201955,40,3,9,5,4
2020,201955,40,4,7,3,4
2020,201955,41,0,17,8,9
2020,201955,41,1,1,0,1
2020,201955,41,2,5,1,4
2020,201955,41,3,4,4,0
2020,201955,41,4,7,3,4
2020,201955,42,0,6,2,4
2020,201955,42,2,1,1,0
2020,201955,42,3,5,1,4
2020,201955,44,0,17,8,9
2020,201955,44,1,1,0,1
2020,201955,44,2,5,1,4
2020,201955,44,3,4,4,0
2020,201955,44,4,7,3,4
2020,201964,0,0,95,62,33
2020,201964,10,0,95,62,33
2020,201964,10,1,4,2,2
2020,201964,10,2,6,4,2
2020,201964,10,3,7,6,1
2020,201964,10,6,78,50,28
2020,201964,40,0,95,62,33
2020,201964,40,1,4,2,2
2020,201964,40,2,6,4,2
2020,201964,40,3,7,6,1
2020,201964,40,6,78,50,28
2020,201964,42,0,95,62,33
2020,201964,42,1,4,2,2
2020,201964,42,2,6,4,2
2020,201964,42,3,7,6,1
2020,201964,42,6,78,50,28
2020,201973,0,0,89,23,66
2020,201973,10,0,84,21,63
2020,201973,10,1,20,7,13
2020,201973,10,2,12,2,10
2020,201973,10,3,24,7,17
2020,201973,10,4,28,5,23
2020,201973,40,0,84,21,63
2020,201973,40,1,20,7,13
2020,201973,40,2,12,2,10
2020,201973,40,3,24,7,17
2020,201973,40,4,28,5,23
2020,201973,41,0,46,13,33
2020,201973,41,1,20,7,13
2020,201973,41,2,11,2,9
2020,201973,41,3,12,3,9
2020,201973,41,4,3,1,2
2020,201973,42,0,38,8,30
2020,201973,42,2,1,0,1
2020,201973,42,3,12,4,8
2020,201973,42,4,25,4,21
2020,201973,44,0,46,13,33
2020,201973,44,1,20,7,13
2020,201973,44,2,11,2,9
2020,201973,44,3,12,3,9
2020,201973,44,4,3,1,2
2020,201973,50,0,5,2,3
2020,202046,0,0,52,34,18
2020,202046,10,0,52,34,18
2020,202046,10,1,10,6,4
2020,202046,10,2,19,14,5
2020,202046,10,3,11,6,5
2020,202046,10,5,12,8,4
2020,202046,40,0,52,34,18
2020,202046,40,1,10,6,4
2020,202046,40,2,19,14,5
2020,202046,40,3,11,6,5
2020,202046,40,5,12,8,4
2020,202046,41,0,40,26,14
2020,202046,41,1,10,6,4
2020,202046,41,2,19,14,5
2020,202046,41,3,11,6,5
2020,202046,42,0,12,8,4
2020,202046,42,5,12,8,4
2020,202046,44,0,40,26,14
2020,202046,44,1,10,6,4
2020,202046,44,2,19,14,5
2020,202046,44,3,11,6,5
2020,202073,0,0,39,24,15
2020,202073,10,0,39,24,15
2020,202073,10,6,39,24,15
2020,202073,40,0,39,24,15
2020,202073,40,6,39,24,15
2020,202073,42,0,39,24,15
2020,202073,42,6,39,24,15
2020,202134,0,0,554,285,269
2020,202134,10,0,554,285,269
2020,202134,10,1,139,93,46
2020,202134,10,2,181,97,84
2020,202134,10,3,118,47,71
2020,202134,10,4,2,2,0
2020,202134,10,5,114,46,68
2020,202134,20,0,311,186,125
2020,202134,20,1,137,92,45
2020,202134,20,2,173,94,79
2020,202134,20,3,1,0,1
2020,202134,30,0,94,39,55
2020,202134,30,2,4,1,3
2020,202134,30,3,89,37,52
2020,202134,30,4,1,1,0
2020,202134,40,0,149,60,89
2020,202134,40,1,2,1,1
2020,202134,40,2,4,2,2
2020,202134,40,3,28,10,18
2020,202134,40,4,1,1,0
2020,202134,40,5,114,46,68
2020,202134,42,0,149,60,89
2020,202134,42,1,2,1,1
2020,202134,42,2,4,2,2
2020,202134,42,3,28,10,18
2020,202134,42,4,1,1,0
2020,202134,42,5,114,46,68
2020,202170,0,0,60,34,26
2020,202170,10,0,60,34,26
2020,202170,10,1,24,11,13
2020,202170,10,2,17,11,6
2020,202170,10,3,19,12,7
2020,202170,40,0,60,34,26
2020,202170,40,1,24,11,13
2020,202170,40,2,17,11,6
2020,202170,40,3,19,12,7
2020,202170,41,0,60,34,26
2020,202170,41,1,24,11,13
2020,202170,41,2,17,11,6
2020,202170,41,3,19,12,7
2020,202170,44,0,57,32,25
2020,202170,44,1,21,9,12
2020,202170,44,2,17,11,6
2020,202170,44,3,19,12,7
2020,202170,45,0,3,2,1
2020,202170,45,1,3,2,1
2020,202222,0,0,344,159,185
2020,202222,10,0,344,159,185
2020,202222,10,1,118,54,64
2020,202222,10,2,73,43,30
2020,202222,10,3,61,27,34
2020,202222,10,4,41,19,22
2020,202222,10,6,51,16,35
2020,202222,20,0,252,124,128
2020,202222,20,1,118,54,64
2020,202222,20,2,73,43,30
2020,202222,20,3,61,27,34
2020,202222,30,0,41,19,22
2020,202222,30,4,41,19,22
2020,202222,40,0,51,16,35
2020,202222,40,6,51,16,35
2020,202222,42,0,51,16,35
2020,202222,42,6,51,16,35
2020,202356,0,0,399,164,235
2020,202356,10,0,399,164,235
2020,202356,10,1,43,15,28
2020,202356,10,2,92,35,57
2020,202356,10,3,238,107,131
2020,202356,10,5,26,7,19
2020,202356,20,0,321,136,185
2020,202356,20,1,43,15,28
2020,202356,20,2,86,32,54
2020,202356,20,3,192,89,103
2020,202356,30,0,52,21,31
2020,202356,30,2,6,3,3
2020,202356,30,3,46,18,28
2020,202356,40,0,26,7,19
2020,202356,40,5,26,7,19
2020,202356,43,0,26,7,19
2020,202356,43,5,26,7,19
2020,202480,0,0,648,355,293
2020,202480,10,0,641,351,290
2020,202480,10,1,132,98,34
2020,202480,10,2,185,102,83
2020,202480,10,3,124,68,56
2020,202480,10,5,171,68,103
2020,202480,10,6,29,15,14
2020,202480,20,0,311,194,117
2020,202480,20,1,132,98,34
2020,202480,20,2,176,95,81
2020,202480,20,3,3,1,2
2020,202480,30,0,130,74,56
2020,202480,30,2,9,7,2
2020,202480,30,3,121,67,54
2020,202480,40,0,200,83,117
2020,202480,40,5,171,68,103
2020,202480,40,6,29,15,14
2020,202480,42,0,200,83,117
2020,202480,42,5,171,68,103
2020,202480,42,6,29,15,14
2020,202480,50,0,7,4,3
2020,202514,0,0,35,21,14
2020,202514,10,0,35,21,14
2020,202514,10,1,4,3,1
2020,202514,10,2,6,4,2
2020,202514,10,3,22,11,11
2020,202514,10,4,3,3,0
2020,202514,20,0,11,8,3
2020,202514,20,1,4,3,1
2020,202514,20,2,4,3,1
2020,202514,20,3,3,2,1
2020,202514,30,0,17,8,9
2020,202514,30,3,17,8,9
2020,202514,40,0,7,5,2
2020,202514,40,2,2,1,1
2020,202514,40,3,2,1,1
2020,202514,40,4,3,3,0
2020,202514,42,0,7,5,2
2020,202514,42,2,2,1,1
2020,202514,42,3,2,1,1
2020,202514,42,4,3,3,0
2020,202523,0,0,247,129,118
2020,202523,10,0,247,129,118
2020,202523,10,1,46,33,13
2020,202523,10,2,92,41,51
2020,202523,10,3,100,49,51
2020,202523,10,4,9,6,3
2020,202523,20,0,132,71,61
2020,202523,20,1,46,33,13
2020,202523,20,2,86,38,48
2020,202523,30,0,51,22,29
2020,202523,30,2,2,0,2
2020,202523,30,3,48,22,26
2020,202523,30,4,1,0,1
2020,202523,40,0,64,36,28
2020,202523,40,2,4,3,1
2020,202523,40,3,52,27,25
2020,202523,40,4,8,6,2
2020,202523,42,0,64,36,28
2020,202523,42,2,4,3,1
2020,202523,42,3,52,27,25
2020,202523,42,4,8,6,2
2020,202648,0,0,46,19,27
2020,202648,10,0,46,19,27
2020,202648,10,1,10,6,4
2020,202648,10,2,15,5,10
2020,202648,10,3,14,5,9
2020,202648,10,4,7,3,4
2020,202648,40,0,46,19,27
2020,202648,40,1,10,6,4
2020,202648,40,2,15,5,10
2020,202648,40,3,14,5,9
2020,202648,40,4,7,3,4
2020,202648,41,0,43,18,25
2020,202648,41,1,9,6,3
2020,202648,41,2,15,5,10
2020,202648,41,3,13,5,8
2020,202648,41,4,6,2,4
2020,202648,42,0,3,1,2
2020,202648,42,1,1,0,1
2020,202648,42,3,1,0,1
2020,202648,42,4,1,1,0
2020,202648,44,0,43,18,25
2020,202648,44,1,9,6,3
2020,202648,44,2,15,5,10
2020,202648,44,3,13,5,8
2020,202648,44,4,6,2,4
2020,202763,0,0,219,103,116
2020,202763,10,0,219,103,116
2020,202763,10,1,28,13,15
2020,202763,10,2,53,30,23
2020,202763,10,3,94,38,56
2020,202763,10,4,44,22,22
2020,202763,20,0,94,54,40
2020,202763,20,1,27,12,15
2020,202763,20,2,46,27,19
2020,202763,20,3,21,15,6
2020,202763,30,0,53,16,37
2020,202763,30,1,1,1,0
2020,202763,30,2,3,0,3
2020,202763,30,3,49,15,34
2020,202763,40,0,72,33,39
2020,202763,40,2,4,3,1
2020,202763,40,3,24,8,16
2020,202763,40,4,44,22,22
2020,202763,42,0,72,33,39
2020,202763,42,2,4,3,1
2020,202763,42,3,24,8,16
2020,202763,42,4,44,22,22
2020,202806,0,0,64,33,31
2020,202806,10,0,64,33,31
2020,202806,10,6,64,33,31
2020,202806,40,0,64,33,31
2020,202806,40,6,64,33,31
2020,202806,41,0,64,33,31
2020,202806,41,6,64,33,31
2020,202806,45,0,64,33,31
2020,202806,45,6,64,33,31
2020,202903,0,0,20,13,7
2020,202903,10,0,19,12,7
2020,202903,10,1,4,3,1
2020,202903,10,2,2,2,0
2020,202903,10,3,9,5,4
2020,202903,10,4,4,2,2
2020,202903,40,0,19,12,7
2020,202903,40,1,4,3,1
2020,202903,40,2,2,2,0
2020,202903,40,3,9,5,4
2020,202903,40,4,4,2,2
2020,202903,41,0,19,12,7
2020,202903,41,1,4,3,1
2020,202903,41,2,2,2,0
2020,202903,41,3,9,5,4
2020,202903,41,4,4,2,2
2020,202903,44,0,19,12,7
2020,202903,44,1,4,3,1
2020,202903,44,2,2,2,0
2020,202903,44,3,9,5,4
2020,202903,44,4,4,2,2
2020,202903,50,0,1,1,0
2020,202912,0,0,30,6,24
2020,202912,10,0,30,6,24
2020,202912,10,1,3,2,1
2020,202912,10,2,9,2,7
2020,202912,10,3,8,1,7
2020,202912,10,4,6,1,5
2020,202912,10,5,4,0,4
2020,202912,40,0,30,6,24
2020,202912,40,1,3,2,1
2020,202912,40,2,9,2,7
2020,202912,40,3,8,1,7
2020,202912,40,4,6,1,5
2020,202912,40,5,4,0,4
2020,202912,42,0,10,4,6
2020,202912,42,1,2,1,1
2020,202912,42,2,4,2,2
2020,202912,42,3,4,1,3
2020,202912,43,0,20,2,18
2020,202912,43,1,1,1,0
2020,202912,43,2,5,0,5
2020,202912,43,3,4,0,4
2020,202912,43,4,6,1,5
2020,202912,43,5,4,0,4
2020,203067,0,0,39,19,20
2020,203067,10,0,39,19,20
2020,203067,10,1,20,12,8
2020,203067,10,2,4,0,4
2020,203067,10,3,15,7,8
2020,203067,20,0,29,16,13
2020,203067,20,1,20,12,8
2020,203067,20,2,3,0,3
2020,203067,20,3,6,4,2
2020,203067,30,0,4,2,2
2020,203067,30,2,1,0,1
2020,203067,30,3,3,2,1
2020,203067,40,0,6,1,5
2020,203067,40,3,6,1,5
2020,203067,41,0,6,1,5
2020,203067,41,3,6,1,5
2020,203067,44,0,6,1,5
2020,203067,44,3,6,1,5
2020,203085,0,0,62,32,30
2020,203085,10,0,62,32,30
2020,203085,10,1,13,7,6
2020,203085,10,2,9,4,5
2020,203085,10,3,36,18,18
2020,203085,10,4,4,3,1
2020,203085,20,0,21,11,10
2020,203085,20,1,13,7,6
2020,203085,20,2,7,4,3
2020,203085,20,3,1,0,1
2020,203085,30,0,16,7,9
2020,203085,30,2,2,0,2
2020,203085,30,3,14,7,7
2020,203085,40,0,25,14,11
2020,203085,40,3,21,11,10
2020,203085,40,4,4,3,1
2020,203085,41,0,20,10,10
2020,203085,41,3,17,8,9
2020,203085,41,4,3,2,1
2020,203085,42,0,3,2,1
2020,203085,42,3,3,2,1
2020,203085,43,0,2,2,0
2020,203085,43,3,1,1,0
2020,203085,43,4,1,1,0
2020,203085,44,0,20,10,10
2020,203085,44,3,17,8,9
2020,203085,44,4,3,2,1
2020,203128,0,0,65,29,36
2020,203128,10,0,65,29,36
2020,203128,10,1,9,2,7
2020,203128,10,2,30,15,15
2020,203128,10,3,18,8,10
2020,203128,10,4,8,4,4
2020,203128,20,0,38,17,21
2020,203128,20,1,9,2,7
2020,203128,20,2,29,15,14
2020,203128,30,0,14,5,9
2020,203128,30,2,1,0,1
2020,203128,30,3,13,5,8
2020,203128,40,0,13,7,6
2020,203128,40,3,5,3,2
2020,203128,40,4,8,4,4
2020,203128,41,0,1,1,0
2020,203128,41,4,1,1,0
2020,203128,42,0,12,6,6
2020,203128,42,3,5,3,2
2020,203128,42,4,7,3,4
2020,203128,44,0,1,1,0
2020,203128,44,4,1,1,0
2020,203155,0,0,68,30,38
2020,203155,10,0,68,30,38
2020,203155,10,6,68,30,38
2020,203155,40,0,68,30,38
2020,203155,40,6,68,30,38
2020,203155,41,0,68,30,38
2020,203155,41,6,68,30,38
2020,203155,45,0,68,30,38
2020,203155,45,6,68,30,38
2020,203331,0,0,67,27,40
2020,203331,10,0,67,27,40
2020,203331,10,1,4,1,3
2020,203331,10,2,6,1,5
2020,203331,10,3,6,3,3
2020,203331,10,4,51,22,29
2020,203331,40,0,67,27,40
2020,203331,40,1,4,1,3
2020,203331,40,2,6,1,5
2020,203331,40,3,6,3,3
2020,203331,40,4,51,22,29
2020,203331,41,0,67,27,40
2020,203331,41,1,4,1,3
2020,203331,41,2,6,1,5
2020,203331,41,3,6,3,3
2020,203331,41,4,51,22,29
2020,203331,44,0,67,27,40
2020,203331,44,1,4,1,3
2020,203331,44,2,6,1,5
2020,203331,44,3,6,3,3
2020,203331,44,4,51,22,29
2020,203368,0,0,175,95,80
2020,203368,10,0,173,95,78
2020,203368,10,1,59,34,25
2020,203368,10,2,69,35,34
2020,203368,10,3,43,24,19
2020,203368,10,4,2,2,0
2020,203368,20,0,133,72,61
2020,203368,20,1,58,33,25
2020,203368,20,2,68,35,33
2020,203368,20,3,7,4,3
2020,203368,30,0,24,12,12
2020,203368,30,2,1,0,1
2020,203368,30,3,23,12,11
2020,203368,40,0,16,11,5
2020,203368,40,1,1,1,0
2020,203368,40,3,13,8,5
2020,203368,40,4,2,2,0
2020,203368,42,0,16,11,5
2020,203368,42,1,1,1,0
2020,203368,42,3,13,8,5
2020,203368,42,4,2,2,0
2020,203368,50,0,2,0,2
2020,203386,0,0,103,17,86
2020,203386,10,0,103,17,86
2020,203386,10,1,4,4,0
2020,203386,10,2,17,2,15
2020,203386,10,3,7,0,7
2020,203386,10,4,75,11,64
2020,203386,40,0,103,17,86
2020,203386,40,1,4,4,0
2020,203386,40,2,17,2,15
2020,203386,40,3,7,0,7
2020,203386,40,4,75,11,64
2020,203386,41,0,103,17,86
2020,203386,41,1,4,4,0
2020,203386,41,2,17,2,15
2020,203386,41,3,7,0,7
2020,203386,41,4,75,11,64
2020,203386,45,0,103,17,86
2020,203386,45,1,4,4,0
2020,203386,45,2,17,2,15
2020,203386,45,3,7,0,7
2020,203386,45,4,75,11,64
2020,203447,0,0,42,14,28
2020,203447,10,0,42,14,28
2020,203447,10,1,2,2,0
2020,203447,10,2,14,6,8
2020,203447,10,3,2,1,1
2020,203447,10,5,24,5,19
2020,203447,20,0,14,7,7
2020,203447,20,1,1,1,0
2020,203447,20,2,12,6,6
2020,203447,20,3,1,0,1
2020,203447,40,0,28,7,21
2020,203447,40,1,1,1,0
2020,203447,40,2,2,0,2
2020,203447,40,3,1,1,0
2020,203447,40,5,24,5,19
2020,203447,42,0,28,7,21
2020,203447,42,1,1,1,0
2020,203447,42,2,2,0,2
2020,203447,42,3,1,1,0
2020,203447,42,5,24,5,19
2020,203456,0,0,16,8,8
2020,203456,10,0,16,8,8
2020,203456,10,2,9,7,2
2020,203456,10,5,7,1,6
2020,203456,20,0,6,4,2
2020,203456,20,2,6,4,2
2020,203456,40,0,10,4,6
2020,203456,40,2,3,3,0
2020,203456,40,5,7,1,6
2020,203456,42,0,10,4,6
2020,203456,42,2,3,3,0
2020,203456,42,5,7,1,6
2020,203465,0,0,100,48,52
2020,203465,10,0,100,48,52
2020,203465,10,1,13,8,5
2020,203465,10,2,45,23,22
2020,203465,10,3,21,13,8
2020,203465,10,5,21,4,17
2020,203465,20,0,54,31,23
2020,203465,20,1,10,7,3
2020,203465,20,2,36,20,16
2020,203465,20,3,8,4,4
2020,203465,30,0,8,6,2
2020,203465,30,3,8,6,2
2020,203465,40,0,38,11,27
2020,203465,40,1,3,1,2
2020,203465,40,2,9,3,6
2020,203465,40,3,5,3,2
2020,203465,40,5,21,4,17
2020,203465,42,0,38,11,27
2020,203465,42,1,3,1,2
2020,203465,42,2,9,3,6
2020,203465,42,3,5,3,2
2020,203465,42,5,21,4,17
2020,203474,0,0,43,19,24
2020,203474,10,0,43,19,24
2020,203474,10,1,8,3,5
2020,203474,10,2,17,7,10
2020,203474,10,3,5,4,1
2020,203474,10,5,13,5,8
2020,203474,20,0,18,9,9
2020,203474,20,1,5,3,2
2020,203474,20,2,12,6,6
2020,203474,20,3,1,0,1
2020,203474,30,0,4,4,0
2020,203474,30,3,4,4,0
2020,203474,40,0,21,6,15
2020,203474,40,1,3,0,3
2020,203474,40,2,5,1,4
2020,203474,40,5,13,5,8
2020,203474,42,0,21,6,15
2020,203474,42,1,3,0,3
2020,203474,42,2,5,1,4
2020,203474,42,5,13,5,8
2020,203483,0,0,48,24,24
2020,203483,10,0,48,24,24
2020,203483,10,1,5,2,3
2020,203483,10,2,14,7,7
2020,203483,10,3,11,8,3
2020,203483,10,5,18,7,11
2020,203483,20,0,18,9,9
2020,203483,20,1,4,2,2
2020,203483,20,2,13,7,6
2020,203483,20,3,1,0,1
2020,203483,30,0,6,4,2
2020,203483,30,3,6,4,2
2020,203483,40,0,24,11,13
2020,203483,40,1,1,0,1
2020,203483,40,2,1,0,1
2020,203483,40,3,4,4,0
2020,203483,40,5,18,7,11
2020,203483,42,0,24,11,13
2020,203483,42,1,1,0,1
2020,203483,42,2,1,0,1
2020,203483,42,3,4,4,0
2020,203483,42,5,18,7,11
2020,203492,0,0,37,13,24
2020,203492,10,0,37,13,24
2020,203492,10,1,3,1,2
2020,203492,10,2,6,3,3
2020,203492,10,3,9,3,6
2020,203492,10,5,19,6,13
2020,203492,20,0,7,3,4
2020,203492,20,1,2,1,1
2020,203492,20,2,4,2,2
2020,203492,20,3,1,0,1
2020,203492,30,0,5,1,4
2020,203492,30,3,5,1,4
2020,203492,40,0,25,9,16
2020,203492,40,1,1,0,1
2020,203492,40,2,2,1,1
2020,203492,40,3,3,2,1
2020,203492,40,5,19,6,13
2020,203492,42,0,25,9,16
2020,203492,42,1,1,0,1
2020,203492,42,2,2,1,1
2020,203492,42,3,3,2,1
2020,203492,42,5,19,6,13
2020,203517,0,0,930,430,500
2020,203517,10,0,930,430,500
2020,203517,10,1,236,140,96
2020,203517,10,2,338,152,186
2020,203517,10,3,219,108,111
2020,203517,10,4,137,30,107
2020,203517,20,0,427,236,191
2020,203517,20,1,180,116,64
2020,203517,20,2,240,115,125
2020,203517,20,3,7,5,2
2020,203517,30,0,154,80,74
2020,203517,30,1,2,1,1
2020,203517,30,2,6,3,3
2020,203517,30,3,146,76,70
2020,203517,40,0,349,114,235
2020,203517,40,1,54,23,31
2020,203517,40,2,92,34,58
2020,203517,40,3,66,27,39
2020,203517,40,4,137,30,107
2020,203517,42,0,349,114,235
2020,203517,42,1,54,23,31
2020,203517,42,2,92,34,58
2020,203517,42,3,66,27,39
2020,203517,42,4,137,30,107
2020,203526,0,0,39,9,30
2020,203526,10,0,39,9,30
2020,203526,10,1,5,2,3
2020,203526,10,2,13,2,11
2020,203526,10,3,5,0,5
2020,203526,10,5,16,5,11
2020,203526,20,0,8,3,5
2020,203526,20,1,3,2,1
2020,203526,20,2,5,1,4
2020,203526,30,0,2,1,1
2020,203526,30,2,1,1,0
2020,203526,30,3,1,0,1
2020,203526,40,0,29,5,24
2020,203526,40,1,2,0,2
2020,203526,40,2,7,0,7
2020,203526,40,3,4,0,4
2020,203526,40,5,16,5,11
2020,203526,42,0,29,5,24
2020,203526,42,1,2,0,2
2020,203526,42,2,7,0,7
2020,203526,42,3,4,0,4
2020,203526,42,5,16,5,11
2020,203535,0,0,205,100,105
2020,203535,10,0,205,100,105
2020,203535,10,1,70,44,26
2020,203535,10,2,51,28,23
2020,203535,10,3,71,26,45
2020,203535,10,4,12,2,10
2020,203535,10,6,1,0,1
2020,203535,20,0,98,53,45
2020,203535,20,1,67,41,26
2020,203535,20,2,31,12,19
2020,203535,30,0,57,33,24
2020,203535,30,1,1,1,0
2020,203535,30,2,20,16,4
2020,203535,30,3,35,16,19
2020,203535,30,6,1,0,1
2020,203535,40,0,50,14,36
2020,203535,40,1,2,2,0
2020,203535,40,3,36,10,26
2020,203535,40,4,12,2,10
2020,203535,41,0,8,2,6
2020,203535,41,3,7,2,5
2020,203535,41,4,1,0,1
2020,203535,42,0,42,12,30
2020,203535,42,1,2,2,0
2020,203535,42,3,29,8,21
2020,203535,42,4,11,2,9
2020,203535,44,0,8,2,6
2020,203535,44,3,7,2,5
2020,203535,44,4,1,0,1
2020,203544,0,0,60,13,47
2020,203544,10,0,60,13,47
2020,203544,10,1,14,5,9
2020,203544,10,2,28,7,21
2020,203544,10,3,17,1,16
2020,203544,10,4,1,0,1
2020,203544,40,0,60,13,47
2020,203544,40,1,14,5,9
2020,203544,40,2,28,7,21
2020,203544,40,3,17,1,16
2020,203544,40,4,1,0,1
2020,203544,42,0,60,13,47
2020,203544,42,1,14,5,9
2020,203544,42,2,28,7,21
2020,203544,42,3,17,1,16
2020,203544,42,4,1,0,1
2020,203580,0,0,47,15,32
2020,203580,10,0,47,15,32
2020,203580,10,1,9,4,5
2020,203580,10,2,17,6,11
2020,203580,10,3,15,5,10
2020,203580,10,4,6,0,6
2020,203580,20,0,23,9,14
2020,203580,20,1,9,4,5
2020,203580,20,2,14,5,9
2020,203580,30,0,8,3,5
2020,203580,30,3,8,3,5
2020,203580,40,0,16,3,13
2020,203580,40,2,3,1,2
2020,203580,40,3,7,2,5
2020,203580,40,4,6,0,6
2020,203580,42,0,16,3,13
2020,203580,42,2,3,1,2
2020,203580,42,3,7,2,5
2020,203580,42,4,6,0,6
2020,203599,0,0,126,60,66
2020,203599,10,0,126,60,66
2020,203599,10,1,76,38,38
2020,203599,10,2,27,13,14
2020,203599,10,3,11,3,8
2020,203599,10,4,12,6,6
2020,203599,20,0,105,53,52
2020,203599,20,1,76,38,38
2020,203599,20,2,21,10,11
2020,203599,20,3,4,1,3
2020,203599,20,4,4,4,0
2020,203599,30,0,21,7,14
2020,203599,30,2,6,3,3
2020,203599,30,3,7,2,5
2020,203599,30,4,8,2,6
2020,203678,0,0,52,19,33
2020,203678,10,0,52,19,33
2020,203678,10,1,5,2,3
2020,203678,10,2,10,3,7
2020,203678,10,3,11,6,5
2020,203678,10,4,26,8,18
2020,203678,40,0,52,19,33
2020,203678,40,1,5,2,3
2020,203678,40,2,10,3,7
2020,203678,40,3,11,6,5
2020,203678,40,4,26,8,18
2020,203678,42,0,52,19,33
2020,203678,42,1,5,2,3
2020,203678,42,2,10,3,7
2020,203678,42,3,11,6,5
2020,203678,42,4,26,8,18
2020,203720,0,0,12,9,3
2020,203720,10,0,12,9,3
2020,203720,10,4,12,9,3
2020,203720,40,0,12,9,3
2020,203720,40,4,12,9,3
2020,203720,41,0,12,9,3
2020,203720,41,4,12,9,3
2020,203720,45,0,12,9,3
2020,203720,45,4,12,9,3
2020,203748,0,0,115,54,61
2020,203748,10,0,108,52,56
2020,203748,10,1,50,24,26
2020,203748,10,2,17,8,9
2020,203748,10,3,28,14,14
2020,203748,10,4,13,6,7
2020,203748,20,0,78,37,41
2020,203748,20,1,50,24,26
2020,203748,20,2,16,8,8
2020,203748,20,3,12,5,7
2020,203748,30,0,25,13,12
2020,203748,30,2,1,0,1
2020,203748,30,3,14,9,5
2020,203748,30,4,10,4,6
2020,203748,40,0,5,2,3
2020,203748,40,3,2,0,2
2020,203748,40,4,3,2,1
2020,203748,42,0,5,2,3
2020,203748,42,3,2,0,2
2020,203748,42,4,3,2,1
2020,203748,50,0,7,2,5
2020,203757,0,0,58,18,40
2020,203757,10,0,58,18,40
2020,203757,10,1,9,2,7
2020,203757,10,2,13,5,8
2020,203757,10,3,25,8,17
2020,203757,10,4,11,3,8
2020,203757,40,0,58,18,40
2020,203757,40,1,9,2,7
2020,203757,40,2,13,5,8
2020,203757,40,3,25,8,17
2020,203757,40,4,11,3,8
2020,203757,41,0,25,9,16
2020,203757,41,1,6,2,4
2020,203757,41,2,8,3,5
2020,203757,41,3,10,4,6
2020,203757,41,4,1,0,1
2020,203757,42,0,33,9,24
2020,203757,42,1,3,0,3
2020,203757,42,2,5,2,3
2020,203757,42,3,15,4,11
2020,203757,42,4,10,3,7
2020,203757,44,0,25,9,16
2020,203757,44,1,6,2,4
2020,203757,44,2,8,3,5
2020,203757,44,3,10,4,6
2020,203757,44,4,1,0,1
2020,203775,0,0,59,29,30
2020,203775,10,0,59,29,30
2020,203775,10,1,26,17,9
2020,203775,10,2,15,7,8
2020,203775,10,3,13,4,9
2020,203775,10,4,5,1,4
2020,203775,20,0,36,22,14
2020,203775,20,1,23,15,8
2020,203775,20,2,13,7,6
2020,203775,30,0,6,2,4
2020,203775,30,2,1,0,1
2020,203775,30,3,5,2,3
2020,203775,40,0,17,5,12
2020,203775,40,1,3,2,1
2020,203775,40,2,1,0,1
2020,203775,40,3,8,2,6
2020,203775,40,4,5,1,4
2020,203775,42,0,17,5,12
2020,203775,42,1,3,2,1
2020,203775,42,2,1,0,1
2020,203775,42,3,8,2,6
2020,203775,42,4,5,1,4
2020,203845,0,0,112,61,51
2020,203845,10,0,112,61,51
2020,203845,10,1,35,21,14
2020,203845,10,2,29,18,11
2020,203845,10,3,43,21,22
2020,203845,10,4,5,1,4
2020,203845,20,0,52,32,20
2020,203845,20,1,32,20,12
2020,203845,20,2,20,12,8
2020,203845,30,0,23,13,10
2020,203845,30,2,3,1,2
2020,203845,30,3,20,12,8
2020,203845,40,0,37,16,21
2020,203845,40,1,3,1,2
2020,203845,40,2,6,5,1
2020,203845,40,3,23,9,14
2020,203845,40,4,5,1,4
2020,203845,42,0,37,16,21
2020,203845,42,1,3,1,2
2020,203845,42,2,6,5,1
2020,203845,42,3,23,9,14
2020,203845,42,4,5,1,4
2020,203881,0,0,56,21,35
2020,203881,10,0,56,21,35
2020,203881,10,1,22,8,14
2020,203881,10,2,7,2,5
2020,203881,10,3,20,9,11
2020,203881,10,4,7,2,5
2020,203881,40,0,56,21,35
2020,203881,40,1,22,8,14
2020,203881,40,2,7,2,5
2020,203881,40,3,20,9,11
2020,203881,40,4,7,2,5
2020,203881,42,0,56,21,35
2020,203881,42,1,22,8,14
2020,203881,42,2,7,2,5
2020,203881,42,3,20,9,11
2020,203881,42,4,7,2,5
2020,203960,0,0,64,8,56
2020,203960,10,0,64,8,56
2020,203960,10,1,4,1,3
2020,203960,10,2,14,2,12
2020,203960,10,3,44,5,39
2020,203960,10,4,2,0,2
2020,203960,40,0,64,8,56
2020,203960,40,1,4,1,3
2020,203960,40,2,14,2,12
2020,203960,40,3,44,5,39
2020,203960,40,4,2,0,2
2020,203960,41,0,24,5,19
2020,203960,41,1,4,1,3
2020,203960,41,2,11,2,9
2020,203960,41,3,9,2,7
2020,203960,42,0,40,3,37
2020,203960,42,2,3,0,3
2020,203960,42,3,35,3,32
2020,203960,42,4,2,0,2
2020,203960,44,0,24,5,19
2020,203960,44,1,4,1,3
2020,203960,44,2,11,2,9
2020,203960,44,3,9,2,7
2020,203997,0,0,12,7,5
2020,203997,10,0,12,7,5
2020,203997,10,1,5,4,1
2020,203997,10,2,3,2,1
2020,203997,10,3,4,1,3
2020,203997,20,0,8,6,2
2020,203997,20,1,5,4,1
2020,203997,20,2,3,2,1
2020,203997,30,0,3,1,2
2020,203997,30,3,3,1,2
2020,203997,40,0,1,0,1
2020,203997,40,3,1,0,1
2020,203997,41,0,1,0,1
2020,203997,41,3,1,0,1
2020,203997,44,0,1,0,1
2020,203997,44,3,1,0,1
2020,204006,0,0,96,38,58
2020,204006,10,0,96,38,58
2020,204006,10,1,14,6,8
2020,204006,10,2,34,15,19
2020,204006,10,3,18,5,13
2020,204006,10,4,4,1,3
2020,204006,10,5,18,6,12
2020,204006,10,6,8,5,3
2020,204006,20,0,46,20,26
2020,204006,20,1,14,6,8
2020,204006,20,2,32,14,18
2020,204006,30,0,20,6,14
2020,204006,30,2,2,1,1
2020,204006,30,3,18,5,13
2020,204006,40,0,30,12,18
2020,204006,40,4,4,1,3
2020,204006,40,5,18,6,12
2020,204006,40,6,8,5,3
2020,204006,41,0,18,6,12
2020,204006,41,5,18,6,12
2020,204006,42,0,12,6,6
2020,204006,42,4,4,1,3
2020,204006,42,6,8,5,3
2020,204006,44,0,18,6,12
2020,204006,44,5,18,6,12
2020,204015,0,0,43,27,16
2020,204015,10,0,43,27,16
2020,204015,10,1,9,5,4
2020,204015,10,2,13,9,4
2020,204015,10,3,9,7,2
2020,204015,10,4,1,1,0
2020,204015,10,5,10,4,6
2020,204015,10,6,1,1,0
2020,204015,20,0,22,14,8
2020,204015,20,1,9,5,4
2020,204015,20,2,13,9,4
2020,204015,30,0,9,7,2
2020,204015,30,3,9,7,2
2020,204015,40,0,12,6,6
2020,204015,40,4,1,1,0
2020,204015,40,5,10,4,6
2020,204015,40,6,1,1,0
2020,204015,41,0,10,4,6
2020,204015,41,5,10,4,6
2020,204015,42,0,2,2,0
2020,204015,42,4,1,1,0
2020,204015,42,6,1,1,0
2020,204015,44,0,10,4,6
2020,204015,44,5,10,4,6
2020,204024,0,0,857,481,376
2020,204024,10,0,857,481,376
2020,204024,10,1,233,140,93
2020,204024,10,2,212,130,82
2020,204024,10,3,182,117,65
2020,204024,10,4,40,15,25
2020,204024,10,5,137,59,78
2020,204024,10,6,53,20,33
2020,204024,20,0,439,267,172
2020,204024,20,1,233,140,93
2020,204024,20,2,203,124,79
2020,204024,20,3,3,3,0
2020,204024,30,0,188,120,68
2020,204024,30,2,9,6,3
2020,204024,30,3,179,114,65
2020,204024,40,0,230,94,136
2020,204024,40,4,40,15,25
2020,204024,40,5,137,59,78
2020,204024,40,6,53,20,33
2020,204024,41,0,137,59,78
2020,204024,41,5,137,59,78
2020,204024,42,0,93,35,58
2020,204024,42,4,40,15,25
2020,204024,42,6,53,20,33
2020,204024,44,0,137,59,78
2020,204024,44,5,137,59,78
2020,204176,0,0,54,2,52
2020,204176,10,0,54,2,52
2020,204176,10,1,1,0,1
2020,204176,10,2,13,0,13
2020,204176,10,3,27,0,27
2020,204176,10,4,13,2,11
2020,204176,40,0,54,2,52
2020,204176,40,1,1,0,1
2020,204176,40,2,13,0,13
2020,204176,40,3,27,0,27
2020,204176,40,4,13,2,11
2020,204176,42,0,54,2,52
2020,204176,42,1,1,0,1
2020,204176,42,2,13,0,13
2020,204176,42,3,27,0,27
2020,204176,42,4,13,2,11
2020,204185,0,0,144,68,76
2020,204185,10,0,144,68,76
2020,204185,10,1,39,20,19
2020,204185,10,2,47,26,21
2020,204185,10,3,50,19,31
2020,204185,10,4,8,3,5
2020,204185,20,0,72,38,34
2020,204185,20,1,34,17,17
2020,204185,20,2,38,21,17
2020,204185,30,0,44,21,23
2020,204185,30,1,5,3,2
2020,204185,30,2,5,3,2
2020,204185,30,3,34,15,19
2020,204185,40,0,28,9,19
2020,204185,40,2,4,2,2
2020,204185,40,3,16,4,12
2020,204185,40,4,8,3,5
2020,204185,41,0,25,9,16
2020,204185,41,2,4,2,2
2020,204185,41,3,15,4,11
2020,204185,41,4,6,3,3
2020,204185,42,0,2,0,2
2020,204185,42,4,2,0,2
2020,204185,43,0,1,0,1
2020,204185,43,3,1,0,1
2020,204185,45,0,25,9,16
2020,204185,45,2,4,2,2
2020,204185,45,3,15,4,11
2020,204185,45,4,6,3,3
2020,204194,0,0,58,31,27
2020,204194,10,0,58,31,27
2020,204194,10,1,21,16,5
2020,204194,10,2,10,5,5
2020,204194,10,3,25,9,16
2020,204194,10,4,2,1,1
2020,204194,40,0,58,31,27
2020,204194,40,1,21,16,5
2020,204194,40,2,10,5,5
2020,204194,40,3,25,9,16
2020,204194,40,4,2,1,1
2020,204194,41,0,18,13,5
2020,204194,41,1,15,12,3
2020,204194,41,2,3,1,2
2020,204194,42,0,40,18,22
2020,204194,42,1,6,4,2
2020,204194,42,2,7,4,3
2020,204194,42,3,25,9,16
2020,204194,42,4,2,1,1
2020,204194,44,0,18,13,5
2020,204194,44,1,15,12,3
2020,204194,44,2,3,1,2
2020,204200,0,0,97,39,58
2020,204200,10,0,97,39,58
2020,204200,10,1,14,8,6
2020,204200,10,2,23,10,13
2020,204200,10,3,38,14,24
2020,204200,10,4,22,7,15
2020,204200,20,0,31,16,15
2020,204200,20,1,14,8,6
2020,204200,20,2,17,8,9
2020,204200,30,0,22,9,13
2020,204200,30,2,1,0,1
2020,204200,30,3,21,9,12
2020,204200,40,0,44,14,30
2020,204200,40,2,5,2,3
2020,204200,40,3,17,5,12
2020,204200,40,4,22,7,15
2020,204200,42,0,44,14,30
2020,204200,42,2,5,2,3
2020,204200,42,3,17,5,12
2020,204200,42,4,22,7,15
2020,204255,0,0,37,17,20
2020,204255,10,0,37,17,20
2020,204255,10,1,11,5,6
2020,204255,10,2,11,6,5
2020,204255,10,3,7,2,5
2020,204255,10,4,8,4,4
2020,204255,40,0,37,17,20
2020,204255,40,1,11,5,6
2020,204255,40,2,11,6,5
2020,204255,40,3,7,2,5
2020,204255,40,4,8,4,4
2020,204255,42,0,37,17,20
2020,204255,42,1,11,5,6
2020,204255,42,2,11,6,5
2020,204255,42,3,7,2,5
2020,204255,42,4,8,4,4
2020,204264,0,0,89,43,46
2020,204264,10,0,89,43,46
2020,204264,10,1,26,13,13
2020,204264,10,2,35,21,14
2020,204264,10,3,27,9,18
2020,204264,10,4,1,0,1
2020,204264,20,0,45,29,16
2020,204264,20,1,22,13,9
2020,204264,20,2,23,16,7
2020,204264,30,0,10,4,6
2020,204264,30,2,2,0,2
2020,204264,30,3,8,4,4
2020,204264,40,0,34,10,24
2020,204264,40,1,4,0,4
2020,204264,40,2,10,5,5
2020,204264,40,3,19,5,14
2020,204264,40,4,1,0,1
2020,204264,41,0,31,9,22
2020,204264,41,1,3,0,3
2020,204264,41,2,10,5,5
2020,204264,41,3,17,4,13
2020,204264,41,4,1,0,1
2020,204264,42,0,3,1,2
2020,204264,42,1,1,0,1
2020,204264,42,3,2,1,1
2020,204264,44,0,31,9,22
2020,204264,44,1,3,0,3
2020,204264,44,2,10,5,5
2020,204264,44,3,17,4,13
2020,204264,44,4,1,0,1
2020,204422,0,0,45,15,30
2020,204422,10,0,45,15,30
2020,204422,10,2,17,4,13
2020,204422,10,3,24,9,15
2020,204422,10,4,4,2,2
2020,204422,40,0,45,15,30
2020,204422,40,2,17,4,13
2020,204422,40,3,24,9,15
2020,204422,40,4,4,2,2
2020,204422,41,0,33,9,24
2020,204422,41,2,17,4,13
2020,204422,41,3,14,4,10
2020,204422,41,4,2,1,1
2020,204422,42,0,12,6,6
2020,204422,42,3,10,5,5
2020,204422,42,4,2,1,1
2020,204422,44,0,33,9,24
2020,204422,44,2,17,4,13
2020,204422,44,3,14,4,10
2020,204422,44,4,2,1,1
2020,204440,0,0,36,14,22
2020,204440,50,0,36,14,22
2020,204468,0,0,49,17,32
2020,204468,10,0,49,17,32
2020,204468,10,1,3,1,2
2020,204468,10,2,16,3,13
2020,204468,10,3,21,9,12
2020,204468,10,4,9,4,5
2020,204468,40,0,49,17,32
2020,204468,40,1,3,1,2
2020,204468,40,2,16,3,13
2020,204468,40,3,21,9,12
2020,204468,40,4,9,4,5
2020,204468,42,0,49,17,32
2020,204468,42,1,3,1,2
2020,204468,42,2,16,3,13
2020,204468,42,3,21,9,12
2020,204468,42,4,9,4,5
2020,204477,0,0,79,49,30
2020,204477,10,0,79,49,30
2020,204477,10,1,28,23,5
2020,204477,10,2,28,17,11
2020,204477,10,3,21,7,14
2020,204477,10,4,1,1,0
2020,204477,10,6,1,1,0
2020,204477,20,0,39,28,11
2020,204477,20,1,23,20,3
2020,204477,20,2,15,8,7
2020,204477,20,3,1,0,1
2020,204477,30,0,11,5,6
2020,204477,30,2,1,1,0
2020,204477,30,3,9,3,6
2020,204477,30,6,1,1,0
2020,204477,40,0,29,16,13
2020,204477,40,1,5,3,2
2020,204477,40,2,12,8,4
2020,204477,40,3,11,4,7
2020,204477,40,4,1,1,0
2020,204477,41,0,1,0,1
2020,204477,41,3,1,0,1
2020,204477,42,0,28,16,12
2020,204477,42,1,5,3,2
2020,204477,42,2,12,8,4
2020,204477,42,3,10,4,6
2020,204477,42,4,1,1,0
2020,204477,44,0,1,0,1
2020,204477,44,3,1,0,1
2020,204486,0,0,98,81,17
2020,204486,10,0,98,81,17
2020,204486,10,1,5,3,2
2020,204486,10,2,5,1,4
2020,204486,10,3,8,6,2
2020,204486,10,4,80,71,9
2020,204486,40,0,98,81,17
2020,204486,40,1,5,3,2
2020,204486,40,2,5,1,4
2020,204486,40,3,8,6,2
2020,204486,40,4,80,71,9
2020,204486,41,0,98,81,17
2020,204486,41,1,5,3,2
2020,204486,41,2,5,1,4
2020,204486,41,3,8,6,2
2020,204486,41,4,80,71,9
2020,204486,45,0,98,81,17
2020,204486,45,1,5,3,2
2020,204486,45,2,5,1,4
2020,204486,45,3,8,6,2
2020,204486,45,4,80,71,9
2020,204501,0,0,295,164,131
2020,204501,10,0,295,164,131
2020,204501,10,1,83,56,27
2020,204501,10,2,80,44,36
2020,204501,10,3,73,36,37
2020,204501,10,4,3,0,3
2020,204501,10,6,56,28,28
2020,204501,20,0,158,95,63
2020,204501,20,1,81,54,27
2020,204501,20,2,75,40,35
2020,204501,20,3,1,0,1
2020,204501,20,6,1,1,0
2020,204501,30,0,69,38,31
2020,204501,30,1,1,1,0
2020,204501,30,2,5,4,1
2020,204501,30,3,55,29,26
2020,204501,30,6,8,4,4
2020,204501,40,0,68,31,37
2020,204501,40,1,1,1,0
2020,204501,40,3,17,7,10
2020,204501,40,4,3,0,3
2020,204501,40,6,47,23,24
2020,204501,41,0,32,15,17
2020,204501,41,1,1,1,0
2020,204501,41,3,8,4,4
2020,204501,41,4,2,0,2
2020,204501,41,6,21,10,11
2020,204501,42,0,30,15,15
2020,204501,42,3,8,3,5
2020,204501,42,4,1,0,1
2020,204501,42,6,21,12,9
2020,204501,43,0,6,1,5
2020,204501,43,3,1,0,1
2020,204501,43,6,5,1,4
2020,204501,44,0,21,8,13
2020,204501,44,3,4,1,3
2020,204501,44,4,2,0,2
2020,204501,44,6,15,7,8
2020,204501,45,0,11,7,4
2020,204501,45,1,1,1,0
2020,204501,45,3,4,3,1
2020,204501,45,6,6,3,3
2020,204608,0,0,42,40,2
2020,204608,50,0,42,40,2
2020,204617,0,0,57,30,27
2020,204617,10,0,57,30,27
2020,204617,10,1,8,4,4
2020,204617,10,2,21,12,9
2020,204617,10,3,24,11,13
2020,204617,10,4,1,1,0
2020,204617,10,5,3,2,1
2020,204617,20,0,31,17,14
2020,204617,20,1,8,4,4
2020,204617,20,2,21,12,9
2020,204617,20,3,2,1,1
2020,204617,30,0,11,3,8
2020,204617,30,3,11,3,8
2020,204617,40,0,15,10,5
2020,204617,40,3,11,7,4
2020,204617,40,4,1,1,0
2020,204617,40,5,3,2,1
2020,204617,41,0,6,3,3
2020,204617,41,3,6,3,3
2020,204617,42,0,9,7,2
2020,204617,42,3,5,4,1
2020,204617,42,4,1,1,0
2020,204617,42,5,3,2,1
2020,204617,44,0,5,3,2
2020,204617,44,3,5,3,2
2020,204617,45,0,1,0,1
2020,204617,45,3,1,0,1
2020,204635,0,0,215,132,83
2020,204635,10,0,215,132,83
2020,204635,10,1,64,50,14
2020,204635,10,2,66,37,29
2020,204635,10,3,72,37,35
2020,204635,10,4,13,8,5
2020,204635,20,0,131,88,43
2020,204635,20,1,63,49,14
2020,204635,20,2,61,34,27
2020,204635,20,3,6,4,2
2020,204635,20,4,1,1,0
2020,204635,30,0,58,29,29
2020,204635,30,2,3,2,1
2020,204635,30,3,52,25,27
2020,204635,30,4,3,2,1
2020,204635,40,0,26,15,11
2020,204635,40,1,1,1,0
2020,204635,40,2,2,1,1
2020,204635,40,3,14,8,6
2020,204635,40,4,9,5,4
2020,204635,41,0,6,5,1
2020,204635,41,2,1,1,0
2020,204635,41,3,3,3,0
2020,204635,41,4,2,1,1
2020,204635,42,0,20,10,10
2020,204635,42,1,1,1,0
2020,204635,42,2,1,0,1
2020,204635,42,3,11,5,6
2020,204635,42,4,7,4,3
2020,204635,44,0,6,5,1
2020,204635,44,2,1,1,0
2020,204635,44,3,3,3,0
2020,204635,44,4,2,1,1
2020,204662,0,0,25,17,8
2020,204662,10,0,25,17,8
2020,204662,10,1,2,1,1
2020,204662,10,2,13,9,4
2020,204662,10,3,10,7,3
2020,204662,20,0,16,11,5
2020,204662,20,1,2,1,1
2020,204662,20,2,13,9,4
2020,204662,20,3,1,1,0
2020,204662,30,0,8,5,3
2020,204662,30,3,8,5,3
2020,204662,40,0,1,1,0
2020,204662,40,3,1,1,0
2020,204662,41,0,1,1,0
2020,204662,41,3,1,1,0
2020,204662,44,0,1,1,0
2020,204662,44,3,1,1,0
2020,204671,0,0,28,17,11
2020,204671,10,0,28,17,11
2020,204671,10,1,10,7,3
2020,204671,10,2,16,9,7
2020,204671,10,3,2,1,1
2020,204671,20,0,26,16,10
2020,204671,20,1,10,7,3
2020,204671,20,2,16,9,7
2020,204671,30,0,2,1,1
2020,204671,30,3,2,1,1
2020,204680,0,0,32,18,14
2020,204680,10,0,32,18,14
2020,204680,10,1,6,6,0
2020,204680,10,2,24,11,13
2020,204680,10,3,2,1,1
2020,204680,20,0,30,17,13
2020,204680,20,1,6,6,0
2020,204680,20,2,24,11,13
2020,204680,30,0,2,1,1
2020,204680,30,3,2,1,1
2020,204699,0,0,37,17,20
2020,204699,10,0,37,17,20
2020,204699,10,1,8,6,2
2020,204699,10,2,15,5,10
2020,204699,10,3,14,6,8
2020,204699,20,0,23,11,12
2020,204699,20,1,8,6,2
2020,204699,20,2,15,5,10
2020,204699,30,0,12,5,7
2020,204699,30,3,12,5,7
2020,204699,40,0,2,1,1
2020,204699,40,3,2,1,1
2020,204699,41,0,2,1,1
2020,204699,41,3,2,1,1
2020,204699,44,0,2,1,1
2020,204699,44,3,2,1,1
2020,204705,0,0,49,27,22
2020,204705,10,0,49,27,22
2020,204705,10,1,9,5,4
2020,204705,10,2,30,18,12
2020,204705,10,3,10,4,6
2020,204705,20,0,39,23,16
2020,204705,20,1,9,5,4
2020,204705,20,2,30,18,12
2020,204705,30,0,10,4,6
2020,204705,30,3,10,4,6
2020,204796,0,0,4451,2481,1970
2020,204796,10,0,4423,2470,1953
2020,204796,10,1,1311,911,400
2020,204796,10,2,1226,683,543
2020,204796,10,3,1877,874,1003
2020,204796,10,4,9,2,7
2020,204796,20,0,1832,1186,646
2020,204796,20,1,1059,756,303
2020,204796,20,2,758,424,334
2020,204796,20,3,14,6,8
2020,204796,20,4,1,0,1
2020,204796,30,0,621,330,291
2020,204796,30,1,4,3,1
2020,204796,30,2,30,25,5
2020,204796,30,3,580,301,279
2020,204796,30,4,7,1,6
2020,204796,40,0,1970,954,1016
2020,204796,40,1,248,152,96
2020,204796,40,2,438,234,204
2020,204796,40,3,1283,567,716
2020,204796,40,4,1,1,0
2020,204796,41,0,1970,954,1016
2020,204796,41,1,248,152,96
2020,204796,41,2,438,234,204
2020,204796,41,3,1283,567,716
2020,204796,41,4,1,1,0
2020,204796,44,0,1970,954,1016
2020,204796,44,1,248,152,96
2020,204796,44,2,438,234,204
2020,204796,44,3,1283,567,716
2020,204796,44,4,1,1,0
2020,204796,50,0,28,11,17
2020,204802,0,0,15,7,8
2020,204802,10,0,15,7,8
2020,204802,10,2,12,6,6
2020,204802,10,3,2,0,2
2020,204802,10,5,1,1,0
2020,204802,20,0,12,6,6
2020,204802,20,2,12,6,6
2020,204802,30,0,2,0,2
2020,204802,30,3,2,0,2
2020,204802,40,0,1,1,0
2020,204802,40,5,1,1,0
2020,204802,42,0,1,1,0
2020,204802,42,5,1,1,0
2020,204820,0,0,40,18,22
2020,204820,10,0,40,18,22
2020,204820,10,2,12,8,4
2020,204820,10,3,3,1,2
2020,204820,10,4,1,1,0
2020,204820,10,5,24,8,16
2020,204820,20,0,10,6,4
2020,204820,20,2,10,6,4
2020,204820,30,0,5,3,2
2020,204820,30,2,2,2,0
2020,204820,30,3,3,1,2
2020,204820,40,0,25,9,16
2020,204820,40,4,1,1,0
2020,204820,40,5,24,8,16
2020,204820,42,0,25,9,16
2020,204820,42,4,1,1,0
2020,204820,42,5,24,8,16
2020,204839,0,0,30,7,23
2020,204839,10,0,30,7,23
2020,204839,10,1,1,0,1
2020,204839,10,2,7,0,7
2020,204839,10,3,4,1,3
2020,204839,10,5,18,6,12
2020,204839,20,0,8,0,8
2020,204839,20,1,1,0,1
2020,204839,20,2,7,0,7
2020,204839,30,0,4,1,3
2020,204839,30,3,4,1,3
2020,204839,40,0,18,6,12
2020,204839,40,5,18,6,12
2020,204839,42,0,18,6,12
2020,204839,42,5,18,6,12
2020,204848,0,0,27,15,12
2020,204848,10,0,27,15,12
2020,204848,10,1,3,2,1
2020,204848,10,2,18,11,7
2020,204848,10,3,1,1,0
2020,204848,10,5,5,1,4
2020,204848,20,0,20,13,7
2020,204848,20,1,3,2,1
2020,204848,20,2,17,11,6
2020,204848,30,0,2,1,1
2020,204848,30,2,1,0,1
2020,204848,30,3,1,1,0
2020,204848,40,0,5,1,4
2020,204848,40,5,5,1,4
2020,204848,42,0,5,1,4
2020,204848,42,5,5,1,4
2020,204857,0,0,1007,569,438
2020,204857,10,0,1007,569,438
2020,204857,10,1,265,181,84
2020,204857,10,2,275,177,98
2020,204857,10,3,146,82,64
2020,204857,10,5,289,122,167
2020,204857,10,6,32,7,25
2020,204857,20,0,533,353,180
2020,204857,20,1,265,181,84
2020,204857,20,2,266,170,96
2020,204857,20,3,2,2,0
2020,204857,30,0,153,87,66
2020,204857,30,2,9,7,2
2020,204857,30,3,144,80,64
2020,204857,40,0,321,129,192
2020,204857,40,5,289,122,167
2020,204857,40,6,32,7,25
2020,204857,42,0,321,129,192
2020,204857,42,5,289,122,167
2020,204857,42,6,32,7,25
2020,204866,0,0,27,12,15
2020,204866,10,0,27,12,15
2020,204866,10,1,6,5,1
2020,204866,10,2,17,7,10
2020,204866,10,3,1,0,1
2020,204866,10,5,3,0,3
2020,204866,20,0,23,12,11
2020,204866,20,1,6,5,1
2020,204866,20,2,17,7,10
2020,204866,30,0,1,0,1
2020,204866,30,3,1,0,1
2020,204866,40,0,3,0,3
2020,204866,40,5,3,0,3
2020,204866,42,0,3,0,3
2020,204866,42,5,3,0,3
2020,204884,0,0,6,1,5
2020,204884,50,0,6,1,5
2020,204909,0,0,115,66,49
2020,204909,10,0,115,66,49
2020,204909,10,1,45,31,14
2020,204909,10,2,44,24,20
2020,204909,10,3,25,10,15
2020,204909,10,4,1,1,0
2020,204909,20,0,82,50,32
2020,204909,20,1,45,31,14
2020,204909,20,2,37,19,18
2020,204909,30,0,19,9,10
2020,204909,30,2,5,3,2
2020,204909,30,3,14,6,8
2020,204909,40,0,14,7,7
2020,204909,40,2,2,2,0
2020,204909,40,3,11,4,7
2020,204909,40,4,1,1,0
2020,204909,42,0,12,5,7
2020,204909,42,3,11,4,7
2020,204909,42,4,1,1,0
2020,204909,43,0,2,2,0
2020,204909,43,2,2,2,0
2020,204936,0,0,151,70,81
2020,204936,10,0,151,70,81
2020,204936,10,1,61,33,28
2020,204936,10,2,51,19,32
2020,204936,10,3,23,9,14
2020,204936,10,4,7,3,4
2020,204936,10,5,9,6,3
2020,204936,20,0,103,48,55
2020,204936,20,1,58,31,27
2020,204936,20,2,45,17,28
2020,204936,30,0,21,8,13
2020,204936,30,2,3,2,1
2020,204936,30,3,18,6,12
2020,204936,40,0,27,14,13
2020,204936,40,1,3,2,1
2020,204936,40,2,3,0,3
2020,204936,40,3,5,3,2
2020,204936,40,4,7,3,4
2020,204936,40,5,9,6,3
2020,204936,42,0,27,14,13
2020,204936,42,1,3,2,1
2020,204936,42,2,3,0,3
2020,204936,42,3,5,3,2
2020,204936,42,4,7,3,4
2020,204936,42,5,9,6,3
2020,204945,0,0,114,58,56
2020,204945,10,0,114,58,56
2020,204945,10,1,66,28,38
2020,204945,10,2,13,8,5
2020,204945,10,3,15,11,4
2020,204945,10,4,20,11,9
2020,204945,20,0,100,51,49
2020,204945,20,1,66,28,38
2020,204945,20,2,13,8,5
2020,204945,20,3,13,10,3
2020,204945,20,4,8,5,3
2020,204945,30,0,13,6,7
2020,204945,30,3,1,0,1
2020,204945,30,4,12,6,6
2020,204945,40,0,1,1,0
2020,204945,40,3,1,1,0
2020,204945,42,0,1,1,0
2020,204945,42,3,1,1,0
2020,204990,0,0,5,3,2
2020,204990,10,0,5,3,2
2020,204990,10,1,2,2,0
2020,204990,10,2,1,0,1
2020,204990,10,4,1,0,1
2020,204990,10,6,1,1,0
2020,204990,20,0,1,1,0
2020,204990,20,1,1,1,0
2020,204990,30,0,1,0,1
2020,204990,30,2,1,0,1
2020,204990,40,0,3,2,1
2020,204990,40,1,1,1,0
2020,204990,40,4,1,0,1
2020,204990,40,6,1,1,0
2020,204990,41,0,3,2,1
2020,204990,41,1,1,1,0
2020,204990,41,4,1,0,1
2020,204990,41,6,1,1,0
2020,204990,44,0,1,0,1
2020,204990,44,4,1,0,1
2020,204990,45,0,2,2,0
2020,204990,45,1,1,1,0
2020,204990,45,6,1,1,0
2020,205027,0,0,18,14,4
2020,205027,10,0,18,14,4
2020,205027,10,1,3,3,0
2020,205027,10,2,6,6,0
2020,205027,10,3,7,4,3
2020,205027,10,4,2,1,1
2020,205027,40,0,18,14,4
2020,205027,40,1,3,3,0
2020,205027,40,2,6,6,0
2020,205027,40,3,7,4,3
2020,205027,40,4,2,1,1
2020,205027,41,0,18,14,4
2020,205027,41,1,3,3,0
2020,205027,41,2,6,6,0
2020,205027,41,3,7,4,3
2020,205027,41,4,2,1,1
2020,205027,44,0,18,14,4
2020,205027,44,1,3,3,0
2020,205027,44,2,6,6,0
2020,205027,44,3,7,4,3
2020,205027,44,4,2,1,1
2020,205054,0,0,20,7,13
2020,205054,10,0,20,7,13
2020,205054,10,4,3,3,0
2020,205054,10,6,17,4,13
2020,205054,40,0,20,7,13
2020,205054,40,4,3,3,0
2020,205054,40,6,17,4,13
2020,205054,41,0,3,3,0
2020,205054,41,4,3,3,0
2020,205054,42,0,17,4,13
2020,205054,42,6,17,4,13
2020,205054,45,0,3,3,0
2020,205054,45,4,3,3,0
2020,205124,0,0,5,5,0
2020,205124,10,0,5,5,0
2020,205124,10,1,5,5,0
2020,205124,20,0,3,3,0
2020,205124,20,1,3,3,0
2020,205124,40,0,2,2,0
2020,205124,40,1,2,2,0
2020,205124,41,0,2,2,0
2020,205124,41,1,2,2,0
2020,205124,44,0,2,2,0
2020,205124,44,1,2,2,0
2020,205179,0,0,25,4,21
2020,205179,10,0,25,4,21
2020,205179,10,4,25,4,21
2020,205179,40,0,25,4,21
2020,205179,40,4,25,4,21
2020,205179,41,0,25,4,21
2020,205179,41,4,25,4,21
2020,205179,45,0,25,4,21
2020,205179,45,4,25,4,21
2020,205203,0,0,68,31,37
2020,205203,10,0,68,31,37
2020,205203,10,1,14,9,5
2020,205203,10,2,6,2,4
2020,205203,10,3,37,14,23
2020,205203,10,4,11,6,5
2020,205203,20,0,29,15,14
2020,205203,20,1,12,7,5
2020,205203,20,2,5,2,3
2020,205203,20,3,12,6,6
2020,205203,30,0,21,5,16
2020,205203,30,3,21,5,16
2020,205203,40,0,18,11,7
2020,205203,40,1,2,2,0
2020,205203,40,2,1,0,1
2020,205203,40,3,4,3,1
2020,205203,40,4,11,6,5
2020,205203,41,0,17,10,7
2020,205203,41,1,1,1,0
2020,205203,41,2,1,0,1
2020,205203,41,3,4,3,1
2020,205203,41,4,11,6,5
2020,205203,43,0,1,1,0
2020,205203,43,1,1,1,0
2020,205203,44,0,17,10,7
2020,205203,44,1,1,1,0
2020,205203,44,2,1,0,1
2020,205203,44,3,4,3,1
2020,205203,44,4,11,6,5
2020,205391,0,0,13,7,6
2020,205391,10,0,13,7,6
2020,205391,10,4,13,7,6
2020,205391,40,0,13,7,6
2020,205391,40,4,13,7,6
2020,205391,42,0,13,7,6
2020,205391,42,4,13,7,6
2020,205443,0,0,136,77,59
2020,205443,10,0,136,77,59
2020,205443,10,1,39,30,9
2020,205443,10,2,54,28,26
2020,205443,10,3,34,15,19
2020,205443,10,4,9,4,5
2020,205443,20,0,68,47,21
2020,205443,20,1,39,30,9
2020,205443,20,2,29,17,12
2020,205443,30,0,57,24,33
2020,205443,30,2,25,11,14
2020,205443,30,3,32,13,19
2020,205443,40,0,11,6,5
2020,205443,40,3,2,2,0
2020,205443,40,4,9,4,5
2020,205443,41,0,5,3,2
2020,205443,41,3,2,2,0
2020,205443,41,4,3,1,2
2020,205443,42,0,6,3,3
2020,205443,42,4,6,3,3
2020,205443,44,0,5,3,2
2020,205443,44,3,2,2,0
2020,205443,44,4,3,1,2
2020,205470,0,0,320,131,189
2020,205470,10,0,320,131,189
2020,205470,10,1,159,69,90
2020,205470,10,2,84,28,56
2020,205470,10,3,30,14,16
2020,205470,10,4,47,20,27
2020,205470,20,0,175,73,102
2020,205470,20,1,156,67,89
2020,205470,20,2,19,6,13
2020,205470,30,0,105,41,64
2020,205470,30,1,3,2,1
2020,205470,30,2,65,22,43
2020,205470,30,3,30,14,16
2020,205470,30,4,7,3,4
2020,205470,40,0,40,17,23
2020,205470,40,4,40,17,23
2020,205470,42,0,40,17,23
2020,205470,42,4,40,17,23
2020,205841,0,0,175,75,100
2020,205841,10,0,175,75,100
2020,205841,10,1,3,2,1
2020,205841,10,2,55,25,30
2020,205841,10,3,60,23,37
2020,205841,10,4,56,24,32
2020,205841,10,6,1,1,0
2020,205841,40,0,175,75,100
2020,205841,40,1,3,2,1
2020,205841,40,2,55,25,30
2020,205841,40,3,60,23,37
2020,205841,40,4,56,24,32
2020,205841,40,6,1,1,0
2020,205841,42,0,175,75,100
2020,205841,42,1,3,2,1
2020,205841,42,2,55,25,30
2020,205841,42,3,60,23,37
2020,205841,42,4,56,24,32
2020,205841,42,6,1,1,0
2020,205887,0,0,20,2,18
2020,205887,10,0,20,2,18
2020,205887,10,6,20,2,18
2020,205887,40,0,20,2,18
2020,205887,40,6,20,2,18
2020,205887,41,0,20,2,18
2020,205887,41,6,20,2,18
2020,205887,45,0,20,2,18
2020,205887,45,6,20,2,18
2020,205957,0,0,126,93,33
2020,205957,10,0,126,93,33
2020,205957,10,1,60,48,12
2020,205957,10,2,27,20,7
2020,205957,10,3,33,22,11
2020,205957,10,4,6,3,3
2020,205957,20,0,85,67,18
2020,205957,20,1,55,45,10
2020,205957,20,2,24,18,6
2020,205957,20,3,6,4,2
2020,205957,30,0,18,11,7
2020,205957,30,1,1,1,0
2020,205957,30,3,16,9,7
2020,205957,30,4,1,1,0
2020,205957,40,0,23,15,8
2020,205957,40,1,4,2,2
2020,205957,40,2,3,2,1
2020,205957,40,3,11,9,2
2020,205957,40,4,5,2,3
2020,205957,42,0,23,15,8
2020,205957,42,1,4,2,2
2020,205957,42,2,3,2,1
2020,205957,42,3,11,9,2
2020,205957,42,4,5,2,3
2020,205966,0,0,42,24,18
2020,205966,10,0,36,19,17
2020,205966,10,1,2,1,1
2020,205966,10,2,19,11,8
2020,205966,10,3,13,7,6
2020,205966,10,4,2,0,2
2020,205966,40,0,36,19,17
2020,205966,40,1,2,1,1
2020,205966,40,2,19,11,8
2020,205966,40,3,13,7,6
2020,205966,40,4,2,0,2
2020,205966,43,0,36,19,17
2020,205966,43,1,2,1,1
2020,205966,43,2,19,11,8
2020,205966,43,3,13,7,6
2020,205966,43,4,2,0,2
2020,205966,50,0,6,5,1
2020,206011,0,0,33,16,17
2020,206011,10,0,32,16,16
2020,206011,10,1,6,3,3
2020,206011,10,2,11,6,5
2020,206011,10,3,11,6,5
2020,206011,10,4,4,1,3
2020,206011,20,0,20,11,9
2020,206011,20,1,6,3,3
2020,206011,20,2,11,6,5
2020,206011,20,3,3,2,1
2020,206011,30,0,12,5,7
2020,206011,30,3,8,4,4
2020,206011,30,4,4,1,3
2020,206011,50,0,1,0,1
2020,206048,0,0,68,40,28
2020,206048,10,0,68,40,28
2020,206048,10,1,17,11,6
2020,206048,10,2,18,8,10
2020,206048,10,3,27,17,10
2020,206048,10,4,6,4,2
2020,206048,40,0,68,40,28
2020,206048,40,1,17,11,6
2020,206048,40,2,18,8,10
2020,206048,40,3,27,17,10
2020,206048,40,4,6,4,2
2020,206048,41,0,62,36,26
2020,206048,41,1,17,11,6
2020,206048,41,2,18,8,10
2020,206048,41,3,27,17,10
2020,206048,42,0,6,4,2
2020,206048,42,4,6,4,2
2020,206048,44,0,62,36,26
2020,206048,44,1,17,11,6
2020,206048,44,2,18,8,10
2020,206048,44,3,27,17,10
2020,206084,0,0,724,397,327
2020,206084,10,0,724,397,327
2020,206084,10,1,216,152,64
2020,206084,10,2,166,96,70
2020,206084,10,3,143,73,70
2020,206084,10,4,25,4,21
2020,206084,10,5,155,59,96
2020,206084,10,6,19,13,6
2020,206084,20,0,358,234,124
2020,206084,20,1,209,146,63
2020,206084,20,2,142,83,59
2020,206084,20,3,4,3,1
2020,206084,20,4,1,0,1
2020,206084,20,6,2,2,0
2020,206084,30,0,160,81,79
2020,206084,30,1,1,1,0
2020,206084,30,2,18,9,9
2020,206084,30,3,135,70,65
2020,206084,30,4,5,1,4
2020,206084,30,6,1,0,1
2020,206084,40,0,206,82,124
2020,206084,40,1,6,5,1
2020,206084,40,2,6,4,2
2020,206084,40,3,4,0,4
2020,206084,40,4,19,3,16
2020,206084,40,5,155,59,96
2020,206084,40,6,16,11,5
2020,206084,42,0,33,13,20
2020,206084,42,1,6,5,1
2020,206084,42,2,1,1,0
2020,206084,42,3,3,0,3
2020,206084,42,4,10,1,9
2020,206084,42,5,13,6,7
2020,206084,43,0,173,69,104
2020,206084,43,2,5,3,2
2020,206084,43,3,1,0,1
2020,206084,43,4,9,2,7
2020,206084,43,5,142,53,89
2020,206084,43,6,16,11,5
2020,206279,0,0,18,8,10
2020,206279,10,0,18,8,10
2020,206279,10,6,18,8,10
2020,206279,40,0,18,8,10
2020,206279,40,6,18,8,10
2020,206279,42,0,18,8,10
2020,206279,42,6,18,8,10
2020,206288,0,0,12,8,4
2020,206288,10,0,12,8,4
2020,206288,10,1,9,5,4
2020,206288,10,2,2,2,0
2020,206288,10,4,1,1,0
2020,206288,20,0,10,6,4
2020,206288,20,1,9,5,4
2020,206288,20,2,1,1,0
2020,206288,30,0,1,1,0
2020,206288,30,2,1,1,0
2020,206288,40,0,1,1,0
2020,206288,40,4,1,1,0
2020,206288,41,0,1,1,0
2020,206288,41,4,1,1,0
2020,206288,44,0,1,1,0
2020,206288,44,4,1,1,0
2020,206349,0,0,60,9,51
2020,206349,10,0,60,9,51
2020,206349,10,1,13,4,9
2020,206349,10,2,13,3,10
2020,206349,10,3,21,2,19
2020,206349,10,4,13,0,13
2020,206349,20,0,22,5,17
2020,206349,20,1,13,4,9
2020,206349,20,2,9,1,8
2020,206349,30,0,4,1,3
2020,206349,30,3,4,1,3
2020,206349,40,0,34,3,31
2020,206349,40,2,4,2,2
2020,206349,40,3,17,1,16
2020,206349,40,4,13,0,13
2020,206349,42,0,34,3,31
2020,206349,42,2,4,2,2
2020,206349,42,3,17,1,16
2020,206349,42,4,13,0,13
2020,206437,0,0,107,40,67
2020,206437,10,0,107,40,67
2020,206437,10,1,31,14,17
2020,206437,10,2,35,14,21
2020,206437,10,3,37,9,28
2020,206437,10,4,4,3,1
2020,206437,20,0,55,27,28
2020,206437,20,1,31,14,17
2020,206437,20,2,24,13,11
2020,206437,30,0,17,7,10
2020,206437,30,2,1,1,0
2020,206437,30,3,16,6,10
2020,206437,40,0,35,6,29
2020,206437,40,2,10,0,10
2020,206437,40,3,21,3,18
2020,206437,40,4,4,3,1
2020,206437,42,0,35,6,29
2020,206437,42,2,10,0,10
2020,206437,42,3,21,3,18
2020,206437,42,4,4,3,1
2020,206446,0,0,43,16,27
2020,206446,10,0,43,16,27
2020,206446,10,1,11,4,7
2020,206446,10,2,11,4,7
2020,206446,10,3,13,5,8
2020,206446,10,4,8,3,5
2020,206446,40,0,43,16,27
2020,206446,40,1,11,4,7
2020,206446,40,2,11,4,7
2020,206446,40,3,13,5,8
2020,206446,40,4,8,3,5
2020,206446,42,0,43,16,27
2020,206446,42,1,11,4,7
2020,206446,42,2,11,4,7
2020,206446,42,3,13,5,8
2020,206446,42,4,8,3,5
2020,206491,0,0,20,13,7
2020,206491,10,0,20,13,7
2020,206491,10,1,2,2,0
2020,206491,10,2,10,6,4
2020,206491,10,3,6,3,3
2020,206491,10,4,2,2,0
2020,206491,20,0,10,7,3
2020,206491,20,1,2,2,0
2020,206491,20,2,8,5,3
2020,206491,30,0,6,3,3
2020,206491,30,2,1,0,1
2020,206491,30,3,5,3,2
2020,206491,40,0,4,3,1
2020,206491,40,2,1,1,0
2020,206491,40,3,1,0,1
2020,206491,40,4,2,2,0
2020,206491,42,0,3,2,1
2020,206491,42,2,1,1,0
2020,206491,42,3,1,0,1
2020,206491,42,4,1,1,0
2020,206491,43,0,1,1,0
2020,206491,43,4,1,1,0
2020,206507,0,0,57,30,27
2020,206507,10,0,57,30,27
2020,206507,10,1,17,11,6
2020,206507,10,2,14,3,11
2020,206507,10,3,25,15,10
2020,206507,10,4,1,1,0
2020,206507,20,0,28,13,15
2020,206507,20,1,17,11,6
2020,206507,20,2,10,1,9
2020,206507,20,3,1,1,0
2020,206507,30,0,12,8,4
2020,206507,30,2,1,1,0
2020,206507,30,3,11,7,4
2020,206507,40,0,17,9,8
2020,206507,40,2,3,1,2
2020,206507,40,3,13,7,6
2020,206507,40,4,1,1,0
2020,206507,42,0,17,9,8
2020,206507,42,2,3,1,2
2020,206507,42,3,13,7,6
2020,206507,42,4,1,1,0
2020,206525,0,0,103,51,52
2020,206525,10,0,103,51,52
2020,206525,10,1,38,21,17
2020,206525,10,2,31,12,19
2020,206525,10,3,30,16,14
2020,206525,10,4,4,2,2
2020,206525,20,0,67,32,35
2020,206525,20,1,37,21,16
2020,206525,20,2,29,11,18
2020,206525,20,3,1,0,1
2020,206525,30,0,20,11,9
2020,206525,30,2,2,1,1
2020,206525,30,3,16,10,6
2020,206525,30,4,2,0,2
2020,206525,40,0,16,8,8
2020,206525,40,1,1,0,1
2020,206525,40,3,13,6,7
2020,206525,40,4,2,2,0
2020,206525,41,0,6,1,5
2020,206525,41,1,1,0,1
2020,206525,41,3,5,1,4
2020,206525,42,0,10,7,3
2020,206525,42,3,8,5,3
2020,206525,42,4,2,2,0
2020,206525,44,0,6,1,5
2020,206525,44,1,1,0,1
2020,206525,44,3,5,1,4
2020,206589,0,0,183,88,95
2020,206589,10,0,183,88,95
2020,206589,10,1,47,28,19
2020,206589,10,2,50,23,27
2020,206589,10,3,78,34,44
2020,206589,10,4,8,3,5
2020,206589,20,0,97,51,46
2020,206589,20,1,47,28,19
2020,206589,20,2,50,23,27
2020,206589,30,0,39,14,25
2020,206589,30,3,39,14,25
2020,206589,40,0,47,23,24
2020,206589,40,3,39,20,19
2020,206589,40,4,8,3,5
2020,206589,41,0,13,5,8
2020,206589,41,3,9,5,4
2020,206589,41,4,4,0,4
2020,206589,42,0,34,18,16
2020,206589,42,3,30,15,15
2020,206589,42,4,4,3,1
2020,206589,44,0,13,5,8
2020,206589,44,3,9,5,4
2020,206589,44,4,4,0,4
2020,206604,0,0,592,322,270
2020,206604,10,0,592,322,270
2020,206604,10,1,175,119,56
2020,206604,10,2,190,100,90
2020,206604,10,3,81,38,43
2020,206604,10,4,33,18,15
2020,206604,10,5,108,44,64
2020,206604,10,6,5,3,2
2020,206604,20,0,307,185,122
2020,206604,20,1,153,103,50
2020,206604,20,2,153,82,71
2020,206604,20,3,1,0,1
2020,206604,30,0,36,21,15
2020,206604,30,2,7,5,2
2020,206604,30,3,29,16,13
2020,206604,40,0,249,116,133
2020,206604,40,1,22,16,6
2020,206604,40,2,30,13,17
2020,206604,40,3,51,22,29
2020,206604,40,4,33,18,15
2020,206604,40,5,108,44,64
2020,206604,40,6,5,3,2
2020,206604,41,0,210,96,114
2020,206604,41,1,22,16,6
2020,206604,41,2,29,12,17
2020,206604,41,3,46,21,25
2020,206604,41,5,108,44,64
2020,206604,41,6,5,3,2
2020,206604,42,0,34,19,15
2020,206604,42,3,1,1,0
2020,206604,42,4,33,18,15
2020,206604,43,0,5,1,4
2020,206604,43,2,1,1,0
2020,206604,43,3,4,0,4
2020,206604,44,0,94,47,47
2020,206604,44,1,15,11,4
2020,206604,44,2,20,10,10
2020,206604,44,3,44,21,23
2020,206604,44,5,10,2,8
2020,206604,44,6,5,3,2
2020,206604,45,0,116,49,67
2020,206604,45,1,7,5,2
2020,206604,45,2,9,2,7
2020,206604,45,3,2,0,2
2020,206604,45,5,98,42,56
2020,206622,0,0,402,175,227
2020,206622,10,0,402,175,227
2020,206622,10,1,73,44,29
2020,206622,10,2,114,58,56
2020,206622,10,3,74,31,43
2020,206622,10,4,123,30,93
2020,206622,10,5,18,12,6
2020,206622,20,0,186,100,86
2020,206622,20,1,73,44,29
2020,206622,20,2,112,56,56
2020,206622,20,3,1,0,1
2020,206622,30,0,75,33,42
2020,206622,30,2,2,2,0
2020,206622,30,3,73,31,42
2020,206622,40,0,141,42,99
2020,206622,40,4,123,30,93
2020,206622,40,5,18,12,6
2020,206622,42,0,135,38,97
2020,206622,42,4,120,28,92
2020,206622,42,5,15,10,5
2020,206622,43,0,6,4,2
2020,206622,43,4,3,2,1
2020,206622,43,5,3,2,1
2020,206695,0,0,377,204,173
2020,206695,10,0,377,204,173
2020,206695,10,1,147,94,53
2020,206695,10,2,106,61,45
2020,206695,10,3,64,27,37
2020,206695,10,5,60,22,38
2020,206695,20,0,260,159,101
2020,206695,20,1,146,94,52
2020,206695,20,2,106,61,45
2020,206695,20,3,8,4,4
2020,206695,30,0,44,17,27
2020,206695,30,3,43,17,26
2020,206695,30,5,1,0,1
2020,206695,40,0,73,28,45
2020,206695,40,1,1,0,1
2020,206695,40,3,13,6,7
2020,206695,40,5,59,22,37
2020,206695,41,0,27,9,18
2020,206695,41,3,10,4,6
2020,206695,41,5,17,5,12
2020,206695,42,0,46,19,27
2020,206695,42,1,1,0,1
2020,206695,42,3,3,2,1
2020,206695,42,5,42,17,25
2020,206695,44,0,27,9,18
2020,206695,44,3,10,4,6
2020,206695,44,5,17,5,12
2020,206817,0,0,16,6,10
2020,206817,10,0,16,6,10
2020,206817,10,1,1,0,1
2020,206817,10,2,7,3,4
2020,206817,10,3,8,3,5
2020,206817,40,0,16,6,10
2020,206817,40,1,1,0,1
2020,206817,40,2,7,3,4
2020,206817,40,3,8,3,5
2020,206817,42,0,16,6,10
2020,206817,42,1,1,0,1
2020,206817,42,2,7,3,4
2020,206817,42,3,8,3,5
2020,206835,0,0,32,16,16
2020,206835,10,0,32,16,16
2020,206835,10,1,3,2,1
2020,206835,10,2,3,2,1
2020,206835,10,3,22,11,11
2020,206835,10,4,4,1,3
2020,206835,40,0,32,16,16
2020,206835,40,1,3,2,1
2020,206835,40,2,3,2,1
2020,206835,40,3,22,11,11
2020,206835,40,4,4,1,3
2020,206835,42,0,32,16,16
2020,206835,42,1,3,2,1
2020,206835,42,2,3,2,1
2020,206835,42,3,22,11,11
2020,206835,42,4,4,1,3
2020,206862,0,0,73,36,37
2020,206862,10,0,73,36,37
2020,206862,10,1,27,13,14
2020,206862,10,2,21,11,10
2020,206862,10,3,25,12,13
2020,206862,40,0,73,36,37
2020,206862,40,1,27,13,14
2020,206862,40,2,21,11,10
2020,206862,40,3,25,12,13
2020,206862,41,0,36,19,17
2020,206862,41,1,21,8,13
2020,206862,41,2,13,10,3
2020,206862,41,3,2,1,1
2020,206862,42,0,37,17,20
2020,206862,42,1,6,5,1
2020,206862,42,2,8,1,7
2020,206862,42,3,23,11,12
2020,206862,44,0,36,19,17
2020,206862,44,1,21,8,13
2020,206862,44,2,13,10,3
2020,206862,44,3,2,1,1
2020,206914,0,0,128,75,53
2020,206914,10,0,128,75,53
2020,206914,10,1,34,23,11
2020,206914,10,2,28,16,12
2020,206914,10,3,29,19,10
2020,206914,10,4,37,17,20
2020,206914,20,0,65,40,25
2020,206914,20,1,34,23,11
2020,206914,20,2,28,16,12
2020,206914,20,3,3,1,2
2020,206914,30,0,26,18,8
2020,206914,30,3,26,18,8
2020,206914,40,0,37,17,20
2020,206914,40,4,37,17,20
2020,206914,42,0,37,17,20
2020,206914,42,4,37,17,20
2020,206923,0,0,46,15,31
2020,206923,10,0,46,15,31
2020,206923,10,4,46,15,31
2020,206923,40,0,46,15,31
2020,206923,40,4,46,15,31
2020,206923,41,0,46,15,31
2020,206923,41,4,46,15,31
2020,206923,45,0,46,15,31
2020,206923,45,4,46,15,31
2020,206932,0,0,16,2,14
2020,206932,10,0,16,2,14
2020,206932,10,4,16,2,14
2020,206932,40,0,16,2,14
2020,206932,40,4,16,2,14
2020,206932,41,0,16,2,14
2020,206932,41,4,16,2,14
2020,206932,45,0,16,2,14
2020,206932,45,4,16,2,14
2020,206941,0,0,557,256,301
2020,206941,10,0,557,256,301
2020,206941,10,1,190,106,84
2020,206941,10,2,101,41,60
2020,206941,10,3,119,48,71
2020,206941,10,4,40,17,23
2020,206941,10,5,107,44,63
2020,206941,20,0,290,143,147
2020,206941,20,1,190,106,84
2020,206941,20,2,89,35,54
2020,206941,20,3,11,2,9
2020,206941,30,0,116,46,70
2020,206941,30,2,11,6,5
2020,206941,30,3,89,35,54
2020,206941,30,4,16,5,11
2020,206941,40,0,151,67,84
2020,206941,40,2,1,0,1
2020,206941,40,3,19,11,8
2020,206941,40,4,24,12,12
2020,206941,40,5,107,44,63
2020,206941,42,0,151,67,84
2020,206941,42,2,1,0,1
2020,206941,42,3,19,11,8
2020,206941,42,4,24,12,12
2020,206941,42,5,107,44,63
2020,206996,0,0,46,16,30
2020,206996,10,0,46,16,30
2020,206996,10,6,46,16,30
2020,206996,40,0,46,16,30
2020,206996,40,6,46,16,30
2020,206996,42,0,46,16,30
2020,206996,42,6,46,16,30
2020,207041,0,0,141,67,74
2020,207041,10,0,141,67,74
2020,207041,10,1,23,15,8
2020,207041,10,2,15,10,5
2020,207041,10,3,60,32,28
2020,207041,10,4,39,10,29
2020,207041,10,5,4,0,4
2020,207041,20,0,38,26,12
2020,207041,20,1,21,14,7
2020,207041,20,2,15,10,5
2020,207041,20,3,2,2,0
2020,207041,30,0,47,23,24
2020,207041,30,1,1,1,0
2020,207041,30,3,46,22,24
2020,207041,40,0,56,18,38
2020,207041,40,1,1,0,1
2020,207041,40,3,12,8,4
2020,207041,40,4,39,10,29
2020,207041,40,5,4,0,4
2020,207041,42,0,56,18,38
2020,207041,42,1,1,0,1
2020,207041,42,3,12,8,4
2020,207041,42,4,39,10,29
2020,207041,42,5,4,0,4
2020,207050,0,0,35,15,20
2020,207050,10,0,35,15,20
2020,207050,10,1,16,8,8
2020,207050,10,4,19,7,12
2020,207050,20,0,16,8,8
2020,207050,20,1,16,8,8
2020,207050,30,0,15,5,10
2020,207050,30,4,15,5,10
2020,207050,40,0,4,2,2
2020,207050,40,4,4,2,2
2020,207050,42,0,4,2,2
2020,207050,42,4,4,2,2
2020,207069,0,0,32,13,19
2020,207069,10,0,32,13,19
2020,207069,10,1,30,13,17
2020,207069,10,4,2,0,2
2020,207069,20,0,9,3,6
2020,207069,20,1,9,3,6
2020,207069,30,0,17,5,12
2020,207069,30,1,15,5,10
2020,207069,30,4,2,0,2
2020,207069,40,0,6,5,1
2020,207069,40,1,6,5,1
2020,207069,42,0,6,5,1
2020,207069,42,1,6,5,1
2020,207157,0,0,13,8,5
2020,207157,10,0,13,8,5
2020,207157,10,6,13,8,5
2020,207157,40,0,13,8,5
2020,207157,40,6,13,8,5
2020,207157,42,0,13,8,5
2020,207157,42,6,13,8,5
2020,207209,0,0,117,60,57
2020,207209,10,0,117,60,57
2020,207209,10,1,3,2,1
2020,207209,10,2,25,17,8
2020,207209,10,3,50,25,25
2020,207209,10,4,39,16,23
2020,207209,20,0,20,13,7
2020,207209,20,1,3,2,1
2020,207209,20,2,16,10,6
2020,207209,20,3,1,1,0
2020,207209,30,0,34,18,16
2020,207209,30,2,7,6,1
2020,207209,30,3,22,9,13
2020,207209,30,4,5,3,2
2020,207209,40,0,63,29,34
2020,207209,40,2,2,1,1
2020,207209,40,3,27,15,12
2020,207209,40,4,34,13,21
2020,207209,42,0,63,29,34
2020,207209,42,2,2,1,1
2020,207209,42,3,27,15,12
2020,207209,42,4,34,13,21
2020,207236,0,0,54,25,29
2020,207236,10,0,54,25,29
2020,207236,10,1,6,3,3
2020,207236,10,2,1,0,1
2020,207236,10,3,9,2,7
2020,207236,10,4,38,20,18
2020,207236,20,0,16,5,11
2020,207236,20,1,6,3,3
2020,207236,20,2,1,0,1
2020,207236,20,3,9,2,7
2020,207236,30,0,38,20,18
2020,207236,30,4,38,20,18
2020,207254,0,0,109,99,10
2020,207254,50,0,109,99,10
2020,207263,0,0,285,138,147
2020,207263,10,0,285,138,147
2020,207263,10,1,69,43,26
2020,207263,10,2,69,37,32
2020,207263,10,3,105,45,60
2020,207263,10,4,39,11,28
2020,207263,10,5,3,2,1
2020,207263,20,0,135,77,58
2020,207263,20,1,67,41,26
2020,207263,20,2,65,35,30
2020,207263,20,3,3,1,2
2020,207263,30,0,76,33,43
2020,207263,30,1,1,1,0
2020,207263,30,2,2,1,1
2020,207263,30,3,69,29,40
2020,207263,30,4,4,2,2
2020,207263,40,0,74,28,46
2020,207263,40,1,1,1,0
2020,207263,40,2,2,1,1
2020,207263,40,3,33,15,18
2020,207263,40,4,35,9,26
2020,207263,40,5,3,2,1
2020,207263,41,0,26,9,17
2020,207263,41,3,9,5,4
2020,207263,41,4,15,3,12
2020,207263,41,5,2,1,1
2020,207263,42,0,38,18,20
2020,207263,42,1,1,1,0
2020,207263,42,2,2,1,1
2020,207263,42,3,17,9,8
2020,207263,42,4,17,6,11
2020,207263,42,5,1,1,0
2020,207263,43,0,10,1,9
2020,207263,43,3,7,1,6
2020,207263,43,4,3,0,3
2020,207263,45,0,26,9,17
2020,207263,45,3,9,5,4
2020,207263,45,4,15,3,12
2020,207263,45,5,2,1,1
2020,207281,0,0,92,36,56
2020,207281,10,0,88,34,54
2020,207281,10,4,88,34,54
2020,207281,20,0,59,24,35
2020,207281,20,4,59,24,35
2020,207281,30,0,29,10,19
2020,207281,30,4,29,10,19
2020,207281,50,0,4,2,2
2020,207290,0,0,47,17,30
2020,207290,10,0,47,17,30
2020,207290,10,4,47,17,30
2020,207290,40,0,47,17,30
2020,207290,40,4,47,17,30
2020,207290,42,0,47,17,30
2020,207290,42,4,47,17,30
2020,207306,0,0,83,39,44
2020,207306,10,0,83,39,44
2020,207306,10,1,21,14,7
2020,207306,10,2,16,4,12
2020,207306,10,3,21,8,13
2020,207306,10,4,24,13,11
2020,207306,10,5,1,0,1
2020,207306,20,0,38,18,20
2020,207306,20,1,21,14,7
2020,207306,20,2,13,3,10
2020,207306,20,3,4,1,3
2020,207306,30,0,19,8,11
2020,207306,30,2,3,1,2
2020,207306,30,3,16,7,9
2020,207306,40,0,26,13,13
2020,207306,40,3,1,0,1
2020,207306,40,4,24,13,11
2020,207306,40,5,1,0,1
2020,207306,42,0,26,13,13
2020,207306,42,3,1,0,1
2020,207306,42,4,24,13,11
2020,207306,42,5,1,0,1
2020,207315,0,0,178,104,74
2020,207315,10,0,178,104,74
2020,207315,10,1,46,30,16
2020,207315,10,2,39,25,14
2020,207315,10,3,93,49,44
2020,207315,20,0,47,30,17
2020,207315,20,1,33,23,10
2020,207315,20,2,14,7,7
2020,207315,30,0,14,9,5
2020,207315,30,1,1,0,1
2020,207315,30,2,5,4,1
2020,207315,30,3,8,5,3
2020,207315,40,0,117,65,52
2020,207315,40,1,12,7,5
2020,207315,40,2,20,14,6
2020,207315,40,3,85,44,41
2020,207315,42,0,117,65,52
2020,207315,42,1,12,7,5
2020,207315,42,2,20,14,6
2020,207315,42,3,85,44,41
2020,207324,0,0,86,57,29
2020,207324,10,0,86,57,29
2020,207324,10,1,39,31,8
2020,207324,10,2,17,14,3
2020,207324,10,3,23,9,14
2020,207324,10,4,7,3,4
2020,207324,20,0,45,33,12
2020,207324,20,1,36,28,8
2020,207324,20,2,7,5,2
2020,207324,20,3,2,0,2
2020,207324,30,0,23,13,10
2020,207324,30,2,8,8,0
2020,207324,30,3,12,4,8
2020,207324,30,4,3,1,2
2020,207324,40,0,18,11,7
2020,207324,40,1,3,3,0
2020,207324,40,2,2,1,1
2020,207324,40,3,9,5,4
2020,207324,40,4,4,2,2
2020,207324,42,0,18,11,7
2020,207324,42,1,3,3,0
2020,207324,42,2,2,1,1
2020,207324,42,3,9,5,4
2020,207324,42,4,4,2,2
2020,207342,0,0,1237,604,633
2020,207342,10,0,1237,604,633
2020,207342,10,1,202,132,70
2020,207342,10,2,212,108,104
2020,207342,10,3,448,214,234
2020,207342,10,4,373,148,225
2020,207342,10,5,2,2,0
2020,207342,20,0,146,96,50
2020,207342,20,1,111,76,35
2020,207342,20,2,35,20,15
2020,207342,30,0,81,35,46
2020,207342,30,1,7,4,3
2020,207342,30,2,21,9,12
2020,207342,30,3,53,22,31
2020,207342,40,0,1010,473,537
2020,207342,40,1,84,52,32
2020,207342,40,2,156,79,77
2020,207342,40,3,395,192,203
2020,207342,40,4,373,148,225
2020,207342,40,5,2,2,0
2020,207342,42,0,1010,473,537
2020,207342,42,1,84,52,32
2020,207342,42,2,156,79,77
2020,207342,42,3,395,192,203
2020,207342,42,4,373,148,225
2020,207342,42,5,2,2,0
2020,207351,0,0,43,25,18
2020,207351,10,0,43,25,18
2020,207351,10,1,6,5,1
2020,207351,10,2,5,3,2
2020,207351,10,3,17,9,8
2020,207351,10,4,14,7,7
2020,207351,10,5,1,1,0
2020,207351,20,0,9,6,3
2020,207351,20,1,6,5,1
2020,207351,20,2,3,1,2
2020,207351,30,0,19,11,8
2020,207351,30,2,2,2,0
2020,207351,30,3,17,9,8
2020,207351,40,0,15,8,7
2020,207351,40,4,14,7,7
2020,207351,40,5,1,1,0
2020,207351,42,0,15,8,7
2020,207351,42,4,14,7,7
2020,207351,42,5,1,1,0
2020,207388,0,0,1254,748,506
2020,207388,10,0,1254,748,506
2020,207388,10,1,333,243,90
2020,207388,10,2,270,173,97
2020,207388,10,3,283,162,121
2020,207388,10,4,1,0,1
2020,207388,10,5,107,52,55
2020,207388,10,6,260,118,142
2020,207388,20,0,590,406,184
2020,207388,20,1,331,241,90
2020,207388,20,2,256,163,93
2020,207388,20,3,2,2,0
2020,207388,20,4,1,0,1
2020,207388,30,0,295,170,125
2020,207388,30,1,1,1,0
2020,207388,30,2,14,10,4
2020,207388,30,3,280,159,121
2020,207388,40,0,369,172,197
2020,207388,40,1,1,1,0
2020,207388,40,3,1,1,0
2020,207388,40,5,107,52,55
2020,207388,40,6,260,118,142
2020,207388,42,0,369,172,197
2020,207388,42,1,1,1,0
2020,207388,42,3,1,1,0
2020,207388,42,5,107,52,55
2020,207388,42,6,260,118,142
2020,207397,0,0,81,31,50
2020,207397,10,0,81,31,50
2020,207397,10,1,7,5,2
2020,207397,10,2,17,6,11
2020,207397,10,3,26,7,19
2020,207397,10,4,31,13,18
2020,207397,20,0,24,11,13
2020,207397,20,1,7,5,2
2020,207397,20,2,17,6,11
2020,207397,30,0,57,20,37
2020,207397,30,3,26,7,19
2020,207397,30,4,31,13,18
2020,207403,0,0,99,59,40
2020,207403,10,0,99,59,40
2020,207403,10,1,33,24,9
2020,207403,10,2,23,15,8
2020,207403,10,3,35,16,19
2020,207403,10,4,8,4,4
2020,207403,20,0,47,32,15
2020,207403,20,1,30,22,8
2020,207403,20,2,17,10,7
2020,207403,30,0,34,18,16
2020,207403,30,1,1,1,0
2020,207403,30,2,5,4,1
2020,207403,30,3,28,13,15
2020,207403,40,0,18,9,9
2020,207403,40,1,2,1,1
2020,207403,40,2,1,1,0
2020,207403,40,3,7,3,4
2020,207403,40,4,8,4,4
2020,207403,41,0,1,0,1
2020,207403,41,4,1,0,1
2020,207403,42,0,17,9,8
2020,207403,42,1,2,1,1
2020,207403,42,2,1,1,0
2020,207403,42,3,7,3,4
2020,207403,42,4,7,4,3
2020,207403,44,0,1,0,1
2020,207403,44,4,1,0,1
2020,207449,0,0,117,56,61
2020,207449,10,0,117,56,61
2020,207449,10,4,117,56,61
2020,207449,40,0,117,56,61
2020,207449,40,4,117,56,61
2020,207449,42,0,117,56,61
2020,207449,42,4,117,56,61
2020,207458,0,0,191,96,95
2020,207458,10,0,191,96,95
2020,207458,10,1,79,50,29
2020,207458,10,2,51,24,27
2020,207458,10,3,47,17,30
2020,207458,10,4,14,5,9
2020,207458,20,0,85,53,32
2020,207458,20,1,61,42,19
2020,207458,20,2,24,11,13
2020,207458,30,0,23,8,15
2020,207458,30,2,12,5,7
2020,207458,30,3,11,3,8
2020,207458,40,0,83,35,48
2020,207458,40,1,18,8,10
2020,207458,40,2,15,8,7
2020,207458,40,3,36,14,22
2020,207458,40,4,14,5,9
2020,207458,41,0,5,5,0
2020,207458,41,1,5,5,0
2020,207458,42,0,78,30,48
2020,207458,42,1,13,3,10
2020,207458,42,2,15,8,7
2020,207458,42,3,36,14,22
2020,207458,42,4,14,5,9
2020,207458,44,0,5,5,0
2020,207458,44,1,5,5,0
2020,207500,0,0,1302,781,521
2020,207500,10,0,1302,781,521
2020,207500,10,1,408,294,114
2020,207500,10,2,368,228,140
2020,207500,10,3,269,141,128
2020,207500,10,4,139,51,88
2020,207500,10,5,118,67,51
2020,207500,20,0,731,496,235
2020,207500,20,1,396,287,109
2020,207500,20,2,335,209,126
2020,207500,30,0,218,113,105
2020,207500,30,2,10,5,5
2020,207500,30,3,208,108,100
2020,207500,40,0,353,172,181
2020,207500,40,1,12,7,5
2020,207500,40,2,23,14,9
2020,207500,40,3,61,33,28
2020,207500,40,4,139,51,88
2020,207500,40,5,118,67,51
2020,207500,41,0,206,106,100
2020,207500,41,1,12,7,5
2020,207500,41,2,22,14,8
2020,207500,41,3,55,29,26
2020,207500,41,4,58,24,34
2020,207500,41,5,59,32,27
2020,207500,42,0,117,58,59
2020,207500,42,2,1,0,1
2020,207500,42,3,6,4,2
2020,207500,42,4,64,23,41
2020,207500,42,5,46,31,15
2020,207500,43,0,30,8,22
2020,207500,43,4,17,4,13
2020,207500,43,5,13,4,9
2020,207500,44,0,206,106,100
2020,207500,44,1,12,7,5
2020,207500,44,2,22,14,8
2020,207500,44,3,55,29,26
2020,207500,44,4,58,24,34
2020,207500,44,5,59,32,27
2020,207564,0,0,89,60,29
2020,207564,10,0,89,60,29
2020,207564,10,6,89,60,29
2020,207564,40,0,89,60,29
2020,207564,40,6,89,60,29
2020,207564,41,0,89,60,29
2020,207564,41,6,89,60,29
2020,207564,45,0,89,60,29
2020,207564,45,6,89,60,29
2020,207582,0,0,151,87,64
2020,207582,10,0,151,87,64
2020,207582,10,1,56,37,19
2020,207582,10,2,30,20,10
2020,207582,10,3,45,20,25
2020,207582,10,5,15,7,8
2020,207582,10,6,5,3,2
2020,207582,40,0,151,87,64
2020,207582,40,1,56,37,19
2020,207582,40,2,30,20,10
2020,207582,40,3,45,20,25
2020,207582,40,5,15,7,8
2020,207582,40,6,5,3,2
2020,207582,41,0,91,60,31
2020,207582,41,1,56,37,19
2020,207582,41,2,30,20,10
2020,207582,41,6,5,3,2
2020,207582,42,0,60,27,33
2020,207582,42,3,45,20,25
2020,207582,42,5,15,7,8
2020,207582,44,0,86,57,29
2020,207582,44,1,56,37,19
2020,207582,44,2,30,20,10
2020,207582,45,0,5,3,2
2020,207582,45,6,5,3,2
2020,207661,0,0,96,53,43
2020,207661,10,0,96,53,43
2020,207661,10,1,30,19,11
2020,207661,10,2,17,14,3
2020,207661,10,3,30,11,19
2020,207661,10,4,19,9,10
2020,207661,20,0,45,31,14
2020,207661,20,1,28,18,10
2020,207661,20,2,16,13,3
2020,207661,20,3,1,0,1
2020,207661,30,0,21,10,11
2020,207661,30,1,1,1,0
2020,207661,30,2,1,1,0
2020,207661,30,3,16,6,10
2020,207661,30,4,3,2,1
2020,207661,40,0,30,12,18
2020,207661,40,1,1,0,1
2020,207661,40,3,13,5,8
2020,207661,40,4,16,7,9
2020,207661,41,0,30,12,18
2020,207661,41,1,1,0,1
2020,207661,41,3,13,5,8
2020,207661,41,4,16,7,9
2020,207661,45,0,30,12,18
2020,207661,45,1,1,0,1
2020,207661,45,3,13,5,8
2020,207661,45,4,16,7,9
2020,207670,0,0,121,47,74
2020,207670,10,0,108,38,70
2020,207670,10,1,108,38,70
2020,207670,20,0,57,24,33
2020,207670,20,1,57,24,33
2020,207670,30,0,37,9,28
2020,207670,30,1,37,9,28
2020,207670,40,0,14,5,9
2020,207670,40,1,14,5,9
2020,207670,42,0,14,5,9
2020,207670,42,1,14,5,9
2020,207670,50,0,13,9,4
2020,207722,0,0,46,25,21
2020,207722,10,0,46,25,21
2020,207722,10,1,17,5,12
2020,207722,10,2,14,9,5
2020,207722,10,3,9,8,1
2020,207722,10,4,6,3,3
2020,207722,20,0,30,13,17
2020,207722,20,1,17,5,12
2020,207722,20,2,13,8,5
2020,207722,30,0,8,7,1
2020,207722,30,2,1,1,0
2020,207722,30,3,7,6,1
2020,207722,40,0,8,5,3
2020,207722,40,3,2,2,0
2020,207722,40,4,6,3,3
2020,207722,42,0,8,5,3
2020,207722,42,3,2,2,0
2020,207722,42,4,6,3,3
2020,207740,0,0,39,14,25
2020,207740,10,0,39,14,25
2020,207740,10,1,5,2,3
2020,207740,10,2,4,1,3
2020,207740,10,3,22,8,14
2020,207740,10,4,8,3,5
2020,207740,20,0,9,3,6
2020,207740,20,1,5,2,3
2020,207740,20,2,4,1,3
2020,207740,30,0,23,7,16
2020,207740,30,3,21,7,14
2020,207740,30,4,2,0,2
2020,207740,40,0,7,4,3
2020,207740,40,3,1,1,0
2020,207740,40,4,6,3,3
2020,207740,42,0,7,4,3
2020,207740,42,3,1,1,0
2020,207740,42,4,6,3,3
2020,207847,0,0,119,63,56
2020,207847,10,0,119,63,56
2020,207847,10,1,42,30,12
2020,207847,10,2,23,9,14
2020,207847,10,3,31,15,16
2020,207847,10,4,23,9,14
2020,207847,20,0,62,37,25
2020,207847,20,1,42,30,12
2020,207847,20,2,20,7,13
2020,207847,30,0,32,15,17
2020,207847,30,2,3,2,1
2020,207847,30,3,28,13,15
2020,207847,30,4,1,0,1
2020,207847,40,0,25,11,14
2020,207847,40,3,3,2,1
2020,207847,40,4,22,9,13
2020,207847,42,0,25,11,14
2020,207847,42,3,3,2,1
2020,207847,42,4,22,9,13
2020,207856,0,0,22,14,8
2020,207856,10,0,22,14,8
2020,207856,10,6,22,14,8
2020,207856,40,0,22,14,8
2020,207856,40,6,22,14,8
2020,207856,42,0,3,1,2
2020,207856,42,6,3,1,2
2020,207856,43,0,19,13,6
2020,207856,43,6,19,13,6
2020,207865,0,0,204,94,110
2020,207865,10,0,204,94,110
2020,207865,10,1,51,25,26
2020,207865,10,2,47,22,25
2020,207865,10,3,43,24,19
2020,207865,10,4,63,23,40
2020,207865,20,0,100,49,51
2020,207865,20,1,51,25,26
2020,207865,20,2,43,18,25
2020,207865,20,3,6,6,0
2020,207865,30,0,28,16,12
2020,207865,30,2,3,3,0
2020,207865,30,3,25,13,12
2020,207865,40,0,76,29,47
2020,207865,40,2,1,1,0
2020,207865,40,3,12,5,7
2020,207865,40,4,63,23,40
2020,207865,42,0,76,29,47
2020,207865,42,2,1,1,0
2020,207865,42,3,12,5,7
2020,207865,42,4,63,23,40
2020,207935,0,0,280,98,182
2020,207935,10,0,280,98,182
2020,207935,10,1,16,1,15
2020,207935,10,2,97,33,64
2020,207935,10,3,167,64,103
2020,207935,40,0,280,98,182
2020,207935,40,1,16,1,15
2020,207935,40,2,97,33,64
2020,207935,40,3,167,64,103
2020,207935,42,0,280,98,182
2020,207935,42,1,16,1,15
2020,207935,42,2,97,33,64
2020,207935,42,3,167,64,103
2020,207962,0,0,16,16,0
2020,207962,10,0,16,16,0
2020,207962,10,4,16,16,0
2020,207962,40,0,16,16,0
2020,207962,40,4,16,16,0
2020,207962,41,0,16,16,0
2020,207962,41,4,16,16,0
2020,207962,45,0,16,16,0
2020,207962,45,4,16,16,0
2020,207971,0,0,309,190,119
2020,207971,10,0,309,190,119
2020,207971,10,1,99,80,19
2020,207971,10,2,94,64,30
2020,207971,10,3,99,40,59
2020,207971,10,4,17,6,11
2020,207971,20,0,165,131,34
2020,207971,20,1,91,77,14
2020,207971,20,2,74,54,20
2020,207971,30,0,51,25,26
2020,207971,30,2,3,3,0
2020,207971,30,3,48,22,26
2020,207971,40,0,93,34,59
2020,207971,40,1,8,3,5
2020,207971,40,2,17,7,10
2020,207971,40,3,51,18,33
2020,207971,40,4,17,6,11
2020,207971,41,0,44,19,25
2020,207971,41,1,4,3,1
2020,207971,41,2,11,3,8
2020,207971,41,3,23,10,13
2020,207971,41,4,6,3,3
2020,207971,42,0,49,15,34
2020,207971,42,1,4,0,4
2020,207971,42,2,6,4,2
2020,207971,42,3,28,8,20
2020,207971,42,4,11,3,8
2020,207971,44,0,44,19,25
2020,207971,44,1,4,3,1
2020,207971,44,2,11,3,8
2020,207971,44,3,23,10,13
2020,207971,44,4,6,3,3
2020,208035,0,0,25,4,21
2020,208035,10,0,25,4,21
2020,208035,10,4,25,4,21
2020,208035,20,0,12,1,11
2020,208035,20,4,12,1,11
2020,208035,30,0,13,3,10
2020,208035,30,4,13,3,10
2020,208275,0,0,51,22,29
2020,208275,10,0,51,22,29
2020,208275,10,4,51,22,29
2020,208275,20,0,40,17,23
2020,208275,20,4,40,17,23
2020,208275,30,0,11,5,6
2020,208275,30,4,11,5,6
2020,208318,0,0,125,61,64
2020,208318,10,0,125,61,64
2020,208318,10,1,40,20,20
2020,208318,10,2,35,20,15
2020,208318,10,3,45,17,28
2020,208318,10,4,5,4,1
2020,208318,20,0,89,46,43
2020,208318,20,1,40,20,20
2020,208318,20,2,33,20,13
2020,208318,20,3,16,6,10
2020,208318,30,0,31,11,20
2020,208318,30,2,2,0,2
2020,208318,30,3,29,11,18
2020,208318,40,0,5,4,1
2020,208318,40,4,5,4,1
2020,208318,42,0,5,4,1
2020,208318,42,4,5,4,1
2020,208390,0,0,187,88,99
2020,208390,10,0,187,88,99
2020,208390,10,4,187,88,99
2020,208390,40,0,187,88,99
2020,208390,40,4,187,88,99
2020,208390,42,0,187,88,99
2020,208390,42,4,187,88,99
2020,208406,0,0,121,64,57
2020,208406,10,0,121,64,57
2020,208406,10,4,121,64,57
2020,208406,40,0,121,64,57
2020,208406,40,4,121,64,57
2020,208406,42,0,121,64,57
2020,208406,42,4,121,64,57
2020,208415,0,0,27,15,12
2020,208415,10,0,27,15,12
2020,208415,10,4,27,15,12
2020,208415,40,0,27,15,12
2020,208415,40,4,27,15,12
2020,208415,42,0,27,15,12
2020,208415,42,4,27,15,12
2020,208479,0,0,13,1,12
2020,208479,10,0,13,1,12
2020,208479,10,4,13,1,12
2020,208479,40,0,13,1,12
2020,208479,40,4,13,1,12
2020,208479,41,0,13,1,12
2020,208479,41,4,13,1,12
2020,208479,45,0,13,1,12
2020,208479,45,4,13,1,12
2020,208512,0,0,64,16,48
2020,208512,10,0,63,16,47
2020,208512,10,4,63,16,47
2020,208512,40,0,63,16,47
2020,208512,40,4,63,16,47
2020,208512,41,0,32,7,25
2020,208512,41,4,32,7,25
2020,208512,43,0,31,9,22
2020,208512,43,4,31,9,22
2020,208512,45,0,32,7,25
2020,208512,45,4,32,7,25
2020,208512,50,0,1,0,1
2020,208646,0,0,108,54,54
2020,208646,10,0,108,54,54
2020,208646,10,1,23,12,11
2020,208646,10,2,39,22,17
2020,208646,10,3,23,12,11
2020,208646,10,4,23,8,15
2020,208646,20,0,57,31,26
2020,208646,20,1,21,11,10
2020,208646,20,2,35,20,15
2020,208646,20,3,1,0,1
2020,208646,30,0,22,11,11
2020,208646,30,1,1,0,1
2020,208646,30,2,4,2,2
2020,208646,30,3,16,9,7
2020,208646,30,4,1,0,1
2020,208646,40,0,29,12,17
2020,208646,40,1,1,1,0
2020,208646,40,3,6,3,3
2020,208646,40,4,22,8,14
2020,208646,42,0,29,12,17
2020,208646,42,1,1,1,0
2020,208646,42,3,6,3,3
2020,208646,42,4,22,8,14
2020,208822,0,0,191,101,90
2020,208822,10,0,191,101,90
2020,208822,10,1,63,42,21
2020,208822,10,2,51,24,27
2020,208822,10,3,70,33,37
2020,208822,10,5,2,1,1
2020,208822,10,6,5,1,4
2020,208822,20,0,69,47,22
2020,208822,20,1,55,38,17
2020,208822,20,2,14,9,5
2020,208822,30,0,81,36,45
2020,208822,30,1,7,4,3
2020,208822,30,2,26,9,17
2020,208822,30,3,48,23,25
2020,208822,40,0,41,18,23
2020,208822,40,1,1,0,1
2020,208822,40,2,11,6,5
2020,208822,40,3,22,10,12
2020,208822,40,5,2,1,1
2020,208822,40,6,5,1,4
2020,208822,42,0,36,17,19
2020,208822,42,1,1,0,1
2020,208822,42,2,11,6,5
2020,208822,42,3,22,10,12
2020,208822,42,5,2,1,1
2020,208822,43,0,5,1,4
2020,208822,43,6,5,1,4
2020,209038,0,0,190,79,111
2020,209038,10,0,190,79,111
2020,209038,10,6,190,79,111
2020,209038,40,0,190,79,111
2020,209038,40,6,190,79,111
2020,209038,42,0,190,79,111
2020,209038,42,6,190,79,111
2020,209056,0,0,209,95,114
2020,209056,10,0,209,95,114
2020,209056,10,1,61,38,23
2020,209056,10,2,82,37,45
2020,209056,10,3,49,14,35
2020,209056,10,4,15,6,9
2020,209056,10,5,1,0,1
2020,209056,10,6,1,0,1
2020,209056,20,0,127,70,57
2020,209056,20,1,52,36,16
2020,209056,20,2,75,34,41
2020,209056,30,0,28,8,20
2020,209056,30,2,3,0,3
2020,209056,30,3,25,8,17
2020,209056,40,0,54,17,37
2020,209056,40,1,9,2,7
2020,209056,40,2,4,3,1
2020,209056,40,3,24,6,18
2020,209056,40,4,15,6,9
2020,209056,40,5,1,0,1
2020,209056,40,6,1,0,1
2020,209056,41,0,7,2,5
2020,209056,41,1,7,2,5
2020,209056,42,0,47,15,32
2020,209056,42,1,2,0,2
2020,209056,42,2,4,3,1
2020,209056,42,3,24,6,18
2020,209056,42,4,15,6,9
2020,209056,42,5,1,0,1
2020,209056,42,6,1,0,1
2020,209056,45,0,7,2,5
2020,209056,45,1,7,2,5
2020,209065,0,0,133,53,80
2020,209065,10,0,133,53,80
2020,209065,10,1,47,26,21
2020,209065,10,2,38,12,26
2020,209065,10,3,48,15,33
2020,209065,20,0,80,37,43
2020,209065,20,1,44,25,19
2020,209065,20,2,32,10,22
2020,209065,20,3,4,2,2
2020,209065,30,0,24,10,14
2020,209065,30,1,1,1,0
2020,209065,30,2,2,1,1
2020,209065,30,3,21,8,13
2020,209065,40,0,29,6,23
2020,209065,40,1,2,0,2
2020,209065,40,2,4,1,3
2020,209065,40,3,23,5,18
2020,209065,42,0,29,6,23
2020,209065,42,1,2,0,2
2020,209065,42,2,4,1,3
2020,209065,42,3,23,5,18
2020,209074,0,0,124,67,57
2020,209074,10,0,124,67,57
2020,209074,10,6,124,67,57
2020,209074,40,0,124,67,57
2020,209074,40,6,124,67,57
2020,209074,42,0,124,67,57
2020,209074,42,6,124,67,57
2020,209241,0,0,15,10,5
2020,209241,10,0,15,10,5
2020,209241,10,1,6,5,1
2020,209241,10,2,9,5,4
2020,209241,40,0,15,10,5
2020,209241,40,1,6,5,1
2020,209241,40,2,9,5,4
2020,209241,42,0,15,10,5
2020,209241,42,1,6,5,1
2020,209241,42,2,9,5,4
2020,209250,0,0,148,65,83
2020,209250,10,0,148,65,83
2020,209250,10,4,148,65,83
2020,209250,20,0,112,56,56
2020,209250,20,4,112,56,56
2020,209250,30,0,34,9,25
2020,209250,30,4,34,9,25
2020,209250,40,0,2,0,2
2020,209250,40,4,2,0,2
2020,209250,42,0,2,0,2
2020,209250,42,4,2,0,2
2020,209287,0,0,23,14,9
2020,209287,10,0,23,14,9
2020,209287,10,1,7,6,1
2020,209287,10,2,7,5,2
2020,209287,10,3,9,3,6
2020,209287,20,0,3,2,1
2020,209287,20,1,3,2,1
2020,209287,40,0,20,12,8
2020,209287,40,1,4,4,0
2020,209287,40,2,7,5,2
2020,209287,40,3,9,3,6
2020,209287,41,0,18,12,6
2020,209287,41,1,4,4,0
2020,209287,41,2,7,5,2
2020,209287,41,3,7,3,4
2020,209287,42,0,2,0,2
2020,209287,42,3,2,0,2
2020,209287,45,0,18,12,6
2020,209287,45,1,4,4,0
2020,209287,45,2,7,5,2
2020,209287,45,3,7,3,4
2020,209296,0,0,26,13,13
2020,209296,10,0,26,13,13
2020,209296,10,1,7,4,3
2020,209296,10,2,7,4,3
2020,209296,10,3,12,5,7
2020,209296,40,0,26,13,13
2020,209296,40,1,7,4,3
2020,209296,40,2,7,4,3
2020,209296,40,3,12,5,7
2020,209296,42,0,26,13,13
2020,209296,42,1,7,4,3
2020,209296,42,2,7,4,3
2020,209296,42,3,12,5,7
2020,209409,0,0,24,15,9
2020,209409,10,0,24,15,9
2020,209409,10,1,6,5,1
2020,209409,10,2,9,6,3
2020,209409,10,3,7,4,3
2020,209409,10,4,2,0,2
2020,209409,40,0,24,15,9
2020,209409,40,1,6,5,1
2020,209409,40,2,9,6,3
2020,209409,40,3,7,4,3
2020,209409,40,4,2,0,2
2020,209409,42,0,24,15,9
2020,209409,42,1,6,5,1
2020,209409,42,2,9,6,3
2020,209409,42,3,7,4,3
2020,209409,42,4,2,0,2
2020,209490,0,0,1746,731,1015
2020,209490,10,0,1746,731,1015
2020,209490,10,1,221,143,78
2020,209490,10,2,318,165,153
2020,209490,10,3,699,296,403
2020,209490,10,4,501,126,375
2020,209490,10,5,7,1,6
2020,209490,20,0,77,50,27
2020,209490,20,1,63,43,20
2020,209490,20,2,14,7,7
2020,209490,30,0,40,26,14
2020,209490,30,1,4,2,2
2020,209490,30,2,17,11,6
2020,209490,30,3,19,13,6
2020,209490,40,0,1629,655,974
2020,209490,40,1,154,98,56
2020,209490,40,2,287,147,140
2020,209490,40,3,680,283,397
2020,209490,40,4,501,126,375
2020,209490,40,5,7,1,6
2020,209490,41,0,19,6,13
2020,209490,41,1,2,0,2
2020,209490,41,2,5,1,4
2020,209490,41,3,12,5,7
2020,209490,42,0,1588,646,942
2020,209490,42,1,152,98,54
2020,209490,42,2,282,146,136
2020,209490,42,3,660,277,383
2020,209490,42,4,493,125,368
2020,209490,42,5,1,0,1
2020,209490,43,0,22,3,19
2020,209490,43,3,8,1,7
2020,209490,43,4,8,1,7
2020,209490,43,5,6,1,5
2020,209490,44,0,19,6,13
2020,209490,44,1,2,0,2
2020,209490,44,2,5,1,4
2020,209490,44,3,12,5,7
2020,209506,0,0,170,99,71
2020,209506,10,0,166,96,70
2020,209506,10,1,47,31,16
2020,209506,10,2,57,36,21
2020,209506,10,3,40,22,18
2020,209506,10,4,21,6,15
2020,209506,10,6,1,1,0
2020,209506,20,0,93,63,30
2020,209506,20,1,47,31,16
2020,209506,20,2,43,29,14
2020,209506,20,3,3,3,0
2020,209506,30,0,49,24,25
2020,209506,30,2,13,7,6
2020,209506,30,3,35,17,18
2020,209506,30,4,1,0,1
2020,209506,40,0,24,9,15
2020,209506,40,2,1,0,1
2020,209506,40,3,2,2,0
2020,209506,40,4,20,6,14
2020,209506,40,6,1,1,0
2020,209506,42,0,24,9,15
2020,209506,42,2,1,0,1
2020,209506,42,3,2,2,0
2020,209506,42,4,20,6,14
2020,209506,42,6,1,1,0
2020,209506,50,0,4,3,1
2020,209542,0,0,1351,783,568
2020,209542,10,0,1351,783,568
2020,209542,10,1,344,255,89
2020,209542,10,2,328,190,138
2020,209542,10,3,243,125,118
2020,209542,10,4,436,213,223
2020,209542,20,0,634,433,201
2020,209542,20,1,342,254,88
2020,209542,20,2,289,177,112
2020,209542,20,3,1,1,0
2020,209542,20,4,2,1,1
2020,209542,30,0,218,115,103
2020,209542,30,2,18,5,13
2020,209542,30,3,200,110,90
2020,209542,40,0,499,235,264
2020,209542,40,1,2,1,1
2020,209542,40,2,21,8,13
2020,209542,40,3,42,14,28
2020,209542,40,4,434,212,222
2020,209542,42,0,499,235,264
2020,209542,42,1,2,1,1
2020,209542,42,2,21,8,13
2020,209542,42,3,42,14,28
2020,209542,42,4,434,212,222
2020,209551,0,0,971,555,416
2020,209551,10,0,971,555,416
2020,209551,10,1,286,192,94
2020,209551,10,2,281,167,114
2020,209551,10,3,202,98,104
2020,209551,10,4,184,95,89
2020,209551,10,5,18,3,15
2020,209551,20,0,550,346,204
2020,209551,20,1,273,182,91
2020,209551,20,2,274,163,111
2020,209551,20,4,3,1,2
2020,209551,30,0,205,102,103
2020,209551,30,1,3,3,0
2020,209551,30,2,7,4,3
2020,209551,30,3,195,95,100
2020,209551,40,0,216,107,109
2020,209551,40,1,10,7,3
2020,209551,40,3,7,3,4
2020,209551,40,4,181,94,87
2020,209551,40,5,18,3,15
2020,209551,41,0,111,58,53
2020,209551,41,1,6,5,1
2020,209551,41,4,91,51,40
2020,209551,41,5,14,2,12
2020,209551,42,0,96,45,51
2020,209551,42,1,3,2,1
2020,209551,42,3,5,2,3
2020,209551,42,4,85,41,44
2020,209551,42,5,3,0,3
2020,209551,43,0,9,4,5
2020,209551,43,1,1,0,1
2020,209551,43,3,2,1,1
2020,209551,43,4,5,2,3
2020,209551,43,5,1,1,0
2020,209551,44,0,111,58,53
2020,209551,44,1,6,5,1
2020,209551,44,4,91,51,40
2020,209551,44,5,14,2,12
2020,209603,0,0,20,7,13
2020,209603,10,0,20,7,13
2020,209603,10,1,2,1,1
2020,209603,10,2,14,5,9
2020,209603,10,3,4,1,3
2020,209603,40,0,20,7,13
2020,209603,40,1,2,1,1
2020,209603,40,2,14,5,9
2020,209603,40,3,4,1,3
2020,209603,42,0,20,7,13
2020,209603,42,1,2,1,1
2020,209603,42,2,14,5,9
2020,209603,42,3,4,1,3
2020,209612,0,0,281,122,159
2020,209612,10,0,281,122,159
2020,209612,10,1,72,45,27
2020,209612,10,2,87,41,46
2020,209612,10,3,111,33,78
2020,209612,10,4,10,3,7
2020,209612,10,6,1,0,1
2020,209612,20,0,132,72,60
2020,209612,20,1,66,41,25
2020,209612,20,2,62,28,34
2020,209612,20,3,4,3,1
2020,209612,30,0,55,18,37
2020,209612,30,1,1,1,0
2020,209612,30,2,6,3,3
2020,209612,30,3,48,14,34
2020,209612,40,0,94,32,62
2020,209612,40,1,5,3,2
2020,209612,40,2,19,10,9
2020,209612,40,3,59,16,43
2020,209612,40,4,10,3,7
2020,209612,40,6,1,0,1
2020,209612,41,0,40,16,24
2020,209612,41,1,5,3,2
2020,209612,41,2,19,10,9
2020,209612,41,3,12,2,10
2020,209612,41,4,4,1,3
2020,209612,42,0,54,16,38
2020,209612,42,3,47,14,33
2020,209612,42,4,6,2,4
2020,209612,42,6,1,0,1
2020,209612,44,0,40,16,24
2020,209612,44,1,5,3,2
2020,209612,44,2,19,10,9
2020,209612,44,3,12,2,10
2020,209612,44,4,4,1,3
2020,209746,0,0,381,178,203
2020,209746,10,0,381,178,203
2020,209746,10,4,381,178,203
2020,209746,20,0,332,158,174
2020,209746,20,4,332,158,174
2020,209746,30,0,42,17,25
2020,209746,30,4,42,17,25
2020,209746,40,0,7,3,4
2020,209746,40,4,7,3,4
2020,209746,42,0,7,3,4
2020,209746,42,4,7,3,4
2020,209807,0,0,742,377,365
2020,209807,10,0,742,377,365
2020,209807,10,1,212,139,73
2020,209807,10,2,209,111,98
2020,209807,10,3,172,71,101
2020,209807,10,4,149,56,93
2020,209807,20,0,388,230,158
2020,209807,20,1,200,132,68
2020,209807,20,2,187,97,90
2020,209807,20,3,1,1,0
2020,209807,30,0,112,46,66
2020,209807,30,2,2,2,0
2020,209807,30,3,110,44,66
2020,209807,40,0,242,101,141
2020,209807,40,1,12,7,5
2020,209807,40,2,20,12,8
2020,209807,40,3,61,26,35
2020,209807,40,4,149,56,93
2020,209807,41,0,182,76,106
2020,209807,41,1,11,6,5
2020,209807,41,2,19,11,8
2020,209807,41,3,49,23,26
2020,209807,41,4,103,36,67
2020,209807,42,0,58,24,34
2020,209807,42,1,1,1,0
2020,209807,42,2,1,1,0
2020,209807,42,3,12,3,9
2020,209807,42,4,44,19,25
2020,209807,43,0,2,1,1
2020,209807,43,4,2,1,1
2020,209807,44,0,55,26,29
2020,209807,44,1,4,4,0
2020,209807,44,2,3,2,1
2020,209807,44,3,14,7,7
2020,209807,44,4,34,13,21
2020,209807,45,0,127,50,77
2020,209807,45,1,7,2,5
2020,209807,45,2,16,9,7
2020,209807,45,3,35,16,19
2020,209807,45,4,69,23,46
2020,209825,0,0,287,117,170
2020,209825,10,0,287,117,170
2020,209825,10,1,48,33,15
2020,209825,10,2,84,41,43
2020,209825,10,3,62,21,41
2020,209825,10,4,63,15,48
2020,209825,10,5,14,3,11
2020,209825,10,6,16,4,12
2020,209825,20,0,127,72,55
2020,209825,20,1,47,33,14
2020,209825,20,2,79,39,40
2020,209825,20,3,1,0,1
2020,209825,30,0,64,21,43
2020,209825,30,2,4,1,3
2020,209825,30,3,60,20,40
2020,209825,40,0,96,24,72
2020,209825,40,1,1,0,1
2020,209825,40,2,1,1,0
2020,209825,40,3,1,1,0
2020,209825,40,4,63,15,48
2020,209825,40,5,14,3,11
2020,209825,40,6,16,4,12
2020,209825,42,0,79,20,59
2020,209825,42,1,1,0,1
2020,209825,42,2,1,1,0
2020,209825,42,3,1,1,0
2020,209825,42,4,51,12,39
2020,209825,42,5,12,3,9
2020,209825,42,6,13,3,10
2020,209825,43,0,17,4,13
2020,209825,43,4,12,3,9
2020,209825,43,5,2,0,2
2020,209825,43,6,3,1,2
2020,209922,0,0,170,94,76
2020,209922,10,0,170,94,76
2020,209922,10,1,61,39,22
2020,209922,10,2,34,20,14
2020,209922,10,3,31,14,17
2020,209922,10,6,44,21,23
2020,209922,20,0,118,70,48
2020,209922,20,1,61,39,22
2020,209922,20,2,32,19,13
2020,209922,20,3,24,12,12
2020,209922,20,6,1,0,1
2020,209922,30,0,28,12,16
2020,209922,30,2,1,0,1
2020,209922,30,3,6,1,5
2020,209922,30,6,21,11,10
2020,209922,40,0,24,12,12
2020,209922,40,2,1,1,0
2020,209922,40,3,1,1,0
2020,209922,40,6,22,10,12
2020,209922,41,0,11,6,5
2020,209922,41,2,1,1,0
2020,209922,41,6,10,5,5
2020,209922,42,0,13,6,7
2020,209922,42,3,1,1,0
2020,209922,42,6,12,5,7
2020,209922,44,0,11,6,5
2020,209922,44,2,1,1,0
2020,209922,44,6,10,5,5
2020,209940,0,0,71,30,41
2020,209940,10,0,71,30,41
2020,209940,10,4,71,30,41
2020,209940,20,0,47,23,24
2020,209940,20,4,47,23,24
2020,209940,30,0,16,5,11
2020,209940,30,4,16,5,11
2020,209940,40,0,8,2,6
2020,209940,40,4,8,2,6
2020,209940,42,0,6,1,5
2020,209940,42,4,6,1,5
2020,209940,43,0,2,1,1
2020,209940,43,4,2,1,1
2020,210146,0,0,151,81,70
2020,210146,10,0,151,81,70
2020,210146,10,1,64,38,26
2020,210146,10,2,31,15,16
2020,210146,10,3,39,20,19
2020,210146,10,4,17,8,9
2020,210146,20,0,85,50,35
2020,210146,20,1,64,38,26
2020,210146,20,2,21,12,9
2020,210146,30,0,49,23,26
2020,210146,30,2,10,3,7
2020,210146,30,3,39,20,19
2020,210146,40,0,17,8,9
2020,210146,40,4,17,8,9
2020,210146,41,0,14,8,6
2020,210146,41,4,14,8,6
2020,210146,42,0,3,0,3
2020,210146,42,4,3,0,3
2020,210146,44,0,14,8,6
2020,210146,44,4,14,8,6
2020,210155,0,0,45,26,19
2020,210155,10,0,45,26,19
2020,210155,10,1,18,14,4
2020,210155,10,2,13,7,6
2020,210155,10,3,13,5,8
2020,210155,10,5,1,0,1
2020,210155,20,0,31,21,10
2020,210155,20,1,18,14,4
2020,210155,20,2,13,7,6
2020,210155,30,0,12,5,7
2020,210155,30,3,12,5,7
2020,210155,40,0,2,0,2
2020,210155,40,3,1,0,1
2020,210155,40,5,1,0,1
2020,210155,41,0,1,0,1
2020,210155,41,3,1,0,1
2020,210155,42,0,1,0,1
2020,210155,42,5,1,0,1
2020,210155,44,0,1,0,1
2020,210155,44,3,1,0,1
2020,210234,0,0,37,17,20
2020,210234,10,0,35,16,19
2020,210234,10,4,35,16,19
2020,210234,20,0,22,13,9
2020,210234,20,4,22,13,9
2020,210234,30,0,6,0,6
2020,210234,30,4,6,0,6
2020,210234,40,0,7,3,4
2020,210234,40,4,7,3,4
2020,210234,41,0,7,3,4
2020,210234,41,4,7,3,4
2020,210234,44,0,7,3,4
2020,210234,44,4,7,3,4
2020,210234,50,0,2,1,1
2020,210270,0,0,58,35,23
2020,210270,10,0,58,35,23
2020,210270,10,4,58,35,23
2020,210270,40,0,58,35,23
2020,210270,40,4,58,35,23
2020,210270,41,0,43,27,16
2020,210270,41,4,43,27,16
2020,210270,42,0,15,8,7
2020,210270,42,4,15,8,7
2020,210270,45,0,43,27,16
2020,210270,45,4,43,27,16
2020,210304,0,0,24,11,13
2020,210304,10,0,24,11,13
2020,210304,10,1,4,3,1
2020,210304,10,2,11,4,7
2020,210304,10,3,7,3,4
2020,210304,10,4,2,1,1
2020,210304,40,0,24,11,13
2020,210304,40,1,4,3,1
2020,210304,40,2,11,4,7
2020,210304,40,3,7,3,4
2020,210304,40,4,2,1,1
2020,210304,42,0,24,11,13
2020,210304,42,1,4,3,1
2020,210304,42,2,11,4,7
2020,210304,42,3,7,3,4
2020,210304,42,4,2,1,1
2020,210331,0,0,47,29,18
2020,210331,10,0,47,29,18
2020,210331,10,1,16,14,2
2020,210331,10,2,18,9,9
2020,210331,10,3,13,6,7
2020,210331,40,0,47,29,18
2020,210331,40,1,16,14,2
2020,210331,40,2,18,9,9
2020,210331,40,3,13,6,7
2020,210331,42,0,47,29,18
2020,210331,42,1,16,14,2
2020,210331,42,2,18,9,9
2020,210331,42,3,13,6,7
2020,210368,0,0,19,13,6
2020,210368,10,0,19,13,6
2020,210368,10,1,10,7,3
2020,210368,10,2,3,3,0
2020,210368,10,3,5,2,3
2020,210368,10,4,1,1,0
2020,210368,40,0,19,13,6
2020,210368,40,1,10,7,3
2020,210368,40,2,3,3,0
2020,210368,40,3,5,2,3
2020,210368,40,4,1,1,0
2020,210368,42,0,19,13,6
2020,210368,42,1,10,7,3
2020,210368,42,2,3,3,0
2020,210368,42,3,5,2,3
2020,210368,42,4,1,1,0
2020,210401,0,0,167,92,75
2020,210401,10,0,167,92,75
2020,210401,10,1,80,46,34
2020,210401,10,2,53,27,26
2020,210401,10,3,25,17,8
2020,210401,10,4,9,2,7
2020,210401,20,0,132,72,60
2020,210401,20,1,80,46,34
2020,210401,20,2,52,26,26
2020,210401,30,0,17,11,6
2020,210401,30,3,17,11,6
2020,210401,40,0,18,9,9
2020,210401,40,2,1,1,0
2020,210401,40,3,8,6,2
2020,210401,40,4,9,2,7
2020,210401,41,0,7,2,5
2020,210401,41,4,7,2,5
2020,210401,42,0,11,7,4
2020,210401,42,2,1,1,0
2020,210401,42,3,8,6,2
2020,210401,42,4,2,0,2
2020,210401,44,0,7,2,5
2020,210401,44,4,7,2,5
2020,210429,0,0,279,125,154
2020,210429,10,0,279,125,154
2020,210429,10,1,86,44,42
2020,210429,10,2,36,16,20
2020,210429,10,3,86,35,51
2020,210429,10,4,67,29,38
2020,210429,10,5,4,1,3
2020,210429,20,0,121,59,62
2020,210429,20,1,86,44,42
2020,210429,20,2,35,15,20
2020,210429,30,0,37,15,22
2020,210429,30,2,1,1,0
2020,210429,30,3,36,14,22
2020,210429,40,0,121,51,70
2020,210429,40,3,50,21,29
2020,210429,40,4,67,29,38
2020,210429,40,5,4,1,3
2020,210429,42,0,121,51,70
2020,210429,42,3,50,21,29
2020,210429,42,4,67,29,38
2020,210429,42,5,4,1,3
2020,210438,0,0,37,18,19
2020,210438,10,0,37,18,19
2020,210438,10,1,3,3,0
2020,210438,10,2,16,8,8
2020,210438,10,3,17,6,11
2020,210438,10,6,1,1,0
2020,210438,20,0,16,9,7
2020,210438,20,1,3,3,0
2020,210438,20,2,12,6,6
2020,210438,20,3,1,0,1
2020,210438,30,0,18,6,12
2020,210438,30,2,4,2,2
2020,210438,30,3,14,4,10
2020,210438,40,0,3,3,0
2020,210438,40,3,2,2,0
2020,210438,40,6,1,1,0
2020,210438,42,0,3,3,0
2020,210438,42,3,2,2,0
2020,210438,42,6,1,1,0
2020,210492,0,0,31,19,12
2020,210492,10,0,31,19,12
2020,210492,10,1,2,1,1
2020,210492,10,2,6,5,1
2020,210492,10,3,23,13,10
2020,210492,20,0,6,5,1
2020,210492,20,1,2,1,1
2020,210492,20,2,3,3,0
2020,210492,20,3,1,1,0
2020,210492,30,0,5,3,2
2020,210492,30,2,1,0,1
2020,210492,30,3,4,3,1
2020,210492,40,0,20,11,9
2020,210492,40,2,2,2,0
2020,210492,40,3,18,9,9
2020,210492,41,0,13,7,6
2020,210492,41,2,2,2,0
2020,210492,41,3,11,5,6
2020,210492,42,0,7,4,3
2020,210492,42,3,7,4,3
2020,210492,44,0,13,7,6
2020,210492,44,2,2,2,0
2020,210492,44,3,11,5,6
2020,210571,0,0,112,54,58
2020,210571,10,0,112,54,58
2020,210571,10,1,23,14,9
2020,210571,10,2,41,23,18
2020,210571,10,3,32,13,19
2020,210571,10,4,16,4,12
2020,210571,20,0,52,31,21
2020,210571,20,1,23,14,9
2020,210571,20,2,29,17,12
2020,210571,30,0,31,15,16
2020,210571,30,2,9,4,5
2020,210571,30,3,22,11,11
2020,210571,40,0,29,8,21
2020,210571,40,2,3,2,1
2020,210571,40,3,10,2,8
2020,210571,40,4,16,4,12
2020,210571,41,0,17,4,13
2020,210571,41,2,2,1,1
2020,210571,41,3,6,2,4
2020,210571,41,4,9,1,8
2020,210571,42,0,12,4,8
2020,210571,42,2,1,1,0
2020,210571,42,3,4,0,4
2020,210571,42,4,7,3,4
2020,210571,44,0,17,4,13
2020,210571,44,2,2,1,1
2020,210571,44,3,6,2,4
2020,210571,44,4,9,1,8
2020,210599,0,0,27,21,6
2020,210599,10,0,27,21,6
2020,210599,10,4,27,21,6
2020,210599,40,0,27,21,6
2020,210599,40,4,27,21,6
2020,210599,41,0,27,21,6
2020,210599,41,4,27,21,6
2020,210599,45,0,27,21,6
2020,210599,45,4,27,21,6
2020,210605,0,0,227,95,132
2020,210605,10,0,227,95,132
2020,210605,10,1,122,54,68
2020,210605,10,2,57,22,35
2020,210605,10,3,40,15,25
2020,210605,10,4,8,4,4
2020,210605,20,0,155,70,85
2020,210605,20,1,118,52,66
2020,210605,20,2,31,15,16
2020,210605,20,3,6,3,3
2020,210605,30,0,60,21,39
2020,210605,30,1,2,0,2
2020,210605,30,2,22,7,15
2020,210605,30,3,33,12,21
2020,210605,30,4,3,2,1
2020,210605,40,0,12,4,8
2020,210605,40,1,2,2,0
2020,210605,40,2,4,0,4
2020,210605,40,3,1,0,1
2020,210605,40,4,5,2,3
2020,210605,41,0,12,4,8
2020,210605,41,1,2,2,0
2020,210605,41,2,4,0,4
2020,210605,41,3,1,0,1
2020,210605,41,4,5,2,3
2020,210605,45,0,12,4,8
2020,210605,45,1,2,2,0
2020,210605,45,2,4,0,4
2020,210605,45,3,1,0,1
2020,210605,45,4,5,2,3
2020,210669,0,0,158,71,87
2020,210669,10,0,157,71,86
2020,210669,10,1,38,23,15
2020,210669,10,2,42,18,24
2020,210669,10,3,61,23,38
2020,210669,10,4,3,1,2
2020,210669,10,6,13,6,7
2020,210669,20,0,86,42,44
2020,210669,20,1,35,21,14
2020,210669,20,2,40,16,24
2020,210669,20,6,11,5,6
2020,210669,30,0,44,16,28
2020,210669,30,3,43,15,28
2020,210669,30,6,1,1,0
2020,210669,40,0,27,13,14
2020,210669,40,1,3,2,1
2020,210669,40,2,2,2,0
2020,210669,40,3,18,8,10
2020,210669,40,4,3,1,2
2020,210669,40,6,1,0,1
2020,210669,41,0,24,12,12
2020,210669,41,1,3,2,1
2020,210669,41,2,2,2,0
2020,210669,41,3,15,7,8
2020,210669,41,4,3,1,2
2020,210669,41,6,1,0,1
2020,210669,42,0,3,1,2
2020,210669,42,3,3,1,2
2020,210669,44,0,24,12,12
2020,210669,44,1,3,2,1
2020,210669,44,2,2,2,0
2020,210669,44,3,15,7,8
2020,210669,44,4,3,1,2
2020,210669,44,6,1,0,1
2020,210669,50,0,1,0,1
2020,210739,0,0,133,60,73
2020,210739,10,0,133,60,73
2020,210739,10,1,16,9,7
2020,210739,10,2,44,19,25
2020,210739,10,3,69,30,39
2020,210739,10,4,4,2,2
2020,210739,20,0,46,25,21
2020,210739,20,1,13,8,5
2020,210739,20,2,33,17,16
2020,210739,30,0,66,28,38
2020,210739,30,1,3,1,2
2020,210739,30,2,8,2,6
2020,210739,30,3,54,25,29
2020,210739,30,4,1,0,1
2020,210739,40,0,21,7,14
2020,210739,40,2,3,0,3
2020,210739,40,3,15,5,10
2020,210739,40,4,3,2,1
2020,210739,41,0,1,0,1
2020,210739,41,3,1,0,1
2020,210739,42,0,20,7,13
2020,210739,42,2,3,0,3
2020,210739,42,3,14,5,9
2020,210739,42,4,3,2,1
2020,210739,44,0,1,0,1
2020,210739,44,3,1,0,1
2020,210775,0,0,108,46,62
2020,210775,10,0,108,46,62
2020,210775,10,1,9,4,5
2020,210775,10,2,30,18,12
2020,210775,10,3,48,20,28
2020,210775,10,4,21,4,17
2020,210775,20,0,45,25,20
2020,210775,20,1,9,4,5
2020,210775,20,2,29,18,11
2020,210775,20,3,7,3,4
2020,210775,30,0,25,12,13
2020,210775,30,3,25,12,13
2020,210775,40,0,38,9,29
2020,210775,40,2,1,0,1
2020,210775,40,3,16,5,11
2020,210775,40,4,21,4,17
2020,210775,41,0,31,7,24
2020,210775,41,3,13,4,9
2020,210775,41,4,18,3,15
2020,210775,42,0,6,2,4
2020,210775,42,3,3,1,2
2020,210775,42,4,3,1,2
2020,210775,43,0,1,0,1
2020,210775,43,2,1,0,1
2020,210775,44,0,31,7,24
2020,210775,44,3,13,4,9
2020,210775,44,4,18,3,15
2020,210809,0,0,18,11,7
2020,210809,10,0,18,11,7
2020,210809,10,1,2,2,0
2020,210809,10,2,2,1,1
2020,210809,10,3,11,6,5
2020,210809,10,4,3,2,1
2020,210809,40,0,18,11,7
2020,210809,40,1,2,2,0
2020,210809,40,2,2,1,1
2020,210809,40,3,11,6,5
2020,210809,40,4,3,2,1
2020,210809,41,0,18,11,7
2020,210809,41,1,2,2,0
2020,210809,41,2,2,1,1
2020,210809,41,3,11,6,5
2020,210809,41,4,3,2,1
2020,210809,44,0,18,11,7
2020,210809,44,1,2,2,0
2020,210809,44,2,2,1,1
2020,210809,44,3,11,6,5
2020,210809,44,4,3,2,1
2020,211024,0,0,31,19,12
2020,211024,10,0,31,19,12
2020,211024,10,1,17,13,4
2020,211024,10,2,8,2,6
2020,211024,10,3,6,4,2
2020,211024,40,0,31,19,12
2020,211024,40,1,17,13,4
2020,211024,40,2,8,2,6
2020,211024,40,3,6,4,2
2020,211024,42,0,31,19,12
2020,211024,42,1,17,13,4
2020,211024,42,2,8,2,6
2020,211024,42,3,6,4,2
2020,211079,0,0,47,16,31
2020,211079,10,0,46,16,30
2020,211079,10,1,9,1,8
2020,211079,10,2,11,3,8
2020,211079,10,3,22,10,12
2020,211079,10,4,2,0,2
2020,211079,10,5,2,2,0
2020,211079,20,0,26,5,21
2020,211079,20,1,9,1,8
2020,211079,20,2,11,3,8
2020,211079,20,3,5,1,4
2020,211079,20,4,1,0,1
2020,211079,30,0,18,9,9
2020,211079,30,3,17,9,8
2020,211079,30,4,1,0,1
2020,211079,40,0,2,2,0
2020,211079,40,5,2,2,0
2020,211079,43,0,2,2,0
2020,211079,43,5,2,2,0
2020,211079,50,0,1,0,1
2020,211088,0,0,161,64,97
2020,211088,10,0,161,64,97
2020,211088,10,1,28,17,11
2020,211088,10,2,51,18,33
2020,211088,10,3,68,24,44
2020,211088,10,4,14,5,9
2020,211088,20,0,74,34,40
2020,211088,20,1,26,17,9
2020,211088,20,2,42,15,27
2020,211088,20,3,6,2,4
2020,211088,30,0,30,14,16
2020,211088,30,1,1,0,1
2020,211088,30,2,3,1,2
2020,211088,30,3,26,13,13
2020,211088,40,0,57,16,41
2020,211088,40,1,1,0,1
2020,211088,40,2,6,2,4
2020,211088,40,3,36,9,27
2020,211088,40,4,14,5,9
2020,211088,42,0,57,16,41
2020,211088,42,1,1,0,1
2020,211088,42,2,6,2,4
2020,211088,42,3,36,9,27
2020,211088,42,4,14,5,9
2020,211130,0,0,8,6,2
2020,211130,10,0,8,6,2
2020,211130,10,1,3,3,0
2020,211130,10,2,2,2,0
2020,211130,10,3,3,1,2
2020,211130,40,0,8,6,2
2020,211130,40,1,3,3,0
2020,211130,40,2,2,2,0
2020,211130,40,3,3,1,2
2020,211130,41,0,8,6,2
2020,211130,41,1,3,3,0
2020,211130,41,2,2,2,0
2020,211130,41,3,3,1,2
2020,211130,44,0,8,6,2
2020,211130,44,1,3,3,0
2020,211130,44,2,2,2,0
2020,211130,44,3,3,1,2
2020,211158,0,0,352,188,164
2020,211158,10,0,352,188,164
2020,211158,10,1,114,81,33
2020,211158,10,2,110,55,55
2020,211158,10,3,97,39,58
2020,211158,10,4,31,13,18
2020,211158,20,0,242,138,104
2020,211158,20,1,114,81,33
2020,211158,20,2,102,49,53
2020,211158,20,3,25,8,17
2020,211158,20,4,1,0,1
2020,211158,30,0,81,37,44
2020,211158,30,2,8,6,2
2020,211158,30,3,72,31,41
2020,211158,30,4,1,0,1
2020,211158,40,0,29,13,16
2020,211158,40,4,29,13,16
2020,211158,42,0,29,13,16
2020,211158,42,4,29,13,16
2020,211273,0,0,165,60,105
2020,211273,10,0,165,60,105
2020,211273,10,1,44,19,25
2020,211273,10,2,41,17,24
2020,211273,10,3,39,13,26
2020,211273,10,4,5,2,3
2020,211273,10,5,33,8,25
2020,211273,10,6,3,1,2
2020,211273,20,0,85,36,49
2020,211273,20,1,44,19,25
2020,211273,20,2,41,17,24
2020,211273,30,0,39,13,26
2020,211273,30,3,39,13,26
2020,211273,40,0,41,11,30
2020,211273,40,4,5,2,3
2020,211273,40,5,33,8,25
2020,211273,40,6,3,1,2
2020,211273,41,0,18,5,13
2020,211273,41,4,1,1,0
2020,211273,41,5,17,4,13
2020,211273,43,0,23,6,17
2020,211273,43,4,4,1,3
2020,211273,43,5,16,4,12
2020,211273,43,6,3,1,2
2020,211273,45,0,18,5,13
2020,211273,45,4,1,1,0
2020,211273,45,5,17,4,13
2020,211291,0,0,398,231,167
2020,211291,10,0,398,231,167
2020,211291,10,1,130,84,46
2020,211291,10,2,130,70,60
2020,211291,10,3,138,77,61
2020,211291,20,0,251,150,101
2020,211291,20,1,127,82,45
2020,211291,20,2,124,68,56
2020,211291,30,0,108,62,46
2020,211291,30,2,2,1,1
2020,211291,30,3,106,61,45
2020,211291,40,0,39,19,20
2020,211291,40,1,3,2,1
2020,211291,40,2,4,1,3
2020,211291,40,3,32,16,16
2020,211291,41,0,7,3,4
2020,211291,41,1,2,1,1
2020,211291,41,2,2,1,1
2020,211291,41,3,3,1,2
2020,211291,42,0,32,16,16
2020,211291,42,1,1,1,0
2020,211291,42,2,2,0,2
2020,211291,42,3,29,15,14
2020,211291,44,0,7,3,4
2020,211291,44,1,2,1,1
2020,211291,44,2,2,1,1
2020,211291,44,3,3,1,2
2020,211307,0,0,130,52,78
2020,211307,10,0,130,52,78
2020,211307,10,1,62,28,34
2020,211307,10,2,43,16,27
2020,211307,10,3,16,6,10
2020,211307,10,4,9,2,7
2020,211307,20,0,91,38,53
2020,211307,20,1,55,23,32
2020,211307,20,2,33,12,21
2020,211307,20,3,3,3,0
2020,211307,30,0,34,12,22
2020,211307,30,1,7,5,2
2020,211307,30,2,9,4,5
2020,211307,30,3,12,3,9
2020,211307,30,4,6,0,6
2020,211307,40,0,5,2,3
2020,211307,40,2,1,0,1
2020,211307,40,3,1,0,1
2020,211307,40,4,3,2,1
2020,211307,42,0,5,2,3
2020,211307,42,2,1,0,1
2020,211307,42,3,1,0,1
2020,211307,42,4,3,2,1
2020,211343,0,0,63,22,41
2020,211343,10,0,63,22,41
2020,211343,10,1,13,3,10
2020,211343,10,2,15,7,8
2020,211343,10,3,10,6,4
2020,211343,10,4,23,6,17
2020,211343,10,6,2,0,2
2020,211343,20,0,43,17,26
2020,211343,20,1,13,3,10
2020,211343,20,2,15,7,8
2020,211343,20,3,10,6,4
2020,211343,20,4,5,1,4
2020,211343,30,0,18,5,13
2020,211343,30,4,18,5,13
2020,211343,40,0,2,0,2
2020,211343,40,6,2,0,2
2020,211343,43,0,2,0,2
2020,211343,43,6,2,0,2
2020,211352,0,0,76,33,43
2020,211352,10,0,76,33,43
2020,211352,10,1,19,7,12
2020,211352,10,2,19,7,12
2020,211352,10,3,35,16,19
2020,211352,10,4,3,3,0
2020,211352,20,0,32,13,19
2020,211352,20,1,15,5,10
2020,211352,20,2,9,5,4
2020,211352,20,3,8,3,5
2020,211352,30,0,26,11,15
2020,211352,30,1,4,2,2
2020,211352,30,2,7,1,6
2020,211352,30,3,15,8,7
2020,211352,40,0,18,9,9
2020,211352,40,2,3,1,2
2020,211352,40,3,12,5,7
2020,211352,40,4,3,3,0
2020,211352,41,0,7,5,2
2020,211352,41,3,4,2,2
2020,211352,41,4,3,3,0
2020,211352,42,0,11,4,7
2020,211352,42,2,3,1,2
2020,211352,42,3,8,3,5
2020,211352,44,0,7,5,2
2020,211352,44,3,4,2,2
2020,211352,44,4,3,3,0
2020,211361,0,0,247,121,126
2020,211361,10,0,247,121,126
2020,211361,10,1,82,40,42
2020,211361,10,2,74,39,35
2020,211361,10,3,71,32,39
2020,211361,10,4,20,10,10
2020,211361,20,0,171,83,88
2020,211361,20,1,82,40,42
2020,211361,20,2,64,33,31
2020,211361,20,3,24,10,14
2020,211361,20,4,1,0,1
2020,211361,30,0,50,24,26
2020,211361,30,2,9,5,4
2020,211361,30,3,40,19,21
2020,211361,30,4,1,0,1
2020,211361,40,0,26,14,12
2020,211361,40,2,1,1,0
2020,211361,40,3,7,3,4
2020,211361,40,4,18,10,8
2020,211361,42,0,26,14,12
2020,211361,42,2,1,1,0
2020,211361,42,3,7,3,4
2020,211361,42,4,18,10,8
2020,211431,0,0,109,26,83
2020,211431,10,0,109,26,83
2020,211431,10,1,28,11,17
2020,211431,10,2,24,4,20
2020,211431,10,3,40,9,31
2020,211431,10,4,17,2,15
2020,211431,20,0,41,13,28
2020,211431,20,1,27,10,17
2020,211431,20,2,13,3,10
2020,211431,20,3,1,0,1
2020,211431,30,0,30,7,23
2020,211431,30,1,1,1,0
2020,211431,30,2,7,1,6
2020,211431,30,3,22,5,17
2020,211431,40,0,38,6,32
2020,211431,40,2,4,0,4
2020,211431,40,3,17,4,13
2020,211431,40,4,17,2,15
2020,211431,42,0,38,6,32
2020,211431,42,2,4,0,4
2020,211431,42,3,17,4,13
2020,211431,42,4,17,2,15
2020,211440,0,0,1286,873,413
2020,211440,10,0,1116,758,358
2020,211440,10,1,417,323,94
2020,211440,10,2,282,191,91
2020,211440,10,3,256,144,112
2020,211440,10,6,161,100,61
2020,211440,20,0,488,382,106
2020,211440,20,1,362,291,71
2020,211440,20,2,126,91,35
2020,211440,30,0,259,159,100
2020,211440,30,2,78,52,26
2020,211440,30,3,181,107,74
2020,211440,40,0,369,217,152
2020,211440,40,1,55,32,23
2020,211440,40,2,78,48,30
2020,211440,40,3,75,37,38
2020,211440,40,6,161,100,61
2020,211440,41,0,208,117,91
2020,211440,41,1,55,32,23
2020,211440,41,2,78,48,30
2020,211440,41,3,75,37,38
2020,211440,42,0,161,100,61
2020,211440,42,6,161,100,61
2020,211440,44,0,208,117,91
2020,211440,44,1,55,32,23
2020,211440,44,2,78,48,30
2020,211440,44,3,75,37,38
2020,211440,50,0,170,115,55
2020,211468,0,0,75,23,52
2020,211468,10,0,75,23,52
2020,211468,10,1,21,8,13
2020,211468,10,2,16,7,9
2020,211468,10,3,24,8,16
2020,211468,10,4,14,0,14
2020,211468,20,0,32,13,19
2020,211468,20,1,21,8,13
2020,211468,20,2,11,5,6
2020,211468,30,0,5,3,2
2020,211468,30,2,2,1,1
2020,211468,30,3,3,2,1
2020,211468,40,0,38,7,31
2020,211468,40,2,3,1,2
2020,211468,40,3,21,6,15
2020,211468,40,4,14,0,14
2020,211468,41,0,4,2,2
2020,211468,41,2,2,1,1
2020,211468,41,3,2,1,1
2020,211468,42,0,34,5,29
2020,211468,42,2,1,0,1
2020,211468,42,3,19,5,14
2020,211468,42,4,14,0,14
2020,211468,44,0,4,2,2
2020,211468,44,2,2,1,1
2020,211468,44,3,2,1,1
2020,211477,0,0,33,18,15
2020,211477,10,0,33,18,15
2020,211477,10,1,3,1,2
2020,211477,10,2,10,7,3
2020,211477,10,3,11,6,5
2020,211477,10,4,9,4,5
2020,211477,40,0,33,18,15
2020,211477,40,1,3,1,2
2020,211477,40,2,10,7,3
2020,211477,40,3,11,6,5
2020,211477,40,4,9,4,5
2020,211477,41,0,33,18,15
2020,211477,41,1,3,1,2
2020,211477,41,2,10,7,3
2020,211477,41,3,11,6,5
2020,211477,41,4,9,4,5
2020,211477,45,0,33,18,15
2020,211477,45,1,3,1,2
2020,211477,45,2,10,7,3
2020,211477,45,3,11,6,5
2020,211477,45,4,9,4,5
2020,211556,0,0,131,43,88
2020,211556,10,0,131,43,88
2020,211556,10,1,18,5,13
2020,211556,10,2,43,15,28
2020,211556,10,3,66,21,45
2020,211556,10,4,4,2,2
2020,211556,20,0,5,1,4
2020,211556,20,1,5,1,4
2020,211556,40,0,126,42,84
2020,211556,40,1,13,4,9
2020,211556,40,2,43,15,28
2020,211556,40,3,66,21,45
2020,211556,40,4,4,2,2
2020,211556,41,0,126,42,84
2020,211556,41,1,13,4,9
2020,211556,41,2,43,15,28
2020,211556,41,3,66,21,45
2020,211556,41,4,4,2,2
2020,211556,44,0,126,42,84
2020,211556,44,1,13,4,9
2020,211556,44,2,43,15,28
2020,211556,44,3,66,21,45
2020,211556,44,4,4,2,2
2020,211583,0,0,66,25,41
2020,211583,10,0,66,25,41
2020,211583,10,1,13,5,8
2020,211583,10,2,11,5,6
2020,211583,10,3,34,13,21
2020,211583,10,4,8,2,6
2020,211583,20,0,24,10,14
2020,211583,20,1,13,5,8
2020,211583,20,2,7,4,3
2020,211583,20,3,4,1,3
2020,211583,30,0,20,8,12
2020,211583,30,2,1,0,1
2020,211583,30,3,19,8,11
2020,211583,40,0,22,7,15
2020,211583,40,2,3,1,2
2020,211583,40,3,11,4,7
2020,211583,40,4,8,2,6
2020,211583,42,0,22,7,15
2020,211583,42,2,3,1,2
2020,211583,42,3,11,4,7
2020,211583,42,4,8,2,6
2020,211608,0,0,31,16,15
2020,211608,10,0,31,16,15
2020,211608,10,1,16,9,7
2020,211608,10,2,9,5,4
2020,211608,10,3,5,2,3
2020,211608,10,4,1,0,1
2020,211608,20,0,24,13,11
2020,211608,20,1,16,9,7
2020,211608,20,2,8,4,4
2020,211608,30,0,6,3,3
2020,211608,30,2,1,1,0
2020,211608,30,3,5,2,3
2020,211608,40,0,1,0,1
2020,211608,40,4,1,0,1
2020,211608,42,0,1,0,1
2020,211608,42,4,1,0,1
2020,211644,0,0,186,81,105
2020,211644,10,0,186,81,105
2020,211644,10,1,60,38,22
2020,211644,10,2,41,15,26
2020,211644,10,3,49,18,31
2020,211644,10,4,36,10,26
2020,211644,20,0,120,61,59
2020,211644,20,1,57,35,22
2020,211644,20,2,35,11,24
2020,211644,20,3,26,15,11
2020,211644,20,4,2,0,2
2020,211644,30,0,33,12,21
2020,211644,30,1,3,3,0
2020,211644,30,2,6,4,2
2020,211644,30,3,22,3,19
2020,211644,30,4,2,2,0
2020,211644,40,0,33,8,25
2020,211644,40,3,1,0,1
2020,211644,40,4,32,8,24
2020,211644,42,0,33,8,25
2020,211644,42,3,1,0,1
2020,211644,42,4,32,8,24
2020,211893,0,0,4,2,2
2020,211893,10,0,4,2,2
2020,211893,10,6,4,2,2
2020,211893,40,0,4,2,2
2020,211893,40,6,4,2,2
2020,211893,42,0,4,2,2
2020,211893,42,6,4,2,2
2020,211927,0,0,132,58,74
2020,211927,10,0,132,58,74
2020,211927,10,1,50,22,28
2020,211927,10,2,62,22,40
2020,211927,10,3,16,10,6
2020,211927,10,4,4,4,0
2020,211927,20,0,114,46,68
2020,211927,20,1,50,22,28
2020,211927,20,2,62,22,40
2020,211927,20,3,2,2,0
2020,211927,30,0,14,8,6
2020,211927,30,3,14,8,6
2020,211927,40,0,4,4,0
2020,211927,40,4,4,4,0
2020,211927,42,0,3,3,0
2020,211927,42,4,3,3,0
2020,211927,43,0,1,1,0
2020,211927,43,4,1,1,0
2020,211981,0,0,92,48,44
2020,211981,10,0,92,48,44
2020,211981,10,1,31,18,13
2020,211981,10,2,27,19,8
2020,211981,10,3,27,10,17
2020,211981,10,4,5,1,4
2020,211981,10,5,2,0,2
2020,211981,20,0,50,33,17
2020,211981,20,1,31,18,13
2020,211981,20,2,15,13,2
2020,211981,20,3,4,2,2
2020,211981,30,0,15,6,9
2020,211981,30,2,5,2,3
2020,211981,30,3,9,4,5
2020,211981,30,4,1,0,1
2020,211981,40,0,27,9,18
2020,211981,40,2,7,4,3
2020,211981,40,3,14,4,10
2020,211981,40,4,4,1,3
2020,211981,40,5,2,0,2
2020,211981,41,0,27,9,18
2020,211981,41,2,7,4,3
2020,211981,41,3,14,4,10
2020,211981,41,4,4,1,3
2020,211981,41,5,2,0,2
2020,211981,44,0,27,9,18
2020,211981,44,2,7,4,3
2020,211981,44,3,14,4,10
2020,211981,44,4,4,1,3
2020,211981,44,5,2,0,2
2020,212009,0,0,215,104,111
2020,212009,10,0,215,104,111
2020,212009,10,1,57,34,23
2020,212009,10,2,86,43,43
2020,212009,10,3,52,20,32
2020,212009,10,4,20,7,13
2020,212009,20,0,137,74,63
2020,212009,20,1,57,34,23
2020,212009,20,2,78,39,39
2020,212009,20,3,2,1,1
2020,212009,30,0,51,22,29
2020,212009,30,2,8,4,4
2020,212009,30,3,41,17,24
2020,212009,30,4,2,1,1
2020,212009,40,0,27,8,19
2020,212009,40,3,9,2,7
2020,212009,40,4,18,6,12
2020,212009,42,0,26,8,18
2020,212009,42,3,8,2,6
2020,212009,42,4,18,6,12
2020,212009,43,0,1,0,1
2020,212009,43,3,1,0,1
2020,212045,0,0,8,4,4
2020,212045,10,0,8,4,4
2020,212045,10,4,8,4,4
2020,212045,40,0,8,4,4
2020,212045,40,4,8,4,4
2020,212045,41,0,8,4,4
2020,212045,41,4,8,4,4
2020,212045,45,0,8,4,4
2020,212045,45,4,8,4,4
2020,212054,0,0,1224,634,590
2020,212054,10,0,1224,634,590
2020,212054,10,1,280,205,75
2020,212054,10,2,236,116,120
2020,212054,10,3,115,67,48
2020,212054,10,4,593,246,347
2020,212054,20,0,496,306,190
2020,212054,20,1,271,198,73
2020,212054,20,2,222,105,117
2020,212054,20,3,3,3,0
2020,212054,30,0,135,82,53
2020,212054,30,1,9,7,2
2020,212054,30,2,14,11,3
2020,212054,30,3,112,64,48
2020,212054,40,0,593,246,347
2020,212054,40,4,593,246,347
2020,212054,41,0,571,237,334
2020,212054,41,4,571,237,334
2020,212054,42,0,22,9,13
2020,212054,42,4,22,9,13
2020,212054,44,0,571,237,334
2020,212054,44,4,571,237,334
2020,212106,0,0,478,231,247
2020,212106,10,0,478,231,247
2020,212106,10,1,93,59,34
2020,212106,10,2,205,107,98
2020,212106,10,3,153,55,98
2020,212106,10,4,25,8,17
2020,212106,10,6,2,2,0
2020,212106,20,0,280,163,117
2020,212106,20,1,93,59,34
2020,212106,20,2,185,103,82
2020,212106,20,3,2,1,1
2020,212106,30,0,71,27,44
2020,212106,30,2,4,0,4
2020,212106,30,3,67,27,40
2020,212106,40,0,127,41,86
2020,212106,40,2,16,4,12
2020,212106,40,3,84,27,57
2020,212106,40,4,25,8,17
2020,212106,40,6,2,2,0
2020,212106,42,0,127,41,86
2020,212106,42,2,16,4,12
2020,212106,42,3,84,27,57
2020,212106,42,4,25,8,17
2020,212106,42,6,2,2,0
2020,212115,0,0,217,114,103
2020,212115,10,0,217,114,103
2020,212115,10,1,87,57,30
2020,212115,10,2,66,33,33
2020,212115,10,3,41,18,23
2020,212115,10,4,23,6,17
2020,212115,20,0,135,80,55
2020,212115,20,1,85,56,29
2020,212115,20,2,42,20,22
2020,212115,20,3,7,4,3
2020,212115,20,4,1,0,1
2020,212115,30,0,66,30,36
2020,212115,30,1,2,1,1
2020,212115,30,2,24,13,11
2020,212115,30,3,33,14,19
2020,212115,30,4,7,2,5
2020,212115,40,0,16,4,12
2020,212115,40,3,1,0,1
2020,212115,40,4,15,4,11
2020,212115,41,0,3,0,3
2020,212115,41,3,1,0,1
2020,212115,41,4,2,0,2
2020,212115,42,0,13,4,9
2020,212115,42,4,13,4,9
2020,212115,44,0,3,0,3
2020,212115,44,3,1,0,1
2020,212115,44,4,2,0,2
2020,212133,0,0,96,44,52
2020,212133,10,0,96,44,52
2020,212133,10,1,29,17,12
2020,212133,10,2,21,12,9
2020,212133,10,3,17,5,12
2020,212133,10,5,22,6,16
2020,212133,10,6,7,4,3
2020,212133,20,0,35,19,16
2020,212133,20,1,24,14,10
2020,212133,20,2,11,5,6
2020,212133,30,0,31,15,16
2020,212133,30,1,5,3,2
2020,212133,30,2,10,7,3
2020,212133,30,3,16,5,11
2020,212133,40,0,30,10,20
2020,212133,40,3,1,0,1
2020,212133,40,5,22,6,16
2020,212133,40,6,7,4,3
2020,212133,42,0,30,10,20
2020,212133,42,3,1,0,1
2020,212133,42,5,22,6,16
2020,212133,42,6,7,4,3
2020,212160,0,0,227,120,107
2020,212160,10,0,227,120,107
2020,212160,10,1,87,54,33
2020,212160,10,2,61,36,25
2020,212160,10,3,59,27,32
2020,212160,10,4,20,3,17
2020,212160,20,0,168,104,64
2020,212160,20,1,87,54,33
2020,212160,20,2,55,32,23
2020,212160,20,3,25,18,7
2020,212160,20,4,1,0,1
2020,212160,30,0,42,13,29
2020,212160,30,2,6,4,2
2020,212160,30,3,32,9,23
2020,212160,30,4,4,0,4
2020,212160,40,0,17,3,14
2020,212160,40,3,2,0,2
2020,212160,40,4,15,3,12
2020,212160,41,0,1,0,1
2020,212160,41,4,1,0,1
2020,212160,42,0,16,3,13
2020,212160,42,3,2,0,2
2020,212160,42,4,14,3,11
2020,212160,44,0,1,0,1
2020,212160,44,4,1,0,1
2020,212197,0,0,106,49,57
2020,212197,10,0,106,49,57
2020,212197,10,1,36,19,17
2020,212197,10,2,41,21,20
2020,212197,10,3,15,6,9
2020,212197,10,4,2,0,2
2020,212197,10,5,12,3,9
2020,212197,20,0,75,39,36
2020,212197,20,1,36,19,17
2020,212197,20,2,39,20,19
2020,212197,30,0,17,7,10
2020,212197,30,2,2,1,1
2020,212197,30,3,15,6,9
2020,212197,40,0,14,3,11
2020,212197,40,4,2,0,2
2020,212197,40,5,12,3,9
2020,212197,42,0,14,3,11
2020,212197,42,4,2,0,2
2020,212197,42,5,12,3,9
2020,212434,0,0,29,19,10
2020,212434,50,0,29,19,10
2020,212577,0,0,251,131,120
2020,212577,10,0,232,126,106
2020,212577,10,1,82,52,30
2020,212577,10,2,71,33,38
2020,212577,10,3,75,39,36
2020,212577,10,4,4,2,2
2020,212577,20,0,153,85,68
2020,212577,20,1,82,52,30
2020,212577,20,2,71,33,38
2020,212577,30,0,45,19,26
2020,212577,30,3,45,19,26
2020,212577,40,0,34,22,12
2020,212577,40,3,30,20,10
2020,212577,40,4,4,2,2
2020,212577,41,0,13,8,5
2020,212577,41,3,12,8,4
2020,212577,41,4,1,0,1
2020,212577,42,0,19,12,7
2020,212577,42,3,17,11,6
2020,212577,42,4,2,1,1
2020,212577,43,0,2,2,0
2020,212577,43,3,1,1,0
2020,212577,43,4,1,1,0
2020,212577,44,0,13,8,5
2020,212577,44,3,12,8,4
2020,212577,44,4,1,0,1
2020,212577,50,0,19,5,14
2020,212601,0,0,240,118,122
2020,212601,10,0,240,118,122
2020,212601,10,1,34,22,12
2020,212601,10,2,76,42,34
2020,212601,10,3,117,49,68
2020,212601,10,4,13,5,8
2020,212601,20,0,90,54,36
2020,212601,20,1,32,20,12
2020,212601,20,2,43,27,16
2020,212601,20,3,15,7,8
2020,212601,30,0,78,37,41
2020,212601,30,1,2,2,0
2020,212601,30,2,21,14,7
2020,212601,30,3,55,21,34
2020,212601,40,0,72,27,45
2020,212601,40,2,12,1,11
2020,212601,40,3,47,21,26
2020,212601,40,4,13,5,8
2020,212601,42,0,72,27,45
2020,212601,42,2,12,1,11
2020,212601,42,3,47,21,26
2020,212601,42,4,13,5,8
2020,212656,0,0,60,41,19
2020,212656,10,0,60,41,19
2020,212656,10,1,25,18,7
2020,212656,10,2,27,18,9
2020,212656,10,3,7,4,3
2020,212656,10,4,1,1,0
2020,212656,20,0,35,27,8
2020,212656,20,1,23,17,6
2020,212656,20,2,12,10,2
2020,212656,30,0,10,5,5
2020,212656,30,1,2,1,1
2020,212656,30,2,5,2,3
2020,212656,30,3,3,2,1
2020,212656,40,0,15,9,6
2020,212656,40,2,10,6,4
2020,212656,40,3,4,2,2
2020,212656,40,4,1,1,0
2020,212656,42,0,15,9,6
2020,212656,42,2,10,6,4
2020,212656,42,3,4,2,2
2020,212656,42,4,1,1,0
2020,212674,0,0,224,122,102
2020,212674,10,0,224,122,102
2020,212674,10,1,61,35,26
2020,212674,10,2,85,50,35
2020,212674,10,3,63,31,32
2020,212674,10,4,1,0,1
2020,212674,10,5,14,6,8
2020,212674,20,0,146,85,61
2020,212674,20,1,61,35,26
2020,212674,20,2,85,50,35
2020,212674,30,0,49,23,26
2020,212674,30,3,49,23,26
2020,212674,40,0,29,14,15
2020,212674,40,3,14,8,6
2020,212674,40,4,1,0,1
2020,212674,40,5,14,6,8
2020,212674,41,0,14,6,8
2020,212674,41,4,1,0,1
2020,212674,41,5,13,6,7
2020,212674,42,0,15,8,7
2020,212674,42,3,14,8,6
2020,212674,42,5,1,0,1
2020,212674,44,0,5,1,4
2020,212674,44,4,1,0,1
2020,212674,44,5,4,1,3
2020,212674,45,0,9,5,4
2020,212674,45,5,9,5,4
2020,212771,0,0,4,2,2
2020,212771,10,0,4,2,2
2020,212771,10,1,4,2,2
2020,212771,40,0,4,2,2
2020,212771,40,1,4,2,2
2020,212771,41,0,4,2,2
2020,212771,41,1,4,2,2
2020,212771,44,0,4,2,2
2020,212771,44,1,4,2,2
2020,212832,0,0,91,20,71
2020,212832,10,0,91,20,71
2020,212832,10,1,8,5,3
2020,212832,10,2,17,9,8
2020,212832,10,3,47,4,43
2020,212832,10,4,19,2,17
2020,212832,20,0,24,10,14
2020,212832,20,1,7,4,3
2020,212832,20,2,10,5,5
2020,212832,20,3,7,1,6
2020,212832,30,0,6,1,5
2020,212832,30,2,1,1,0
2020,212832,30,3,5,0,5
2020,212832,40,0,61,9,52
2020,212832,40,1,1,1,0
2020,212832,40,2,6,3,3
2020,212832,40,3,35,3,32
2020,212832,40,4,19,2,17
2020,212832,41,0,34,6,28
2020,212832,41,1,1,1,0
2020,212832,41,2,4,3,1
2020,212832,41,3,20,2,18
2020,212832,41,4,9,0,9
2020,212832,42,0,27,3,24
2020,212832,42,2,2,0,2
2020,212832,42,3,15,1,14
2020,212832,42,4,10,2,8
2020,212832,44,0,34,6,28
2020,212832,44,1,1,1,0
2020,212832,44,2,4,3,1
2020,212832,44,3,20,2,18
2020,212832,44,4,9,0,9
2020,212869,0,0,64,12,52
2020,212869,10,0,64,12,52
2020,212869,10,1,6,3,3
2020,212869,10,2,17,1,16
2020,212869,10,3,18,4,14
2020,212869,10,4,23,4,19
2020,212869,20,0,3,1,2
2020,212869,20,1,3,1,2
2020,212869,40,0,61,11,50
2020,212869,40,1,3,2,1
2020,212869,40,2,17,1,16
2020,212869,40,3,18,4,14
2020,212869,40,4,23,4,19
2020,212869,42,0,61,11,50
2020,212869,42,1,3,2,1
2020,212869,42,2,17,1,16
2020,212869,42,3,18,4,14
2020,212869,42,4,23,4,19
2020,212878,0,0,265,91,174
2020,212878,10,0,265,91,174
2020,212878,10,1,98,42,56
2020,212878,10,2,87,27,60
2020,212878,10,3,56,13,43
2020,212878,10,4,24,9,15
2020,212878,20,0,194,75,119
2020,212878,20,1,98,42,56
2020,212878,20,2,74,25,49
2020,212878,20,3,22,8,14
2020,212878,30,0,70,15,55
2020,212878,30,2,13,2,11
2020,212878,30,3,34,5,29
2020,212878,30,4,23,8,15
2020,212878,40,0,1,1,0
2020,212878,40,4,1,1,0
2020,212878,42,0,1,1,0
2020,212878,42,4,1,1,0
2020,212911,0,0,165,73,92
2020,212911,10,0,165,73,92
2020,212911,10,1,45,26,19
2020,212911,10,2,40,15,25
2020,212911,10,3,71,27,44
2020,212911,10,4,5,3,2
2020,212911,10,5,4,2,2
2020,212911,20,0,79,39,40
2020,212911,20,1,42,25,17
2020,212911,20,2,37,14,23
2020,212911,30,0,31,14,17
2020,212911,30,3,31,14,17
2020,212911,40,0,55,20,35
2020,212911,40,1,3,1,2
2020,212911,40,2,3,1,2
2020,212911,40,3,40,13,27
2020,212911,40,4,5,3,2
2020,212911,40,5,4,2,2
2020,212911,41,0,55,20,35
2020,212911,41,1,3,1,2
2020,212911,41,2,3,1,2
2020,212911,41,3,40,13,27
2020,212911,41,4,5,3,2
2020,212911,41,5,4,2,2
2020,212911,44,0,55,20,35
2020,212911,44,1,3,1,2
2020,212911,44,2,3,1,2
2020,212911,44,3,40,13,27
2020,212911,44,4,5,3,2
2020,212911,44,5,4,2,2
2020,212975,0,0,26,16,10
2020,212975,50,0,26,16,10
2020,212984,0,0,76,20,56
2020,212984,10,0,76,20,56
2020,212984,10,1,17,3,14
2020,212984,10,2,17,9,8
2020,212984,10,3,32,7,25
2020,212984,10,4,10,1,9
2020,212984,40,0,76,20,56
2020,212984,40,1,17,3,14
2020,212984,40,2,17,9,8
2020,212984,40,3,32,7,25
2020,212984,40,4,10,1,9
2020,212984,41,0,25,8,17
2020,212984,41,1,16,3,13
2020,212984,41,2,8,4,4
2020,212984,41,3,1,1,0
2020,212984,42,0,49,12,37
2020,212984,42,1,1,0,1
2020,212984,42,2,9,5,4
2020,212984,42,3,30,6,24
2020,212984,42,4,9,1,8
2020,212984,43,0,2,0,2
2020,212984,43,3,1,0,1
2020,212984,43,4,1,0,1
2020,212984,44,0,25,8,17
2020,212984,44,1,16,3,13
2020,212984,44,2,8,4,4
2020,212984,44,3,1,1,0
2020,213011,0,0,73,24,49
2020,213011,10,0,73,24,49
2020,213011,10,1,26,11,15
2020,213011,10,2,11,3,8
2020,213011,10,3,20,4,16
2020,213011,10,4,11,3,8
2020,213011,10,6,5,3,2
2020,213011,20,0,28,11,17
2020,213011,20,1,25,11,14
2020,213011,20,2,2,0,2
2020,213011,20,3,1,0,1
2020,213011,30,0,40,10,30
2020,213011,30,1,1,0,1
2020,213011,30,2,9,3,6
2020,213011,30,3,19,4,15
2020,213011,30,4,11,3,8
2020,213011,40,0,5,3,2
2020,213011,40,6,5,3,2
2020,213011,42,0,5,3,2
2020,213011,42,6,5,3,2
2020,213020,0,0,462,241,221
2020,213020,10,0,462,241,221
2020,213020,10,1,198,122,76
2020,213020,10,2,160,81,79
2020,213020,10,3,68,27,41
2020,213020,10,4,36,11,25
2020,213020,20,0,373,210,163
2020,213020,20,1,198,122,76
2020,213020,20,2,152,77,75
2020,213020,20,3,22,11,11
2020,213020,20,4,1,0,1
2020,213020,30,0,50,18,32
2020,213020,30,2,8,4,4
2020,213020,30,3,39,13,26
2020,213020,30,4,3,1,2
2020,213020,40,0,39,13,26
2020,213020,40,3,7,3,4
2020,213020,40,4,32,10,22
2020,213020,42,0,39,13,26
2020,213020,42,3,7,3,4
2020,213020,42,4,32,10,22
2020,213181,0,0,29,0,29
2020,213181,50,0,29,0,29
2020,213233,0,0,29,19,10
2020,213233,10,0,29,19,10
2020,213233,10,4,29,19,10
2020,213233,40,0,29,19,10
2020,213233,40,4,29,19,10
2020,213233,41,0,29,19,10
2020,213233,41,4,29,19,10
2020,213233,44,0,29,19,10
2020,213233,44,4,29,19,10
2020,213251,0,0,101,58,43
2020,213251,10,0,101,58,43
2020,213251,10,1,55,37,18
2020,213251,10,2,23,12,11
2020,213251,10,3,18,5,13
2020,213251,10,4,5,4,1
2020,213251,20,0,77,49,28
2020,213251,20,1,54,37,17
2020,213251,20,2,23,12,11
2020,213251,30,0,10,4,6
2020,213251,30,3,10,4,6
2020,213251,40,0,14,5,9
2020,213251,40,1,1,0,1
2020,213251,40,3,8,1,7
2020,213251,40,4,5,4,1
2020,213251,41,0,13,5,8
2020,213251,41,3,8,1,7
2020,213251,41,4,5,4,1
2020,213251,43,0,1,0,1
2020,213251,43,1,1,0,1
2020,213251,44,0,13,5,8
2020,213251,44,3,8,1,7
2020,213251,44,4,5,4,1
2020,213303,0,0,45,16,29
2020,213303,10,0,45,16,29
2020,213303,10,1,15,5,10
2020,213303,10,2,10,3,7
2020,213303,10,3,14,7,7
2020,213303,10,4,6,1,5
2020,213303,20,0,27,8,19
2020,213303,20,1,15,5,10
2020,213303,20,2,10,3,7
2020,213303,20,3,2,0,2
2020,213303,30,0,10,5,5
2020,213303,30,3,10,5,5
2020,213303,40,0,8,3,5
2020,213303,40,3,2,2,0
2020,213303,40,4,6,1,5
2020,213303,42,0,8,3,5
2020,213303,42,3,2,2,0
2020,213303,42,4,6,1,5
2020,213321,0,0,150,75,75
2020,213321,10,0,150,75,75
2020,213321,10,1,53,31,22
2020,213321,10,2,56,27,29
2020,213321,10,3,34,15,19
2020,213321,10,4,6,1,5
2020,213321,10,6,1,1,0
2020,213321,20,0,76,41,35
2020,213321,20,1,38,24,14
2020,213321,20,2,38,17,21
2020,213321,30,0,22,11,11
2020,213321,30,1,1,0,1
2020,213321,30,2,3,3,0
2020,213321,30,3,18,8,10
2020,213321,40,0,52,23,29
2020,213321,40,1,14,7,7
2020,213321,40,2,15,7,8
2020,213321,40,3,16,7,9
2020,213321,40,4,6,1,5
2020,213321,40,6,1,1,0
2020,213321,41,0,2,2,0
2020,213321,41,2,1,1,0
2020,213321,41,3,1,1,0
2020,213321,42,0,12,2,10
2020,213321,42,1,4,1,3
2020,213321,42,2,3,0,3
2020,213321,42,3,5,1,4
2020,213321,43,0,38,19,19
2020,213321,43,1,10,6,4
2020,213321,43,2,11,6,5
2020,213321,43,3,10,5,5
2020,213321,43,4,6,1,5
2020,213321,43,6,1,1,0
2020,213321,45,0,2,2,0
2020,213321,45,2,1,1,0
2020,213321,45,3,1,1,0
2020,213349,0,0,346,174,172
2020,213349,10,0,346,174,172
2020,213349,10,1,119,66,53
2020,213349,10,2,113,67,46
2020,213349,10,3,92,31,61
2020,213349,10,4,22,10,12
2020,213349,20,0,252,134,118
2020,213349,20,1,117,65,52
2020,213349,20,2,109,64,45
2020,213349,20,3,26,5,21
2020,213349,30,0,50,24,26
2020,213349,30,1,2,1,1
2020,213349,30,2,4,3,1
2020,213349,30,3,44,20,24
2020,213349,40,0,44,16,28
2020,213349,40,3,22,6,16
2020,213349,40,4,22,10,12
2020,213349,41,0,1,0,1
2020,213349,41,3,1,0,1
2020,213349,42,0,43,16,27
2020,213349,42,3,21,6,15
2020,213349,42,4,22,10,12
2020,213349,44,0,1,0,1
2020,213349,44,3,1,0,1
2020,213358,0,0,65,24,41
2020,213358,10,0,65,24,41
2020,213358,10,1,28,11,17
2020,213358,10,2,12,5,7
2020,213358,10,3,22,6,16
2020,213358,10,4,3,2,1
2020,213358,40,0,65,24,41
2020,213358,40,1,28,11,17
2020,213358,40,2,12,5,7
2020,213358,40,3,22,6,16
2020,213358,40,4,3,2,1
2020,213358,41,0,62,22,40
2020,213358,41,1,28,11,17
2020,213358,41,2,12,5,7
2020,213358,41,3,22,6,16
2020,213358,42,0,3,2,1
2020,213358,42,4,3,2,1
2020,213358,44,0,62,22,40
2020,213358,44,1,28,11,17
2020,213358,44,2,12,5,7
2020,213358,44,3,22,6,16
2020,213367,0,0,196,81,115
2020,213367,10,0,196,81,115
2020,213367,10,1,36,21,15
2020,213367,10,2,81,35,46
2020,213367,10,3,70,24,46
2020,213367,10,4,9,1,8
2020,213367,20,0,117,57,60
2020,213367,20,1,36,21,15
2020,213367,20,2,77,34,43
2020,213367,20,3,4,2,2
2020,213367,30,0,38,14,24
2020,213367,30,2,3,1,2
2020,213367,30,3,35,13,22
2020,213367,40,0,41,10,31
2020,213367,40,2,1,0,1
2020,213367,40,3,31,9,22
2020,213367,40,4,9,1,8
2020,213367,42,0,41,10,31
2020,213367,42,2,1,0,1
2020,213367,42,3,31,9,22
2020,213367,42,4,9,1,8
2020,213376,0,0,31,11,20
2020,213376,10,0,30,10,20
2020,213376,10,1,3,2,1
2020,213376,10,2,3,0,3
2020,213376,10,3,8,3,5
2020,213376,10,4,16,5,11
2020,213376,20,0,12,5,7
2020,213376,20,1,3,2,1
2020,213376,20,2,3,0,3
2020,213376,20,3,6,3,3
2020,213376,30,0,18,5,13
2020,213376,30,3,2,0,2
2020,213376,30,4,16,5,11
2020,213376,50,0,1,1,0
2020,213385,0,0,251,144,107
2020,213385,10,0,251,144,107
2020,213385,10,1,76,46,30
2020,213385,10,2,78,56,22
2020,213385,10,3,88,38,50
2020,213385,10,4,9,4,5
2020,213385,20,0,151,101,50
2020,213385,20,1,74,46,28
2020,213385,20,2,77,55,22
2020,213385,30,0,69,28,41
2020,213385,30,2,1,1,0
2020,213385,30,3,68,27,41
2020,213385,40,0,31,15,16
2020,213385,40,1,2,0,2
2020,213385,40,3,20,11,9
2020,213385,40,4,9,4,5
2020,213385,41,0,12,6,6
2020,213385,41,1,1,0,1
2020,213385,41,3,4,2,2
2020,213385,41,4,7,4,3
2020,213385,42,0,15,9,6
2020,213385,42,1,1,0,1
2020,213385,42,3,14,9,5
2020,213385,43,0,4,0,4
2020,213385,43,3,2,0,2
2020,213385,43,4,2,0,2
2020,213385,44,0,12,6,6
2020,213385,44,1,1,0,1
2020,213385,44,3,4,2,2
2020,213385,44,4,7,4,3
2020,213400,0,0,74,54,20
2020,213400,10,0,74,54,20
2020,213400,10,1,25,23,2
2020,213400,10,2,5,4,1
2020,213400,10,3,44,27,17
2020,213400,40,0,74,54,20
2020,213400,40,1,25,23,2
2020,213400,40,2,5,4,1
2020,213400,40,3,44,27,17
2020,213400,42,0,49,37,12
2020,213400,42,1,12,11,1
2020,213400,42,2,4,4,0
2020,213400,42,3,33,22,11
2020,213400,43,0,25,17,8
2020,213400,43,1,13,12,1
2020,213400,43,2,1,0,1
2020,213400,43,3,11,5,6
2020,213446,0,0,6,2,4
2020,213446,10,0,6,2,4
2020,213446,10,1,5,2,3
2020,213446,10,2,1,0,1
2020,213446,20,0,4,2,2
2020,213446,20,1,4,2,2
2020,213446,30,0,1,0,1
2020,213446,30,1,1,0,1
2020,213446,40,0,1,0,1
2020,213446,40,2,1,0,1
2020,213446,42,0,1,0,1
2020,213446,42,2,1,0,1
2020,213507,0,0,123,64,59
2020,213507,10,0,123,64,59
2020,213507,10,1,30,20,10
2020,213507,10,2,45,26,19
2020,213507,10,3,48,18,30
2020,213507,20,0,66,42,24
2020,213507,20,1,30,20,10
2020,213507,20,2,35,22,13
2020,213507,20,3,1,0,1
2020,213507,30,0,32,8,24
2020,213507,30,2,7,2,5
2020,213507,30,3,25,6,19
2020,213507,40,0,25,14,11
2020,213507,40,2,3,2,1
2020,213507,40,3,22,12,10
2020,213507,41,0,23,13,10
2020,213507,41,2,3,2,1
2020,213507,41,3,20,11,9
2020,213507,42,0,2,1,1
2020,213507,42,3,2,1,1
2020,213507,44,0,23,13,10
2020,213507,44,2,3,2,1
2020,213507,44,3,20,11,9
2020,213525,0,0,81,33,48
2020,213525,10,0,81,33,48
2020,213525,10,1,20,5,15
2020,213525,10,2,21,9,12
2020,213525,10,3,35,16,19
2020,213525,10,4,5,3,2
2020,213525,40,0,81,33,48
2020,213525,40,1,20,5,15
2020,213525,40,2,21,9,12
2020,213525,40,3,35,16,19
2020,213525,40,4,5,3,2
2020,213525,42,0,81,33,48
2020,213525,42,1,20,5,15
2020,213525,42,2,21,9,12
2020,213525,42,3,35,16,19
2020,213525,42,4,5,3,2
2020,213534,0,0,21,8,13
2020,213534,10,0,21,8,13
2020,213534,10,4,21,8,13
2020,213534,40,0,21,8,13
2020,213534,40,4,21,8,13
2020,213534,41,0,21,8,13
2020,213534,41,4,21,8,13
2020,213534,45,0,21,8,13
2020,213534,45,4,21,8,13
2020,213543,0,0,552,356,196
2020,213543,10,0,552,356,196
2020,213543,10,1,192,147,45
2020,213543,10,2,163,96,67
2020,213543,10,3,100,53,47
2020,213543,10,5,81,53,28
2020,213543,10,6,16,7,9
2020,213543,20,0,354,243,111
2020,213543,20,1,192,147,45
2020,213543,20,2,162,96,66
2020,213543,30,0,101,53,48
2020,213543,30,2,1,0,1
2020,213543,30,3,100,53,47
2020,213543,40,0,97,60,37
2020,213543,40,5,81,53,28
2020,213543,40,6,16,7,9
2020,213543,41,0,95,58,37
2020,213543,41,5,79,51,28
2020,213543,41,6,16,7,9
2020,213543,42,0,2,2,0
2020,213543,42,5,2,2,0
2020,213543,44,0,95,58,37
2020,213543,44,5,79,51,28
2020,213543,44,6,16,7,9
2020,213570,0,0,20,7,13
2020,213570,10,0,20,7,13
2020,213570,10,4,20,7,13
2020,213570,40,0,20,7,13
2020,213570,40,4,20,7,13
2020,213570,41,0,20,7,13
2020,213570,41,4,20,7,13
2020,213570,45,0,20,7,13
2020,213570,45,4,20,7,13
2020,213589,0,0,9,9,0
2020,213589,10,0,9,9,0
2020,213589,10,4,9,9,0
2020,213589,40,0,9,9,0
2020,213589,40,4,9,9,0
2020,213589,41,0,9,9,0
2020,213589,41,4,9,9,0
2020,213589,45,0,9,9,0
2020,213589,45,4,9,9,0
2020,213598,0,0,103,57,46
2020,213598,10,0,103,57,46
2020,213598,10,1,26,20,6
2020,213598,10,2,22,13,9
2020,213598,10,3,43,19,24
2020,213598,10,4,2,2,0
2020,213598,10,5,10,3,7
2020,213598,20,0,48,33,15
2020,213598,20,1,25,19,6
2020,213598,20,2,20,12,8
2020,213598,20,3,3,2,1
2020,213598,30,0,40,20,20
2020,213598,30,1,1,1,0
2020,213598,30,2,2,1,1
2020,213598,30,3,35,16,19
2020,213598,30,4,2,2,0
2020,213598,40,0,15,4,11
2020,213598,40,3,5,1,4
2020,213598,40,5,10,3,7
2020,213598,42,0,15,4,11
2020,213598,42,3,5,1,4
2020,213598,42,5,10,3,7
2020,213613,0,0,182,91,91
2020,213613,10,0,182,91,91
2020,213613,10,1,82,44,38
2020,213613,10,2,45,24,21
2020,213613,10,3,47,21,26
2020,213613,10,4,8,2,6
2020,213613,20,0,143,74,69
2020,213613,20,1,82,44,38
2020,213613,20,2,43,23,20
2020,213613,20,3,18,7,11
2020,213613,30,0,24,11,13
2020,213613,30,2,2,1,1
2020,213613,30,3,20,9,11
2020,213613,30,4,2,1,1
2020,213613,40,0,15,6,9
2020,213613,40,3,9,5,4
2020,213613,40,4,6,1,5
2020,213613,42,0,15,6,9
2020,213613,42,3,9,5,4
2020,213613,42,4,6,1,5
2020,213631,0,0,18,13,5
2020,213631,10,0,18,13,5
2020,213631,10,1,7,5,2
2020,213631,10,2,5,3,2
2020,213631,10,3,4,3,1
2020,213631,10,4,1,1,0
2020,213631,10,6,1,1,0
2020,213631,20,0,18,13,5
2020,213631,20,1,7,5,2
2020,213631,20,2,5,3,2
2020,213631,20,3,4,3,1
2020,213631,20,4,1,1,0
2020,213631,20,6,1,1,0
2020,213659,0,0,103,50,53
2020,213659,10,0,103,50,53
2020,213659,10,1,29,14,15
2020,213659,10,2,26,13,13
2020,213659,10,3,29,13,16
2020,213659,10,4,18,9,9
2020,213659,10,5,1,1,0
2020,213659,40,0,103,50,53
2020,213659,40,1,29,14,15
2020,213659,40,2,26,13,13
2020,213659,40,3,29,13,16
2020,213659,40,4,18,9,9
2020,213659,40,5,1,1,0
2020,213659,42,0,103,50,53
2020,213659,42,1,29,14,15
2020,213659,42,2,26,13,13
2020,213659,42,3,29,13,16
2020,213659,42,4,18,9,9
2020,213659,42,5,1,1,0
2020,213668,0,0,88,50,38
2020,213668,10,0,88,50,38
2020,213668,10,1,18,13,5
2020,213668,10,2,22,10,12
2020,213668,10,3,39,24,15
2020,213668,10,4,2,0,2
2020,213668,10,5,7,3,4
2020,213668,20,0,51,29,22
2020,213668,20,1,18,13,5
2020,213668,20,2,22,10,12
2020,213668,20,3,11,6,5
2020,213668,30,0,25,16,9
2020,213668,30,3,24,16,8
2020,213668,30,4,1,0,1
2020,213668,40,0,12,5,7
2020,213668,40,3,4,2,2
2020,213668,40,4,1,0,1
2020,213668,40,5,7,3,4
2020,213668,41,0,12,5,7
2020,213668,41,3,4,2,2
2020,213668,41,4,1,0,1
2020,213668,41,5,7,3,4
2020,213668,44,0,5,2,3
2020,213668,44,3,4,2,2
2020,213668,44,4,1,0,1
2020,213668,45,0,7,3,4
2020,213668,45,5,7,3,4
2020,213774,0,0,24,5,19
2020,213774,10,0,24,5,19
2020,213774,10,1,8,2,6
2020,213774,10,2,1,1,0
2020,213774,10,3,8,1,7
2020,213774,10,4,7,1,6
2020,213774,40,0,24,5,19
2020,213774,40,1,8,2,6
2020,213774,40,2,1,1,0
2020,213774,40,3,8,1,7
2020,213774,40,4,7,1,6
2020,213774,42,0,24,5,19
2020,213774,42,1,8,2,6
2020,213774,42,2,1,1,0
2020,213774,42,3,8,1,7
2020,213774,42,4,7,1,6
2020,213783,0,0,89,37,52
2020,213783,10,0,89,37,52
2020,213783,10,1,29,16,13
2020,213783,10,2,34,15,19
2020,213783,10,3,20,5,15
2020,213783,10,4,6,1,5
2020,213783,20,0,72,32,40
2020,213783,20,1,29,16,13
2020,213783,20,2,34,15,19
2020,213783,20,3,9,1,8
2020,213783,30,0,13,4,9
2020,213783,30,3,11,4,7
2020,213783,30,4,2,0,2
2020,213783,40,0,4,1,3
2020,213783,40,4,4,1,3
2020,213783,42,0,4,1,3
2020,213783,42,4,4,1,3
2020,213826,0,0,148,57,91
2020,213826,10,0,148,57,91
2020,213826,10,1,20,15,5
2020,213826,10,2,56,20,36
2020,213826,10,3,44,14,30
2020,213826,10,4,28,8,20
2020,213826,20,0,68,34,34
2020,213826,20,1,20,15,5
2020,213826,20,2,47,18,29
2020,213826,20,3,1,1,0
2020,213826,30,0,23,8,15
2020,213826,30,2,2,1,1
2020,213826,30,3,21,7,14
2020,213826,40,0,57,15,42
2020,213826,40,2,7,1,6
2020,213826,40,3,22,6,16
2020,213826,40,4,28,8,20
2020,213826,42,0,57,15,42
2020,213826,42,2,7,1,6
2020,213826,42,3,22,6,16
2020,213826,42,4,28,8,20
2020,213914,0,0,13,1,12
2020,213914,50,0,13,1,12
2020,213987,0,0,127,70,57
2020,213987,10,0,127,70,57
2020,213987,10,1,22,17,5
2020,213987,10,2,38,22,16
2020,213987,10,3,49,22,27
2020,213987,10,4,11,5,6
2020,213987,10,5,7,4,3
2020,213987,20,0,60,39,21
2020,213987,20,1,22,17,5
2020,213987,20,2,38,22,16
2020,213987,30,0,27,11,16
2020,213987,30,3,27,11,16
2020,213987,40,0,40,20,20
2020,213987,40,3,22,11,11
2020,213987,40,4,11,5,6
2020,213987,40,5,7,4,3
2020,213987,42,0,40,20,20
2020,213987,42,3,22,11,11
2020,213987,42,4,11,5,6
2020,213987,42,5,7,4,3
2020,213996,0,0,195,108,87
2020,213996,10,0,195,108,87
2020,213996,10,1,74,55,19
2020,213996,10,2,50,25,25
2020,213996,10,3,51,21,30
2020,213996,10,5,20,7,13
2020,213996,20,0,116,76,40
2020,213996,20,1,72,54,18
2020,213996,20,2,43,21,22
2020,213996,20,3,1,1,0
2020,213996,30,0,40,22,18
2020,213996,30,1,2,1,1
2020,213996,30,2,3,3,0
2020,213996,30,3,35,18,17
2020,213996,40,0,39,10,29
2020,213996,40,2,4,1,3
2020,213996,40,3,15,2,13
2020,213996,40,5,20,7,13
2020,213996,41,0,15,1,14
2020,213996,41,2,4,1,3
2020,213996,41,3,11,0,11
2020,213996,42,0,24,9,15
2020,213996,42,3,4,2,2
2020,213996,42,5,20,7,13
2020,213996,45,0,15,1,14
2020,213996,45,2,4,1,3
2020,213996,45,3,11,0,11
2020,214041,0,0,277,146,131
2020,214041,10,0,277,146,131
2020,214041,10,1,82,48,34
2020,214041,10,2,108,54,54
2020,214041,10,3,83,42,41
2020,214041,10,4,4,2,2
2020,214041,20,0,213,112,101
2020,214041,20,1,82,48,34
2020,214041,20,2,107,54,53
2020,214041,20,3,24,10,14
2020,214041,30,0,61,31,30
2020,214041,30,2,1,0,1
2020,214041,30,3,58,31,27
2020,214041,30,4,2,0,2
2020,214041,40,0,3,3,0
2020,214041,40,3,1,1,0
2020,214041,40,4,2,2,0
2020,214041,42,0,3,3,0
2020,214041,42,3,1,1,0
2020,214041,42,4,2,2,0
2020,214069,0,0,139,56,83
2020,214069,10,0,139,56,83
2020,214069,10,1,27,15,12
2020,214069,10,2,35,18,17
2020,214069,10,3,76,22,54
2020,214069,10,4,1,1,0
2020,214069,20,0,59,31,28
2020,214069,20,1,27,15,12
2020,214069,20,2,32,16,16
2020,214069,30,0,34,16,18
2020,214069,30,2,3,2,1
2020,214069,30,3,31,14,17
2020,214069,40,0,46,9,37
2020,214069,40,3,45,8,37
2020,214069,40,4,1,1,0
2020,214069,41,0,31,4,27
2020,214069,41,3,31,4,27
2020,214069,42,0,15,5,10
2020,214069,42,3,14,4,10
2020,214069,42,4,1,1,0
2020,214069,44,0,31,4,27
2020,214069,44,3,31,4,27
2020,214111,0,0,160,62,98
2020,214111,10,0,160,62,98
2020,214111,10,1,18,8,10
2020,214111,10,2,36,8,28
2020,214111,10,3,76,30,46
2020,214111,10,4,28,16,12
2020,214111,10,6,2,0,2
2020,214111,20,0,123,44,79
2020,214111,20,1,18,8,10
2020,214111,20,2,36,8,28
2020,214111,20,3,69,28,41
2020,214111,30,0,33,17,16
2020,214111,30,3,7,2,5
2020,214111,30,4,26,15,11
2020,214111,40,0,4,1,3
2020,214111,40,4,2,1,1
2020,214111,40,6,2,0,2
2020,214111,43,0,4,1,3
2020,214111,43,4,2,1,1
2020,214111,43,6,2,0,2
2020,214148,0,0,24,7,17
2020,214148,10,0,24,7,17
2020,214148,10,1,4,0,4
2020,214148,10,2,9,5,4
2020,214148,10,3,10,2,8
2020,214148,10,4,1,0,1
2020,214148,20,0,1,0,1
2020,214148,20,1,1,0,1
2020,214148,40,0,23,7,16
2020,214148,40,1,3,0,3
2020,214148,40,2,9,5,4
2020,214148,40,3,10,2,8
2020,214148,40,4,1,0,1
2020,214148,41,0,22,7,15
2020,214148,41,1,3,0,3
2020,214148,41,2,9,5,4
2020,214148,41,3,10,2,8
2020,214148,43,0,1,0,1
2020,214148,43,4,1,0,1
2020,214148,44,0,22,7,15
2020,214148,44,1,3,0,3
2020,214148,44,2,9,5,4
2020,214148,44,3,10,2,8
2020,214157,0,0,163,57,106
2020,214157,10,0,163,57,106
2020,214157,10,1,35,20,15
2020,214157,10,2,52,16,36
2020,214157,10,3,61,17,44
2020,214157,10,4,9,3,6
2020,214157,10,5,6,1,5
2020,214157,20,0,74,32,42
2020,214157,20,1,32,18,14
2020,214157,20,2,42,14,28
2020,214157,30,0,57,14,43
2020,214157,30,2,6,1,5
2020,214157,30,3,46,12,34
2020,214157,30,4,5,1,4
2020,214157,40,0,32,11,21
2020,214157,40,1,3,2,1
2020,214157,40,2,4,1,3
2020,214157,40,3,15,5,10
2020,214157,40,4,4,2,2
2020,214157,40,5,6,1,5
2020,214157,41,0,28,9,19
2020,214157,41,1,3,2,1
2020,214157,41,2,3,1,2
2020,214157,41,3,13,4,9
2020,214157,41,4,3,1,2
2020,214157,41,5,6,1,5
2020,214157,42,0,4,2,2
2020,214157,42,2,1,0,1
2020,214157,42,3,2,1,1
2020,214157,42,4,1,1,0
2020,214157,45,0,28,9,19
2020,214157,45,1,3,2,1
2020,214157,45,2,3,1,2
2020,214157,45,3,13,4,9
2020,214157,45,4,3,1,2
2020,214157,45,5,6,1,5
2020,214166,0,0,59,19,40
2020,214166,10,0,59,19,40
2020,214166,10,1,10,2,8
2020,214166,10,2,18,7,11
2020,214166,10,3,17,7,10
2020,214166,10,4,14,3,11
2020,214166,40,0,59,19,40
2020,214166,40,1,10,2,8
2020,214166,40,2,18,7,11
2020,214166,40,3,17,7,10
2020,214166,40,4,14,3,11
2020,214166,42,0,59,19,40
2020,214166,42,1,10,2,8
2020,214166,42,2,18,7,11
2020,214166,42,3,17,7,10
2020,214166,42,4,14,3,11
2020,214175,0,0,183,95,88
2020,214175,10,0,183,95,88
2020,214175,10,1,62,41,21
2020,214175,10,2,39,16,23
2020,214175,10,3,57,30,27
2020,214175,10,5,24,7,17
2020,214175,10,6,1,1,0
2020,214175,20,0,101,57,44
2020,214175,20,1,62,41,21
2020,214175,20,2,39,16,23
2020,214175,30,0,46,23,23
2020,214175,30,3,46,23,23
2020,214175,40,0,36,15,21
2020,214175,40,3,11,7,4
2020,214175,40,5,24,7,17
2020,214175,40,6,1,1,0
2020,214175,41,0,15,8,7
2020,214175,41,3,4,2,2
2020,214175,41,5,10,5,5
2020,214175,41,6,1,1,0
2020,214175,42,0,20,7,13
2020,214175,42,3,6,5,1
2020,214175,42,5,14,2,12
2020,214175,43,0,1,0,1
2020,214175,43,3,1,0,1
2020,214175,44,0,15,8,7
2020,214175,44,3,4,2,2
2020,214175,44,5,10,5,5
2020,214175,44,6,1,1,0
2020,214272,0,0,95,38,57
2020,214272,10,0,95,38,57
2020,214272,10,1,22,10,12
2020,214272,10,2,29,12,17
2020,214272,10,3,39,14,25
2020,214272,10,4,5,2,3
2020,214272,40,0,95,38,57
2020,214272,40,1,22,10,12
2020,214272,40,2,29,12,17
2020,214272,40,3,39,14,25
2020,214272,40,4,5,2,3
2020,214272,41,0,77,30,47
2020,214272,41,1,22,10,12
2020,214272,41,2,27,10,17
2020,214272,41,3,24,9,15
2020,214272,41,4,4,1,3
2020,214272,42,0,18,8,10
2020,214272,42,2,2,2,0
2020,214272,42,3,15,5,10
2020,214272,42,4,1,1,0
2020,214272,44,0,77,30,47
2020,214272,44,1,22,10,12
2020,214272,44,2,27,10,17
2020,214272,44,3,24,9,15
2020,214272,44,4,4,1,3
2020,214290,0,0,27,24,3
2020,214290,10,0,27,24,3
2020,214290,10,4,27,24,3
2020,214290,40,0,27,24,3
2020,214290,40,4,27,24,3
2020,214290,41,0,27,24,3
2020,214290,41,4,27,24,3
2020,214290,45,0,27,24,3
2020,214290,45,4,27,24,3
2020,214379,0,0,118,49,69
2020,214379,10,0,116,47,69
2020,214379,10,1,58,26,32
2020,214379,10,2,21,10,11
2020,214379,10,3,31,8,23
2020,214379,10,4,6,3,3
2020,214379,20,0,86,40,46
2020,214379,20,1,58,26,32
2020,214379,20,2,19,9,10
2020,214379,20,3,8,4,4
2020,214379,20,4,1,1,0
2020,214379,30,0,29,7,22
2020,214379,30,2,2,1,1
2020,214379,30,3,22,4,18
2020,214379,30,4,5,2,3
2020,214379,40,0,1,0,1
2020,214379,40,3,1,0,1
2020,214379,43,0,1,0,1
2020,214379,43,3,1,0,1
2020,214379,50,0,2,2,0
2020,214564,0,0,98,27,71
2020,214564,10,0,86,25,61
2020,214564,10,1,8,4,4
2020,214564,10,2,20,6,14
2020,214564,10,3,50,13,37
2020,214564,10,4,8,2,6
2020,214564,20,0,16,6,10
2020,214564,20,1,8,4,4
2020,214564,20,2,8,2,6
2020,214564,30,0,12,4,8
2020,214564,30,2,4,2,2
2020,214564,30,3,8,2,6
2020,214564,40,0,58,15,43
2020,214564,40,2,8,2,6
2020,214564,40,3,42,11,31
2020,214564,40,4,8,2,6
2020,214564,42,0,58,15,43
2020,214564,42,2,8,2,6
2020,214564,42,3,42,11,31
2020,214564,42,4,8,2,6
2020,214564,50,0,12,2,10
2020,214582,0,0,15,4,11
2020,214582,10,0,15,4,11
2020,214582,10,4,15,4,11
2020,214582,40,0,15,4,11
2020,214582,40,4,15,4,11
2020,214582,41,0,15,4,11
2020,214582,41,4,15,4,11
2020,214582,45,0,15,4,11
2020,214582,45,4,15,4,11
2020,214883,0,0,25,12,13
2020,214883,10,0,25,12,13
2020,214883,10,1,12,5,7
2020,214883,10,2,10,5,5
2020,214883,10,3,3,2,1
2020,214883,40,0,25,12,13
2020,214883,40,1,12,5,7
2020,214883,40,2,10,5,5
2020,214883,40,3,3,2,1
2020,214883,41,0,25,12,13
2020,214883,41,1,12,5,7
2020,214883,41,2,10,5,5
2020,214883,41,3,3,2,1
2020,214883,45,0,25,12,13
2020,214883,45,1,12,5,7
2020,214883,45,2,10,5,5
2020,214883,45,3,3,2,1
2020,214892,0,0,29,12,17
2020,214892,10,0,29,12,17
2020,214892,10,4,29,12,17
2020,214892,40,0,29,12,17
2020,214892,40,4,29,12,17
2020,214892,43,0,29,12,17
2020,214892,43,4,29,12,17
2020,214944,0,0,20,17,3
2020,214944,10,0,20,17,3
2020,214944,10,4,20,17,3
2020,214944,40,0,20,17,3
2020,214944,40,4,20,17,3
2020,214944,41,0,20,17,3
2020,214944,41,4,20,17,3
2020,214944,45,0,20,17,3
2020,214944,45,4,20,17,3
2020,214971,0,0,19,14,5
2020,214971,10,0,19,14,5
2020,214971,10,1,16,11,5
2020,214971,10,2,2,2,0
2020,214971,10,3,1,1,0
2020,214971,40,0,19,14,5
2020,214971,40,1,16,11,5
2020,214971,40,2,2,2,0
2020,214971,40,3,1,1,0
2020,214971,42,0,19,14,5
2020,214971,42,1,16,11,5
2020,214971,42,2,2,2,0
2020,214971,42,3,1,1,0
2020,215053,0,0,14,8,6
2020,215053,10,0,14,8,6
2020,215053,10,2,2,2,0
2020,215053,10,3,12,6,6
2020,215053,40,0,14,8,6
2020,215053,40,2,2,2,0
2020,215053,40,3,12,6,6
2020,215053,41,0,14,8,6
2020,215053,41,2,2,2,0
2020,215053,41,3,12,6,6
2020,215053,44,0,14,8,6
2020,215053,44,2,2,2,0
2020,215053,44,3,12,6,6
2020,215062,0,0,2248,1370,878
2020,215062,10,0,2225,1361,864
2020,215062,10,1,954,711,243
2020,215062,10,2,360,232,128
2020,215062,10,3,411,218,193
2020,215062,10,4,178,75,103
2020,215062,10,5,322,125,197
2020,215062,20,0,1300,935,365
2020,215062,20,1,954,711,243
2020,215062,20,2,346,224,122
2020,215062,30,0,425,226,199
2020,215062,30,2,14,8,6
2020,215062,30,3,411,218,193
2020,215062,40,0,500,200,300
2020,215062,40,4,178,75,103
2020,215062,40,5,322,125,197
2020,215062,41,0,174,66,108
2020,215062,41,5,174,66,108
2020,215062,42,0,326,134,192
2020,215062,42,4,178,75,103
2020,215062,42,5,148,59,89
2020,215062,44,0,174,66,108
2020,215062,44,5,174,66,108
2020,215062,50,0,23,9,14
2020,215105,0,0,93,56,37
2020,215105,10,0,93,56,37
2020,215105,10,1,17,12,5
2020,215105,10,2,35,22,13
2020,215105,10,3,39,21,18
2020,215105,10,6,2,1,1
2020,215105,20,0,9,5,4
2020,215105,20,1,5,2,3
2020,215105,20,2,4,3,1
2020,215105,40,0,84,51,33
2020,215105,40,1,12,10,2
2020,215105,40,2,31,19,12
2020,215105,40,3,39,21,18
2020,215105,40,6,2,1,1
2020,215105,41,0,69,41,28
2020,215105,41,1,11,9,2
2020,215105,41,2,30,19,11
2020,215105,41,3,28,13,15
2020,215105,42,0,15,10,5
2020,215105,42,1,1,1,0
2020,215105,42,2,1,0,1
2020,215105,42,3,11,8,3
2020,215105,42,6,2,1,1
2020,215105,44,0,69,41,28
2020,215105,44,1,11,9,2
2020,215105,44,2,30,19,11
2020,215105,44,3,28,13,15
2020,215114,0,0,44,29,15
2020,215114,10,0,44,29,15
2020,215114,10,1,19,11,8
2020,215114,10,2,12,12,0
2020,215114,10,3,11,6,5
2020,215114,10,4,2,0,2
2020,215114,40,0,44,29,15
2020,215114,40,1,19,11,8
2020,215114,40,2,12,12,0
2020,215114,40,3,11,6,5
2020,215114,40,4,2,0,2
2020,215114,41,0,20,14,6
2020,215114,41,1,13,7,6
2020,215114,41,2,6,6,0
2020,215114,41,3,1,1,0
2020,215114,42,0,24,15,9
2020,215114,42,1,6,4,2
2020,215114,42,2,6,6,0
2020,215114,42,3,10,5,5
2020,215114,42,4,2,0,2
2020,215114,44,0,20,14,6
2020,215114,44,1,13,7,6
2020,215114,44,2,6,6,0
2020,215114,44,3,1,1,0
2020,215123,0,0,211,110,101
2020,215123,10,0,211,110,101
2020,215123,10,1,67,45,22
2020,215123,10,2,68,38,30
2020,215123,10,3,67,23,44
2020,215123,10,4,9,4,5
2020,215123,20,0,25,13,12
2020,215123,20,1,24,12,12
2020,215123,20,2,1,1,0
2020,215123,30,0,103,65,38
2020,215123,30,1,40,30,10
2020,215123,30,2,63,35,28
2020,215123,40,0,83,32,51
2020,215123,40,1,3,3,0
2020,215123,40,2,4,2,2
2020,215123,40,3,67,23,44
2020,215123,40,4,9,4,5
2020,215123,42,0,83,32,51
2020,215123,42,1,3,3,0
2020,215123,42,2,4,2,2
2020,215123,42,3,67,23,44
2020,215123,42,4,9,4,5
2020,215132,0,0,156,68,88
2020,215132,10,0,156,68,88
2020,215132,10,1,29,21,8
2020,215132,10,2,43,12,31
2020,215132,10,3,70,28,42
2020,215132,10,4,10,5,5
2020,215132,10,5,4,2,2
2020,215132,20,0,46,26,20
2020,215132,20,1,27,20,7
2020,215132,20,2,19,6,13
2020,215132,30,0,21,13,8
2020,215132,30,2,3,2,1
2020,215132,30,3,18,11,7
2020,215132,40,0,89,29,60
2020,215132,40,1,2,1,1
2020,215132,40,2,21,4,17
2020,215132,40,3,52,17,35
2020,215132,40,4,10,5,5
2020,215132,40,5,4,2,2
2020,215132,41,0,25,9,16
2020,215132,41,1,1,0,1
2020,215132,41,2,14,3,11
2020,215132,41,3,7,5,2
2020,215132,41,5,3,1,2
2020,215132,42,0,64,20,44
2020,215132,42,1,1,1,0
2020,215132,42,2,7,1,6
2020,215132,42,3,45,12,33
2020,215132,42,4,10,5,5
2020,215132,42,5,1,1,0
2020,215132,44,0,25,9,16
2020,215132,44,1,1,0,1
2020,215132,44,2,14,3,11
2020,215132,44,3,7,5,2
2020,215132,44,5,3,1,2
2020,215239,0,0,310,140,170
2020,215239,10,0,310,140,170
2020,215239,10,1,10,6,4
2020,215239,10,2,55,22,33
2020,215239,10,3,228,107,121
2020,215239,10,4,7,2,5
2020,215239,10,5,10,3,7
2020,215239,20,0,241,118,123
2020,215239,20,1,10,6,4
2020,215239,20,2,55,22,33
2020,215239,20,3,176,90,86
2020,215239,30,0,59,19,40
2020,215239,30,3,52,17,35
2020,215239,30,4,7,2,5
2020,215239,40,0,10,3,7
2020,215239,40,5,10,3,7
2020,215239,43,0,10,3,7
2020,215239,43,5,10,3,7
2020,215266,0,0,69,43,26
2020,215266,10,0,69,43,26
2020,215266,10,1,8,6,2
2020,215266,10,2,25,16,9
2020,215266,10,3,30,19,11
2020,215266,10,4,6,2,4
2020,215266,20,0,31,22,9
2020,215266,20,1,8,6,2
2020,215266,20,2,23,16,7
2020,215266,30,0,5,4,1
2020,215266,30,3,5,4,1
2020,215266,40,0,33,17,16
2020,215266,40,2,2,0,2
2020,215266,40,3,25,15,10
2020,215266,40,4,6,2,4
2020,215266,41,0,23,11,12
2020,215266,41,2,2,0,2
2020,215266,41,3,16,9,7
2020,215266,41,4,5,2,3
2020,215266,43,0,10,6,4
2020,215266,43,3,9,6,3
2020,215266,43,4,1,0,1
2020,215266,44,0,23,11,12
2020,215266,44,2,2,0,2
2020,215266,44,3,16,9,7
2020,215266,44,4,5,2,3
2020,215275,0,0,80,38,42
2020,215275,10,0,80,38,42
2020,215275,10,1,7,5,2
2020,215275,10,2,31,14,17
2020,215275,10,3,17,8,9
2020,215275,10,4,25,11,14
2020,215275,20,0,31,17,14
2020,215275,20,1,6,4,2
2020,215275,20,2,25,13,12
2020,215275,30,0,5,4,1
2020,215275,30,3,5,4,1
2020,215275,40,0,44,17,27
2020,215275,40,1,1,1,0
2020,215275,40,2,6,1,5
2020,215275,40,3,12,4,8
2020,215275,40,4,25,11,14
2020,215275,41,0,29,8,21
2020,215275,41,1,1,1,0
2020,215275,41,2,6,1,5
2020,215275,41,3,11,3,8
2020,215275,41,4,11,3,8
2020,215275,43,0,15,9,6
2020,215275,43,3,1,1,0
2020,215275,43,4,14,8,6
2020,215275,44,0,29,8,21
2020,215275,44,1,1,1,0
2020,215275,44,2,6,1,5
2020,215275,44,3,11,3,8
2020,215275,44,4,11,3,8
2020,215284,0,0,133,72,61
2020,215284,10,0,133,72,61
2020,215284,10,1,17,13,4
2020,215284,10,2,53,31,22
2020,215284,10,3,41,21,20
2020,215284,10,4,22,7,15
2020,215284,20,0,68,43,25
2020,215284,20,1,17,13,4
2020,215284,20,2,51,30,21
2020,215284,30,0,11,4,7
2020,215284,30,3,11,4,7
2020,215284,40,0,54,25,29
2020,215284,40,2,2,1,1
2020,215284,40,3,30,17,13
2020,215284,40,4,22,7,15
2020,215284,41,0,51,25,26
2020,215284,41,2,2,1,1
2020,215284,41,3,29,17,12
2020,215284,41,4,20,7,13
2020,215284,43,0,3,0,3
2020,215284,43,3,1,0,1
2020,215284,43,4,2,0,2
2020,215284,44,0,51,25,26
2020,215284,44,2,2,1,1
2020,215284,44,3,29,17,12
2020,215284,44,4,20,7,13
2020,215293,0,0,4261,2383,1878
2020,215293,10,0,4261,2383,1878
2020,215293,10,1,1036,758,278
2020,215293,10,2,1040,592,448
2020,215293,10,3,1733,853,880
2020,215293,10,4,192,73,119
2020,215293,10,5,260,107,153
2020,215293,20,0,1183,817,366
2020,215293,20,1,744,554,190
2020,215293,20,2,438,263,175
2020,215293,20,3,1,0,1
2020,215293,30,0,367,218,149
2020,215293,30,1,2,2,0
2020,215293,30,2,19,11,8
2020,215293,30,3,346,205,141
2020,215293,40,0,2711,1348,1363
2020,215293,40,1,290,202,88
2020,215293,40,2,583,318,265
2020,215293,40,3,1386,648,738
2020,215293,40,4,192,73,119
2020,215293,40,5,260,107,153
2020,215293,41,0,913,394,519
2020,215293,41,1,70,44,26
2020,215293,41,2,122,53,69
2020,215293,41,3,451,202,249
2020,215293,41,4,61,17,44
2020,215293,41,5,209,78,131
2020,215293,42,0,1624,867,757
2020,215293,42,1,203,145,58
2020,215293,42,2,431,251,180
2020,215293,42,3,890,429,461
2020,215293,42,4,97,40,57
2020,215293,42,5,3,2,1
2020,215293,43,0,174,87,87
2020,215293,43,1,17,13,4
2020,215293,43,2,30,14,16
2020,215293,43,3,45,17,28
2020,215293,43,4,34,16,18
2020,215293,43,5,48,27,21
2020,215293,44,0,913,394,519
2020,215293,44,1,70,44,26
2020,215293,44,2,122,53,69
2020,215293,44,3,451,202,249
2020,215293,44,4,61,17,44
2020,215293,44,5,209,78,131
2020,215309,0,0,10,3,7
2020,215309,10,0,10,3,7
2020,215309,10,1,1,1,0
2020,215309,10,2,2,1,1
2020,215309,10,3,2,1,1
2020,215309,10,4,5,0,5
2020,215309,20,0,3,2,1
2020,215309,20,1,1,1,0
2020,215309,20,2,2,1,1
2020,215309,40,0,7,1,6
2020,215309,40,3,2,1,1
2020,215309,40,4,5,0,5
2020,215309,41,0,5,1,4
2020,215309,41,3,1,1,0
2020,215309,41,4,4,0,4
2020,215309,43,0,2,0,2
2020,215309,43,3,1,0,1
2020,215309,43,4,1,0,1
2020,215309,44,0,5,1,4
2020,215309,44,3,1,1,0
2020,215309,44,4,4,0,4
2020,215381,0,0,46,42,4
2020,215381,50,0,46,42,4
2020,215415,0,0,65,37,28
2020,215415,10,0,65,37,28
2020,215415,10,4,65,37,28
2020,215415,40,0,65,37,28
2020,215415,40,4,65,37,28
2020,215415,41,0,65,37,28
2020,215415,41,4,65,37,28
2020,215415,45,0,65,37,28
2020,215415,45,4,65,37,28
2020,215424,0,0,14,11,3
2020,215424,10,0,14,11,3
2020,215424,10,1,8,7,1
2020,215424,10,2,4,2,2
2020,215424,10,3,2,2,0
2020,215424,20,0,9,7,2
2020,215424,20,1,8,7,1
2020,215424,20,2,1,0,1
2020,215424,30,0,4,3,1
2020,215424,30,2,3,2,1
2020,215424,30,3,1,1,0
2020,215424,40,0,1,1,0
2020,215424,40,3,1,1,0
2020,215424,42,0,1,1,0
2020,215424,42,3,1,1,0
2020,215442,0,0,144,73,71
2020,215442,10,0,139,71,68
2020,215442,10,1,60,33,27
2020,215442,10,2,38,20,18
2020,215442,10,3,29,14,15
2020,215442,10,5,12,4,8
2020,215442,20,0,94,51,43
2020,215442,20,1,60,33,27
2020,215442,20,2,34,18,16
2020,215442,30,0,31,14,17
2020,215442,30,2,3,1,2
2020,215442,30,3,28,13,15
2020,215442,40,0,14,6,8
2020,215442,40,2,1,1,0
2020,215442,40,3,1,1,0
2020,215442,40,5,12,4,8
2020,215442,43,0,14,6,8
2020,215442,43,2,1,1,0
2020,215442,43,3,1,1,0
2020,215442,43,5,12,4,8
2020,215442,50,0,5,2,3
2020,215585,0,0,53,9,44
2020,215585,10,0,50,8,42
2020,215585,10,1,14,3,11
2020,215585,10,2,12,1,11
2020,215585,10,3,15,2,13
2020,215585,10,4,9,2,7
2020,215585,40,0,50,8,42
2020,215585,40,1,14,3,11
2020,215585,40,2,12,1,11
2020,215585,40,3,15,2,13
2020,215585,40,4,9,2,7
2020,215585,41,0,48,7,41
2020,215585,41,1,14,3,11
2020,215585,41,2,12,1,11
2020,215585,41,3,14,2,12
2020,215585,41,4,8,1,7
2020,215585,43,0,2,1,1
2020,215585,43,3,1,0,1
2020,215585,43,4,1,1,0
2020,215585,44,0,48,7,41
2020,215585,44,1,14,3,11
2020,215585,44,2,12,1,11
2020,215585,44,3,14,2,12
2020,215585,44,4,8,1,7
2020,215585,50,0,3,1,2
2020,215619,0,0,5,2,3
2020,215619,10,0,5,2,3
2020,215619,10,1,3,2,1
2020,215619,10,2,1,0,1
2020,215619,10,3,1,0,1
2020,215619,20,0,4,2,2
2020,215619,20,1,3,2,1
2020,215619,20,2,1,0,1
2020,215619,40,0,1,0,1
2020,215619,40,3,1,0,1
2020,215619,41,0,1,0,1
2020,215619,41,3,1,0,1
2020,215619,44,0,1,0,1
2020,215619,44,3,1,0,1
2020,215637,0,0,15,9,6
2020,215637,10,0,15,9,6
2020,215637,10,4,15,9,6
2020,215637,40,0,15,9,6
2020,215637,40,4,15,9,6
2020,215637,42,0,15,9,6
2020,215637,42,4,15,9,6
2020,215655,0,0,182,94,88
2020,215655,10,0,182,94,88
2020,215655,10,1,91,51,40
2020,215655,10,2,58,28,30
2020,215655,10,3,26,13,13
2020,215655,10,5,7,2,5
2020,215655,20,0,161,86,75
2020,215655,20,1,91,51,40
2020,215655,20,2,58,28,30
2020,215655,20,3,12,7,5
2020,215655,30,0,14,6,8
2020,215655,30,3,14,6,8
2020,215655,40,0,7,2,5
2020,215655,40,5,7,2,5
2020,215655,41,0,6,2,4
2020,215655,41,5,6,2,4
2020,215655,42,0,1,0,1
2020,215655,42,5,1,0,1
2020,215655,44,0,6,2,4
2020,215655,44,5,6,2,4
2020,215682,0,0,28,28,0
2020,215682,10,0,28,28,0
2020,215682,10,4,28,28,0
2020,215682,40,0,28,28,0
2020,215682,40,4,28,28,0
2020,215682,41,0,28,28,0
2020,215682,41,4,28,28,0
2020,215682,45,0,28,28,0
2020,215682,45,4,28,28,0
2020,215691,0,0,28,12,16
2020,215691,10,0,28,12,16
2020,215691,10,1,2,1,1
2020,215691,10,2,12,5,7
2020,215691,10,3,14,6,8
2020,215691,20,0,12,5,7
2020,215691,20,1,2,1,1
2020,215691,20,2,10,4,6
2020,215691,30,0,4,3,1
2020,215691,30,3,4,3,1
2020,215691,40,0,12,4,8
2020,215691,40,2,2,1,1
2020,215691,40,3,10,3,7
2020,215691,41,0,10,4,6
2020,215691,41,2,2,1,1
2020,215691,41,3,8,3,5
2020,215691,42,0,2,0,2
2020,215691,42,3,2,0,2
2020,215691,44,0,10,4,6
2020,215691,44,2,2,1,1
2020,215691,44,3,8,3,5
2020,215743,0,0,113,55,58
2020,215743,10,0,110,53,57
2020,215743,10,1,32,23,9
2020,215743,10,2,37,15,22
2020,215743,10,3,31,12,19
2020,215743,10,4,10,3,7
2020,215743,20,0,57,33,24
2020,215743,20,1,31,23,8
2020,215743,20,2,25,10,15
2020,215743,20,3,1,0,1
2020,215743,30,0,18,9,9
2020,215743,30,2,5,3,2
2020,215743,30,3,12,6,6
2020,215743,30,4,1,0,1
2020,215743,40,0,35,11,24
2020,215743,40,1,1,0,1
2020,215743,40,2,7,2,5
2020,215743,40,3,18,6,12
2020,215743,40,4,9,3,6
2020,215743,41,0,34,10,24
2020,215743,41,1,1,0,1
2020,215743,41,2,7,2,5
2020,215743,41,3,18,6,12
2020,215743,41,4,8,2,6
2020,215743,42,0,1,1,0
2020,215743,42,4,1,1,0
2020,215743,45,0,34,10,24
2020,215743,45,1,1,0,1
2020,215743,45,2,7,2,5
2020,215743,45,3,18,6,12
2020,215743,45,4,8,2,6
2020,215743,50,0,3,2,1
2020,215770,0,0,268,146,122
2020,215770,10,0,268,146,122
2020,215770,10,1,77,46,31
2020,215770,10,2,81,42,39
2020,215770,10,3,62,34,28
2020,215770,10,4,48,24,24
2020,215770,20,0,176,99,77
2020,215770,20,1,77,46,31
2020,215770,20,2,81,42,39
2020,215770,20,3,18,11,7
2020,215770,30,0,44,23,21
2020,215770,30,3,44,23,21
2020,215770,40,0,48,24,24
2020,215770,40,4,48,24,24
2020,215770,42,0,47,24,23
2020,215770,42,4,47,24,23
2020,215770,43,0,1,0,1
2020,215770,43,4,1,0,1
2020,215798,0,0,102,69,33
2020,215798,10,0,102,69,33
2020,215798,10,1,28,19,9
2020,215798,10,2,38,29,9
2020,215798,10,3,30,16,14
2020,215798,10,4,6,5,1
2020,215798,20,0,61,45,16
2020,215798,20,1,25,17,8
2020,215798,20,2,36,28,8
2020,215798,30,0,20,12,8
2020,215798,30,1,1,1,0
2020,215798,30,3,19,11,8
2020,215798,40,0,21,12,9
2020,215798,40,1,2,1,1
2020,215798,40,2,2,1,1
2020,215798,40,3,11,5,6
2020,215798,40,4,6,5,1
2020,215798,41,0,12,5,7
2020,215798,41,1,2,1,1
2020,215798,41,2,1,0,1
2020,215798,41,3,7,3,4
2020,215798,41,4,2,1,1
2020,215798,42,0,9,7,2
2020,215798,42,2,1,1,0
2020,215798,42,3,4,2,2
2020,215798,42,4,4,4,0
2020,215798,44,0,12,5,7
2020,215798,44,1,2,1,1
2020,215798,44,2,1,0,1
2020,215798,44,3,7,3,4
2020,215798,44,4,2,1,1
2020,215929,0,0,280,162,118
2020,215929,10,0,280,162,118
2020,215929,10,1,93,60,33
2020,215929,10,2,77,47,30
2020,215929,10,3,69,38,31
2020,215929,10,4,2,2,0
2020,215929,10,5,2,1,1
2020,215929,10,6,37,14,23
2020,215929,20,0,178,112,66
2020,215929,20,1,91,59,32
2020,215929,20,2,75,47,28
2020,215929,20,3,12,6,6
2020,215929,30,0,63,35,28
2020,215929,30,1,2,1,1
2020,215929,30,2,2,0,2
2020,215929,30,3,57,32,25
2020,215929,30,4,2,2,0
2020,215929,40,0,39,15,24
2020,215929,40,5,2,1,1
2020,215929,40,6,37,14,23
2020,215929,41,0,14,4,10
2020,215929,41,6,14,4,10
2020,215929,42,0,25,11,14
2020,215929,42,5,2,1,1
2020,215929,42,6,23,10,13
2020,215929,44,0,14,4,10
2020,215929,44,6,14,4,10
2020,215947,0,0,99,37,62
2020,215947,10,0,99,37,62
2020,215947,10,1,13,5,8
2020,215947,10,2,45,21,24
2020,215947,10,3,32,10,22
2020,215947,10,4,9,1,8
2020,215947,20,0,45,18,27
2020,215947,20,1,11,3,8
2020,215947,20,2,34,15,19
2020,215947,30,0,30,13,17
2020,215947,30,1,1,1,0
2020,215947,30,2,11,6,5
2020,215947,30,3,18,6,12
2020,215947,40,0,24,6,18
2020,215947,40,1,1,1,0
2020,215947,40,3,14,4,10
2020,215947,40,4,9,1,8
2020,215947,41,0,2,2,0
2020,215947,41,1,1,1,0
2020,215947,41,3,1,1,0
2020,215947,42,0,22,4,18
2020,215947,42,3,13,3,10
2020,215947,42,4,9,1,8
2020,215947,44,0,2,2,0
2020,215947,44,1,1,1,0
2020,215947,44,3,1,1,0
2020,215992,0,0,15,6,9
2020,215992,10,0,15,6,9
2020,215992,10,4,15,6,9
2020,215992,40,0,15,6,9
2020,215992,40,4,15,6,9
2020,215992,41,0,15,6,9
2020,215992,41,4,15,6,9
2020,215992,45,0,15,6,9
2020,215992,45,4,15,6,9
2020,216010,0,0,279,164,115
2020,216010,10,0,279,164,115
2020,216010,10,1,100,64,36
2020,216010,10,2,108,66,42
2020,216010,10,3,49,25,24
2020,216010,10,4,22,9,13
2020,216010,20,0,211,129,82
2020,216010,20,1,99,63,36
2020,216010,20,2,97,57,40
2020,216010,20,3,15,9,6
2020,216010,30,0,47,26,21
2020,216010,30,1,1,1,0
2020,216010,30,2,11,9,2
2020,216010,30,3,33,15,18
2020,216010,30,4,2,1,1
2020,216010,40,0,21,9,12
2020,216010,40,3,1,1,0
2020,216010,40,4,20,8,12
2020,216010,42,0,21,9,12
2020,216010,42,3,1,1,0
2020,216010,42,4,20,8,12
2020,216038,0,0,362,176,186
2020,216038,10,0,362,176,186
2020,216038,10,1,85,40,45
2020,216038,10,2,129,64,65
2020,216038,10,3,114,55,59
2020,216038,10,4,34,17,17
2020,216038,20,0,219,107,112
2020,216038,20,1,84,39,45
2020,216038,20,2,109,53,56
2020,216038,20,3,26,15,11
2020,216038,30,0,110,52,58
2020,216038,30,1,1,1,0
2020,216038,30,2,20,11,9
2020,216038,30,3,87,39,48
2020,216038,30,4,2,1,1
2020,216038,40,0,33,17,16
2020,216038,40,3,1,1,0
2020,216038,40,4,32,16,16
2020,216038,41,0,2,1,1
2020,216038,41,4,2,1,1
2020,216038,42,0,31,16,15
2020,216038,42,3,1,1,0
2020,216038,42,4,30,15,15
2020,216038,44,0,2,1,1
2020,216038,44,4,2,1,1
2020,216047,0,0,17,14,3
2020,216047,10,0,17,14,3
2020,216047,10,1,5,5,0
2020,216047,10,2,1,0,1
2020,216047,10,3,7,6,1
2020,216047,10,4,4,3,1
2020,216047,40,0,17,14,3
2020,216047,40,1,5,5,0
2020,216047,40,2,1,0,1
2020,216047,40,3,7,6,1
2020,216047,40,4,4,3,1
2020,216047,41,0,17,14,3
2020,216047,41,1,5,5,0
2020,216047,41,2,1,0,1
2020,216047,41,3,7,6,1
2020,216047,41,4,4,3,1
2020,216047,44,0,17,14,3
2020,216047,44,1,5,5,0
2020,216047,44,2,1,0,1
2020,216047,44,3,7,6,1
2020,216047,44,4,4,3,1
2020,216083,0,0,28,11,17
2020,216083,10,0,28,11,17
2020,216083,10,4,28,11,17
2020,216083,40,0,28,11,17
2020,216083,40,4,28,11,17
2020,216083,42,0,28,11,17
2020,216083,42,4,28,11,17
2020,216278,0,0,142,74,68
2020,216278,10,0,142,74,68
2020,216278,10,1,26,18,8
2020,216278,10,2,57,30,27
2020,216278,10,3,50,20,30
2020,216278,10,4,1,1,0
2020,216278,10,5,6,4,2
2020,216278,10,6,2,1,1
2020,216278,20,0,82,47,35
2020,216278,20,1,26,18,8
2020,216278,20,2,56,29,27
2020,216278,30,0,42,17,25
2020,216278,30,2,1,1,0
2020,216278,30,3,41,16,25
2020,216278,40,0,18,10,8
2020,216278,40,3,9,4,5
2020,216278,40,4,1,1,0
2020,216278,40,5,6,4,2
2020,216278,40,6,2,1,1
2020,216278,42,0,18,10,8
2020,216278,42,3,9,4,5
2020,216278,42,4,1,1,0
2020,216278,42,5,6,4,2
2020,216278,42,6,2,1,1
2020,216287,0,0,226,120,106
2020,216287,10,0,226,120,106
2020,216287,10,1,89,48,41
2020,216287,10,2,50,24,26
2020,216287,10,3,85,46,39
2020,216287,10,4,2,2,0
2020,216287,20,0,133,71,62
2020,216287,20,1,86,48,38
2020,216287,20,2,47,23,24
2020,216287,30,0,45,22,23
2020,216287,30,2,1,0,1
2020,216287,30,3,44,22,22
2020,216287,40,0,48,27,21
2020,216287,40,1,3,0,3
2020,216287,40,2,2,1,1
2020,216287,40,3,41,24,17
2020,216287,40,4,2,2,0
2020,216287,41,0,42,23,19
2020,216287,41,1,3,0,3
2020,216287,41,2,2,1,1
2020,216287,41,3,37,22,15
2020,216287,42,0,6,4,2
2020,216287,42,3,4,2,2
2020,216287,42,4,2,2,0
2020,216287,44,0,42,23,19
2020,216287,44,1,3,0,3
2020,216287,44,2,2,1,1
2020,216287,44,3,37,22,15
2020,216296,0,0,72,54,18
2020,216296,10,0,72,54,18
2020,216296,10,1,11,9,2
2020,216296,10,2,9,6,3
2020,216296,10,3,10,9,1
2020,216296,10,4,42,30,12
2020,216296,20,0,42,34,8
2020,216296,20,1,11,9,2
2020,216296,20,2,9,6,3
2020,216296,20,3,10,9,1
2020,216296,20,4,12,10,2
2020,216296,30,0,30,20,10
2020,216296,30,4,30,20,10
2020,216339,0,0,2271,1297,974
2020,216339,10,0,2271,1297,974
2020,216339,10,1,619,433,186
2020,216339,10,2,730,403,327
2020,216339,10,3,843,429,414
2020,216339,10,4,79,32,47
2020,216339,20,0,718,477,241
2020,216339,20,1,403,297,106
2020,216339,20,2,314,179,135
2020,216339,20,3,1,1,0
2020,216339,30,0,245,119,126
2020,216339,30,1,2,0,2
2020,216339,30,2,31,14,17
2020,216339,30,3,212,105,107
2020,216339,40,0,1308,701,607
2020,216339,40,1,214,136,78
2020,216339,40,2,385,210,175
2020,216339,40,3,630,323,307
2020,216339,40,4,79,32,47
2020,216339,41,0,1308,701,607
2020,216339,41,1,214,136,78
2020,216339,41,2,385,210,175
2020,216339,41,3,630,323,307
2020,216339,41,4,79,32,47
2020,216339,44,0,768,394,374
2020,216339,44,1,78,43,35
2020,216339,44,2,239,131,108
2020,216339,44,3,391,196,195
2020,216339,44,4,60,24,36
2020,216339,45,0,540,307,233
2020,216339,45,1,136,93,43
2020,216339,45,2,146,79,67
2020,216339,45,3,239,127,112
2020,216339,45,4,19,8,11
2020,216357,0,0,58,28,30
2020,216357,10,0,58,28,30
2020,216357,10,1,21,14,7
2020,216357,10,2,17,7,10
2020,216357,10,3,17,7,10
2020,216357,10,5,3,0,3
2020,216357,20,0,29,17,12
2020,216357,20,1,19,13,6
2020,216357,20,2,10,4,6
2020,216357,30,0,25,10,15
2020,216357,30,1,2,1,1
2020,216357,30,2,7,3,4
2020,216357,30,3,16,6,10
2020,216357,40,0,4,1,3
2020,216357,40,3,1,1,0
2020,216357,40,5,3,0,3
2020,216357,42,0,4,1,3
2020,216357,42,3,1,1,0
2020,216357,42,5,3,0,3
2020,216366,0,0,326,105,221
2020,216366,10,0,326,105,221
2020,216366,10,1,43,21,22
2020,216366,10,2,97,32,65
2020,216366,10,3,157,47,110
2020,216366,10,4,29,5,24
2020,216366,20,0,41,24,17
2020,216366,20,1,19,13,6
2020,216366,20,2,22,11,11
2020,216366,30,0,27,13,14
2020,216366,30,1,1,1,0
2020,216366,30,3,26,12,14
2020,216366,40,0,258,68,190
2020,216366,40,1,23,7,16
2020,216366,40,2,75,21,54
2020,216366,40,3,131,35,96
2020,216366,40,4,29,5,24
2020,216366,41,0,153,35,118
2020,216366,41,1,10,4,6
2020,216366,41,2,42,12,30
2020,216366,41,3,85,17,68
2020,216366,41,4,16,2,14
2020,216366,42,0,104,33,71
2020,216366,42,1,13,3,10
2020,216366,42,2,33,9,24
2020,216366,42,3,46,18,28
2020,216366,42,4,12,3,9
2020,216366,43,0,1,0,1
2020,216366,43,4,1,0,1
2020,216366,44,0,152,34,118
2020,216366,44,1,9,3,6
2020,216366,44,2,42,12,30
2020,216366,44,3,85,17,68
2020,216366,44,4,16,2,14
2020,216366,45,0,1,1,0
2020,216366,45,1,1,1,0
2020,216436,0,0,14,14,0
2020,216436,10,0,14,14,0
2020,216436,10,4,14,14,0
2020,216436,40,0,14,14,0
2020,216436,40,4,14,14,0
2020,216436,41,0,14,14,0
2020,216436,41,4,14,14,0
2020,216436,45,0,14,14,0
2020,216436,45,4,14,14,0
2020,216445,0,0,14,14,0
2020,216445,10,0,14,14,0
2020,216445,10,4,14,14,0
2020,216445,40,0,14,14,0
2020,216445,40,4,14,14,0
2020,216445,41,0,14,14,0
2020,216445,41,4,14,14,0
2020,216445,45,0,14,14,0
2020,216445,45,4,14,14,0
2020,216454,0,0,12,10,2
2020,216454,10,0,12,10,2
2020,216454,10,4,12,10,2
2020,216454,40,0,12,10,2
2020,216454,40,4,12,10,2
2020,216454,41,0,12,10,2
2020,216454,41,4,12,10,2
2020,216454,45,0,12,10,2
2020,216454,45,4,12,10,2
2020,216463,0,0,10,8,2
2020,216463,10,0,10,8,2
2020,216463,10,1,4,2,2
2020,216463,10,2,5,5,0
2020,216463,10,3,1,1,0
2020,216463,40,0,10,8,2
2020,216463,40,1,4,2,2
2020,216463,40,2,5,5,0
2020,216463,40,3,1,1,0
2020,216463,41,0,10,8,2
2020,216463,41,1,4,2,2
2020,216463,41,2,5,5,0
2020,216463,41,3,1,1,0
2020,216463,44,0,9,7,2
2020,216463,44,1,3,1,2
2020,216463,44,2,5,5,0
2020,216463,44,3,1,1,0
2020,216463,45,0,1,1,0
2020,216463,45,1,1,1,0
2020,216524,0,0,127,53,74
2020,216524,10,0,127,53,74
2020,216524,10,1,25,17,8
2020,216524,10,2,41,16,25
2020,216524,10,3,41,14,27
2020,216524,10,4,20,6,14
2020,216524,20,0,66,33,33
2020,216524,20,1,25,17,8
2020,216524,20,2,41,16,25
2020,216524,30,0,33,10,23
2020,216524,30,3,33,10,23
2020,216524,40,0,28,10,18
2020,216524,40,3,8,4,4
2020,216524,40,4,20,6,14
2020,216524,41,0,21,9,12
2020,216524,41,3,8,4,4
2020,216524,41,4,13,5,8
2020,216524,42,0,7,1,6
2020,216524,42,4,7,1,6
2020,216524,44,0,21,9,12
2020,216524,44,3,8,4,4
2020,216524,44,4,13,5,8
2020,216542,0,0,22,11,11
2020,216542,10,0,22,11,11
2020,216542,10,1,6,3,3
2020,216542,10,2,6,5,1
2020,216542,10,3,10,3,7
2020,216542,40,0,22,11,11
2020,216542,40,1,6,3,3
2020,216542,40,2,6,5,1
2020,216542,40,3,10,3,7
2020,216542,42,0,21,11,10
2020,216542,42,1,5,3,2
2020,216542,42,2,6,5,1
2020,216542,42,3,10,3,7
2020,216542,43,0,1,0,1
2020,216542,43,1,1,0,1
2020,216597,0,0,720,409,311
2020,216597,10,0,720,409,311
2020,216597,10,1,219,157,62
2020,216597,10,2,211,116,95
2020,216597,10,3,211,105,106
2020,216597,10,4,79,31,48
2020,216597,20,0,367,239,128
2020,216597,20,1,171,125,46
2020,216597,20,2,184,105,79
2020,216597,20,3,12,9,3
2020,216597,30,0,105,55,50
2020,216597,30,2,4,2,2
2020,216597,30,3,101,53,48
2020,216597,40,0,248,115,133
2020,216597,40,1,48,32,16
2020,216597,40,2,23,9,14
2020,216597,40,3,98,43,55
2020,216597,40,4,79,31,48
2020,216597,41,0,190,93,97
2020,216597,41,1,43,28,15
2020,216597,41,2,22,9,13
2020,216597,41,3,90,42,48
2020,216597,41,4,35,14,21
2020,216597,42,0,56,20,36
2020,216597,42,1,5,4,1
2020,216597,42,2,1,0,1
2020,216597,42,3,8,1,7
2020,216597,42,4,42,15,27
2020,216597,43,0,2,2,0
2020,216597,43,4,2,2,0
2020,216597,44,0,190,93,97
2020,216597,44,1,43,28,15
2020,216597,44,2,22,9,13
2020,216597,44,3,90,42,48
2020,216597,44,4,35,14,21
2020,216667,0,0,112,53,59
2020,216667,10,0,112,53,59
2020,216667,10,1,42,24,18
2020,216667,10,2,34,16,18
2020,216667,10,3,29,11,18
2020,216667,10,4,7,2,5
2020,216667,20,0,76,40,36
2020,216667,20,1,42,24,18
2020,216667,20,2,34,16,18
2020,216667,30,0,17,8,9
2020,216667,30,3,17,8,9
2020,216667,40,0,19,5,14
2020,216667,40,3,12,3,9
2020,216667,40,4,7,2,5
2020,216667,41,0,19,5,14
2020,216667,41,3,12,3,9
2020,216667,41,4,7,2,5
2020,216667,44,0,19,5,14
2020,216667,44,3,12,3,9
2020,216667,44,4,7,2,5
2020,216694,0,0,81,36,45
2020,216694,10,0,81,36,45
2020,216694,10,1,21,14,7
2020,216694,10,2,16,8,8
2020,216694,10,3,23,10,13
2020,216694,10,4,21,4,17
2020,216694,20,0,35,22,13
2020,216694,20,1,18,12,6
2020,216694,20,2,14,7,7
2020,216694,20,3,3,3,0
2020,216694,30,0,22,7,15
2020,216694,30,1,1,1,0
2020,216694,30,2,2,1,1
2020,216694,30,3,17,5,12
2020,216694,30,4,2,0,2
2020,216694,40,0,24,7,17
2020,216694,40,1,2,1,1
2020,216694,40,3,3,2,1
2020,216694,40,4,19,4,15
2020,216694,42,0,24,7,17
2020,216694,42,1,2,1,1
2020,216694,42,3,3,2,1
2020,216694,42,4,19,4,15
2020,216764,0,0,675,316,359
2020,216764,10,0,675,316,359
2020,216764,10,1,211,101,110
2020,216764,10,2,221,100,121
2020,216764,10,3,144,70,74
2020,216764,10,4,99,45,54
2020,216764,20,0,442,207,235
2020,216764,20,1,207,98,109
2020,216764,20,2,209,95,114
2020,216764,20,3,22,12,10
2020,216764,20,4,4,2,2
2020,216764,30,0,149,69,80
2020,216764,30,1,3,2,1
2020,216764,30,2,11,5,6
2020,216764,30,3,118,55,63
2020,216764,30,4,17,7,10
2020,216764,40,0,84,40,44
2020,216764,40,1,1,1,0
2020,216764,40,2,1,0,1
2020,216764,40,3,4,3,1
2020,216764,40,4,78,36,42
2020,216764,41,0,2,1,1
2020,216764,41,1,1,1,0
2020,216764,41,2,1,0,1
2020,216764,42,0,82,39,43
2020,216764,42,3,4,3,1
2020,216764,42,4,78,36,42
2020,216764,44,0,2,1,1
2020,216764,44,1,1,1,0
2020,216764,44,2,1,0,1
2020,216782,0,0,14,2,12
2020,216782,50,0,14,2,12
2020,216807,0,0,74,36,38
2020,216807,10,0,74,36,38
2020,216807,10,1,20,12,8
2020,216807,10,2,26,11,15
2020,216807,10,3,16,9,7
2020,216807,10,5,12,4,8
2020,216807,20,0,44,21,23
2020,216807,20,1,20,12,8
2020,216807,20,2,22,8,14
2020,216807,20,3,2,1,1
2020,216807,30,0,17,10,7
2020,216807,30,2,4,3,1
2020,216807,30,3,13,7,6
2020,216807,40,0,13,5,8
2020,216807,40,3,1,1,0
2020,216807,40,5,12,4,8
2020,216807,42,0,13,5,8
2020,216807,42,3,1,1,0
2020,216807,42,5,12,4,8
2020,216816,0,0,17,15,2
2020,216816,10,0,16,14,2
2020,216816,10,1,7,7,0
2020,216816,10,2,4,4,0
2020,216816,10,3,2,2,0
2020,216816,10,5,3,1,2
2020,216816,20,0,5,5,0
2020,216816,20,1,5,5,0
2020,216816,40,0,11,9,2
2020,216816,40,1,2,2,0
2020,216816,40,2,4,4,0
2020,216816,40,3,2,2,0
2020,216816,40,5,3,1,2
2020,216816,41,0,11,9,2
2020,216816,41,1,2,2,0
2020,216816,41,2,4,4,0
2020,216816,41,3,2,2,0
2020,216816,41,5,3,1,2
2020,216816,44,0,11,9,2
2020,216816,44,1,2,2,0
2020,216816,44,2,4,4,0
2020,216816,44,3,2,2,0
2020,216816,44,5,3,1,2
2020,216816,50,0,1,1,0
2020,216825,0,0,74,34,40
2020,216825,10,0,74,34,40
2020,216825,10,1,8,3,5
2020,216825,10,2,8,6,2
2020,216825,10,3,49,22,27
2020,216825,10,4,9,3,6
2020,216825,40,0,74,34,40
2020,216825,40,1,8,3,5
2020,216825,40,2,8,6,2
2020,216825,40,3,49,22,27
2020,216825,40,4,9,3,6
2020,216825,42,0,74,34,40
2020,216825,42,1,8,3,5
2020,216825,42,2,8,6,2
2020,216825,42,3,49,22,27
2020,216825,42,4,9,3,6
2020,216852,0,0,263,112,151
2020,216852,10,0,263,112,151
2020,216852,10,1,79,43,36
2020,216852,10,2,92,40,52
2020,216852,10,3,69,26,43
2020,216852,10,4,12,1,11
2020,216852,10,5,11,2,9
2020,216852,20,0,159,77,82
2020,216852,20,1,78,42,36
2020,216852,20,2,81,35,46
2020,216852,30,0,51,16,35
2020,216852,30,2,3,1,2
2020,216852,30,3,47,15,32
2020,216852,30,4,1,0,1
2020,216852,40,0,53,19,34
2020,216852,40,1,1,1,0
2020,216852,40,2,8,4,4
2020,216852,40,3,22,11,11
2020,216852,40,4,11,1,10
2020,216852,40,5,11,2,9
2020,216852,41,0,19,6,13
2020,216852,41,2,5,2,3
2020,216852,41,3,3,2,1
2020,216852,41,4,5,0,5
2020,216852,41,5,6,2,4
2020,216852,42,0,34,13,21
2020,216852,42,1,1,1,0
2020,216852,42,2,3,2,1
2020,216852,42,3,19,9,10
2020,216852,42,4,6,1,5
2020,216852,42,5,5,0,5
2020,216852,44,0,19,6,13
2020,216852,44,2,5,2,3
2020,216852,44,3,3,2,1
2020,216852,44,4,5,0,5
2020,216852,44,5,6,2,4
2020,216931,0,0,176,90,86
2020,216931,10,0,176,90,86
2020,216931,10,1,32,22,10
2020,216931,10,2,70,36,34
2020,216931,10,3,52,26,26
2020,216931,10,6,22,6,16
2020,216931,20,0,102,58,44
2020,216931,20,1,32,22,10
2020,216931,20,2,70,36,34
2020,216931,30,0,50,25,25
2020,216931,30,3,50,25,25
2020,216931,40,0,24,7,17
2020,216931,40,3,2,1,1
2020,216931,40,6,22,6,16
2020,216931,41,0,2,1,1
2020,216931,41,3,2,1,1
2020,216931,42,0,22,6,16
2020,216931,42,6,22,6,16
2020,216931,44,0,2,1,1
2020,216931,44,3,2,1,1
2020,216940,0,0,19,16,3
2020,216940,10,0,19,16,3
2020,216940,10,2,7,7,0
2020,216940,10,4,12,9,3
2020,216940,40,0,19,16,3
2020,216940,40,2,7,7,0
2020,216940,40,4,12,9,3
2020,216940,41,0,4,2,2
2020,216940,41,2,2,2,0
2020,216940,41,4,2,0,2
2020,216940,42,0,15,14,1
2020,216940,42,2,5,5,0
2020,216940,42,4,10,9,1
2020,216940,44,0,4,2,2
2020,216940,44,2,2,2,0
2020,216940,44,4,2,0,2
2020,217013,0,0,50,20,30
2020,217013,10,0,50,20,30
2020,217013,10,1,12,6,6
2020,217013,10,2,15,9,6
2020,217013,10,3,15,3,12
2020,217013,10,4,1,0,1
2020,217013,10,5,7,2,5
2020,217013,20,0,26,14,12
2020,217013,20,1,12,6,6
2020,217013,20,2,14,8,6
2020,217013,30,0,10,3,7
2020,217013,30,2,1,1,0
2020,217013,30,3,9,2,7
2020,217013,40,0,14,3,11
2020,217013,40,3,6,1,5
2020,217013,40,4,1,0,1
2020,217013,40,5,7,2,5
2020,217013,42,0,14,3,11
2020,217013,42,3,6,1,5
2020,217013,42,4,1,0,1
2020,217013,42,5,7,2,5
2020,217059,0,0,168,89,79
2020,217059,10,0,168,89,79
2020,217059,10,1,20,15,5
2020,217059,10,2,69,34,35
2020,217059,10,3,53,24,29
2020,217059,10,4,26,16,10
2020,217059,20,0,100,58,42
2020,217059,20,1,19,15,4
2020,217059,20,2,67,32,35
2020,217059,20,3,14,11,3
2020,217059,30,0,41,15,26
2020,217059,30,2,2,2,0
2020,217059,30,3,39,13,26
2020,217059,40,0,27,16,11
2020,217059,40,1,1,0,1
2020,217059,40,4,26,16,10
2020,217059,42,0,27,16,11
2020,217059,42,1,1,0,1
2020,217059,42,4,26,16,10
2020,217077,0,0,38,19,19
2020,217077,50,0,38,19,19
2020,217156,0,0,884,553,331
2020,217156,10,0,881,552,329
2020,217156,10,1,412,305,107
2020,217156,10,2,163,92,71
2020,217156,10,3,145,84,61
2020,217156,10,4,1,1,0
2020,217156,10,5,79,31,48
2020,217156,10,6,81,39,42
2020,217156,20,0,555,388,167
2020,217156,20,1,404,300,104
2020,217156,20,2,151,88,63
2020,217156,30,0,141,86,55
2020,217156,30,2,4,2,2
2020,217156,30,3,136,83,53
2020,217156,30,4,1,1,0
2020,217156,40,0,185,78,107
2020,217156,40,1,8,5,3
2020,217156,40,2,8,2,6
2020,217156,40,3,9,1,8
2020,217156,40,5,79,31,48
2020,217156,40,6,81,39,42
2020,217156,41,0,149,60,89
2020,217156,41,1,8,5,3
2020,217156,41,2,8,2,6
2020,217156,41,3,8,0,8
2020,217156,41,5,79,31,48
2020,217156,41,6,46,22,24
2020,217156,42,0,32,15,17
2020,217156,42,3,1,1,0
2020,217156,42,6,31,14,17
2020,217156,43,0,4,3,1
2020,217156,43,6,4,3,1
2020,217156,44,0,149,60,89
2020,217156,44,1,8,5,3
2020,217156,44,2,8,2,6
2020,217156,44,3,8,0,8
2020,217156,44,5,79,31,48
2020,217156,44,6,46,22,24
2020,217156,50,0,3,1,2
2020,217165,0,0,170,97,73
2020,217165,10,0,170,97,73
2020,217165,10,1,73,47,26
2020,217165,10,2,22,16,6
2020,217165,10,3,22,6,16
2020,217165,10,5,53,28,25
2020,217165,20,0,94,62,32
2020,217165,20,1,73,47,26
2020,217165,20,2,21,15,6
2020,217165,30,0,23,7,16
2020,217165,30,2,1,1,0
2020,217165,30,3,22,6,16
2020,217165,40,0,53,28,25
2020,217165,40,5,53,28,25
2020,217165,41,0,17,7,10
2020,217165,41,5,17,7,10
2020,217165,42,0,12,5,7
2020,217165,42,5,12,5,7
2020,217165,43,0,24,16,8
2020,217165,43,5,24,16,8
2020,217165,44,0,17,7,10
2020,217165,44,5,17,7,10
2020,217235,0,0,260,146,114
2020,217235,10,0,260,146,114
2020,217235,10,1,60,32,28
2020,217235,10,2,138,72,66
2020,217235,10,3,44,28,16
2020,217235,10,4,13,11,2
2020,217235,10,5,5,3,2
2020,217235,40,0,260,146,114
2020,217235,40,1,60,32,28
2020,217235,40,2,138,72,66
2020,217235,40,3,44,28,16
2020,217235,40,4,13,11,2
2020,217235,40,5,5,3,2
2020,217235,41,0,24,13,11
2020,217235,41,1,10,8,2
2020,217235,41,2,14,5,9
2020,217235,42,0,236,133,103
2020,217235,42,1,50,24,26
2020,217235,42,2,124,67,57
2020,217235,42,3,44,28,16
2020,217235,42,4,13,11,2
2020,217235,42,5,5,3,2
2020,217235,44,0,24,13,11
2020,217235,44,1,10,8,2
2020,217235,44,2,14,5,9
2020,217305,0,0,116,66,50
2020,217305,10,0,116,66,50
2020,217305,10,1,18,10,8
2020,217305,10,2,32,18,14
2020,217305,10,3,44,27,17
2020,217305,10,4,22,11,11
2020,217305,40,0,116,66,50
2020,217305,40,1,18,10,8
2020,217305,40,2,32,18,14
2020,217305,40,3,44,27,17
2020,217305,40,4,22,11,11
2020,217305,42,0,116,66,50
2020,217305,42,1,18,10,8
2020,217305,42,2,32,18,14
2020,217305,42,3,44,27,17
2020,217305,42,4,22,11,11
2020,217402,0,0,303,177,126
2020,217402,10,0,303,177,126
2020,217402,10,1,69,49,20
2020,217402,10,2,104,57,47
2020,217402,10,3,115,63,52
2020,217402,10,4,15,8,7
2020,217402,20,0,199,123,76
2020,217402,20,1,69,49,20
2020,217402,20,2,102,57,45
2020,217402,20,3,28,17,11
2020,217402,30,0,63,30,33
2020,217402,30,2,2,0,2
2020,217402,30,3,60,29,31
2020,217402,30,4,1,1,0
2020,217402,40,0,41,24,17
2020,217402,40,3,27,17,10
2020,217402,40,4,14,7,7
2020,217402,42,0,40,24,16
2020,217402,42,3,26,17,9
2020,217402,42,4,14,7,7
2020,217402,43,0,1,0,1
2020,217402,43,3,1,0,1
2020,217420,0,0,319,122,197
2020,217420,10,0,319,122,197
2020,217420,10,1,119,52,67
2020,217420,10,2,118,46,72
2020,217420,10,3,82,24,58
2020,217420,20,0,242,100,142
2020,217420,20,1,119,52,67
2020,217420,20,2,116,46,70
2020,217420,20,3,7,2,5
2020,217420,30,0,49,17,32
2020,217420,30,2,1,0,1
2020,217420,30,3,48,17,31
2020,217420,40,0,28,5,23
2020,217420,40,2,1,0,1
2020,217420,40,3,27,5,22
2020,217420,41,0,23,5,18
2020,217420,41,3,23,5,18
2020,217420,42,0,5,0,5
2020,217420,42,2,1,0,1
2020,217420,42,3,4,0,4
2020,217420,44,0,23,5,18
2020,217420,44,3,23,5,18
2020,217475,0,0,286,104,182
2020,217475,10,0,286,104,182
2020,217475,10,1,105,33,72
2020,217475,10,2,69,25,44
2020,217475,10,3,110,46,64
2020,217475,10,4,2,0,2
2020,217475,20,0,200,68,132
2020,217475,20,1,105,33,72
2020,217475,20,2,69,25,44
2020,217475,20,3,26,10,16
2020,217475,30,0,84,36,48
2020,217475,30,3,84,36,48
2020,217475,40,0,2,0,2
2020,217475,40,4,2,0,2
2020,217475,41,0,2,0,2
2020,217475,41,4,2,0,2
2020,217475,44,0,2,0,2
2020,217475,44,4,2,0,2
2020,217484,0,0,772,380,392
2020,217484,10,0,772,380,392
2020,217484,10,1,267,158,109
2020,217484,10,2,158,78,80
2020,217484,10,3,188,84,104
2020,217484,10,5,159,60,99
2020,217484,20,0,391,226,165
2020,217484,20,1,255,155,100
2020,217484,20,2,136,71,65
2020,217484,30,0,171,82,89
2020,217484,30,2,6,3,3
2020,217484,30,3,165,79,86
2020,217484,40,0,210,72,138
2020,217484,40,1,12,3,9
2020,217484,40,2,16,4,12
2020,217484,40,3,23,5,18
2020,217484,40,5,159,60,99
2020,217484,41,0,136,45,91
2020,217484,41,1,12,3,9
2020,217484,41,2,16,4,12
2020,217484,41,3,22,5,17
2020,217484,41,5,86,33,53
2020,217484,42,0,73,27,46
2020,217484,42,3,1,0,1
2020,217484,42,5,72,27,45
2020,217484,43,0,1,0,1
2020,217484,43,5,1,0,1
2020,217484,44,0,136,45,91
2020,217484,44,1,12,3,9
2020,217484,44,2,16,4,12
2020,217484,44,3,22,5,17
2020,217484,44,5,86,33,53
2020,217493,0,0,185,98,87
2020,217493,10,0,185,98,87
2020,217493,10,1,66,32,34
2020,217493,10,2,60,39,21
2020,217493,10,3,55,23,32
2020,217493,10,6,4,4,0
2020,217493,40,0,185,98,87
2020,217493,40,1,66,32,34
2020,217493,40,2,60,39,21
2020,217493,40,3,55,23,32
2020,217493,40,6,4,4,0
2020,217493,41,0,156,85,71
2020,217493,41,1,66,32,34
2020,217493,41,2,60,39,21
2020,217493,41,3,30,14,16
2020,217493,42,0,29,13,16
2020,217493,42,3,25,9,16
2020,217493,42,6,4,4,0
2020,217493,44,0,156,85,71
2020,217493,44,1,66,32,34
2020,217493,44,2,60,39,21
2020,217493,44,3,30,14,16
2020,217518,0,0,192,103,89
2020,217518,10,0,192,103,89
2020,217518,10,1,97,57,40
2020,217518,10,2,56,26,30
2020,217518,10,3,35,20,15
2020,217518,10,5,4,0,4
2020,217518,20,0,152,83,69
2020,217518,20,1,97,57,40
2020,217518,20,2,55,26,29
2020,217518,30,0,35,20,15
2020,217518,30,2,1,0,1
2020,217518,30,3,34,20,14
2020,217518,40,0,5,0,5
2020,217518,40,3,1,0,1
2020,217518,40,5,4,0,4
2020,217518,41,0,5,0,5
2020,217518,41,3,1,0,1
2020,217518,41,5,4,0,4
2020,217518,44,0,5,0,5
2020,217518,44,3,1,0,1
2020,217518,44,5,4,0,4
2020,217536,0,0,116,45,71
2020,217536,10,0,116,45,71
2020,217536,10,1,26,16,10
2020,217536,10,2,33,16,17
2020,217536,10,3,36,7,29
2020,217536,10,5,21,6,15
2020,217536,20,0,59,32,27
2020,217536,20,1,26,16,10
2020,217536,20,2,33,16,17
2020,217536,30,0,32,7,25
2020,217536,30,3,32,7,25
2020,217536,40,0,25,6,19
2020,217536,40,3,4,0,4
2020,217536,40,5,21,6,15
2020,217536,41,0,5,2,3
2020,217536,41,5,5,2,3
2020,217536,42,0,20,4,16
2020,217536,42,3,4,0,4
2020,217536,42,5,16,4,12
2020,217536,44,0,5,2,3
2020,217536,44,5,5,2,3
2020,217606,0,0,5,5,0
2020,217606,10,0,5,5,0
2020,217606,10,1,3,3,0
2020,217606,10,2,1,1,0
2020,217606,10,3,1,1,0
2020,217606,40,0,5,5,0
2020,217606,40,1,3,3,0
2020,217606,40,2,1,1,0
2020,217606,40,3,1,1,0
2020,217606,41,0,5,5,0
2020,217606,41,1,3,3,0
2020,217606,41,2,1,1,0
2020,217606,41,3,1,1,0
2020,217606,45,0,5,5,0
2020,217606,45,1,3,3,0
2020,217606,45,2,1,1,0
2020,217606,45,3,1,1,0
2020,217615,0,0,52,25,27
2020,217615,10,0,52,25,27
2020,217615,10,6,52,25,27
2020,217615,40,0,52,25,27
2020,217615,40,6,52,25,27
2020,217615,41,0,52,25,27
2020,217615,41,6,52,25,27
2020,217615,45,0,52,25,27
2020,217615,45,6,52,25,27
2020,217624,0,0,41,25,16
2020,217624,10,0,41,25,16
2020,217624,10,2,8,5,3
2020,217624,10,3,23,14,9
2020,217624,10,4,10,6,4
2020,217624,20,0,4,2,2
2020,217624,20,2,4,2,2
2020,217624,30,0,21,15,6
2020,217624,30,2,4,3,1
2020,217624,30,3,17,12,5
2020,217624,40,0,16,8,8
2020,217624,40,3,6,2,4
2020,217624,40,4,10,6,4
2020,217624,42,0,16,8,8
2020,217624,42,3,6,2,4
2020,217624,42,4,10,6,4
2020,217633,0,0,163,76,87
2020,217633,10,0,163,76,87
2020,217633,10,1,21,16,5
2020,217633,10,2,39,22,17
2020,217633,10,3,69,27,42
2020,217633,10,4,25,8,17
2020,217633,10,5,9,3,6
2020,217633,20,0,41,26,15
2020,217633,20,1,17,14,3
2020,217633,20,2,22,12,10
2020,217633,20,3,2,0,2
2020,217633,30,0,33,22,11
2020,217633,30,1,2,1,1
2020,217633,30,2,8,5,3
2020,217633,30,3,23,16,7
2020,217633,40,0,89,28,61
2020,217633,40,1,2,1,1
2020,217633,40,2,9,5,4
2020,217633,40,3,44,11,33
2020,217633,40,4,25,8,17
2020,217633,40,5,9,3,6
2020,217633,41,0,4,2,2
2020,217633,41,1,1,0,1
2020,217633,41,2,2,1,1
2020,217633,41,3,1,1,0
2020,217633,42,0,85,26,59
2020,217633,42,1,1,1,0
2020,217633,42,2,7,4,3
2020,217633,42,3,43,10,33
2020,217633,42,4,25,8,17
2020,217633,42,5,9,3,6
2020,217633,44,0,4,2,2
2020,217633,44,1,1,0,1
2020,217633,44,2,2,1,1
2020,217633,44,3,1,1,0
2020,217688,0,0,224,122,102
2020,217688,10,0,192,96,96
2020,217688,10,1,42,25,17
2020,217688,10,2,50,36,14
2020,217688,10,3,78,31,47
2020,217688,10,4,20,4,16
2020,217688,10,5,2,0,2
2020,217688,20,0,29,13,16
2020,217688,20,1,28,12,16
2020,217688,20,2,1,1,0
2020,217688,30,0,109,68,41
2020,217688,30,1,13,12,1
2020,217688,30,2,48,35,13
2020,217688,30,3,48,21,27
2020,217688,40,0,54,15,39
2020,217688,40,1,1,1,0
2020,217688,40,2,1,0,1
2020,217688,40,3,30,10,20
2020,217688,40,4,20,4,16
2020,217688,40,5,2,0,2
2020,217688,41,0,16,6,10
2020,217688,41,2,1,0,1
2020,217688,41,3,15,6,9
2020,217688,42,0,38,9,29
2020,217688,42,1,1,1,0
2020,217688,42,3,15,4,11
2020,217688,42,4,20,4,16
2020,217688,42,5,2,0,2
2020,217688,44,0,16,6,10
2020,217688,44,2,1,0,1
2020,217688,44,3,15,6,9
2020,217688,50,0,32,26,6
2020,217712,0,0,54,20,34
2020,217712,10,0,54,20,34
2020,217712,10,6,54,20,34
2020,217712,40,0,54,20,34
2020,217712,40,6,54,20,34
2020,217712,41,0,54,20,34
2020,217712,41,6,54,20,34
2020,217712,45,0,54,20,34
2020,217712,45,6,54,20,34
2020,217721,0,0,88,46,42
2020,217721,10,0,88,46,42
2020,217721,10,1,15,10,5
2020,217721,10,2,35,23,12
2020,217721,10,3,16,6,10
2020,217721,10,4,22,7,15
2020,217721,20,0,43,29,14
2020,217721,20,1,13,9,4
2020,217721,20,2,29,20,9
2020,217721,20,3,1,0,1
2020,217721,30,0,20,9,11
2020,217721,30,1,2,1,1
2020,217721,30,2,5,2,3
2020,217721,30,3,13,6,7
2020,217721,40,0,25,8,17
2020,217721,40,2,1,1,0
2020,217721,40,3,2,0,2
2020,217721,40,4,22,7,15
2020,217721,42,0,25,8,17
2020,217721,42,2,1,1,0
2020,217721,42,3,2,0,2
2020,217721,42,4,22,7,15
2020,217749,0,0,166,100,66
2020,217749,10,0,166,100,66
2020,217749,10,1,56,43,13
2020,217749,10,2,57,31,26
2020,217749,10,3,45,23,22
2020,217749,10,4,8,3,5
2020,217749,40,0,166,100,66
2020,217749,40,1,56,43,13
2020,217749,40,2,57,31,26
2020,217749,40,3,45,23,22
2020,217749,40,4,8,3,5
2020,217749,42,0,166,100,66
2020,217749,42,1,56,43,13
2020,217749,42,2,57,31,26
2020,217749,42,3,45,23,22
2020,217749,42,4,8,3,5
2020,217776,0,0,55,32,23
2020,217776,10,0,55,32,23
2020,217776,10,1,14,11,3
2020,217776,10,2,20,12,8
2020,217776,10,3,20,9,11
2020,217776,10,4,1,0,1
2020,217776,20,0,11,10,1
2020,217776,20,1,9,8,1
2020,217776,20,2,2,2,0
2020,217776,30,0,42,22,20
2020,217776,30,1,5,3,2
2020,217776,30,2,18,10,8
2020,217776,30,3,19,9,10
2020,217776,40,0,2,0,2
2020,217776,40,3,1,0,1
2020,217776,40,4,1,0,1
2020,217776,42,0,2,0,2
2020,217776,42,3,1,0,1
2020,217776,42,4,1,0,1
2020,217819,0,0,511,264,247
2020,217819,10,0,511,264,247
2020,217819,10,1,149,92,57
2020,217819,10,2,189,106,83
2020,217819,10,3,115,49,66
2020,217819,10,4,58,17,41
2020,217819,20,0,330,195,135
2020,217819,20,1,147,92,55
2020,217819,20,2,182,103,79
2020,217819,20,3,1,0,1
2020,217819,30,0,105,46,59
2020,217819,30,1,2,0,2
2020,217819,30,2,3,2,1
2020,217819,30,3,100,44,56
2020,217819,40,0,76,23,53
2020,217819,40,2,4,1,3
2020,217819,40,3,14,5,9
2020,217819,40,4,58,17,41
2020,217819,41,0,50,14,36
2020,217819,41,4,50,14,36
2020,217819,42,0,26,9,17
2020,217819,42,2,4,1,3
2020,217819,42,3,14,5,9
2020,217819,42,4,8,3,5
2020,217819,44,0,50,14,36
2020,217819,44,4,50,14,36
2020,217837,0,0,24,15,9
2020,217837,10,0,24,15,9
2020,217837,10,6,24,15,9
2020,217837,40,0,24,15,9
2020,217837,40,6,24,15,9
2020,217837,41,0,24,15,9
2020,217837,41,6,24,15,9
2020,217837,45,0,24,15,9
2020,217837,45,6,24,15,9
2020,217864,0,0,208,128,80
2020,217864,10,0,208,128,80
2020,217864,10,1,66,50,16
2020,217864,10,2,62,29,33
2020,217864,10,3,63,42,21
2020,217864,10,4,17,7,10
2020,217864,20,0,109,71,38
2020,217864,20,1,62,47,15
2020,217864,20,2,46,23,23
2020,217864,20,3,1,1,0
2020,217864,30,0,78,47,31
2020,217864,30,1,2,2,0
2020,217864,30,2,16,6,10
2020,217864,30,3,60,39,21
2020,217864,40,0,21,10,11
2020,217864,40,1,2,1,1
2020,217864,40,3,2,2,0
2020,217864,40,4,17,7,10
2020,217864,41,0,9,4,5
2020,217864,41,1,2,1,1
2020,217864,41,4,7,3,4
2020,217864,42,0,12,6,6
2020,217864,42,3,2,2,0
2020,217864,42,4,10,4,6
2020,217864,44,0,9,4,5
2020,217864,44,1,2,1,1
2020,217864,44,4,7,3,4
2020,217873,0,0,119,67,52
2020,217873,10,0,119,67,52
2020,217873,10,1,18,12,6
2020,217873,10,2,37,22,15
2020,217873,10,3,48,26,22
2020,217873,10,4,16,7,9
2020,217873,20,0,50,31,19
2020,217873,20,1,16,10,6
2020,217873,20,2,31,19,12
2020,217873,20,3,3,2,1
2020,217873,30,0,51,30,21
2020,217873,30,1,2,2,0
2020,217873,30,2,6,3,3
2020,217873,30,3,40,22,18
2020,217873,30,4,3,3,0
2020,217873,40,0,18,6,12
2020,217873,40,3,5,2,3
2020,217873,40,4,13,4,9
2020,217873,42,0,18,6,12
2020,217873,42,3,5,2,3
2020,217873,42,4,13,4,9
2020,217882,0,0,1360,810,550
2020,217882,10,0,1360,810,550
2020,217882,10,1,355,270,85
2020,217882,10,2,327,205,122
2020,217882,10,3,271,156,115
2020,217882,10,4,2,1,1
2020,217882,10,5,348,147,201
2020,217882,10,6,57,31,26
2020,217882,20,0,656,461,195
2020,217882,20,1,355,270,85
2020,217882,20,2,301,191,110
2020,217882,30,0,297,170,127
2020,217882,30,2,26,14,12
2020,217882,30,3,271,156,115
2020,217882,40,0,407,179,228
2020,217882,40,4,2,1,1
2020,217882,40,5,348,147,201
2020,217882,40,6,57,31,26
2020,217882,41,0,166,78,88
2020,217882,41,5,166,78,88
2020,217882,42,0,238,101,137
2020,217882,42,4,2,1,1
2020,217882,42,5,179,69,110
2020,217882,42,6,57,31,26
2020,217882,43,0,3,0,3
2020,217882,43,5,3,0,3
2020,217882,44,0,166,78,88
2020,217882,44,5,166,78,88
2020,217891,0,0,10,9,1
2020,217891,10,0,10,9,1
2020,217891,10,1,10,9,1
2020,217891,40,0,10,9,1
2020,217891,40,1,10,9,1
2020,217891,43,0,10,9,1
2020,217891,43,1,10,9,1
2020,217907,0,0,69,35,34
2020,217907,10,0,69,35,34
2020,217907,10,1,28,12,16
2020,217907,10,2,19,9,10
2020,217907,10,3,19,11,8
2020,217907,10,5,3,3,0
2020,217907,20,0,42,20,22
2020,217907,20,1,22,10,12
2020,217907,20,2,19,9,10
2020,217907,20,3,1,1,0
2020,217907,30,0,19,10,9
2020,217907,30,1,2,1,1
2020,217907,30,3,17,9,8
2020,217907,40,0,8,5,3
2020,217907,40,1,4,1,3
2020,217907,40,3,1,1,0
2020,217907,40,5,3,3,0
2020,217907,42,0,8,5,3
2020,217907,42,1,4,1,3
2020,217907,42,3,1,1,0
2020,217907,42,5,3,3,0
2020,217925,0,0,48,33,15
2020,217925,10,0,46,33,13
2020,217925,10,1,22,17,5
2020,217925,10,2,24,16,8
2020,217925,40,0,46,33,13
2020,217925,40,1,22,17,5
2020,217925,40,2,24,16,8
2020,217925,41,0,29,22,7
2020,217925,41,1,22,17,5
2020,217925,41,2,7,5,2
2020,217925,42,0,17,11,6
2020,217925,42,2,17,11,6
2020,217925,44,0,29,22,7
2020,217925,44,1,22,17,5
2020,217925,44,2,7,5,2
2020,217925,50,0,2,0,2
2020,217934,0,0,47,12,35
2020,217934,10,0,47,12,35
2020,217934,10,1,11,2,9
2020,217934,10,2,10,4,6
2020,217934,10,3,18,4,14
2020,217934,10,5,8,2,6
2020,217934,20,0,18,4,14
2020,217934,20,1,11,2,9
2020,217934,20,2,7,2,5
2020,217934,30,0,21,6,15
2020,217934,30,2,3,2,1
2020,217934,30,3,18,4,14
2020,217934,40,0,8,2,6
2020,217934,40,5,8,2,6
2020,217934,42,0,8,2,6
2020,217934,42,5,8,2,6
2020,217961,0,0,84,30,54
2020,217961,10,0,84,30,54
2020,217961,10,1,18,11,7
2020,217961,10,2,26,7,19
2020,217961,10,3,35,11,24
2020,217961,10,4,3,1,2
2020,217961,10,5,2,0,2
2020,217961,20,0,45,19,26
2020,217961,20,1,18,11,7
2020,217961,20,2,26,7,19
2020,217961,20,3,1,1,0
2020,217961,30,0,33,9,24
2020,217961,30,3,33,9,24
2020,217961,40,0,6,2,4
2020,217961,40,3,1,1,0
2020,217961,40,4,3,1,2
2020,217961,40,5,2,0,2
2020,217961,42,0,6,2,4
2020,217961,42,3,1,1,0
2020,217961,42,4,3,1,2
2020,217961,42,5,2,0,2
2020,217989,0,0,25,13,12
2020,217989,10,0,25,13,12
2020,217989,10,6,25,13,12
2020,217989,40,0,25,13,12
2020,217989,40,6,25,13,12
2020,217989,41,0,25,13,12
2020,217989,41,6,25,13,12
2020,217989,44,0,1,1,0
2020,217989,44,6,1,1,0
2020,217989,45,0,24,12,12
2020,217989,45,6,24,12,12
2020,217998,0,0,43,24,19
2020,217998,10,0,43,24,19
2020,217998,10,1,21,16,5
2020,217998,10,2,7,6,1
2020,217998,10,3,15,2,13
2020,217998,20,0,22,16,6
2020,217998,20,1,16,15,1
2020,217998,20,2,1,1,0
2020,217998,20,3,5,0,5
2020,217998,30,0,18,7,11
2020,217998,30,1,4,1,3
2020,217998,30,2,5,4,1
2020,217998,30,3,9,2,7
2020,217998,40,0,3,1,2
2020,217998,40,1,1,0,1
2020,217998,40,2,1,1,0
2020,217998,40,3,1,0,1
2020,217998,42,0,3,1,2
2020,217998,42,1,1,0,1
2020,217998,42,2,1,1,0
2020,217998,42,3,1,0,1
2020,218025,0,0,81,37,44
2020,218025,10,0,81,37,44
2020,218025,10,6,81,37,44
2020,218025,40,0,81,37,44
2020,218025,40,6,81,37,44
2020,218025,41,0,81,37,44
2020,218025,41,6,81,37,44
2020,218025,45,0,81,37,44
2020,218025,45,6,81,37,44
2020,218061,0,0,212,102,110
2020,218061,10,0,212,102,110
2020,218061,10,1,69,47,22
2020,218061,10,2,47,18,29
2020,218061,10,3,83,35,48
2020,218061,10,4,13,2,11
2020,218061,20,0,114,64,50
2020,218061,20,1,68,46,22
2020,218061,20,2,45,17,28
2020,218061,20,3,1,1,0
2020,218061,30,0,78,33,45
2020,218061,30,2,2,1,1
2020,218061,30,3,74,32,42
2020,218061,30,4,2,0,2
2020,218061,40,0,20,5,15
2020,218061,40,1,1,1,0
2020,218061,40,3,8,2,6
2020,218061,40,4,11,2,9
2020,218061,41,0,1,0,1
2020,218061,41,4,1,0,1
2020,218061,42,0,19,5,14
2020,218061,42,1,1,1,0
2020,218061,42,3,8,2,6
2020,218061,42,4,10,2,8
2020,218061,44,0,1,0,1
2020,218061,44,4,1,0,1
2020,218070,0,0,260,142,118
2020,218070,10,0,260,142,118
2020,218070,10,1,81,53,28
2020,218070,10,2,29,17,12
2020,218070,10,3,118,60,58
2020,218070,10,4,13,7,6
2020,218070,10,5,14,5,9
2020,218070,10,6,5,0,5
2020,218070,20,0,164,102,62
2020,218070,20,1,78,52,26
2020,218070,20,2,22,13,9
2020,218070,20,3,54,31,23
2020,218070,20,4,10,6,4
2020,218070,30,0,60,25,35
2020,218070,30,1,2,0,2
2020,218070,30,2,6,3,3
2020,218070,30,3,52,22,30
2020,218070,40,0,36,15,21
2020,218070,40,1,1,1,0
2020,218070,40,2,1,1,0
2020,218070,40,3,12,7,5
2020,218070,40,4,3,1,2
2020,218070,40,5,14,5,9
2020,218070,40,6,5,0,5
2020,218070,42,0,33,14,19
2020,218070,42,2,1,1,0
2020,218070,42,3,12,7,5
2020,218070,42,4,2,1,1
2020,218070,42,5,13,5,8
2020,218070,42,6,5,0,5
2020,218070,43,0,3,1,2
2020,218070,43,1,1,1,0
2020,218070,43,4,1,0,1
2020,218070,43,5,1,0,1
2020,218113,0,0,346,141,205
2020,218113,10,0,346,141,205
2020,218113,10,6,346,141,205
2020,218113,40,0,346,141,205
2020,218113,40,6,346,141,205
2020,218113,41,0,346,141,205
2020,218113,41,6,346,141,205
2020,218113,45,0,346,141,205
2020,218113,45,6,346,141,205
2020,218140,0,0,165,78,87
2020,218140,10,0,165,78,87
2020,218140,10,6,165,78,87
2020,218140,40,0,165,78,87
2020,218140,40,6,165,78,87
2020,218140,41,0,165,78,87
2020,218140,41,6,165,78,87
2020,218140,45,0,165,78,87
2020,218140,45,6,165,78,87
2020,218229,0,0,155,65,90
2020,218229,10,0,155,65,90
2020,218229,10,1,20,12,8
2020,218229,10,2,32,19,13
2020,218229,10,3,56,25,31
2020,218229,10,4,9,0,9
2020,218229,10,5,35,8,27
2020,218229,10,6,3,1,2
2020,218229,20,0,56,32,24
2020,218229,20,1,20,12,8
2020,218229,20,2,28,16,12
2020,218229,20,3,6,4,2
2020,218229,20,5,1,0,1
2020,218229,20,6,1,0,1
2020,218229,30,0,53,22,31
2020,218229,30,2,2,2,0
2020,218229,30,3,44,17,27
2020,218229,30,5,6,2,4
2020,218229,30,6,1,1,0
2020,218229,40,0,46,11,35
2020,218229,40,2,2,1,1
2020,218229,40,3,6,4,2
2020,218229,40,4,9,0,9
2020,218229,40,5,28,6,22
2020,218229,40,6,1,0,1
2020,218229,41,0,3,1,2
2020,218229,41,5,3,1,2
2020,218229,42,0,5,3,2
2020,218229,42,3,1,1,0
2020,218229,42,4,1,0,1
2020,218229,42,5,3,2,1
2020,218229,43,0,38,7,31
2020,218229,43,2,2,1,1
2020,218229,43,3,5,3,2
2020,218229,43,4,8,0,8
2020,218229,43,5,22,3,19
2020,218229,43,6,1,0,1
2020,218229,45,0,3,1,2
2020,218229,45,5,3,1,2
2020,218238,0,0,94,43,51
2020,218238,10,0,94,43,51
2020,218238,10,1,25,14,11
2020,218238,10,2,23,11,12
2020,218238,10,3,26,11,15
2020,218238,10,4,2,1,1
2020,218238,10,5,18,6,12
2020,218238,20,0,43,23,20
2020,218238,20,1,25,14,11
2020,218238,20,2,13,7,6
2020,218238,20,3,5,2,3
2020,218238,30,0,33,14,19
2020,218238,30,2,10,4,6
2020,218238,30,3,21,9,12
2020,218238,30,4,2,1,1
2020,218238,40,0,18,6,12
2020,218238,40,5,18,6,12
2020,218238,42,0,18,6,12
2020,218238,42,5,18,6,12
2020,218335,0,0,192,73,119
2020,218335,10,0,189,73,116
2020,218335,10,1,57,32,25
2020,218335,10,2,57,21,36
2020,218335,10,3,43,12,31
2020,218335,10,4,32,8,24
2020,218335,20,0,31,17,14
2020,218335,20,1,30,17,13
2020,218335,20,2,1,0,1
2020,218335,30,0,112,43,69
2020,218335,30,1,21,14,7
2020,218335,30,2,44,17,27
2020,218335,30,3,31,10,21
2020,218335,30,4,16,2,14
2020,218335,40,0,46,13,33
2020,218335,40,1,6,1,5
2020,218335,40,2,12,4,8
2020,218335,40,3,12,2,10
2020,218335,40,4,16,6,10
2020,218335,42,0,46,13,33
2020,218335,42,1,6,1,5
2020,218335,42,2,12,4,8
2020,218335,42,3,12,2,10
2020,218335,42,4,16,6,10
2020,218335,50,0,3,0,3
2020,218353,0,0,217,100,117
2020,218353,10,0,217,100,117
2020,218353,10,6,217,100,117
2020,218353,40,0,217,100,117
2020,218353,40,6,217,100,117
2020,218353,41,0,217,100,117
2020,218353,41,6,217,100,117
2020,218353,45,0,217,100,117
2020,218353,45,6,217,100,117
2020,218399,0,0,22,12,10
2020,218399,10,0,22,12,10
2020,218399,10,1,6,5,1
2020,218399,10,2,6,3,3
2020,218399,10,3,9,4,5
2020,218399,10,4,1,0,1
2020,218399,40,0,22,12,10
2020,218399,40,1,6,5,1
2020,218399,40,2,6,3,3
2020,218399,40,3,9,4,5
2020,218399,40,4,1,0,1
2020,218399,41,0,1,1,0
2020,218399,41,1,1,1,0
2020,218399,42,0,21,11,10
2020,218399,42,1,5,4,1
2020,218399,42,2,6,3,3
2020,218399,42,3,9,4,5
2020,218399,42,4,1,0,1
2020,218399,44,0,1,1,0
2020,218399,44,1,1,1,0
2020,218414,0,0,76,39,37
2020,218414,10,0,76,39,37
2020,218414,10,1,16,12,4
2020,218414,10,2,21,10,11
2020,218414,10,3,37,16,21
2020,218414,10,4,2,1,1
2020,218414,20,0,35,19,16
2020,218414,20,1,13,10,3
2020,218414,20,2,18,7,11
2020,218414,20,3,4,2,2
2020,218414,30,0,26,12,14
2020,218414,30,2,1,1,0
2020,218414,30,3,25,11,14
2020,218414,40,0,15,8,7
2020,218414,40,1,3,2,1
2020,218414,40,2,2,2,0
2020,218414,40,3,8,3,5
2020,218414,40,4,2,1,1
2020,218414,42,0,15,8,7
2020,218414,42,1,3,2,1
2020,218414,42,2,2,2,0
2020,218414,42,3,8,3,5
2020,218414,42,4,2,1,1
2020,218441,0,0,154,86,68
2020,218441,10,0,154,86,68
2020,218441,10,1,50,33,17
2020,218441,10,2,26,17,9
2020,218441,10,3,36,21,15
2020,218441,10,4,42,15,27
2020,218441,40,0,154,86,68
2020,218441,40,1,50,33,17
2020,218441,40,2,26,17,9
2020,218441,40,3,36,21,15
2020,218441,40,4,42,15,27
2020,218441,42,0,154,86,68
2020,218441,42,1,50,33,17
2020,218441,42,2,26,17,9
2020,218441,42,3,36,21,15
2020,218441,42,4,42,15,27
2020,218487,0,0,66,21,45
2020,218487,10,0,66,21,45
2020,218487,10,6,66,21,45
2020,218487,40,0,66,21,45
2020,218487,40,6,66,21,45
2020,218487,41,0,66,21,45
2020,218487,41,6,66,21,45
2020,218487,45,0,66,21,45
2020,218487,45,6,66,21,45
2020,218520,0,0,116,51,65
2020,218520,10,0,116,51,65
2020,218520,10,6,116,51,65
2020,218520,40,0,116,51,65
2020,218520,40,6,116,51,65
2020,218520,41,0,116,51,65
2020,218520,41,6,116,51,65
2020,218520,45,0,116,51,65
2020,218520,45,6,116,51,65
2020,218539,0,0,101,60,41
2020,218539,10,0,101,60,41
2020,218539,10,1,42,31,11
2020,218539,10,2,32,17,15
2020,218539,10,3,26,11,15
2020,218539,10,4,1,1,0
2020,218539,20,0,70,46,24
2020,218539,20,1,42,31,11
2020,218539,20,2,28,15,13
2020,218539,30,0,15,7,8
2020,218539,30,2,1,0,1
2020,218539,30,3,14,7,7
2020,218539,40,0,16,7,9
2020,218539,40,2,3,2,1
2020,218539,40,3,12,4,8
2020,218539,40,4,1,1,0
2020,218539,42,0,16,7,9
2020,218539,42,2,3,2,1
2020,218539,42,3,12,4,8
2020,218539,42,4,1,1,0
2020,218645,0,0,158,78,80
2020,218645,10,0,158,78,80
2020,218645,10,1,30,21,9
2020,218645,10,2,52,22,30
2020,218645,10,3,43,17,26
2020,218645,10,4,33,18,15
2020,218645,20,0,76,39,37
2020,218645,20,1,30,21,9
2020,218645,20,2,45,17,28
2020,218645,20,3,1,1,0
2020,218645,30,0,49,21,28
2020,218645,30,2,7,5,2
2020,218645,30,3,42,16,26
2020,218645,40,0,33,18,15
2020,218645,40,4,33,18,15
2020,218645,41,0,4,3,1
2020,218645,41,4,4,3,1
2020,218645,42,0,29,15,14
2020,218645,42,4,29,15,14
2020,218645,44,0,4,3,1
2020,218645,44,4,4,3,1
2020,218654,0,0,94,42,52
2020,218654,10,0,94,42,52
2020,218654,10,1,11,8,3
2020,218654,10,2,32,16,16
2020,218654,10,3,26,10,16
2020,218654,10,4,25,8,17
2020,218654,20,0,37,21,16
2020,218654,20,1,11,8,3
2020,218654,20,2,26,13,13
2020,218654,30,0,30,12,18
2020,218654,30,2,6,3,3
2020,218654,30,3,24,9,15
2020,218654,40,0,27,9,18
2020,218654,40,3,2,1,1
2020,218654,40,4,25,8,17
2020,218654,42,0,27,9,18
2020,218654,42,3,2,1,1
2020,218654,42,4,25,8,17
2020,218663,0,0,1693,932,761
2020,218663,10,0,1693,932,761
2020,218663,10,1,480,337,143
2020,218663,10,2,530,283,247
2020,218663,10,3,433,201,232
2020,218663,10,4,220,99,121
2020,218663,10,5,26,12,14
2020,218663,10,6,4,0,4
2020,218663,20,0,835,521,314
2020,218663,20,1,445,311,134
2020,218663,20,2,388,210,178
2020,218663,20,3,2,0,2
2020,218663,30,0,291,158,133
2020,218663,30,1,1,1,0
2020,218663,30,2,26,18,8
2020,218663,30,3,264,139,125
2020,218663,40,0,567,253,314
2020,218663,40,1,34,25,9
2020,218663,40,2,116,55,61
2020,218663,40,3,167,62,105
2020,218663,40,4,220,99,121
2020,218663,40,5,26,12,14
2020,218663,40,6,4,0,4
2020,218663,41,0,216,90,126
2020,218663,41,1,14,9,5
2020,218663,41,2,31,9,22
2020,218663,41,3,42,17,25
2020,218663,41,4,119,50,69
2020,218663,41,5,8,5,3
2020,218663,41,6,2,0,2
2020,218663,42,0,346,159,187
2020,218663,42,1,20,16,4
2020,218663,42,2,83,44,39
2020,218663,42,3,122,43,79
2020,218663,42,4,101,49,52
2020,218663,42,5,18,7,11
2020,218663,42,6,2,0,2
2020,218663,43,0,5,4,1
2020,218663,43,2,2,2,0
2020,218663,43,3,3,2,1
2020,218663,44,0,216,90,126
2020,218663,44,1,14,9,5
2020,218663,44,2,31,9,22
2020,218663,44,3,42,17,25
2020,218663,44,4,119,50,69
2020,218663,44,5,8,5,3
2020,218663,44,6,2,0,2
2020,218672,0,0,53,29,24
2020,218672,10,0,53,29,24
2020,218672,10,1,9,4,5
2020,218672,10,2,19,10,9
2020,218672,10,3,6,3,3
2020,218672,10,4,19,12,7
2020,218672,20,0,28,14,14
2020,218672,20,1,9,4,5
2020,218672,20,2,19,10,9
2020,218672,30,0,6,3,3
2020,218672,30,3,6,3,3
2020,218672,40,0,19,12,7
2020,218672,40,4,19,12,7
2020,218672,41,0,16,9,7
2020,218672,41,4,16,9,7
2020,218672,42,0,3,3,0
2020,218672,42,4,3,3,0
2020,218672,44,0,16,9,7
2020,218672,44,4,16,9,7
2020,218681,0,0,22,14,8
2020,218681,10,0,22,14,8
2020,218681,10,1,4,3,1
2020,218681,10,2,4,3,1
2020,218681,10,3,8,4,4
2020,218681,10,4,6,4,2
2020,218681,20,0,8,6,2
2020,218681,20,1,4,3,1
2020,218681,20,2,4,3,1
2020,218681,30,0,8,4,4
2020,218681,30,3,8,4,4
2020,218681,40,0,6,4,2
2020,218681,40,4,6,4,2
2020,218681,41,0,3,3,0
2020,218681,41,4,3,3,0
2020,218681,42,0,3,1,2
2020,218681,42,4,3,1,2
2020,218681,44,0,3,3,0
2020,218681,44,4,3,3,0
2020,218690,0,0,39,18,21
2020,218690,10,0,39,18,21
2020,218690,10,1,12,6,6
2020,218690,10,2,2,2,0
2020,218690,10,3,9,4,5
2020,218690,10,4,16,6,10
2020,218690,20,0,14,8,6
2020,218690,20,1,12,6,6
2020,218690,20,2,1,1,0
2020,218690,20,3,1,1,0
2020,218690,30,0,9,4,5
2020,218690,30,2,1,1,0
2020,218690,30,3,8,3,5
2020,218690,40,0,16,6,10
2020,218690,40,4,16,6,10
2020,218690,41,0,7,4,3
2020,218690,41,4,7,4,3
2020,218690,42,0,9,2,7
2020,218690,42,4,9,2,7
2020,218690,44,0,7,4,3
2020,218690,44,4,7,4,3
2020,218706,0,0,15,6,9
2020,218706,10,0,15,6,9
2020,218706,10,1,2,1,1
2020,218706,10,2,2,1,1
2020,218706,10,3,6,2,4
2020,218706,10,4,5,2,3
2020,218706,20,0,4,2,2
2020,218706,20,1,2,1,1
2020,218706,20,2,2,1,1
2020,218706,30,0,6,2,4
2020,218706,30,3,6,2,4
2020,218706,40,0,5,2,3
2020,218706,40,4,5,2,3
2020,218706,42,0,5,2,3
2020,218706,42,4,5,2,3
2020,218724,0,0,486,264,222
2020,218724,10,0,486,264,222
2020,218724,10,1,104,77,27
2020,218724,10,2,122,69,53
2020,218724,10,3,113,53,60
2020,218724,10,4,6,4,2
2020,218724,10,5,141,61,80
2020,218724,20,0,220,141,79
2020,218724,20,1,103,76,27
2020,218724,20,2,116,65,51
2020,218724,20,3,1,0,1
2020,218724,30,0,113,55,58
2020,218724,30,2,6,4,2
2020,218724,30,3,107,51,56
2020,218724,40,0,153,68,85
2020,218724,40,1,1,1,0
2020,218724,40,3,5,2,3
2020,218724,40,4,6,4,2
2020,218724,40,5,141,61,80
2020,218724,42,0,153,68,85
2020,218724,42,1,1,1,0
2020,218724,42,3,5,2,3
2020,218724,42,4,6,4,2
2020,218724,42,5,141,61,80
2020,218733,0,0,130,67,63
2020,218733,10,0,130,67,63
2020,218733,10,1,34,22,12
2020,218733,10,2,32,14,18
2020,218733,10,3,39,20,19
2020,218733,10,4,25,11,14
2020,218733,20,0,66,38,28
2020,218733,20,1,34,22,12
2020,218733,20,2,30,14,16
2020,218733,20,3,2,2,0
2020,218733,30,0,32,16,16
2020,218733,30,2,2,0,2
2020,218733,30,3,28,15,13
2020,218733,30,4,2,1,1
2020,218733,40,0,32,13,19
2020,218733,40,3,9,3,6
2020,218733,40,4,23,10,13
2020,218733,42,0,32,13,19
2020,218733,42,3,9,3,6
2020,218733,42,4,23,10,13
2020,218742,0,0,232,97,135
2020,218742,10,0,232,97,135
2020,218742,10,1,42,21,21
2020,218742,10,2,57,29,28
2020,218742,10,3,64,25,39
2020,218742,10,4,69,22,47
2020,218742,20,0,96,51,45
2020,218742,20,1,42,21,21
2020,218742,20,2,53,29,24
2020,218742,20,3,1,1,0
2020,218742,30,0,67,24,43
2020,218742,30,2,4,0,4
2020,218742,30,3,63,24,39
2020,218742,40,0,69,22,47
2020,218742,40,4,69,22,47
2020,218742,41,0,34,15,19
2020,218742,41,4,34,15,19
2020,218742,42,0,35,7,28
2020,218742,42,4,35,7,28
2020,218742,44,0,34,15,19
2020,218742,44,4,34,15,19
2020,218751,0,0,37,14,23
2020,218751,10,0,37,14,23
2020,218751,10,1,9,3,6
2020,218751,10,2,8,2,6
2020,218751,10,3,13,5,8
2020,218751,10,4,7,4,3
2020,218751,40,0,37,14,23
2020,218751,40,1,9,3,6
2020,218751,40,2,8,2,6
2020,218751,40,3,13,5,8
2020,218751,40,4,7,4,3
2020,218751,43,0,37,14,23
2020,218751,43,1,9,3,6
2020,218751,43,2,8,2,6
2020,218751,43,3,13,5,8
2020,218751,43,4,7,4,3
2020,218821,0,0,37,16,21
2020,218821,10,0,37,16,21
2020,218821,10,6,37,16,21
2020,218821,20,0,12,7,5
2020,218821,20,6,12,7,5
2020,218821,30,0,9,3,6
2020,218821,30,6,9,3,6
2020,218821,40,0,16,6,10
2020,218821,40,6,16,6,10
2020,218821,42,0,16,6,10
2020,218821,42,6,16,6,10
2020,218830,0,0,124,54,70
2020,218830,10,0,124,54,70
2020,218830,10,6,124,54,70
2020,218830,40,0,124,54,70
2020,218830,40,6,124,54,70
2020,218830,41,0,124,54,70
2020,218830,41,6,124,54,70
2020,218830,45,0,124,54,70
2020,218830,45,6,124,54,70
2020,218858,0,0,90,38,52
2020,218858,10,0,90,38,52
2020,218858,10,6,90,38,52
2020,218858,40,0,90,38,52
2020,218858,40,6,90,38,52
2020,218858,41,0,90,38,52
2020,218858,41,6,90,38,52
2020,218858,45,0,90,38,52
2020,218858,45,6,90,38,52
2020,218885,0,0,143,56,87
2020,218885,10,0,143,56,87
2020,218885,10,6,143,56,87
2020,218885,40,0,143,56,87
2020,218885,40,6,143,56,87
2020,218885,41,0,143,56,87
2020,218885,41,6,143,56,87
2020,218885,45,0,143,56,87
2020,218885,45,6,143,56,87
2020,218894,0,0,245,107,138
2020,218894,10,0,245,107,138
2020,218894,10,6,245,107,138
2020,218894,40,0,245,107,138
2020,218894,40,6,245,107,138
2020,218894,41,0,245,107,138
2020,218894,41,6,245,107,138
2020,218894,45,0,245,107,138
2020,218894,45,6,245,107,138
2020,218919,0,0,31,18,13
2020,218919,10,0,31,18,13
2020,218919,10,1,2,2,0
2020,218919,10,2,6,3,3
2020,218919,10,3,18,9,9
2020,218919,10,4,5,4,1
2020,218919,20,0,5,3,2
2020,218919,20,1,1,1,0
2020,218919,20,2,4,2,2
2020,218919,30,0,26,15,11
2020,218919,30,1,1,1,0
2020,218919,30,2,2,1,1
2020,218919,30,3,18,9,9
2020,218919,30,4,5,4,1
2020,218955,0,0,25,11,14
2020,218955,10,0,25,11,14
2020,218955,10,6,25,11,14
2020,218955,40,0,25,11,14
2020,218955,40,6,25,11,14
2020,218955,41,0,25,11,14
2020,218955,41,6,25,11,14
2020,218955,45,0,25,11,14
2020,218955,45,6,25,11,14
2020,218964,0,0,284,128,156
2020,218964,10,0,284,128,156
2020,218964,10,1,81,47,34
2020,218964,10,2,79,38,41
2020,218964,10,3,90,33,57
2020,218964,10,4,34,10,24
2020,218964,20,0,148,76,72
2020,218964,20,1,80,46,34
2020,218964,20,2,66,30,36
2020,218964,20,3,2,0,2
2020,218964,30,0,84,39,45
2020,218964,30,2,11,7,4
2020,218964,30,3,73,32,41
2020,218964,40,0,52,13,39
2020,218964,40,1,1,1,0
2020,218964,40,2,2,1,1
2020,218964,40,3,15,1,14
2020,218964,40,4,34,10,24
2020,218964,41,0,23,7,16
2020,218964,41,1,1,1,0
2020,218964,41,2,2,1,1
2020,218964,41,3,7,0,7
2020,218964,41,4,13,5,8
2020,218964,42,0,29,6,23
2020,218964,42,3,8,1,7
2020,218964,42,4,21,5,16
2020,218964,44,0,23,7,16
2020,218964,44,1,1,1,0
2020,218964,44,2,2,1,1
2020,218964,44,3,7,0,7
2020,218964,44,4,13,5,8
2020,218973,0,0,142,74,68
2020,218973,10,0,142,74,68
2020,218973,10,1,51,30,21
2020,218973,10,2,43,23,20
2020,218973,10,3,38,16,22
2020,218973,10,4,10,5,5
2020,218973,20,0,107,60,47
2020,218973,20,1,51,30,21
2020,218973,20,2,43,23,20
2020,218973,20,3,13,7,6
2020,218973,30,0,25,9,16
2020,218973,30,3,25,9,16
2020,218973,40,0,10,5,5
2020,218973,40,4,10,5,5
2020,218973,41,0,4,3,1
2020,218973,41,4,4,3,1
2020,218973,42,0,5,2,3
2020,218973,42,4,5,2,3
2020,218973,43,0,1,0,1
2020,218973,43,4,1,0,1
2020,218973,44,0,2,2,0
2020,218973,44,4,2,2,0
2020,218973,45,0,2,1,1
2020,218973,45,4,2,1,1
2020,218991,0,0,111,48,63
2020,218991,10,0,111,48,63
2020,218991,10,6,111,48,63
2020,218991,40,0,111,48,63
2020,218991,40,6,111,48,63
2020,218991,41,0,111,48,63
2020,218991,41,6,111,48,63
2020,218991,45,0,111,48,63
2020,218991,45,6,111,48,63
2020,219000,0,0,130,55,75
2020,219000,10,0,130,55,75
2020,219000,10,1,30,22,8
2020,219000,10,2,32,14,18
2020,219000,10,3,62,19,43
2020,219000,10,4,6,0,6
2020,219000,20,0,50,29,21
2020,219000,20,1,30,22,8
2020,219000,20,2,20,7,13
2020,219000,30,0,43,16,27
2020,219000,30,2,9,5,4
2020,219000,30,3,34,11,23
2020,219000,40,0,37,10,27
2020,219000,40,2,3,2,1
2020,219000,40,3,28,8,20
2020,219000,40,4,6,0,6
2020,219000,41,0,10,2,8
2020,219000,41,2,2,1,1
2020,219000,41,3,8,1,7
2020,219000,42,0,26,7,19
2020,219000,42,2,1,1,0
2020,219000,42,3,19,6,13
2020,219000,42,4,6,0,6
2020,219000,43,0,1,1,0
2020,219000,43,3,1,1,0
2020,219000,44,0,10,2,8
2020,219000,44,2,2,1,1
2020,219000,44,3,8,1,7
2020,219046,0,0,119,68,51
2020,219046,10,0,119,68,51
2020,219046,10,1,29,20,9
2020,219046,10,2,30,18,12
2020,219046,10,3,34,21,13
2020,219046,10,4,19,7,12
2020,219046,10,5,7,2,5
2020,219046,20,0,57,37,20
2020,219046,20,1,29,20,9
2020,219046,20,2,28,17,11
2020,219046,30,0,31,19,12
2020,219046,30,2,2,1,1
2020,219046,30,3,29,18,11
2020,219046,40,0,31,12,19
2020,219046,40,3,5,3,2
2020,219046,40,4,19,7,12
2020,219046,40,5,7,2,5
2020,219046,42,0,31,12,19
2020,219046,42,3,5,3,2
2020,219046,42,4,19,7,12
2020,219046,42,5,7,2,5
2020,219082,0,0,103,69,34
2020,219082,10,0,103,69,34
2020,219082,10,1,17,15,2
2020,219082,10,2,24,15,9
2020,219082,10,3,33,27,6
2020,219082,10,4,24,10,14
2020,219082,10,5,5,2,3
2020,219082,20,0,39,29,10
2020,219082,20,1,16,14,2
2020,219082,20,2,23,15,8
2020,219082,30,0,32,25,7
2020,219082,30,2,1,0,1
2020,219082,30,3,31,25,6
2020,219082,40,0,32,15,17
2020,219082,40,1,1,1,0
2020,219082,40,3,2,2,0
2020,219082,40,4,24,10,14
2020,219082,40,5,5,2,3
2020,219082,42,0,32,15,17
2020,219082,42,1,1,1,0
2020,219082,42,3,2,2,0
2020,219082,42,4,24,10,14
2020,219082,42,5,5,2,3
2020,219091,0,0,44,19,25
2020,219091,10,0,44,19,25
2020,219091,10,1,11,8,3
2020,219091,10,2,14,7,7
2020,219091,10,3,16,3,13
2020,219091,10,4,3,1,2
2020,219091,20,0,22,12,10
2020,219091,20,1,11,8,3
2020,219091,20,2,11,4,7
2020,219091,30,0,11,3,8
2020,219091,30,2,1,1,0
2020,219091,30,3,10,2,8
2020,219091,40,0,11,4,7
2020,219091,40,2,2,2,0
2020,219091,40,3,6,1,5
2020,219091,40,4,3,1,2
2020,219091,42,0,11,4,7
2020,219091,42,2,2,2,0
2020,219091,42,3,6,1,5
2020,219091,42,4,3,1,2
2020,219143,0,0,111,67,44
2020,219143,10,0,106,63,43
2020,219143,10,4,106,63,43
2020,219143,40,0,106,63,43
2020,219143,40,4,106,63,43
2020,219143,42,0,106,63,43
2020,219143,42,4,106,63,43
2020,219143,50,0,5,4,1
2020,219189,0,0,66,39,27
2020,219189,10,0,66,39,27
2020,219189,10,4,66,39,27
2020,219189,40,0,66,39,27
2020,219189,40,4,66,39,27
2020,219189,42,0,66,39,27
2020,219189,42,4,66,39,27
2020,219198,0,0,45,21,24
2020,219198,10,0,45,21,24
2020,219198,10,1,8,6,2
2020,219198,10,2,12,7,5
2020,219198,10,3,22,6,16
2020,219198,10,4,3,2,1
2020,219198,20,0,22,12,10
2020,219198,20,1,8,6,2
2020,219198,20,2,10,6,4
2020,219198,20,3,4,0,4
2020,219198,30,0,16,5,11
2020,219198,30,2,1,1,0
2020,219198,30,3,15,4,11
2020,219198,40,0,7,4,3
2020,219198,40,2,1,0,1
2020,219198,40,3,3,2,1
2020,219198,40,4,3,2,1
2020,219198,42,0,7,4,3
2020,219198,42,2,1,0,1
2020,219198,42,3,3,2,1
2020,219198,42,4,3,2,1
2020,219204,0,0,1,0,1
2020,219204,50,0,1,0,1
2020,219259,0,0,89,48,41
2020,219259,10,0,89,48,41
2020,219259,10,1,21,15,6
2020,219259,10,2,19,12,7
2020,219259,10,3,34,16,18
2020,219259,10,4,14,4,10
2020,219259,10,5,1,1,0
2020,219259,20,0,40,27,13
2020,219259,20,1,21,15,6
2020,219259,20,2,19,12,7
2020,219259,30,0,33,15,18
2020,219259,30,3,33,15,18
2020,219259,40,0,16,6,10
2020,219259,40,3,1,1,0
2020,219259,40,4,14,4,10
2020,219259,40,5,1,1,0
2020,219259,42,0,16,6,10
2020,219259,42,3,1,1,0
2020,219259,42,4,14,4,10
2020,219259,42,5,1,1,0
2020,219277,0,0,59,26,33
2020,219277,10,0,58,26,32
2020,219277,10,1,1,1,0
2020,219277,10,2,8,3,5
2020,219277,10,3,49,22,27
2020,219277,40,0,58,26,32
2020,219277,40,1,1,1,0
2020,219277,40,2,8,3,5
2020,219277,40,3,49,22,27
2020,219277,41,0,2,2,0
2020,219277,41,1,1,1,0
2020,219277,41,2,1,1,0
2020,219277,42,0,54,22,32
2020,219277,42,2,7,2,5
2020,219277,42,3,47,20,27
2020,219277,43,0,2,2,0
2020,219277,43,3,2,2,0
2020,219277,44,0,2,2,0
2020,219277,44,1,1,1,0
2020,219277,44,2,1,1,0
2020,219277,50,0,1,0,1
2020,219295,0,0,34,7,27
2020,219295,10,0,34,7,27
2020,219295,10,1,5,3,2
2020,219295,10,2,3,2,1
2020,219295,10,3,8,2,6
2020,219295,10,4,18,0,18
2020,219295,20,0,4,3,1
2020,219295,20,1,4,3,1
2020,219295,30,0,5,2,3
2020,219295,30,2,2,2,0
2020,219295,30,3,2,0,2
2020,219295,30,4,1,0,1
2020,219295,40,0,25,2,23
2020,219295,40,1,1,0,1
2020,219295,40,2,1,0,1
2020,219295,40,3,6,2,4
2020,219295,40,4,17,0,17
2020,219295,42,0,25,2,23
2020,219295,42,1,1,0,1
2020,219295,42,2,1,0,1
2020,219295,42,3,6,2,4
2020,219295,42,4,17,0,17
2020,219347,0,0,157,117,40
2020,219347,10,0,157,117,40
2020,219347,10,1,35,32,3
2020,219347,10,2,44,35,9
2020,219347,10,3,49,33,16
2020,219347,10,4,11,6,5
2020,219347,10,5,18,11,7
2020,219347,20,0,78,66,12
2020,219347,20,1,33,30,3
2020,219347,20,2,40,34,6
2020,219347,20,3,5,2,3
2020,219347,30,0,40,29,11
2020,219347,30,2,2,1,1
2020,219347,30,3,38,28,10
2020,219347,40,0,39,22,17
2020,219347,40,1,2,2,0
2020,219347,40,2,2,0,2
2020,219347,40,3,6,3,3
2020,219347,40,4,11,6,5
2020,219347,40,5,18,11,7
2020,219347,42,0,39,22,17
2020,219347,42,1,2,2,0
2020,219347,42,2,2,0,2
2020,219347,42,3,6,3,3
2020,219347,42,4,11,6,5
2020,219347,42,5,18,11,7
2020,219356,0,0,497,271,226
2020,219356,10,0,497,271,226
2020,219356,10,1,132,93,39
2020,219356,10,2,100,66,34
2020,219356,10,3,106,55,51
2020,219356,10,4,79,33,46
2020,219356,10,5,80,24,56
2020,219356,20,0,209,147,62
2020,219356,20,1,119,84,35
2020,219356,20,2,90,63,27
2020,219356,30,0,92,50,42
2020,219356,30,1,2,2,0
2020,219356,30,2,1,0,1
2020,219356,30,3,89,48,41
2020,219356,40,0,196,74,122
2020,219356,40,1,11,7,4
2020,219356,40,2,9,3,6
2020,219356,40,3,17,7,10
2020,219356,40,4,79,33,46
2020,219356,40,5,80,24,56
2020,219356,42,0,196,74,122
2020,219356,42,1,11,7,4
2020,219356,42,2,9,3,6
2020,219356,42,3,17,7,10
2020,219356,42,4,79,33,46
2020,219356,42,5,80,24,56
2020,219374,0,0,17,5,12
2020,219374,10,0,17,5,12
2020,219374,10,4,17,5,12
2020,219374,40,0,17,5,12
2020,219374,40,4,17,5,12
2020,219374,42,0,17,5,12
2020,219374,42,4,17,5,12
2020,219383,0,0,55,32,23
2020,219383,10,0,55,32,23
2020,219383,10,1,11,7,4
2020,219383,10,2,22,13,9
2020,219383,10,3,20,10,10
2020,219383,10,4,2,2,0
2020,219383,20,0,34,21,13
2020,219383,20,1,11,7,4
2020,219383,20,2,22,13,9
2020,219383,20,3,1,1,0
2020,219383,30,0,6,4,2
2020,219383,30,3,6,4,2
2020,219383,40,0,15,7,8
2020,219383,40,3,13,5,8
2020,219383,40,4,2,2,0
2020,219383,42,0,15,7,8
2020,219383,42,3,13,5,8
2020,219383,42,4,2,2,0
2020,219408,0,0,9,4,5
2020,219408,10,0,9,4,5
2020,219408,10,4,9,4,5
2020,219408,40,0,9,4,5
2020,219408,40,4,9,4,5
2020,219408,42,0,9,4,5
2020,219408,42,4,9,4,5
2020,219426,0,0,98,44,54
2020,219426,10,0,83,39,44
2020,219426,10,4,83,39,44
2020,219426,40,0,83,39,44
2020,219426,40,4,83,39,44
2020,219426,41,0,83,39,44
2020,219426,41,4,83,39,44
2020,219426,45,0,83,39,44
2020,219426,45,4,83,39,44
2020,219426,50,0,15,5,10
2020,219471,0,0,433,215,218
2020,219471,10,0,417,207,210
2020,219471,10,1,78,57,21
2020,219471,10,2,91,54,37
2020,219471,10,3,116,59,57
2020,219471,10,4,96,22,74
2020,219471,10,5,35,14,21
2020,219471,10,6,1,1,0
2020,219471,20,0,154,107,47
2020,219471,20,1,75,56,19
2020,219471,20,2,79,51,28
2020,219471,30,0,95,50,45
2020,219471,30,2,3,0,3
2020,219471,30,3,91,50,41
2020,219471,30,4,1,0,1
2020,219471,40,0,168,50,118
2020,219471,40,1,3,1,2
2020,219471,40,2,9,3,6
2020,219471,40,3,25,9,16
2020,219471,40,4,95,22,73
2020,219471,40,5,35,14,21
2020,219471,40,6,1,1,0
2020,219471,42,0,168,50,118
2020,219471,42,1,3,1,2
2020,219471,42,2,9,3,6
2020,219471,42,3,25,9,16
2020,219471,42,4,95,22,73
2020,219471,42,5,35,14,21
2020,219471,42,6,1,1,0
2020,219471,50,0,16,8,8
2020,219480,0,0,48,26,22
2020,219480,10,0,48,26,22
2020,219480,10,4,48,26,22
2020,219480,40,0,48,26,22
2020,219480,40,4,48,26,22
2020,219480,42,0,48,26,22
2020,219480,42,4,48,26,22
2020,219505,0,0,3,1,2
2020,219505,10,0,3,1,2
2020,219505,10,1,3,1,2
2020,219505,40,0,3,1,2
2020,219505,40,1,3,1,2
2020,219505,41,0,3,1,2
2020,219505,41,1,3,1,2
2020,219505,45,0,3,1,2
2020,219505,45,1,3,1,2
2020,219602,0,0,391,195,196
2020,219602,10,0,391,195,196
2020,219602,10,1,134,83,51
2020,219602,10,2,100,47,53
2020,219602,10,3,117,50,67
2020,219602,10,4,39,15,24
2020,219602,10,6,1,0,1
2020,219602,20,0,242,125,117
2020,219602,20,1,133,82,51
2020,219602,20,2,89,39,50
2020,219602,20,3,10,2,8
2020,219602,20,4,10,2,8
2020,219602,30,0,108,55,53
2020,219602,30,1,1,1,0
2020,219602,30,2,11,8,3
2020,219602,30,3,93,44,49
2020,219602,30,4,3,2,1
2020,219602,40,0,41,15,26
2020,219602,40,3,14,4,10
2020,219602,40,4,26,11,15
2020,219602,40,6,1,0,1
2020,219602,41,0,5,1,4
2020,219602,41,3,1,1,0
2020,219602,41,4,4,0,4
2020,219602,42,0,35,14,21
2020,219602,42,3,13,3,10
2020,219602,42,4,22,11,11
2020,219602,43,0,1,0,1
2020,219602,43,6,1,0,1
2020,219602,44,0,5,1,4
2020,219602,44,3,1,1,0
2020,219602,44,4,4,0,4
2020,219639,0,0,67,13,54
2020,219639,10,0,67,13,54
2020,219639,10,1,5,1,4
2020,219639,10,2,13,1,12
2020,219639,10,3,38,9,29
2020,219639,10,4,2,0,2
2020,219639,10,6,9,2,7
2020,219639,40,0,67,13,54
2020,219639,40,1,5,1,4
2020,219639,40,2,13,1,12
2020,219639,40,3,38,9,29
2020,219639,40,4,2,0,2
2020,219639,40,6,9,2,7
2020,219639,41,0,67,13,54
2020,219639,41,1,5,1,4
2020,219639,41,2,13,1,12
2020,219639,41,3,38,9,29
2020,219639,41,4,2,0,2
2020,219639,41,6,9,2,7
2020,219639,45,0,67,13,54
2020,219639,45,1,5,1,4
2020,219639,45,2,13,1,12
2020,219639,45,3,38,9,29
2020,219639,45,4,2,0,2
2020,219639,45,6,9,2,7
2020,219709,0,0,383,193,190
2020,219709,10,0,383,193,190
2020,219709,10,1,113,75,38
2020,219709,10,2,127,55,72
2020,219709,10,3,102,41,61
2020,219709,10,4,41,22,19
2020,219709,20,0,231,124,107
2020,219709,20,1,109,71,38
2020,219709,20,2,119,52,67
2020,219709,20,3,3,1,2
2020,219709,30,0,106,45,61
2020,219709,30,1,1,1,0
2020,219709,30,2,6,3,3
2020,219709,30,3,92,38,54
2020,219709,30,4,7,3,4
2020,219709,40,0,46,24,22
2020,219709,40,1,3,3,0
2020,219709,40,2,2,0,2
2020,219709,40,3,7,2,5
2020,219709,40,4,34,19,15
2020,219709,42,0,46,24,22
2020,219709,42,1,3,3,0
2020,219709,42,2,2,0,2
2020,219709,42,3,7,2,5
2020,219709,42,4,34,19,15
2020,219718,0,0,159,88,71
2020,219718,10,0,159,88,71
2020,219718,10,1,20,15,5
2020,219718,10,2,38,18,20
2020,219718,10,3,26,13,13
2020,219718,10,4,9,4,5
2020,219718,10,5,66,38,28
2020,219718,20,0,41,27,14
2020,219718,20,1,19,15,4
2020,219718,20,2,22,12,10
2020,219718,40,0,118,61,57
2020,219718,40,1,1,0,1
2020,219718,40,2,16,6,10
2020,219718,40,3,26,13,13
2020,219718,40,4,9,4,5
2020,219718,40,5,66,38,28
2020,219718,42,0,118,61,57
2020,219718,42,1,1,0,1
2020,219718,42,2,16,6,10
2020,219718,42,3,26,13,13
2020,219718,42,4,9,4,5
2020,219718,42,5,66,38,28
2020,219790,0,0,39,28,11
2020,219790,10,0,39,28,11
2020,219790,10,1,18,16,2
2020,219790,10,2,9,6,3
2020,219790,10,3,8,5,3
2020,219790,10,4,4,1,3
2020,219790,40,0,39,28,11
2020,219790,40,1,18,16,2
2020,219790,40,2,9,6,3
2020,219790,40,3,8,5,3
2020,219790,40,4,4,1,3
2020,219790,42,0,39,28,11
2020,219790,42,1,18,16,2
2020,219790,42,2,9,6,3
2020,219790,42,3,8,5,3
2020,219790,42,4,4,1,3
2020,219806,0,0,115,57,58
2020,219806,10,0,115,57,58
2020,219806,10,1,31,19,12
2020,219806,10,2,38,16,22
2020,219806,10,3,42,20,22
2020,219806,10,4,4,2,2
2020,219806,20,0,51,26,25
2020,219806,20,1,30,18,12
2020,219806,20,2,20,8,12
2020,219806,20,3,1,0,1
2020,219806,30,0,46,23,23
2020,219806,30,2,14,7,7
2020,219806,30,3,31,16,15
2020,219806,30,4,1,0,1
2020,219806,40,0,18,8,10
2020,219806,40,1,1,1,0
2020,219806,40,2,4,1,3
2020,219806,40,3,10,4,6
2020,219806,40,4,3,2,1
2020,219806,42,0,17,8,9
2020,219806,42,1,1,1,0
2020,219806,42,2,4,1,3
2020,219806,42,3,9,4,5
2020,219806,42,4,3,2,1
2020,219806,43,0,1,0,1
2020,219806,43,3,1,0,1
2020,219824,0,0,231,106,125
2020,219824,10,0,231,106,125
2020,219824,10,1,30,11,19
2020,219824,10,2,48,20,28
2020,219824,10,3,47,23,24
2020,219824,10,4,106,52,54
2020,219824,20,0,96,40,56
2020,219824,20,1,29,11,18
2020,219824,20,2,43,18,25
2020,219824,20,3,19,8,11
2020,219824,20,4,5,3,2
2020,219824,30,0,76,33,43
2020,219824,30,2,5,2,3
2020,219824,30,3,19,8,11
2020,219824,30,4,52,23,29
2020,219824,40,0,59,33,26
2020,219824,40,1,1,0,1
2020,219824,40,3,9,7,2
2020,219824,40,4,49,26,23
2020,219824,42,0,59,33,26
2020,219824,42,1,1,0,1
2020,219824,42,3,9,7,2
2020,219824,42,4,49,26,23
2020,219833,0,0,113,71,42
2020,219833,10,0,113,71,42
2020,219833,10,1,29,20,9
2020,219833,10,2,38,26,12
2020,219833,10,3,39,22,17
2020,219833,10,4,7,3,4
2020,219833,20,0,59,42,17
2020,219833,20,1,28,19,9
2020,219833,20,2,31,23,8
2020,219833,30,0,21,14,7
2020,219833,30,1,1,1,0
2020,219833,30,2,2,1,1
2020,219833,30,3,18,12,6
2020,219833,40,0,33,15,18
2020,219833,40,2,5,2,3
2020,219833,40,3,21,10,11
2020,219833,40,4,7,3,4
2020,219833,41,0,9,7,2
2020,219833,41,3,6,5,1
2020,219833,41,4,3,2,1
2020,219833,42,0,22,7,15
2020,219833,42,2,4,2,2
2020,219833,42,3,15,5,10
2020,219833,42,4,3,0,3
2020,219833,43,0,2,1,1
2020,219833,43,2,1,0,1
2020,219833,43,4,1,1,0
2020,219833,44,0,2,2,0
2020,219833,44,3,2,2,0
2020,219833,45,0,7,5,2
2020,219833,45,3,4,3,1
2020,219833,45,4,3,2,1
2020,219842,0,0,9,8,1
2020,219842,10,0,9,8,1
2020,219842,10,1,5,5,0
2020,219842,10,2,2,1,1
2020,219842,10,3,2,2,0
2020,219842,20,0,4,4,0
2020,219842,20,1,4,4,0
2020,219842,40,0,5,4,1
2020,219842,40,1,1,1,0
2020,219842,40,2,2,1,1
2020,219842,40,3,2,2,0
2020,219842,43,0,5,4,1
2020,219842,43,1,1,1,0
2020,219842,43,2,2,1,1
2020,219842,43,3,2,2,0
2020,219879,0,0,78,35,43
2020,219879,10,0,78,35,43
2020,219879,10,1,9,5,4
2020,219879,10,2,34,13,21
2020,219879,10,3,8,5,3
2020,219879,10,4,27,12,15
2020,219879,20,0,40,14,26
2020,219879,20,1,8,5,3
2020,219879,20,2,30,9,21
2020,219879,20,3,1,0,1
2020,219879,20,4,1,0,1
2020,219879,30,0,31,16,15
2020,219879,30,1,1,0,1
2020,219879,30,2,1,1,0
2020,219879,30,3,7,5,2
2020,219879,30,4,22,10,12
2020,219879,40,0,7,5,2
2020,219879,40,2,3,3,0
2020,219879,40,4,4,2,2
2020,219879,41,0,7,5,2
2020,219879,41,2,3,3,0
2020,219879,41,4,4,2,2
2020,219879,44,0,7,5,2
2020,219879,44,2,3,3,0
2020,219879,44,4,4,2,2
2020,219888,0,0,106,42,64
2020,219888,10,0,102,41,61
2020,219888,10,1,12,6,6
2020,219888,10,2,42,22,20
2020,219888,10,3,24,9,15
2020,219888,10,4,24,4,20
2020,219888,20,0,56,29,27
2020,219888,20,1,12,6,6
2020,219888,20,2,36,18,18
2020,219888,20,3,8,5,3
2020,219888,30,0,22,8,14
2020,219888,30,2,5,3,2
2020,219888,30,3,15,4,11
2020,219888,30,4,2,1,1
2020,219888,40,0,24,4,20
2020,219888,40,2,1,1,0
2020,219888,40,3,1,0,1
2020,219888,40,4,22,3,19
2020,219888,42,0,21,4,17
2020,219888,42,2,1,1,0
2020,219888,42,4,20,3,17
2020,219888,43,0,3,0,3
2020,219888,43,3,1,0,1
2020,219888,43,4,2,0,2
2020,219888,50,0,4,1,3
2020,219903,0,0,40,7,33
2020,219903,10,0,40,7,33
2020,219903,10,4,40,7,33
2020,219903,40,0,40,7,33
2020,219903,40,4,40,7,33
2020,219903,41,0,40,7,33
2020,219903,41,4,40,7,33
2020,219903,45,0,40,7,33
2020,219903,45,4,40,7,33
2020,219949,0,0,79,32,47
2020,219949,10,0,79,32,47
2020,219949,10,1,13,10,3
2020,219949,10,2,15,8,7
2020,219949,10,3,34,4,30
2020,219949,10,4,17,10,7
2020,219949,40,0,79,32,47
2020,219949,40,1,13,10,3
2020,219949,40,2,15,8,7
2020,219949,40,3,34,4,30
2020,219949,40,4,17,10,7
2020,219949,42,0,79,32,47
2020,219949,42,1,13,10,3
2020,219949,42,2,15,8,7
2020,219949,42,3,34,4,30
2020,219949,42,4,17,10,7
2020,219976,0,0,232,124,108
2020,219976,10,0,232,124,108
2020,219976,10,1,58,44,14
2020,219976,10,2,76,42,34
2020,219976,10,3,80,33,47
2020,219976,10,4,14,4,10
2020,219976,10,5,4,1,3
2020,219976,20,0,64,46,18
2020,219976,20,1,45,35,10
2020,219976,20,2,19,11,8
2020,219976,30,0,99,50,49
2020,219976,30,1,10,8,2
2020,219976,30,2,39,21,18
2020,219976,30,3,49,20,29
2020,219976,30,4,1,1,0
2020,219976,40,0,69,28,41
2020,219976,40,1,3,1,2
2020,219976,40,2,18,10,8
2020,219976,40,3,31,13,18
2020,219976,40,4,13,3,10
2020,219976,40,5,4,1,3
2020,219976,42,0,69,28,41
2020,219976,42,1,3,1,2
2020,219976,42,2,18,10,8
2020,219976,42,3,31,13,18
2020,219976,42,4,13,3,10
2020,219976,42,5,4,1,3
2020,220057,0,0,47,17,30
2020,220057,10,0,47,17,30
2020,220057,10,1,4,3,1
2020,220057,10,2,24,8,16
2020,220057,10,3,5,2,3
2020,220057,10,4,14,4,10
2020,220057,20,0,27,11,16
2020,220057,20,1,4,3,1
2020,220057,20,2,23,8,15
2020,220057,30,0,17,4,13
2020,220057,30,2,1,0,1
2020,220057,30,3,5,2,3
2020,220057,30,4,11,2,9
2020,220057,40,0,3,2,1
2020,220057,40,4,3,2,1
2020,220057,42,0,3,2,1
2020,220057,42,4,3,2,1
2020,220075,0,0,773,402,371
2020,220075,10,0,773,402,371
2020,220075,10,1,234,162,72
2020,220075,10,2,197,107,90
2020,220075,10,3,236,93,143
2020,220075,10,4,38,6,32
2020,220075,10,5,62,31,31
2020,220075,10,6,6,3,3
2020,220075,20,0,370,233,137
2020,220075,20,1,204,145,59
2020,220075,20,2,151,82,69
2020,220075,20,3,14,5,9
2020,220075,20,4,1,1,0
2020,220075,30,0,132,55,77
2020,220075,30,2,8,4,4
2020,220075,30,3,124,51,73
2020,220075,40,0,271,114,157
2020,220075,40,1,30,17,13
2020,220075,40,2,38,21,17
2020,220075,40,3,98,37,61
2020,220075,40,4,37,5,32
2020,220075,40,5,62,31,31
2020,220075,40,6,6,3,3
2020,220075,42,0,270,113,157
2020,220075,42,1,30,17,13
2020,220075,42,2,38,21,17
2020,220075,42,3,97,36,61
2020,220075,42,4,37,5,32
2020,220075,42,5,62,31,31
2020,220075,42,6,6,3,3
2020,220075,43,0,1,1,0
2020,220075,43,3,1,1,0
2020,220118,0,0,14,2,12
2020,220118,10,0,14,2,12
2020,220118,10,4,14,2,12
2020,220118,40,0,14,2,12
2020,220118,40,4,14,2,12
2020,220118,41,0,14,2,12
2020,220118,41,4,14,2,12
2020,220118,45,0,14,2,12
2020,220118,45,4,14,2,12
2020,220181,0,0,56,27,29
2020,220181,10,0,56,27,29
2020,220181,10,1,9,6,3
2020,220181,10,2,26,12,14
2020,220181,10,3,12,7,5
2020,220181,10,4,8,1,7
2020,220181,10,6,1,1,0
2020,220181,20,0,26,15,11
2020,220181,20,1,7,5,2
2020,220181,20,2,19,10,9
2020,220181,30,0,16,8,8
2020,220181,30,2,6,2,4
2020,220181,30,3,10,6,4
2020,220181,40,0,14,4,10
2020,220181,40,1,2,1,1
2020,220181,40,2,1,0,1
2020,220181,40,3,2,1,1
2020,220181,40,4,8,1,7
2020,220181,40,6,1,1,0
2020,220181,42,0,14,4,10
2020,220181,42,1,2,1,1
2020,220181,42,2,1,0,1
2020,220181,42,3,2,1,1
2020,220181,42,4,8,1,7
2020,220181,42,6,1,1,0
2020,220206,0,0,18,12,6
2020,220206,10,0,18,12,6
2020,220206,10,1,7,4,3
2020,220206,10,2,2,2,0
2020,220206,10,3,2,0,2
2020,220206,10,4,7,6,1
2020,220206,40,0,18,12,6
2020,220206,40,1,7,4,3
2020,220206,40,2,2,2,0
2020,220206,40,3,2,0,2
2020,220206,40,4,7,6,1
2020,220206,43,0,18,12,6
2020,220206,43,1,7,4,3
2020,220206,43,2,2,2,0
2020,220206,43,3,2,0,2
2020,220206,43,4,7,6,1
2020,220215,0,0,99,66,33
2020,220215,10,0,99,66,33
2020,220215,10,1,19,17,2
2020,220215,10,2,32,24,8
2020,220215,10,3,33,17,16
2020,220215,10,4,15,8,7
2020,220215,20,0,54,42,12
2020,220215,20,1,18,16,2
2020,220215,20,2,27,20,7
2020,220215,20,3,9,6,3
2020,220215,30,0,24,13,11
2020,220215,30,1,1,1,0
2020,220215,30,2,5,4,1
2020,220215,30,3,15,6,9
2020,220215,30,4,3,2,1
2020,220215,40,0,21,11,10
2020,220215,40,3,9,5,4
2020,220215,40,4,12,6,6
2020,220215,42,0,21,11,10
2020,220215,42,3,9,5,4
2020,220215,42,4,12,6,6
2020,220400,0,0,93,36,57
2020,220400,10,0,93,36,57
2020,220400,10,1,12,6,6
2020,220400,10,2,57,18,39
2020,220400,10,3,20,9,11
2020,220400,10,4,4,3,1
2020,220400,20,0,51,18,33
2020,220400,20,1,12,6,6
2020,220400,20,2,38,12,26
2020,220400,20,3,1,0,1
2020,220400,30,0,9,1,8
2020,220400,30,2,8,0,8
2020,220400,30,3,1,1,0
2020,220400,40,0,33,17,16
2020,220400,40,2,11,6,5
2020,220400,40,3,18,8,10
2020,220400,40,4,4,3,1
2020,220400,42,0,33,17,16
2020,220400,42,2,11,6,5
2020,220400,42,3,18,8,10
2020,220400,42,4,4,3,1
2020,220473,0,0,41,27,14
2020,220473,10,0,41,27,14
2020,220473,10,1,26,17,9
2020,220473,10,2,9,8,1
2020,220473,10,3,5,2,3
2020,220473,10,4,1,0,1
2020,220473,40,0,41,27,14
2020,220473,40,1,26,17,9
2020,220473,40,2,9,8,1
2020,220473,40,3,5,2,3
2020,220473,40,4,1,0,1
2020,220473,42,0,41,27,14
2020,220473,42,1,26,17,9
2020,220473,42,2,9,8,1
2020,220473,42,3,5,2,3
2020,220473,42,4,1,0,1
2020,220516,0,0,84,29,55
2020,220516,10,0,84,29,55
2020,220516,10,1,14,9,5
2020,220516,10,2,30,10,20
2020,220516,10,3,36,9,27
2020,220516,10,4,4,1,3
2020,220516,40,0,84,29,55
2020,220516,40,1,14,9,5
2020,220516,40,2,30,10,20
2020,220516,40,3,36,9,27
2020,220516,40,4,4,1,3
2020,220516,41,0,44,23,21
2020,220516,41,1,14,9,5
2020,220516,41,2,22,10,12
2020,220516,41,3,8,4,4
2020,220516,42,0,40,6,34
2020,220516,42,2,8,0,8
2020,220516,42,3,28,5,23
2020,220516,42,4,4,1,3
2020,220516,44,0,44,23,21
2020,220516,44,1,14,9,5
2020,220516,44,2,22,10,12
2020,220516,44,3,8,4,4
2020,220552,0,0,237,72,165
2020,220552,10,0,237,72,165
2020,220552,10,1,14,9,5
2020,220552,10,2,47,13,34
2020,220552,10,3,101,30,71
2020,220552,10,4,65,20,45
2020,220552,10,6,10,0,10
2020,220552,40,0,237,72,165
2020,220552,40,1,14,9,5
2020,220552,40,2,47,13,34
2020,220552,40,3,101,30,71
2020,220552,40,4,65,20,45
2020,220552,40,6,10,0,10
2020,220552,41,0,237,72,165
2020,220552,41,1,14,9,5
2020,220552,41,2,47,13,34
2020,220552,41,3,101,30,71
2020,220552,41,4,65,20,45
2020,220552,41,6,10,0,10
2020,220552,45,0,237,72,165
2020,220552,45,1,14,9,5
2020,220552,45,2,47,13,34
2020,220552,45,3,101,30,71
2020,220552,45,4,65,20,45
2020,220552,45,6,10,0,10
2020,220598,0,0,57,40,17
2020,220598,10,0,57,40,17
2020,220598,10,1,1,1,0
2020,220598,10,2,12,9,3
2020,220598,10,3,39,25,14
2020,220598,10,4,5,5,0
2020,220598,20,0,8,5,3
2020,220598,20,1,1,1,0
2020,220598,20,2,7,4,3
2020,220598,30,0,21,15,6
2020,220598,30,2,3,3,0
2020,220598,30,3,18,12,6
2020,220598,40,0,28,20,8
2020,220598,40,2,2,2,0
2020,220598,40,3,21,13,8
2020,220598,40,4,5,5,0
2020,220598,42,0,28,20,8
2020,220598,42,2,2,2,0
2020,220598,42,3,21,13,8
2020,220598,42,4,5,5,0
2020,220604,0,0,39,20,19
2020,220604,10,0,39,20,19
2020,220604,10,1,8,5,3
2020,220604,10,2,8,4,4
2020,220604,10,3,15,7,8
2020,220604,10,4,8,4,4
2020,220604,20,0,20,10,10
2020,220604,20,1,8,5,3
2020,220604,20,2,6,2,4
2020,220604,20,3,6,3,3
2020,220604,30,0,5,1,4
2020,220604,30,2,1,1,0
2020,220604,30,3,4,0,4
2020,220604,40,0,14,9,5
2020,220604,40,2,1,1,0
2020,220604,40,3,5,4,1
2020,220604,40,4,8,4,4
2020,220604,42,0,14,9,5
2020,220604,42,2,1,1,0
2020,220604,42,3,5,4,1
2020,220604,42,4,8,4,4
2020,220613,0,0,184,103,81
2020,220613,10,0,184,103,81
2020,220613,10,1,50,36,14
2020,220613,10,2,55,41,14
2020,220613,10,3,48,19,29
2020,220613,10,5,31,7,24
2020,220613,20,0,99,73,26
2020,220613,20,1,49,35,14
2020,220613,20,2,47,36,11
2020,220613,20,3,3,2,1
2020,220613,30,0,51,21,30
2020,220613,30,1,1,1,0
2020,220613,30,2,7,4,3
2020,220613,30,3,43,16,27
2020,220613,40,0,34,9,25
2020,220613,40,2,1,1,0
2020,220613,40,3,2,1,1
2020,220613,40,5,31,7,24
2020,220613,42,0,34,9,25
2020,220613,42,2,1,1,0
2020,220613,42,3,2,1,1
2020,220613,42,5,31,7,24
2020,220631,0,0,313,131,182
2020,220631,10,0,303,126,177
2020,220631,10,1,24,14,10
2020,220631,10,2,85,46,39
2020,220631,10,3,132,53,79
2020,220631,10,4,49,6,43
2020,220631,10,5,13,7,6
2020,220631,20,0,5,3,2
2020,220631,20,1,4,3,1
2020,220631,20,3,1,0,1
2020,220631,30,0,2,2,0
2020,220631,30,1,1,1,0
2020,220631,30,2,1,1,0
2020,220631,40,0,296,121,175
2020,220631,40,1,19,10,9
2020,220631,40,2,84,45,39
2020,220631,40,3,131,53,78
2020,220631,40,4,49,6,43
2020,220631,40,5,13,7,6
2020,220631,42,0,151,70,81
2020,220631,42,1,11,6,5
2020,220631,42,2,56,31,25
2020,220631,42,3,62,26,36
2020,220631,42,4,11,1,10
2020,220631,42,5,11,6,5
2020,220631,43,0,145,51,94
2020,220631,43,1,8,4,4
2020,220631,43,2,28,14,14
2020,220631,43,3,69,27,42
2020,220631,43,4,38,5,33
2020,220631,43,5,2,1,1
2020,220631,50,0,10,5,5
2020,220701,0,0,42,22,20
2020,220701,10,0,42,22,20
2020,220701,10,1,9,5,4
2020,220701,10,2,9,5,4
2020,220701,10,3,16,8,8
2020,220701,10,4,8,4,4
2020,220701,20,0,15,8,7
2020,220701,20,1,8,5,3
2020,220701,20,2,7,3,4
2020,220701,30,0,18,9,9
2020,220701,30,1,1,0,1
2020,220701,30,2,1,1,0
2020,220701,30,3,16,8,8
2020,220701,40,0,9,5,4
2020,220701,40,2,1,1,0
2020,220701,40,4,8,4,4
2020,220701,42,0,3,1,2
2020,220701,42,2,1,1,0
2020,220701,42,4,2,0,2
2020,220701,43,0,6,4,2
2020,220701,43,4,6,4,2
2020,220710,0,0,74,36,38
2020,220710,10,0,74,36,38
2020,220710,10,1,18,9,9
2020,220710,10,2,25,13,12
2020,220710,10,3,18,9,9
2020,220710,10,5,13,5,8
2020,220710,20,0,44,23,21
2020,220710,20,1,18,9,9
2020,220710,20,2,23,12,11
2020,220710,20,3,3,2,1
2020,220710,30,0,17,8,9
2020,220710,30,2,2,1,1
2020,220710,30,3,15,7,8
2020,220710,40,0,13,5,8
2020,220710,40,5,13,5,8
2020,220710,41,0,3,0,3
2020,220710,41,5,3,0,3
2020,220710,42,0,10,5,5
2020,220710,42,5,10,5,5
2020,220710,44,0,3,0,3
2020,220710,44,5,3,0,3
2020,220792,0,0,200,111,89
2020,220792,10,0,200,111,89
2020,220792,10,1,51,31,20
2020,220792,10,2,59,44,15
2020,220792,10,3,84,32,52
2020,220792,10,4,6,4,2
2020,220792,20,0,33,20,13
2020,220792,20,1,11,7,4
2020,220792,20,2,9,6,3
2020,220792,20,3,12,7,5
2020,220792,20,4,1,0,1
2020,220792,30,0,24,14,10
2020,220792,30,1,10,8,2
2020,220792,30,2,5,3,2
2020,220792,30,3,9,3,6
2020,220792,40,0,143,77,66
2020,220792,40,1,30,16,14
2020,220792,40,2,45,35,10
2020,220792,40,3,63,22,41
2020,220792,40,4,5,4,1
2020,220792,42,0,143,77,66
2020,220792,42,1,30,16,14
2020,220792,42,2,45,35,10
2020,220792,42,3,63,22,41
2020,220792,42,4,5,4,1
2020,220862,0,0,886,461,425
2020,220862,10,0,886,461,425
2020,220862,10,1,197,131,66
2020,220862,10,2,255,140,115
2020,220862,10,3,243,110,133
2020,220862,10,4,191,80,111
2020,220862,20,0,416,264,152
2020,220862,20,1,182,128,54
2020,220862,20,2,231,135,96
2020,220862,20,3,3,1,2
2020,220862,30,0,181,98,83
2020,220862,30,1,2,1,1
2020,220862,30,2,2,1,1
2020,220862,30,3,177,96,81
2020,220862,40,0,289,99,190
2020,220862,40,1,13,2,11
2020,220862,40,2,22,4,18
2020,220862,40,3,63,13,50
2020,220862,40,4,191,80,111
2020,220862,41,0,98,17,81
2020,220862,41,1,10,0,10
2020,220862,41,2,22,4,18
2020,220862,41,3,37,4,33
2020,220862,41,4,29,9,20
2020,220862,42,0,190,82,108
2020,220862,42,1,3,2,1
2020,220862,42,3,26,9,17
2020,220862,42,4,161,71,90
2020,220862,43,0,1,0,1
2020,220862,43,4,1,0,1
2020,220862,45,0,98,17,81
2020,220862,45,1,10,0,10
2020,220862,45,2,22,4,18
2020,220862,45,3,37,4,33
2020,220862,45,4,29,9,20
2020,220871,0,0,10,5,5
2020,220871,10,0,10,5,5
2020,220871,10,1,5,3,2
2020,220871,10,2,3,2,1
2020,220871,10,3,2,0,2
2020,220871,20,0,5,3,2
2020,220871,20,1,5,3,2
2020,220871,30,0,3,1,2
2020,220871,30,2,2,1,1
2020,220871,30,3,1,0,1
2020,220871,40,0,2,1,1
2020,220871,40,2,1,1,0
2020,220871,40,3,1,0,1
2020,220871,41,0,1,1,0
2020,220871,41,2,1,1,0
2020,220871,42,0,1,0,1
2020,220871,42,3,1,0,1
2020,220871,44,0,1,1,0
2020,220871,44,2,1,1,0
2020,220978,0,0,946,494,452
2020,220978,10,0,946,494,452
2020,220978,10,1,341,209,132
2020,220978,10,2,225,123,102
2020,220978,10,3,183,90,93
2020,220978,10,4,51,17,34
2020,220978,10,5,146,55,91
2020,220978,20,0,543,318,225
2020,220978,20,1,337,206,131
2020,220978,20,2,205,111,94
2020,220978,20,3,1,1,0
2020,220978,30,0,180,93,87
2020,220978,30,2,13,7,6
2020,220978,30,3,167,86,81
2020,220978,40,0,223,83,140
2020,220978,40,1,4,3,1
2020,220978,40,2,7,5,2
2020,220978,40,3,15,3,12
2020,220978,40,4,51,17,34
2020,220978,40,5,146,55,91
2020,220978,41,0,75,27,48
2020,220978,41,1,4,3,1
2020,220978,41,2,6,4,2
2020,220978,41,3,15,3,12
2020,220978,41,4,50,17,33
2020,220978,42,0,143,53,90
2020,220978,42,2,1,1,0
2020,220978,42,4,1,0,1
2020,220978,42,5,141,52,89
2020,220978,43,0,5,3,2
2020,220978,43,5,5,3,2
2020,220978,44,0,1,1,0
2020,220978,44,4,1,1,0
2020,220978,45,0,74,26,48
2020,220978,45,1,4,3,1
2020,220978,45,2,6,4,2
2020,220978,45,3,15,3,12
2020,220978,45,4,49,16,33
2020,220996,0,0,6,3,3
2020,220996,10,0,6,3,3
2020,220996,10,1,6,3,3
2020,220996,40,0,6,3,3
2020,220996,40,1,6,3,3
2020,220996,41,0,6,3,3
2020,220996,41,1,6,3,3
2020,220996,44,0,1,1,0
2020,220996,44,1,1,1,0
2020,220996,45,0,5,2,3
2020,220996,45,1,5,2,3
2020,221096,0,0,131,64,67
2020,221096,10,0,131,64,67
2020,221096,10,1,8,4,4
2020,221096,10,2,44,17,27
2020,221096,10,3,26,10,16
2020,221096,10,4,53,33,20
2020,221096,20,0,50,21,29
2020,221096,20,1,8,4,4
2020,221096,20,2,42,17,25
2020,221096,30,0,70,35,35
2020,221096,30,2,2,0,2
2020,221096,30,3,25,9,16
2020,221096,30,4,43,26,17
2020,221096,40,0,11,8,3
2020,221096,40,3,1,1,0
2020,221096,40,4,10,7,3
2020,221096,42,0,11,8,3
2020,221096,42,3,1,1,0
2020,221096,42,4,10,7,3
2020,221148,0,0,55,55,0
2020,221148,10,0,55,55,0
2020,221148,10,4,55,55,0
2020,221148,40,0,55,55,0
2020,221148,40,4,55,55,0
2020,221148,41,0,55,55,0
2020,221148,41,4,55,55,0
2020,221148,45,0,55,55,0
2020,221148,45,4,55,55,0
2020,221184,0,0,144,65,79
2020,221184,10,0,144,65,79
2020,221184,10,1,8,5,3
2020,221184,10,2,48,22,26
2020,221184,10,3,47,18,29
2020,221184,10,4,41,20,21
2020,221184,20,0,32,18,14
2020,221184,20,1,5,4,1
2020,221184,20,2,23,11,12
2020,221184,20,3,4,3,1
2020,221184,30,0,5,2,3
2020,221184,30,1,1,1,0
2020,221184,30,2,4,1,3
2020,221184,40,0,107,45,62
2020,221184,40,1,2,0,2
2020,221184,40,2,21,10,11
2020,221184,40,3,43,15,28
2020,221184,40,4,41,20,21
2020,221184,41,0,40,15,25
2020,221184,41,2,6,4,2
2020,221184,41,3,13,4,9
2020,221184,41,4,21,7,14
2020,221184,42,0,56,23,33
2020,221184,42,1,2,0,2
2020,221184,42,2,15,6,9
2020,221184,42,3,28,10,18
2020,221184,42,4,11,7,4
2020,221184,43,0,11,7,4
2020,221184,43,3,2,1,1
2020,221184,43,4,9,6,3
2020,221184,44,0,40,15,25
2020,221184,44,2,6,4,2
2020,221184,44,3,13,4,9
2020,221184,44,4,21,7,14
2020,221351,0,0,182,96,86
2020,221351,10,0,182,96,86
2020,221351,10,1,40,30,10
2020,221351,10,2,69,32,37
2020,221351,10,3,69,34,35
2020,221351,10,4,4,0,4
2020,221351,20,0,106,62,44
2020,221351,20,1,40,30,10
2020,221351,20,2,66,32,34
2020,221351,30,0,52,26,26
2020,221351,30,3,52,26,26
2020,221351,40,0,24,8,16
2020,221351,40,2,3,0,3
2020,221351,40,3,17,8,9
2020,221351,40,4,4,0,4
2020,221351,42,0,24,8,16
2020,221351,42,2,3,0,3
2020,221351,42,3,17,8,9
2020,221351,42,4,4,0,4
2020,221397,0,0,112,41,71
2020,221397,10,0,112,41,71
2020,221397,10,1,20,11,9
2020,221397,10,2,51,23,28
2020,221397,10,3,34,3,31
2020,221397,10,4,7,4,3
2020,221397,20,0,66,33,33
2020,221397,20,1,18,11,7
2020,221397,20,2,45,20,25
2020,221397,20,3,1,0,1
2020,221397,20,4,2,2,0
2020,221397,30,0,34,4,30
2020,221397,30,3,33,3,30
2020,221397,30,4,1,1,0
2020,221397,40,0,12,4,8
2020,221397,40,1,2,0,2
2020,221397,40,2,6,3,3
2020,221397,40,4,4,1,3
2020,221397,41,0,2,1,1
2020,221397,41,4,2,1,1
2020,221397,43,0,10,3,7
2020,221397,43,1,2,0,2
2020,221397,43,2,6,3,3
2020,221397,43,4,2,0,2
2020,221397,44,0,1,0,1
2020,221397,44,4,1,0,1
2020,221397,45,0,1,1,0
2020,221397,45,4,1,1,0
2020,221485,0,0,189,79,110
2020,221485,10,0,189,79,110
2020,221485,10,1,17,4,13
2020,221485,10,2,65,27,38
2020,221485,10,3,56,26,30
2020,221485,10,4,49,22,27
2020,221485,10,6,2,0,2
2020,221485,20,0,75,30,45
2020,221485,20,1,17,4,13
2020,221485,20,2,45,18,27
2020,221485,20,3,9,5,4
2020,221485,20,4,4,3,1
2020,221485,30,0,20,8,12
2020,221485,30,2,4,2,2
2020,221485,30,3,11,5,6
2020,221485,30,4,4,1,3
2020,221485,30,6,1,0,1
2020,221485,40,0,94,41,53
2020,221485,40,2,16,7,9
2020,221485,40,3,36,16,20
2020,221485,40,4,41,18,23
2020,221485,40,6,1,0,1
2020,221485,42,0,94,41,53
2020,221485,42,2,16,7,9
2020,221485,42,3,36,16,20
2020,221485,42,4,41,18,23
2020,221485,42,6,1,0,1
2020,221519,0,0,170,98,72
2020,221519,10,0,170,98,72
2020,221519,10,1,57,33,24
2020,221519,10,2,49,32,17
2020,221519,10,3,60,32,28
2020,221519,10,4,4,1,3
2020,221519,20,0,99,60,39
2020,221519,20,1,55,32,23
2020,221519,20,2,44,28,16
2020,221519,30,0,39,21,18
2020,221519,30,3,39,21,18
2020,221519,40,0,32,17,15
2020,221519,40,1,2,1,1
2020,221519,40,2,5,4,1
2020,221519,40,3,21,11,10
2020,221519,40,4,4,1,3
2020,221519,41,0,6,4,2
2020,221519,41,2,2,1,1
2020,221519,41,3,2,2,0
2020,221519,41,4,2,1,1
2020,221519,42,0,26,13,13
2020,221519,42,1,2,1,1
2020,221519,42,2,3,3,0
2020,221519,42,3,19,9,10
2020,221519,42,4,2,0,2
2020,221519,44,0,6,4,2
2020,221519,44,2,2,1,1
2020,221519,44,3,2,2,0
2020,221519,44,4,2,1,1
2020,221643,0,0,231,90,141
2020,221643,10,0,231,90,141
2020,221643,10,1,30,15,15
2020,221643,10,2,136,47,89
2020,221643,10,3,28,11,17
2020,221643,10,4,37,17,20
2020,221643,20,0,159,61,98
2020,221643,20,1,30,15,15
2020,221643,20,2,124,45,79
2020,221643,20,3,5,1,4
2020,221643,30,0,64,24,40
2020,221643,30,2,12,2,10
2020,221643,30,3,21,9,12
2020,221643,30,4,31,13,18
2020,221643,40,0,8,5,3
2020,221643,40,3,2,1,1
2020,221643,40,4,6,4,2
2020,221643,42,0,8,5,3
2020,221643,42,3,2,1,1
2020,221643,42,4,6,4,2
2020,221661,0,0,139,65,74
2020,221661,10,0,138,65,73
2020,221661,10,1,60,32,28
2020,221661,10,2,56,29,27
2020,221661,10,3,22,4,18
2020,221661,40,0,138,65,73
2020,221661,40,1,60,32,28
2020,221661,40,2,56,29,27
2020,221661,40,3,22,4,18
2020,221661,42,0,138,65,73
2020,221661,42,1,60,32,28
2020,221661,42,2,56,29,27
2020,221661,42,3,22,4,18
2020,221661,50,0,1,0,1
2020,221670,0,0,53,22,31
2020,221670,10,0,53,22,31
2020,221670,10,1,12,9,3
2020,221670,10,2,22,7,15
2020,221670,10,3,11,4,7
2020,221670,10,4,8,2,6
2020,221670,40,0,53,22,31
2020,221670,40,1,12,9,3
2020,221670,40,2,22,7,15
2020,221670,40,3,11,4,7
2020,221670,40,4,8,2,6
2020,221670,41,0,53,22,31
2020,221670,41,1,12,9,3
2020,221670,41,2,22,7,15
2020,221670,41,3,11,4,7
2020,221670,41,4,8,2,6
2020,221670,45,0,53,22,31
2020,221670,45,1,12,9,3
2020,221670,45,2,22,7,15
2020,221670,45,3,11,4,7
2020,221670,45,4,8,2,6
2020,221731,0,0,71,30,41
2020,221731,10,0,71,30,41
2020,221731,10,1,15,8,7
2020,221731,10,2,17,9,8
2020,221731,10,3,38,13,25
2020,221731,10,4,1,0,1
2020,221731,20,0,23,13,10
2020,221731,20,1,15,8,7
2020,221731,20,2,8,5,3
2020,221731,30,0,22,11,11
2020,221731,30,2,3,2,1
2020,221731,30,3,19,9,10
2020,221731,40,0,26,6,20
2020,221731,40,2,6,2,4
2020,221731,40,3,19,4,15
2020,221731,40,4,1,0,1
2020,221731,42,0,26,6,20
2020,221731,42,2,6,2,4
2020,221731,42,3,19,4,15
2020,221731,42,4,1,0,1
2020,221740,0,0,498,256,242
2020,221740,10,0,498,256,242
2020,221740,10,1,130,82,48
2020,221740,10,2,102,58,44
2020,221740,10,3,132,56,76
2020,221740,10,4,2,1,1
2020,221740,10,5,129,58,71
2020,221740,10,6,3,1,2
2020,221740,20,0,216,129,87
2020,221740,20,1,128,81,47
2020,221740,20,2,87,47,40
2020,221740,20,3,1,1,0
2020,221740,30,0,126,60,66
2020,221740,30,1,1,1,0
2020,221740,30,2,12,9,3
2020,221740,30,3,113,50,63
2020,221740,40,0,156,67,89
2020,221740,40,1,1,0,1
2020,221740,40,2,3,2,1
2020,221740,40,3,18,5,13
2020,221740,40,4,2,1,1
2020,221740,40,5,129,58,71
2020,221740,40,6,3,1,2
2020,221740,42,0,156,67,89
2020,221740,42,1,1,0,1
2020,221740,42,2,3,2,1
2020,221740,42,3,18,5,13
2020,221740,42,4,2,1,1
2020,221740,42,5,129,58,71
2020,221740,42,6,3,1,2
2020,221759,0,0,1665,898,767
2020,221759,10,0,1665,898,767
2020,221759,10,1,521,361,160
2020,221759,10,2,405,216,189
2020,221759,10,3,343,165,178
2020,221759,10,4,29,3,26
2020,221759,10,5,360,150,210
2020,221759,10,6,7,3,4
2020,221759,20,0,834,545,289
2020,221759,20,1,500,352,148
2020,221759,20,2,334,193,141
2020,221759,30,0,293,162,131
2020,221759,30,1,4,3,1
2020,221759,30,2,29,16,13
2020,221759,30,3,260,143,117
2020,221759,40,0,538,191,347
2020,221759,40,1,17,6,11
2020,221759,40,2,42,7,35
2020,221759,40,3,83,22,61
2020,221759,40,4,29,3,26
2020,221759,40,5,360,150,210
2020,221759,40,6,7,3,4
2020,221759,41,0,518,184,334
2020,221759,41,1,17,6,11
2020,221759,41,2,42,7,35
2020,221759,41,3,83,22,61
2020,221759,41,4,29,3,26
2020,221759,41,5,346,145,201
2020,221759,41,6,1,1,0
2020,221759,43,0,20,7,13
2020,221759,43,5,14,5,9
2020,221759,43,6,6,2,4
2020,221759,45,0,518,184,334
2020,221759,45,1,17,6,11
2020,221759,45,2,42,7,35
2020,221759,45,3,83,22,61
2020,221759,45,4,29,3,26
2020,221759,45,5,346,145,201
2020,221759,45,6,1,1,0
2020,221768,0,0,293,167,126
2020,221768,10,0,293,167,126
2020,221768,10,1,91,60,31
2020,221768,10,2,70,40,30
2020,221768,10,3,54,33,21
2020,221768,10,4,10,7,3
2020,221768,10,5,68,27,41
2020,221768,20,0,163,100,63
2020,221768,20,1,91,60,31
2020,221768,20,2,61,34,27
2020,221768,20,3,5,1,4
2020,221768,20,4,6,5,1
2020,221768,30,0,53,36,17
2020,221768,30,2,7,6,1
2020,221768,30,3,44,28,16
2020,221768,30,4,2,2,0
2020,221768,40,0,77,31,46
2020,221768,40,2,2,0,2
2020,221768,40,3,5,4,1
2020,221768,40,4,2,0,2
2020,221768,40,5,68,27,41
2020,221768,42,0,77,31,46
2020,221768,42,2,2,0,2
2020,221768,42,3,5,4,1
2020,221768,42,4,2,0,2
2020,221768,42,5,68,27,41
2020,221838,0,0,366,196,170
2020,221838,10,0,366,196,170
2020,221838,10,1,108,69,39
2020,221838,10,2,116,62,54
2020,221838,10,3,85,40,45
2020,221838,10,4,5,3,2
2020,221838,10,6,52,22,30
2020,221838,20,0,227,132,95
2020,221838,20,1,100,62,38
2020,221838,20,2,103,56,47
2020,221838,20,3,22,13,9
2020,221838,20,4,1,1,0
2020,221838,20,6,1,0,1
2020,221838,30,0,121,58,63
2020,221838,30,1,8,7,1
2020,221838,30,2,13,6,7
2020,221838,30,3,62,26,36
2020,221838,30,4,2,1,1
2020,221838,30,6,36,18,18
2020,221838,40,0,18,6,12
2020,221838,40,3,1,1,0
2020,221838,40,4,2,1,1
2020,221838,40,6,15,4,11
2020,221838,41,0,6,3,3
2020,221838,41,3,1,1,0
2020,221838,41,6,5,2,3
2020,221838,42,0,12,3,9
2020,221838,42,4,2,1,1
2020,221838,42,6,10,2,8
2020,221838,44,0,6,3,3
2020,221838,44,3,1,1,0
2020,221838,44,6,5,2,3
2020,221847,0,0,446,262,184
2020,221847,10,0,446,262,184
2020,221847,10,1,131,100,31
2020,221847,10,2,117,68,49
2020,221847,10,3,89,49,40
2020,221847,10,4,45,18,27
2020,221847,10,5,64,27,37
2020,221847,20,0,273,179,94
2020,221847,20,1,131,100,31
2020,221847,20,2,110,62,48
2020,221847,20,3,13,6,7
2020,221847,20,4,19,11,8
2020,221847,30,0,83,49,34
2020,221847,30,2,7,6,1
2020,221847,30,3,76,43,33
2020,221847,40,0,90,34,56
2020,221847,40,4,26,7,19
2020,221847,40,5,64,27,37
2020,221847,41,0,64,27,37
2020,221847,41,5,64,27,37
2020,221847,42,0,26,7,19
2020,221847,42,4,26,7,19
2020,221847,44,0,64,27,37
2020,221847,44,5,64,27,37
2020,221892,0,0,94,55,39
2020,221892,10,0,94,55,39
2020,221892,10,1,35,25,10
2020,221892,10,2,35,22,13
2020,221892,10,3,22,7,15
2020,221892,10,4,2,1,1
2020,221892,20,0,24,19,5
2020,221892,20,1,20,15,5
2020,221892,20,2,4,4,0
2020,221892,30,0,70,36,34
2020,221892,30,1,15,10,5
2020,221892,30,2,31,18,13
2020,221892,30,3,22,7,15
2020,221892,30,4,2,1,1
2020,221908,0,0,128,61,67
2020,221908,10,0,128,61,67
2020,221908,10,1,9,5,4
2020,221908,10,2,58,28,30
2020,221908,10,3,23,10,13
2020,221908,10,4,38,18,20
2020,221908,20,0,56,26,30
2020,221908,20,1,9,5,4
2020,221908,20,2,47,21,26
2020,221908,30,0,11,4,7
2020,221908,30,2,7,4,3
2020,221908,30,3,4,0,4
2020,221908,40,0,61,31,30
2020,221908,40,2,4,3,1
2020,221908,40,3,19,10,9
2020,221908,40,4,38,18,20
2020,221908,42,0,61,31,30
2020,221908,42,2,4,3,1
2020,221908,42,3,19,10,9
2020,221908,42,4,38,18,20
2020,221953,0,0,64,33,31
2020,221953,10,0,64,33,31
2020,221953,10,1,5,3,2
2020,221953,10,2,21,12,9
2020,221953,10,3,34,15,19
2020,221953,10,4,4,3,1
2020,221953,40,0,64,33,31
2020,221953,40,1,5,3,2
2020,221953,40,2,21,12,9
2020,221953,40,3,34,15,19
2020,221953,40,4,4,3,1
2020,221953,41,0,31,17,14
2020,221953,41,1,5,3,2
2020,221953,41,2,18,10,8
2020,221953,41,3,8,4,4
2020,221953,42,0,33,16,17
2020,221953,42,2,3,2,1
2020,221953,42,3,26,11,15
2020,221953,42,4,4,3,1
2020,221953,44,0,31,17,14
2020,221953,44,1,5,3,2
2020,221953,44,2,18,10,8
2020,221953,44,3,8,4,4
2020,221971,0,0,223,116,107
2020,221971,10,0,209,113,96
2020,221971,10,1,84,59,25
2020,221971,10,2,53,22,31
2020,221971,10,3,72,32,40
2020,221971,20,0,96,68,28
2020,221971,20,1,76,54,22
2020,221971,20,2,20,14,6
2020,221971,30,0,103,39,64
2020,221971,30,1,6,3,3
2020,221971,30,2,30,7,23
2020,221971,30,3,67,29,38
2020,221971,40,0,10,6,4
2020,221971,40,1,2,2,0
2020,221971,40,2,3,1,2
2020,221971,40,3,5,3,2
2020,221971,41,0,8,5,3
2020,221971,41,1,2,2,0
2020,221971,41,2,3,1,2
2020,221971,41,3,3,2,1
2020,221971,42,0,2,1,1
2020,221971,42,3,2,1,1
2020,221971,44,0,8,5,3
2020,221971,44,1,2,2,0
2020,221971,44,2,3,1,2
2020,221971,44,3,3,2,1
2020,221971,50,0,14,3,11
2020,221999,0,0,1249,667,582
2020,221999,10,0,1249,667,582
2020,221999,10,1,483,347,136
2020,221999,10,2,275,140,135
2020,221999,10,3,280,111,169
2020,221999,10,4,40,7,33
2020,221999,10,5,160,60,100
2020,221999,10,6,11,2,9
2020,221999,20,0,619,431,188
2020,221999,20,1,420,315,105
2020,221999,20,2,199,116,83
2020,221999,30,0,176,85,91
2020,221999,30,2,2,0,2
2020,221999,30,3,174,85,89
2020,221999,40,0,454,151,303
2020,221999,40,1,63,32,31
2020,221999,40,2,74,24,50
2020,221999,40,3,106,26,80
2020,221999,40,4,40,7,33
2020,221999,40,5,160,60,100
2020,221999,40,6,11,2,9
2020,221999,41,0,358,125,233
2020,221999,41,1,59,28,31
2020,221999,41,2,71,22,49
2020,221999,41,3,89,25,64
2020,221999,41,4,2,0,2
2020,221999,41,5,126,48,78
2020,221999,41,6,11,2,9
2020,221999,42,0,81,20,61
2020,221999,42,1,1,1,0
2020,221999,42,2,2,1,1
2020,221999,42,3,15,1,14
2020,221999,42,4,35,6,29
2020,221999,42,5,28,11,17
2020,221999,43,0,15,6,9
2020,221999,43,1,3,3,0
2020,221999,43,2,1,1,0
2020,221999,43,3,2,0,2
2020,221999,43,4,3,1,2
2020,221999,43,5,6,1,5
2020,221999,44,0,358,125,233
2020,221999,44,1,59,28,31
2020,221999,44,2,71,22,49
2020,221999,44,3,89,25,64
2020,221999,44,4,2,0,2
2020,221999,44,5,126,48,78
2020,221999,44,6,11,2,9
2020,222053,0,0,188,86,102
2020,222053,10,0,188,86,102
2020,222053,10,1,22,13,9
2020,222053,10,2,82,34,48
2020,222053,10,3,34,14,20
2020,222053,10,4,50,25,25
2020,222053,20,0,90,42,48
2020,222053,20,1,21,13,8
2020,222053,20,2,66,29,37
2020,222053,20,3,2,0,2
2020,222053,20,4,1,0,1
2020,222053,30,0,40,14,26
2020,222053,30,2,3,0,3
2020,222053,30,3,16,5,11
2020,222053,30,4,21,9,12
2020,222053,40,0,58,30,28
2020,222053,40,1,1,0,1
2020,222053,40,2,13,5,8
2020,222053,40,3,16,9,7
2020,222053,40,4,28,16,12
2020,222053,42,0,20,10,10
2020,222053,42,1,1,0,1
2020,222053,42,2,2,1,1
2020,222053,42,3,5,3,2
2020,222053,42,4,12,6,6
2020,222053,43,0,38,20,18
2020,222053,43,2,11,4,7
2020,222053,43,3,11,6,5
2020,222053,43,4,16,10,6
2020,222062,0,0,162,64,98
2020,222062,10,0,162,64,98
2020,222062,10,1,26,13,13
2020,222062,10,2,69,23,46
2020,222062,10,3,43,17,26
2020,222062,10,4,24,11,13
2020,222062,20,0,50,17,33
2020,222062,20,1,20,8,12
2020,222062,20,2,29,9,20
2020,222062,20,3,1,0,1
2020,222062,30,0,30,9,21
2020,222062,30,1,5,4,1
2020,222062,30,2,20,5,15
2020,222062,30,3,5,0,5
2020,222062,40,0,82,38,44
2020,222062,40,1,1,1,0
2020,222062,40,2,20,9,11
2020,222062,40,3,37,17,20
2020,222062,40,4,24,11,13
2020,222062,42,0,82,38,44
2020,222062,42,1,1,1,0
2020,222062,42,2,20,9,11
2020,222062,42,3,37,17,20
2020,222062,42,4,24,11,13
2020,222105,0,0,18,17,1
2020,222105,10,0,18,17,1
2020,222105,10,4,18,17,1
2020,222105,40,0,18,17,1
2020,222105,40,4,18,17,1
2020,222105,41,0,18,17,1
2020,222105,41,4,18,17,1
2020,222105,45,0,18,17,1
2020,222105,45,4,18,17,1
2020,222178,0,0,272,153,119
2020,222178,10,0,272,153,119
2020,222178,10,1,68,54,14
2020,222178,10,2,77,51,26
2020,222178,10,3,60,28,32
2020,222178,10,4,30,7,23
2020,222178,10,6,37,13,24
2020,222178,20,0,135,100,35
2020,222178,20,1,66,54,12
2020,222178,20,2,64,42,22
2020,222178,20,3,5,4,1
2020,222178,30,0,50,23,27
2020,222178,30,2,5,4,1
2020,222178,30,3,42,19,23
2020,222178,30,6,3,0,3
2020,222178,40,0,87,30,57
2020,222178,40,1,2,0,2
2020,222178,40,2,8,5,3
2020,222178,40,3,13,5,8
2020,222178,40,4,30,7,23
2020,222178,40,6,34,13,21
2020,222178,41,0,1,1,0
2020,222178,41,6,1,1,0
2020,222178,42,0,86,29,57
2020,222178,42,1,2,0,2
2020,222178,42,2,8,5,3
2020,222178,42,3,13,5,8
2020,222178,42,4,30,7,23
2020,222178,42,6,33,12,21
2020,222178,44,0,1,1,0
2020,222178,44,6,1,1,0
2020,222567,0,0,110,51,59
2020,222567,10,0,103,47,56
2020,222567,10,4,103,47,56
2020,222567,20,0,57,26,31
2020,222567,20,4,57,26,31
2020,222567,30,0,43,20,23
2020,222567,30,4,43,20,23
2020,222567,40,0,3,1,2
2020,222567,40,4,3,1,2
2020,222567,42,0,3,1,2
2020,222567,42,4,3,1,2
2020,222567,50,0,7,4,3
2020,222576,0,0,187,74,113
2020,222576,10,0,187,74,113
2020,222576,10,1,26,11,15
2020,222576,10,2,12,4,8
2020,222576,10,3,36,12,24
2020,222576,10,4,113,47,66
2020,222576,20,0,53,18,35
2020,222576,20,1,25,11,14
2020,222576,20,2,8,2,6
2020,222576,20,3,15,3,12
2020,222576,20,4,5,2,3
2020,222576,30,0,133,55,78
2020,222576,30,1,1,0,1
2020,222576,30,2,4,2,2
2020,222576,30,3,21,9,12
2020,222576,30,4,107,44,63
2020,222576,40,0,1,1,0
2020,222576,40,4,1,1,0
2020,222576,42,0,1,1,0
2020,222576,42,4,1,1,0
2020,222628,0,0,18,10,8
2020,222628,10,0,18,10,8
2020,222628,10,1,14,8,6
2020,222628,10,2,3,1,2
2020,222628,10,3,1,1,0
2020,222628,40,0,18,10,8
2020,222628,40,1,14,8,6
2020,222628,40,2,3,1,2
2020,222628,40,3,1,1,0
2020,222628,41,0,1,1,0
2020,222628,41,3,1,1,0
2020,222628,42,0,17,9,8
2020,222628,42,1,14,8,6
2020,222628,42,2,3,1,2
2020,222628,45,0,1,1,0
2020,222628,45,3,1,1,0
2020,222822,0,0,99,35,64
2020,222822,10,0,98,34,64
2020,222822,10,6,98,34,64
2020,222822,40,0,98,34,64
2020,222822,40,6,98,34,64
2020,222822,42,0,98,34,64
2020,222822,42,6,98,34,64
2020,222822,50,0,1,1,0
2020,222831,0,0,309,165,144
2020,222831,10,0,309,165,144
2020,222831,10,1,78,48,30
2020,222831,10,2,58,36,22
2020,222831,10,3,67,38,29
2020,222831,10,4,73,35,38
2020,222831,10,5,1,0,1
2020,222831,10,6,32,8,24
2020,222831,20,0,138,85,53
2020,222831,20,1,78,48,30
2020,222831,20,2,58,36,22
2020,222831,20,3,2,1,1
2020,222831,30,0,65,37,28
2020,222831,30,3,65,37,28
2020,222831,40,0,106,43,63
2020,222831,40,4,73,35,38
2020,222831,40,5,1,0,1
2020,222831,40,6,32,8,24
2020,222831,41,0,100,41,59
2020,222831,41,4,68,33,35
2020,222831,41,6,32,8,24
2020,222831,42,0,5,2,3
2020,222831,42,4,5,2,3
2020,222831,43,0,1,0,1
2020,222831,43,5,1,0,1
2020,222831,45,0,100,41,59
2020,222831,45,4,68,33,35
2020,222831,45,6,32,8,24
2020,222877,0,0,5,2,3
2020,222877,10,0,5,2,3
2020,222877,10,4,5,2,3
2020,222877,40,0,5,2,3
2020,222877,40,4,5,2,3
2020,222877,41,0,5,2,3
2020,222877,41,4,5,2,3
2020,222877,45,0,5,2,3
2020,222877,45,4,5,2,3
2020,222938,0,0,7,6,1
2020,222938,10,0,7,6,1
2020,222938,10,4,7,6,1
2020,222938,40,0,7,6,1
2020,222938,40,4,7,6,1
2020,222938,41,0,7,6,1
2020,222938,41,4,7,6,1
2020,222938,45,0,7,6,1
2020,222938,45,4,7,6,1
2020,222983,0,0,100,59,41
2020,222983,10,0,100,59,41
2020,222983,10,1,28,21,7
2020,222983,10,2,40,28,12
2020,222983,10,3,27,10,17
2020,222983,10,4,5,0,5
2020,222983,20,0,68,49,19
2020,222983,20,1,28,21,7
2020,222983,20,2,40,28,12
2020,222983,30,0,23,9,14
2020,222983,30,3,23,9,14
2020,222983,40,0,9,1,8
2020,222983,40,3,4,1,3
2020,222983,40,4,5,0,5
2020,222983,42,0,9,1,8
2020,222983,42,3,4,1,3
2020,222983,42,4,5,0,5
2020,222992,0,0,618,275,343
2020,222992,10,0,618,275,343
2020,222992,10,1,329,160,169
2020,222992,10,2,147,49,98
2020,222992,10,3,47,23,24
2020,222992,10,4,4,2,2
2020,222992,10,6,91,41,50
2020,222992,40,0,618,275,343
2020,222992,40,1,329,160,169
2020,222992,40,2,147,49,98
2020,222992,40,3,47,23,24
2020,222992,40,4,4,2,2
2020,222992,40,6,91,41,50
2020,222992,42,0,618,275,343
2020,222992,42,1,329,160,169
2020,222992,42,2,147,49,98
2020,222992,42,3,47,23,24
2020,222992,42,4,4,2,2
2020,222992,42,6,91,41,50
2020,223001,0,0,20,12,8
2020,223001,10,0,20,12,8
2020,223001,10,1,9,5,4
2020,223001,10,2,5,3,2
2020,223001,10,3,2,2,0
2020,223001,10,4,1,0,1
2020,223001,10,6,3,2,1
2020,223001,20,0,10,6,4
2020,223001,20,1,8,5,3
2020,223001,20,2,2,1,1
2020,223001,30,0,5,3,2
2020,223001,30,2,2,1,1
2020,223001,30,3,2,2,0
2020,223001,30,4,1,0,1
2020,223001,40,0,5,3,2
2020,223001,40,1,1,0,1
2020,223001,40,2,1,1,0
2020,223001,40,6,3,2,1
2020,223001,41,0,1,0,1
2020,223001,41,6,1,0,1
2020,223001,42,0,4,3,1
2020,223001,42,1,1,0,1
2020,223001,42,2,1,1,0
2020,223001,42,6,2,2,0
2020,223001,45,0,1,0,1
2020,223001,45,6,1,0,1
2020,223083,0,0,29,1,28
2020,223083,10,0,29,1,28
2020,223083,10,4,29,1,28
2020,223083,40,0,29,1,28
2020,223083,40,4,29,1,28
2020,223083,41,0,29,1,28
2020,223083,41,4,29,1,28
2020,223083,45,0,29,1,28
2020,223083,45,4,29,1,28
2020,223223,0,0,3263,1507,1756
2020,223223,10,0,3263,1507,1756
2020,223223,10,1,360,257,103
2020,223223,10,2,584,347,237
2020,223223,10,3,1703,743,960
2020,223223,10,4,616,160,456
2020,223223,20,0,424,293,131
2020,223223,20,1,255,194,61
2020,223223,20,2,169,99,70
2020,223223,30,0,452,243,209
2020,223223,30,2,32,20,12
2020,223223,30,3,420,223,197
2020,223223,40,0,2387,971,1416
2020,223223,40,1,105,63,42
2020,223223,40,2,383,228,155
2020,223223,40,3,1283,520,763
2020,223223,40,4,616,160,456
2020,223223,42,0,2387,971,1416
2020,223223,42,1,105,63,42
2020,223223,42,2,383,228,155
2020,223223,42,3,1283,520,763
2020,223223,42,4,616,160,456
2020,223232,0,0,1084,614,470
2020,223232,10,0,1084,614,470
2020,223232,10,1,297,227,70
2020,223232,10,2,305,177,128
2020,223232,10,3,236,104,132
2020,223232,10,4,5,0,5
2020,223232,10,5,241,106,135
2020,223232,20,0,523,375,148
2020,223232,20,1,283,223,60
2020,223232,20,2,240,152,88
2020,223232,30,0,172,86,86
2020,223232,30,2,19,10,9
2020,223232,30,3,153,76,77
2020,223232,40,0,389,153,236
2020,223232,40,1,14,4,10
2020,223232,40,2,46,15,31
2020,223232,40,3,83,28,55
2020,223232,40,4,5,0,5
2020,223232,40,5,241,106,135
2020,223232,42,0,389,153,236
2020,223232,42,1,14,4,10
2020,223232,42,2,46,15,31
2020,223232,42,3,83,28,55
2020,223232,42,4,5,0,5
2020,223232,42,5,241,106,135
2020,223320,0,0,47,18,29
2020,223320,10,0,45,17,28
2020,223320,10,1,10,4,6
2020,223320,10,2,15,7,8
2020,223320,10,3,6,1,5
2020,223320,10,4,14,5,9
2020,223320,40,0,45,17,28
2020,223320,40,1,10,4,6
2020,223320,40,2,15,7,8
2020,223320,40,3,6,1,5
2020,223320,40,4,14,5,9
2020,223320,42,0,45,17,28
2020,223320,42,1,10,4,6
2020,223320,42,2,15,7,8
2020,223320,42,3,6,1,5
2020,223320,42,4,14,5,9
2020,223320,50,0,2,1,1
2020,223427,0,0,394,192,202
2020,223427,10,0,394,192,202
2020,223427,10,6,394,192,202
2020,223427,40,0,394,192,202
2020,223427,40,6,394,192,202
2020,223427,41,0,278,132,146
2020,223427,41,6,278,132,146
2020,223427,43,0,116,60,56
2020,223427,43,6,116,60,56
2020,223427,44,0,278,132,146
2020,223427,44,6,278,132,146
2020,223463,0,0,21,9,12
2020,223463,50,0,21,9,12
2020,223472,0,0,9,1,8
2020,223472,10,0,9,1,8
2020,223472,10,4,9,1,8
2020,223472,40,0,9,1,8
2020,223472,40,4,9,1,8
2020,223472,42,0,9,1,8
2020,223472,42,4,9,1,8
2020,223506,0,0,101,62,39
2020,223506,10,0,101,62,39
2020,223506,10,1,14,8,6
2020,223506,10,2,18,11,7
2020,223506,10,3,42,24,18
2020,223506,10,4,27,19,8
2020,223506,20,0,34,18,16
2020,223506,20,1,13,7,6
2020,223506,20,2,11,7,4
2020,223506,20,3,10,4,6
2020,223506,40,0,67,44,23
2020,223506,40,1,1,1,0
2020,223506,40,2,7,4,3
2020,223506,40,3,32,20,12
2020,223506,40,4,27,19,8
2020,223506,41,0,21,14,7
2020,223506,41,2,5,2,3
2020,223506,41,3,8,6,2
2020,223506,41,4,8,6,2
2020,223506,42,0,44,29,15
2020,223506,42,1,1,1,0
2020,223506,42,2,2,2,0
2020,223506,42,3,24,14,10
2020,223506,42,4,17,12,5
2020,223506,43,0,2,1,1
2020,223506,43,4,2,1,1
2020,223506,44,0,21,14,7
2020,223506,44,2,5,2,3
2020,223506,44,3,8,6,2
2020,223506,44,4,8,6,2
2020,223816,0,0,185,98,87
2020,223816,10,0,149,68,81
2020,223816,10,1,149,68,81
2020,223816,40,0,149,68,81
2020,223816,40,1,149,68,81
2020,223816,42,0,149,68,81
2020,223816,42,1,149,68,81
2020,223816,50,0,36,30,6
2020,223898,0,0,74,36,38
2020,223898,10,0,74,36,38
2020,223898,10,1,70,32,38
2020,223898,10,4,4,4,0
2020,223898,20,0,19,10,9
2020,223898,20,1,19,10,9
2020,223898,30,0,3,2,1
2020,223898,30,1,2,1,1
2020,223898,30,4,1,1,0
2020,223898,40,0,52,24,28
2020,223898,40,1,49,21,28
2020,223898,40,4,3,3,0
2020,223898,42,0,52,24,28
2020,223898,42,1,49,21,28
2020,223898,42,4,3,3,0
2020,223922,0,0,42,22,20
2020,223922,10,0,42,22,20
2020,223922,10,4,42,22,20
2020,223922,40,0,42,22,20
2020,223922,40,4,42,22,20
2020,223922,42,0,16,4,12
2020,223922,42,4,16,4,12
2020,223922,43,0,26,18,8
2020,223922,43,4,26,18,8
2020,224004,0,0,55,26,29
2020,224004,10,0,55,26,29
2020,224004,10,1,10,8,2
2020,224004,10,2,23,11,12
2020,224004,10,3,18,6,12
2020,224004,10,4,4,1,3
2020,224004,40,0,55,26,29
2020,224004,40,1,10,8,2
2020,224004,40,2,23,11,12
2020,224004,40,3,18,6,12
2020,224004,40,4,4,1,3
2020,224004,41,0,51,25,26
2020,224004,41,1,10,8,2
2020,224004,41,2,23,11,12
2020,224004,41,3,18,6,12
2020,224004,42,0,4,1,3
2020,224004,42,4,4,1,3
2020,224004,44,0,51,25,26
2020,224004,44,1,10,8,2
2020,224004,44,2,23,11,12
2020,224004,44,3,18,6,12
2020,224110,0,0,146,54,92
2020,224110,10,0,146,54,92
2020,224110,10,6,146,54,92
2020,224110,40,0,146,54,92
2020,224110,40,6,146,54,92
2020,224110,43,0,146,54,92
2020,224110,43,6,146,54,92
2020,224147,0,0,421,209,212
2020,224147,10,0,421,209,212
2020,224147,10,1,84,58,26
2020,224147,10,2,112,62,50
2020,224147,10,3,211,83,128
2020,224147,10,4,8,2,6
2020,224147,10,5,6,4,2
2020,224147,20,0,172,104,68
2020,224147,20,1,79,55,24
2020,224147,20,2,91,49,42
2020,224147,20,3,2,0,2
2020,224147,30,0,133,67,66
2020,224147,30,1,2,2,0
2020,224147,30,2,9,7,2
2020,224147,30,3,122,58,64
2020,224147,40,0,116,38,78
2020,224147,40,1,3,1,2
2020,224147,40,2,12,6,6
2020,224147,40,3,87,25,62
2020,224147,40,4,8,2,6
2020,224147,40,5,6,4,2
2020,224147,42,0,115,37,78
2020,224147,42,1,3,1,2
2020,224147,42,2,12,6,6
2020,224147,42,3,87,25,62
2020,224147,42,4,8,2,6
2020,224147,42,5,5,3,2
2020,224147,43,0,1,1,0
2020,224147,43,5,1,1,0
2020,224226,0,0,117,71,46
2020,224226,10,0,117,71,46
2020,224226,10,1,48,27,21
2020,224226,10,2,18,12,6
2020,224226,10,3,51,32,19
2020,224226,40,0,117,71,46
2020,224226,40,1,48,27,21
2020,224226,40,2,18,12,6
2020,224226,40,3,51,32,19
2020,224226,42,0,117,71,46
2020,224226,42,1,48,27,21
2020,224226,42,2,18,12,6
2020,224226,42,3,51,32,19
2020,224244,0,0,7,4,3
2020,224244,10,0,7,4,3
2020,224244,10,1,2,2,0
2020,224244,10,2,4,2,2
2020,224244,10,4,1,0,1
2020,224244,40,0,7,4,3
2020,224244,40,1,2,2,0
2020,224244,40,2,4,2,2
2020,224244,40,4,1,0,1
2020,224244,41,0,6,4,2
2020,224244,41,1,2,2,0
2020,224244,41,2,4,2,2
2020,224244,42,0,1,0,1
2020,224244,42,4,1,0,1
2020,224244,44,0,6,4,2
2020,224244,44,1,2,2,0
2020,224244,44,2,4,2,2
2020,224305,0,0,67,60,7
2020,224305,10,0,67,60,7
2020,224305,10,1,36,33,3
2020,224305,10,2,13,12,1
2020,224305,10,3,18,15,3
2020,224305,20,0,32,30,2
2020,224305,20,1,29,27,2
2020,224305,20,2,3,3,0
2020,224305,30,0,20,16,4
2020,224305,30,2,8,7,1
2020,224305,30,3,12,9,3
2020,224305,40,0,15,14,1
2020,224305,40,1,7,6,1
2020,224305,40,2,2,2,0
2020,224305,40,3,6,6,0
2020,224305,42,0,15,14,1
2020,224305,42,1,7,6,1
2020,224305,42,2,2,2,0
2020,224305,42,3,6,6,0
2020,224323,0,0,143,84,59
2020,224323,10,0,143,84,59
2020,224323,10,1,18,15,3
2020,224323,10,2,63,40,23
2020,224323,10,3,31,16,15
2020,224323,10,4,31,13,18
2020,224323,20,0,79,55,24
2020,224323,20,1,18,15,3
2020,224323,20,2,57,37,20
2020,224323,20,3,4,3,1
2020,224323,30,0,33,16,17
2020,224323,30,2,6,3,3
2020,224323,30,3,27,13,14
2020,224323,40,0,31,13,18
2020,224323,40,4,31,13,18
2020,224323,42,0,31,13,18
2020,224323,42,4,31,13,18
2020,224350,0,0,331,171,160
2020,224350,10,0,302,157,145
2020,224350,10,1,94,57,37
2020,224350,10,2,61,29,32
2020,224350,10,3,47,18,29
2020,224350,10,4,100,53,47
2020,224350,20,0,189,98,91
2020,224350,20,1,94,57,37
2020,224350,20,2,60,29,31
2020,224350,20,3,35,12,23
2020,224350,30,0,58,23,35
2020,224350,30,2,1,0,1
2020,224350,30,3,12,6,6
2020,224350,30,4,45,17,28
2020,224350,40,0,55,36,19
2020,224350,40,4,55,36,19
2020,224350,42,0,16,9,7
2020,224350,42,4,16,9,7
2020,224350,43,0,39,27,12
2020,224350,43,4,39,27,12
2020,224350,50,0,29,14,15
2020,224527,0,0,72,43,29
2020,224527,10,0,72,43,29
2020,224527,10,1,25,21,4
2020,224527,10,2,17,10,7
2020,224527,10,3,30,12,18
2020,224527,20,0,1,1,0
2020,224527,20,1,1,1,0
2020,224527,40,0,71,42,29
2020,224527,40,1,24,20,4
2020,224527,40,2,17,10,7
2020,224527,40,3,30,12,18
2020,224527,41,0,27,22,5
2020,224527,41,1,22,18,4
2020,224527,41,2,5,4,1
2020,224527,42,0,44,20,24
2020,224527,42,1,2,2,0
2020,224527,42,2,12,6,6
2020,224527,42,3,30,12,18
2020,224527,44,0,27,22,5
2020,224527,44,1,22,18,4
2020,224527,44,2,5,4,1
2020,224545,0,0,93,47,46
2020,224545,10,0,93,47,46
2020,224545,10,1,21,15,6
2020,224545,10,2,20,15,5
2020,224545,10,3,32,13,19
2020,224545,10,4,19,3,16
2020,224545,10,5,1,1,0
2020,224545,20,0,32,25,7
2020,224545,20,1,18,14,4
2020,224545,20,2,14,11,3
2020,224545,30,0,31,17,14
2020,224545,30,1,1,1,0
2020,224545,30,2,5,4,1
2020,224545,30,3,25,12,13
2020,224545,40,0,30,5,25
2020,224545,40,1,2,0,2
2020,224545,40,2,1,0,1
2020,224545,40,3,7,1,6
2020,224545,40,4,19,3,16
2020,224545,40,5,1,1,0
2020,224545,42,0,30,5,25
2020,224545,42,1,2,0,2
2020,224545,42,2,1,0,1
2020,224545,42,3,7,1,6
2020,224545,42,4,19,3,16
2020,224545,42,5,1,1,0
2020,224554,0,0,370,191,179
2020,224554,10,0,370,191,179
2020,224554,10,1,64,45,19
2020,224554,10,2,125,68,57
2020,224554,10,3,118,55,63
2020,224554,10,4,54,19,35
2020,224554,10,5,9,4,5
2020,224554,20,0,177,109,68
2020,224554,20,1,64,45,19
2020,224554,20,2,107,60,47
2020,224554,20,3,6,4,2
2020,224554,30,0,97,45,52
2020,224554,30,2,3,2,1
2020,224554,30,3,93,42,51
2020,224554,30,4,1,1,0
2020,224554,40,0,96,37,59
2020,224554,40,2,15,6,9
2020,224554,40,3,19,9,10
2020,224554,40,4,53,18,35
2020,224554,40,5,9,4,5
2020,224554,42,0,96,37,59
2020,224554,42,2,15,6,9
2020,224554,42,3,19,9,10
2020,224554,42,4,53,18,35
2020,224554,42,5,9,4,5
2020,224615,0,0,885,419,466
2020,224615,10,0,885,419,466
2020,224615,10,6,885,419,466
2020,224615,40,0,885,419,466
2020,224615,40,6,885,419,466
2020,224615,42,0,885,419,466
2020,224615,42,6,885,419,466
2020,224642,0,0,413,185,228
2020,224642,10,0,413,185,228
2020,224642,10,1,158,74,84
2020,224642,10,2,46,18,28
2020,224642,10,3,142,63,79
2020,224642,10,5,59,28,31
2020,224642,10,6,8,2,6
2020,224642,20,0,205,92,113
2020,224642,20,1,158,74,84
2020,224642,20,2,46,18,28
2020,224642,20,6,1,0,1
2020,224642,30,0,144,65,79
2020,224642,30,3,142,63,79
2020,224642,30,6,2,2,0
2020,224642,40,0,64,28,36
2020,224642,40,5,59,28,31
2020,224642,40,6,5,0,5
2020,224642,42,0,6,3,3
2020,224642,42,5,6,3,3
2020,224642,43,0,58,25,33
2020,224642,43,5,53,25,28
2020,224642,43,6,5,0,5
2020,224660,0,0,26,17,9
2020,224660,10,0,26,17,9
2020,224660,10,4,26,17,9
2020,224660,40,0,26,17,9
2020,224660,40,4,26,17,9
2020,224660,41,0,26,17,9
2020,224660,41,4,26,17,9
2020,224660,45,0,26,17,9
2020,224660,45,4,26,17,9
2020,224679,0,0,63,53,10
2020,224679,10,0,63,53,10
2020,224679,10,4,63,53,10
2020,224679,40,0,63,53,10
2020,224679,40,4,63,53,10
2020,224679,41,0,63,53,10
2020,224679,41,4,63,53,10
2020,224679,45,0,63,53,10
2020,224679,45,4,63,53,10
2020,224712,0,0,16,7,9
2020,224712,10,0,16,7,9
2020,224712,10,1,3,3,0
2020,224712,10,2,5,3,2
2020,224712,10,3,7,1,6
2020,224712,10,4,1,0,1
2020,224712,20,0,5,5,0
2020,224712,20,1,3,3,0
2020,224712,20,2,2,2,0
2020,224712,40,0,11,2,9
2020,224712,40,2,3,1,2
2020,224712,40,3,7,1,6
2020,224712,40,4,1,0,1
2020,224712,41,0,10,2,8
2020,224712,41,2,3,1,2
2020,224712,41,3,7,1,6
2020,224712,42,0,1,0,1
2020,224712,42,4,1,0,1
2020,224712,44,0,10,2,8
2020,224712,44,2,3,1,2
2020,224712,44,3,7,1,6
2020,224776,0,0,4,3,1
2020,224776,10,0,4,3,1
2020,224776,10,4,4,3,1
2020,224776,40,0,4,3,1
2020,224776,40,4,4,3,1
2020,224776,41,0,4,3,1
2020,224776,41,4,4,3,1
2020,224776,45,0,4,3,1
2020,224776,45,4,4,3,1
2020,224891,0,0,37,17,20
2020,224891,10,0,30,12,18
2020,224891,10,1,7,5,2
2020,224891,10,2,3,0,3
2020,224891,10,3,12,3,9
2020,224891,10,4,8,4,4
2020,224891,40,0,30,12,18
2020,224891,40,1,7,5,2
2020,224891,40,2,3,0,3
2020,224891,40,3,12,3,9
2020,224891,40,4,8,4,4
2020,224891,41,0,7,4,3
2020,224891,41,1,6,4,2
2020,224891,41,2,1,0,1
2020,224891,42,0,23,8,15
2020,224891,42,1,1,1,0
2020,224891,42,2,2,0,2
2020,224891,42,3,12,3,9
2020,224891,42,4,8,4,4
2020,224891,44,0,6,3,3
2020,224891,44,1,5,3,2
2020,224891,44,2,1,0,1
2020,224891,45,0,1,1,0
2020,224891,45,1,1,1,0
2020,224891,50,0,7,5,2
2020,224961,0,0,63,32,31
2020,224961,10,0,62,32,30
2020,224961,10,1,2,2,0
2020,224961,10,2,8,5,3
2020,224961,10,3,6,3,3
2020,224961,10,4,46,22,24
2020,224961,20,0,16,11,5
2020,224961,20,1,2,2,0
2020,224961,20,2,6,4,2
2020,224961,20,3,4,2,2
2020,224961,20,4,4,3,1
2020,224961,30,0,46,21,25
2020,224961,30,2,2,1,1
2020,224961,30,3,2,1,1
2020,224961,30,4,42,19,23
2020,224961,50,0,1,0,1
2020,225070,0,0,113,41,72
2020,225070,10,0,110,40,70
2020,225070,10,1,110,40,70
2020,225070,40,0,110,40,70
2020,225070,40,1,110,40,70
2020,225070,42,0,110,40,70
2020,225070,42,1,110,40,70
2020,225070,50,0,3,1,2
2020,225201,0,0,36,22,14
2020,225201,10,0,35,21,14
2020,225201,10,4,35,21,14
2020,225201,40,0,35,21,14
2020,225201,40,4,35,21,14
2020,225201,41,0,33,19,14
2020,225201,41,4,33,19,14
2020,225201,43,0,2,2,0
2020,225201,43,4,2,2,0
2020,225201,45,0,33,19,14
2020,225201,45,4,33,19,14
2020,225201,50,0,1,1,0
2020,225247,0,0,104,61,43
2020,225247,10,0,104,61,43
2020,225247,10,1,49,33,16
2020,225247,10,2,24,14,10
2020,225247,10,3,27,12,15
2020,225247,10,4,4,2,2
2020,225247,20,0,68,44,24
2020,225247,20,1,48,32,16
2020,225247,20,2,18,11,7
2020,225247,20,3,2,1,1
2020,225247,40,0,36,17,19
2020,225247,40,1,1,1,0
2020,225247,40,2,6,3,3
2020,225247,40,3,25,11,14
2020,225247,40,4,4,2,2
2020,225247,42,0,36,17,19
2020,225247,42,1,1,1,0
2020,225247,42,2,6,3,3
2020,225247,42,3,25,11,14
2020,225247,42,4,4,2,2
2020,225308,0,0,160,84,76
2020,225308,10,0,160,84,76
2020,225308,10,4,159,83,76
2020,225308,10,6,1,1,0
2020,225308,40,0,160,84,76
2020,225308,40,4,159,83,76
2020,225308,40,6,1,1,0
2020,225308,42,0,40,26,14
2020,225308,42,4,39,25,14
2020,225308,42,6,1,1,0
2020,225308,43,0,120,58,62
2020,225308,43,4,120,58,62
2020,225371,0,0,90,44,46
2020,225371,10,0,90,44,46
2020,225371,10,6,90,44,46
2020,225371,40,0,90,44,46
2020,225371,40,6,90,44,46
2020,225371,42,0,90,44,46
2020,225371,42,6,90,44,46
2020,225399,0,0,131,74,57
2020,225399,10,0,131,74,57
2020,225399,10,1,35,24,11
2020,225399,10,2,37,21,16
2020,225399,10,3,58,29,29
2020,225399,10,4,1,0,1
2020,225399,40,0,131,74,57
2020,225399,40,1,35,24,11
2020,225399,40,2,37,21,16
2020,225399,40,3,58,29,29
2020,225399,40,4,1,0,1
2020,225399,41,0,98,61,37
2020,225399,41,1,31,22,9
2020,225399,41,2,35,20,15
2020,225399,41,3,32,19,13
2020,225399,42,0,33,13,20
2020,225399,42,1,4,2,2
2020,225399,42,2,2,1,1
2020,225399,42,3,26,10,16
2020,225399,42,4,1,0,1
2020,225399,44,0,98,61,37
2020,225399,44,1,31,22,9
2020,225399,44,2,35,20,15
2020,225399,44,3,32,19,13
2020,225414,0,0,278,144,134
2020,225414,10,0,269,141,128
2020,225414,10,1,61,37,24
2020,225414,10,2,104,60,44
2020,225414,10,3,59,30,29
2020,225414,10,5,30,10,20
2020,225414,10,6,15,4,11
2020,225414,20,0,165,97,68
2020,225414,20,1,61,37,24
2020,225414,20,2,104,60,44
2020,225414,30,0,59,30,29
2020,225414,30,3,59,30,29
2020,225414,40,0,45,14,31
2020,225414,40,5,30,10,20
2020,225414,40,6,15,4,11
2020,225414,42,0,45,14,31
2020,225414,42,5,30,10,20
2020,225414,42,6,15,4,11
2020,225414,50,0,9,3,6
2020,225423,0,0,864,419,445
2020,225423,10,0,864,419,445
2020,225423,10,4,864,419,445
2020,225423,40,0,864,419,445
2020,225423,40,4,864,419,445
2020,225423,42,0,864,419,445
2020,225423,42,4,864,419,445
2020,225432,0,0,344,182,162
2020,225432,10,0,344,182,162
2020,225432,10,1,64,44,20
2020,225432,10,2,108,57,51
2020,225432,10,3,71,37,34
2020,225432,10,4,1,0,1
2020,225432,10,5,93,39,54
2020,225432,10,6,7,5,2
2020,225432,20,0,168,98,70
2020,225432,20,1,63,43,20
2020,225432,20,2,105,55,50
2020,225432,30,0,76,40,36
2020,225432,30,1,1,1,0
2020,225432,30,2,3,2,1
2020,225432,30,3,71,37,34
2020,225432,30,4,1,0,1
2020,225432,40,0,100,44,56
2020,225432,40,5,93,39,54
2020,225432,40,6,7,5,2
2020,225432,42,0,99,44,55
2020,225432,42,5,93,39,54
2020,225432,42,6,6,5,1
2020,225432,43,0,1,0,1
2020,225432,43,6,1,0,1
2020,225502,0,0,127,72,55
2020,225502,10,0,125,72,53
2020,225502,10,1,31,19,12
2020,225502,10,2,43,25,18
2020,225502,10,3,39,23,16
2020,225502,10,5,9,5,4
2020,225502,10,6,3,0,3
2020,225502,20,0,72,42,30
2020,225502,20,1,31,19,12
2020,225502,20,2,41,23,18
2020,225502,30,0,41,25,16
2020,225502,30,2,2,2,0
2020,225502,30,3,39,23,16
2020,225502,40,0,12,5,7
2020,225502,40,5,9,5,4
2020,225502,40,6,3,0,3
2020,225502,42,0,12,5,7
2020,225502,42,5,9,5,4
2020,225502,42,6,3,0,3
2020,225502,50,0,2,0,2
2020,225511,0,0,1511,871,640
2020,225511,10,0,1330,809,521
2020,225511,10,1,441,331,110
2020,225511,10,2,354,207,147
2020,225511,10,3,217,117,100
2020,225511,10,5,88,37,51
2020,225511,10,6,230,117,113
2020,225511,20,0,779,528,251
2020,225511,20,1,438,329,109
2020,225511,20,2,341,199,142
2020,225511,30,0,233,127,106
2020,225511,30,1,3,2,1
2020,225511,30,2,13,8,5
2020,225511,30,3,217,117,100
2020,225511,40,0,318,154,164
2020,225511,40,5,88,37,51
2020,225511,40,6,230,117,113
2020,225511,41,0,3,0,3
2020,225511,41,5,2,0,2
2020,225511,41,6,1,0,1
2020,225511,42,0,289,139,150
2020,225511,42,5,60,22,38
2020,225511,42,6,229,117,112
2020,225511,43,0,26,15,11
2020,225511,43,5,26,15,11
2020,225511,44,0,3,0,3
2020,225511,44,5,2,0,2
2020,225511,44,6,1,0,1
2020,225511,50,0,181,62,119
2020,225520,0,0,117,57,60
2020,225520,10,0,117,57,60
2020,225520,10,1,6,4,2
2020,225520,10,2,27,12,15
2020,225520,10,3,25,14,11
2020,225520,10,4,59,27,32
2020,225520,40,0,117,57,60
2020,225520,40,1,6,4,2
2020,225520,40,2,27,12,15
2020,225520,40,3,25,14,11
2020,225520,40,4,59,27,32
2020,225520,41,0,10,4,6
2020,225520,41,3,4,4,0
2020,225520,41,4,6,0,6
2020,225520,42,0,107,53,54
2020,225520,42,1,6,4,2
2020,225520,42,2,27,12,15
2020,225520,42,3,21,10,11
2020,225520,42,4,53,27,26
2020,225520,45,0,10,4,6
2020,225520,45,3,4,4,0
2020,225520,45,4,6,0,6
2020,225548,0,0,58,37,21
2020,225548,10,0,58,37,21
2020,225548,10,1,20,16,4
2020,225548,10,2,14,10,4
2020,225548,10,3,17,8,9
2020,225548,10,4,7,3,4
2020,225548,20,0,1,1,0
2020,225548,20,1,1,1,0
2020,225548,40,0,57,36,21
2020,225548,40,1,19,15,4
2020,225548,40,2,14,10,4
2020,225548,40,3,17,8,9
2020,225548,40,4,7,3,4
2020,225548,42,0,57,36,21
2020,225548,42,1,19,15,4
2020,225548,42,2,14,10,4
2020,225548,42,3,17,8,9
2020,225548,42,4,7,3,4
2020,225575,0,0,44,21,23
2020,225575,10,0,44,21,23
2020,225575,10,1,10,4,6
2020,225575,10,2,13,5,8
2020,225575,10,3,15,10,5
2020,225575,10,4,3,0,3
2020,225575,10,5,3,2,1
2020,225575,20,0,15,7,8
2020,225575,20,1,9,3,6
2020,225575,20,2,6,4,2
2020,225575,30,0,22,11,11
2020,225575,30,2,7,1,6
2020,225575,30,3,15,10,5
2020,225575,40,0,7,3,4
2020,225575,40,1,1,1,0
2020,225575,40,4,3,0,3
2020,225575,40,5,3,2,1
2020,225575,42,0,7,3,4
2020,225575,42,1,1,1,0
2020,225575,42,4,3,0,3
2020,225575,42,5,3,2,1
2020,225627,0,0,340,155,185
2020,225627,10,0,340,155,185
2020,225627,10,1,88,44,44
2020,225627,10,2,109,52,57
2020,225627,10,3,108,47,61
2020,225627,10,4,34,12,22
2020,225627,10,5,1,0,1
2020,225627,20,0,163,76,87
2020,225627,20,1,75,35,40
2020,225627,20,2,88,41,47
2020,225627,30,0,71,34,37
2020,225627,30,1,3,3,0
2020,225627,30,2,5,3,2
2020,225627,30,3,63,28,35
2020,225627,40,0,106,45,61
2020,225627,40,1,10,6,4
2020,225627,40,2,16,8,8
2020,225627,40,3,45,19,26
2020,225627,40,4,34,12,22
2020,225627,40,5,1,0,1
2020,225627,42,0,106,45,61
2020,225627,42,1,10,6,4
2020,225627,42,2,16,8,8
2020,225627,42,3,45,19,26
2020,225627,42,4,34,12,22
2020,225627,42,5,1,0,1
2020,225876,0,0,9,3,6
2020,225876,10,0,9,3,6
2020,225876,10,4,9,3,6
2020,225876,40,0,9,3,6
2020,225876,40,4,9,3,6
2020,225876,41,0,9,3,6
2020,225876,41,4,9,3,6
2020,225876,45,0,9,3,6
2020,225876,45,4,9,3,6
2020,225885,0,0,41,24,17
2020,225885,10,0,41,24,17
2020,225885,10,1,5,3,2
2020,225885,10,2,5,4,1
2020,225885,10,3,30,17,13
2020,225885,10,4,1,0,1
2020,225885,20,0,5,4,1
2020,225885,20,1,2,1,1
2020,225885,20,2,2,2,0
2020,225885,20,3,1,1,0
2020,225885,40,0,36,20,16
2020,225885,40,1,3,2,1
2020,225885,40,2,3,2,1
2020,225885,40,3,29,16,13
2020,225885,40,4,1,0,1
2020,225885,42,0,36,20,16
2020,225885,42,1,3,2,1
2020,225885,42,2,3,2,1
2020,225885,42,3,29,16,13
2020,225885,42,4,1,0,1
2020,226019,0,0,140,62,78
2020,226019,10,0,140,62,78
2020,226019,10,4,140,62,78
2020,226019,40,0,140,62,78
2020,226019,40,4,140,62,78
2020,226019,42,0,31,16,15
2020,226019,42,4,31,16,15
2020,226019,43,0,109,46,63
2020,226019,43,4,109,46,63
2020,226091,0,0,434,218,216
2020,226091,10,0,434,218,216
2020,226091,10,1,85,56,29
2020,226091,10,2,112,66,46
2020,226091,10,3,90,45,45
2020,226091,10,4,147,51,96
2020,226091,20,0,200,124,76
2020,226091,20,1,84,56,28
2020,226091,20,2,109,65,44
2020,226091,20,3,7,3,4
2020,226091,30,0,78,40,38
2020,226091,30,2,3,1,2
2020,226091,30,3,72,37,35
2020,226091,30,4,3,2,1
2020,226091,40,0,156,54,102
2020,226091,40,1,1,0,1
2020,226091,40,3,11,5,6
2020,226091,40,4,144,49,95
2020,226091,42,0,86,26,60
2020,226091,42,3,11,5,6
2020,226091,42,4,75,21,54
2020,226091,43,0,70,28,42
2020,226091,43,1,1,0,1
2020,226091,43,4,69,28,41
2020,226107,0,0,41,16,25
2020,226107,10,0,41,16,25
2020,226107,10,1,1,1,0
2020,226107,10,2,1,0,1
2020,226107,10,3,6,4,2
2020,226107,10,4,32,10,22
2020,226107,10,5,1,1,0
2020,226107,20,0,12,6,6
2020,226107,20,1,1,1,0
2020,226107,20,2,1,0,1
2020,226107,20,3,4,3,1
2020,226107,20,4,6,2,4
2020,226107,30,0,6,2,4
2020,226107,30,3,2,1,1
2020,226107,30,4,4,1,3
2020,226107,40,0,23,8,15
2020,226107,40,4,22,7,15
2020,226107,40,5,1,1,0
2020,226107,42,0,22,7,15
2020,226107,42,4,22,7,15
2020,226107,43,0,1,1,0
2020,226107,43,5,1,1,0
2020,226116,0,0,60,25,35
2020,226116,10,0,60,25,35
2020,226116,10,1,2,0,2
2020,226116,10,2,1,1,0
2020,226116,10,3,4,1,3
2020,226116,10,4,53,23,30
2020,226116,20,0,28,7,21
2020,226116,20,1,2,0,2
2020,226116,20,2,1,1,0
2020,226116,20,3,3,0,3
2020,226116,20,4,22,6,16
2020,226116,30,0,28,14,14
2020,226116,30,3,1,1,0
2020,226116,30,4,27,13,14
2020,226116,40,0,4,4,0
2020,226116,40,4,4,4,0
2020,226116,42,0,3,3,0
2020,226116,42,4,3,3,0
2020,226116,43,0,1,1,0
2020,226116,43,4,1,1,0
2020,226134,0,0,170,93,77
2020,226134,10,0,170,93,77
2020,226134,10,1,106,59,47
2020,226134,10,2,10,6,4
2020,226134,10,3,32,15,17
2020,226134,10,4,22,13,9
2020,226134,20,0,116,65,51
2020,226134,20,1,106,59,47
2020,226134,20,2,10,6,4
2020,226134,30,0,35,17,18
2020,226134,30,3,32,15,17
2020,226134,30,4,3,2,1
2020,226134,40,0,19,11,8
2020,226134,40,4,19,11,8
2020,226134,42,0,17,9,8
2020,226134,42,4,17,9,8
2020,226134,43,0,2,2,0
2020,226134,43,4,2,2,0
2020,226152,0,0,232,122,110
2020,226152,10,0,232,122,110
2020,226152,10,1,29,24,5
2020,226152,10,2,62,34,28
2020,226152,10,3,108,50,58
2020,226152,10,4,21,8,13
2020,226152,10,5,12,6,6
2020,226152,20,0,65,46,19
2020,226152,20,1,27,22,5
2020,226152,20,2,37,23,14
2020,226152,20,3,1,1,0
2020,226152,30,0,86,50,36
2020,226152,30,1,1,1,0
2020,226152,30,2,18,8,10
2020,226152,30,3,67,41,26
2020,226152,40,0,81,26,55
2020,226152,40,1,1,1,0
2020,226152,40,2,7,3,4
2020,226152,40,3,40,8,32
2020,226152,40,4,21,8,13
2020,226152,40,5,12,6,6
2020,226152,42,0,81,26,55
2020,226152,42,1,1,1,0
2020,226152,42,2,7,3,4
2020,226152,42,3,40,8,32
2020,226152,42,4,21,8,13
2020,226152,42,5,12,6,6
2020,226204,0,0,162,80,82
2020,226204,10,0,162,80,82
2020,226204,10,6,162,80,82
2020,226204,40,0,162,80,82
2020,226204,40,6,162,80,82
2020,226204,41,0,81,43,38
2020,226204,41,6,81,43,38
2020,226204,42,0,34,9,25
2020,226204,42,6,34,9,25
2020,226204,43,0,47,28,19
2020,226204,43,6,47,28,19
2020,226204,44,0,81,43,38
2020,226204,44,6,81,43,38
2020,226231,0,0,107,83,24
2020,226231,10,0,77,59,18
2020,226231,10,1,30,23,7
2020,226231,10,2,26,18,8
2020,226231,10,3,19,16,3
2020,226231,10,4,1,1,0
2020,226231,10,5,1,1,0
2020,226231,20,0,40,32,8
2020,226231,20,1,25,21,4
2020,226231,20,2,14,10,4
2020,226231,20,3,1,1,0
2020,226231,30,0,33,24,9
2020,226231,30,1,4,2,2
2020,226231,30,2,12,8,4
2020,226231,30,3,17,14,3
2020,226231,40,0,4,3,1
2020,226231,40,1,1,0,1
2020,226231,40,3,1,1,0
2020,226231,40,4,1,1,0
2020,226231,40,5,1,1,0
2020,226231,42,0,4,3,1
2020,226231,42,1,1,0,1
2020,226231,42,3,1,1,0
2020,226231,42,4,1,1,0
2020,226231,42,5,1,1,0
2020,226231,50,0,30,24,6
2020,226277,0,0,53,52,1
2020,226277,10,0,53,52,1
2020,226277,10,4,53,52,1
2020,226277,40,0,53,52,1
2020,226277,40,4,53,52,1
2020,226277,41,0,53,52,1
2020,226277,41,4,53,52,1
2020,226277,45,0,53,52,1
2020,226277,45,4,53,52,1
2020,226383,0,0,87,46,41
2020,226383,10,0,87,46,41
2020,226383,10,1,30,18,12
2020,226383,10,2,24,18,6
2020,226383,10,3,26,8,18
2020,226383,10,4,2,0,2
2020,226383,10,6,5,2,3
2020,226383,20,0,51,29,22
2020,226383,20,1,28,17,11
2020,226383,20,2,18,12,6
2020,226383,20,3,5,0,5
2020,226383,30,0,31,15,16
2020,226383,30,1,2,1,1
2020,226383,30,2,6,6,0
2020,226383,30,3,21,8,13
2020,226383,30,4,2,0,2
2020,226383,40,0,5,2,3
2020,226383,40,6,5,2,3
2020,226383,42,0,5,2,3
2020,226383,42,6,5,2,3
2020,226408,0,0,114,52,62
2020,226408,10,0,114,52,62
2020,226408,10,1,17,12,5
2020,226408,10,2,26,15,11
2020,226408,10,3,71,25,46
2020,226408,20,0,59,29,30
2020,226408,20,1,17,12,5
2020,226408,20,2,20,11,9
2020,226408,20,3,22,6,16
2020,226408,40,0,55,23,32
2020,226408,40,2,6,4,2
2020,226408,40,3,49,19,30
2020,226408,41,0,26,13,13
2020,226408,41,2,6,4,2
2020,226408,41,3,20,9,11
2020,226408,42,0,29,10,19
2020,226408,42,3,29,10,19
2020,226408,44,0,24,13,11
2020,226408,44,2,6,4,2
2020,226408,44,3,18,9,9
2020,226408,45,0,2,0,2
2020,226408,45,3,2,0,2
2020,226471,0,0,163,70,93
2020,226471,10,0,163,70,93
2020,226471,10,1,62,30,32
2020,226471,10,2,29,15,14
2020,226471,10,3,61,21,40
2020,226471,10,4,11,4,7
2020,226471,20,0,69,35,34
2020,226471,20,1,54,26,28
2020,226471,20,2,15,9,6
2020,226471,30,0,58,25,33
2020,226471,30,1,7,3,4
2020,226471,30,2,13,6,7
2020,226471,30,3,38,16,22
2020,226471,40,0,36,10,26
2020,226471,40,1,1,1,0
2020,226471,40,2,1,0,1
2020,226471,40,3,23,5,18
2020,226471,40,4,11,4,7
2020,226471,42,0,36,10,26
2020,226471,42,1,1,1,0
2020,226471,42,2,1,0,1
2020,226471,42,3,23,5,18
2020,226471,42,4,11,4,7
2020,226578,0,0,205,67,138
2020,226578,10,0,205,67,138
2020,226578,10,1,110,39,71
2020,226578,10,2,57,17,40
2020,226578,10,3,28,10,18
2020,226578,10,4,10,1,9
2020,226578,20,0,110,39,71
2020,226578,20,1,110,39,71
2020,226578,30,0,57,17,40
2020,226578,30,2,57,17,40
2020,226578,40,0,38,11,27
2020,226578,40,3,28,10,18
2020,226578,40,4,10,1,9
2020,226578,42,0,28,10,18
2020,226578,42,3,28,10,18
2020,226578,43,0,10,1,9
2020,226578,43,4,10,1,9
2020,226587,0,0,79,46,33
2020,226587,10,0,79,46,33
2020,226587,10,1,26,19,7
2020,226587,10,2,16,10,6
2020,226587,10,3,18,12,6
2020,226587,10,4,19,5,14
2020,226587,20,0,42,29,13
2020,226587,20,1,26,19,7
2020,226587,20,2,16,10,6
2020,226587,30,0,12,9,3
2020,226587,30,3,11,9,2
2020,226587,30,4,1,0,1
2020,226587,40,0,25,8,17
2020,226587,40,3,7,3,4
2020,226587,40,4,18,5,13
2020,226587,42,0,25,8,17
2020,226587,42,3,7,3,4
2020,226587,42,4,18,5,13
2020,226806,0,0,134,64,70
2020,226806,10,0,128,61,67
2020,226806,10,1,35,18,17
2020,226806,10,2,53,26,27
2020,226806,10,3,13,7,6
2020,226806,10,4,27,10,17
2020,226806,40,0,128,61,67
2020,226806,40,1,35,18,17
2020,226806,40,2,53,26,27
2020,226806,40,3,13,7,6
2020,226806,40,4,27,10,17
2020,226806,42,0,128,61,67
2020,226806,42,1,35,18,17
2020,226806,42,2,53,26,27
2020,226806,42,3,13,7,6
2020,226806,42,4,27,10,17
2020,226806,50,0,6,3,3
2020,226833,0,0,233,113,120
2020,226833,10,0,233,113,120
2020,226833,10,1,47,32,15
2020,226833,10,2,78,39,39
2020,226833,10,3,85,30,55
2020,226833,10,4,16,7,9
2020,226833,10,5,7,5,2
2020,226833,20,0,126,72,54
2020,226833,20,1,47,32,15
2020,226833,20,2,74,37,37
2020,226833,20,3,5,3,2
2020,226833,30,0,57,26,31
2020,226833,30,2,3,1,2
2020,226833,30,3,54,25,29
2020,226833,40,0,50,15,35
2020,226833,40,2,1,1,0
2020,226833,40,3,26,2,24
2020,226833,40,4,16,7,9
2020,226833,40,5,7,5,2
2020,226833,42,0,47,14,33
2020,226833,42,2,1,1,0
2020,226833,42,3,24,2,22
2020,226833,42,4,16,7,9
2020,226833,42,5,6,4,2
2020,226833,43,0,3,1,2
2020,226833,43,3,2,0,2
2020,226833,43,5,1,1,0
2020,226879,0,0,5,4,1
2020,226879,10,0,5,4,1
2020,226879,10,1,5,4,1
2020,226879,40,0,5,4,1
2020,226879,40,1,5,4,1
2020,226879,43,0,5,4,1
2020,226879,43,1,5,4,1
2020,226903,0,0,116,62,54
2020,226903,10,0,116,62,54
2020,226903,10,4,116,62,54
2020,226903,40,0,116,62,54
2020,226903,40,4,116,62,54
2020,226903,41,0,116,62,54
2020,226903,41,4,116,62,54
2020,226903,45,0,116,62,54
2020,226903,45,4,116,62,54
2020,227146,0,0,117,32,85
2020,227146,10,0,115,30,85
2020,227146,10,1,15,4,11
2020,227146,10,2,82,22,60
2020,227146,10,3,18,4,14
2020,227146,40,0,115,30,85
2020,227146,40,1,15,4,11
2020,227146,40,2,82,22,60
2020,227146,40,3,18,4,14
2020,227146,42,0,115,30,85
2020,227146,42,1,15,4,11
2020,227146,42,2,82,22,60
2020,227146,42,3,18,4,14
2020,227146,50,0,2,2,0
2020,227182,0,0,909,409,500
2020,227182,10,0,909,409,500
2020,227182,10,1,693,315,378
2020,227182,10,2,137,45,92
2020,227182,10,3,16,2,14
2020,227182,10,4,63,47,16
2020,227182,40,0,909,409,500
2020,227182,40,1,693,315,378
2020,227182,40,2,137,45,92
2020,227182,40,3,16,2,14
2020,227182,40,4,63,47,16
2020,227182,41,0,728,324,404
2020,227182,41,1,688,312,376
2020,227182,41,2,40,12,28
2020,227182,42,0,177,83,94
2020,227182,42,1,5,3,2
2020,227182,42,2,97,33,64
2020,227182,42,3,16,2,14
2020,227182,42,4,59,45,14
2020,227182,43,0,4,2,2
2020,227182,43,4,4,2,2
2020,227182,44,0,728,324,404
2020,227182,44,1,688,312,376
2020,227182,44,2,40,12,28
2020,227216,0,0,1138,626,512
2020,227216,10,0,1127,622,505
2020,227216,10,1,327,228,99
2020,227216,10,2,247,144,103
2020,227216,10,3,214,110,104
2020,227216,10,4,43,18,25
2020,227216,10,5,291,120,171
2020,227216,10,6,5,2,3
2020,227216,20,0,567,368,199
2020,227216,20,1,327,228,99
2020,227216,20,2,239,139,100
2020,227216,20,3,1,1,0
2020,227216,30,0,220,113,107
2020,227216,30,2,7,4,3
2020,227216,30,3,213,109,104
2020,227216,40,0,340,141,199
2020,227216,40,2,1,1,0
2020,227216,40,4,43,18,25
2020,227216,40,5,291,120,171
2020,227216,40,6,5,2,3
2020,227216,41,0,254,106,148
2020,227216,41,4,2,1,1
2020,227216,41,5,252,105,147
2020,227216,42,0,36,13,23
2020,227216,42,5,36,13,23
2020,227216,43,0,50,22,28
2020,227216,43,2,1,1,0
2020,227216,43,4,41,17,24
2020,227216,43,5,3,2,1
2020,227216,43,6,5,2,3
2020,227216,44,0,254,106,148
2020,227216,44,4,2,1,1
2020,227216,44,5,252,105,147
2020,227216,50,0,11,4,7
2020,227225,0,0,66,26,40
2020,227225,10,0,66,26,40
2020,227225,10,1,39,17,22
2020,227225,10,2,5,2,3
2020,227225,10,3,3,0,3
2020,227225,10,4,19,7,12
2020,227225,40,0,66,26,40
2020,227225,40,1,39,17,22
2020,227225,40,2,5,2,3
2020,227225,40,3,3,0,3
2020,227225,40,4,19,7,12
2020,227225,42,0,66,26,40
2020,227225,42,1,39,17,22
2020,227225,42,2,5,2,3
2020,227225,42,3,3,0,3
2020,227225,42,4,19,7,12
2020,227289,0,0,21,13,8
2020,227289,10,0,18,12,6
2020,227289,10,1,10,8,2
2020,227289,10,2,2,0,2
2020,227289,10,3,5,4,1
2020,227289,10,4,1,0,1
2020,227289,40,0,18,12,6
2020,227289,40,1,10,8,2
2020,227289,40,2,2,0,2
2020,227289,40,3,5,4,1
2020,227289,40,4,1,0,1
2020,227289,41,0,17,11,6
2020,227289,41,1,9,7,2
2020,227289,41,2,2,0,2
2020,227289,41,3,5,4,1
2020,227289,41,4,1,0,1
2020,227289,42,0,1,1,0
2020,227289,42,1,1,1,0
2020,227289,44,0,17,11,6
2020,227289,44,1,9,7,2
2020,227289,44,2,2,0,2
2020,227289,44,3,5,4,1
2020,227289,44,4,1,0,1
2020,227289,50,0,3,1,2
2020,227304,0,0,126,66,60
2020,227304,10,0,126,66,60
2020,227304,10,1,15,13,2
2020,227304,10,2,42,24,18
2020,227304,10,3,18,8,10
2020,227304,10,4,51,21,30
2020,227304,20,0,7,4,3
2020,227304,20,1,4,3,1
2020,227304,20,3,1,0,1
2020,227304,20,4,2,1,1
2020,227304,40,0,119,62,57
2020,227304,40,1,11,10,1
2020,227304,40,2,42,24,18
2020,227304,40,3,17,8,9
2020,227304,40,4,49,20,29
2020,227304,42,0,119,62,57
2020,227304,42,1,11,10,1
2020,227304,42,2,42,24,18
2020,227304,42,3,17,8,9
2020,227304,42,4,49,20,29
2020,227331,0,0,105,40,65
2020,227331,10,0,105,40,65
2020,227331,10,1,30,7,23
2020,227331,10,2,27,9,18
2020,227331,10,3,47,24,23
2020,227331,10,4,1,0,1
2020,227331,20,0,44,11,33
2020,227331,20,1,27,7,20
2020,227331,20,2,17,4,13
2020,227331,30,0,29,13,16
2020,227331,30,3,28,13,15
2020,227331,30,4,1,0,1
2020,227331,40,0,32,16,16
2020,227331,40,1,3,0,3
2020,227331,40,2,10,5,5
2020,227331,40,3,19,11,8
2020,227331,42,0,31,15,16
2020,227331,42,1,3,0,3
2020,227331,42,2,10,5,5
2020,227331,42,3,18,10,8
2020,227331,43,0,1,1,0
2020,227331,43,3,1,1,0
2020,227368,0,0,1335,742,593
2020,227368,10,0,1335,742,593
2020,227368,10,1,269,196,73
2020,227368,10,2,270,171,99
2020,227368,10,3,261,142,119
2020,227368,10,4,1,0,1
2020,227368,10,5,534,233,301
2020,227368,20,0,516,350,166
2020,227368,20,1,264,192,72
2020,227368,20,2,252,158,94
2020,227368,30,0,178,97,81
2020,227368,30,3,178,97,81
2020,227368,40,0,641,295,346
2020,227368,40,1,5,4,1
2020,227368,40,2,18,13,5
2020,227368,40,3,83,45,38
2020,227368,40,4,1,0,1
2020,227368,40,5,534,233,301
2020,227368,41,0,502,233,269
2020,227368,41,1,5,4,1
2020,227368,41,2,18,13,5
2020,227368,41,3,83,45,38
2020,227368,41,4,1,0,1
2020,227368,41,5,395,171,224
2020,227368,42,0,139,62,77
2020,227368,42,5,139,62,77
2020,227368,44,0,502,233,269
2020,227368,44,1,5,4,1
2020,227368,44,2,18,13,5
2020,227368,44,3,83,45,38
2020,227368,44,4,1,0,1
2020,227368,44,5,395,171,224
2020,227377,0,0,99,48,51
2020,227377,10,0,95,45,50
2020,227377,10,6,95,45,50
2020,227377,40,0,95,45,50
2020,227377,40,6,95,45,50
2020,227377,42,0,95,45,50
2020,227377,42,6,95,45,50
2020,227377,50,0,4,3,1
2020,227386,0,0,71,27,44
2020,227386,10,0,71,27,44
2020,227386,10,1,53,21,32
2020,227386,10,4,18,6,12
2020,227386,40,0,71,27,44
2020,227386,40,1,53,21,32
2020,227386,40,4,18,6,12
2020,227386,42,0,71,27,44
2020,227386,42,1,53,21,32
2020,227386,42,4,18,6,12
2020,227401,0,0,77,40,37
2020,227401,10,0,77,40,37
2020,227401,10,6,77,40,37
2020,227401,40,0,77,40,37
2020,227401,40,6,77,40,37
2020,227401,42,0,77,40,37
2020,227401,42,6,77,40,37
2020,227429,0,0,13,7,6
2020,227429,10,0,13,7,6
2020,227429,10,2,7,4,3
2020,227429,10,5,6,3,3
2020,227429,40,0,13,7,6
2020,227429,40,2,7,4,3
2020,227429,40,5,6,3,3
2020,227429,42,0,13,7,6
2020,227429,42,2,7,4,3
2020,227429,42,5,6,3,3
2020,227526,0,0,432,247,185
2020,227526,10,0,425,244,181
2020,227526,10,1,76,57,19
2020,227526,10,2,65,43,22
2020,227526,10,3,118,62,56
2020,227526,10,4,2,1,1
2020,227526,10,5,164,81,83
2020,227526,20,0,135,96,39
2020,227526,20,1,75,56,19
2020,227526,20,2,60,40,20
2020,227526,30,0,126,67,59
2020,227526,30,1,1,1,0
2020,227526,30,2,5,3,2
2020,227526,30,3,118,62,56
2020,227526,30,4,2,1,1
2020,227526,40,0,164,81,83
2020,227526,40,5,164,81,83
2020,227526,42,0,13,6,7
2020,227526,42,5,13,6,7
2020,227526,43,0,151,75,76
2020,227526,43,5,151,75,76
2020,227526,50,0,7,3,4
2020,227687,0,0,38,14,24
2020,227687,10,0,38,14,24
2020,227687,10,1,1,1,0
2020,227687,10,2,3,1,2
2020,227687,10,3,4,3,1
2020,227687,10,4,30,9,21
2020,227687,20,0,1,1,0
2020,227687,20,1,1,1,0
2020,227687,40,0,37,13,24
2020,227687,40,2,3,1,2
2020,227687,40,3,4,3,1
2020,227687,40,4,30,9,21
2020,227687,41,0,1,1,0
2020,227687,41,4,1,1,0
2020,227687,42,0,36,12,24
2020,227687,42,2,3,1,2
2020,227687,42,3,4,3,1
2020,227687,42,4,29,8,21
2020,227687,44,0,1,1,0
2020,227687,44,4,1,1,0
2020,227757,0,0,698,442,256
2020,227757,10,0,698,442,256
2020,227757,10,1,310,236,74
2020,227757,10,2,109,67,42
2020,227757,10,3,123,71,52
2020,227757,10,4,14,6,8
2020,227757,10,5,140,60,80
2020,227757,10,6,2,2,0
2020,227757,20,0,418,303,115
2020,227757,20,1,310,236,74
2020,227757,20,2,108,67,41
2020,227757,30,0,123,71,52
2020,227757,30,3,123,71,52
2020,227757,40,0,157,68,89
2020,227757,40,2,1,0,1
2020,227757,40,4,14,6,8
2020,227757,40,5,140,60,80
2020,227757,40,6,2,2,0
2020,227757,41,0,129,53,76
2020,227757,41,4,11,5,6
2020,227757,41,5,116,46,70
2020,227757,41,6,2,2,0
2020,227757,42,0,28,15,13
2020,227757,42,2,1,0,1
2020,227757,42,4,3,1,2
2020,227757,42,5,24,14,10
2020,227757,44,0,129,53,76
2020,227757,44,4,11,5,6
2020,227757,44,5,116,46,70
2020,227757,44,6,2,2,0
2020,227845,0,0,162,74,88
2020,227845,10,0,162,74,88
2020,227845,10,1,42,20,22
2020,227845,10,2,62,23,39
2020,227845,10,3,51,29,22
2020,227845,10,4,4,2,2
2020,227845,10,5,3,0,3
2020,227845,20,0,84,35,49
2020,227845,20,1,41,20,21
2020,227845,20,2,43,15,28
2020,227845,30,0,65,33,32
2020,227845,30,1,1,0,1
2020,227845,30,2,19,8,11
2020,227845,30,3,45,25,20
2020,227845,40,0,13,6,7
2020,227845,40,3,6,4,2
2020,227845,40,4,4,2,2
2020,227845,40,5,3,0,3
2020,227845,42,0,13,6,7
2020,227845,42,3,6,4,2
2020,227845,42,4,4,2,2
2020,227845,42,5,3,0,3
2020,227854,0,0,238,131,107
2020,227854,10,0,192,100,92
2020,227854,10,1,16,8,8
2020,227854,10,2,23,12,11
2020,227854,10,3,57,30,27
2020,227854,10,4,96,50,46
2020,227854,20,0,61,31,30
2020,227854,20,1,15,7,8
2020,227854,20,2,15,9,6
2020,227854,20,3,17,12,5
2020,227854,20,4,14,3,11
2020,227854,30,0,1,1,0
2020,227854,30,4,1,1,0
2020,227854,40,0,130,68,62
2020,227854,40,1,1,1,0
2020,227854,40,2,8,3,5
2020,227854,40,3,40,18,22
2020,227854,40,4,81,46,35
2020,227854,42,0,130,68,62
2020,227854,42,1,1,1,0
2020,227854,42,2,8,3,5
2020,227854,42,3,40,18,22
2020,227854,42,4,81,46,35
2020,227854,50,0,46,31,15
2020,227863,0,0,129,70,59
2020,227863,10,0,129,70,59
2020,227863,10,1,27,15,12
2020,227863,10,2,46,29,17
2020,227863,10,3,43,21,22
2020,227863,10,4,12,5,7
2020,227863,10,6,1,0,1
2020,227863,20,0,71,43,28
2020,227863,20,1,24,15,9
2020,227863,20,2,44,27,17
2020,227863,20,3,3,1,2
2020,227863,30,0,13,9,4
2020,227863,30,3,13,9,4
2020,227863,40,0,45,18,27
2020,227863,40,1,3,0,3
2020,227863,40,2,2,2,0
2020,227863,40,3,27,11,16
2020,227863,40,4,12,5,7
2020,227863,40,6,1,0,1
2020,227863,42,0,45,18,27
2020,227863,42,1,3,0,3
2020,227863,42,2,2,2,0
2020,227863,42,3,27,11,16
2020,227863,42,4,12,5,7
2020,227863,42,6,1,0,1
2020,227881,0,0,804,410,394
2020,227881,10,0,804,410,394
2020,227881,10,1,191,125,66
2020,227881,10,2,185,106,79
2020,227881,10,3,185,84,101
2020,227881,10,4,1,0,1
2020,227881,10,5,242,95,147
2020,227881,20,0,365,221,144
2020,227881,20,1,190,124,66
2020,227881,20,2,172,97,75
2020,227881,20,3,2,0,2
2020,227881,20,4,1,0,1
2020,227881,30,0,197,94,103
2020,227881,30,1,1,1,0
2020,227881,30,2,13,9,4
2020,227881,30,3,183,84,99
2020,227881,40,0,242,95,147
2020,227881,40,5,242,95,147
2020,227881,42,0,169,63,106
2020,227881,42,5,169,63,106
2020,227881,43,0,73,32,41
2020,227881,43,5,73,32,41
2020,227924,0,0,296,134,162
2020,227924,10,0,254,119,135
2020,227924,10,1,88,39,49
2020,227924,10,2,31,14,17
2020,227924,10,3,57,25,32
2020,227924,10,4,78,41,37
2020,227924,20,0,166,76,90
2020,227924,20,1,87,39,48
2020,227924,20,2,28,14,14
2020,227924,20,3,30,14,16
2020,227924,20,4,21,9,12
2020,227924,40,0,88,43,45
2020,227924,40,1,1,0,1
2020,227924,40,2,3,0,3
2020,227924,40,3,27,11,16
2020,227924,40,4,57,32,25
2020,227924,42,0,88,43,45
2020,227924,42,1,1,0,1
2020,227924,42,2,3,0,3
2020,227924,42,3,27,11,16
2020,227924,42,4,57,32,25
2020,227924,50,0,42,15,27
2020,227979,0,0,522,236,286
2020,227979,10,0,522,236,286
2020,227979,10,6,522,236,286
2020,227979,40,0,522,236,286
2020,227979,40,6,522,236,286
2020,227979,42,0,522,236,286
2020,227979,42,6,522,236,286
2020,228042,0,0,61,33,28
2020,228042,10,0,61,33,28
2020,228042,10,1,10,5,5
2020,228042,10,2,15,7,8
2020,228042,10,3,23,18,5
2020,228042,10,4,13,3,10
2020,228042,20,0,15,8,7
2020,228042,20,1,9,5,4
2020,228042,20,2,6,3,3
2020,228042,30,0,24,17,7
2020,228042,30,2,9,4,5
2020,228042,30,3,15,13,2
2020,228042,40,0,22,8,14
2020,228042,40,1,1,0,1
2020,228042,40,3,8,5,3
2020,228042,40,4,13,3,10
2020,228042,41,0,3,0,3
2020,228042,41,1,1,0,1
2020,228042,41,3,2,0,2
2020,228042,43,0,19,8,11
2020,228042,43,3,6,5,1
2020,228042,43,4,13,3,10
2020,228042,45,0,3,0,3
2020,228042,45,1,1,0,1
2020,228042,45,3,2,0,2
2020,228149,0,0,209,125,84
2020,228149,10,0,209,125,84
2020,228149,10,1,93,64,29
2020,228149,10,2,54,34,20
2020,228149,10,3,37,17,20
2020,228149,10,4,21,10,11
2020,228149,10,5,4,0,4
2020,228149,20,0,136,95,41
2020,228149,20,1,83,61,22
2020,228149,20,2,51,32,19
2020,228149,20,3,2,2,0
2020,228149,30,0,29,12,17
2020,228149,30,2,2,1,1
2020,228149,30,3,27,11,16
2020,228149,40,0,44,18,26
2020,228149,40,1,10,3,7
2020,228149,40,2,1,1,0
2020,228149,40,3,8,4,4
2020,228149,40,4,21,10,11
2020,228149,40,5,4,0,4
2020,228149,41,0,12,4,8
2020,228149,41,1,9,2,7
2020,228149,41,4,3,2,1
2020,228149,42,0,32,14,18
2020,228149,42,1,1,1,0
2020,228149,42,2,1,1,0
2020,228149,42,3,8,4,4
2020,228149,42,4,18,8,10
2020,228149,42,5,4,0,4
2020,228149,44,0,12,4,8
2020,228149,44,1,9,2,7
2020,228149,44,4,3,2,1
2020,228158,0,0,259,123,136
2020,228158,10,0,259,123,136
2020,228158,10,1,53,27,26
2020,228158,10,2,38,21,17
2020,228158,10,3,87,39,48
2020,228158,10,4,81,36,45
2020,228158,20,0,173,92,81
2020,228158,20,1,52,27,25
2020,228158,20,2,37,20,17
2020,228158,20,3,69,35,34
2020,228158,20,4,15,10,5
2020,228158,30,0,82,29,53
2020,228158,30,1,1,0,1
2020,228158,30,2,1,1,0
2020,228158,30,3,17,4,13
2020,228158,30,4,63,24,39
2020,228158,40,0,4,2,2
2020,228158,40,3,1,0,1
2020,228158,40,4,3,2,1
2020,228158,42,0,4,2,2
2020,228158,42,3,1,0,1
2020,228158,42,4,3,2,1
2020,228194,0,0,50,30,20
2020,228194,10,0,50,30,20
2020,228194,10,1,43,27,16
2020,228194,10,2,5,1,4
2020,228194,10,3,2,2,0
2020,228194,20,0,43,27,16
2020,228194,20,1,43,27,16
2020,228194,30,0,2,2,0
2020,228194,30,3,2,2,0
2020,228194,40,0,5,1,4
2020,228194,40,2,5,1,4
2020,228194,42,0,5,1,4
2020,228194,42,2,5,1,4
2020,228246,0,0,767,449,318
2020,228246,10,0,767,449,318
2020,228246,10,1,217,169,48
2020,228246,10,2,158,104,54
2020,228246,10,3,111,50,61
2020,228246,10,4,131,70,61
2020,228246,10,5,143,52,91
2020,228246,10,6,7,4,3
2020,228246,20,0,373,270,103
2020,228246,20,1,216,168,48
2020,228246,20,2,156,102,54
2020,228246,20,3,1,0,1
2020,228246,30,0,113,53,60
2020,228246,30,1,1,1,0
2020,228246,30,2,2,2,0
2020,228246,30,3,110,50,60
2020,228246,40,0,281,126,155
2020,228246,40,4,131,70,61
2020,228246,40,5,143,52,91
2020,228246,40,6,7,4,3
2020,228246,41,0,212,97,115
2020,228246,41,4,93,52,41
2020,228246,41,5,114,42,72
2020,228246,41,6,5,3,2
2020,228246,42,0,69,29,40
2020,228246,42,4,38,18,20
2020,228246,42,5,29,10,19
2020,228246,42,6,2,1,1
2020,228246,44,0,212,97,115
2020,228246,44,4,93,52,41
2020,228246,44,5,114,42,72
2020,228246,44,6,5,3,2
2020,228316,0,0,122,60,62
2020,228316,10,0,121,59,62
2020,228316,10,1,7,4,3
2020,228316,10,2,1,1,0
2020,228316,10,3,8,4,4
2020,228316,10,4,104,49,55
2020,228316,10,6,1,1,0
2020,228316,20,0,17,10,7
2020,228316,20,1,7,4,3
2020,228316,20,2,1,1,0
2020,228316,20,3,3,1,2
2020,228316,20,4,6,4,2
2020,228316,30,0,20,10,10
2020,228316,30,3,5,3,2
2020,228316,30,4,14,6,8
2020,228316,30,6,1,1,0
2020,228316,40,0,84,39,45
2020,228316,40,4,84,39,45
2020,228316,42,0,83,38,45
2020,228316,42,4,83,38,45
2020,228316,43,0,1,1,0
2020,228316,43,4,1,1,0
2020,228316,50,0,1,1,0
2020,228325,0,0,65,41,24
2020,228325,10,0,65,41,24
2020,228325,10,1,23,17,6
2020,228325,10,2,10,6,4
2020,228325,10,3,16,10,6
2020,228325,10,4,16,8,8
2020,228325,40,0,65,41,24
2020,228325,40,1,23,17,6
2020,228325,40,2,10,6,4
2020,228325,40,3,16,10,6
2020,228325,40,4,16,8,8
2020,228325,41,0,7,6,1
2020,228325,41,1,3,2,1
2020,228325,41,2,2,2,0
2020,228325,41,3,1,1,0
2020,228325,41,4,1,1,0
2020,228325,42,0,56,35,21
2020,228325,42,1,20,15,5
2020,228325,42,2,8,4,4
2020,228325,42,3,15,9,6
2020,228325,42,4,13,7,6
2020,228325,43,0,2,0,2
2020,228325,43,4,2,0,2
2020,228325,45,0,7,6,1
2020,228325,45,1,3,2,1
2020,228325,45,2,2,2,0
2020,228325,45,3,1,1,0
2020,228325,45,4,1,1,0
2020,228343,0,0,110,49,61
2020,228343,10,0,110,49,61
2020,228343,10,1,39,15,24
2020,228343,10,2,36,21,15
2020,228343,10,3,16,7,9
2020,228343,10,4,19,6,13
2020,228343,20,0,75,36,39
2020,228343,20,1,39,15,24
2020,228343,20,2,36,21,15
2020,228343,30,0,16,7,9
2020,228343,30,3,16,7,9
2020,228343,40,0,19,6,13
2020,228343,40,4,19,6,13
2020,228343,41,0,13,4,9
2020,228343,41,4,13,4,9
2020,228343,42,0,6,2,4
2020,228343,42,4,6,2,4
2020,228343,44,0,5,0,5
2020,228343,44,4,5,0,5
2020,228343,45,0,8,4,4
2020,228343,45,4,8,4,4
2020,228431,0,0,530,266,264
2020,228431,10,0,530,266,264
2020,228431,10,1,117,83,34
2020,228431,10,2,146,83,63
2020,228431,10,3,128,63,65
2020,228431,10,4,50,7,43
2020,228431,10,5,80,27,53
2020,228431,10,6,9,3,6
2020,228431,20,0,274,171,103
2020,228431,20,1,117,83,34
2020,228431,20,2,133,77,56
2020,228431,20,3,19,10,9
2020,228431,20,4,3,1,2
2020,228431,20,5,2,0,2
2020,228431,30,0,115,54,61
2020,228431,30,2,13,6,7
2020,228431,30,3,98,46,52
2020,228431,30,4,4,2,2
2020,228431,40,0,141,41,100
2020,228431,40,3,11,7,4
2020,228431,40,4,43,4,39
2020,228431,40,5,78,27,51
2020,228431,40,6,9,3,6
2020,228431,42,0,55,14,41
2020,228431,42,4,20,2,18
2020,228431,42,5,32,11,21
2020,228431,42,6,3,1,2
2020,228431,43,0,86,27,59
2020,228431,43,3,11,7,4
2020,228431,43,4,23,2,21
2020,228431,43,5,46,16,30
2020,228431,43,6,6,2,4
2020,228459,0,0,1298,642,656
2020,228459,10,0,1278,630,648
2020,228459,10,1,277,172,105
2020,228459,10,2,278,139,139
2020,228459,10,3,259,117,142
2020,228459,10,5,464,202,262
2020,228459,20,0,520,294,226
2020,228459,20,1,265,162,103
2020,228459,20,2,251,130,121
2020,228459,20,3,4,2,2
2020,228459,30,0,228,106,122
2020,228459,30,1,2,2,0
2020,228459,30,2,6,4,2
2020,228459,30,3,220,100,120
2020,228459,40,0,530,230,300
2020,228459,40,1,10,8,2
2020,228459,40,2,21,5,16
2020,228459,40,3,35,15,20
2020,228459,40,5,464,202,262
2020,228459,41,0,268,106,162
2020,228459,41,1,8,6,2
2020,228459,41,2,21,5,16
2020,228459,41,3,17,4,13
2020,228459,41,5,222,91,131
2020,228459,42,0,262,124,138
2020,228459,42,1,2,2,0
2020,228459,42,3,18,11,7
2020,228459,42,5,242,111,131
2020,228459,44,0,268,106,162
2020,228459,44,1,8,6,2
2020,228459,44,2,21,5,16
2020,228459,44,3,17,4,13
2020,228459,44,5,222,91,131
2020,228459,50,0,20,12,8
2020,228468,0,0,44,27,17
2020,228468,10,0,44,27,17
2020,228468,10,1,12,11,1
2020,228468,10,2,13,8,5
2020,228468,10,3,19,8,11
2020,228468,40,0,44,27,17
2020,228468,40,1,12,11,1
2020,228468,40,2,13,8,5
2020,228468,40,3,19,8,11
2020,228468,41,0,20,17,3
2020,228468,41,1,11,10,1
2020,228468,41,2,6,4,2
2020,228468,41,3,3,3,0
2020,228468,42,0,24,10,14
2020,228468,42,1,1,1,0
2020,228468,42,2,7,4,3
2020,228468,42,3,16,5,11
2020,228468,45,0,20,17,3
2020,228468,45,1,11,10,1
2020,228468,45,2,6,4,2
2020,228468,45,3,3,3,0
2020,228486,0,0,9,5,4
2020,228486,10,0,9,5,4
2020,228486,10,2,9,5,4
2020,228486,40,0,9,5,4
2020,228486,40,2,9,5,4
2020,228486,42,0,9,5,4
2020,228486,42,2,9,5,4
2020,228501,0,0,108,60,48
2020,228501,10,0,108,60,48
2020,228501,10,1,27,17,10
2020,228501,10,2,17,11,6
2020,228501,10,3,38,23,15
2020,228501,10,4,4,1,3
2020,228501,10,5,18,7,11
2020,228501,10,6,4,1,3
2020,228501,20,0,37,23,14
2020,228501,20,1,27,17,10
2020,228501,20,2,10,6,4
2020,228501,30,0,47,29,18
2020,228501,30,2,7,5,2
2020,228501,30,3,34,22,12
2020,228501,30,4,4,1,3
2020,228501,30,5,1,1,0
2020,228501,30,6,1,0,1
2020,228501,40,0,24,8,16
2020,228501,40,3,4,1,3
2020,228501,40,5,17,6,11
2020,228501,40,6,3,1,2
2020,228501,42,0,17,6,11
2020,228501,42,3,4,1,3
2020,228501,42,5,13,5,8
2020,228501,43,0,7,2,5
2020,228501,43,5,4,1,3
2020,228501,43,6,3,1,2
2020,228529,0,0,433,226,207
2020,228529,10,0,429,225,204
2020,228529,10,1,83,61,22
2020,228529,10,2,113,63,50
2020,228529,10,3,144,69,75
2020,228529,10,4,87,30,57
2020,228529,10,5,2,2,0
2020,228529,20,0,178,115,63
2020,228529,20,1,78,57,21
2020,228529,20,2,100,58,42
2020,228529,30,0,122,65,57
2020,228529,30,1,3,2,1
2020,228529,30,2,8,5,3
2020,228529,30,3,110,57,53
2020,228529,30,4,1,1,0
2020,228529,40,0,129,45,84
2020,228529,40,1,2,2,0
2020,228529,40,2,5,0,5
2020,228529,40,3,34,12,22
2020,228529,40,4,86,29,57
2020,228529,40,5,2,2,0
2020,228529,41,0,41,14,27
2020,228529,41,1,2,2,0
2020,228529,41,2,5,0,5
2020,228529,41,3,34,12,22
2020,228529,42,0,88,31,57
2020,228529,42,4,86,29,57
2020,228529,42,5,2,2,0
2020,228529,45,0,41,14,27
2020,228529,45,1,2,2,0
2020,228529,45,2,5,0,5
2020,228529,45,3,34,12,22
2020,228529,50,0,4,1,3
2020,228547,0,0,758,327,431
2020,228547,10,0,758,327,431
2020,228547,10,1,120,62,58
2020,228547,10,2,138,61,77
2020,228547,10,3,147,46,101
2020,228547,10,4,353,158,195
2020,228547,20,0,298,125,173
2020,228547,20,1,114,58,56
2020,228547,20,2,85,38,47
2020,228547,20,3,97,29,68
2020,228547,20,4,2,0,2
2020,228547,30,0,440,195,245
2020,228547,30,1,6,4,2
2020,228547,30,2,53,23,30
2020,228547,30,3,50,17,33
2020,228547,30,4,331,151,180
2020,228547,40,0,20,7,13
2020,228547,40,4,20,7,13
2020,228547,42,0,18,6,12
2020,228547,42,4,18,6,12
2020,228547,43,0,2,1,1
2020,228547,43,4,2,1,1
2020,228608,0,0,131,55,76
2020,228608,10,0,130,55,75
2020,228608,10,1,45,21,24
2020,228608,10,2,37,16,21
2020,228608,10,3,47,18,29
2020,228608,10,4,1,0,1
2020,228608,20,0,67,34,33
2020,228608,20,1,41,21,20
2020,228608,20,2,24,12,12
2020,228608,20,3,1,1,0
2020,228608,20,4,1,0,1
2020,228608,30,0,62,21,41
2020,228608,30,1,4,0,4
2020,228608,30,2,13,4,9
2020,228608,30,3,45,17,28
2020,228608,40,0,1,0,1
2020,228608,40,3,1,0,1
2020,228608,42,0,1,0,1
2020,228608,42,3,1,0,1
2020,228608,50,0,1,0,1
2020,228635,0,0,1905,1067,838
2020,228635,10,0,1905,1067,838
2020,228635,10,1,410,296,114
2020,228635,10,2,425,253,172
2020,228635,10,3,1027,497,530
2020,228635,10,4,43,21,22
2020,228635,20,0,167,129,38
2020,228635,20,1,136,108,28
2020,228635,20,2,31,21,10
2020,228635,30,0,54,40,14
2020,228635,30,2,1,0,1
2020,228635,30,3,53,40,13
2020,228635,40,0,1684,898,786
2020,228635,40,1,274,188,86
2020,228635,40,2,393,232,161
2020,228635,40,3,974,457,517
2020,228635,40,4,43,21,22
2020,228635,42,0,1684,898,786
2020,228635,42,1,274,188,86
2020,228635,42,2,393,232,161
2020,228635,42,3,974,457,517
2020,228635,42,4,43,21,22
2020,228644,0,0,776,398,378
2020,228644,10,0,776,398,378
2020,228644,10,1,195,143,52
2020,228644,10,2,207,113,94
2020,228644,10,3,327,126,201
2020,228644,10,4,14,7,7
2020,228644,10,5,1,0,1
2020,228644,10,6,32,9,23
2020,228644,20,0,195,131,64
2020,228644,20,1,133,99,34
2020,228644,20,2,62,32,30
2020,228644,30,0,64,31,33
2020,228644,30,1,2,1,1
2020,228644,30,2,13,9,4
2020,228644,30,3,49,21,28
2020,228644,40,0,517,236,281
2020,228644,40,1,60,43,17
2020,228644,40,2,132,72,60
2020,228644,40,3,278,105,173
2020,228644,40,4,14,7,7
2020,228644,40,5,1,0,1
2020,228644,40,6,32,9,23
2020,228644,42,0,514,235,279
2020,228644,42,1,60,43,17
2020,228644,42,2,132,72,60
2020,228644,42,3,275,104,171
2020,228644,42,4,14,7,7
2020,228644,42,5,1,0,1
2020,228644,42,6,32,9,23
2020,228644,43,0,3,1,2
2020,228644,43,3,3,1,2
2020,228653,0,0,582,301,281
2020,228653,10,0,582,301,281
2020,228653,10,1,182,122,60
2020,228653,10,2,150,71,79
2020,228653,10,3,245,105,140
2020,228653,10,4,3,2,1
2020,228653,10,6,2,1,1
2020,228653,20,0,179,118,61
2020,228653,20,1,136,98,38
2020,228653,20,2,43,20,23
2020,228653,30,0,60,32,28
2020,228653,30,1,2,2,0
2020,228653,30,2,24,14,10
2020,228653,30,3,34,16,18
2020,228653,40,0,343,151,192
2020,228653,40,1,44,22,22
2020,228653,40,2,83,37,46
2020,228653,40,3,211,89,122
2020,228653,40,4,3,2,1
2020,228653,40,6,2,1,1
2020,228653,42,0,343,151,192
2020,228653,42,1,44,22,22
2020,228653,42,2,83,37,46
2020,228653,42,3,211,89,122
2020,228653,42,4,3,2,1
2020,228653,42,6,2,1,1
2020,228699,0,0,99,38,61
2020,228699,10,0,99,38,61
2020,228699,10,1,24,10,14
2020,228699,10,2,27,8,19
2020,228699,10,3,27,6,21
2020,228699,10,4,11,8,3
2020,228699,10,6,10,6,4
2020,228699,20,0,34,13,21
2020,228699,20,1,18,8,10
2020,228699,20,2,16,5,11
2020,228699,40,0,65,25,40
2020,228699,40,1,6,2,4
2020,228699,40,2,11,3,8
2020,228699,40,3,27,6,21
2020,228699,40,4,11,8,3
2020,228699,40,6,10,6,4
2020,228699,41,0,10,6,4
2020,228699,41,6,10,6,4
2020,228699,42,0,55,19,36
2020,228699,42,1,6,2,4
2020,228699,42,2,11,3,8
2020,228699,42,3,27,6,21
2020,228699,42,4,11,8,3
2020,228699,45,0,10,6,4
2020,228699,45,6,10,6,4
2020,228705,0,0,341,219,122
2020,228705,10,0,341,219,122
2020,228705,10,1,101,78,23
2020,228705,10,2,95,61,34
2020,228705,10,3,97,61,36
2020,228705,10,4,3,0,3
2020,228705,10,5,35,15,20
2020,228705,10,6,10,4,6
2020,228705,20,0,187,131,56
2020,228705,20,1,98,75,23
2020,228705,20,2,88,56,32
2020,228705,20,3,1,0,1
2020,228705,30,0,76,52,24
2020,228705,30,2,6,5,1
2020,228705,30,3,70,47,23
2020,228705,40,0,78,36,42
2020,228705,40,1,3,3,0
2020,228705,40,2,1,0,1
2020,228705,40,3,26,14,12
2020,228705,40,4,3,0,3
2020,228705,40,5,35,15,20
2020,228705,40,6,10,4,6
2020,228705,41,0,9,6,3
2020,228705,41,3,9,6,3
2020,228705,42,0,59,26,33
2020,228705,42,1,3,3,0
2020,228705,42,2,1,0,1
2020,228705,42,3,17,8,9
2020,228705,42,4,3,0,3
2020,228705,42,5,35,15,20
2020,228705,43,0,10,4,6
2020,228705,43,6,10,4,6
2020,228705,45,0,9,6,3
2020,228705,45,3,9,6,3
2020,228723,0,0,3299,2072,1227
2020,228723,10,0,3299,2072,1227
2020,228723,10,1,1176,928,248
2020,228723,10,2,719,440,279
2020,228723,10,3,666,341,325
2020,228723,10,4,502,248,254
2020,228723,10,5,236,115,121
2020,228723,20,0,1575,1157,418
2020,228723,20,1,1020,805,215
2020,228723,20,2,546,347,199
2020,228723,20,3,6,3,3
2020,228723,20,4,3,2,1
2020,228723,30,0,470,273,197
2020,228723,30,1,8,7,1
2020,228723,30,2,57,38,19
2020,228723,30,3,403,228,175
2020,228723,30,4,2,0,2
2020,228723,40,0,1254,642,612
2020,228723,40,1,148,116,32
2020,228723,40,2,116,55,61
2020,228723,40,3,257,110,147
2020,228723,40,4,497,246,251
2020,228723,40,5,236,115,121
2020,228723,41,0,115,66,49
2020,228723,41,1,15,13,2
2020,228723,41,2,14,5,9
2020,228723,41,3,29,20,9
2020,228723,41,4,46,25,21
2020,228723,41,5,11,3,8
2020,228723,42,0,1093,550,543
2020,228723,42,1,131,102,29
2020,228723,42,2,93,46,47
2020,228723,42,3,216,83,133
2020,228723,42,4,437,213,224
2020,228723,42,5,216,106,110
2020,228723,43,0,46,26,20
2020,228723,43,1,2,1,1
2020,228723,43,2,9,4,5
2020,228723,43,3,12,7,5
2020,228723,43,4,14,8,6
2020,228723,43,5,9,6,3
2020,228723,44,0,115,66,49
2020,228723,44,1,15,13,2
2020,228723,44,2,14,5,9
2020,228723,44,3,29,20,9
2020,228723,44,4,46,25,21
2020,228723,44,5,11,3,8
2020,228769,0,0,1093,571,522
2020,228769,10,0,1093,571,522
2020,228769,10,1,241,191,50
2020,228769,10,2,206,126,80
2020,228769,10,3,187,87,100
2020,228769,10,5,184,93,91
2020,228769,10,6,275,74,201
2020,228769,20,0,447,317,130
2020,228769,20,1,241,191,50
2020,228769,20,2,206,126,80
2020,228769,30,0,187,87,100
2020,228769,30,3,187,87,100
2020,228769,40,0,459,167,292
2020,228769,40,5,184,93,91
2020,228769,40,6,275,74,201
2020,228769,42,0,184,93,91
2020,228769,42,5,184,93,91
2020,228769,43,0,275,74,201
2020,228769,43,6,275,74,201
2020,228778,0,0,2801,1593,1208
2020,228778,10,0,2801,1593,1208
2020,228778,10,1,979,698,281
2020,228778,10,2,521,287,234
2020,228778,10,3,372,194,178
2020,228778,10,4,41,15,26
2020,228778,10,5,846,377,469
2020,228778,10,6,42,22,20
2020,228778,20,0,1488,979,509
2020,228778,20,1,977,697,280
2020,228778,20,2,511,282,229
2020,228778,30,0,384,200,184
2020,228778,30,1,2,1,1
2020,228778,30,2,10,5,5
2020,228778,30,3,372,194,178
2020,228778,40,0,929,414,515
2020,228778,40,4,41,15,26
2020,228778,40,5,846,377,469
2020,228778,40,6,42,22,20
2020,228778,41,0,339,159,180
2020,228778,41,4,11,9,2
2020,228778,41,5,328,150,178
2020,228778,42,0,563,239,324
2020,228778,42,4,29,6,23
2020,228778,42,5,492,211,281
2020,228778,42,6,42,22,20
2020,228778,43,0,27,16,11
2020,228778,43,4,1,0,1
2020,228778,43,5,26,16,10
2020,228778,44,0,339,159,180
2020,228778,44,4,11,9,2
2020,228778,44,5,328,150,178
2020,228787,0,0,908,601,307
2020,228787,10,0,908,601,307
2020,228787,10,1,253,209,44
2020,228787,10,2,154,110,44
2020,228787,10,3,132,86,46
2020,228787,10,5,369,196,173
2020,228787,20,0,403,316,87
2020,228787,20,1,252,208,44
2020,228787,20,2,151,108,43
2020,228787,30,0,136,89,47
2020,228787,30,1,1,1,0
2020,228787,30,2,3,2,1
2020,228787,30,3,132,86,46
2020,228787,40,0,369,196,173
2020,228787,40,5,369,196,173
2020,228787,42,0,368,196,172
2020,228787,42,5,368,196,172
2020,228787,43,0,1,0,1
2020,228787,43,5,1,0,1
2020,228796,0,0,765,430,335
2020,228796,10,0,765,430,335
2020,228796,10,1,162,129,33
2020,228796,10,2,180,119,61
2020,228796,10,3,133,70,63
2020,228796,10,5,290,112,178
2020,228796,20,0,335,242,93
2020,228796,20,1,162,129,33
2020,228796,20,2,173,113,60
2020,228796,30,0,140,76,64
2020,228796,30,2,7,6,1
2020,228796,30,3,133,70,63
2020,228796,40,0,290,112,178
2020,228796,40,5,290,112,178
2020,228796,42,0,286,111,175
2020,228796,42,5,286,111,175
2020,228796,43,0,4,1,3
2020,228796,43,5,4,1,3
2020,228802,0,0,358,166,192
2020,228802,10,0,358,166,192
2020,228802,10,1,65,47,18
2020,228802,10,2,96,52,44
2020,228802,10,3,63,31,32
2020,228802,10,4,81,13,68
2020,228802,10,5,52,23,29
2020,228802,10,6,1,0,1
2020,228802,20,0,151,94,57
2020,228802,20,1,63,45,18
2020,228802,20,2,88,49,39
2020,228802,30,0,68,34,34
2020,228802,30,2,6,3,3
2020,228802,30,3,62,31,31
2020,228802,40,0,139,38,101
2020,228802,40,1,2,2,0
2020,228802,40,2,2,0,2
2020,228802,40,3,1,0,1
2020,228802,40,4,81,13,68
2020,228802,40,5,52,23,29
2020,228802,40,6,1,0,1
2020,228802,42,0,137,36,101
2020,228802,42,1,2,2,0
2020,228802,42,2,2,0,2
2020,228802,42,3,1,0,1
2020,228802,42,4,79,11,68
2020,228802,42,5,52,23,29
2020,228802,42,6,1,0,1
2020,228802,43,0,2,2,0
2020,228802,43,4,2,2,0
2020,228866,0,0,22,14,8
2020,228866,10,0,22,14,8
2020,228866,10,1,9,5,4
2020,228866,10,2,4,3,1
2020,228866,10,3,7,6,1
2020,228866,10,4,2,0,2
2020,228866,40,0,22,14,8
2020,228866,40,1,9,5,4
2020,228866,40,2,4,3,1
2020,228866,40,3,7,6,1
2020,228866,40,4,2,0,2
2020,228866,42,0,22,14,8
2020,228866,42,1,9,5,4
2020,228866,42,2,4,3,1
2020,228866,42,3,7,6,1
2020,228866,42,4,2,0,2
2020,228875,0,0,725,359,366
2020,228875,10,0,722,358,364
2020,228875,10,1,205,134,71
2020,228875,10,2,229,119,110
2020,228875,10,3,161,60,101
2020,228875,10,4,87,35,52
2020,228875,10,5,40,10,30
2020,228875,20,0,356,216,140
2020,228875,20,1,179,122,57
2020,228875,20,2,175,94,81
2020,228875,20,3,2,0,2
2020,228875,30,0,111,49,62
2020,228875,30,2,7,3,4
2020,228875,30,3,103,46,57
2020,228875,30,5,1,0,1
2020,228875,40,0,255,93,162
2020,228875,40,1,26,12,14
2020,228875,40,2,47,22,25
2020,228875,40,3,56,14,42
2020,228875,40,4,87,35,52
2020,228875,40,5,39,10,29
2020,228875,41,0,79,33,46
2020,228875,41,1,15,4,11
2020,228875,41,2,20,11,9
2020,228875,41,3,7,6,1
2020,228875,41,4,37,12,25
2020,228875,42,0,172,59,113
2020,228875,42,1,11,8,3
2020,228875,42,2,27,11,16
2020,228875,42,3,49,8,41
2020,228875,42,4,50,23,27
2020,228875,42,5,35,9,26
2020,228875,43,0,4,1,3
2020,228875,43,5,4,1,3
2020,228875,44,0,79,33,46
2020,228875,44,1,15,4,11
2020,228875,44,2,20,11,9
2020,228875,44,3,7,6,1
2020,228875,44,4,37,12,25
2020,228875,50,0,3,1,2
2020,228884,0,0,33,18,15
2020,228884,10,0,33,18,15
2020,228884,10,1,2,1,1
2020,228884,10,2,10,7,3
2020,228884,10,3,10,6,4
2020,228884,10,4,11,4,7
2020,228884,30,0,33,18,15
2020,228884,30,1,2,1,1
2020,228884,30,2,10,7,3
2020,228884,30,3,10,6,4
2020,228884,30,4,11,4,7
2020,228909,0,0,240,111,129
2020,228909,10,0,240,111,129
2020,228909,10,1,56,44,12
2020,228909,10,2,60,31,29
2020,228909,10,3,110,34,76
2020,228909,10,4,14,2,12
2020,228909,20,0,64,45,19
2020,228909,20,1,43,35,8
2020,228909,20,2,20,10,10
2020,228909,20,3,1,0,1
2020,228909,30,0,31,15,16
2020,228909,30,1,1,1,0
2020,228909,30,2,12,7,5
2020,228909,30,3,18,7,11
2020,228909,40,0,145,51,94
2020,228909,40,1,12,8,4
2020,228909,40,2,28,14,14
2020,228909,40,3,91,27,64
2020,228909,40,4,14,2,12
2020,228909,42,0,145,51,94
2020,228909,42,1,12,8,4
2020,228909,42,2,28,14,14
2020,228909,42,3,91,27,64
2020,228909,42,4,14,2,12
2020,228981,0,0,84,37,47
2020,228981,10,0,84,37,47
2020,228981,10,1,24,14,10
2020,228981,10,2,28,13,15
2020,228981,10,3,21,9,12
2020,228981,10,4,3,0,3
2020,228981,10,5,5,1,4
2020,228981,10,6,3,0,3
2020,228981,20,0,52,28,24
2020,228981,20,1,24,14,10
2020,228981,20,2,27,13,14
2020,228981,20,3,1,1,0
2020,228981,30,0,19,4,15
2020,228981,30,2,1,0,1
2020,228981,30,3,15,4,11
2020,228981,30,4,3,0,3
2020,228981,40,0,13,5,8
2020,228981,40,3,5,4,1
2020,228981,40,5,5,1,4
2020,228981,40,6,3,0,3
2020,228981,42,0,13,5,8
2020,228981,42,3,5,4,1
2020,228981,42,5,5,1,4
2020,228981,42,6,3,0,3
2020,229018,0,0,166,98,68
2020,229018,10,0,166,98,68
2020,229018,10,1,29,22,7
2020,229018,10,2,39,28,11
2020,229018,10,3,53,32,21
2020,229018,10,5,45,16,29
2020,229018,20,0,62,44,18
2020,229018,20,1,27,20,7
2020,229018,20,2,35,24,11
2020,229018,30,0,58,38,20
2020,229018,30,1,2,2,0
2020,229018,30,2,4,4,0
2020,229018,30,3,52,32,20
2020,229018,40,0,46,16,30
2020,229018,40,3,1,0,1
2020,229018,40,5,45,16,29
2020,229018,42,0,46,16,30
2020,229018,42,3,1,0,1
2020,229018,42,5,45,16,29
2020,229027,0,0,958,568,390
2020,229027,10,0,958,568,390
2020,229027,10,1,259,192,67
2020,229027,10,2,227,143,84
2020,229027,10,3,232,124,108
2020,229027,10,5,236,108,128
2020,229027,10,6,4,1,3
2020,229027,20,0,456,313,143
2020,229027,20,1,253,189,64
2020,229027,20,2,203,124,79
2020,229027,30,0,189,102,87
2020,229027,30,2,8,7,1
2020,229027,30,3,181,95,86
2020,229027,40,0,313,153,160
2020,229027,40,1,6,3,3
2020,229027,40,2,16,12,4
2020,229027,40,3,51,29,22
2020,229027,40,5,236,108,128
2020,229027,40,6,4,1,3
2020,229027,41,0,69,46,23
2020,229027,41,1,3,2,1
2020,229027,41,2,11,10,1
2020,229027,41,3,7,6,1
2020,229027,41,5,48,28,20
2020,229027,42,0,244,107,137
2020,229027,42,1,3,1,2
2020,229027,42,2,5,2,3
2020,229027,42,3,44,23,21
2020,229027,42,5,188,80,108
2020,229027,42,6,4,1,3
2020,229027,44,0,69,46,23
2020,229027,44,1,3,2,1
2020,229027,44,2,11,10,1
2020,229027,44,3,7,6,1
2020,229027,44,5,48,28,20
2020,229063,0,0,396,194,202
2020,229063,10,0,396,194,202
2020,229063,10,1,129,76,53
2020,229063,10,2,82,42,40
2020,229063,10,3,19,8,11
2020,229063,10,6,166,68,98
2020,229063,20,0,216,122,94
2020,229063,20,1,129,76,53
2020,229063,20,2,82,42,40
2020,229063,20,3,5,4,1
2020,229063,30,0,14,4,10
2020,229063,30,3,14,4,10
2020,229063,40,0,166,68,98
2020,229063,40,6,166,68,98
2020,229063,42,0,161,67,94
2020,229063,42,6,161,67,94
2020,229063,43,0,5,1,4
2020,229063,43,6,5,1,4
2020,229115,0,0,1468,877,591
2020,229115,10,0,1468,877,591
2020,229115,10,1,412,302,110
2020,229115,10,2,407,276,131
2020,229115,10,3,351,185,166
2020,229115,10,4,231,79,152
2020,229115,10,5,9,6,3
2020,229115,10,6,58,29,29
2020,229115,20,0,792,553,239
2020,229115,20,1,397,292,105
2020,229115,20,2,355,241,114
2020,229115,20,3,3,3,0
2020,229115,20,6,37,17,20
2020,229115,30,0,336,185,151
2020,229115,30,1,4,3,1
2020,229115,30,2,24,19,5
2020,229115,30,3,297,159,138
2020,229115,30,6,11,4,7
2020,229115,40,0,340,139,201
2020,229115,40,1,11,7,4
2020,229115,40,2,28,16,12
2020,229115,40,3,51,23,28
2020,229115,40,4,231,79,152
2020,229115,40,5,9,6,3
2020,229115,40,6,10,8,2
2020,229115,42,0,41,16,25
2020,229115,42,1,1,1,0
2020,229115,42,2,2,0,2
2020,229115,42,3,2,0,2
2020,229115,42,4,29,8,21
2020,229115,42,6,7,7,0
2020,229115,43,0,299,123,176
2020,229115,43,1,10,6,4
2020,229115,43,2,26,16,10
2020,229115,43,3,49,23,26
2020,229115,43,4,202,71,131
2020,229115,43,5,9,6,3
2020,229115,43,6,3,1,2
2020,229160,0,0,113,57,56
2020,229160,10,0,113,57,56
2020,229160,10,1,30,18,12
2020,229160,10,2,46,20,26
2020,229160,10,3,31,17,14
2020,229160,10,4,6,2,4
2020,229160,20,0,75,40,35
2020,229160,20,1,29,17,12
2020,229160,20,2,42,20,22
2020,229160,20,3,4,3,1
2020,229160,30,0,31,13,18
2020,229160,30,1,1,1,0
2020,229160,30,2,4,0,4
2020,229160,30,3,24,11,13
2020,229160,30,4,2,1,1
2020,229160,40,0,7,4,3
2020,229160,40,3,3,3,0
2020,229160,40,4,4,1,3
2020,229160,43,0,7,4,3
2020,229160,43,3,3,3,0
2020,229160,43,4,4,1,3
2020,229179,0,0,452,110,342
2020,229179,10,0,452,110,342
2020,229179,10,1,122,33,89
2020,229179,10,2,144,34,110
2020,229179,10,3,159,37,122
2020,229179,10,4,6,1,5
2020,229179,10,5,21,5,16
2020,229179,20,0,209,61,148
2020,229179,20,1,111,32,79
2020,229179,20,2,97,29,68
2020,229179,20,3,1,0,1
2020,229179,30,0,119,34,85
2020,229179,30,1,3,0,3
2020,229179,30,2,11,2,9
2020,229179,30,3,105,32,73
2020,229179,40,0,124,15,109
2020,229179,40,1,8,1,7
2020,229179,40,2,36,3,33
2020,229179,40,3,53,5,48
2020,229179,40,4,6,1,5
2020,229179,40,5,21,5,16
2020,229179,42,0,124,15,109
2020,229179,42,1,8,1,7
2020,229179,42,2,36,3,33
2020,229179,42,3,53,5,48
2020,229179,42,4,6,1,5
2020,229179,42,5,21,5,16
2020,229267,0,0,267,153,114
2020,229267,10,0,267,153,114
2020,229267,10,1,99,61,38
2020,229267,10,2,88,53,35
2020,229267,10,3,68,36,32
2020,229267,10,4,1,0,1
2020,229267,10,5,10,3,7
2020,229267,10,6,1,0,1
2020,229267,20,0,181,108,73
2020,229267,20,1,94,56,38
2020,229267,20,2,87,52,35
2020,229267,30,0,46,22,24
2020,229267,30,3,46,22,24
2020,229267,40,0,40,23,17
2020,229267,40,1,5,5,0
2020,229267,40,2,1,1,0
2020,229267,40,3,22,14,8
2020,229267,40,4,1,0,1
2020,229267,40,5,10,3,7
2020,229267,40,6,1,0,1
2020,229267,42,0,40,23,17
2020,229267,42,1,5,5,0
2020,229267,42,2,1,1,0
2020,229267,42,3,22,14,8
2020,229267,42,4,1,0,1
2020,229267,42,5,10,3,7
2020,229267,42,6,1,0,1
2020,229300,0,0,1816,959,857
2020,229300,10,0,1805,956,849
2020,229300,10,1,334,226,108
2020,229300,10,2,415,219,196
2020,229300,10,3,978,487,491
2020,229300,10,4,67,21,46
2020,229300,10,6,11,3,8
2020,229300,20,0,256,174,82
2020,229300,20,1,184,131,53
2020,229300,20,2,72,43,29
2020,229300,30,0,140,83,57
2020,229300,30,1,14,12,2
2020,229300,30,2,32,15,17
2020,229300,30,3,94,56,38
2020,229300,40,0,1409,699,710
2020,229300,40,1,136,83,53
2020,229300,40,2,311,161,150
2020,229300,40,3,884,431,453
2020,229300,40,4,67,21,46
2020,229300,40,6,11,3,8
2020,229300,42,0,1409,699,710
2020,229300,42,1,136,83,53
2020,229300,42,2,311,161,150
2020,229300,42,3,884,431,453
2020,229300,42,4,67,21,46
2020,229300,42,6,11,3,8
2020,229300,50,0,11,3,8
2020,229337,0,0,744,347,397
2020,229337,10,0,744,347,397
2020,229337,10,1,155,100,55
2020,229337,10,2,213,108,105
2020,229337,10,3,311,119,192
2020,229337,10,4,32,6,26
2020,229337,10,6,33,14,19
2020,229337,20,0,136,87,49
2020,229337,20,1,96,68,28
2020,229337,20,2,40,19,21
2020,229337,30,0,67,43,24
2020,229337,30,1,4,4,0
2020,229337,30,2,16,12,4
2020,229337,30,3,47,27,20
2020,229337,40,0,541,217,324
2020,229337,40,1,55,28,27
2020,229337,40,2,157,77,80
2020,229337,40,3,264,92,172
2020,229337,40,4,32,6,26
2020,229337,40,6,33,14,19
2020,229337,42,0,541,217,324
2020,229337,42,1,55,28,27
2020,229337,42,2,157,77,80
2020,229337,42,3,264,92,172
2020,229337,42,4,32,6,26
2020,229337,42,6,33,14,19
2020,229355,0,0,319,139,180
2020,229355,10,0,319,139,180
2020,229355,10,1,319,139,180
2020,229355,40,0,319,139,180
2020,229355,40,1,319,139,180
2020,229355,41,0,193,85,108
2020,229355,41,1,193,85,108
2020,229355,42,0,126,54,72
2020,229355,42,1,126,54,72
2020,229355,44,0,193,85,108
2020,229355,44,1,193,85,108
2020,229504,0,0,85,34,51
2020,229504,10,0,85,34,51
2020,229504,10,6,85,34,51
2020,229504,40,0,85,34,51
2020,229504,40,6,85,34,51
2020,229504,42,0,85,34,51
2020,229504,42,6,85,34,51
2020,229540,0,0,91,36,55
2020,229540,10,0,91,36,55
2020,229540,10,1,26,8,18
2020,229540,10,2,32,12,20
2020,229540,10,3,12,6,6
2020,229540,10,4,18,8,10
2020,229540,10,6,3,2,1
2020,229540,20,0,58,22,36
2020,229540,20,1,26,8,18
2020,229540,20,2,21,8,13
2020,229540,20,3,3,2,1
2020,229540,20,4,8,4,4
2020,229540,30,0,30,13,17
2020,229540,30,2,11,4,7
2020,229540,30,3,8,4,4
2020,229540,30,4,8,3,5
2020,229540,30,6,3,2,1
2020,229540,40,0,3,1,2
2020,229540,40,3,1,0,1
2020,229540,40,4,2,1,1
2020,229540,42,0,1,1,0
2020,229540,42,4,1,1,0
2020,229540,43,0,2,0,2
2020,229540,43,3,1,0,1
2020,229540,43,4,1,0,1
2020,229780,0,0,127,81,46
2020,229780,10,0,127,81,46
2020,229780,10,1,64,48,16
2020,229780,10,2,29,18,11
2020,229780,10,3,27,9,18
2020,229780,10,4,5,5,0
2020,229780,10,5,2,1,1
2020,229780,40,0,127,81,46
2020,229780,40,1,64,48,16
2020,229780,40,2,29,18,11
2020,229780,40,3,27,9,18
2020,229780,40,4,5,5,0
2020,229780,40,5,2,1,1
2020,229780,42,0,127,81,46
2020,229780,42,1,64,48,16
2020,229780,42,2,29,18,11
2020,229780,42,3,27,9,18
2020,229780,42,4,5,5,0
2020,229780,42,5,2,1,1
2020,229799,0,0,135,52,83
2020,229799,10,0,135,52,83
2020,229799,10,4,133,52,81
2020,229799,10,6,2,0,2
2020,229799,40,0,135,52,83
2020,229799,40,4,133,52,81
2020,229799,40,6,2,0,2
2020,229799,42,0,135,52,83
2020,229799,42,4,133,52,81
2020,229799,42,6,2,0,2
2020,229814,0,0,347,181,166
2020,229814,10,0,347,181,166
2020,229814,10,1,71,48,23
2020,229814,10,2,73,41,32
2020,229814,10,3,106,60,46
2020,229814,10,4,91,29,62
2020,229814,10,5,6,3,3
2020,229814,20,0,136,85,51
2020,229814,20,1,69,47,22
2020,229814,20,2,67,38,29
2020,229814,30,0,87,53,34
2020,229814,30,2,1,1,0
2020,229814,30,3,86,52,34
2020,229814,40,0,124,43,81
2020,229814,40,1,2,1,1
2020,229814,40,2,5,2,3
2020,229814,40,3,20,8,12
2020,229814,40,4,91,29,62
2020,229814,40,5,6,3,3
2020,229814,42,0,99,34,65
2020,229814,42,1,1,0,1
2020,229814,42,2,1,0,1
2020,229814,42,3,7,4,3
2020,229814,42,4,84,27,57
2020,229814,42,5,6,3,3
2020,229814,43,0,25,9,16
2020,229814,43,1,1,1,0
2020,229814,43,2,4,2,2
2020,229814,43,3,13,4,9
2020,229814,43,4,7,2,5
2020,229832,0,0,35,19,16
2020,229832,10,0,35,19,16
2020,229832,10,2,1,0,1
2020,229832,10,3,13,8,5
2020,229832,10,4,21,11,10
2020,229832,40,0,35,19,16
2020,229832,40,2,1,0,1
2020,229832,40,3,13,8,5
2020,229832,40,4,21,11,10
2020,229832,42,0,35,19,16
2020,229832,42,2,1,0,1
2020,229832,42,3,13,8,5
2020,229832,42,4,21,11,10
2020,229841,0,0,185,73,112
2020,229841,10,0,185,73,112
2020,229841,10,6,185,73,112
2020,229841,40,0,185,73,112
2020,229841,40,6,185,73,112
2020,229841,41,0,54,13,41
2020,229841,41,6,54,13,41
2020,229841,42,0,130,59,71
2020,229841,42,6,130,59,71
2020,229841,43,0,1,1,0
2020,229841,43,6,1,1,0
2020,229841,44,0,54,13,41
2020,229841,44,6,54,13,41
2020,229887,0,0,27,16,11
2020,229887,10,0,27,16,11
2020,229887,10,2,6,4,2
2020,229887,10,3,13,9,4
2020,229887,10,4,8,3,5
2020,229887,40,0,27,16,11
2020,229887,40,2,6,4,2
2020,229887,40,3,13,9,4
2020,229887,40,4,8,3,5
2020,229887,42,0,27,16,11
2020,229887,42,2,6,4,2
2020,229887,42,3,13,9,4
2020,229887,42,4,8,3,5
2020,230038,0,0,1264,993,271
2020,230038,10,0,1264,993,271
2020,230038,10,1,420,370,50
2020,230038,10,2,513,404,109
2020,230038,10,3,321,216,105
2020,230038,10,4,10,3,7
2020,230038,20,0,856,711,145
2020,230038,20,1,411,362,49
2020,230038,20,2,441,345,96
2020,230038,20,3,4,4,0
2020,230038,30,0,354,247,107
2020,230038,30,1,5,4,1
2020,230038,30,2,59,49,10
2020,230038,30,3,290,194,96
2020,230038,40,0,54,35,19
2020,230038,40,1,4,4,0
2020,230038,40,2,13,10,3
2020,230038,40,3,27,18,9
2020,230038,40,4,10,3,7
2020,230038,42,0,54,35,19
2020,230038,42,1,4,4,0
2020,230038,42,2,13,10,3
2020,230038,42,3,27,18,9
2020,230038,42,4,10,3,7
2020,230047,0,0,129,102,27
2020,230047,10,0,129,102,27
2020,230047,10,1,30,25,5
2020,230047,10,2,44,37,7
2020,230047,10,3,50,35,15
2020,230047,10,6,5,5,0
2020,230047,40,0,129,102,27
2020,230047,40,1,30,25,5
2020,230047,40,2,44,37,7
2020,230047,40,3,50,35,15
2020,230047,40,6,5,5,0
2020,230047,42,0,129,102,27
2020,230047,42,1,30,25,5
2020,230047,42,2,44,37,7
2020,230047,42,3,50,35,15
2020,230047,42,6,5,5,0
2020,230056,0,0,9,2,7
2020,230056,50,0,9,2,7
2020,230171,0,0,236,127,109
2020,230171,10,0,236,127,109
2020,230171,10,1,38,25,13
2020,230171,10,2,64,34,30
2020,230171,10,3,100,54,46
2020,230171,10,4,26,10,16
2020,230171,10,6,8,4,4
2020,230171,20,0,106,59,47
2020,230171,20,1,38,25,13
2020,230171,20,2,59,30,29
2020,230171,20,3,8,3,5
2020,230171,20,4,1,1,0
2020,230171,30,0,82,48,34
2020,230171,30,2,4,3,1
2020,230171,30,3,78,45,33
2020,230171,40,0,48,20,28
2020,230171,40,2,1,1,0
2020,230171,40,3,14,6,8
2020,230171,40,4,25,9,16
2020,230171,40,6,8,4,4
2020,230171,41,0,34,13,21
2020,230171,41,2,1,1,0
2020,230171,41,3,8,1,7
2020,230171,41,4,17,7,10
2020,230171,41,6,8,4,4
2020,230171,42,0,14,7,7
2020,230171,42,3,6,5,1
2020,230171,42,4,8,2,6
2020,230171,44,0,8,4,4
2020,230171,44,6,8,4,4
2020,230171,45,0,26,9,17
2020,230171,45,2,1,1,0
2020,230171,45,3,8,1,7
2020,230171,45,4,17,7,10
2020,230366,0,0,8,1,7
2020,230366,10,0,8,1,7
2020,230366,10,4,8,1,7
2020,230366,40,0,8,1,7
2020,230366,40,4,8,1,7
2020,230366,41,0,8,1,7
2020,230366,41,4,8,1,7
2020,230366,45,0,8,1,7
2020,230366,45,4,8,1,7
2020,230418,0,0,17,11,6
2020,230418,10,0,17,11,6
2020,230418,10,6,17,11,6
2020,230418,40,0,17,11,6
2020,230418,40,6,17,11,6
2020,230418,41,0,17,11,6
2020,230418,41,6,17,11,6
2020,230418,45,0,17,11,6
2020,230418,45,6,17,11,6
2020,230597,0,0,147,98,49
2020,230597,10,0,147,98,49
2020,230597,10,1,21,16,5
2020,230597,10,2,39,25,14
2020,230597,10,3,44,29,15
2020,230597,10,4,43,28,15
2020,230597,20,0,69,43,26
2020,230597,20,1,21,16,5
2020,230597,20,2,29,16,13
2020,230597,20,3,19,11,8
2020,230597,30,0,61,42,19
2020,230597,30,2,10,9,1
2020,230597,30,3,25,18,7
2020,230597,30,4,26,15,11
2020,230597,40,0,17,13,4
2020,230597,40,4,17,13,4
2020,230597,41,0,17,13,4
2020,230597,41,4,17,13,4
2020,230597,44,0,17,13,4
2020,230597,44,4,17,13,4
2020,230603,0,0,339,219,120
2020,230603,10,0,339,219,120
2020,230603,10,1,58,53,5
2020,230603,10,2,77,48,29
2020,230603,10,3,147,83,64
2020,230603,10,5,47,27,20
2020,230603,10,6,10,8,2
2020,230603,20,0,124,92,32
2020,230603,20,1,58,53,5
2020,230603,20,2,65,38,27
2020,230603,20,3,1,1,0
2020,230603,30,0,112,76,36
2020,230603,30,2,7,7,0
2020,230603,30,3,103,67,36
2020,230603,30,5,2,2,0
2020,230603,40,0,103,51,52
2020,230603,40,2,5,3,2
2020,230603,40,3,43,15,28
2020,230603,40,5,45,25,20
2020,230603,40,6,10,8,2
2020,230603,42,0,103,51,52
2020,230603,42,2,5,3,2
2020,230603,42,3,43,15,28
2020,230603,42,5,45,25,20
2020,230603,42,6,10,8,2
2020,230621,0,0,9,5,4
2020,230621,10,0,9,5,4
2020,230621,10,6,9,5,4
2020,230621,40,0,9,5,4
2020,230621,40,6,9,5,4
2020,230621,41,0,9,5,4
2020,230621,41,6,9,5,4
2020,230621,45,0,9,5,4
2020,230621,45,6,9,5,4
2020,230728,0,0,1049,629,420
2020,230728,10,0,1049,629,420
2020,230728,10,1,266,194,72
2020,230728,10,2,267,177,90
2020,230728,10,3,341,164,177
2020,230728,10,4,38,21,17
2020,230728,10,5,137,73,64
2020,230728,20,0,495,350,145
2020,230728,20,1,257,187,70
2020,230728,20,2,237,162,75
2020,230728,20,4,1,1,0
2020,230728,30,0,242,125,117
2020,230728,30,2,1,0,1
2020,230728,30,3,237,122,115
2020,230728,30,4,4,3,1
2020,230728,40,0,312,154,158
2020,230728,40,1,9,7,2
2020,230728,40,2,29,15,14
2020,230728,40,3,104,42,62
2020,230728,40,4,33,17,16
2020,230728,40,5,137,73,64
2020,230728,42,0,312,154,158
2020,230728,42,1,9,7,2
2020,230728,42,2,29,15,14
2020,230728,42,3,104,42,62
2020,230728,42,4,33,17,16
2020,230728,42,5,137,73,64
2020,230737,0,0,753,493,260
2020,230737,10,0,753,493,260
2020,230737,10,1,123,82,41
2020,230737,10,2,264,183,81
2020,230737,10,3,212,130,82
2020,230737,10,5,154,98,56
2020,230737,20,0,372,251,121
2020,230737,20,1,121,81,40
2020,230737,20,2,251,170,81
2020,230737,30,0,227,144,83
2020,230737,30,1,2,1,1
2020,230737,30,2,13,13,0
2020,230737,30,3,212,130,82
2020,230737,40,0,154,98,56
2020,230737,40,5,154,98,56
2020,230737,41,0,101,67,34
2020,230737,41,5,101,67,34
2020,230737,42,0,53,31,22
2020,230737,42,5,53,31,22
2020,230737,44,0,101,67,34
2020,230737,44,5,101,67,34
2020,230746,0,0,348,191,157
2020,230746,10,0,348,191,157
2020,230746,10,1,56,32,24
2020,230746,10,2,136,77,59
2020,230746,10,3,134,76,58
2020,230746,10,4,17,5,12
2020,230746,10,5,5,1,4
2020,230746,20,0,186,111,75
2020,230746,20,1,56,32,24
2020,230746,20,2,122,73,49
2020,230746,20,3,8,6,2
2020,230746,30,0,140,74,66
2020,230746,30,2,14,4,10
2020,230746,30,3,126,70,56
2020,230746,40,0,22,6,16
2020,230746,40,4,17,5,12
2020,230746,40,5,5,1,4
2020,230746,41,0,16,6,10
2020,230746,41,4,11,5,6
2020,230746,41,5,5,1,4
2020,230746,42,0,3,0,3
2020,230746,42,4,3,0,3
2020,230746,43,0,3,0,3
2020,230746,43,4,3,0,3
2020,230746,45,0,16,6,10
2020,230746,45,4,11,5,6
2020,230746,45,5,5,1,4
2020,230764,0,0,2329,1389,940
2020,230764,10,0,2208,1338,870
2020,230764,10,1,770,544,226
2020,230764,10,2,556,319,237
2020,230764,10,3,567,306,261
2020,230764,10,4,24,10,14
2020,230764,10,5,291,159,132
2020,230764,20,0,1114,757,357
2020,230764,20,1,702,510,192
2020,230764,20,2,411,247,164
2020,230764,20,3,1,0,1
2020,230764,30,0,497,288,209
2020,230764,30,1,24,15,9
2020,230764,30,2,47,23,24
2020,230764,30,3,419,244,175
2020,230764,30,4,7,6,1
2020,230764,40,0,597,293,304
2020,230764,40,1,44,19,25
2020,230764,40,2,98,49,49
2020,230764,40,3,147,62,85
2020,230764,40,4,17,4,13
2020,230764,40,5,291,159,132
2020,230764,42,0,501,245,256
2020,230764,42,1,39,19,20
2020,230764,42,2,92,45,47
2020,230764,42,3,138,58,80
2020,230764,42,4,14,3,11
2020,230764,42,5,218,120,98
2020,230764,43,0,96,48,48
2020,230764,43,1,5,0,5
2020,230764,43,2,6,4,2
2020,230764,43,3,9,4,5
2020,230764,43,4,3,1,2
2020,230764,43,5,73,39,34
2020,230764,50,0,121,51,70
2020,230782,0,0,582,304,278
2020,230782,10,0,582,304,278
2020,230782,10,1,111,78,33
2020,230782,10,2,83,45,38
2020,230782,10,3,244,123,121
2020,230782,10,4,140,55,85
2020,230782,10,5,3,2,1
2020,230782,10,6,1,1,0
2020,230782,20,0,279,167,112
2020,230782,20,1,110,78,32
2020,230782,20,2,82,45,37
2020,230782,20,3,83,42,41
2020,230782,20,4,4,2,2
2020,230782,30,0,160,77,83
2020,230782,30,1,1,0,1
2020,230782,30,2,1,0,1
2020,230782,30,3,149,72,77
2020,230782,30,4,9,5,4
2020,230782,40,0,143,60,83
2020,230782,40,3,12,9,3
2020,230782,40,4,127,48,79
2020,230782,40,5,3,2,1
2020,230782,40,6,1,1,0
2020,230782,42,0,143,60,83
2020,230782,42,3,12,9,3
2020,230782,42,4,127,48,79
2020,230782,42,5,3,2,1
2020,230782,42,6,1,1,0
2020,230807,0,0,133,66,67
2020,230807,10,0,133,66,67
2020,230807,10,1,44,23,21
2020,230807,10,2,46,28,18
2020,230807,10,3,43,15,28
2020,230807,40,0,133,66,67
2020,230807,40,1,44,23,21
2020,230807,40,2,46,28,18
2020,230807,40,3,43,15,28
2020,230807,41,0,126,64,62
2020,230807,41,1,44,23,21
2020,230807,41,2,46,28,18
2020,230807,41,3,36,13,23
2020,230807,42,0,6,1,5
2020,230807,42,3,6,1,5
2020,230807,43,0,1,1,0
2020,230807,43,3,1,1,0
2020,230807,44,0,126,64,62
2020,230807,44,1,44,23,21
2020,230807,44,2,46,28,18
2020,230807,44,3,36,13,23
2020,230816,0,0,61,28,33
2020,230816,10,0,61,28,33
2020,230816,10,6,61,28,33
2020,230816,40,0,61,28,33
2020,230816,40,6,61,28,33
2020,230816,41,0,61,28,33
2020,230816,41,6,61,28,33
2020,230816,44,0,61,28,33
2020,230816,44,6,61,28,33
2020,230834,0,0,79,40,39
2020,230834,10,0,79,40,39
2020,230834,10,1,33,18,15
2020,230834,10,2,28,17,11
2020,230834,10,3,18,5,13
2020,230834,20,0,61,35,26
2020,230834,20,1,33,18,15
2020,230834,20,2,28,17,11
2020,230834,30,0,18,5,13
2020,230834,30,3,18,5,13
2020,230852,0,0,111,67,44
2020,230852,10,0,111,67,44
2020,230852,10,1,27,17,10
2020,230852,10,2,48,24,24
2020,230852,10,3,33,23,10
2020,230852,10,4,3,3,0
2020,230852,40,0,111,67,44
2020,230852,40,1,27,17,10
2020,230852,40,2,48,24,24
2020,230852,40,3,33,23,10
2020,230852,40,4,3,3,0
2020,230852,41,0,108,64,44
2020,230852,41,1,27,17,10
2020,230852,41,2,48,24,24
2020,230852,41,3,33,23,10
2020,230852,42,0,3,3,0
2020,230852,42,4,3,3,0
2020,230852,44,0,108,64,44
2020,230852,44,1,27,17,10
2020,230852,44,2,48,24,24
2020,230852,44,3,33,23,10
2020,230889,0,0,18,8,10
2020,230889,10,0,18,8,10
2020,230889,10,6,18,8,10
2020,230889,40,0,18,8,10
2020,230889,40,6,18,8,10
2020,230889,41,0,18,8,10
2020,230889,41,6,18,8,10
2020,230889,44,0,9,4,5
2020,230889,44,6,9,4,5
2020,230889,45,0,9,4,5
2020,230889,45,6,9,4,5
2020,230913,0,0,67,39,28
2020,230913,10,0,67,39,28
2020,230913,10,1,27,17,10
2020,230913,10,2,22,17,5
2020,230913,10,3,18,5,13
2020,230913,20,0,49,34,15
2020,230913,20,1,27,17,10
2020,230913,20,2,22,17,5
2020,230913,30,0,13,5,8
2020,230913,30,3,13,5,8
2020,230913,40,0,5,0,5
2020,230913,40,3,5,0,5
2020,230913,42,0,5,0,5
2020,230913,42,3,5,0,5
2020,230959,0,0,318,176,142
2020,230959,10,0,318,176,142
2020,230959,10,1,112,72,40
2020,230959,10,2,69,36,33
2020,230959,10,3,92,40,52
2020,230959,10,4,3,1,2
2020,230959,10,5,4,1,3
2020,230959,10,6,38,26,12
2020,230959,20,0,173,103,70
2020,230959,20,1,111,71,40
2020,230959,20,2,62,32,30
2020,230959,30,0,77,35,42
2020,230959,30,3,77,35,42
2020,230959,40,0,68,38,30
2020,230959,40,1,1,1,0
2020,230959,40,2,7,4,3
2020,230959,40,3,15,5,10
2020,230959,40,4,3,1,2
2020,230959,40,5,4,1,3
2020,230959,40,6,38,26,12
2020,230959,41,0,58,33,25
2020,230959,41,1,1,1,0
2020,230959,41,2,7,4,3
2020,230959,41,3,10,2,8
2020,230959,41,4,2,1,1
2020,230959,41,5,4,1,3
2020,230959,41,6,34,24,10
2020,230959,42,0,10,5,5
2020,230959,42,3,5,3,2
2020,230959,42,4,1,0,1
2020,230959,42,6,4,2,2
2020,230959,44,0,58,33,25
2020,230959,44,1,1,1,0
2020,230959,44,2,7,4,3
2020,230959,44,3,10,2,8
2020,230959,44,4,2,1,1
2020,230959,44,5,4,1,3
2020,230959,44,6,34,24,10
2020,230995,0,0,164,95,69
2020,230995,10,0,164,95,69
2020,230995,10,1,38,25,13
2020,230995,10,2,49,33,16
2020,230995,10,3,30,16,14
2020,230995,10,5,38,13,25
2020,230995,10,6,9,8,1
2020,230995,20,0,77,50,27
2020,230995,20,1,34,22,12
2020,230995,20,2,43,28,15
2020,230995,30,0,37,21,16
2020,230995,30,1,2,1,1
2020,230995,30,2,5,4,1
2020,230995,30,3,30,16,14
2020,230995,40,0,50,24,26
2020,230995,40,1,2,2,0
2020,230995,40,2,1,1,0
2020,230995,40,5,38,13,25
2020,230995,40,6,9,8,1
2020,230995,42,0,50,24,26
2020,230995,42,1,2,2,0
2020,230995,42,2,1,1,0
2020,230995,42,5,38,13,25
2020,230995,42,6,9,8,1
2020,231059,0,0,113,61,52
2020,231059,10,0,113,61,52
2020,231059,10,1,45,31,14
2020,231059,10,2,34,19,15
2020,231059,10,3,16,5,11
2020,231059,10,4,18,6,12
2020,231059,20,0,79,50,29
2020,231059,20,1,45,31,14
2020,231059,20,2,34,19,15
2020,231059,30,0,15,5,10
2020,231059,30,3,15,5,10
2020,231059,40,0,19,6,13
2020,231059,40,3,1,0,1
2020,231059,40,4,18,6,12
2020,231059,41,0,1,1,0
2020,231059,41,4,1,1,0
2020,231059,42,0,17,5,12
2020,231059,42,4,17,5,12
2020,231059,43,0,1,0,1
2020,231059,43,3,1,0,1
2020,231059,44,0,1,1,0
2020,231059,44,4,1,1,0
2020,231068,0,0,4,1,3
2020,231068,10,0,4,1,3
2020,231068,10,1,1,0,1
2020,231068,10,2,3,1,2
2020,231068,40,0,4,1,3
2020,231068,40,1,1,0,1
2020,231068,40,2,3,1,2
2020,231068,41,0,4,1,3
2020,231068,41,1,1,0,1
2020,231068,41,2,3,1,2
2020,231068,44,0,4,1,3
2020,231068,44,1,1,0,1
2020,231068,44,2,3,1,2
2020,231095,0,0,21,9,12
2020,231095,10,0,21,9,12
2020,231095,10,4,21,9,12
2020,231095,40,0,21,9,12
2020,231095,40,4,21,9,12
2020,231095,41,0,21,9,12
2020,231095,41,4,21,9,12
2020,231095,45,0,21,9,12
2020,231095,45,4,21,9,12
2020,231147,0,0,52,20,32
2020,231147,10,0,51,19,32
2020,231147,10,1,24,13,11
2020,231147,10,2,5,0,5
2020,231147,10,3,22,6,16
2020,231147,20,0,3,2,1
2020,231147,20,1,3,2,1
2020,231147,40,0,48,17,31
2020,231147,40,1,21,11,10
2020,231147,40,2,5,0,5
2020,231147,40,3,22,6,16
2020,231147,41,0,28,11,17
2020,231147,41,1,18,10,8
2020,231147,41,2,1,0,1
2020,231147,41,3,9,1,8
2020,231147,42,0,20,6,14
2020,231147,42,1,3,1,2
2020,231147,42,2,4,0,4
2020,231147,42,3,13,5,8
2020,231147,44,0,28,11,17
2020,231147,44,1,18,10,8
2020,231147,44,2,1,0,1
2020,231147,44,3,9,1,8
2020,231147,50,0,1,1,0
2020,231165,0,0,76,35,41
2020,231165,10,0,76,35,41
2020,231165,10,1,30,20,10
2020,231165,10,2,14,5,9
2020,231165,10,3,32,10,22
2020,231165,20,0,44,25,19
2020,231165,20,1,30,20,10
2020,231165,20,2,14,5,9
2020,231165,30,0,29,10,19
2020,231165,30,3,29,10,19
2020,231165,40,0,3,0,3
2020,231165,40,3,3,0,3
2020,231165,42,0,3,0,3
2020,231165,42,3,3,0,3
2020,231174,0,0,733,393,340
2020,231174,10,0,733,393,340
2020,231174,10,1,257,172,85
2020,231174,10,2,208,102,106
2020,231174,10,3,107,50,57
2020,231174,10,4,15,1,14
2020,231174,10,5,146,68,78
2020,231174,20,0,442,269,173
2020,231174,20,1,248,171,77
2020,231174,20,2,194,98,96
2020,231174,30,0,82,44,38
2020,231174,30,3,82,44,38
2020,231174,40,0,209,80,129
2020,231174,40,1,9,1,8
2020,231174,40,2,14,4,10
2020,231174,40,3,25,6,19
2020,231174,40,4,15,1,14
2020,231174,40,5,146,68,78
2020,231174,42,0,209,80,129
2020,231174,42,1,9,1,8
2020,231174,42,2,14,4,10
2020,231174,42,3,25,6,19
2020,231174,42,4,15,1,14
2020,231174,42,5,146,68,78
2020,231411,0,0,20,18,2
2020,231411,10,0,20,18,2
2020,231411,10,4,20,18,2
2020,231411,40,0,20,18,2
2020,231411,40,4,20,18,2
2020,231411,41,0,20,18,2
2020,231411,41,4,20,18,2
2020,231411,45,0,20,18,2
2020,231411,45,4,20,18,2
2020,231420,0,0,55,28,27
2020,231420,10,0,55,28,27
2020,231420,10,1,13,9,4
2020,231420,10,2,18,6,12
2020,231420,10,3,21,11,10
2020,231420,10,4,3,2,1
2020,231420,20,0,30,15,15
2020,231420,20,1,11,8,3
2020,231420,20,2,16,5,11
2020,231420,20,3,2,1,1
2020,231420,20,4,1,1,0
2020,231420,30,0,20,11,9
2020,231420,30,1,2,1,1
2020,231420,30,2,1,1,0
2020,231420,30,3,17,9,8
2020,231420,40,0,5,2,3
2020,231420,40,2,1,0,1
2020,231420,40,3,2,1,1
2020,231420,40,4,2,1,1
2020,231420,41,0,5,2,3
2020,231420,41,2,1,0,1
2020,231420,41,3,2,1,1
2020,231420,41,4,2,1,1
2020,231420,44,0,5,2,3
2020,231420,44,2,1,0,1
2020,231420,44,3,2,1,1
2020,231420,44,4,2,1,1
2020,231536,0,0,69,33,36
2020,231536,10,0,69,33,36
2020,231536,10,1,11,3,8
2020,231536,10,2,21,13,8
2020,231536,10,3,19,7,12
2020,231536,10,4,13,6,7
2020,231536,10,5,5,4,1
2020,231536,40,0,69,33,36
2020,231536,40,1,11,3,8
2020,231536,40,2,21,13,8
2020,231536,40,3,19,7,12
2020,231536,40,4,13,6,7
2020,231536,40,5,5,4,1
2020,231536,42,0,69,33,36
2020,231536,42,1,11,3,8
2020,231536,42,2,21,13,8
2020,231536,42,3,19,7,12
2020,231536,42,4,13,6,7
2020,231536,42,5,5,4,1
2020,231554,0,0,46,27,19
2020,231554,10,0,46,27,19
2020,231554,10,1,11,7,4
2020,231554,10,2,9,6,3
2020,231554,10,3,25,14,11
2020,231554,10,4,1,0,1
2020,231554,40,0,46,27,19
2020,231554,40,1,11,7,4
2020,231554,40,2,9,6,3
2020,231554,40,3,25,14,11
2020,231554,40,4,1,0,1
2020,231554,42,0,46,27,19
2020,231554,42,1,11,7,4
2020,231554,42,2,9,6,3
2020,231554,42,3,25,14,11
2020,231554,42,4,1,0,1
2020,231581,0,0,113,57,56
2020,231581,10,0,113,57,56
2020,231581,10,1,15,12,3
2020,231581,10,2,49,24,25
2020,231581,10,3,25,12,13
2020,231581,10,4,24,9,15
2020,231581,20,0,62,35,27
2020,231581,20,1,15,12,3
2020,231581,20,2,45,22,23
2020,231581,20,3,1,0,1
2020,231581,20,4,1,1,0
2020,231581,30,0,27,13,14
2020,231581,30,2,4,2,2
2020,231581,30,3,22,10,12
2020,231581,30,4,1,1,0
2020,231581,40,0,24,9,15
2020,231581,40,3,2,2,0
2020,231581,40,4,22,7,15
2020,231581,42,0,24,9,15
2020,231581,42,3,2,2,0
2020,231581,42,4,22,7,15
2020,231624,0,0,694,400,294
2020,231624,10,0,694,400,294
2020,231624,10,1,265,173,92
2020,231624,10,2,195,112,83
2020,231624,10,3,142,81,61
2020,231624,10,4,19,6,13
2020,231624,10,5,73,28,45
2020,231624,20,0,425,269,156
2020,231624,20,1,253,167,86
2020,231624,20,2,172,102,70
2020,231624,30,0,106,61,45
2020,231624,30,2,4,1,3
2020,231624,30,3,102,60,42
2020,231624,40,0,163,70,93
2020,231624,40,1,12,6,6
2020,231624,40,2,19,9,10
2020,231624,40,3,40,21,19
2020,231624,40,4,19,6,13
2020,231624,40,5,73,28,45
2020,231624,41,0,93,35,58
2020,231624,41,1,8,5,3
2020,231624,41,2,9,3,6
2020,231624,41,3,17,8,9
2020,231624,41,4,2,0,2
2020,231624,41,5,57,19,38
2020,231624,42,0,63,34,29
2020,231624,42,1,4,1,3
2020,231624,42,2,10,6,4
2020,231624,42,3,23,13,10
2020,231624,42,4,10,5,5
2020,231624,42,5,16,9,7
2020,231624,43,0,7,1,6
2020,231624,43,4,7,1,6
2020,231624,44,0,32,14,18
2020,231624,44,1,1,0,1
2020,231624,44,3,12,7,5
2020,231624,44,4,1,0,1
2020,231624,44,5,18,7,11
2020,231624,45,0,61,21,40
2020,231624,45,1,7,5,2
2020,231624,45,2,9,3,6
2020,231624,45,3,5,1,4
2020,231624,45,4,1,0,1
2020,231624,45,5,39,12,27
2020,231651,0,0,133,90,43
2020,231651,10,0,133,90,43
2020,231651,10,1,43,35,8
2020,231651,10,2,44,28,16
2020,231651,10,3,34,22,12
2020,231651,10,4,2,0,2
2020,231651,10,5,10,5,5
2020,231651,20,0,70,51,19
2020,231651,20,1,38,31,7
2020,231651,20,2,32,20,12
2020,231651,30,0,41,29,12
2020,231651,30,1,2,2,0
2020,231651,30,2,9,6,3
2020,231651,30,3,30,21,9
2020,231651,40,0,22,10,12
2020,231651,40,1,3,2,1
2020,231651,40,2,3,2,1
2020,231651,40,3,4,1,3
2020,231651,40,4,2,0,2
2020,231651,40,5,10,5,5
2020,231651,41,0,4,3,1
2020,231651,41,2,2,1,1
2020,231651,41,5,2,2,0
2020,231651,42,0,18,7,11
2020,231651,42,1,3,2,1
2020,231651,42,2,1,1,0
2020,231651,42,3,4,1,3
2020,231651,42,4,2,0,2
2020,231651,42,5,8,3,5
2020,231651,44,0,4,3,1
2020,231651,44,2,2,1,1
2020,231651,44,5,2,2,0
2020,231697,0,0,54,26,28
2020,231697,10,0,54,26,28
2020,231697,10,1,19,9,10
2020,231697,10,2,13,7,6
2020,231697,10,3,13,8,5
2020,231697,10,4,8,2,6
2020,231697,10,5,1,0,1
2020,231697,40,0,54,26,28
2020,231697,40,1,19,9,10
2020,231697,40,2,13,7,6
2020,231697,40,3,13,8,5
2020,231697,40,4,8,2,6
2020,231697,40,5,1,0,1
2020,231697,42,0,54,26,28
2020,231697,42,1,19,9,10
2020,231697,42,2,13,7,6
2020,231697,42,3,13,8,5
2020,231697,42,4,8,2,6
2020,231697,42,5,1,0,1
2020,231712,0,0,287,164,123
2020,231712,10,0,286,163,123
2020,231712,10,1,52,37,15
2020,231712,10,2,93,50,43
2020,231712,10,3,74,46,28
2020,231712,10,4,17,8,9
2020,231712,10,5,50,22,28
2020,231712,20,0,144,86,58
2020,231712,20,1,52,37,15
2020,231712,20,2,92,49,43
2020,231712,30,0,74,46,28
2020,231712,30,2,1,1,0
2020,231712,30,3,73,45,28
2020,231712,40,0,68,31,37
2020,231712,40,3,1,1,0
2020,231712,40,4,17,8,9
2020,231712,40,5,50,22,28
2020,231712,41,0,37,15,22
2020,231712,41,4,8,4,4
2020,231712,41,5,29,11,18
2020,231712,42,0,31,16,15
2020,231712,42,3,1,1,0
2020,231712,42,4,9,4,5
2020,231712,42,5,21,11,10
2020,231712,44,0,37,15,22
2020,231712,44,4,8,4,4
2020,231712,44,5,29,11,18
2020,231712,50,0,1,1,0
2020,231785,0,0,40,11,29
2020,231785,10,0,40,11,29
2020,231785,10,4,40,11,29
2020,231785,40,0,40,11,29
2020,231785,40,4,40,11,29
2020,231785,41,0,40,11,29
2020,231785,41,4,40,11,29
2020,231785,45,0,40,11,29
2020,231785,45,4,40,11,29
2020,231873,0,0,18,6,12
2020,231873,10,0,18,6,12
2020,231873,10,2,7,2,5
2020,231873,10,3,2,1,1
2020,231873,10,4,9,3,6
2020,231873,40,0,18,6,12
2020,231873,40,2,7,2,5
2020,231873,40,3,2,1,1
2020,231873,40,4,9,3,6
2020,231873,42,0,18,6,12
2020,231873,42,2,7,2,5
2020,231873,42,3,2,1,1
2020,231873,42,4,9,3,6
2020,231882,0,0,47,28,19
2020,231882,10,0,47,28,19
2020,231882,10,1,7,6,1
2020,231882,10,2,16,7,9
2020,231882,10,3,11,5,6
2020,231882,10,4,13,10,3
2020,231882,40,0,47,28,19
2020,231882,40,1,7,6,1
2020,231882,40,2,16,7,9
2020,231882,40,3,11,5,6
2020,231882,40,4,13,10,3
2020,231882,42,0,47,28,19
2020,231882,42,1,7,6,1
2020,231882,42,2,16,7,9
2020,231882,42,3,11,5,6
2020,231882,42,4,13,10,3
2020,231970,0,0,216,107,109
2020,231970,10,0,216,107,109
2020,231970,10,1,41,27,14
2020,231970,10,2,62,33,29
2020,231970,10,3,97,45,52
2020,231970,10,4,16,2,14
2020,231970,20,0,10,7,3
2020,231970,20,1,9,6,3
2020,231970,20,2,1,1,0
2020,231970,30,0,57,33,24
2020,231970,30,1,27,18,9
2020,231970,30,2,30,15,15
2020,231970,40,0,149,67,82
2020,231970,40,1,5,3,2
2020,231970,40,2,31,17,14
2020,231970,40,3,97,45,52
2020,231970,40,4,16,2,14
2020,231970,41,0,149,67,82
2020,231970,41,1,5,3,2
2020,231970,41,2,31,17,14
2020,231970,41,3,97,45,52
2020,231970,41,4,16,2,14
2020,231970,44,0,149,67,82
2020,231970,44,1,5,3,2
2020,231970,44,2,31,17,14
2020,231970,44,3,97,45,52
2020,231970,44,4,16,2,14
2020,232016,0,0,3,1,2
2020,232016,50,0,3,1,2
2020,232025,0,0,92,38,54
2020,232025,10,0,92,38,54
2020,232025,10,1,18,11,7
2020,232025,10,2,28,11,17
2020,232025,10,3,41,14,27
2020,232025,10,4,5,2,3
2020,232025,20,0,35,18,17
2020,232025,20,1,17,11,6
2020,232025,20,2,17,6,11
2020,232025,20,3,1,1,0
2020,232025,30,0,22,9,13
2020,232025,30,2,9,4,5
2020,232025,30,3,13,5,8
2020,232025,40,0,35,11,24
2020,232025,40,1,1,0,1
2020,232025,40,2,2,1,1
2020,232025,40,3,27,8,19
2020,232025,40,4,5,2,3
2020,232025,41,0,5,3,2
2020,232025,41,3,4,3,1
2020,232025,41,4,1,0,1
2020,232025,42,0,28,7,21
2020,232025,42,1,1,0,1
2020,232025,42,2,2,1,1
2020,232025,42,3,21,4,17
2020,232025,42,4,4,2,2
2020,232025,43,0,2,1,1
2020,232025,43,3,2,1,1
2020,232025,44,0,5,3,2
2020,232025,44,3,4,3,1
2020,232025,44,4,1,0,1
2020,232043,0,0,89,41,48
2020,232043,10,0,89,41,48
2020,232043,10,1,17,9,8
2020,232043,10,2,23,12,11
2020,232043,10,3,32,14,18
2020,232043,10,4,15,4,11
2020,232043,10,5,2,2,0
2020,232043,20,0,35,19,16
2020,232043,20,1,17,9,8
2020,232043,20,2,18,10,8
2020,232043,30,0,23,12,11
2020,232043,30,2,3,1,2
2020,232043,30,3,20,11,9
2020,232043,40,0,31,10,21
2020,232043,40,2,2,1,1
2020,232043,40,3,12,3,9
2020,232043,40,4,15,4,11
2020,232043,40,5,2,2,0
2020,232043,41,0,7,3,4
2020,232043,41,2,1,1,0
2020,232043,41,3,5,1,4
2020,232043,41,4,1,1,0
2020,232043,42,0,24,7,17
2020,232043,42,2,1,0,1
2020,232043,42,3,7,2,5
2020,232043,42,4,14,3,11
2020,232043,42,5,2,2,0
2020,232043,44,0,7,3,4
2020,232043,44,2,1,1,0
2020,232043,44,3,5,1,4
2020,232043,44,4,1,1,0
2020,232052,0,0,14,7,7
2020,232052,10,0,14,7,7
2020,232052,10,1,1,0,1
2020,232052,10,2,4,2,2
2020,232052,10,3,5,3,2
2020,232052,10,4,3,1,2
2020,232052,10,5,1,1,0
2020,232052,40,0,14,7,7
2020,232052,40,1,1,0,1
2020,232052,40,2,4,2,2
2020,232052,40,3,5,3,2
2020,232052,40,4,3,1,2
2020,232052,40,5,1,1,0
2020,232052,42,0,14,7,7
2020,232052,42,1,1,0,1
2020,232052,42,2,4,2,2
2020,232052,42,3,5,3,2
2020,232052,42,4,3,1,2
2020,232052,42,5,1,1,0
2020,232089,0,0,60,29,31
2020,232089,10,0,60,29,31
2020,232089,10,1,8,2,6
2020,232089,10,2,23,12,11
2020,232089,10,3,25,12,13
2020,232089,10,4,4,3,1
2020,232089,20,0,34,15,19
2020,232089,20,1,8,2,6
2020,232089,20,2,23,12,11
2020,232089,20,3,3,1,2
2020,232089,30,0,12,7,5
2020,232089,30,3,12,7,5
2020,232089,40,0,14,7,7
2020,232089,40,3,10,4,6
2020,232089,40,4,4,3,1
2020,232089,42,0,14,7,7
2020,232089,42,3,10,4,6
2020,232089,42,4,4,3,1
2020,232186,0,0,1399,766,633
2020,232186,10,0,1399,766,633
2020,232186,10,1,376,257,119
2020,232186,10,2,496,259,237
2020,232186,10,3,438,214,224
2020,232186,10,4,89,36,53
2020,232186,20,0,686,434,252
2020,232186,20,1,337,239,98
2020,232186,20,2,348,195,153
2020,232186,20,3,1,0,1
2020,232186,30,0,228,127,101
2020,232186,30,1,1,1,0
2020,232186,30,2,14,8,6
2020,232186,30,3,213,118,95
2020,232186,40,0,485,205,280
2020,232186,40,1,38,17,21
2020,232186,40,2,134,56,78
2020,232186,40,3,224,96,128
2020,232186,40,4,89,36,53
2020,232186,41,0,296,129,167
2020,232186,41,1,37,17,20
2020,232186,41,2,120,50,70
2020,232186,41,3,97,45,52
2020,232186,41,4,42,17,25
2020,232186,42,0,189,76,113
2020,232186,42,1,1,0,1
2020,232186,42,2,14,6,8
2020,232186,42,3,127,51,76
2020,232186,42,4,47,19,28
2020,232186,44,0,296,129,167
2020,232186,44,1,37,17,20
2020,232186,44,2,120,50,70
2020,232186,44,3,97,45,52
2020,232186,44,4,42,17,25
2020,232195,0,0,96,27,69
2020,232195,10,0,96,27,69
2020,232195,10,1,12,2,10
2020,232195,10,2,21,2,19
2020,232195,10,3,36,18,18
2020,232195,10,4,25,5,20
2020,232195,10,5,2,0,2
2020,232195,40,0,96,27,69
2020,232195,40,1,12,2,10
2020,232195,40,2,21,2,19
2020,232195,40,3,36,18,18
2020,232195,40,4,25,5,20
2020,232195,40,5,2,0,2
2020,232195,42,0,96,27,69
2020,232195,42,1,12,2,10
2020,232195,42,2,21,2,19
2020,232195,42,3,36,18,18
2020,232195,42,4,25,5,20
2020,232195,42,5,2,0,2
2020,232256,0,0,101,66,35
2020,232256,10,0,101,66,35
2020,232256,10,1,32,24,8
2020,232256,10,2,28,17,11
2020,232256,10,3,22,14,8
2020,232256,10,5,19,11,8
2020,232256,20,0,60,41,19
2020,232256,20,1,32,24,8
2020,232256,20,2,28,17,11
2020,232256,30,0,22,14,8
2020,232256,30,3,22,14,8
2020,232256,40,0,19,11,8
2020,232256,40,5,19,11,8
2020,232256,42,0,19,11,8
2020,232256,42,5,19,11,8
2020,232265,0,0,214,113,101
2020,232265,10,0,194,106,88
2020,232265,10,1,33,26,7
2020,232265,10,2,46,28,18
2020,232265,10,3,96,47,49
2020,232265,10,4,9,3,6
2020,232265,10,5,1,1,0
2020,232265,10,6,9,1,8
2020,232265,20,0,53,38,15
2020,232265,20,1,29,22,7
2020,232265,20,2,21,13,8
2020,232265,20,3,3,3,0
2020,232265,30,0,18,12,6
2020,232265,30,1,1,1,0
2020,232265,30,2,7,5,2
2020,232265,30,3,10,6,4
2020,232265,40,0,123,56,67
2020,232265,40,1,3,3,0
2020,232265,40,2,18,10,8
2020,232265,40,3,83,38,45
2020,232265,40,4,9,3,6
2020,232265,40,5,1,1,0
2020,232265,40,6,9,1,8
2020,232265,41,0,1,1,0
2020,232265,41,1,1,1,0
2020,232265,42,0,122,55,67
2020,232265,42,1,2,2,0
2020,232265,42,2,18,10,8
2020,232265,42,3,83,38,45
2020,232265,42,4,9,3,6
2020,232265,42,5,1,1,0
2020,232265,42,6,9,1,8
2020,232265,44,0,1,1,0
2020,232265,44,1,1,1,0
2020,232265,50,0,20,7,13
2020,232308,0,0,81,34,47
2020,232308,10,0,81,34,47
2020,232308,10,1,21,7,14
2020,232308,10,2,24,13,11
2020,232308,10,3,32,13,19
2020,232308,10,4,2,1,1
2020,232308,10,5,2,0,2
2020,232308,20,0,39,17,22
2020,232308,20,1,19,7,12
2020,232308,20,2,20,10,10
2020,232308,30,0,15,5,10
2020,232308,30,2,2,1,1
2020,232308,30,3,13,4,9
2020,232308,40,0,27,12,15
2020,232308,40,1,2,0,2
2020,232308,40,2,2,2,0
2020,232308,40,3,19,9,10
2020,232308,40,4,2,1,1
2020,232308,40,5,2,0,2
2020,232308,41,0,19,8,11
2020,232308,41,1,2,0,2
2020,232308,41,2,1,1,0
2020,232308,41,3,14,6,8
2020,232308,41,4,1,1,0
2020,232308,41,5,1,0,1
2020,232308,42,0,8,4,4
2020,232308,42,2,1,1,0
2020,232308,42,3,5,3,2
2020,232308,42,4,1,0,1
2020,232308,42,5,1,0,1
2020,232308,44,0,19,8,11
2020,232308,44,1,2,0,2
2020,232308,44,2,1,1,0
2020,232308,44,3,14,6,8
2020,232308,44,4,1,1,0
2020,232308,44,5,1,0,1
2020,232414,0,0,107,45,62
2020,232414,10,0,107,45,62
2020,232414,10,1,29,14,15
2020,232414,10,2,36,15,21
2020,232414,10,3,27,8,19
2020,232414,10,4,15,8,7
2020,232414,40,0,107,45,62
2020,232414,40,1,29,14,15
2020,232414,40,2,36,15,21
2020,232414,40,3,27,8,19
2020,232414,40,4,15,8,7
2020,232414,42,0,107,45,62
2020,232414,42,1,29,14,15
2020,232414,42,2,36,15,21
2020,232414,42,3,27,8,19
2020,232414,42,4,15,8,7
2020,232423,0,0,1060,524,536
2020,232423,10,0,1060,524,536
2020,232423,10,1,374,218,156
2020,232423,10,2,292,148,144
2020,232423,10,3,240,97,143
2020,232423,10,4,154,61,93
2020,232423,20,0,638,348,290
2020,232423,20,1,373,217,156
2020,232423,20,2,265,131,134
2020,232423,30,0,181,82,99
2020,232423,30,2,8,6,2
2020,232423,30,3,171,74,97
2020,232423,30,4,2,2,0
2020,232423,40,0,241,94,147
2020,232423,40,1,1,1,0
2020,232423,40,2,19,11,8
2020,232423,40,3,69,23,46
2020,232423,40,4,152,59,93
2020,232423,42,0,241,94,147
2020,232423,42,1,1,1,0
2020,232423,42,2,19,11,8
2020,232423,42,3,69,23,46
2020,232423,42,4,152,59,93
2020,232450,0,0,118,45,73
2020,232450,10,0,118,45,73
2020,232450,10,1,29,10,19
2020,232450,10,2,27,8,19
2020,232450,10,3,24,6,18
2020,232450,10,4,37,20,17
2020,232450,10,5,1,1,0
2020,232450,40,0,118,45,73
2020,232450,40,1,29,10,19
2020,232450,40,2,27,8,19
2020,232450,40,3,24,6,18
2020,232450,40,4,37,20,17
2020,232450,40,5,1,1,0
2020,232450,42,0,118,45,73
2020,232450,42,1,29,10,19
2020,232450,42,2,27,8,19
2020,232450,42,3,24,6,18
2020,232450,42,4,37,20,17
2020,232450,42,5,1,1,0
2020,232557,0,0,1051,616,435
2020,232557,10,0,1051,616,435
2020,232557,10,1,189,150,39
2020,232557,10,2,201,126,75
2020,232557,10,3,633,329,304
2020,232557,10,4,28,11,17
2020,232557,20,0,11,9,2
2020,232557,20,1,11,9,2
2020,232557,30,0,4,2,2
2020,232557,30,1,3,1,2
2020,232557,30,2,1,1,0
2020,232557,40,0,1036,605,431
2020,232557,40,1,175,140,35
2020,232557,40,2,200,125,75
2020,232557,40,3,633,329,304
2020,232557,40,4,28,11,17
2020,232557,42,0,1036,605,431
2020,232557,42,1,175,140,35
2020,232557,42,2,200,125,75
2020,232557,42,3,633,329,304
2020,232557,42,4,28,11,17
2020,232566,0,0,264,124,140
2020,232566,10,0,257,124,133
2020,232566,10,1,54,31,23
2020,232566,10,2,83,42,41
2020,232566,10,3,83,34,49
2020,232566,10,4,4,2,2
2020,232566,10,5,33,15,18
2020,232566,20,0,133,71,62
2020,232566,20,1,53,31,22
2020,232566,20,2,80,40,40
2020,232566,30,0,89,37,52
2020,232566,30,1,1,0,1
2020,232566,30,2,3,2,1
2020,232566,30,3,83,34,49
2020,232566,30,4,2,1,1
2020,232566,40,0,35,16,19
2020,232566,40,4,2,1,1
2020,232566,40,5,33,15,18
2020,232566,41,0,6,1,5
2020,232566,41,5,6,1,5
2020,232566,42,0,29,15,14
2020,232566,42,4,2,1,1
2020,232566,42,5,27,14,13
2020,232566,44,0,6,1,5
2020,232566,44,5,6,1,5
2020,232566,50,0,7,0,7
2020,232575,0,0,65,21,44
2020,232575,10,0,65,21,44
2020,232575,10,1,18,7,11
2020,232575,10,2,20,7,13
2020,232575,10,3,17,3,14
2020,232575,10,4,10,4,6
2020,232575,40,0,65,21,44
2020,232575,40,1,18,7,11
2020,232575,40,2,20,7,13
2020,232575,40,3,17,3,14
2020,232575,40,4,10,4,6
2020,232575,42,0,65,21,44
2020,232575,42,1,18,7,11
2020,232575,42,2,20,7,13
2020,232575,42,3,17,3,14
2020,232575,42,4,10,4,6
2020,232609,0,0,184,87,97
2020,232609,10,0,184,87,97
2020,232609,10,1,48,28,20
2020,232609,10,2,61,30,31
2020,232609,10,3,67,24,43
2020,232609,10,4,8,5,3
2020,232609,20,0,91,48,43
2020,232609,20,1,46,26,20
2020,232609,20,2,44,21,23
2020,232609,20,3,1,1,0
2020,232609,30,0,38,16,22
2020,232609,30,2,5,3,2
2020,232609,30,3,33,13,20
2020,232609,40,0,55,23,32
2020,232609,40,1,2,2,0
2020,232609,40,2,12,6,6
2020,232609,40,3,33,10,23
2020,232609,40,4,8,5,3
2020,232609,42,0,55,23,32
2020,232609,42,1,2,2,0
2020,232609,42,2,12,6,6
2020,232609,42,3,33,10,23
2020,232609,42,4,8,5,3
2020,232618,0,0,27,0,27
2020,232618,10,0,27,0,27
2020,232618,10,6,27,0,27
2020,232618,40,0,27,0,27
2020,232618,40,6,27,0,27
2020,232618,42,0,7,0,7
2020,232618,42,6,7,0,7
2020,232618,43,0,20,0,20
2020,232618,43,6,20,0,20
2020,232672,0,0,92,27,65
2020,232672,10,0,92,27,65
2020,232672,10,1,15,4,11
2020,232672,10,2,30,8,22
2020,232672,10,3,43,15,28
2020,232672,10,4,4,0,4
2020,232672,20,0,35,11,24
2020,232672,20,1,14,4,10
2020,232672,20,2,20,6,14
2020,232672,20,3,1,1,0
2020,232672,30,0,3,0,3
2020,232672,30,3,3,0,3
2020,232672,40,0,54,16,38
2020,232672,40,1,1,0,1
2020,232672,40,2,10,2,8
2020,232672,40,3,39,14,25
2020,232672,40,4,4,0,4
2020,232672,41,0,54,16,38
2020,232672,41,1,1,0,1
2020,232672,41,2,10,2,8
2020,232672,41,3,39,14,25
2020,232672,41,4,4,0,4
2020,232672,44,0,54,16,38
2020,232672,44,1,1,0,1
2020,232672,44,2,10,2,8
2020,232672,44,3,39,14,25
2020,232672,44,4,4,0,4
2020,232681,0,0,249,122,127
2020,232681,10,0,249,122,127
2020,232681,10,1,85,41,44
2020,232681,10,2,79,44,35
2020,232681,10,3,53,18,35
2020,232681,10,4,5,3,2
2020,232681,10,5,27,16,11
2020,232681,20,0,162,83,79
2020,232681,20,1,85,41,44
2020,232681,20,2,72,40,32
2020,232681,20,3,5,2,3
2020,232681,30,0,46,15,31
2020,232681,30,2,7,4,3
2020,232681,30,3,39,11,28
2020,232681,40,0,41,24,17
2020,232681,40,3,9,5,4
2020,232681,40,4,5,3,2
2020,232681,40,5,27,16,11
2020,232681,43,0,41,24,17
2020,232681,43,3,9,5,4
2020,232681,43,4,5,3,2
2020,232681,43,5,27,16,11
2020,232706,0,0,144,41,103
2020,232706,10,0,144,41,103
2020,232706,10,1,39,8,31
2020,232706,10,2,42,20,22
2020,232706,10,3,43,7,36
2020,232706,10,4,19,6,13
2020,232706,10,6,1,0,1
2020,232706,20,0,74,25,49
2020,232706,20,1,39,8,31
2020,232706,20,2,35,17,18
2020,232706,30,0,48,9,39
2020,232706,30,2,6,2,4
2020,232706,30,3,42,7,35
2020,232706,40,0,22,7,15
2020,232706,40,2,1,1,0
2020,232706,40,3,1,0,1
2020,232706,40,4,19,6,13
2020,232706,40,6,1,0,1
2020,232706,42,0,22,7,15
2020,232706,42,2,1,1,0
2020,232706,42,3,1,0,1
2020,232706,42,4,19,6,13
2020,232706,42,6,1,0,1
2020,232788,0,0,46,24,22
2020,232788,10,0,46,24,22
2020,232788,10,1,8,4,4
2020,232788,10,2,11,4,7
2020,232788,10,3,15,8,7
2020,232788,10,4,12,8,4
2020,232788,40,0,46,24,22
2020,232788,40,1,8,4,4
2020,232788,40,2,11,4,7
2020,232788,40,3,15,8,7
2020,232788,40,4,12,8,4
2020,232788,42,0,46,24,22
2020,232788,42,1,8,4,4
2020,232788,42,2,11,4,7
2020,232788,42,3,15,8,7
2020,232788,42,4,12,8,4
2020,232797,0,0,12,0,12
2020,232797,50,0,12,0,12
2020,232867,0,0,48,26,22
2020,232867,10,0,48,26,22
2020,232867,10,1,18,8,10
2020,232867,10,2,10,7,3
2020,232867,10,3,12,8,4
2020,232867,10,4,8,3,5
2020,232867,40,0,48,26,22
2020,232867,40,1,18,8,10
2020,232867,40,2,10,7,3
2020,232867,40,3,12,8,4
2020,232867,40,4,8,3,5
2020,232867,42,0,48,26,22
2020,232867,42,1,18,8,10
2020,232867,42,2,10,7,3
2020,232867,42,3,12,8,4
2020,232867,42,4,8,3,5
2020,232885,0,0,34,3,31
2020,232885,10,0,33,2,31
2020,232885,10,1,3,0,3
2020,232885,10,2,9,0,9
2020,232885,10,3,16,2,14
2020,232885,10,4,4,0,4
2020,232885,10,5,1,0,1
2020,232885,40,0,33,2,31
2020,232885,40,1,3,0,3
2020,232885,40,2,9,0,9
2020,232885,40,3,16,2,14
2020,232885,40,4,4,0,4
2020,232885,40,5,1,0,1
2020,232885,42,0,33,2,31
2020,232885,42,1,3,0,3
2020,232885,42,2,9,0,9
2020,232885,42,3,16,2,14
2020,232885,42,4,4,0,4
2020,232885,42,5,1,0,1
2020,232885,50,0,1,1,0
2020,232937,0,0,242,127,115
2020,232937,10,0,242,127,115
2020,232937,10,1,78,49,29
2020,232937,10,2,59,27,32
2020,232937,10,3,82,40,42
2020,232937,10,4,23,11,12
2020,232937,20,0,100,62,38
2020,232937,20,1,54,39,15
2020,232937,20,2,17,9,8
2020,232937,20,3,29,14,15
2020,232937,30,0,58,27,31
2020,232937,30,1,15,5,10
2020,232937,30,2,14,5,9
2020,232937,30,3,27,16,11
2020,232937,30,4,2,1,1
2020,232937,40,0,84,38,46
2020,232937,40,1,9,5,4
2020,232937,40,2,28,13,15
2020,232937,40,3,26,10,16
2020,232937,40,4,21,10,11
2020,232937,42,0,19,12,7
2020,232937,42,1,2,0,2
2020,232937,42,2,7,6,1
2020,232937,42,3,4,1,3
2020,232937,42,4,6,5,1
2020,232937,43,0,65,26,39
2020,232937,43,1,7,5,2
2020,232937,43,2,21,7,14
2020,232937,43,3,22,9,13
2020,232937,43,4,15,5,10
2020,232946,0,0,615,259,356
2020,232946,10,0,615,259,356
2020,232946,10,1,188,89,99
2020,232946,10,2,190,84,106
2020,232946,10,3,133,45,88
2020,232946,10,4,94,37,57
2020,232946,10,5,10,4,6
2020,232946,40,0,615,259,356
2020,232946,40,1,188,89,99
2020,232946,40,2,190,84,106
2020,232946,40,3,133,45,88
2020,232946,40,4,94,37,57
2020,232946,40,5,10,4,6
2020,232946,42,0,615,259,356
2020,232946,42,1,188,89,99
2020,232946,42,2,190,84,106
2020,232946,42,3,133,45,88
2020,232946,42,4,94,37,57
2020,232946,42,5,10,4,6
2020,232982,0,0,844,456,388
2020,232982,10,0,844,456,388
2020,232982,10,1,207,155,52
2020,232982,10,2,221,130,91
2020,232982,10,3,194,93,101
2020,232982,10,4,6,1,5
2020,232982,10,5,214,76,138
2020,232982,10,6,2,1,1
2020,232982,20,0,412,276,136
2020,232982,20,1,204,154,50
2020,232982,20,2,208,122,86
2020,232982,30,0,174,90,84
2020,232982,30,1,1,1,0
2020,232982,30,2,9,6,3
2020,232982,30,3,164,83,81
2020,232982,40,0,258,90,168
2020,232982,40,1,2,0,2
2020,232982,40,2,4,2,2
2020,232982,40,3,30,10,20
2020,232982,40,4,6,1,5
2020,232982,40,5,214,76,138
2020,232982,40,6,2,1,1
2020,232982,42,0,258,90,168
2020,232982,42,1,2,0,2
2020,232982,42,2,4,2,2
2020,232982,42,3,30,10,20
2020,232982,42,4,6,1,5
2020,232982,42,5,214,76,138
2020,232982,42,6,2,1,1
2020,233019,0,0,44,22,22
2020,233019,10,0,44,22,22
2020,233019,10,1,5,3,2
2020,233019,10,2,17,6,11
2020,233019,10,3,9,4,5
2020,233019,10,4,13,9,4
2020,233019,40,0,44,22,22
2020,233019,40,1,5,3,2
2020,233019,40,2,17,6,11
2020,233019,40,3,9,4,5
2020,233019,40,4,13,9,4
2020,233019,41,0,30,14,16
2020,233019,41,1,4,3,1
2020,233019,41,2,16,6,10
2020,233019,41,3,6,2,4
2020,233019,41,4,4,3,1
2020,233019,42,0,14,8,6
2020,233019,42,1,1,0,1
2020,233019,42,2,1,0,1
2020,233019,42,3,3,2,1
2020,233019,42,4,9,6,3
2020,233019,44,0,30,14,16
2020,233019,44,1,4,3,1
2020,233019,44,2,16,6,10
2020,233019,44,3,6,2,4
2020,233019,44,4,4,3,1
2020,233037,0,0,20,7,13
2020,233037,10,0,20,7,13
2020,233037,10,1,1,1,0
2020,233037,10,2,10,4,6
2020,233037,10,3,6,1,5
2020,233037,10,4,3,1,2
2020,233037,40,0,20,7,13
2020,233037,40,1,1,1,0
2020,233037,40,2,10,4,6
2020,233037,40,3,6,1,5
2020,233037,40,4,3,1,2
2020,233037,42,0,20,7,13
2020,233037,42,1,1,1,0
2020,233037,42,2,10,4,6
2020,233037,42,3,6,1,5
2020,233037,42,4,3,1,2
2020,233082,0,0,9,0,9
2020,233082,10,0,9,0,9
2020,233082,10,2,3,0,3
2020,233082,10,4,6,0,6
2020,233082,40,0,9,0,9
2020,233082,40,2,3,0,3
2020,233082,40,4,6,0,6
2020,233082,41,0,9,0,9
2020,233082,41,2,3,0,3
2020,233082,41,4,6,0,6
2020,233082,45,0,9,0,9
2020,233082,45,2,3,0,3
2020,233082,45,4,6,0,6
2020,233116,0,0,75,33,42
2020,233116,10,0,75,33,42
2020,233116,10,1,21,8,13
2020,233116,10,2,33,16,17
2020,233116,10,3,11,4,7
2020,233116,10,4,10,5,5
2020,233116,40,0,75,33,42
2020,233116,40,1,21,8,13
2020,233116,40,2,33,16,17
2020,233116,40,3,11,4,7
2020,233116,40,4,10,5,5
2020,233116,42,0,75,33,42
2020,233116,42,1,21,8,13
2020,233116,42,2,33,16,17
2020,233116,42,3,11,4,7
2020,233116,42,4,10,5,5
2020,233277,0,0,507,222,285
2020,233277,10,0,507,222,285
2020,233277,10,1,160,88,72
2020,233277,10,2,121,57,64
2020,233277,10,3,145,53,92
2020,233277,10,4,81,24,57
2020,233277,20,0,259,133,126
2020,233277,20,1,154,86,68
2020,233277,20,2,102,44,58
2020,233277,20,3,3,3,0
2020,233277,30,0,108,46,62
2020,233277,30,1,3,1,2
2020,233277,30,2,11,7,4
2020,233277,30,3,90,38,52
2020,233277,30,4,4,0,4
2020,233277,40,0,140,43,97
2020,233277,40,1,3,1,2
2020,233277,40,2,8,6,2
2020,233277,40,3,52,12,40
2020,233277,40,4,77,24,53
2020,233277,42,0,140,43,97
2020,233277,42,1,3,1,2
2020,233277,42,2,8,6,2
2020,233277,42,3,52,12,40
2020,233277,42,4,77,24,53
2020,233295,0,0,116,52,64
2020,233295,10,0,116,52,64
2020,233295,10,1,49,27,22
2020,233295,10,2,28,14,14
2020,233295,10,3,21,8,13
2020,233295,10,4,18,3,15
2020,233295,20,0,74,41,33
2020,233295,20,1,48,27,21
2020,233295,20,2,26,14,12
2020,233295,30,0,24,8,16
2020,233295,30,1,1,0,1
2020,233295,30,2,2,0,2
2020,233295,30,3,21,8,13
2020,233295,40,0,18,3,15
2020,233295,40,4,18,3,15
2020,233295,42,0,18,3,15
2020,233295,42,4,18,3,15
2020,233301,0,0,67,24,43
2020,233301,10,0,66,24,42
2020,233301,10,1,29,12,17
2020,233301,10,2,18,6,12
2020,233301,10,3,16,6,10
2020,233301,10,4,3,0,3
2020,233301,20,0,46,18,28
2020,233301,20,1,29,12,17
2020,233301,20,2,17,6,11
2020,233301,30,0,15,6,9
2020,233301,30,3,15,6,9
2020,233301,40,0,5,0,5
2020,233301,40,2,1,0,1
2020,233301,40,3,1,0,1
2020,233301,40,4,3,0,3
2020,233301,41,0,5,0,5
2020,233301,41,2,1,0,1
2020,233301,41,3,1,0,1
2020,233301,41,4,3,0,3
2020,233301,44,0,5,0,5
2020,233301,44,2,1,0,1
2020,233301,44,3,1,0,1
2020,233301,44,4,3,0,3
2020,233301,50,0,1,0,1
2020,233310,0,0,30,9,21
2020,233310,10,0,30,9,21
2020,233310,10,1,6,4,2
2020,233310,10,2,8,1,7
2020,233310,10,3,10,3,7
2020,233310,10,4,6,1,5
2020,233310,40,0,30,9,21
2020,233310,40,1,6,4,2
2020,233310,40,2,8,1,7
2020,233310,40,3,10,3,7
2020,233310,40,4,6,1,5
2020,233310,42,0,30,9,21
2020,233310,42,1,6,4,2
2020,233310,42,2,8,1,7
2020,233310,42,3,10,3,7
2020,233310,42,4,6,1,5
2020,233329,0,0,7,2,5
2020,233329,10,0,7,2,5
2020,233329,10,4,7,2,5
2020,233329,40,0,7,2,5
2020,233329,40,4,7,2,5
2020,233329,41,0,7,2,5
2020,233329,41,4,7,2,5
2020,233329,45,0,7,2,5
2020,233329,45,4,7,2,5
2020,233338,0,0,35,15,20
2020,233338,10,0,35,15,20
2020,233338,10,1,10,4,6
2020,233338,10,2,6,3,3
2020,233338,10,3,14,6,8
2020,233338,10,4,5,2,3
2020,233338,20,0,13,4,9
2020,233338,20,1,9,3,6
2020,233338,20,2,4,1,3
2020,233338,40,0,22,11,11
2020,233338,40,1,1,1,0
2020,233338,40,2,2,2,0
2020,233338,40,3,14,6,8
2020,233338,40,4,5,2,3
2020,233338,42,0,22,11,11
2020,233338,42,1,1,1,0
2020,233338,42,2,2,2,0
2020,233338,42,3,14,6,8
2020,233338,42,4,5,2,3
2020,233356,0,0,31,2,29
2020,233356,10,0,31,2,29
2020,233356,10,1,1,0,1
2020,233356,10,2,4,1,3
2020,233356,10,3,16,0,16
2020,233356,10,4,10,1,9
2020,233356,40,0,31,2,29
2020,233356,40,1,1,0,1
2020,233356,40,2,4,1,3
2020,233356,40,3,16,0,16
2020,233356,40,4,10,1,9
2020,233356,41,0,2,0,2
2020,233356,41,3,1,0,1
2020,233356,41,4,1,0,1
2020,233356,43,0,29,2,27
2020,233356,43,1,1,0,1
2020,233356,43,2,4,1,3
2020,233356,43,3,15,0,15
2020,233356,43,4,9,1,8
2020,233356,45,0,2,0,2
2020,233356,45,3,1,0,1
2020,233356,45,4,1,0,1
2020,233374,0,0,427,227,200
2020,233374,10,0,427,227,200
2020,233374,10,1,126,77,49
2020,233374,10,2,134,70,64
2020,233374,10,3,75,35,40
2020,233374,10,4,1,0,1
2020,233374,10,5,1,1,0
2020,233374,10,6,90,44,46
2020,233374,20,0,240,138,102
2020,233374,20,1,114,73,41
2020,233374,20,2,125,65,60
2020,233374,20,3,1,0,1
2020,233374,30,0,72,36,36
2020,233374,30,2,3,2,1
2020,233374,30,3,66,32,34
2020,233374,30,6,3,2,1
2020,233374,40,0,115,53,62
2020,233374,40,1,12,4,8
2020,233374,40,2,6,3,3
2020,233374,40,3,8,3,5
2020,233374,40,4,1,0,1
2020,233374,40,5,1,1,0
2020,233374,40,6,87,42,45
2020,233374,41,0,47,17,30
2020,233374,41,1,11,3,8
2020,233374,41,2,1,0,1
2020,233374,41,3,4,1,3
2020,233374,41,6,31,13,18
2020,233374,42,0,43,22,21
2020,233374,42,1,1,1,0
2020,233374,42,2,4,2,2
2020,233374,42,3,2,2,0
2020,233374,42,4,1,0,1
2020,233374,42,5,1,1,0
2020,233374,42,6,34,16,18
2020,233374,43,0,25,14,11
2020,233374,43,2,1,1,0
2020,233374,43,3,2,0,2
2020,233374,43,6,22,13,9
2020,233374,45,0,47,17,30
2020,233374,45,1,11,3,8
2020,233374,45,2,1,0,1
2020,233374,45,3,4,1,3
2020,233374,45,6,31,13,18
2020,233408,0,0,31,0,31
2020,233408,10,0,31,0,31
2020,233408,10,4,31,0,31
2020,233408,40,0,31,0,31
2020,233408,40,4,31,0,31
2020,233408,41,0,31,0,31
2020,233408,41,4,31,0,31
2020,233408,45,0,31,0,31
2020,233408,45,4,31,0,31
2020,233426,0,0,164,76,88
2020,233426,10,0,164,76,88
2020,233426,10,1,51,29,22
2020,233426,10,2,52,26,26
2020,233426,10,3,29,11,18
2020,233426,10,6,32,10,22
2020,233426,20,0,101,54,47
2020,233426,20,1,51,29,22
2020,233426,20,2,50,25,25
2020,233426,30,0,31,12,19
2020,233426,30,2,2,1,1
2020,233426,30,3,29,11,18
2020,233426,40,0,32,10,22
2020,233426,40,6,32,10,22
2020,233426,42,0,32,10,22
2020,233426,42,6,32,10,22
2020,233541,0,0,252,109,143
2020,233541,10,0,252,109,143
2020,233541,10,1,49,25,24
2020,233541,10,2,96,43,53
2020,233541,10,3,85,32,53
2020,233541,10,4,3,2,1
2020,233541,10,5,16,4,12
2020,233541,10,6,3,3,0
2020,233541,40,0,252,109,143
2020,233541,40,1,49,25,24
2020,233541,40,2,96,43,53
2020,233541,40,3,85,32,53
2020,233541,40,4,3,2,1
2020,233541,40,5,16,4,12
2020,233541,40,6,3,3,0
2020,233541,42,0,252,109,143
2020,233541,42,1,49,25,24
2020,233541,42,2,96,43,53
2020,233541,42,3,85,32,53
2020,233541,42,4,3,2,1
2020,233541,42,5,16,4,12
2020,233541,42,6,3,3,0
2020,233602,0,0,5,5,0
2020,233602,10,0,5,5,0
2020,233602,10,1,5,5,0
2020,233602,40,0,5,5,0
2020,233602,40,1,5,5,0
2020,233602,42,0,5,5,0
2020,233602,42,1,5,5,0
2020,233611,0,0,65,43,22
2020,233611,10,0,65,43,22
2020,233611,10,1,15,10,5
2020,233611,10,2,10,9,1
2020,233611,10,3,18,12,6
2020,233611,10,4,22,12,10
2020,233611,40,0,65,43,22
2020,233611,40,1,15,10,5
2020,233611,40,2,10,9,1
2020,233611,40,3,18,12,6
2020,233611,40,4,22,12,10
2020,233611,41,0,20,15,5
2020,233611,41,1,13,8,5
2020,233611,41,2,6,6,0
2020,233611,41,3,1,1,0
2020,233611,42,0,32,23,9
2020,233611,42,1,2,2,0
2020,233611,42,2,4,3,1
2020,233611,42,3,17,11,6
2020,233611,42,4,9,7,2
2020,233611,43,0,13,5,8
2020,233611,43,4,13,5,8
2020,233611,44,0,20,15,5
2020,233611,44,1,13,8,5
2020,233611,44,2,6,6,0
2020,233611,44,3,1,1,0
2020,233639,0,0,48,21,27
2020,233639,10,0,48,21,27
2020,233639,10,1,11,2,9
2020,233639,10,2,14,6,8
2020,233639,10,3,15,8,7
2020,233639,10,4,5,4,1
2020,233639,10,5,3,1,2
2020,233639,40,0,48,21,27
2020,233639,40,1,11,2,9
2020,233639,40,2,14,6,8
2020,233639,40,3,15,8,7
2020,233639,40,4,5,4,1
2020,233639,40,5,3,1,2
2020,233639,42,0,48,21,27
2020,233639,42,1,11,2,9
2020,233639,42,2,14,6,8
2020,233639,42,3,15,8,7
2020,233639,42,4,5,4,1
2020,233639,42,5,3,1,2
2020,233648,0,0,46,18,28
2020,233648,10,0,46,18,28
2020,233648,10,1,3,1,2
2020,233648,10,2,14,5,9
2020,233648,10,3,18,7,11
2020,233648,10,4,11,5,6
2020,233648,40,0,46,18,28
2020,233648,40,1,3,1,2
2020,233648,40,2,14,5,9
2020,233648,40,3,18,7,11
2020,233648,40,4,11,5,6
2020,233648,42,0,46,18,28
2020,233648,42,1,3,1,2
2020,233648,42,2,14,5,9
2020,233648,42,3,18,7,11
2020,233648,42,4,11,5,6
2020,233718,0,0,36,19,17
2020,233718,10,0,36,19,17
2020,233718,10,1,9,6,3
2020,233718,10,2,10,3,7
2020,233718,10,3,15,9,6
2020,233718,10,4,2,1,1
2020,233718,20,0,15,8,7
2020,233718,20,1,7,5,2
2020,233718,20,2,8,3,5
2020,233718,30,0,4,3,1
2020,233718,30,3,4,3,1
2020,233718,40,0,17,8,9
2020,233718,40,1,2,1,1
2020,233718,40,2,2,0,2
2020,233718,40,3,11,6,5
2020,233718,40,4,2,1,1
2020,233718,41,0,11,2,9
2020,233718,41,1,1,0,1
2020,233718,41,2,2,0,2
2020,233718,41,3,6,1,5
2020,233718,41,4,2,1,1
2020,233718,42,0,5,5,0
2020,233718,42,1,1,1,0
2020,233718,42,3,4,4,0
2020,233718,43,0,1,1,0
2020,233718,43,3,1,1,0
2020,233718,44,0,11,2,9
2020,233718,44,1,1,0,1
2020,233718,44,2,2,0,2
2020,233718,44,3,6,1,5
2020,233718,44,4,2,1,1
2020,233754,0,0,92,35,57
2020,233754,10,0,92,35,57
2020,233754,10,1,14,4,10
2020,233754,10,2,29,11,18
2020,233754,10,3,27,11,16
2020,233754,10,4,21,9,12
2020,233754,10,5,1,0,1
2020,233754,40,0,92,35,57
2020,233754,40,1,14,4,10
2020,233754,40,2,29,11,18
2020,233754,40,3,27,11,16
2020,233754,40,4,21,9,12
2020,233754,40,5,1,0,1
2020,233754,42,0,92,35,57
2020,233754,42,1,14,4,10
2020,233754,42,2,29,11,18
2020,233754,42,3,27,11,16
2020,233754,42,4,21,9,12
2020,233754,42,5,1,0,1
2020,233772,0,0,274,126,148
2020,233772,10,0,274,126,148
2020,233772,10,1,62,28,34
2020,233772,10,2,76,37,39
2020,233772,10,3,63,28,35
2020,233772,10,4,67,29,38
2020,233772,10,5,6,4,2
2020,233772,40,0,274,126,148
2020,233772,40,1,62,28,34
2020,233772,40,2,76,37,39
2020,233772,40,3,63,28,35
2020,233772,40,4,67,29,38
2020,233772,40,5,6,4,2
2020,233772,42,0,274,126,148
2020,233772,42,1,62,28,34
2020,233772,42,2,76,37,39
2020,233772,42,3,63,28,35
2020,233772,42,4,67,29,38
2020,233772,42,5,6,4,2
2020,233842,0,0,24,14,10
2020,233842,10,0,24,14,10
2020,233842,10,1,10,7,3
2020,233842,10,2,8,4,4
2020,233842,10,3,5,3,2
2020,233842,10,4,1,0,1
2020,233842,20,0,14,9,5
2020,233842,20,1,9,6,3
2020,233842,20,2,5,3,2
2020,233842,30,0,3,1,2
2020,233842,30,3,2,1,1
2020,233842,30,4,1,0,1
2020,233842,40,0,7,4,3
2020,233842,40,1,1,1,0
2020,233842,40,2,3,1,2
2020,233842,40,3,3,2,1
2020,233842,41,0,7,4,3
2020,233842,41,1,1,1,0
2020,233842,41,2,3,1,2
2020,233842,41,3,3,2,1
2020,233842,44,0,2,1,1
2020,233842,44,3,2,1,1
2020,233842,45,0,5,3,2
2020,233842,45,1,1,1,0
2020,233842,45,2,3,1,2
2020,233842,45,3,1,1,0
2020,233897,0,0,103,53,50
2020,233897,10,0,103,53,50
2020,233897,10,1,28,18,10
2020,233897,10,2,29,19,10
2020,233897,10,3,21,10,11
2020,233897,10,4,25,6,19
2020,233897,20,0,59,40,19
2020,233897,20,1,28,18,10
2020,233897,20,2,28,19,9
2020,233897,20,3,3,3,0
2020,233897,30,0,19,7,12
2020,233897,30,2,1,0,1
2020,233897,30,3,18,7,11
2020,233897,40,0,25,6,19
2020,233897,40,4,25,6,19
2020,233897,42,0,25,6,19
2020,233897,42,4,25,6,19
2020,233903,0,0,36,14,22
2020,233903,10,0,36,14,22
2020,233903,10,1,3,0,3
2020,233903,10,2,12,3,9
2020,233903,10,3,13,5,8
2020,233903,10,4,8,6,2
2020,233903,40,0,36,14,22
2020,233903,40,1,3,0,3
2020,233903,40,2,12,3,9
2020,233903,40,3,13,5,8
2020,233903,40,4,8,6,2
2020,233903,42,0,36,14,22
2020,233903,42,1,3,0,3
2020,233903,42,2,12,3,9
2020,233903,42,3,13,5,8
2020,233903,42,4,8,6,2
2020,233921,0,0,2109,1333,776
2020,233921,10,0,2109,1333,776
2020,233921,10,1,597,476,121
2020,233921,10,2,550,339,211
2020,233921,10,3,623,351,272
2020,233921,10,4,295,140,155
2020,233921,10,5,2,2,0
2020,233921,10,6,42,25,17
2020,233921,20,0,1011,727,284
2020,233921,20,1,561,450,111
2020,233921,20,2,450,277,173
2020,233921,30,0,488,291,197
2020,233921,30,1,7,4,3
2020,233921,30,2,33,24,9
2020,233921,30,3,448,263,185
2020,233921,40,0,610,315,295
2020,233921,40,1,29,22,7
2020,233921,40,2,67,38,29
2020,233921,40,3,175,88,87
2020,233921,40,4,295,140,155
2020,233921,40,5,2,2,0
2020,233921,40,6,42,25,17
2020,233921,42,0,610,315,295
2020,233921,42,1,29,22,7
2020,233921,42,2,67,38,29
2020,233921,42,3,175,88,87
2020,233921,42,4,295,140,155
2020,233921,42,5,2,2,0
2020,233921,42,6,42,25,17
2020,233949,0,0,78,32,46
2020,233949,10,0,78,32,46
2020,233949,10,1,15,7,8
2020,233949,10,2,25,8,17
2020,233949,10,3,21,8,13
2020,233949,10,4,17,9,8
2020,233949,40,0,78,32,46
2020,233949,40,1,15,7,8
2020,233949,40,2,25,8,17
2020,233949,40,3,21,8,13
2020,233949,40,4,17,9,8
2020,233949,42,0,78,32,46
2020,233949,42,1,15,7,8
2020,233949,42,2,25,8,17
2020,233949,42,3,21,8,13
2020,233949,42,4,17,9,8
2020,234030,0,0,2211,1230,981
2020,234030,10,0,2209,1229,980
2020,234030,10,1,470,348,122
2020,234030,10,2,675,354,321
2020,234030,10,3,912,456,456
2020,234030,10,4,152,71,81
2020,234030,20,0,702,453,249
2020,234030,20,1,350,270,80
2020,234030,20,2,351,183,168
2020,234030,20,3,1,0,1
2020,234030,30,0,278,153,125
2020,234030,30,1,19,10,9
2020,234030,30,2,18,12,6
2020,234030,30,3,241,131,110
2020,234030,40,0,1229,623,606
2020,234030,40,1,101,68,33
2020,234030,40,2,306,159,147
2020,234030,40,3,670,325,345
2020,234030,40,4,152,71,81
2020,234030,42,0,1229,623,606
2020,234030,42,1,101,68,33
2020,234030,42,2,306,159,147
2020,234030,42,3,670,325,345
2020,234030,42,4,152,71,81
2020,234030,50,0,2,1,1
2020,234076,0,0,2484,1514,970
2020,234076,10,0,2484,1514,970
2020,234076,10,1,821,605,216
2020,234076,10,2,776,448,328
2020,234076,10,3,746,396,350
2020,234076,10,4,41,28,13
2020,234076,10,5,100,37,63
2020,234076,20,0,1097,776,321
2020,234076,20,1,705,531,174
2020,234076,20,2,392,245,147
2020,234076,30,0,392,234,158
2020,234076,30,2,74,47,27
2020,234076,30,3,318,187,131
2020,234076,40,0,995,504,491
2020,234076,40,1,116,74,42
2020,234076,40,2,310,156,154
2020,234076,40,3,428,209,219
2020,234076,40,4,41,28,13
2020,234076,40,5,100,37,63
2020,234076,41,0,870,439,431
2020,234076,41,1,113,71,42
2020,234076,41,2,301,153,148
2020,234076,41,3,399,192,207
2020,234076,41,4,8,4,4
2020,234076,41,5,49,19,30
2020,234076,42,0,120,61,59
2020,234076,42,1,2,2,0
2020,234076,42,2,8,3,5
2020,234076,42,3,27,15,12
2020,234076,42,4,32,23,9
2020,234076,42,5,51,18,33
2020,234076,43,0,5,4,1
2020,234076,43,1,1,1,0
2020,234076,43,2,1,0,1
2020,234076,43,3,2,2,0
2020,234076,43,4,1,1,0
2020,234076,44,0,870,439,431
2020,234076,44,1,113,71,42
2020,234076,44,2,301,153,148
2020,234076,44,3,399,192,207
2020,234076,44,4,8,4,4
2020,234076,44,5,49,19,30
2020,234085,0,0,142,94,48
2020,234085,10,0,142,94,48
2020,234085,10,1,61,50,11
2020,234085,10,2,26,15,11
2020,234085,10,3,48,25,23
2020,234085,10,4,4,2,2
2020,234085,10,5,3,2,1
2020,234085,20,0,70,55,15
2020,234085,20,1,57,47,10
2020,234085,20,2,13,8,5
2020,234085,30,0,52,28,24
2020,234085,30,1,2,2,0
2020,234085,30,2,12,6,6
2020,234085,30,3,38,20,18
2020,234085,40,0,20,11,9
2020,234085,40,1,2,1,1
2020,234085,40,2,1,1,0
2020,234085,40,3,10,5,5
2020,234085,40,4,4,2,2
2020,234085,40,5,3,2,1
2020,234085,41,0,15,7,8
2020,234085,41,1,1,0,1
2020,234085,41,2,1,1,0
2020,234085,41,3,10,5,5
2020,234085,41,4,1,0,1
2020,234085,41,5,2,1,1
2020,234085,42,0,5,4,1
2020,234085,42,1,1,1,0
2020,234085,42,4,3,2,1
2020,234085,42,5,1,1,0
2020,234085,44,0,15,7,8
2020,234085,44,1,1,0,1
2020,234085,44,2,1,1,0
2020,234085,44,3,10,5,5
2020,234085,44,4,1,0,1
2020,234085,44,5,2,1,1
2020,234137,0,0,5,5,0
2020,234137,10,0,5,5,0
2020,234137,10,1,4,4,0
2020,234137,10,4,1,1,0
2020,234137,40,0,5,5,0
2020,234137,40,1,4,4,0
2020,234137,40,4,1,1,0
2020,234137,41,0,5,5,0
2020,234137,41,1,4,4,0
2020,234137,41,4,1,1,0
2020,234137,45,0,5,5,0
2020,234137,45,1,4,4,0
2020,234137,45,4,1,1,0
2020,234155,0,0,272,145,127
2020,234155,10,0,272,145,127
2020,234155,10,1,61,38,23
2020,234155,10,2,85,50,35
2020,234155,10,3,85,42,43
2020,234155,10,4,41,15,26
2020,234155,20,0,129,77,52
2020,234155,20,1,58,35,23
2020,234155,20,2,68,40,28
2020,234155,20,3,3,2,1
2020,234155,30,0,52,23,29
2020,234155,30,2,13,7,6
2020,234155,30,3,38,15,23
2020,234155,30,4,1,1,0
2020,234155,40,0,91,45,46
2020,234155,40,1,3,3,0
2020,234155,40,2,4,3,1
2020,234155,40,3,44,25,19
2020,234155,40,4,40,14,26
2020,234155,42,0,91,45,46
2020,234155,42,1,3,3,0
2020,234155,42,2,4,3,1
2020,234155,42,3,44,25,19
2020,234155,42,4,40,14,26
2020,234164,0,0,70,35,35
2020,234164,10,0,65,35,30
2020,234164,10,1,9,6,3
2020,234164,10,2,23,12,11
2020,234164,10,3,29,15,14
2020,234164,10,4,4,2,2
2020,234164,20,0,14,9,5
2020,234164,20,1,9,6,3
2020,234164,20,2,4,3,1
2020,234164,20,3,1,0,1
2020,234164,30,0,51,26,25
2020,234164,30,2,19,9,10
2020,234164,30,3,28,15,13
2020,234164,30,4,4,2,2
2020,234164,50,0,5,0,5
2020,234173,0,0,89,45,44
2020,234173,10,0,89,45,44
2020,234173,10,1,43,22,21
2020,234173,10,2,25,15,10
2020,234173,10,3,17,6,11
2020,234173,10,4,4,2,2
2020,234173,20,0,68,37,31
2020,234173,20,1,43,22,21
2020,234173,20,2,25,15,10
2020,234173,30,0,17,6,11
2020,234173,30,3,17,6,11
2020,234173,40,0,4,2,2
2020,234173,40,4,4,2,2
2020,234173,42,0,4,2,2
2020,234173,42,4,4,2,2
2020,234207,0,0,251,138,113
2020,234207,10,0,251,138,113
2020,234207,10,1,115,73,42
2020,234207,10,2,59,32,27
2020,234207,10,3,66,29,37
2020,234207,10,4,9,3,6
2020,234207,10,5,2,1,1
2020,234207,20,0,156,96,60
2020,234207,20,1,104,66,38
2020,234207,20,2,52,30,22
2020,234207,30,0,48,21,27
2020,234207,30,2,6,2,4
2020,234207,30,3,42,19,23
2020,234207,40,0,47,21,26
2020,234207,40,1,11,7,4
2020,234207,40,2,1,0,1
2020,234207,40,3,24,10,14
2020,234207,40,4,9,3,6
2020,234207,40,5,2,1,1
2020,234207,41,0,19,10,9
2020,234207,41,1,8,5,3
2020,234207,41,3,1,1,0
2020,234207,41,4,8,3,5
2020,234207,41,5,2,1,1
2020,234207,42,0,28,11,17
2020,234207,42,1,3,2,1
2020,234207,42,2,1,0,1
2020,234207,42,3,23,9,14
2020,234207,42,4,1,0,1
2020,234207,44,0,19,10,9
2020,234207,44,1,8,5,3
2020,234207,44,3,1,1,0
2020,234207,44,4,8,3,5
2020,234207,44,5,2,1,1
2020,234377,0,0,29,9,20
2020,234377,10,0,29,9,20
2020,234377,10,1,3,1,2
2020,234377,10,2,10,2,8
2020,234377,10,3,11,3,8
2020,234377,10,4,5,3,2
2020,234377,40,0,29,9,20
2020,234377,40,1,3,1,2
2020,234377,40,2,10,2,8
2020,234377,40,3,11,3,8
2020,234377,40,4,5,3,2
2020,234377,42,0,29,9,20
2020,234377,42,1,3,1,2
2020,234377,42,2,10,2,8
2020,234377,42,3,11,3,8
2020,234377,42,4,5,3,2
2020,234669,0,0,199,86,113
2020,234669,10,0,199,86,113
2020,234669,10,1,45,16,29
2020,234669,10,2,112,52,60
2020,234669,10,3,39,17,22
2020,234669,10,4,3,1,2
2020,234669,20,0,151,64,87
2020,234669,20,1,45,16,29
2020,234669,20,2,106,48,58
2020,234669,30,0,39,17,22
2020,234669,30,3,39,17,22
2020,234669,40,0,9,5,4
2020,234669,40,2,6,4,2
2020,234669,40,4,3,1,2
2020,234669,42,0,7,4,3
2020,234669,42,2,6,4,2
2020,234669,42,4,1,0,1
2020,234669,43,0,2,1,1
2020,234669,43,4,2,1,1
2020,234696,0,0,63,31,32
2020,234696,10,0,63,31,32
2020,234696,10,6,63,31,32
2020,234696,20,0,37,19,18
2020,234696,20,6,37,19,18
2020,234696,30,0,12,6,6
2020,234696,30,6,12,6,6
2020,234696,40,0,14,6,8
2020,234696,40,6,14,6,8
2020,234696,42,0,14,6,8
2020,234696,42,6,14,6,8
2020,234711,0,0,48,29,19
2020,234711,10,0,48,29,19
2020,234711,10,4,48,29,19
2020,234711,20,0,35,24,11
2020,234711,20,4,35,24,11
2020,234711,30,0,11,3,8
2020,234711,30,4,11,3,8
2020,234711,40,0,2,2,0
2020,234711,40,4,2,2,0
2020,234711,42,0,2,2,0
2020,234711,42,4,2,2,0
2020,234827,0,0,508,270,238
2020,234827,10,0,489,253,236
2020,234827,10,1,155,96,59
2020,234827,10,2,117,57,60
2020,234827,10,3,70,39,31
2020,234827,10,4,13,13,0
2020,234827,10,5,134,48,86
2020,234827,20,0,272,153,119
2020,234827,20,1,155,96,59
2020,234827,20,2,117,57,60
2020,234827,30,0,70,39,31
2020,234827,30,3,70,39,31
2020,234827,40,0,147,61,86
2020,234827,40,4,13,13,0
2020,234827,40,5,134,48,86
2020,234827,42,0,112,48,64
2020,234827,42,5,112,48,64
2020,234827,43,0,35,13,22
2020,234827,43,4,13,13,0
2020,234827,43,5,22,0,22
2020,234827,50,0,19,17,2
2020,234845,0,0,70,30,40
2020,234845,10,0,70,30,40
2020,234845,10,6,70,30,40
2020,234845,20,0,39,16,23
2020,234845,20,6,39,16,23
2020,234845,30,0,18,10,8
2020,234845,30,6,18,10,8
2020,234845,40,0,13,4,9
2020,234845,40,6,13,4,9
2020,234845,42,0,13,4,9
2020,234845,42,6,13,4,9
2020,234915,0,0,31,14,17
2020,234915,10,0,31,14,17
2020,234915,10,6,31,14,17
2020,234915,40,0,31,14,17
2020,234915,40,6,31,14,17
2020,234915,41,0,31,14,17
2020,234915,41,6,31,14,17
2020,234915,45,0,31,14,17
2020,234915,45,6,31,14,17
2020,234933,0,0,173,69,104
2020,234933,10,0,173,69,104
2020,234933,10,4,173,69,104
2020,234933,20,0,126,50,76
2020,234933,20,4,126,50,76
2020,234933,30,0,26,9,17
2020,234933,30,4,26,9,17
2020,234933,40,0,21,10,11
2020,234933,40,4,21,10,11
2020,234933,42,0,21,10,11
2020,234933,42,4,21,10,11
2020,234951,0,0,101,49,52
2020,234951,10,0,101,49,52
2020,234951,10,4,95,46,49
2020,234951,10,6,6,3,3
2020,234951,20,0,63,29,34
2020,234951,20,4,59,27,32
2020,234951,20,6,4,2,2
2020,234951,30,0,33,17,16
2020,234951,30,4,32,17,15
2020,234951,30,6,1,0,1
2020,234951,40,0,5,3,2
2020,234951,40,4,4,2,2
2020,234951,40,6,1,1,0
2020,234951,42,0,4,2,2
2020,234951,42,4,4,2,2
2020,234951,43,0,1,1,0
2020,234951,43,6,1,1,0
2020,234979,0,0,138,63,75
2020,234979,10,0,138,63,75
2020,234979,10,6,138,63,75
2020,234979,20,0,86,42,44
2020,234979,20,6,86,42,44
2020,234979,30,0,39,15,24
2020,234979,30,6,39,15,24
2020,234979,40,0,13,6,7
2020,234979,40,6,13,6,7
2020,234979,42,0,12,5,7
2020,234979,42,6,12,5,7
2020,234979,43,0,1,1,0
2020,234979,43,6,1,1,0
2020,235024,0,0,41,15,26
2020,235024,10,0,41,15,26
2020,235024,10,1,16,5,11
2020,235024,10,2,13,4,9
2020,235024,10,3,11,6,5
2020,235024,10,6,1,0,1
2020,235024,40,0,41,15,26
2020,235024,40,1,16,5,11
2020,235024,40,2,13,4,9
2020,235024,40,3,11,6,5
2020,235024,40,6,1,0,1
2020,235024,41,0,30,11,19
2020,235024,41,1,16,5,11
2020,235024,41,2,9,4,5
2020,235024,41,3,5,2,3
2020,235024,42,0,11,4,7
2020,235024,42,2,4,0,4
2020,235024,42,3,6,4,2
2020,235024,42,6,1,0,1
2020,235024,44,0,30,11,19
2020,235024,44,1,16,5,11
2020,235024,44,2,9,4,5
2020,235024,44,3,5,2,3
2020,235097,0,0,444,222,222
2020,235097,10,0,444,222,222
2020,235097,10,1,155,95,60
2020,235097,10,2,74,42,32
2020,235097,10,3,66,25,41
2020,235097,10,5,149,60,89
2020,235097,20,0,229,137,92
2020,235097,20,1,155,95,60
2020,235097,20,2,74,42,32
2020,235097,30,0,66,25,41
2020,235097,30,3,66,25,41
2020,235097,40,0,149,60,89
2020,235097,40,5,149,60,89
2020,235097,41,0,57,24,33
2020,235097,41,5,57,24,33
2020,235097,42,0,92,36,56
2020,235097,42,5,92,36,56
2020,235097,44,0,57,24,33
2020,235097,44,5,57,24,33
2020,235103,0,0,111,48,63
2020,235103,10,0,111,48,63
2020,235103,10,6,111,48,63
2020,235103,20,0,95,44,51
2020,235103,20,6,95,44,51
2020,235103,30,0,7,2,5
2020,235103,30,6,7,2,5
2020,235103,40,0,9,2,7
2020,235103,40,6,9,2,7
2020,235103,42,0,9,2,7
2020,235103,42,6,9,2,7
2020,235149,0,0,134,57,77
2020,235149,10,0,134,57,77
2020,235149,10,6,134,57,77
2020,235149,20,0,86,40,46
2020,235149,20,6,86,40,46
2020,235149,30,0,31,12,19
2020,235149,30,6,31,12,19
2020,235149,40,0,17,5,12
2020,235149,40,6,17,5,12
2020,235149,42,0,17,5,12
2020,235149,42,6,17,5,12
2020,235167,0,0,122,52,70
2020,235167,10,0,122,52,70
2020,235167,10,6,122,52,70
2020,235167,40,0,122,52,70
2020,235167,40,6,122,52,70
2020,235167,41,0,117,49,68
2020,235167,41,6,117,49,68
2020,235167,43,0,5,3,2
2020,235167,43,6,5,3,2
2020,235167,44,0,117,49,68
2020,235167,44,6,117,49,68
2020,235237,0,0,142,56,86
2020,235237,10,0,142,56,86
2020,235237,10,4,142,56,86
2020,235237,20,0,97,41,56
2020,235237,20,4,97,41,56
2020,235237,30,0,35,12,23
2020,235237,30,4,35,12,23
2020,235237,40,0,10,3,7
2020,235237,40,4,10,3,7
2020,235237,42,0,10,3,7
2020,235237,42,4,10,3,7
2020,235316,0,0,445,248,197
2020,235316,10,0,445,248,197
2020,235316,10,1,133,85,48
2020,235316,10,2,142,77,65
2020,235316,10,3,148,79,69
2020,235316,10,5,22,7,15
2020,235316,20,0,231,144,87
2020,235316,20,1,130,84,46
2020,235316,20,2,98,57,41
2020,235316,20,3,3,3,0
2020,235316,30,0,135,68,67
2020,235316,30,1,3,1,2
2020,235316,30,2,32,16,16
2020,235316,30,3,100,51,49
2020,235316,40,0,79,36,43
2020,235316,40,2,12,4,8
2020,235316,40,3,45,25,20
2020,235316,40,5,22,7,15
2020,235316,41,0,38,17,21
2020,235316,41,2,12,4,8
2020,235316,41,3,20,11,9
2020,235316,41,5,6,2,4
2020,235316,42,0,41,19,22
2020,235316,42,3,25,14,11
2020,235316,42,5,16,5,11
2020,235316,44,0,38,17,21
2020,235316,44,2,12,4,8
2020,235316,44,3,20,11,9
2020,235316,44,5,6,2,4
2020,235334,0,0,57,34,23
2020,235334,10,0,57,34,23
2020,235334,10,3,57,34,23
2020,235334,20,0,38,23,15
2020,235334,20,3,38,23,15
2020,235334,30,0,11,6,5
2020,235334,30,3,11,6,5
2020,235334,40,0,8,5,3
2020,235334,40,3,8,5,3
2020,235334,42,0,6,3,3
2020,235334,42,3,6,3,3
2020,235334,43,0,2,2,0
2020,235334,43,3,2,2,0
2020,235343,0,0,169,88,81
2020,235343,10,0,169,88,81
2020,235343,10,4,169,88,81
2020,235343,20,0,122,68,54
2020,235343,20,4,122,68,54
2020,235343,30,0,41,17,24
2020,235343,30,4,41,17,24
2020,235343,40,0,6,3,3
2020,235343,40,4,6,3,3
2020,235343,42,0,6,3,3
2020,235343,42,4,6,3,3
2020,235422,0,0,57,27,30
2020,235422,10,0,57,27,30
2020,235422,10,1,6,4,2
2020,235422,10,2,27,17,10
2020,235422,10,3,19,5,14
2020,235422,10,4,5,1,4
2020,235422,40,0,57,27,30
2020,235422,40,1,6,4,2
2020,235422,40,2,27,17,10
2020,235422,40,3,19,5,14
2020,235422,40,4,5,1,4
2020,235422,41,0,13,9,4
2020,235422,41,1,4,3,1
2020,235422,41,2,7,5,2
2020,235422,41,3,2,1,1
2020,235422,42,0,44,18,26
2020,235422,42,1,2,1,1
2020,235422,42,2,20,12,8
2020,235422,42,3,17,4,13
2020,235422,42,4,5,1,4
2020,235422,44,0,13,9,4
2020,235422,44,1,4,3,1
2020,235422,44,2,7,5,2
2020,235422,44,3,2,1,1
2020,235431,0,0,161,58,103
2020,235431,10,0,161,58,103
2020,235431,10,6,161,58,103
2020,235431,20,0,99,40,59
2020,235431,20,6,99,40,59
2020,235431,30,0,31,8,23
2020,235431,30,6,31,8,23
2020,235431,40,0,31,10,21
2020,235431,40,6,31,10,21
2020,235431,42,0,31,10,21
2020,235431,42,6,31,10,21
2020,235547,0,0,23,5,18
2020,235547,10,0,23,5,18
2020,235547,10,1,4,2,2
2020,235547,10,2,9,2,7
2020,235547,10,3,10,1,9
2020,235547,40,0,23,5,18
2020,235547,40,1,4,2,2
2020,235547,40,2,9,2,7
2020,235547,40,3,10,1,9
2020,235547,41,0,6,3,3
2020,235547,41,1,1,1,0
2020,235547,41,2,4,2,2
2020,235547,41,3,1,0,1
2020,235547,42,0,17,2,15
2020,235547,42,1,3,1,2
2020,235547,42,2,5,0,5
2020,235547,42,3,9,1,8
2020,235547,44,0,6,3,3
2020,235547,44,1,1,1,0
2020,235547,44,2,4,2,2
2020,235547,44,3,1,0,1
2020,235671,0,0,64,36,28
2020,235671,10,0,64,36,28
2020,235671,10,4,16,8,8
2020,235671,10,6,48,28,20
2020,235671,20,0,39,21,18
2020,235671,20,4,7,4,3
2020,235671,20,6,32,17,15
2020,235671,30,0,11,8,3
2020,235671,30,4,2,1,1
2020,235671,30,6,9,7,2
2020,235671,40,0,14,7,7
2020,235671,40,4,7,3,4
2020,235671,40,6,7,4,3
2020,235671,42,0,14,7,7
2020,235671,42,4,7,3,4
2020,235671,42,6,7,4,3
2020,235699,0,0,84,30,54
2020,235699,10,0,84,30,54
2020,235699,10,6,84,30,54
2020,235699,20,0,34,14,20
2020,235699,20,6,34,14,20
2020,235699,30,0,17,5,12
2020,235699,30,6,17,5,12
2020,235699,40,0,33,11,22
2020,235699,40,6,33,11,22
2020,235699,42,0,33,11,22
2020,235699,42,6,33,11,22
2020,235750,0,0,74,32,42
2020,235750,10,0,74,32,42
2020,235750,10,4,74,32,42
2020,235750,20,0,56,29,27
2020,235750,20,4,56,29,27
2020,235750,30,0,9,0,9
2020,235750,30,4,9,0,9
2020,235750,40,0,9,3,6
2020,235750,40,4,9,3,6
2020,235750,42,0,9,3,6
2020,235750,42,4,9,3,6
2020,236072,0,0,95,38,57
2020,236072,10,0,95,38,57
2020,236072,10,6,95,38,57
2020,236072,20,0,66,29,37
2020,236072,20,6,66,29,37
2020,236072,40,0,29,9,20
2020,236072,40,6,29,9,20
2020,236072,42,0,22,7,15
2020,236072,42,6,22,7,15
2020,236072,43,0,7,2,5
2020,236072,43,6,7,2,5
2020,236133,0,0,56,26,30
2020,236133,10,0,56,26,30
2020,236133,10,1,14,8,6
2020,236133,10,2,18,8,10
2020,236133,10,3,21,9,12
2020,236133,10,4,3,1,2
2020,236133,20,0,24,12,12
2020,236133,20,1,14,8,6
2020,236133,20,2,10,4,6
2020,236133,30,0,29,13,16
2020,236133,30,2,8,4,4
2020,236133,30,3,21,9,12
2020,236133,40,0,3,1,2
2020,236133,40,4,3,1,2
2020,236133,42,0,3,1,2
2020,236133,42,4,3,1,2
2020,236188,0,0,130,55,75
2020,236188,10,0,130,55,75
2020,236188,10,4,130,55,75
2020,236188,20,0,90,39,51
2020,236188,20,4,90,39,51
2020,236188,30,0,33,16,17
2020,236188,30,4,33,16,17
2020,236188,40,0,7,0,7
2020,236188,40,4,7,0,7
2020,236188,42,0,7,0,7
2020,236188,42,4,7,0,7
2020,236212,0,0,53,45,8
2020,236212,10,0,53,45,8
2020,236212,10,4,53,45,8
2020,236212,40,0,53,45,8
2020,236212,40,4,53,45,8
2020,236212,41,0,53,45,8
2020,236212,41,4,53,45,8
2020,236212,45,0,53,45,8
2020,236212,45,4,53,45,8
2020,236230,0,0,198,89,109
2020,236230,10,0,198,89,109
2020,236230,10,1,50,30,20
2020,236230,10,2,77,27,50
2020,236230,10,3,61,31,30
2020,236230,10,4,10,1,9
2020,236230,20,0,128,57,71
2020,236230,20,1,50,30,20
2020,236230,20,2,76,26,50
2020,236230,20,3,2,1,1
2020,236230,30,0,41,18,23
2020,236230,30,2,1,1,0
2020,236230,30,3,40,17,23
2020,236230,40,0,29,14,15
2020,236230,40,3,19,13,6
2020,236230,40,4,10,1,9
2020,236230,41,0,2,1,1
2020,236230,41,3,2,1,1
2020,236230,42,0,25,12,13
2020,236230,42,3,17,12,5
2020,236230,42,4,8,0,8
2020,236230,43,0,2,1,1
2020,236230,43,4,2,1,1
2020,236230,44,0,2,1,1
2020,236230,44,3,2,1,1
2020,236258,0,0,46,24,22
2020,236258,10,0,46,24,22
2020,236258,10,4,46,24,22
2020,236258,20,0,26,15,11
2020,236258,20,4,26,15,11
2020,236258,30,0,8,2,6
2020,236258,30,4,8,2,6
2020,236258,40,0,12,7,5
2020,236258,40,4,12,7,5
2020,236258,42,0,12,7,5
2020,236258,42,4,12,7,5
2020,236328,0,0,227,107,120
2020,236328,10,0,226,106,120
2020,236328,10,1,122,67,55
2020,236328,10,2,38,19,19
2020,236328,10,3,49,14,35
2020,236328,10,4,17,6,11
2020,236328,20,0,144,78,66
2020,236328,20,1,119,65,54
2020,236328,20,2,25,13,12
2020,236328,30,0,36,14,22
2020,236328,30,1,1,0,1
2020,236328,30,2,10,6,4
2020,236328,30,3,25,8,17
2020,236328,40,0,46,14,32
2020,236328,40,1,2,2,0
2020,236328,40,2,3,0,3
2020,236328,40,3,24,6,18
2020,236328,40,4,17,6,11
2020,236328,41,0,3,1,2
2020,236328,41,3,3,1,2
2020,236328,42,0,43,13,30
2020,236328,42,1,2,2,0
2020,236328,42,2,3,0,3
2020,236328,42,3,21,5,16
2020,236328,42,4,17,6,11
2020,236328,44,0,3,1,2
2020,236328,44,3,3,1,2
2020,236328,50,0,1,1,0
2020,236382,0,0,65,33,32
2020,236382,10,0,65,33,32
2020,236382,10,4,65,33,32
2020,236382,20,0,40,21,19
2020,236382,20,4,40,21,19
2020,236382,30,0,15,6,9
2020,236382,30,4,15,6,9
2020,236382,40,0,10,6,4
2020,236382,40,4,10,6,4
2020,236382,42,0,9,5,4
2020,236382,42,4,9,5,4
2020,236382,43,0,1,1,0
2020,236382,43,4,1,1,0
2020,236452,0,0,96,51,45
2020,236452,10,0,96,51,45
2020,236452,10,1,18,12,6
2020,236452,10,2,27,14,13
2020,236452,10,3,36,19,17
2020,236452,10,4,15,6,9
2020,236452,20,0,45,26,19
2020,236452,20,1,18,12,6
2020,236452,20,2,27,14,13
2020,236452,30,0,33,16,17
2020,236452,30,3,33,16,17
2020,236452,40,0,18,9,9
2020,236452,40,3,3,3,0
2020,236452,40,4,15,6,9
2020,236452,42,0,18,9,9
2020,236452,42,3,3,3,0
2020,236452,42,4,15,6,9
2020,236504,0,0,69,37,32
2020,236504,10,0,69,37,32
2020,236504,10,4,2,1,1
2020,236504,10,6,67,36,31
2020,236504,20,0,53,30,23
2020,236504,20,4,2,1,1
2020,236504,20,6,51,29,22
2020,236504,40,0,16,7,9
2020,236504,40,6,16,7,9
2020,236504,42,0,13,6,7
2020,236504,42,6,13,6,7
2020,236504,43,0,3,1,2
2020,236504,43,6,3,1,2
2020,236513,0,0,164,71,93
2020,236513,10,0,164,71,93
2020,236513,10,6,164,71,93
2020,236513,20,0,110,50,60
2020,236513,20,6,110,50,60
2020,236513,40,0,54,21,33
2020,236513,40,6,54,21,33
2020,236513,42,0,42,15,27
2020,236513,42,6,42,15,27
2020,236513,43,0,12,6,6
2020,236513,43,6,12,6,6
2020,236577,0,0,211,108,103
2020,236577,10,0,211,108,103
2020,236577,10,1,64,40,24
2020,236577,10,2,61,28,33
2020,236577,10,3,72,38,34
2020,236577,10,4,12,2,10
2020,236577,10,6,2,0,2
2020,236577,20,0,110,64,46
2020,236577,20,1,62,39,23
2020,236577,20,2,47,25,22
2020,236577,20,3,1,0,1
2020,236577,30,0,56,28,28
2020,236577,30,2,10,2,8
2020,236577,30,3,46,26,20
2020,236577,40,0,45,16,29
2020,236577,40,1,2,1,1
2020,236577,40,2,4,1,3
2020,236577,40,3,25,12,13
2020,236577,40,4,12,2,10
2020,236577,40,6,2,0,2
2020,236577,41,0,22,6,16
2020,236577,41,1,1,1,0
2020,236577,41,2,4,1,3
2020,236577,41,3,11,3,8
2020,236577,41,4,6,1,5
2020,236577,42,0,21,10,11
2020,236577,42,1,1,0,1
2020,236577,42,3,14,9,5
2020,236577,42,4,5,1,4
2020,236577,42,6,1,0,1
2020,236577,43,0,2,0,2
2020,236577,43,4,1,0,1
2020,236577,43,6,1,0,1
2020,236577,44,0,22,6,16
2020,236577,44,1,1,1,0
2020,236577,44,2,4,1,3
2020,236577,44,3,11,3,8
2020,236577,44,4,6,1,5
2020,236595,0,0,529,231,298
2020,236595,10,0,529,231,298
2020,236595,10,1,111,59,52
2020,236595,10,2,164,82,82
2020,236595,10,3,84,30,54
2020,236595,10,4,112,40,72
2020,236595,10,5,39,13,26
2020,236595,10,6,19,7,12
2020,236595,20,0,264,141,123
2020,236595,20,1,105,57,48
2020,236595,20,2,156,82,74
2020,236595,20,3,3,2,1
2020,236595,30,0,69,25,44
2020,236595,30,2,2,0,2
2020,236595,30,3,67,25,42
2020,236595,40,0,196,65,131
2020,236595,40,1,6,2,4
2020,236595,40,2,6,0,6
2020,236595,40,3,14,3,11
2020,236595,40,4,112,40,72
2020,236595,40,5,39,13,26
2020,236595,40,6,19,7,12
2020,236595,42,0,196,65,131
2020,236595,42,1,6,2,4
2020,236595,42,2,6,0,6
2020,236595,42,3,14,3,11
2020,236595,42,4,112,40,72
2020,236595,42,5,39,13,26
2020,236595,42,6,19,7,12
2020,236610,0,0,130,48,82
2020,236610,10,0,130,48,82
2020,236610,10,6,130,48,82
2020,236610,20,0,93,34,59
2020,236610,20,6,93,34,59
2020,236610,30,0,16,8,8
2020,236610,30,6,16,8,8
2020,236610,40,0,21,6,15
2020,236610,40,6,21,6,15
2020,236610,42,0,21,6,15
2020,236610,42,6,21,6,15
2020,236638,0,0,90,36,54
2020,236638,10,0,90,36,54
2020,236638,10,6,90,36,54
2020,236638,20,0,62,25,37
2020,236638,20,6,62,25,37
2020,236638,30,0,22,9,13
2020,236638,30,6,22,9,13
2020,236638,40,0,6,2,4
2020,236638,40,6,6,2,4
2020,236638,42,0,6,2,4
2020,236638,42,6,6,2,4
2020,236656,0,0,95,42,53
2020,236656,10,0,95,42,53
2020,236656,10,6,95,42,53
2020,236656,20,0,40,17,23
2020,236656,20,6,40,17,23
2020,236656,30,0,55,25,30
2020,236656,30,6,55,25,30
2020,236692,0,0,203,98,105
2020,236692,10,0,203,98,105
2020,236692,10,4,203,98,105
2020,236692,20,0,141,73,68
2020,236692,20,4,141,73,68
2020,236692,30,0,41,16,25
2020,236692,30,4,41,16,25
2020,236692,40,0,21,9,12
2020,236692,40,4,21,9,12
2020,236692,42,0,21,9,12
2020,236692,42,4,21,9,12
2020,236708,0,0,131,62,69
2020,236708,10,0,131,62,69
2020,236708,10,4,131,62,69
2020,236708,20,0,108,50,58
2020,236708,20,4,108,50,58
2020,236708,30,0,10,6,4
2020,236708,30,4,10,6,4
2020,236708,40,0,13,6,7
2020,236708,40,4,13,6,7
2020,236708,42,0,13,6,7
2020,236708,42,4,13,6,7
2020,236753,0,0,136,60,76
2020,236753,10,0,136,60,76
2020,236753,10,4,136,60,76
2020,236753,20,0,100,48,52
2020,236753,20,4,100,48,52
2020,236753,30,0,19,7,12
2020,236753,30,4,19,7,12
2020,236753,40,0,17,5,12
2020,236753,40,4,17,5,12
2020,236753,42,0,17,5,12
2020,236753,42,4,17,5,12
2020,236887,0,0,107,58,49
2020,236887,10,0,107,58,49
2020,236887,10,6,107,58,49
2020,236887,20,0,62,29,33
2020,236887,20,6,62,29,33
2020,236887,30,0,10,6,4
2020,236887,30,6,10,6,4
2020,236887,40,0,35,23,12
2020,236887,40,6,35,23,12
2020,236887,42,0,35,23,12
2020,236887,42,6,35,23,12
2020,236896,0,0,88,50,38
2020,236896,10,0,88,50,38
2020,236896,10,1,32,20,12
2020,236896,10,2,25,15,10
2020,236896,10,3,24,10,14
2020,236896,10,4,7,5,2
2020,236896,20,0,53,35,18
2020,236896,20,1,31,20,11
2020,236896,20,2,18,12,6
2020,236896,20,3,4,3,1
2020,236896,30,0,27,10,17
2020,236896,30,1,1,0,1
2020,236896,30,2,6,3,3
2020,236896,30,3,18,7,11
2020,236896,30,4,2,0,2
2020,236896,40,0,8,5,3
2020,236896,40,2,1,0,1
2020,236896,40,3,2,0,2
2020,236896,40,4,5,5,0
2020,236896,42,0,8,5,3
2020,236896,42,2,1,0,1
2020,236896,42,3,2,0,2
2020,236896,42,4,5,5,0
2020,236939,0,0,1330,753,577
2020,236939,10,0,1330,753,577
2020,236939,10,1,337,246,91
2020,236939,10,2,299,189,110
2020,236939,10,3,202,102,100
2020,236939,10,4,27,8,19
2020,236939,10,5,42,20,22
2020,236939,10,6,423,188,235
2020,236939,20,0,626,429,197
2020,236939,20,1,336,245,91
2020,236939,20,2,290,184,106
2020,236939,30,0,212,108,104
2020,236939,30,1,1,1,0
2020,236939,30,2,9,5,4
2020,236939,30,3,202,102,100
2020,236939,40,0,492,216,276
2020,236939,40,4,27,8,19
2020,236939,40,5,42,20,22
2020,236939,40,6,423,188,235
2020,236939,41,0,325,149,176
2020,236939,41,4,20,6,14
2020,236939,41,5,5,2,3
2020,236939,41,6,300,141,159
2020,236939,42,0,164,66,98
2020,236939,42,4,7,2,5
2020,236939,42,5,36,18,18
2020,236939,42,6,121,46,75
2020,236939,43,0,3,1,2
2020,236939,43,5,1,0,1
2020,236939,43,6,2,1,1
2020,236939,44,0,210,87,123
2020,236939,44,4,20,6,14
2020,236939,44,5,5,2,3
2020,236939,44,6,185,79,106
2020,236939,45,0,115,62,53
2020,236939,45,6,115,62,53
2020,236948,0,0,4720,2519,2201
2020,236948,10,0,4719,2519,2200
2020,236948,10,1,1553,1031,522
2020,236948,10,2,1218,654,564
2020,236948,10,3,1229,572,657
2020,236948,10,4,326,177,149
2020,236948,10,5,393,85,308
2020,236948,20,0,2259,1425,834
2020,236948,20,1,1391,946,445
2020,236948,20,2,868,479,389
2020,236948,30,0,691,326,365
2020,236948,30,2,3,1,2
2020,236948,30,3,688,325,363
2020,236948,40,0,1769,768,1001
2020,236948,40,1,162,85,77
2020,236948,40,2,347,174,173
2020,236948,40,3,541,247,294
2020,236948,40,4,326,177,149
2020,236948,40,5,393,85,308
2020,236948,41,0,557,268,289
2020,236948,41,1,110,46,64
2020,236948,41,2,250,125,125
2020,236948,41,3,188,92,96
2020,236948,41,5,9,5,4
2020,236948,42,0,1212,500,712
2020,236948,42,1,52,39,13
2020,236948,42,2,97,49,48
2020,236948,42,3,353,155,198
2020,236948,42,4,326,177,149
2020,236948,42,5,384,80,304
2020,236948,44,0,557,268,289
2020,236948,44,1,110,46,64
2020,236948,44,2,250,125,125
2020,236948,44,3,188,92,96
2020,236948,44,5,9,5,4
2020,236948,50,0,1,0,1
2020,236975,0,0,85,38,47
2020,236975,10,0,85,38,47
2020,236975,10,6,85,38,47
2020,236975,20,0,62,34,28
2020,236975,20,6,62,34,28
2020,236975,30,0,16,2,14
2020,236975,30,6,16,2,14
2020,236975,40,0,7,2,5
2020,236975,40,6,7,2,5
2020,236975,42,0,7,2,5
2020,236975,42,6,7,2,5
2020,237011,0,0,657,342,315
2020,237011,10,0,657,342,315
2020,237011,10,1,232,143,89
2020,237011,10,2,173,90,83
2020,237011,10,3,152,70,82
2020,237011,10,4,100,39,61
2020,237011,20,0,403,232,171
2020,237011,20,1,232,143,89
2020,237011,20,2,171,89,82
2020,237011,30,0,154,71,83
2020,237011,30,2,2,1,1
2020,237011,30,3,152,70,82
2020,237011,40,0,100,39,61
2020,237011,40,4,100,39,61
2020,237011,41,0,64,24,40
2020,237011,41,4,64,24,40
2020,237011,42,0,36,15,21
2020,237011,42,4,36,15,21
2020,237011,44,0,64,24,40
2020,237011,44,4,64,24,40
2020,237039,0,0,85,33,52
2020,237039,10,0,85,33,52
2020,237039,10,1,24,6,18
2020,237039,10,2,17,8,9
2020,237039,10,3,14,7,7
2020,237039,10,4,18,6,12
2020,237039,10,6,12,6,6
2020,237039,20,0,66,26,40
2020,237039,20,1,24,6,18
2020,237039,20,2,17,8,9
2020,237039,20,3,14,7,7
2020,237039,20,6,11,5,6
2020,237039,30,0,19,7,12
2020,237039,30,4,18,6,12
2020,237039,30,6,1,1,0
2020,237057,0,0,178,94,84
2020,237057,10,0,178,94,84
2020,237057,10,1,43,29,14
2020,237057,10,2,58,26,32
2020,237057,10,3,44,20,24
2020,237057,10,4,9,4,5
2020,237057,10,5,24,15,9
2020,237057,20,0,98,53,45
2020,237057,20,1,42,28,14
2020,237057,20,2,55,25,30
2020,237057,20,3,1,0,1
2020,237057,30,0,34,16,18
2020,237057,30,2,2,1,1
2020,237057,30,3,32,15,17
2020,237057,40,0,46,25,21
2020,237057,40,1,1,1,0
2020,237057,40,2,1,0,1
2020,237057,40,3,11,5,6
2020,237057,40,4,9,4,5
2020,237057,40,5,24,15,9
2020,237057,41,0,26,14,12
2020,237057,41,3,1,1,0
2020,237057,41,4,5,1,4
2020,237057,41,5,20,12,8
2020,237057,42,0,20,11,9
2020,237057,42,1,1,1,0
2020,237057,42,2,1,0,1
2020,237057,42,3,10,4,6
2020,237057,42,4,4,3,1
2020,237057,42,5,4,3,1
2020,237057,44,0,26,14,12
2020,237057,44,3,1,1,0
2020,237057,44,4,5,1,4
2020,237057,44,5,20,12,8
2020,237066,0,0,184,99,85
2020,237066,10,0,184,99,85
2020,237066,10,1,51,35,16
2020,237066,10,2,48,22,26
2020,237066,10,3,42,18,24
2020,237066,10,4,12,7,5
2020,237066,10,5,31,17,14
2020,237066,20,0,78,46,32
2020,237066,20,1,42,30,12
2020,237066,20,2,35,15,20
2020,237066,20,3,1,1,0
2020,237066,30,0,28,12,16
2020,237066,30,1,2,2,0
2020,237066,30,2,4,2,2
2020,237066,30,3,22,8,14
2020,237066,40,0,78,41,37
2020,237066,40,1,7,3,4
2020,237066,40,2,9,5,4
2020,237066,40,3,19,9,10
2020,237066,40,4,12,7,5
2020,237066,40,5,31,17,14
2020,237066,42,0,78,41,37
2020,237066,42,1,7,3,4
2020,237066,42,2,9,5,4
2020,237066,42,3,19,9,10
2020,237066,42,4,12,7,5
2020,237066,42,5,31,17,14
2020,237109,0,0,136,66,70
2020,237109,10,0,136,66,70
2020,237109,10,4,134,66,68
2020,237109,10,6,2,0,2
2020,237109,20,0,69,34,35
2020,237109,20,4,69,34,35
2020,237109,30,0,9,4,5
2020,237109,30,4,7,4,3
2020,237109,30,6,2,0,2
2020,237109,40,0,58,28,30
2020,237109,40,4,58,28,30
2020,237109,42,0,57,27,30
2020,237109,42,4,57,27,30
2020,237109,43,0,1,1,0
2020,237109,43,4,1,1,0
2020,237118,0,0,53,25,28
2020,237118,10,0,53,25,28
2020,237118,10,1,3,3,0
2020,237118,10,2,18,8,10
2020,237118,10,3,31,14,17
2020,237118,10,4,1,0,1
2020,237118,20,0,20,9,11
2020,237118,20,1,3,3,0
2020,237118,20,2,10,5,5
2020,237118,20,3,7,1,6
2020,237118,30,0,33,16,17
2020,237118,30,2,8,3,5
2020,237118,30,3,24,13,11
2020,237118,30,4,1,0,1
2020,237136,0,0,13,8,5
2020,237136,10,0,13,8,5
2020,237136,10,1,4,2,2
2020,237136,10,2,1,0,1
2020,237136,10,3,5,5,0
2020,237136,10,4,3,1,2
2020,237136,40,0,13,8,5
2020,237136,40,1,4,2,2
2020,237136,40,2,1,0,1
2020,237136,40,3,5,5,0
2020,237136,40,4,3,1,2
2020,237136,42,0,13,8,5
2020,237136,42,1,4,2,2
2020,237136,42,2,1,0,1
2020,237136,42,3,5,5,0
2020,237136,42,4,3,1,2
2020,237181,0,0,45,23,22
2020,237181,10,0,45,23,22
2020,237181,10,1,18,9,9
2020,237181,10,2,13,8,5
2020,237181,10,3,14,6,8
2020,237181,20,0,21,12,9
2020,237181,20,1,13,7,6
2020,237181,20,2,8,5,3
2020,237181,30,0,17,8,9
2020,237181,30,1,1,0,1
2020,237181,30,2,5,3,2
2020,237181,30,3,11,5,6
2020,237181,40,0,7,3,4
2020,237181,40,1,4,2,2
2020,237181,40,3,3,1,2
2020,237181,42,0,7,3,4
2020,237181,42,1,4,2,2
2020,237181,42,3,3,1,2
2020,237215,0,0,63,33,30
2020,237215,10,0,63,33,30
2020,237215,10,1,17,14,3
2020,237215,10,2,18,10,8
2020,237215,10,3,17,5,12
2020,237215,10,4,10,4,6
2020,237215,10,5,1,0,1
2020,237215,20,0,33,22,11
2020,237215,20,1,17,14,3
2020,237215,20,2,13,8,5
2020,237215,20,3,3,0,3
2020,237215,30,0,12,7,5
2020,237215,30,2,4,2,2
2020,237215,30,3,8,5,3
2020,237215,40,0,18,4,14
2020,237215,40,2,1,0,1
2020,237215,40,3,6,0,6
2020,237215,40,4,10,4,6
2020,237215,40,5,1,0,1
2020,237215,42,0,18,4,14
2020,237215,42,2,1,0,1
2020,237215,42,3,6,0,6
2020,237215,42,4,10,4,6
2020,237215,42,5,1,0,1
2020,237312,0,0,112,43,69
2020,237312,10,0,112,43,69
2020,237312,10,1,9,5,4
2020,237312,10,2,28,16,12
2020,237312,10,3,61,18,43
2020,237312,10,4,14,4,10
2020,237312,40,0,112,43,69
2020,237312,40,1,9,5,4
2020,237312,40,2,28,16,12
2020,237312,40,3,61,18,43
2020,237312,40,4,14,4,10
2020,237312,41,0,73,26,47
2020,237312,41,1,7,3,4
2020,237312,41,2,25,15,10
2020,237312,41,3,35,6,29
2020,237312,41,4,6,2,4
2020,237312,42,0,35,14,21
2020,237312,42,1,1,1,0
2020,237312,42,2,3,1,2
2020,237312,42,3,23,10,13
2020,237312,42,4,8,2,6
2020,237312,43,0,4,3,1
2020,237312,43,1,1,1,0
2020,237312,43,3,3,2,1
2020,237312,44,0,73,26,47
2020,237312,44,1,7,3,4
2020,237312,44,2,25,15,10
2020,237312,44,3,35,6,29
2020,237312,44,4,6,2,4
2020,237330,0,0,84,45,39
2020,237330,10,0,84,45,39
2020,237330,10,1,30,16,14
2020,237330,10,2,13,6,7
2020,237330,10,3,28,17,11
2020,237330,10,4,13,6,7
2020,237330,20,0,40,21,19
2020,237330,20,1,30,16,14
2020,237330,20,2,10,5,5
2020,237330,30,0,23,14,9
2020,237330,30,2,3,1,2
2020,237330,30,3,20,13,7
2020,237330,40,0,21,10,11
2020,237330,40,3,8,4,4
2020,237330,40,4,13,6,7
2020,237330,42,0,21,10,11
2020,237330,42,3,8,4,4
2020,237330,42,4,13,6,7
2020,237358,0,0,45,19,26
2020,237358,10,0,45,19,26
2020,237358,10,1,12,4,8
2020,237358,10,2,9,3,6
2020,237358,10,3,16,8,8
2020,237358,10,4,8,4,4
2020,237358,20,0,17,5,12
2020,237358,20,1,11,4,7
2020,237358,20,2,6,1,5
2020,237358,30,0,1,0,1
2020,237358,30,3,1,0,1
2020,237358,40,0,27,14,13
2020,237358,40,1,1,0,1
2020,237358,40,2,3,2,1
2020,237358,40,3,15,8,7
2020,237358,40,4,8,4,4
2020,237358,41,0,8,3,5
2020,237358,41,3,7,3,4
2020,237358,41,4,1,0,1
2020,237358,42,0,19,11,8
2020,237358,42,1,1,0,1
2020,237358,42,2,3,2,1
2020,237358,42,3,8,5,3
2020,237358,42,4,7,4,3
2020,237358,44,0,8,3,5
2020,237358,44,3,7,3,4
2020,237358,44,4,1,0,1
2020,237367,0,0,166,83,83
2020,237367,10,0,149,76,73
2020,237367,10,1,42,24,18
2020,237367,10,2,34,19,15
2020,237367,10,3,65,29,36
2020,237367,10,4,8,4,4
2020,237367,20,0,78,41,37
2020,237367,20,1,41,23,18
2020,237367,20,2,28,14,14
2020,237367,20,3,9,4,5
2020,237367,30,0,39,18,21
2020,237367,30,2,5,4,1
2020,237367,30,3,34,14,20
2020,237367,40,0,32,17,15
2020,237367,40,1,1,1,0
2020,237367,40,2,1,1,0
2020,237367,40,3,22,11,11
2020,237367,40,4,8,4,4
2020,237367,42,0,32,17,15
2020,237367,42,1,1,1,0
2020,237367,42,2,1,1,0
2020,237367,42,3,22,11,11
2020,237367,42,4,8,4,4
2020,237367,50,0,17,7,10
2020,237385,0,0,59,37,22
2020,237385,10,0,59,37,22
2020,237385,10,1,9,8,1
2020,237385,10,2,21,13,8
2020,237385,10,3,20,13,7
2020,237385,10,5,9,3,6
2020,237385,20,0,30,21,9
2020,237385,20,1,9,8,1
2020,237385,20,2,21,13,8
2020,237385,30,0,20,13,7
2020,237385,30,3,20,13,7
2020,237385,40,0,9,3,6
2020,237385,40,5,9,3,6
2020,237385,42,0,9,3,6
2020,237385,42,5,9,3,6
2020,237437,0,0,15,3,12
2020,237437,50,0,15,3,12
2020,237525,0,0,820,464,356
2020,237525,10,0,820,464,356
2020,237525,10,1,240,155,85
2020,237525,10,2,218,130,88
2020,237525,10,3,301,161,140
2020,237525,10,4,61,18,43
2020,237525,20,0,397,237,160
2020,237525,20,1,229,146,83
2020,237525,20,2,166,91,75
2020,237525,20,3,2,0,2
2020,237525,30,0,161,85,76
2020,237525,30,1,3,3,0
2020,237525,30,2,14,7,7
2020,237525,30,3,144,75,69
2020,237525,40,0,262,142,120
2020,237525,40,1,8,6,2
2020,237525,40,2,38,32,6
2020,237525,40,3,155,86,69
2020,237525,40,4,61,18,43
2020,237525,41,0,52,24,28
2020,237525,41,1,1,0,1
2020,237525,41,3,15,12,3
2020,237525,41,4,36,12,24
2020,237525,42,0,210,118,92
2020,237525,42,1,7,6,1
2020,237525,42,2,38,32,6
2020,237525,42,3,140,74,66
2020,237525,42,4,25,6,19
2020,237525,44,0,52,24,28
2020,237525,44,1,1,0,1
2020,237525,44,3,15,12,3
2020,237525,44,4,36,12,24
2020,237640,0,0,17,7,10
2020,237640,10,0,17,7,10
2020,237640,10,1,3,2,1
2020,237640,10,3,14,5,9
2020,237640,40,0,17,7,10
2020,237640,40,1,3,2,1
2020,237640,40,3,14,5,9
2020,237640,42,0,17,7,10
2020,237640,42,1,3,2,1
2020,237640,42,3,14,5,9
2020,237686,0,0,73,33,40
2020,237686,10,0,73,33,40
2020,237686,10,1,17,11,6
2020,237686,10,2,18,7,11
2020,237686,10,3,19,12,7
2020,237686,10,4,19,3,16
2020,237686,40,0,73,33,40
2020,237686,40,1,17,11,6
2020,237686,40,2,18,7,11
2020,237686,40,3,19,12,7
2020,237686,40,4,19,3,16
2020,237686,41,0,29,15,14
2020,237686,41,1,16,11,5
2020,237686,41,2,11,3,8
2020,237686,41,3,2,1,1
2020,237686,42,0,44,18,26
2020,237686,42,1,1,0,1
2020,237686,42,2,7,4,3
2020,237686,42,3,17,11,6
2020,237686,42,4,19,3,16
2020,237686,44,0,18,8,10
2020,237686,44,1,5,4,1
2020,237686,44,2,11,3,8
2020,237686,44,3,2,1,1
2020,237686,45,0,11,7,4
2020,237686,45,1,11,7,4
2020,237701,0,0,53,21,32
2020,237701,10,0,53,21,32
2020,237701,10,1,10,6,4
2020,237701,10,2,9,4,5
2020,237701,10,3,8,4,4
2020,237701,10,4,25,6,19
2020,237701,10,6,1,1,0
2020,237701,20,0,20,11,9
2020,237701,20,1,10,6,4
2020,237701,20,2,7,3,4
2020,237701,20,3,2,1,1
2020,237701,20,6,1,1,0
2020,237701,30,0,22,7,15
2020,237701,30,3,6,3,3
2020,237701,30,4,16,4,12
2020,237701,40,0,11,3,8
2020,237701,40,2,2,1,1
2020,237701,40,4,9,2,7
2020,237701,42,0,11,3,8
2020,237701,42,2,2,1,1
2020,237701,42,4,9,2,7
2020,237783,0,0,26,14,12
2020,237783,10,0,26,14,12
2020,237783,10,1,14,9,5
2020,237783,10,2,8,3,5
2020,237783,10,3,4,2,2
2020,237783,40,0,26,14,12
2020,237783,40,1,14,9,5
2020,237783,40,2,8,3,5
2020,237783,40,3,4,2,2
2020,237783,41,0,26,14,12
2020,237783,41,1,14,9,5
2020,237783,41,2,8,3,5
2020,237783,41,3,4,2,2
2020,237783,45,0,26,14,12
2020,237783,45,1,14,9,5
2020,237783,45,2,8,3,5
2020,237783,45,3,4,2,2
2020,237792,0,0,141,68,73
2020,237792,10,0,141,68,73
2020,237792,10,1,31,18,13
2020,237792,10,2,53,24,29
2020,237792,10,3,39,19,20
2020,237792,10,5,18,7,11
2020,237792,20,0,83,41,42
2020,237792,20,1,31,18,13
2020,237792,20,2,52,23,29
2020,237792,30,0,40,20,20
2020,237792,30,2,1,1,0
2020,237792,30,3,39,19,20
2020,237792,40,0,18,7,11
2020,237792,40,5,18,7,11
2020,237792,41,0,6,1,5
2020,237792,41,5,6,1,5
2020,237792,42,0,12,6,6
2020,237792,42,5,12,6,6
2020,237792,44,0,6,1,5
2020,237792,44,5,6,1,5
2020,237817,0,0,60,21,39
2020,237817,10,0,60,21,39
2020,237817,10,1,13,3,10
2020,237817,10,2,8,1,7
2020,237817,10,3,12,6,6
2020,237817,10,4,24,10,14
2020,237817,10,5,3,1,2
2020,237817,20,0,3,0,3
2020,237817,20,1,2,0,2
2020,237817,20,3,1,0,1
2020,237817,40,0,57,21,36
2020,237817,40,1,11,3,8
2020,237817,40,2,8,1,7
2020,237817,40,3,11,6,5
2020,237817,40,4,24,10,14
2020,237817,40,5,3,1,2
2020,237817,42,0,57,21,36
2020,237817,42,1,11,3,8
2020,237817,42,2,8,1,7
2020,237817,42,3,11,6,5
2020,237817,42,4,24,10,14
2020,237817,42,5,3,1,2
2020,237880,0,0,61,28,33
2020,237880,10,0,61,28,33
2020,237880,10,1,15,9,6
2020,237880,10,2,26,10,16
2020,237880,10,3,19,9,10
2020,237880,10,4,1,0,1
2020,237880,20,0,32,14,18
2020,237880,20,1,13,7,6
2020,237880,20,2,19,7,12
2020,237880,30,0,20,9,11
2020,237880,30,2,4,2,2
2020,237880,30,3,15,7,8
2020,237880,30,4,1,0,1
2020,237880,40,0,9,5,4
2020,237880,40,1,2,2,0
2020,237880,40,2,3,1,2
2020,237880,40,3,4,2,2
2020,237880,41,0,9,5,4
2020,237880,41,1,2,2,0
2020,237880,41,2,3,1,2
2020,237880,41,3,4,2,2
2020,237880,45,0,9,5,4
2020,237880,45,1,2,2,0
2020,237880,45,2,3,1,2
2020,237880,45,3,4,2,2
2020,237899,0,0,100,58,42
2020,237899,10,0,100,58,42
2020,237899,10,1,31,19,12
2020,237899,10,2,24,15,9
2020,237899,10,3,29,18,11
2020,237899,10,4,16,6,10
2020,237899,20,0,30,13,17
2020,237899,20,1,18,8,10
2020,237899,20,2,9,4,5
2020,237899,20,3,3,1,2
2020,237899,30,0,24,17,7
2020,237899,30,1,9,7,2
2020,237899,30,2,8,6,2
2020,237899,30,3,7,4,3
2020,237899,40,0,46,28,18
2020,237899,40,1,4,4,0
2020,237899,40,2,7,5,2
2020,237899,40,3,19,13,6
2020,237899,40,4,16,6,10
2020,237899,42,0,46,28,18
2020,237899,42,1,4,4,0
2020,237899,42,2,7,5,2
2020,237899,42,3,19,13,6
2020,237899,42,4,16,6,10
2020,237932,0,0,148,74,74
2020,237932,10,0,148,74,74
2020,237932,10,1,37,23,14
2020,237932,10,2,36,18,18
2020,237932,10,3,43,19,24
2020,237932,10,4,30,13,17
2020,237932,10,5,2,1,1
2020,237932,20,0,62,36,26
2020,237932,20,1,37,23,14
2020,237932,20,2,23,12,11
2020,237932,20,3,2,1,1
2020,237932,30,0,32,15,17
2020,237932,30,2,10,5,5
2020,237932,30,3,22,10,12
2020,237932,40,0,54,23,31
2020,237932,40,2,3,1,2
2020,237932,40,3,19,8,11
2020,237932,40,4,30,13,17
2020,237932,40,5,2,1,1
2020,237932,42,0,54,23,31
2020,237932,42,2,3,1,2
2020,237932,42,3,19,8,11
2020,237932,42,4,30,13,17
2020,237932,42,5,2,1,1
2020,237950,0,0,88,52,36
2020,237950,10,0,88,52,36
2020,237950,10,1,11,8,3
2020,237950,10,2,23,14,9
2020,237950,10,3,46,30,16
2020,237950,10,4,8,0,8
2020,237950,20,0,33,20,13
2020,237950,20,1,11,8,3
2020,237950,20,2,21,12,9
2020,237950,20,3,1,0,1
2020,237950,30,0,34,26,8
2020,237950,30,2,2,2,0
2020,237950,30,3,32,24,8
2020,237950,40,0,21,6,15
2020,237950,40,3,13,6,7
2020,237950,40,4,8,0,8
2020,237950,42,0,21,6,15
2020,237950,42,3,13,6,7
2020,237950,42,4,8,0,8
2020,237969,0,0,65,30,35
2020,237969,10,0,65,30,35
2020,237969,10,1,8,5,3
2020,237969,10,2,26,7,19
2020,237969,10,3,31,18,13
2020,237969,20,0,40,16,24
2020,237969,20,1,8,5,3
2020,237969,20,2,26,7,19
2020,237969,20,3,6,4,2
2020,237969,30,0,16,9,7
2020,237969,30,3,16,9,7
2020,237969,40,0,9,5,4
2020,237969,40,3,9,5,4
2020,237969,42,0,9,5,4
2020,237969,42,3,9,5,4
2020,237987,0,0,6,2,4
2020,237987,50,0,6,2,4
2020,237996,0,0,13,4,9
2020,237996,50,0,13,4,9
2020,238014,0,0,54,23,31
2020,238014,10,0,54,23,31
2020,238014,10,1,8,4,4
2020,238014,10,2,4,1,3
2020,238014,10,3,14,7,7
2020,238014,10,4,28,11,17
2020,238014,20,0,4,1,3
2020,238014,20,1,4,1,3
2020,238014,40,0,50,22,28
2020,238014,40,1,4,3,1
2020,238014,40,2,4,1,3
2020,238014,40,3,14,7,7
2020,238014,40,4,28,11,17
2020,238014,42,0,50,22,28
2020,238014,42,1,4,3,1
2020,238014,42,2,4,1,3
2020,238014,42,3,14,7,7
2020,238014,42,4,28,11,17
2020,238032,0,0,1348,739,609
2020,238032,10,0,1348,739,609
2020,238032,10,1,415,289,126
2020,238032,10,2,424,221,203
2020,238032,10,3,393,190,203
2020,238032,10,4,62,19,43
2020,238032,10,5,2,1,1
2020,238032,10,6,52,19,33
2020,238032,20,0,658,430,228
2020,238032,20,1,366,260,106
2020,238032,20,2,288,167,121
2020,238032,20,3,1,0,1
2020,238032,20,6,3,3,0
2020,238032,30,0,243,143,100
2020,238032,30,1,11,9,2
2020,238032,30,2,28,16,12
2020,238032,30,3,200,114,86
2020,238032,30,6,4,4,0
2020,238032,40,0,447,166,281
2020,238032,40,1,38,20,18
2020,238032,40,2,108,38,70
2020,238032,40,3,192,76,116
2020,238032,40,4,62,19,43
2020,238032,40,5,2,1,1
2020,238032,40,6,45,12,33
2020,238032,42,0,447,166,281
2020,238032,42,1,38,20,18
2020,238032,42,2,108,38,70
2020,238032,42,3,192,76,116
2020,238032,42,4,62,19,43
2020,238032,42,5,2,1,1
2020,238032,42,6,45,12,33
2020,238078,0,0,26,10,16
2020,238078,10,0,26,10,16
2020,238078,10,1,6,5,1
2020,238078,10,2,8,2,6
2020,238078,10,3,9,3,6
2020,238078,10,4,3,0,3
2020,238078,20,0,12,6,6
2020,238078,20,1,5,4,1
2020,238078,20,2,4,1,3
2020,238078,20,3,3,1,2
2020,238078,30,0,9,2,7
2020,238078,30,2,4,1,3
2020,238078,30,3,4,1,3
2020,238078,30,4,1,0,1
2020,238078,40,0,5,2,3
2020,238078,40,1,1,1,0
2020,238078,40,3,2,1,1
2020,238078,40,4,2,0,2
2020,238078,41,0,5,2,3
2020,238078,41,1,1,1,0
2020,238078,41,3,2,1,1
2020,238078,41,4,2,0,2
2020,238078,44,0,5,2,3
2020,238078,44,1,1,1,0
2020,238078,44,3,2,1,1
2020,238078,44,4,2,0,2
2020,238193,0,0,92,17,75
2020,238193,10,0,92,17,75
2020,238193,10,1,26,8,18
2020,238193,10,2,24,3,21
2020,238193,10,3,42,6,36
2020,238193,20,0,36,11,25
2020,238193,20,1,25,8,17
2020,238193,20,2,10,2,8
2020,238193,20,3,1,1,0
2020,238193,30,0,40,6,34
2020,238193,30,1,1,0,1
2020,238193,30,2,11,1,10
2020,238193,30,3,28,5,23
2020,238193,40,0,16,0,16
2020,238193,40,2,3,0,3
2020,238193,40,3,13,0,13
2020,238193,42,0,16,0,16
2020,238193,42,2,3,0,3
2020,238193,42,3,13,0,13
2020,238263,0,0,434,196,238
2020,238263,10,0,434,196,238
2020,238263,10,4,434,196,238
2020,238263,40,0,434,196,238
2020,238263,40,4,434,196,238
2020,238263,42,0,434,196,238
2020,238263,42,4,434,196,238
2020,238324,0,0,18,1,17
2020,238324,10,0,18,1,17
2020,238324,10,3,11,1,10
2020,238324,10,4,7,0,7
2020,238324,40,0,18,1,17
2020,238324,40,3,11,1,10
2020,238324,40,4,7,0,7
2020,238324,42,0,18,1,17
2020,238324,42,3,11,1,10
2020,238324,42,4,7,0,7
2020,238333,0,0,87,39,48
2020,238333,10,0,87,39,48
2020,238333,10,1,33,17,16
2020,238333,10,2,30,10,20
2020,238333,10,3,21,10,11
2020,238333,10,6,3,2,1
2020,238333,20,0,59,26,33
2020,238333,20,1,33,17,16
2020,238333,20,2,26,9,17
2020,238333,30,0,16,10,6
2020,238333,30,2,1,1,0
2020,238333,30,3,15,9,6
2020,238333,40,0,12,3,9
2020,238333,40,2,3,0,3
2020,238333,40,3,6,1,5
2020,238333,40,6,3,2,1
2020,238333,41,0,8,1,7
2020,238333,41,2,3,0,3
2020,238333,41,3,3,0,3
2020,238333,41,6,2,1,1
2020,238333,42,0,4,2,2
2020,238333,42,3,3,1,2
2020,238333,42,6,1,1,0
2020,238333,44,0,8,1,7
2020,238333,44,2,3,0,3
2020,238333,44,3,3,0,3
2020,238333,44,6,2,1,1
2020,238397,0,0,75,34,41
2020,238397,10,0,75,34,41
2020,238397,10,4,75,34,41
2020,238397,40,0,75,34,41
2020,238397,40,4,75,34,41
2020,238397,42,0,75,34,41
2020,238397,42,4,75,34,41
2020,238430,0,0,60,22,38
2020,238430,10,0,60,22,38
2020,238430,10,1,7,4,3
2020,238430,10,2,20,9,11
2020,238430,10,3,33,9,24
2020,238430,20,0,32,17,15
2020,238430,20,1,7,4,3
2020,238430,20,2,19,9,10
2020,238430,20,3,6,4,2
2020,238430,30,0,5,1,4
2020,238430,30,2,1,0,1
2020,238430,30,3,4,1,3
2020,238430,40,0,23,4,19
2020,238430,40,3,23,4,19
2020,238430,42,0,23,4,19
2020,238430,42,3,23,4,19
2020,238458,0,0,142,47,95
2020,238458,10,0,142,47,95
2020,238458,10,1,18,8,10
2020,238458,10,2,39,15,24
2020,238458,10,3,42,10,32
2020,238458,10,5,43,14,29
2020,238458,20,0,43,19,24
2020,238458,20,1,16,6,10
2020,238458,20,2,27,13,14
2020,238458,30,0,20,7,13
2020,238458,30,2,2,0,2
2020,238458,30,3,18,7,11
2020,238458,40,0,79,21,58
2020,238458,40,1,2,2,0
2020,238458,40,2,10,2,8
2020,238458,40,3,24,3,21
2020,238458,40,5,43,14,29
2020,238458,41,0,68,19,49
2020,238458,41,1,2,2,0
2020,238458,41,2,10,2,8
2020,238458,41,3,20,3,17
2020,238458,41,5,36,12,24
2020,238458,42,0,11,2,9
2020,238458,42,3,4,0,4
2020,238458,42,5,7,2,5
2020,238458,44,0,68,19,49
2020,238458,44,1,2,2,0
2020,238458,44,2,10,2,8
2020,238458,44,3,20,3,17
2020,238458,44,5,36,12,24
2020,238476,0,0,152,85,67
2020,238476,10,0,152,85,67
2020,238476,10,1,43,31,12
2020,238476,10,2,52,27,25
2020,238476,10,3,54,25,29
2020,238476,10,4,1,0,1
2020,238476,10,5,2,2,0
2020,238476,20,0,81,53,28
2020,238476,20,1,39,30,9
2020,238476,20,2,41,23,18
2020,238476,20,3,1,0,1
2020,238476,30,0,25,7,18
2020,238476,30,1,1,0,1
2020,238476,30,2,2,1,1
2020,238476,30,3,22,6,16
2020,238476,40,0,46,25,21
2020,238476,40,1,3,1,2
2020,238476,40,2,9,3,6
2020,238476,40,3,31,19,12
2020,238476,40,4,1,0,1
2020,238476,40,5,2,2,0
2020,238476,41,0,43,24,19
2020,238476,41,1,2,1,1
2020,238476,41,2,9,3,6
2020,238476,41,3,30,18,12
2020,238476,41,5,2,2,0
2020,238476,42,0,3,1,2
2020,238476,42,1,1,0,1
2020,238476,42,3,1,1,0
2020,238476,42,4,1,0,1
2020,238476,44,0,43,24,19
2020,238476,44,1,2,1,1
2020,238476,44,2,9,3,6
2020,238476,44,3,30,18,12
2020,238476,44,5,2,2,0
2020,238616,0,0,224,108,116
2020,238616,10,0,224,108,116
2020,238616,10,1,62,43,19
2020,238616,10,2,71,35,36
2020,238616,10,3,86,30,56
2020,238616,10,4,5,0,5
2020,238616,40,0,224,108,116
2020,238616,40,1,62,43,19
2020,238616,40,2,71,35,36
2020,238616,40,3,86,30,56
2020,238616,40,4,5,0,5
2020,238616,41,0,194,97,97
2020,238616,41,1,62,43,19
2020,238616,41,2,71,35,36
2020,238616,41,3,60,19,41
2020,238616,41,4,1,0,1
2020,238616,42,0,27,9,18
2020,238616,42,3,23,9,14
2020,238616,42,4,4,0,4
2020,238616,43,0,3,2,1
2020,238616,43,3,3,2,1
2020,238616,44,0,194,97,97
2020,238616,44,1,62,43,19
2020,238616,44,2,71,35,36
2020,238616,44,3,60,19,41
2020,238616,44,4,1,0,1
2020,238661,0,0,104,38,66
2020,238661,10,0,104,38,66
2020,238661,10,1,16,9,7
2020,238661,10,2,34,12,22
2020,238661,10,3,15,4,11
2020,238661,10,4,4,0,4
2020,238661,10,5,35,13,22
2020,238661,20,0,43,18,25
2020,238661,20,1,16,9,7
2020,238661,20,2,27,9,18
2020,238661,30,0,18,6,12
2020,238661,30,2,7,3,4
2020,238661,30,3,11,3,8
2020,238661,40,0,43,14,29
2020,238661,40,3,4,1,3
2020,238661,40,4,4,0,4
2020,238661,40,5,35,13,22
2020,238661,42,0,40,14,26
2020,238661,42,3,4,1,3
2020,238661,42,4,2,0,2
2020,238661,42,5,34,13,21
2020,238661,43,0,3,0,3
2020,238661,43,4,2,0,2
2020,238661,43,5,1,0,1
2020,238722,0,0,304,167,137
2020,238722,10,0,304,167,137
2020,238722,10,6,304,167,137
2020,238722,40,0,304,167,137
2020,238722,40,6,304,167,137
2020,238722,41,0,304,167,137
2020,238722,41,6,304,167,137
2020,238722,44,0,304,167,137
2020,238722,44,6,304,167,137
2020,238759,0,0,222,100,122
2020,238759,10,0,222,100,122
2020,238759,10,6,222,100,122
2020,238759,40,0,222,100,122
2020,238759,40,6,222,100,122
2020,238759,42,0,222,100,122
2020,238759,42,6,222,100,122
2020,238980,0,0,42,22,20
2020,238980,10,0,42,22,20
2020,238980,10,1,11,8,3
2020,238980,10,2,12,7,5
2020,238980,10,3,9,4,5
2020,238980,10,4,10,3,7
2020,238980,20,0,19,12,7
2020,238980,20,1,11,8,3
2020,238980,20,2,8,4,4
2020,238980,30,0,8,5,3
2020,238980,30,2,2,2,0
2020,238980,30,3,6,3,3
2020,238980,40,0,15,5,10
2020,238980,40,2,2,1,1
2020,238980,40,3,3,1,2
2020,238980,40,4,10,3,7
2020,238980,42,0,15,5,10
2020,238980,42,2,2,1,1
2020,238980,42,3,3,1,2
2020,238980,42,4,10,3,7
2020,239008,0,0,104,48,56
2020,239008,10,0,104,48,56
2020,239008,10,4,104,48,56
2020,239008,40,0,104,48,56
2020,239008,40,4,104,48,56
2020,239008,42,0,104,48,56
2020,239008,42,4,104,48,56
2020,239017,0,0,169,87,82
2020,239017,10,0,169,87,82
2020,239017,10,1,37,27,10
2020,239017,10,2,70,37,33
2020,239017,10,3,45,17,28
2020,239017,10,4,16,5,11
2020,239017,10,5,1,1,0
2020,239017,20,0,104,63,41
2020,239017,20,1,37,27,10
2020,239017,20,2,67,36,31
2020,239017,30,0,32,11,21
2020,239017,30,2,3,1,2
2020,239017,30,3,29,10,19
2020,239017,40,0,33,13,20
2020,239017,40,3,16,7,9
2020,239017,40,4,16,5,11
2020,239017,40,5,1,1,0
2020,239017,41,0,24,9,15
2020,239017,41,3,12,5,7
2020,239017,41,4,12,4,8
2020,239017,42,0,8,4,4
2020,239017,42,3,4,2,2
2020,239017,42,4,3,1,2
2020,239017,42,5,1,1,0
2020,239017,43,0,1,0,1
2020,239017,43,4,1,0,1
2020,239017,44,0,22,9,13
2020,239017,44,3,11,5,6
2020,239017,44,4,11,4,7
2020,239017,45,0,2,0,2
2020,239017,45,3,1,0,1
2020,239017,45,4,1,0,1
2020,239071,0,0,34,22,12
2020,239071,10,0,34,22,12
2020,239071,10,1,11,9,2
2020,239071,10,2,19,11,8
2020,239071,10,3,4,2,2
2020,239071,40,0,34,22,12
2020,239071,40,1,11,9,2
2020,239071,40,2,19,11,8
2020,239071,40,3,4,2,2
2020,239071,42,0,34,22,12
2020,239071,42,1,11,9,2
2020,239071,42,2,19,11,8
2020,239071,42,3,4,2,2
2020,239080,0,0,60,22,38
2020,239080,10,0,57,20,37
2020,239080,10,1,7,4,3
2020,239080,10,2,20,8,12
2020,239080,10,3,27,6,21
2020,239080,10,4,3,2,1
2020,239080,20,0,14,10,4
2020,239080,20,1,5,4,1
2020,239080,20,2,9,6,3
2020,239080,30,0,22,7,15
2020,239080,30,1,1,0,1
2020,239080,30,2,6,2,4
2020,239080,30,3,15,5,10
2020,239080,40,0,21,3,18
2020,239080,40,1,1,0,1
2020,239080,40,2,5,0,5
2020,239080,40,3,12,1,11
2020,239080,40,4,3,2,1
2020,239080,42,0,21,3,18
2020,239080,42,1,1,0,1
2020,239080,42,2,5,0,5
2020,239080,42,3,12,1,11
2020,239080,42,4,3,2,1
2020,239080,50,0,3,2,1
2020,239105,0,0,716,386,330
2020,239105,10,0,716,386,330
2020,239105,10,1,156,104,52
2020,239105,10,2,219,108,111
2020,239105,10,3,232,120,112
2020,239105,10,4,53,20,33
2020,239105,10,5,1,1,0
2020,239105,10,6,55,33,22
2020,239105,20,0,304,183,121
2020,239105,20,1,134,93,41
2020,239105,20,2,170,90,80
2020,239105,30,0,156,87,69
2020,239105,30,2,4,3,1
2020,239105,30,3,152,84,68
2020,239105,40,0,256,116,140
2020,239105,40,1,22,11,11
2020,239105,40,2,45,15,30
2020,239105,40,3,80,36,44
2020,239105,40,4,53,20,33
2020,239105,40,5,1,1,0
2020,239105,40,6,55,33,22
2020,239105,42,0,256,116,140
2020,239105,42,1,22,11,11
2020,239105,42,2,45,15,30
2020,239105,42,3,80,36,44
2020,239105,42,4,53,20,33
2020,239105,42,5,1,1,0
2020,239105,42,6,55,33,22
2020,239169,0,0,1719,1013,706
2020,239169,10,0,1719,1013,706
2020,239169,10,1,412,296,116
2020,239169,10,2,374,221,153
2020,239169,10,3,816,430,386
2020,239169,10,4,103,59,44
2020,239169,10,6,14,7,7
2020,239169,20,0,162,120,42
2020,239169,20,1,159,118,41
2020,239169,20,2,3,2,1
2020,239169,30,0,1011,597,414
2020,239169,30,1,226,158,68
2020,239169,30,2,310,181,129
2020,239169,30,3,475,258,217
2020,239169,40,0,546,296,250
2020,239169,40,1,27,20,7
2020,239169,40,2,61,38,23
2020,239169,40,3,341,172,169
2020,239169,40,4,103,59,44
2020,239169,40,6,14,7,7
2020,239169,41,0,429,230,199
2020,239169,41,1,27,20,7
2020,239169,41,2,61,38,23
2020,239169,41,3,341,172,169
2020,239169,42,0,117,66,51
2020,239169,42,4,103,59,44
2020,239169,42,6,14,7,7
2020,239169,44,0,429,230,199
2020,239169,44,1,27,20,7
2020,239169,44,2,61,38,23
2020,239169,44,3,341,172,169
2020,239220,0,0,80,38,42
2020,239220,10,0,80,38,42
2020,239220,10,4,80,38,42
2020,239220,40,0,80,38,42
2020,239220,40,4,80,38,42
2020,239220,43,0,80,38,42
2020,239220,43,4,80,38,42
2020,239248,0,0,504,239,265
2020,239248,10,0,449,227,222
2020,239248,10,4,449,227,222
2020,239248,40,0,449,227,222
2020,239248,40,4,449,227,222
2020,239248,42,0,449,227,222
2020,239248,42,4,449,227,222
2020,239248,50,0,55,12,43
2020,239309,0,0,59,31,28
2020,239309,10,0,57,30,27
2020,239309,10,1,22,13,9
2020,239309,10,2,12,8,4
2020,239309,10,3,3,2,1
2020,239309,10,4,16,7,9
2020,239309,10,6,4,0,4
2020,239309,40,0,57,30,27
2020,239309,40,1,22,13,9
2020,239309,40,2,12,8,4
2020,239309,40,3,3,2,1
2020,239309,40,4,16,7,9
2020,239309,40,6,4,0,4
2020,239309,41,0,7,3,4
2020,239309,41,1,3,1,2
2020,239309,41,2,4,2,2
2020,239309,42,0,50,27,23
2020,239309,42,1,19,12,7
2020,239309,42,2,8,6,2
2020,239309,42,3,3,2,1
2020,239309,42,4,16,7,9
2020,239309,42,6,4,0,4
2020,239309,44,0,7,3,4
2020,239309,44,1,3,1,2
2020,239309,44,2,4,2,2
2020,239309,50,0,2,1,1
2020,239318,0,0,160,103,57
2020,239318,10,0,160,103,57
2020,239318,10,1,40,27,13
2020,239318,10,2,45,32,13
2020,239318,10,3,54,33,21
2020,239318,10,4,21,11,10
2020,239318,40,0,160,103,57
2020,239318,40,1,40,27,13
2020,239318,40,2,45,32,13
2020,239318,40,3,54,33,21
2020,239318,40,4,21,11,10
2020,239318,41,0,139,92,47
2020,239318,41,1,40,27,13
2020,239318,41,2,45,32,13
2020,239318,41,3,54,33,21
2020,239318,42,0,21,11,10
2020,239318,42,4,21,11,10
2020,239318,44,0,139,92,47
2020,239318,44,1,40,27,13
2020,239318,44,2,45,32,13
2020,239318,44,3,54,33,21
2020,239372,0,0,143,66,77
2020,239372,10,0,143,66,77
2020,239372,10,4,143,66,77
2020,239372,40,0,143,66,77
2020,239372,40,4,143,66,77
2020,239372,42,0,143,66,77
2020,239372,42,4,143,66,77
2020,239390,0,0,63,7,56
2020,239390,10,0,63,7,56
2020,239390,10,1,9,2,7
2020,239390,10,2,18,1,17
2020,239390,10,3,30,3,27
2020,239390,10,4,5,1,4
2020,239390,10,6,1,0,1
2020,239390,20,0,29,5,24
2020,239390,20,1,8,2,6
2020,239390,20,2,16,1,15
2020,239390,20,3,5,2,3
2020,239390,30,0,18,1,17
2020,239390,30,1,1,0,1
2020,239390,30,2,2,0,2
2020,239390,30,3,15,1,14
2020,239390,40,0,16,1,15
2020,239390,40,3,10,0,10
2020,239390,40,4,5,1,4
2020,239390,40,6,1,0,1
2020,239390,42,0,16,1,15
2020,239390,42,3,10,0,10
2020,239390,42,4,5,1,4
2020,239390,42,6,1,0,1
2020,239424,0,0,8,7,1
2020,239424,10,0,8,7,1
2020,239424,10,1,2,2,0
2020,239424,10,2,1,1,0
2020,239424,10,3,4,3,1
2020,239424,10,4,1,1,0
2020,239424,20,0,2,2,0
2020,239424,20,1,2,2,0
2020,239424,30,0,5,4,1
2020,239424,30,2,1,1,0
2020,239424,30,3,4,3,1
2020,239424,40,0,1,1,0
2020,239424,40,4,1,1,0
2020,239424,41,0,1,1,0
2020,239424,41,4,1,1,0
2020,239424,44,0,1,1,0
2020,239424,44,4,1,1,0
2020,239442,0,0,50,26,24
2020,239442,10,0,50,26,24
2020,239442,10,4,50,26,24
2020,239442,40,0,50,26,24
2020,239442,40,4,50,26,24
2020,239442,42,0,50,26,24
2020,239442,42,4,50,26,24
2020,239460,0,0,137,67,70
2020,239460,10,0,137,67,70
2020,239460,10,4,137,67,70
2020,239460,40,0,137,67,70
2020,239460,40,4,137,67,70
2020,239460,42,0,134,67,67
2020,239460,42,4,134,67,67
2020,239460,43,0,3,0,3
2020,239460,43,4,3,0,3
2020,239488,0,0,258,127,131
2020,239488,10,0,258,127,131
2020,239488,10,6,258,127,131
2020,239488,40,0,258,127,131
2020,239488,40,6,258,127,131
2020,239488,42,0,258,127,131
2020,239488,42,6,258,127,131
2020,239512,0,0,47,25,22
2020,239512,10,0,47,25,22
2020,239512,10,1,13,9,4
2020,239512,10,2,9,5,4
2020,239512,10,3,22,11,11
2020,239512,10,4,3,0,3
2020,239512,20,0,22,14,8
2020,239512,20,1,13,9,4
2020,239512,20,2,9,5,4
2020,239512,30,0,19,9,10
2020,239512,30,3,19,9,10
2020,239512,40,0,6,2,4
2020,239512,40,3,3,2,1
2020,239512,40,4,3,0,3
2020,239512,41,0,6,2,4
2020,239512,41,3,3,2,1
2020,239512,41,4,3,0,3
2020,239512,45,0,6,2,4
2020,239512,45,3,3,2,1
2020,239512,45,4,3,0,3
2020,239628,0,0,52,29,23
2020,239628,10,0,52,29,23
2020,239628,10,1,18,9,9
2020,239628,10,2,22,14,8
2020,239628,10,3,9,5,4
2020,239628,10,4,3,1,2
2020,239628,20,0,38,21,17
2020,239628,20,1,18,9,9
2020,239628,20,2,20,12,8
2020,239628,30,0,12,8,4
2020,239628,30,2,2,2,0
2020,239628,30,3,9,5,4
2020,239628,30,4,1,1,0
2020,239628,40,0,2,0,2
2020,239628,40,4,2,0,2
2020,239628,42,0,2,0,2
2020,239628,42,4,2,0,2
2020,239637,0,0,9,9,0
2020,239637,10,0,9,9,0
2020,239637,10,1,2,2,0
2020,239637,10,2,2,2,0
2020,239637,10,3,4,4,0
2020,239637,10,4,1,1,0
2020,239637,40,0,9,9,0
2020,239637,40,1,2,2,0
2020,239637,40,2,2,2,0
2020,239637,40,3,4,4,0
2020,239637,40,4,1,1,0
2020,239637,41,0,7,7,0
2020,239637,41,1,2,2,0
2020,239637,41,2,2,2,0
2020,239637,41,3,2,2,0
2020,239637,41,4,1,1,0
2020,239637,42,0,2,2,0
2020,239637,42,3,2,2,0
2020,239637,44,0,7,7,0
2020,239637,44,1,2,2,0
2020,239637,44,2,2,2,0
2020,239637,44,3,2,2,0
2020,239637,44,4,1,1,0
2020,239716,0,0,131,68,63
2020,239716,10,0,129,68,61
2020,239716,10,1,27,19,8
2020,239716,10,2,43,20,23
2020,239716,10,3,55,27,28
2020,239716,10,4,4,2,2
2020,239716,20,0,79,42,37
2020,239716,20,1,26,18,8
2020,239716,20,2,41,19,22
2020,239716,20,3,12,5,7
2020,239716,30,0,40,20,20
2020,239716,30,2,2,1,1
2020,239716,30,3,38,19,19
2020,239716,40,0,10,6,4
2020,239716,40,1,1,1,0
2020,239716,40,3,5,3,2
2020,239716,40,4,4,2,2
2020,239716,42,0,10,6,4
2020,239716,42,1,1,1,0
2020,239716,42,3,5,3,2
2020,239716,42,4,4,2,2
2020,239716,50,0,2,0,2
2020,239910,0,0,75,35,40
2020,239910,10,0,75,35,40
2020,239910,10,4,75,35,40
2020,239910,40,0,75,35,40
2020,239910,40,4,75,35,40
2020,239910,42,0,75,35,40
2020,239910,42,4,75,35,40
2020,240107,0,0,100,43,57
2020,240107,10,0,100,43,57
2020,240107,10,1,22,10,12
2020,240107,10,2,30,16,14
2020,240107,10,3,45,16,29
2020,240107,10,4,3,1,2
2020,240107,20,0,52,24,28
2020,240107,20,1,22,10,12
2020,240107,20,2,28,14,14
2020,240107,20,3,2,0,2
2020,240107,30,0,33,9,24
2020,240107,30,2,1,1,0
2020,240107,30,3,32,8,24
2020,240107,40,0,15,10,5
2020,240107,40,2,1,1,0
2020,240107,40,3,11,8,3
2020,240107,40,4,3,1,2
2020,240107,42,0,15,10,5
2020,240107,42,2,1,1,0
2020,240107,42,3,11,8,3
2020,240107,42,4,3,1,2
2020,240116,0,0,223,105,118
2020,240116,10,0,223,105,118
2020,240116,10,6,223,105,118
2020,240116,40,0,223,105,118
2020,240116,40,6,223,105,118
2020,240116,42,0,221,104,117
2020,240116,42,6,221,104,117
2020,240116,43,0,2,1,1
2020,240116,43,6,2,1,1
2020,240125,0,0,196,90,106
2020,240125,10,0,196,90,106
2020,240125,10,4,196,90,106
2020,240125,40,0,196,90,106
2020,240125,40,4,196,90,106
2020,240125,42,0,196,90,106
2020,240125,42,4,196,90,106
2020,240170,0,0,180,78,102
2020,240170,10,0,180,78,102
2020,240170,10,4,180,78,102
2020,240170,40,0,180,78,102
2020,240170,40,4,180,78,102
2020,240170,42,0,180,78,102
2020,240170,42,4,180,78,102
2020,240189,0,0,471,242,229
2020,240189,10,0,471,242,229
2020,240189,10,1,104,60,44
2020,240189,10,2,151,79,72
2020,240189,10,3,107,50,57
2020,240189,10,5,109,53,56
2020,240189,20,0,253,137,116
2020,240189,20,1,104,60,44
2020,240189,20,2,149,77,72
2020,240189,30,0,107,52,55
2020,240189,30,2,2,2,0
2020,240189,30,3,105,50,55
2020,240189,40,0,111,53,58
2020,240189,40,3,2,0,2
2020,240189,40,5,109,53,56
2020,240189,41,0,104,48,56
2020,240189,41,3,2,0,2
2020,240189,41,5,102,48,54
2020,240189,42,0,7,5,2
2020,240189,42,5,7,5,2
2020,240189,44,0,45,22,23
2020,240189,44,5,45,22,23
2020,240189,45,0,59,26,33
2020,240189,45,3,2,0,2
2020,240189,45,5,57,26,31
2020,240198,0,0,144,58,86
2020,240198,10,0,144,58,86
2020,240198,10,4,144,58,86
2020,240198,40,0,144,58,86
2020,240198,40,4,144,58,86
2020,240198,42,0,144,58,86
2020,240198,42,4,144,58,86
2020,240268,0,0,439,211,228
2020,240268,10,0,439,211,228
2020,240268,10,1,150,97,53
2020,240268,10,2,99,41,58
2020,240268,10,3,107,42,65
2020,240268,10,4,9,0,9
2020,240268,10,5,74,31,43
2020,240268,20,0,246,140,106
2020,240268,20,1,150,97,53
2020,240268,20,2,92,41,51
2020,240268,20,3,4,2,2
2020,240268,30,0,95,38,57
2020,240268,30,2,3,0,3
2020,240268,30,3,92,38,54
2020,240268,40,0,98,33,65
2020,240268,40,2,4,0,4
2020,240268,40,3,11,2,9
2020,240268,40,4,9,0,9
2020,240268,40,5,74,31,43
2020,240268,41,0,82,24,58
2020,240268,41,2,4,0,4
2020,240268,41,3,11,2,9
2020,240268,41,4,8,0,8
2020,240268,41,5,59,22,37
2020,240268,42,0,13,7,6
2020,240268,42,4,1,0,1
2020,240268,42,5,12,7,5
2020,240268,43,0,3,2,1
2020,240268,43,5,3,2,1
2020,240268,44,0,39,13,26
2020,240268,44,3,1,0,1
2020,240268,44,4,5,0,5
2020,240268,44,5,33,13,20
2020,240268,45,0,43,11,32
2020,240268,45,2,4,0,4
2020,240268,45,3,10,2,8
2020,240268,45,4,3,0,3
2020,240268,45,5,26,9,17
2020,240277,0,0,245,118,127
2020,240277,10,0,245,118,127
2020,240277,10,1,40,22,18
2020,240277,10,2,88,49,39
2020,240277,10,3,48,27,21
2020,240277,10,4,1,0,1
2020,240277,10,5,68,20,48
2020,240277,20,0,127,71,56
2020,240277,20,1,40,22,18
2020,240277,20,2,87,49,38
2020,240277,30,0,50,27,23
2020,240277,30,2,1,0,1
2020,240277,30,3,48,27,21
2020,240277,30,4,1,0,1
2020,240277,40,0,68,20,48
2020,240277,40,5,68,20,48
2020,240277,41,0,66,18,48
2020,240277,41,5,66,18,48
2020,240277,42,0,1,1,0
2020,240277,42,5,1,1,0
2020,240277,43,0,1,1,0
2020,240277,43,5,1,1,0
2020,240277,44,0,15,5,10
2020,240277,44,5,15,5,10
2020,240277,45,0,51,13,38
2020,240277,45,5,51,13,38
2020,240329,0,0,481,237,244
2020,240329,10,0,481,237,244
2020,240329,10,1,101,60,41
2020,240329,10,2,129,57,72
2020,240329,10,3,133,65,68
2020,240329,10,5,118,55,63
2020,240329,20,0,225,117,108
2020,240329,20,1,100,59,41
2020,240329,20,2,113,50,63
2020,240329,20,3,12,8,4
2020,240329,30,0,121,63,58
2020,240329,30,2,11,6,5
2020,240329,30,3,110,57,53
2020,240329,40,0,135,57,78
2020,240329,40,1,1,1,0
2020,240329,40,2,5,1,4
2020,240329,40,3,11,0,11
2020,240329,40,5,118,55,63
2020,240329,41,0,120,52,68
2020,240329,41,1,1,1,0
2020,240329,41,2,5,1,4
2020,240329,41,3,10,0,10
2020,240329,41,5,104,50,54
2020,240329,42,0,14,5,9
2020,240329,42,3,1,0,1
2020,240329,42,5,13,5,8
2020,240329,43,0,1,0,1
2020,240329,43,5,1,0,1
2020,240329,44,0,84,40,44
2020,240329,44,2,1,0,1
2020,240329,44,3,9,0,9
2020,240329,44,5,74,40,34
2020,240329,45,0,36,12,24
2020,240329,45,1,1,1,0
2020,240329,45,2,4,1,3
2020,240329,45,3,1,0,1
2020,240329,45,5,30,10,20
2020,240338,0,0,61,35,26
2020,240338,10,0,61,35,26
2020,240338,10,1,16,11,5
2020,240338,10,2,17,9,8
2020,240338,10,3,19,13,6
2020,240338,10,4,3,1,2
2020,240338,10,5,6,1,5
2020,240338,40,0,61,35,26
2020,240338,40,1,16,11,5
2020,240338,40,2,17,9,8
2020,240338,40,3,19,13,6
2020,240338,40,4,3,1,2
2020,240338,40,5,6,1,5
2020,240338,41,0,61,35,26
2020,240338,41,1,16,11,5
2020,240338,41,2,17,9,8
2020,240338,41,3,19,13,6
2020,240338,41,4,3,1,2
2020,240338,41,5,6,1,5
2020,240338,45,0,61,35,26
2020,240338,45,1,16,11,5
2020,240338,45,2,17,9,8
2020,240338,45,3,19,13,6
2020,240338,45,4,3,1,2
2020,240338,45,5,6,1,5
2020,240365,0,0,396,210,186
2020,240365,10,0,396,210,186
2020,240365,10,1,123,76,47
2020,240365,10,2,122,68,54
2020,240365,10,3,55,27,28
2020,240365,10,5,96,39,57
2020,240365,20,0,226,135,91
2020,240365,20,1,123,76,47
2020,240365,20,2,103,59,44
2020,240365,30,0,71,36,35
2020,240365,30,2,18,9,9
2020,240365,30,3,53,27,26
2020,240365,40,0,99,39,60
2020,240365,40,2,1,0,1
2020,240365,40,3,2,0,2
2020,240365,40,5,96,39,57
2020,240365,41,0,94,37,57
2020,240365,41,2,1,0,1
2020,240365,41,3,2,0,2
2020,240365,41,5,91,37,54
2020,240365,42,0,2,1,1
2020,240365,42,5,2,1,1
2020,240365,43,0,3,1,2
2020,240365,43,5,3,1,2
2020,240365,44,0,75,26,49
2020,240365,44,2,1,0,1
2020,240365,44,3,1,0,1
2020,240365,44,5,73,26,47
2020,240365,45,0,19,11,8
2020,240365,45,3,1,0,1
2020,240365,45,5,18,11,7
2020,240374,0,0,167,86,81
2020,240374,10,0,163,86,77
2020,240374,10,1,26,15,11
2020,240374,10,2,58,34,24
2020,240374,10,3,39,17,22
2020,240374,10,5,40,20,20
2020,240374,20,0,66,40,26
2020,240374,20,1,26,15,11
2020,240374,20,2,40,25,15
2020,240374,30,0,54,24,30
2020,240374,30,2,18,9,9
2020,240374,30,3,36,15,21
2020,240374,40,0,43,22,21
2020,240374,40,3,3,2,1
2020,240374,40,5,40,20,20
2020,240374,41,0,40,21,19
2020,240374,41,3,3,2,1
2020,240374,41,5,37,19,18
2020,240374,42,0,2,0,2
2020,240374,42,5,2,0,2
2020,240374,43,0,1,1,0
2020,240374,43,5,1,1,0
2020,240374,44,0,14,10,4
2020,240374,44,3,3,2,1
2020,240374,44,5,11,8,3
2020,240374,45,0,26,11,15
2020,240374,45,5,26,11,15
2020,240374,50,0,4,0,4
2020,240392,0,0,44,8,36
2020,240392,10,0,44,8,36
2020,240392,10,1,17,4,13
2020,240392,10,2,7,2,5
2020,240392,10,3,20,2,18
2020,240392,40,0,44,8,36
2020,240392,40,1,17,4,13
2020,240392,40,2,7,2,5
2020,240392,40,3,20,2,18
2020,240392,41,0,44,8,36
2020,240392,41,1,17,4,13
2020,240392,41,2,7,2,5
2020,240392,41,3,20,2,18
2020,240392,45,0,44,8,36
2020,240392,45,1,17,4,13
2020,240392,45,2,7,2,5
2020,240392,45,3,20,2,18
2020,240417,0,0,316,170,146
2020,240417,10,0,316,170,146
2020,240417,10,1,108,57,51
2020,240417,10,2,54,31,23
2020,240417,10,3,90,46,44
2020,240417,10,5,64,36,28
2020,240417,20,0,165,91,74
2020,240417,20,1,106,56,50
2020,240417,20,2,53,31,22
2020,240417,20,3,5,3,2
2020,240417,20,5,1,1,0
2020,240417,30,0,86,43,43
2020,240417,30,2,1,0,1
2020,240417,30,3,85,43,42
2020,240417,40,0,65,36,29
2020,240417,40,1,2,1,1
2020,240417,40,5,63,35,28
2020,240417,41,0,58,32,26
2020,240417,41,1,2,1,1
2020,240417,41,5,56,31,25
2020,240417,42,0,2,1,1
2020,240417,42,5,2,1,1
2020,240417,43,0,5,3,2
2020,240417,43,5,5,3,2
2020,240417,44,0,53,29,24
2020,240417,44,1,2,1,1
2020,240417,44,5,51,28,23
2020,240417,45,0,5,3,2
2020,240417,45,5,5,3,2
2020,240426,0,0,112,54,58
2020,240426,10,0,112,54,58
2020,240426,10,1,29,21,8
2020,240426,10,2,28,12,16
2020,240426,10,3,25,13,12
2020,240426,10,4,1,0,1
2020,240426,10,5,29,8,21
2020,240426,20,0,53,33,20
2020,240426,20,1,29,21,8
2020,240426,20,2,22,10,12
2020,240426,20,3,2,2,0
2020,240426,30,0,30,13,17
2020,240426,30,2,6,2,4
2020,240426,30,3,23,11,12
2020,240426,30,4,1,0,1
2020,240426,40,0,29,8,21
2020,240426,40,5,29,8,21
2020,240426,41,0,28,7,21
2020,240426,41,5,28,7,21
2020,240426,42,0,1,1,0
2020,240426,42,5,1,1,0
2020,240426,45,0,28,7,21
2020,240426,45,5,28,7,21
2020,240444,0,0,3724,2142,1582
2020,240444,10,0,3716,2140,1576
2020,240444,10,1,1507,979,528
2020,240444,10,2,803,443,360
2020,240444,10,3,1102,580,522
2020,240444,10,4,174,68,106
2020,240444,10,5,130,70,60
2020,240444,20,0,1493,976,517
2020,240444,20,1,1091,747,344
2020,240444,20,2,402,229,173
2020,240444,30,0,532,282,250
2020,240444,30,1,2,1,1
2020,240444,30,2,5,2,3
2020,240444,30,3,524,279,245
2020,240444,30,4,1,0,1
2020,240444,40,0,1691,882,809
2020,240444,40,1,414,231,183
2020,240444,40,2,396,212,184
2020,240444,40,3,578,301,277
2020,240444,40,4,173,68,105
2020,240444,40,5,130,70,60
2020,240444,41,0,1600,833,767
2020,240444,41,1,409,229,180
2020,240444,41,2,385,207,178
2020,240444,41,3,574,300,274
2020,240444,41,4,110,34,76
2020,240444,41,5,122,63,59
2020,240444,42,0,83,44,39
2020,240444,42,1,5,2,3
2020,240444,42,2,11,5,6
2020,240444,42,3,3,1,2
2020,240444,42,4,59,32,27
2020,240444,42,5,5,4,1
2020,240444,43,0,8,5,3
2020,240444,43,3,1,0,1
2020,240444,43,4,4,2,2
2020,240444,43,5,3,3,0
2020,240444,44,0,74,36,38
2020,240444,44,1,7,2,5
2020,240444,44,2,3,1,2
2020,240444,44,3,32,20,12
2020,240444,44,4,16,5,11
2020,240444,44,5,16,8,8
2020,240444,45,0,1526,797,729
2020,240444,45,1,402,227,175
2020,240444,45,2,382,206,176
2020,240444,45,3,542,280,262
2020,240444,45,4,94,29,65
2020,240444,45,5,106,55,51
2020,240444,50,0,8,2,6
2020,240453,0,0,997,504,493
2020,240453,10,0,997,504,493
2020,240453,10,1,260,166,94
2020,240453,10,2,362,187,175
2020,240453,10,3,155,57,98
2020,240453,10,4,24,3,21
2020,240453,10,5,196,91,105
2020,240453,20,0,579,345,234
2020,240453,20,1,243,159,84
2020,240453,20,2,335,185,150
2020,240453,20,3,1,1,0
2020,240453,30,0,98,45,53
2020,240453,30,2,3,0,3
2020,240453,30,3,95,45,50
2020,240453,40,0,320,114,206
2020,240453,40,1,17,7,10
2020,240453,40,2,24,2,22
2020,240453,40,3,59,11,48
2020,240453,40,4,24,3,21
2020,240453,40,5,196,91,105
2020,240453,41,0,309,109,200
2020,240453,41,1,17,7,10
2020,240453,41,2,24,2,22
2020,240453,41,3,52,9,43
2020,240453,41,4,24,3,21
2020,240453,41,5,192,88,104
2020,240453,42,0,9,4,5
2020,240453,42,3,7,2,5
2020,240453,42,5,2,2,0
2020,240453,43,0,2,1,1
2020,240453,43,5,2,1,1
2020,240453,44,0,115,53,62
2020,240453,44,1,1,1,0
2020,240453,44,2,1,1,0
2020,240453,44,3,16,5,11
2020,240453,44,4,15,0,15
2020,240453,44,5,82,46,36
2020,240453,45,0,194,56,138
2020,240453,45,1,16,6,10
2020,240453,45,2,23,1,22
2020,240453,45,3,36,4,32
2020,240453,45,4,9,3,6
2020,240453,45,5,110,42,68
2020,240462,0,0,296,184,112
2020,240462,10,0,296,184,112
2020,240462,10,1,88,55,33
2020,240462,10,2,69,47,22
2020,240462,10,3,72,47,25
2020,240462,10,5,67,35,32
2020,240462,20,0,155,102,53
2020,240462,20,1,88,55,33
2020,240462,20,2,67,47,20
2020,240462,30,0,75,47,28
2020,240462,30,2,2,0,2
2020,240462,30,3,72,47,25
2020,240462,30,5,1,0,1
2020,240462,40,0,66,35,31
2020,240462,40,5,66,35,31
2020,240462,41,0,65,34,31
2020,240462,41,5,65,34,31
2020,240462,42,0,1,1,0
2020,240462,42,5,1,1,0
2020,240462,44,0,60,31,29
2020,240462,44,5,60,31,29
2020,240462,45,0,5,3,2
2020,240462,45,5,5,3,2
2020,240471,0,0,217,126,91
2020,240471,10,0,217,126,91
2020,240471,10,1,97,65,32
2020,240471,10,2,34,15,19
2020,240471,10,3,63,35,28
2020,240471,10,5,23,11,12
2020,240471,20,0,127,79,48
2020,240471,20,1,94,64,30
2020,240471,20,2,33,15,18
2020,240471,30,0,53,32,21
2020,240471,30,3,53,32,21
2020,240471,40,0,37,15,22
2020,240471,40,1,3,1,2
2020,240471,40,2,1,0,1
2020,240471,40,3,10,3,7
2020,240471,40,5,23,11,12
2020,240471,41,0,36,15,21
2020,240471,41,1,3,1,2
2020,240471,41,2,1,0,1
2020,240471,41,3,9,3,6
2020,240471,41,5,23,11,12
2020,240471,42,0,1,0,1
2020,240471,42,3,1,0,1
2020,240471,44,0,16,8,8
2020,240471,44,3,2,2,0
2020,240471,44,5,14,6,8
2020,240471,45,0,20,7,13
2020,240471,45,1,3,1,2
2020,240471,45,2,1,0,1
2020,240471,45,3,7,1,6
2020,240471,45,5,9,5,4
2020,240480,0,0,326,180,146
2020,240480,10,0,326,180,146
2020,240480,10,1,124,78,46
2020,240480,10,2,90,54,36
2020,240480,10,3,71,34,37
2020,240480,10,4,2,1,1
2020,240480,10,5,39,13,26
2020,240480,20,0,211,130,81
2020,240480,20,1,123,77,46
2020,240480,20,2,86,53,33
2020,240480,20,3,1,0,1
2020,240480,20,5,1,0,1
2020,240480,30,0,67,34,33
2020,240480,30,2,2,1,1
2020,240480,30,3,64,32,32
2020,240480,30,4,1,1,0
2020,240480,40,0,48,16,32
2020,240480,40,1,1,1,0
2020,240480,40,2,2,0,2
2020,240480,40,3,6,2,4
2020,240480,40,4,1,0,1
2020,240480,40,5,38,13,25
2020,240480,41,0,41,12,29
2020,240480,41,1,1,1,0
2020,240480,41,2,2,0,2
2020,240480,41,3,6,2,4
2020,240480,41,4,1,0,1
2020,240480,41,5,31,9,22
2020,240480,42,0,6,3,3
2020,240480,42,5,6,3,3
2020,240480,43,0,1,1,0
2020,240480,43,5,1,1,0
2020,240480,44,0,20,7,13
2020,240480,44,5,20,7,13
2020,240480,45,0,21,5,16
2020,240480,45,1,1,1,0
2020,240480,45,2,2,0,2
2020,240480,45,3,6,2,4
2020,240480,45,4,1,0,1
2020,240480,45,5,11,2,9
2020,240505,0,0,128,71,57
2020,240505,10,0,128,71,57
2020,240505,10,4,128,71,57
2020,240505,20,0,102,59,43
2020,240505,20,4,102,59,43
2020,240505,30,0,25,11,14
2020,240505,30,4,25,11,14
2020,240505,40,0,1,1,0
2020,240505,40,4,1,1,0
2020,240505,42,0,1,1,0
2020,240505,42,4,1,1,0
2020,240514,0,0,55,24,31
2020,240514,10,0,55,24,31
2020,240514,10,1,24,14,10
2020,240514,10,2,9,2,7
2020,240514,10,3,7,2,5
2020,240514,10,4,15,6,9
2020,240514,20,0,41,19,22
2020,240514,20,1,23,14,9
2020,240514,20,2,9,2,7
2020,240514,20,3,7,2,5
2020,240514,20,4,2,1,1
2020,240514,30,0,12,5,7
2020,240514,30,4,12,5,7
2020,240514,40,0,2,0,2
2020,240514,40,1,1,0,1
2020,240514,40,4,1,0,1
2020,240514,42,0,2,0,2
2020,240514,42,1,1,0,1
2020,240514,42,4,1,0,1
2020,240596,0,0,36,17,19
2020,240596,10,0,34,16,18
2020,240596,10,1,11,6,5
2020,240596,10,2,8,3,5
2020,240596,10,3,15,7,8
2020,240596,20,0,22,10,12
2020,240596,20,1,11,6,5
2020,240596,20,2,8,3,5
2020,240596,20,3,3,1,2
2020,240596,30,0,12,6,6
2020,240596,30,3,12,6,6
2020,240596,50,0,2,1,1
2020,240620,0,0,125,54,71
2020,240620,10,0,124,54,70
2020,240620,10,6,124,54,70
2020,240620,40,0,124,54,70
2020,240620,40,6,124,54,70
2020,240620,41,0,43,20,23
2020,240620,41,6,43,20,23
2020,240620,42,0,74,32,42
2020,240620,42,6,74,32,42
2020,240620,43,0,7,2,5
2020,240620,43,6,7,2,5
2020,240620,45,0,43,20,23
2020,240620,45,6,43,20,23
2020,240620,50,0,1,0,1
2020,240657,0,0,61,35,26
2020,240657,10,0,61,35,26
2020,240657,10,1,3,1,2
2020,240657,10,2,20,15,5
2020,240657,10,3,24,14,10
2020,240657,10,4,14,5,9
2020,240657,20,0,41,27,14
2020,240657,20,1,3,1,2
2020,240657,20,2,20,15,5
2020,240657,20,3,18,11,7
2020,240657,30,0,11,7,4
2020,240657,30,3,4,3,1
2020,240657,30,4,7,4,3
2020,240657,40,0,9,1,8
2020,240657,40,3,2,0,2
2020,240657,40,4,7,1,6
2020,240657,42,0,9,1,8
2020,240657,42,3,2,0,2
2020,240657,42,4,7,1,6
2020,240666,0,0,104,48,56
2020,240666,10,0,98,45,53
2020,240666,10,2,3,2,1
2020,240666,10,3,59,32,27
2020,240666,10,4,36,11,25
2020,240666,20,0,61,33,28
2020,240666,20,2,3,2,1
2020,240666,20,3,58,31,27
2020,240666,30,0,29,9,20
2020,240666,30,3,1,1,0
2020,240666,30,4,28,8,20
2020,240666,40,0,8,3,5
2020,240666,40,4,8,3,5
2020,240666,42,0,8,3,5
2020,240666,42,4,8,3,5
2020,240666,50,0,6,3,3
2020,240693,0,0,75,35,40
2020,240693,10,0,75,35,40
2020,240693,10,1,10,5,5
2020,240693,10,2,22,9,13
2020,240693,10,3,20,10,10
2020,240693,10,4,23,11,12
2020,240693,40,0,75,35,40
2020,240693,40,1,10,5,5
2020,240693,40,2,22,9,13
2020,240693,40,3,20,10,10
2020,240693,40,4,23,11,12
2020,240693,42,0,75,35,40
2020,240693,42,1,10,5,5
2020,240693,42,2,22,9,13
2020,240693,42,3,20,10,10
2020,240693,42,4,23,11,12
2020,240718,0,0,31,30,1
2020,240718,10,0,31,30,1
2020,240718,10,4,31,30,1
2020,240718,40,0,31,30,1
2020,240718,40,4,31,30,1
2020,240718,41,0,31,30,1
2020,240718,41,4,31,30,1
2020,240718,45,0,31,30,1
2020,240718,45,4,31,30,1
2020,240727,0,0,719,405,314
2020,240727,10,0,719,405,314
2020,240727,10,1,197,144,53
2020,240727,10,2,185,103,82
2020,240727,10,3,149,76,73
2020,240727,10,4,19,11,8
2020,240727,10,5,169,71,98
2020,240727,20,0,376,244,132
2020,240727,20,1,196,143,53
2020,240727,20,2,180,101,79
2020,240727,30,0,154,78,76
2020,240727,30,2,5,2,3
2020,240727,30,3,149,76,73
2020,240727,40,0,189,83,106
2020,240727,40,1,1,1,0
2020,240727,40,4,19,11,8
2020,240727,40,5,169,71,98
2020,240727,41,0,103,47,56
2020,240727,41,4,4,4,0
2020,240727,41,5,99,43,56
2020,240727,42,0,86,36,50
2020,240727,42,1,1,1,0
2020,240727,42,4,15,7,8
2020,240727,42,5,70,28,42
2020,240727,44,0,103,47,56
2020,240727,44,4,4,4,0
2020,240727,44,5,99,43,56
2020,240736,0,0,80,38,42
2020,240736,10,0,80,38,42
2020,240736,10,4,80,38,42
2020,240736,20,0,48,23,25
2020,240736,20,4,48,23,25
2020,240736,30,0,7,2,5
2020,240736,30,4,7,2,5
2020,240736,40,0,25,13,12
2020,240736,40,4,25,13,12
2020,240736,42,0,6,5,1
2020,240736,42,4,6,5,1
2020,240736,43,0,19,8,11
2020,240736,43,4,19,8,11
2020,240745,0,0,51,24,27
2020,240745,10,0,51,24,27
2020,240745,10,1,7,1,6
2020,240745,10,2,6,2,4
2020,240745,10,3,16,7,9
2020,240745,10,4,20,12,8
2020,240745,10,5,2,2,0
2020,240745,20,0,47,22,25
2020,240745,20,1,7,1,6
2020,240745,20,2,6,2,4
2020,240745,20,3,16,7,9
2020,240745,20,4,16,10,6
2020,240745,20,5,2,2,0
2020,240745,30,0,2,0,2
2020,240745,30,4,2,0,2
2020,240745,40,0,2,2,0
2020,240745,40,4,2,2,0
2020,240745,42,0,2,2,0
2020,240745,42,4,2,2,0
2020,240754,0,0,133,68,65
2020,240754,10,0,133,68,65
2020,240754,10,1,42,25,17
2020,240754,10,2,38,16,22
2020,240754,10,3,34,20,14
2020,240754,10,4,19,7,12
2020,240754,20,0,69,35,34
2020,240754,20,1,37,21,16
2020,240754,20,2,30,12,18
2020,240754,20,3,2,2,0
2020,240754,30,0,33,22,11
2020,240754,30,1,4,4,0
2020,240754,30,2,7,4,3
2020,240754,30,3,22,14,8
2020,240754,40,0,31,11,20
2020,240754,40,1,1,0,1
2020,240754,40,2,1,0,1
2020,240754,40,3,10,4,6
2020,240754,40,4,19,7,12
2020,240754,41,0,18,7,11
2020,240754,41,1,1,0,1
2020,240754,41,3,4,2,2
2020,240754,41,4,13,5,8
2020,240754,42,0,10,4,6
2020,240754,42,3,5,2,3
2020,240754,42,4,5,2,3
2020,240754,43,0,3,0,3
2020,240754,43,2,1,0,1
2020,240754,43,3,1,0,1
2020,240754,43,4,1,0,1
2020,240754,44,0,18,7,11
2020,240754,44,1,1,0,1
2020,240754,44,3,4,2,2
2020,240754,44,4,13,5,8
2020,240790,0,0,34,14,20
2020,240790,10,0,34,14,20
2020,240790,10,1,1,1,0
2020,240790,10,2,6,2,4
2020,240790,10,3,18,8,10
2020,240790,10,4,9,3,6
2020,240790,40,0,34,14,20
2020,240790,40,1,1,1,0
2020,240790,40,2,6,2,4
2020,240790,40,3,18,8,10
2020,240790,40,4,9,3,6
2020,240790,41,0,34,14,20
2020,240790,41,1,1,1,0
2020,240790,41,2,6,2,4
2020,240790,41,3,18,8,10
2020,240790,41,4,9,3,6
2020,240790,44,0,34,14,20
2020,240790,44,1,1,1,0
2020,240790,44,2,6,2,4
2020,240790,44,3,18,8,10
2020,240790,44,4,9,3,6
2020,241100,0,0,7,4,3
2020,241100,10,0,7,4,3
2020,241100,10,1,1,1,0
2020,241100,10,3,6,3,3
2020,241100,20,0,7,4,3
2020,241100,20,1,1,1,0
2020,241100,20,3,6,3,3
2020,241128,0,0,7,3,4
2020,241128,10,0,7,3,4
2020,241128,10,2,4,1,3
2020,241128,10,3,1,0,1
2020,241128,10,4,2,2,0
2020,241128,20,0,7,3,4
2020,241128,20,2,4,1,3
2020,241128,20,3,1,0,1
2020,241128,20,4,2,2,0
2020,241191,0,0,34,18,16
2020,241191,10,0,34,18,16
2020,241191,10,2,7,3,4
2020,241191,10,3,19,10,9
2020,241191,10,4,2,1,1
2020,241191,10,6,6,4,2
2020,241191,20,0,16,8,8
2020,241191,20,2,6,3,3
2020,241191,20,3,9,4,5
2020,241191,20,4,1,1,0
2020,241191,30,0,13,7,6
2020,241191,30,2,1,0,1
2020,241191,30,3,10,6,4
2020,241191,30,4,1,0,1
2020,241191,30,6,1,1,0
2020,241191,40,0,5,3,2
2020,241191,40,6,5,3,2
2020,241191,42,0,2,1,1
2020,241191,42,6,2,1,1
2020,241191,43,0,3,2,1
2020,241191,43,6,3,2,1
2020,241216,0,0,60,31,29
2020,241216,10,0,60,31,29
2020,241216,10,1,60,31,29
2020,241216,40,0,60,31,29
2020,241216,40,1,60,31,29
2020,241216,41,0,22,14,8
2020,241216,41,1,22,14,8
2020,241216,42,0,8,6,2
2020,241216,42,1,8,6,2
2020,241216,43,0,30,11,19
2020,241216,43,1,30,11,19
2020,241216,44,0,22,14,8
2020,241216,44,1,22,14,8
2020,241225,0,0,24,7,17
2020,241225,10,0,19,6,13
2020,241225,10,1,1,1,0
2020,241225,10,2,10,3,7
2020,241225,10,3,4,2,2
2020,241225,10,4,4,0,4
2020,241225,40,0,19,6,13
2020,241225,40,1,1,1,0
2020,241225,40,2,10,3,7
2020,241225,40,3,4,2,2
2020,241225,40,4,4,0,4
2020,241225,42,0,19,6,13
2020,241225,42,1,1,1,0
2020,241225,42,2,10,3,7
2020,241225,42,3,4,2,2
2020,241225,42,4,4,0,4
2020,241225,50,0,5,1,4
2020,241304,0,0,33,13,20
2020,241304,10,0,33,13,20
2020,241304,10,1,4,2,2
2020,241304,10,4,29,11,18
2020,241304,40,0,33,13,20
2020,241304,40,1,4,2,2
2020,241304,40,4,29,11,18
2020,241304,42,0,29,11,18
2020,241304,42,4,29,11,18
2020,241304,43,0,4,2,2
2020,241304,43,1,4,2,2
2020,241331,0,0,35,15,20
2020,241331,10,0,35,15,20
2020,241331,10,1,7,6,1
2020,241331,10,2,18,6,12
2020,241331,10,3,10,3,7
2020,241331,40,0,35,15,20
2020,241331,40,1,7,6,1
2020,241331,40,2,18,6,12
2020,241331,40,3,10,3,7
2020,241331,41,0,29,12,17
2020,241331,41,1,7,6,1
2020,241331,41,2,15,5,10
2020,241331,41,3,7,1,6
2020,241331,42,0,6,3,3
2020,241331,42,2,3,1,2
2020,241331,42,3,3,2,1
2020,241331,44,0,29,12,17
2020,241331,44,1,7,6,1
2020,241331,44,2,15,5,10
2020,241331,44,3,7,1,6
2020,241377,0,0,21,12,9
2020,241377,10,0,21,12,9
2020,241377,10,1,1,1,0
2020,241377,10,2,1,0,1
2020,241377,10,3,5,2,3
2020,241377,10,4,14,9,5
2020,241377,40,0,21,12,9
2020,241377,40,1,1,1,0
2020,241377,40,2,1,0,1
2020,241377,40,3,5,2,3
2020,241377,40,4,14,9,5
2020,241377,42,0,21,12,9
2020,241377,42,1,1,1,0
2020,241377,42,2,1,0,1
2020,241377,42,3,5,2,3
2020,241377,42,4,14,9,5
2020,241395,0,0,23,9,14
2020,241395,10,0,23,9,14
2020,241395,10,1,2,1,1
2020,241395,10,2,6,2,4
2020,241395,10,3,4,2,2
2020,241395,10,4,3,1,2
2020,241395,10,6,8,3,5
2020,241395,40,0,23,9,14
2020,241395,40,1,2,1,1
2020,241395,40,2,6,2,4
2020,241395,40,3,4,2,2
2020,241395,40,4,3,1,2
2020,241395,40,6,8,3,5
2020,241395,41,0,8,4,4
2020,241395,41,1,2,1,1
2020,241395,41,2,5,2,3
2020,241395,41,3,1,1,0
2020,241395,42,0,8,3,5
2020,241395,42,2,1,0,1
2020,241395,42,3,3,1,2
2020,241395,42,4,3,1,2
2020,241395,42,6,1,1,0
2020,241395,43,0,7,2,5
2020,241395,43,6,7,2,5
2020,241395,45,0,8,4,4
2020,241395,45,1,2,1,1
2020,241395,45,2,5,2,3
2020,241395,45,3,1,1,0
2020,241410,0,0,222,96,126
2020,241410,10,0,222,96,126
2020,241410,10,1,43,23,20
2020,241410,10,2,64,27,37
2020,241410,10,3,70,33,37
2020,241410,10,4,24,7,17
2020,241410,10,6,21,6,15
2020,241410,40,0,222,96,126
2020,241410,40,1,43,23,20
2020,241410,40,2,64,27,37
2020,241410,40,3,70,33,37
2020,241410,40,4,24,7,17
2020,241410,40,6,21,6,15
2020,241410,41,0,155,69,86
2020,241410,41,1,41,23,18
2020,241410,41,2,58,23,35
2020,241410,41,3,50,20,30
2020,241410,41,4,6,3,3
2020,241410,42,0,51,22,29
2020,241410,42,1,2,0,2
2020,241410,42,2,6,4,2
2020,241410,42,3,20,13,7
2020,241410,42,4,18,4,14
2020,241410,42,6,5,1,4
2020,241410,43,0,16,5,11
2020,241410,43,6,16,5,11
2020,241410,45,0,155,69,86
2020,241410,45,1,41,23,18
2020,241410,45,2,58,23,35
2020,241410,45,3,50,20,30
2020,241410,45,4,6,3,3
2020,241517,0,0,1,1,0
2020,241517,10,0,1,1,0
2020,241517,10,1,1,1,0
2020,241517,20,0,1,1,0
2020,241517,20,1,1,1,0
2020,241614,0,0,17,11,6
2020,241614,10,0,17,11,6
2020,241614,10,1,1,0,1
2020,241614,10,4,2,1,1
2020,241614,10,6,14,10,4
2020,241614,20,0,2,0,2
2020,241614,20,1,1,0,1
2020,241614,20,4,1,0,1
2020,241614,40,0,15,11,4
2020,241614,40,4,1,1,0
2020,241614,40,6,14,10,4
2020,241614,41,0,1,1,0
2020,241614,41,4,1,1,0
2020,241614,43,0,14,10,4
2020,241614,43,6,14,10,4
2020,241614,44,0,1,1,0
2020,241614,44,4,1,1,0
2020,241720,0,0,22,9,13
2020,241720,10,0,21,9,12
2020,241720,10,1,1,1,0
2020,241720,10,2,1,1,0
2020,241720,10,3,5,2,3
2020,241720,10,4,14,5,9
2020,241720,20,0,21,9,12
2020,241720,20,1,1,1,0
2020,241720,20,2,1,1,0
2020,241720,20,3,5,2,3
2020,241720,20,4,14,5,9
2020,241720,50,0,1,0,1
2020,241739,0,0,135,44,91
2020,241739,10,0,135,44,91
2020,241739,10,1,12,4,8
2020,241739,10,2,18,6,12
2020,241739,10,3,45,15,30
2020,241739,10,4,60,19,41
2020,241739,20,0,7,1,6
2020,241739,20,1,4,0,4
2020,241739,20,2,3,1,2
2020,241739,40,0,128,43,85
2020,241739,40,1,8,4,4
2020,241739,40,2,15,5,10
2020,241739,40,3,45,15,30
2020,241739,40,4,60,19,41
2020,241739,41,0,49,19,30
2020,241739,41,1,7,4,3
2020,241739,41,2,15,5,10
2020,241739,41,3,23,9,14
2020,241739,41,4,4,1,3
2020,241739,42,0,79,24,55
2020,241739,42,1,1,0,1
2020,241739,42,3,22,6,16
2020,241739,42,4,56,18,38
2020,241739,44,0,49,19,30
2020,241739,44,1,7,4,3
2020,241739,44,2,15,5,10
2020,241739,44,3,23,9,14
2020,241739,44,4,4,1,3
2020,241766,0,0,36,26,10
2020,241766,10,0,36,26,10
2020,241766,10,1,9,4,5
2020,241766,10,2,13,10,3
2020,241766,10,3,9,9,0
2020,241766,10,4,3,2,1
2020,241766,10,6,2,1,1
2020,241766,20,0,33,24,9
2020,241766,20,1,9,4,5
2020,241766,20,2,13,10,3
2020,241766,20,3,9,9,0
2020,241766,20,4,2,1,1
2020,241766,30,0,1,1,0
2020,241766,30,4,1,1,0
2020,241766,40,0,2,1,1
2020,241766,40,6,2,1,1
2020,241766,43,0,2,1,1
2020,241766,43,6,2,1,1
2020,241836,0,0,33,8,25
2020,241836,10,0,33,8,25
2020,241836,10,4,33,8,25
2020,241836,40,0,33,8,25
2020,241836,40,4,33,8,25
2020,241836,41,0,33,8,25
2020,241836,41,4,33,8,25
2020,241836,45,0,33,8,25
2020,241836,45,4,33,8,25
2020,241951,0,0,19,9,10
2020,241951,10,0,19,9,10
2020,241951,10,1,3,2,1
2020,241951,10,2,1,0,1
2020,241951,10,4,7,5,2
2020,241951,10,6,8,2,6
2020,241951,20,0,11,7,4
2020,241951,20,1,3,2,1
2020,241951,20,2,1,0,1
2020,241951,20,4,7,5,2
2020,241951,40,0,8,2,6
2020,241951,40,6,8,2,6
2020,241951,43,0,8,2,6
2020,241951,43,6,8,2,6
2020,242042,0,0,45,15,30
2020,242042,10,0,45,15,30
2020,242042,10,1,45,15,30
2020,242042,20,0,26,6,20
2020,242042,20,1,26,6,20
2020,242042,30,0,18,9,9
2020,242042,30,1,18,9,9
2020,242042,40,0,1,0,1
2020,242042,40,1,1,0,1
2020,242042,43,0,1,0,1
2020,242042,43,1,1,0,1
2020,242112,0,0,17,5,12
2020,242112,10,0,17,5,12
2020,242112,10,1,17,5,12
2020,242112,20,0,17,5,12
2020,242112,20,1,17,5,12
2020,242121,0,0,4,2,2
2020,242121,10,0,4,2,2
2020,242121,10,1,4,2,2
2020,242121,40,0,4,2,2
2020,242121,40,1,4,2,2
2020,242121,42,0,3,2,1
2020,242121,42,1,3,2,1
2020,242121,43,0,1,0,1
2020,242121,43,1,1,0,1
2020,242130,0,0,12,3,9
2020,242130,10,0,12,3,9
2020,242130,10,4,12,3,9
2020,242130,40,0,12,3,9
2020,242130,40,4,12,3,9
2020,242130,43,0,12,3,9
2020,242130,43,4,12,3,9
2020,242149,0,0,10,3,7
2020,242149,10,0,10,3,7
2020,242149,10,4,10,3,7
2020,242149,40,0,10,3,7
2020,242149,40,4,10,3,7
2020,242149,43,0,10,3,7
2020,242149,43,4,10,3,7
2020,242556,0,0,32,16,16
2020,242556,10,0,32,16,16
2020,242556,10,1,32,16,16
2020,242556,20,0,20,10,10
2020,242556,20,1,20,10,10
2020,242556,40,0,12,6,6
2020,242556,40,1,12,6,6
2020,242556,41,0,7,4,3
2020,242556,41,1,7,4,3
2020,242556,42,0,5,2,3
2020,242556,42,1,5,2,3
2020,242556,44,0,7,4,3
2020,242556,44,1,7,4,3
2020,242565,0,0,32,13,19
2020,242565,10,0,32,13,19
2020,242565,10,1,32,13,19
2020,242565,40,0,32,13,19
2020,242565,40,1,32,13,19
2020,242565,41,0,32,13,19
2020,242565,41,1,32,13,19
2020,242565,45,0,32,13,19
2020,242565,45,1,32,13,19
2020,242583,0,0,32,15,17
2020,242583,10,0,32,15,17
2020,242583,10,1,32,15,17
2020,242583,20,0,17,7,10
2020,242583,20,1,17,7,10
2020,242583,30,0,15,8,7
2020,242583,30,1,15,8,7
2020,242617,0,0,86,37,49
2020,242617,10,0,86,37,49
2020,242617,10,1,21,12,9
2020,242617,10,2,37,17,20
2020,242617,10,3,26,8,18
2020,242617,10,4,2,0,2
2020,242617,20,0,68,30,38
2020,242617,20,1,21,12,9
2020,242617,20,2,33,15,18
2020,242617,20,3,14,3,11
2020,242617,30,0,12,5,7
2020,242617,30,2,3,1,2
2020,242617,30,3,9,4,5
2020,242617,40,0,6,2,4
2020,242617,40,2,1,1,0
2020,242617,40,3,3,1,2
2020,242617,40,4,2,0,2
2020,242617,42,0,6,2,4
2020,242617,42,2,1,1,0
2020,242617,42,3,3,1,2
2020,242617,42,4,2,0,2
2020,242626,0,0,77,30,47
2020,242626,10,0,77,30,47
2020,242626,10,1,8,0,8
2020,242626,10,2,20,7,13
2020,242626,10,3,38,21,17
2020,242626,10,4,11,2,9
2020,242626,20,0,48,20,28
2020,242626,20,1,8,0,8
2020,242626,20,2,17,7,10
2020,242626,20,3,23,13,10
2020,242626,30,0,17,6,11
2020,242626,30,2,3,0,3
2020,242626,30,3,13,6,7
2020,242626,30,4,1,0,1
2020,242626,40,0,12,4,8
2020,242626,40,3,2,2,0
2020,242626,40,4,10,2,8
2020,242626,42,0,11,4,7
2020,242626,42,3,2,2,0
2020,242626,42,4,9,2,7
2020,242626,43,0,1,0,1
2020,242626,43,4,1,0,1
2020,242635,0,0,69,31,38
2020,242635,10,0,69,31,38
2020,242635,10,1,19,10,9
2020,242635,10,2,11,5,6
2020,242635,10,3,29,12,17
2020,242635,10,4,10,4,6
2020,242635,20,0,45,22,23
2020,242635,20,1,19,10,9
2020,242635,20,2,10,5,5
2020,242635,20,3,16,7,9
2020,242635,30,0,15,3,12
2020,242635,30,2,1,0,1
2020,242635,30,3,8,1,7
2020,242635,30,4,6,2,4
2020,242635,40,0,9,6,3
2020,242635,40,3,5,4,1
2020,242635,40,4,4,2,2
2020,242635,42,0,9,6,3
2020,242635,42,3,5,4,1
2020,242635,42,4,4,2,2
2020,242644,0,0,27,10,17
2020,242644,10,0,27,10,17
2020,242644,10,1,1,1,0
2020,242644,10,2,5,1,4
2020,242644,10,3,16,7,9
2020,242644,10,4,5,1,4
2020,242644,20,0,11,3,8
2020,242644,20,1,1,1,0
2020,242644,20,2,4,1,3
2020,242644,20,3,6,1,5
2020,242644,30,0,8,2,6
2020,242644,30,2,1,0,1
2020,242644,30,3,4,2,2
2020,242644,30,4,3,0,3
2020,242644,40,0,8,5,3
2020,242644,40,3,6,4,2
2020,242644,40,4,2,1,1
2020,242644,42,0,8,5,3
2020,242644,42,3,6,4,2
2020,242644,42,4,2,1,1
2020,242653,0,0,168,82,86
2020,242653,10,0,168,82,86
2020,242653,10,1,51,29,22
2020,242653,10,2,57,28,29
2020,242653,10,3,47,20,27
2020,242653,10,4,13,5,8
2020,242653,20,0,111,59,52
2020,242653,20,1,47,28,19
2020,242653,20,2,51,25,26
2020,242653,20,3,13,6,7
2020,242653,30,0,30,9,21
2020,242653,30,1,2,0,2
2020,242653,30,2,5,2,3
2020,242653,30,3,21,7,14
2020,242653,30,4,2,0,2
2020,242653,40,0,27,14,13
2020,242653,40,1,2,1,1
2020,242653,40,2,1,1,0
2020,242653,40,3,13,7,6
2020,242653,40,4,11,5,6
2020,242653,42,0,27,14,13
2020,242653,42,1,2,1,1
2020,242653,42,2,1,1,0
2020,242653,42,3,13,7,6
2020,242653,42,4,11,5,6
2020,242662,0,0,90,36,54
2020,242662,10,0,90,36,54
2020,242662,10,1,15,7,8
2020,242662,10,2,35,19,16
2020,242662,10,3,32,8,24
2020,242662,10,4,8,2,6
2020,242662,20,0,63,29,34
2020,242662,20,1,15,7,8
2020,242662,20,2,28,16,12
2020,242662,20,3,20,6,14
2020,242662,30,0,24,7,17
2020,242662,30,2,7,3,4
2020,242662,30,3,10,2,8
2020,242662,30,4,7,2,5
2020,242662,40,0,3,0,3
2020,242662,40,3,2,0,2
2020,242662,40,4,1,0,1
2020,242662,42,0,3,0,3
2020,242662,42,3,2,0,2
2020,242662,42,4,1,0,1
2020,242680,0,0,36,15,21
2020,242680,10,0,36,15,21
2020,242680,10,1,3,2,1
2020,242680,10,2,11,6,5
2020,242680,10,3,21,7,14
2020,242680,10,4,1,0,1
2020,242680,20,0,27,14,13
2020,242680,20,1,3,2,1
2020,242680,20,2,9,6,3
2020,242680,20,3,15,6,9
2020,242680,30,0,7,1,6
2020,242680,30,2,2,0,2
2020,242680,30,3,5,1,4
2020,242680,40,0,2,0,2
2020,242680,40,3,1,0,1
2020,242680,40,4,1,0,1
2020,242680,42,0,2,0,2
2020,242680,42,3,1,0,1
2020,242680,42,4,1,0,1
2020,242699,0,0,31,11,20
2020,242699,10,0,31,11,20
2020,242699,10,1,2,1,1
2020,242699,10,2,7,4,3
2020,242699,10,3,16,6,10
2020,242699,10,4,6,0,6
2020,242699,20,0,19,7,12
2020,242699,20,1,2,1,1
2020,242699,20,2,6,3,3
2020,242699,20,3,11,3,8
2020,242699,30,0,5,3,2
2020,242699,30,2,1,1,0
2020,242699,30,3,3,2,1
2020,242699,30,4,1,0,1
2020,242699,40,0,7,1,6
2020,242699,40,3,2,1,1
2020,242699,40,4,5,0,5
2020,242699,42,0,7,1,6
2020,242699,42,3,2,1,1
2020,242699,42,4,5,0,5
2020,242705,0,0,88,51,37
2020,242705,10,0,88,51,37
2020,242705,10,1,14,11,3
2020,242705,10,2,24,13,11
2020,242705,10,3,37,21,16
2020,242705,10,4,13,6,7
2020,242705,20,0,56,32,24
2020,242705,20,1,13,10,3
2020,242705,20,2,20,11,9
2020,242705,20,3,23,11,12
2020,242705,30,0,20,13,7
2020,242705,30,1,1,1,0
2020,242705,30,2,4,2,2
2020,242705,30,3,9,7,2
2020,242705,30,4,6,3,3
2020,242705,40,0,12,6,6
2020,242705,40,3,5,3,2
2020,242705,40,4,7,3,4
2020,242705,41,0,2,2,0
2020,242705,41,3,1,1,0
2020,242705,41,4,1,1,0
2020,242705,42,0,10,4,6
2020,242705,42,3,4,2,2
2020,242705,42,4,6,2,4
2020,242705,44,0,2,2,0
2020,242705,44,3,1,1,0
2020,242705,44,4,1,1,0
2020,242723,0,0,24,15,9
2020,242723,10,0,24,15,9
2020,242723,10,1,15,9,6
2020,242723,10,2,8,5,3
2020,242723,10,3,1,1,0
2020,242723,20,0,22,14,8
2020,242723,20,1,15,9,6
2020,242723,20,2,7,5,2
2020,242723,30,0,2,1,1
2020,242723,30,2,1,0,1
2020,242723,30,3,1,1,0
2020,242972,0,0,306,110,196
2020,242972,10,0,306,110,196
2020,242972,10,1,6,4,2
2020,242972,10,2,58,19,39
2020,242972,10,4,242,87,155
2020,242972,20,0,89,32,57
2020,242972,20,1,6,4,2
2020,242972,20,2,58,19,39
2020,242972,20,4,25,9,16
2020,242972,40,0,217,78,139
2020,242972,40,4,217,78,139
2020,242972,42,0,5,0,5
2020,242972,42,4,5,0,5
2020,242972,43,0,212,78,134
2020,242972,43,4,212,78,134
2020,243081,0,0,123,46,77
2020,243081,10,0,123,46,77
2020,243081,10,1,34,16,18
2020,243081,10,2,19,6,13
2020,243081,10,3,65,22,43
2020,243081,10,4,5,2,3
2020,243081,40,0,123,46,77
2020,243081,40,1,34,16,18
2020,243081,40,2,19,6,13
2020,243081,40,3,65,22,43
2020,243081,40,4,5,2,3
2020,243081,41,0,123,46,77
2020,243081,41,1,34,16,18
2020,243081,41,2,19,6,13
2020,243081,41,3,65,22,43
2020,243081,41,4,5,2,3
2020,243081,44,0,20,5,15
2020,243081,44,1,2,0,2
2020,243081,44,2,1,0,1
2020,243081,44,3,13,4,9
2020,243081,44,4,4,1,3
2020,243081,45,0,103,41,62
2020,243081,45,1,32,16,16
2020,243081,45,2,18,6,12
2020,243081,45,3,52,18,34
2020,243081,45,4,1,1,0
2020,243106,0,0,87,43,44
2020,243106,10,0,87,43,44
2020,243106,10,1,37,21,16
2020,243106,10,2,19,12,7
2020,243106,10,3,20,5,15
2020,243106,10,4,11,5,6
2020,243106,20,0,64,36,28
2020,243106,20,1,37,21,16
2020,243106,20,2,19,12,7
2020,243106,20,3,6,1,5
2020,243106,20,4,2,2,0
2020,243106,40,0,23,7,16
2020,243106,40,3,14,4,10
2020,243106,40,4,9,3,6
2020,243106,43,0,23,7,16
2020,243106,43,3,14,4,10
2020,243106,43,4,9,3,6
2020,243115,0,0,127,58,69
2020,243115,10,0,127,58,69
2020,243115,10,1,67,31,36
2020,243115,10,2,33,14,19
2020,243115,10,3,16,9,7
2020,243115,10,4,11,4,7
2020,243115,20,0,113,55,58
2020,243115,20,1,67,31,36
2020,243115,20,2,31,13,18
2020,243115,20,3,13,9,4
2020,243115,20,4,2,2,0
2020,243115,30,0,3,1,2
2020,243115,30,2,2,1,1
2020,243115,30,4,1,0,1
2020,243115,40,0,11,2,9
2020,243115,40,3,3,0,3
2020,243115,40,4,8,2,6
2020,243115,42,0,11,2,9
2020,243115,42,3,3,0,3
2020,243115,42,4,8,2,6
2020,243133,0,0,171,85,86
2020,243133,10,0,171,85,86
2020,243133,10,1,54,31,23
2020,243133,10,2,36,16,20
2020,243133,10,3,54,21,33
2020,243133,10,4,27,17,10
2020,243133,20,0,114,59,55
2020,243133,20,1,54,31,23
2020,243133,20,2,33,15,18
2020,243133,20,3,25,11,14
2020,243133,20,4,2,2,0
2020,243133,30,0,7,2,5
2020,243133,30,2,3,1,2
2020,243133,30,3,4,1,3
2020,243133,40,0,50,24,26
2020,243133,40,3,25,9,16
2020,243133,40,4,25,15,10
2020,243133,43,0,50,24,26
2020,243133,43,3,25,9,16
2020,243133,43,4,25,15,10
2020,243142,0,0,81,42,39
2020,243142,10,0,81,42,39
2020,243142,10,1,20,11,9
2020,243142,10,2,16,7,9
2020,243142,10,3,23,12,11
2020,243142,10,4,22,12,10
2020,243142,20,0,52,28,24
2020,243142,20,1,20,11,9
2020,243142,20,2,16,7,9
2020,243142,20,3,15,9,6
2020,243142,20,4,1,1,0
2020,243142,30,0,4,2,2
2020,243142,30,3,1,1,0
2020,243142,30,4,3,1,2
2020,243142,40,0,25,12,13
2020,243142,40,3,7,2,5
2020,243142,40,4,18,10,8
2020,243142,41,0,1,0,1
2020,243142,41,4,1,0,1
2020,243142,42,0,7,4,3
2020,243142,42,3,2,0,2
2020,243142,42,4,5,4,1
2020,243142,43,0,17,8,9
2020,243142,43,3,5,2,3
2020,243142,43,4,12,6,6
2020,243142,45,0,1,0,1
2020,243142,45,4,1,0,1
2020,243151,0,0,121,62,59
2020,243151,10,0,121,62,59
2020,243151,10,1,35,18,17
2020,243151,10,2,49,21,28
2020,243151,10,3,30,19,11
2020,243151,10,4,7,4,3
2020,243151,20,0,71,41,30
2020,243151,20,1,35,18,17
2020,243151,20,2,8,5,3
2020,243151,20,3,28,18,10
2020,243151,30,0,7,2,5
2020,243151,30,2,5,1,4
2020,243151,30,3,2,1,1
2020,243151,40,0,43,19,24
2020,243151,40,2,36,15,21
2020,243151,40,4,7,4,3
2020,243151,43,0,43,19,24
2020,243151,43,2,36,15,21
2020,243151,43,4,7,4,3
2020,243160,0,0,9,5,4
2020,243160,10,0,4,3,1
2020,243160,10,1,1,1,0
2020,243160,10,2,2,1,1
2020,243160,10,3,1,1,0
2020,243160,20,0,3,2,1
2020,243160,20,2,2,1,1
2020,243160,20,3,1,1,0
2020,243160,40,0,1,1,0
2020,243160,40,1,1,1,0
2020,243160,42,0,1,1,0
2020,243160,42,1,1,1,0
2020,243160,50,0,5,2,3
2020,243179,0,0,150,74,76
2020,243179,10,0,150,74,76
2020,243179,10,1,82,44,38
2020,243179,10,2,26,12,14
2020,243179,10,3,25,13,12
2020,243179,10,4,17,5,12
2020,243179,20,0,113,61,52
2020,243179,20,1,82,44,38
2020,243179,20,2,24,11,13
2020,243179,20,3,7,6,1
2020,243179,30,0,5,1,4
2020,243179,30,2,2,1,1
2020,243179,30,3,2,0,2
2020,243179,30,4,1,0,1
2020,243179,40,0,32,12,20
2020,243179,40,3,16,7,9
2020,243179,40,4,16,5,11
2020,243179,42,0,1,1,0
2020,243179,42,3,1,1,0
2020,243179,43,0,31,11,20
2020,243179,43,3,15,6,9
2020,243179,43,4,16,5,11
2020,243188,0,0,43,21,22
2020,243188,10,0,43,21,22
2020,243188,10,1,17,9,8
2020,243188,10,2,9,4,5
2020,243188,10,3,7,3,4
2020,243188,10,4,10,5,5
2020,243188,20,0,30,15,15
2020,243188,20,1,17,9,8
2020,243188,20,2,9,4,5
2020,243188,20,3,3,1,2
2020,243188,20,4,1,1,0
2020,243188,40,0,13,6,7
2020,243188,40,3,4,2,2
2020,243188,40,4,9,4,5
2020,243188,43,0,13,6,7
2020,243188,43,3,4,2,2
2020,243188,43,4,9,4,5
2020,243197,0,0,479,304,175
2020,243197,10,0,479,304,175
2020,243197,10,1,316,216,100
2020,243197,10,2,84,48,36
2020,243197,10,3,79,40,39
2020,243197,20,0,398,263,135
2020,243197,20,1,314,215,99
2020,243197,20,2,77,44,33
2020,243197,20,3,7,4,3
2020,243197,30,0,12,6,6
2020,243197,30,1,1,0,1
2020,243197,30,2,7,4,3
2020,243197,30,3,4,2,2
2020,243197,40,0,69,35,34
2020,243197,40,1,1,1,0
2020,243197,40,3,68,34,34
2020,243197,42,0,69,35,34
2020,243197,42,1,1,1,0
2020,243197,42,3,68,34,34
2020,243203,0,0,598,236,362
2020,243203,10,0,598,236,362
2020,243203,10,1,277,118,159
2020,243203,10,2,130,54,76
2020,243203,10,3,127,53,74
2020,243203,10,4,21,5,16
2020,243203,10,6,43,6,37
2020,243203,20,0,356,148,208
2020,243203,20,1,247,106,141
2020,243203,20,2,77,31,46
2020,243203,20,3,28,11,17
2020,243203,20,4,4,0,4
2020,243203,30,0,59,23,36
2020,243203,30,1,14,5,9
2020,243203,30,2,20,9,11
2020,243203,30,3,20,8,12
2020,243203,30,4,4,1,3
2020,243203,30,6,1,0,1
2020,243203,40,0,183,65,118
2020,243203,40,1,16,7,9
2020,243203,40,2,33,14,19
2020,243203,40,3,79,34,45
2020,243203,40,4,13,4,9
2020,243203,40,6,42,6,36
2020,243203,42,0,183,65,118
2020,243203,42,1,16,7,9
2020,243203,42,2,33,14,19
2020,243203,42,3,79,34,45
2020,243203,42,4,13,4,9
2020,243203,42,6,42,6,36
2020,243212,0,0,72,30,42
2020,243212,10,0,72,30,42
2020,243212,10,1,26,11,15
2020,243212,10,2,20,7,13
2020,243212,10,3,16,4,12
2020,243212,10,4,10,8,2
2020,243212,20,0,58,26,32
2020,243212,20,1,26,11,15
2020,243212,20,2,18,6,12
2020,243212,20,3,9,4,5
2020,243212,20,4,5,5,0
2020,243212,30,0,4,1,3
2020,243212,30,2,2,1,1
2020,243212,30,3,2,0,2
2020,243212,40,0,10,3,7
2020,243212,40,3,5,0,5
2020,243212,40,4,5,3,2
2020,243212,42,0,6,1,5
2020,243212,42,3,3,0,3
2020,243212,42,4,3,1,2
2020,243212,43,0,4,2,2
2020,243212,43,3,2,0,2
2020,243212,43,4,2,2,0
2020,243221,0,0,719,386,333
2020,243221,10,0,719,386,333
2020,243221,10,1,396,229,167
2020,243221,10,2,91,42,49
2020,243221,10,3,143,72,71
2020,243221,10,4,89,43,46
2020,243221,20,0,523,289,234
2020,243221,20,1,394,229,165
2020,243221,20,2,89,42,47
2020,243221,20,3,34,15,19
2020,243221,20,4,6,3,3
2020,243221,30,0,22,12,10
2020,243221,30,2,2,0,2
2020,243221,30,3,20,12,8
2020,243221,40,0,174,85,89
2020,243221,40,1,2,0,2
2020,243221,40,3,89,45,44
2020,243221,40,4,83,40,43
2020,243221,42,0,54,27,27
2020,243221,42,3,33,16,17
2020,243221,42,4,21,11,10
2020,243221,43,0,120,58,62
2020,243221,43,1,2,0,2
2020,243221,43,3,56,29,27
2020,243221,43,4,62,29,33
2020,243346,0,0,109,48,61
2020,243346,10,0,109,48,61
2020,243346,10,1,12,6,6
2020,243346,10,2,20,6,14
2020,243346,10,3,32,13,19
2020,243346,10,4,45,23,22
2020,243346,20,0,5,3,2
2020,243346,20,1,2,1,1
2020,243346,20,2,2,1,1
2020,243346,20,3,1,1,0
2020,243346,40,0,104,45,59
2020,243346,40,1,10,5,5
2020,243346,40,2,18,5,13
2020,243346,40,3,31,12,19
2020,243346,40,4,45,23,22
2020,243346,41,0,69,30,39
2020,243346,41,1,10,5,5
2020,243346,41,2,18,5,13
2020,243346,41,3,23,7,16
2020,243346,41,4,18,13,5
2020,243346,42,0,34,14,20
2020,243346,42,3,7,4,3
2020,243346,42,4,27,10,17
2020,243346,43,0,1,1,0
2020,243346,43,3,1,1,0
2020,243346,44,0,69,30,39
2020,243346,44,1,10,5,5
2020,243346,44,2,18,5,13
2020,243346,44,3,23,7,16
2020,243346,44,4,18,13,5
2020,243443,0,0,76,28,48
2020,243443,10,0,63,21,42
2020,243443,10,1,23,8,15
2020,243443,10,2,7,1,6
2020,243443,10,3,13,5,8
2020,243443,10,4,20,7,13
2020,243443,20,0,46,16,30
2020,243443,20,1,23,8,15
2020,243443,20,2,7,1,6
2020,243443,20,3,11,4,7
2020,243443,20,4,5,3,2
2020,243443,40,0,17,5,12
2020,243443,40,3,2,1,1
2020,243443,40,4,15,4,11
2020,243443,42,0,6,2,4
2020,243443,42,3,2,1,1
2020,243443,42,4,4,1,3
2020,243443,43,0,11,3,8
2020,243443,43,4,11,3,8
2020,243443,50,0,13,7,6
2020,243498,0,0,5,4,1
2020,243498,10,0,5,4,1
2020,243498,10,1,5,4,1
2020,243498,20,0,5,4,1
2020,243498,20,1,5,4,1
2020,243568,0,0,45,18,27
2020,243568,10,0,45,18,27
2020,243568,10,1,14,7,7
2020,243568,10,2,14,6,8
2020,243568,10,3,14,4,10
2020,243568,10,4,3,1,2
2020,243568,40,0,45,18,27
2020,243568,40,1,14,7,7
2020,243568,40,2,14,6,8
2020,243568,40,3,14,4,10
2020,243568,40,4,3,1,2
2020,243568,41,0,45,18,27
2020,243568,41,1,14,7,7
2020,243568,41,2,14,6,8
2020,243568,41,3,14,4,10
2020,243568,41,4,3,1,2
2020,243568,44,0,45,18,27
2020,243568,44,1,14,7,7
2020,243568,44,2,14,6,8
2020,243568,44,3,14,4,10
2020,243568,44,4,3,1,2
2020,243577,0,0,125,81,44
2020,243577,10,0,125,81,44
2020,243577,10,1,31,24,7
2020,243577,10,2,74,44,30
2020,243577,10,3,15,10,5
2020,243577,10,4,5,3,2
2020,243577,40,0,125,81,44
2020,243577,40,1,31,24,7
2020,243577,40,2,74,44,30
2020,243577,40,3,15,10,5
2020,243577,40,4,5,3,2
2020,243577,41,0,125,81,44
2020,243577,41,1,31,24,7
2020,243577,41,2,74,44,30
2020,243577,41,3,15,10,5
2020,243577,41,4,5,3,2
2020,243577,44,0,125,81,44
2020,243577,44,1,31,24,7
2020,243577,44,2,74,44,30
2020,243577,44,3,15,10,5
2020,243577,44,4,5,3,2
2020,243586,0,0,37,17,20
2020,243586,10,0,37,17,20
2020,243586,10,1,4,3,1
2020,243586,10,2,5,4,1
2020,243586,10,3,21,9,12
2020,243586,10,4,2,0,2
2020,243586,10,6,5,1,4
2020,243586,40,0,37,17,20
2020,243586,40,1,4,3,1
2020,243586,40,2,5,4,1
2020,243586,40,3,21,9,12
2020,243586,40,4,2,0,2
2020,243586,40,6,5,1,4
2020,243586,41,0,29,16,13
2020,243586,41,1,4,3,1
2020,243586,41,2,5,4,1
2020,243586,41,3,19,9,10
2020,243586,41,4,1,0,1
2020,243586,42,0,3,0,3
2020,243586,42,3,2,0,2
2020,243586,42,4,1,0,1
2020,243586,43,0,5,1,4
2020,243586,43,6,5,1,4
2020,243586,45,0,29,16,13
2020,243586,45,1,4,3,1
2020,243586,45,2,5,4,1
2020,243586,45,3,19,9,10
2020,243586,45,4,1,0,1
2020,243601,0,0,171,80,91
2020,243601,10,0,171,80,91
2020,243601,10,1,26,14,12
2020,243601,10,2,30,12,18
2020,243601,10,3,76,35,41
2020,243601,10,4,39,19,20
2020,243601,20,0,19,8,11
2020,243601,20,1,12,4,8
2020,243601,20,2,6,3,3
2020,243601,20,3,1,1,0
2020,243601,40,0,152,72,80
2020,243601,40,1,14,10,4
2020,243601,40,2,24,9,15
2020,243601,40,3,75,34,41
2020,243601,40,4,39,19,20
2020,243601,41,0,99,49,50
2020,243601,41,1,14,10,4
2020,243601,41,2,24,9,15
2020,243601,41,3,46,21,25
2020,243601,41,4,15,9,6
2020,243601,42,0,53,23,30
2020,243601,42,3,29,13,16
2020,243601,42,4,24,10,14
2020,243601,44,0,99,49,50
2020,243601,44,1,14,10,4
2020,243601,44,2,24,9,15
2020,243601,44,3,46,21,25
2020,243601,44,4,15,9,6
2020,243638,0,0,102,60,42
2020,243638,10,0,102,60,42
2020,243638,10,1,50,32,18
2020,243638,10,2,15,9,6
2020,243638,10,3,12,6,6
2020,243638,10,4,25,13,12
2020,243638,40,0,102,60,42
2020,243638,40,1,50,32,18
2020,243638,40,2,15,9,6
2020,243638,40,3,12,6,6
2020,243638,40,4,25,13,12
2020,243638,41,0,102,60,42
2020,243638,41,1,50,32,18
2020,243638,41,2,15,9,6
2020,243638,41,3,12,6,6
2020,243638,41,4,25,13,12
2020,243638,44,0,102,60,42
2020,243638,44,1,50,32,18
2020,243638,44,2,15,9,6
2020,243638,44,3,12,6,6
2020,243638,44,4,25,13,12
2020,243647,0,0,33,16,17
2020,243647,10,0,33,16,17
2020,243647,10,2,12,5,7
2020,243647,10,4,17,8,9
2020,243647,10,5,4,3,1
2020,243647,40,0,33,16,17
2020,243647,40,2,12,5,7
2020,243647,40,4,17,8,9
2020,243647,40,5,4,3,1
2020,243647,41,0,33,16,17
2020,243647,41,2,12,5,7
2020,243647,41,4,17,8,9
2020,243647,41,5,4,3,1
2020,243647,44,0,33,16,17
2020,243647,44,2,12,5,7
2020,243647,44,4,17,8,9
2020,243647,44,5,4,3,1
2020,243665,0,0,108,46,62
2020,243665,10,0,108,46,62
2020,243665,10,1,20,15,5
2020,243665,10,2,29,16,13
2020,243665,10,3,46,12,34
2020,243665,10,4,13,3,10
2020,243665,20,0,35,25,10
2020,243665,20,1,14,11,3
2020,243665,20,2,17,12,5
2020,243665,20,3,4,2,2
2020,243665,30,0,21,6,15
2020,243665,30,2,5,1,4
2020,243665,30,3,16,5,11
2020,243665,40,0,52,15,37
2020,243665,40,1,6,4,2
2020,243665,40,2,7,3,4
2020,243665,40,3,26,5,21
2020,243665,40,4,13,3,10
2020,243665,41,0,21,6,15
2020,243665,41,1,2,0,2
2020,243665,41,2,4,2,2
2020,243665,41,3,11,2,9
2020,243665,41,4,4,2,2
2020,243665,42,0,29,9,20
2020,243665,42,1,4,4,0
2020,243665,42,2,3,1,2
2020,243665,42,3,15,3,12
2020,243665,42,4,7,1,6
2020,243665,43,0,2,0,2
2020,243665,43,4,2,0,2
2020,243665,44,0,20,6,14
2020,243665,44,1,2,0,2
2020,243665,44,2,4,2,2
2020,243665,44,3,10,2,8
2020,243665,44,4,4,2,2
2020,243665,45,0,1,0,1
2020,243665,45,3,1,0,1
2020,243744,0,0,3724,2217,1507
2020,243744,10,0,2106,1459,647
2020,243744,10,1,1240,942,298
2020,243744,10,2,443,278,165
2020,243744,10,3,423,239,184
2020,243744,20,0,1170,877,293
2020,243744,20,1,913,711,202
2020,243744,20,2,257,166,91
2020,243744,30,0,336,198,138
2020,243744,30,1,7,6,1
2020,243744,30,2,33,20,13
2020,243744,30,3,296,172,124
2020,243744,40,0,600,384,216
2020,243744,40,1,320,225,95
2020,243744,40,2,153,92,61
2020,243744,40,3,127,67,60
2020,243744,41,0,600,384,216
2020,243744,41,1,320,225,95
2020,243744,41,2,153,92,61
2020,243744,41,3,127,67,60
2020,243744,44,0,600,384,216
2020,243744,44,1,320,225,95
2020,243744,44,2,153,92,61
2020,243744,44,3,127,67,60
2020,243744,50,0,1618,758,860
2020,243780,0,0,2039,1369,670
2020,243780,10,0,1814,1266,548
2020,243780,10,1,814,633,181
2020,243780,10,2,474,307,167
2020,243780,10,3,523,324,199
2020,243780,10,4,3,2,1
2020,243780,20,0,1266,922,344
2020,243780,20,1,806,625,181
2020,243780,20,2,459,296,163
2020,243780,20,3,1,1,0
2020,243780,30,0,481,301,180
2020,243780,30,1,2,2,0
2020,243780,30,2,14,10,4
2020,243780,30,3,465,289,176
2020,243780,40,0,67,43,24
2020,243780,40,1,6,6,0
2020,243780,40,2,1,1,0
2020,243780,40,3,57,34,23
2020,243780,40,4,3,2,1
2020,243780,41,0,41,26,15
2020,243780,41,1,3,3,0
2020,243780,41,2,1,1,0
2020,243780,41,3,37,22,15
2020,243780,42,0,20,13,7
2020,243780,42,3,18,11,7
2020,243780,42,4,2,2,0
2020,243780,43,0,6,4,2
2020,243780,43,1,3,3,0
2020,243780,43,3,2,1,1
2020,243780,43,4,1,0,1
2020,243780,44,0,38,24,14
2020,243780,44,1,1,1,0
2020,243780,44,2,1,1,0
2020,243780,44,3,36,22,14
2020,243780,45,0,3,2,1
2020,243780,45,1,2,2,0
2020,243780,45,3,1,0,1
2020,243780,50,0,225,103,122
2020,243823,0,0,78,44,34
2020,243823,10,0,73,43,30
2020,243823,10,1,12,8,4
2020,243823,10,2,10,5,5
2020,243823,10,3,31,20,11
2020,243823,10,4,20,10,10
2020,243823,40,0,73,43,30
2020,243823,40,1,12,8,4
2020,243823,40,2,10,5,5
2020,243823,40,3,31,20,11
2020,243823,40,4,20,10,10
2020,243823,41,0,20,10,10
2020,243823,41,4,20,10,10
2020,243823,42,0,53,33,20
2020,243823,42,1,12,8,4
2020,243823,42,2,10,5,5
2020,243823,42,3,31,20,11
2020,243823,45,0,20,10,10
2020,243823,45,4,20,10,10
2020,243823,50,0,5,1,4
2020,243832,0,0,36,15,21
2020,243832,10,0,36,15,21
2020,243832,10,4,36,15,21
2020,243832,40,0,36,15,21
2020,243832,40,4,36,15,21
2020,243832,42,0,36,15,21
2020,243832,42,4,36,15,21
2020,243841,0,0,14,5,9
2020,243841,10,0,14,5,9
2020,243841,10,4,14,5,9
2020,243841,40,0,14,5,9
2020,243841,40,4,14,5,9
2020,243841,43,0,14,5,9
2020,243841,43,4,14,5,9
2020,244233,0,0,5,2,3
2020,244233,10,0,5,2,3
2020,244233,10,4,5,2,3
2020,244233,40,0,5,2,3
2020,244233,40,4,5,2,3
2020,244233,41,0,5,2,3
2020,244233,41,4,5,2,3
2020,244233,45,0,5,2,3
2020,244233,45,4,5,2,3
2020,244437,0,0,442,177,265
2020,244437,10,0,436,174,262
2020,244437,10,1,42,21,21
2020,244437,10,2,147,65,82
2020,244437,10,3,119,44,75
2020,244437,10,4,35,10,25
2020,244437,10,5,61,24,37
2020,244437,10,6,32,10,22
2020,244437,20,0,240,100,140
2020,244437,20,1,42,21,21
2020,244437,20,2,144,64,80
2020,244437,20,3,54,15,39
2020,244437,30,0,93,36,57
2020,244437,30,2,3,1,2
2020,244437,30,3,64,29,35
2020,244437,30,4,26,6,20
2020,244437,40,0,103,38,65
2020,244437,40,3,1,0,1
2020,244437,40,4,9,4,5
2020,244437,40,5,61,24,37
2020,244437,40,6,32,10,22
2020,244437,41,0,2,1,1
2020,244437,41,4,1,1,0
2020,244437,41,6,1,0,1
2020,244437,42,0,101,37,64
2020,244437,42,3,1,0,1
2020,244437,42,4,8,3,5
2020,244437,42,5,61,24,37
2020,244437,42,6,31,10,21
2020,244437,45,0,2,1,1
2020,244437,45,4,1,1,0
2020,244437,45,6,1,0,1
2020,244437,50,0,6,3,3
2020,244446,0,0,79,39,40
2020,244446,10,0,79,39,40
2020,244446,10,6,79,39,40
2020,244446,40,0,79,39,40
2020,244446,40,6,79,39,40
2020,244446,41,0,79,39,40
2020,244446,41,6,79,39,40
2020,244446,44,0,79,39,40
2020,244446,44,6,79,39,40
2020,245625,0,0,22,7,15
2020,245625,10,0,15,5,10
2020,245625,10,1,8,4,4
2020,245625,10,2,5,1,4
2020,245625,10,3,2,0,2
2020,245625,20,0,15,5,10
2020,245625,20,1,8,4,4
2020,245625,20,2,5,1,4
2020,245625,20,3,2,0,2
2020,245625,50,0,7,2,5
2020,245652,0,0,34,24,10
2020,245652,10,0,34,24,10
2020,245652,10,6,34,24,10
2020,245652,20,0,27,22,5
2020,245652,20,6,27,22,5
2020,245652,30,0,7,2,5
2020,245652,30,6,7,2,5
2020,245838,0,0,31,15,16
2020,245838,50,0,31,15,16
2020,245847,0,0,6,2,4
2020,245847,50,0,6,2,4
2020,245865,0,0,56,16,40
2020,245865,50,0,56,16,40
2020,245883,0,0,62,14,48
2020,245883,50,0,62,14,48
2020,245953,0,0,31,16,15
2020,245953,10,0,31,16,15
2020,245953,10,1,7,4,3
2020,245953,10,2,11,7,4
2020,245953,10,3,11,4,7
2020,245953,10,4,2,1,1
2020,245953,40,0,31,16,15
2020,245953,40,1,7,4,3
2020,245953,40,2,11,7,4
2020,245953,40,3,11,4,7
2020,245953,40,4,2,1,1
2020,245953,42,0,31,16,15
2020,245953,42,1,7,4,3
2020,245953,42,2,11,7,4
2020,245953,42,3,11,4,7
2020,245953,42,4,2,1,1
2020,245962,0,0,8,3,5
2020,245962,10,0,8,3,5
2020,245962,10,4,8,3,5
2020,245962,40,0,8,3,5
2020,245962,40,4,8,3,5
2020,245962,41,0,8,3,5
2020,245962,41,4,8,3,5
2020,245962,45,0,8,3,5
2020,245962,45,4,8,3,5
2020,246354,0,0,139,72,67
2020,246354,10,0,111,55,56
2020,246354,10,1,26,13,13
2020,246354,10,2,13,7,6
2020,246354,10,3,30,17,13
2020,246354,10,4,42,18,24
2020,246354,20,0,59,30,29
2020,246354,20,1,26,13,13
2020,246354,20,2,9,5,4
2020,246354,20,3,16,9,7
2020,246354,20,4,8,3,5
2020,246354,40,0,52,25,27
2020,246354,40,2,4,2,2
2020,246354,40,3,14,8,6
2020,246354,40,4,34,15,19
2020,246354,42,0,52,25,27
2020,246354,42,2,4,2,2
2020,246354,42,3,14,8,6
2020,246354,42,4,34,15,19
2020,246354,50,0,28,17,11
2020,246813,0,0,98,45,53
2020,246813,10,0,98,45,53
2020,246813,10,6,98,45,53
2020,246813,40,0,98,45,53
2020,246813,40,6,98,45,53
2020,246813,41,0,98,45,53
2020,246813,41,6,98,45,53
2020,246813,45,0,98,45,53
2020,246813,45,6,98,45,53
2020,246974,0,0,5,2,3
2020,246974,10,0,5,2,3
2020,246974,10,4,5,2,3
2020,246974,40,0,5,2,3
2020,246974,40,4,5,2,3
2020,246974,41,0,5,2,3
2020,246974,41,4,5,2,3
2020,246974,45,0,5,2,3
2020,246974,45,4,5,2,3
2020,247065,0,0,13,2,11
2020,247065,10,0,13,2,11
2020,247065,10,4,13,2,11
2020,247065,40,0,13,2,11
2020,247065,40,4,13,2,11
2020,247065,41,0,13,2,11
2020,247065,41,4,13,2,11
2020,247065,45,0,13,2,11
2020,247065,45,4,13,2,11
2020,247603,0,0,21,8,13
2020,247603,10,0,21,8,13
2020,247603,10,1,5,2,3
2020,247603,10,2,6,3,3
2020,247603,10,3,6,1,5
2020,247603,10,4,4,2,2
2020,247603,20,0,18,6,12
2020,247603,20,1,5,2,3
2020,247603,20,2,6,3,3
2020,247603,20,3,6,1,5
2020,247603,20,4,1,0,1
2020,247603,30,0,3,2,1
2020,247603,30,4,3,2,1
2020,247649,0,0,56,29,27
2020,247649,10,0,56,29,27
2020,247649,10,1,9,3,6
2020,247649,10,2,30,15,15
2020,247649,10,3,16,11,5
2020,247649,10,6,1,0,1
2020,247649,40,0,56,29,27
2020,247649,40,1,9,3,6
2020,247649,40,2,30,15,15
2020,247649,40,3,16,11,5
2020,247649,40,6,1,0,1
2020,247649,41,0,56,29,27
2020,247649,41,1,9,3,6
2020,247649,41,2,30,15,15
2020,247649,41,3,16,11,5
2020,247649,41,6,1,0,1
2020,247649,45,0,56,29,27
2020,247649,45,1,9,3,6
2020,247649,45,2,30,15,15
2020,247649,45,3,16,11,5
2020,247649,45,6,1,0,1
2020,247834,0,0,522,220,302
2020,247834,10,0,522,220,302
2020,247834,10,6,522,220,302
2020,247834,40,0,522,220,302
2020,247834,40,6,522,220,302
2020,247834,41,0,326,135,191
2020,247834,41,6,326,135,191
2020,247834,42,0,196,85,111
2020,247834,42,6,196,85,111
2020,247834,44,0,326,135,191
2020,247834,44,6,326,135,191
2020,247940,0,0,74,41,33
2020,247940,10,0,74,41,33
2020,247940,10,1,29,15,14
2020,247940,10,2,23,11,12
2020,247940,10,3,9,6,3
2020,247940,10,4,13,9,4
2020,247940,20,0,21,12,9
2020,247940,20,1,16,9,7
2020,247940,20,2,5,3,2
2020,247940,30,0,1,0,1
2020,247940,30,3,1,0,1
2020,247940,40,0,52,29,23
2020,247940,40,1,13,6,7
2020,247940,40,2,18,8,10
2020,247940,40,3,8,6,2
2020,247940,40,4,13,9,4
2020,247940,42,0,13,9,4
2020,247940,42,1,3,2,1
2020,247940,42,2,3,2,1
2020,247940,42,3,3,2,1
2020,247940,42,4,4,3,1
2020,247940,43,0,39,20,19
2020,247940,43,1,10,4,6
2020,247940,43,2,15,6,9
2020,247940,43,3,5,4,1
2020,247940,43,4,9,6,3
2020,248934,0,0,415,149,266
2020,248934,10,0,411,145,266
2020,248934,10,1,25,14,11
2020,248934,10,2,159,93,66
2020,248934,10,4,227,38,189
2020,248934,40,0,411,145,266
2020,248934,40,1,25,14,11
2020,248934,40,2,159,93,66
2020,248934,40,4,227,38,189
2020,248934,41,0,411,145,266
2020,248934,41,1,25,14,11
2020,248934,41,2,159,93,66
2020,248934,41,4,227,38,189
2020,248934,45,0,411,145,266
2020,248934,45,1,25,14,11
2020,248934,45,2,159,93,66
2020,248934,45,4,227,38,189
2020,248934,50,0,4,4,0
2020,250027,0,0,21,10,11
2020,250027,10,0,21,10,11
2020,250027,10,4,21,10,11
2020,250027,40,0,21,10,11
2020,250027,40,4,21,10,11
2020,250027,41,0,21,10,11
2020,250027,41,4,21,10,11
2020,250027,45,0,21,10,11
2020,250027,45,4,21,10,11
2020,251260,0,0,93,38,55
2020,251260,10,0,93,38,55
2020,251260,10,6,93,38,55
2020,251260,20,0,67,27,40
2020,251260,20,6,67,27,40
2020,251260,30,0,26,11,15
2020,251260,30,6,26,11,15
2020,251312,0,0,19,5,14
2020,251312,10,0,19,5,14
2020,251312,10,2,1,0,1
2020,251312,10,3,12,4,8
2020,251312,10,4,6,1,5
2020,251312,40,0,19,5,14
2020,251312,40,2,1,0,1
2020,251312,40,3,12,4,8
2020,251312,40,4,6,1,5
2020,251312,41,0,19,5,14
2020,251312,41,2,1,0,1
2020,251312,41,3,12,4,8
2020,251312,41,4,6,1,5
2020,251312,45,0,19,5,14
2020,251312,45,2,1,0,1
2020,251312,45,3,12,4,8
2020,251312,45,4,6,1,5
2020,260372,0,0,14,7,7
2020,260372,10,0,13,7,6
2020,260372,10,4,13,7,6
2020,260372,40,0,13,7,6
2020,260372,40,4,13,7,6
2020,260372,41,0,13,7,6
2020,260372,41,4,13,7,6
2020,260372,45,0,13,7,6
2020,260372,45,4,13,7,6
2020,260372,50,0,1,0,1
2020,260691,0,0,49,13,36
2020,260691,10,0,49,13,36
2020,260691,10,4,49,13,36
2020,260691,40,0,49,13,36
2020,260691,40,4,49,13,36
2020,260691,41,0,49,13,36
2020,260691,41,4,49,13,36
2020,260691,45,0,49,13,36
2020,260691,45,4,49,13,36
2020,260789,0,0,17,5,12
2020,260789,10,0,17,5,12
2020,260789,10,4,17,5,12
2020,260789,40,0,17,5,12
2020,260789,40,4,17,5,12
2020,260789,41,0,17,5,12
2020,260789,41,4,17,5,12
2020,260789,45,0,17,5,12
2020,260789,45,4,17,5,12
2020,260813,0,0,10,3,7
2020,260813,10,0,10,3,7
2020,260813,10,4,10,3,7
2020,260813,40,0,10,3,7
2020,260813,40,4,10,3,7
2020,260813,42,0,10,3,7
2020,260813,42,4,10,3,7
2020,260992,0,0,21,3,18
2020,260992,10,0,21,3,18
2020,260992,10,1,3,1,2
2020,260992,10,2,9,2,7
2020,260992,10,3,5,0,5
2020,260992,10,4,4,0,4
2020,260992,40,0,21,3,18
2020,260992,40,1,3,1,2
2020,260992,40,2,9,2,7
2020,260992,40,3,5,0,5
2020,260992,40,4,4,0,4
2020,260992,41,0,21,3,18
2020,260992,41,1,3,1,2
2020,260992,41,2,9,2,7
2020,260992,41,3,5,0,5
2020,260992,41,4,4,0,4
2020,260992,45,0,21,3,18
2020,260992,45,1,3,1,2
2020,260992,45,2,9,2,7
2020,260992,45,3,5,0,5
2020,260992,45,4,4,0,4
2020,262031,0,0,101,36,65
2020,262031,10,0,101,36,65
2020,262031,10,1,33,12,21
2020,262031,10,2,24,13,11
2020,262031,10,3,22,6,16
2020,262031,10,4,22,5,17
2020,262031,20,0,69,26,43
2020,262031,20,1,33,12,21
2020,262031,20,2,21,10,11
2020,262031,20,3,11,4,7
2020,262031,20,4,4,0,4
2020,262031,30,0,22,8,14
2020,262031,30,2,2,2,0
2020,262031,30,3,8,2,6
2020,262031,30,4,12,4,8
2020,262031,40,0,10,2,8
2020,262031,40,2,1,1,0
2020,262031,40,3,3,0,3
2020,262031,40,4,6,1,5
2020,262031,42,0,10,2,8
2020,262031,42,2,1,1,0
2020,262031,42,3,3,0,3
2020,262031,42,4,6,1,5
2020,262086,0,0,97,29,68
2020,262086,10,0,97,29,68
2020,262086,10,1,18,10,8
2020,262086,10,2,40,12,28
2020,262086,10,3,39,7,32
2020,262086,40,0,97,29,68
2020,262086,40,1,18,10,8
2020,262086,40,2,40,12,28
2020,262086,40,3,39,7,32
2020,262086,41,0,70,23,47
2020,262086,41,1,17,9,8
2020,262086,41,2,35,10,25
2020,262086,41,3,18,4,14
2020,262086,42,0,27,6,21
2020,262086,42,1,1,1,0
2020,262086,42,2,5,2,3
2020,262086,42,3,21,3,18
2020,262086,44,0,70,23,47
2020,262086,44,1,17,9,8
2020,262086,44,2,35,10,25
2020,262086,44,3,18,4,14
2020,262129,0,0,108,49,59
2020,262129,10,0,108,49,59
2020,262129,10,1,31,18,13
2020,262129,10,2,25,6,19
2020,262129,10,3,45,24,21
2020,262129,10,4,4,0,4
2020,262129,10,6,3,1,2
2020,262129,20,0,55,23,32
2020,262129,20,1,30,17,13
2020,262129,20,2,25,6,19
2020,262129,30,0,34,20,14
2020,262129,30,1,1,1,0
2020,262129,30,3,33,19,14
2020,262129,40,0,19,6,13
2020,262129,40,3,12,5,7
2020,262129,40,4,4,0,4
2020,262129,40,6,3,1,2
2020,262129,42,0,19,6,13
2020,262129,42,3,12,5,7
2020,262129,42,4,4,0,4
2020,262129,42,6,3,1,2
2020,262457,0,0,12,2,10
2020,262457,10,0,12,2,10
2020,262457,10,4,12,2,10
2020,262457,40,0,12,2,10
2020,262457,40,4,12,2,10
2020,262457,41,0,12,2,10
2020,262457,41,4,12,2,10
2020,262457,45,0,12,2,10
2020,262457,45,4,12,2,10
2020,363633,0,0,24,8,16
2020,363633,10,0,24,8,16
2020,363633,10,4,24,8,16
2020,363633,40,0,24,8,16
2020,363633,40,4,24,8,16
2020,363633,42,0,3,2,1
2020,363633,42,4,3,2,1
2020,363633,43,0,21,6,15
2020,363633,43,4,21,6,15
2020,363721,0,0,26,9,17
2020,363721,10,0,23,9,14
2020,363721,10,1,16,5,11
2020,363721,10,2,5,2,3
2020,363721,10,3,2,2,0
2020,363721,20,0,17,6,11
2020,363721,20,1,16,5,11
2020,363721,20,2,1,1,0
2020,363721,30,0,6,3,3
2020,363721,30,2,4,1,3
2020,363721,30,3,2,2,0
2020,363721,50,0,3,0,3
2020,363907,0,0,17,5,12
2020,363907,10,0,17,5,12
2020,363907,10,1,1,1,0
2020,363907,10,3,6,3,3
2020,363907,10,4,10,1,9
2020,363907,40,0,17,5,12
2020,363907,40,1,1,1,0
2020,363907,40,3,6,3,3
2020,363907,40,4,10,1,9
2020,363907,42,0,17,5,12
2020,363907,42,1,1,1,0
2020,363907,42,3,6,3,3
2020,363907,42,4,10,1,9
2020,363934,0,0,35,21,14
2020,363934,10,0,28,19,9
2020,363934,10,1,28,19,9
2020,363934,40,0,28,19,9
2020,363934,40,1,28,19,9
2020,363934,41,0,28,19,9
2020,363934,41,1,28,19,9
2020,363934,45,0,28,19,9
2020,363934,45,1,28,19,9
2020,363934,50,0,7,2,5
2020,364016,0,0,113,53,60
2020,364016,10,0,113,53,60
2020,364016,10,6,113,53,60
2020,364016,20,0,85,44,41
2020,364016,20,6,85,44,41
2020,364016,30,0,22,5,17
2020,364016,30,6,22,5,17
2020,364016,40,0,6,4,2
2020,364016,40,6,6,4,2
2020,364016,42,0,6,4,2
2020,364016,42,6,6,4,2
2020,364025,0,0,138,56,82
2020,364025,10,0,138,56,82
2020,364025,10,6,138,56,82
2020,364025,20,0,81,32,49
2020,364025,20,6,81,32,49
2020,364025,30,0,50,21,29
2020,364025,30,6,50,21,29
2020,364025,40,0,7,3,4
2020,364025,40,6,7,3,4
2020,364025,42,0,7,3,4
2020,364025,42,6,7,3,4
2020,365204,0,0,91,21,70
2020,365204,50,0,91,21,70
2020,366003,0,0,7,5,2
2020,366003,10,0,7,5,2
2020,366003,10,1,7,5,2
2020,366003,40,0,7,5,2
2020,366003,40,1,7,5,2
2020,366003,41,0,6,4,2
2020,366003,41,1,6,4,2
2020,366003,43,0,1,1,0
2020,366003,43,1,1,1,0
2020,366003,45,0,6,4,2
2020,366003,45,1,6,4,2
2020,366252,0,0,279,193,86
2020,366252,10,0,279,193,86
2020,366252,10,1,10,9,1
2020,366252,10,2,42,23,19
2020,366252,10,3,93,64,29
2020,366252,10,4,125,91,34
2020,366252,10,5,9,6,3
2020,366252,40,0,279,193,86
2020,366252,40,1,10,9,1
2020,366252,40,2,42,23,19
2020,366252,40,3,93,64,29
2020,366252,40,4,125,91,34
2020,366252,40,5,9,6,3
2020,366252,42,0,275,190,85
2020,366252,42,1,10,9,1
2020,366252,42,2,42,23,19
2020,366252,42,3,93,64,29
2020,366252,42,4,124,90,34
2020,366252,42,5,6,4,2
2020,366252,43,0,4,3,1
2020,366252,43,4,1,1,0
2020,366252,43,5,3,2,1
2020,366270,0,0,16,1,15
2020,366270,10,0,16,1,15
2020,366270,10,4,16,1,15
2020,366270,40,0,16,1,15
2020,366270,40,4,16,1,15
2020,366270,41,0,16,1,15
2020,366270,41,4,16,1,15
2020,366270,45,0,16,1,15
2020,366270,45,4,16,1,15
2020,366340,0,0,8,4,4
2020,366340,10,0,8,4,4
2020,366340,10,4,8,4,4
2020,366340,40,0,8,4,4
2020,366340,40,4,8,4,4
2020,366340,42,0,7,4,3
2020,366340,42,4,7,4,3
2020,366340,43,0,1,0,1
2020,366340,43,4,1,0,1
2020,366368,0,0,6,4,2
2020,366368,10,0,6,4,2
2020,366368,10,1,6,4,2
2020,366368,40,0,6,4,2
2020,366368,40,1,6,4,2
2020,366368,41,0,5,3,2
2020,366368,41,1,5,3,2
2020,366368,42,0,1,1,0
2020,366368,42,1,1,1,0
2020,366368,44,0,5,3,2
2020,366368,44,1,5,3,2
2020,366395,0,0,288,150,138
2020,366395,10,0,288,150,138
2020,366395,10,1,135,65,70
2020,366395,10,2,81,45,36
2020,366395,10,3,56,29,27
2020,366395,10,4,16,11,5
2020,366395,20,0,167,87,80
2020,366395,20,1,116,54,62
2020,366395,20,2,35,22,13
2020,366395,20,3,16,11,5
2020,366395,30,0,121,63,58
2020,366395,30,1,19,11,8
2020,366395,30,2,46,23,23
2020,366395,30,3,40,18,22
2020,366395,30,4,16,11,5
2020,366401,0,0,128,65,63
2020,366401,10,0,128,65,63
2020,366401,10,4,128,65,63
2020,366401,20,0,99,48,51
2020,366401,20,4,99,48,51
2020,366401,30,0,25,13,12
2020,366401,30,4,25,13,12
2020,366401,40,0,4,4,0
2020,366401,40,4,4,4,0
2020,366401,43,0,4,4,0
2020,366401,43,4,4,4,0
2020,366465,0,0,65,27,38
2020,366465,50,0,65,27,38
2020,366535,0,0,9,4,5
2020,366535,50,0,9,4,5
2020,366553,0,0,50,9,41
2020,366553,10,0,50,9,41
2020,366553,10,4,50,9,41
2020,366553,40,0,50,9,41
2020,366553,40,4,50,9,41
2020,366553,41,0,50,9,41
2020,366553,41,4,50,9,41
2020,366553,45,0,50,9,41
2020,366553,45,4,50,9,41
2020,366711,0,0,392,174,218
2020,366711,10,0,392,174,218
2020,366711,10,1,110,57,53
2020,366711,10,2,89,47,42
2020,366711,10,3,75,36,39
2020,366711,10,5,117,34,83
2020,366711,10,6,1,0,1
2020,366711,20,0,195,100,95
2020,366711,20,1,110,57,53
2020,366711,20,2,84,43,41
2020,366711,20,6,1,0,1
2020,366711,30,0,80,40,40
2020,366711,30,2,5,4,1
2020,366711,30,3,75,36,39
2020,366711,40,0,117,34,83
2020,366711,40,5,117,34,83
2020,366711,41,0,83,23,60
2020,366711,41,5,83,23,60
2020,366711,42,0,30,11,19
2020,366711,42,5,30,11,19
2020,366711,43,0,4,0,4
2020,366711,43,5,4,0,4
2020,366711,44,0,83,23,60
2020,366711,44,5,83,23,60
2020,367112,0,0,6,1,5
2020,367112,10,0,6,1,5
2020,367112,10,4,6,1,5
2020,367112,40,0,6,1,5
2020,367112,40,4,6,1,5
2020,367112,41,0,6,1,5
2020,367112,41,4,6,1,5
2020,367112,45,0,6,1,5
2020,367112,45,4,6,1,5
2020,367459,0,0,153,65,88
2020,367459,10,0,153,65,88
2020,367459,10,1,30,12,18
2020,367459,10,2,12,5,7
2020,367459,10,3,3,0,3
2020,367459,10,4,30,14,16
2020,367459,10,6,78,34,44
2020,367459,40,0,153,65,88
2020,367459,40,1,30,12,18
2020,367459,40,2,12,5,7
2020,367459,40,3,3,0,3
2020,367459,40,4,30,14,16
2020,367459,40,6,78,34,44
2020,367459,42,0,152,65,87
2020,367459,42,1,30,12,18
2020,367459,42,2,12,5,7
2020,367459,42,3,3,0,3
2020,367459,42,4,30,14,16
2020,367459,42,6,77,34,43
2020,367459,43,0,1,0,1
2020,367459,43,6,1,0,1
2020,367884,0,0,21,8,13
2020,367884,10,0,21,8,13
2020,367884,10,6,21,8,13
2020,367884,40,0,21,8,13
2020,367884,40,6,21,8,13
2020,367884,41,0,5,2,3
2020,367884,41,6,5,2,3
2020,367884,42,0,15,6,9
2020,367884,42,6,15,6,9
2020,367884,43,0,1,0,1
2020,367884,43,6,1,0,1
2020,367884,44,0,5,2,3
2020,367884,44,6,5,2,3
2020,367954,0,0,199,61,138
2020,367954,10,0,199,61,138
2020,367954,10,1,7,2,5
2020,367954,10,2,26,9,17
2020,367954,10,3,112,37,75
2020,367954,10,4,45,12,33
2020,367954,10,5,1,0,1
2020,367954,10,6,8,1,7
2020,367954,40,0,199,61,138
2020,367954,40,1,7,2,5
2020,367954,40,2,26,9,17
2020,367954,40,3,112,37,75
2020,367954,40,4,45,12,33
2020,367954,40,5,1,0,1
2020,367954,40,6,8,1,7
2020,367954,41,0,199,61,138
2020,367954,41,1,7,2,5
2020,367954,41,2,26,9,17
2020,367954,41,3,112,37,75
2020,367954,41,4,45,12,33
2020,367954,41,5,1,0,1
2020,367954,41,6,8,1,7
2020,367954,45,0,199,61,138
2020,367954,45,1,7,2,5
2020,367954,45,2,26,9,17
2020,367954,45,3,112,37,75
2020,367954,45,4,45,12,33
2020,367954,45,5,1,0,1
2020,367954,45,6,8,1,7
2020,368443,0,0,11,4,7
2020,368443,10,0,11,4,7
2020,368443,10,4,11,4,7
2020,368443,40,0,11,4,7
2020,368443,40,4,11,4,7
2020,368443,41,0,11,4,7
2020,368443,41,4,11,4,7
2020,368443,45,0,11,4,7
2020,368443,45,4,11,4,7
2020,368452,0,0,3,3,0
2020,368452,10,0,3,3,0
2020,368452,10,4,3,3,0
2020,368452,40,0,3,3,0
2020,368452,40,4,3,3,0
2020,368452,43,0,3,3,0
2020,368452,43,4,3,3,0
2020,368629,0,0,21,3,18
2020,368629,10,0,21,3,18
2020,368629,10,4,21,3,18
2020,368629,40,0,21,3,18
2020,368629,40,4,21,3,18
2020,368629,41,0,21,3,18
2020,368629,41,4,21,3,18
2020,368629,45,0,21,3,18
2020,368629,45,4,21,3,18
2020,368911,0,0,73,22,51
2020,368911,10,0,73,22,51
2020,368911,10,4,73,22,51
2020,368911,40,0,73,22,51
2020,368911,40,4,73,22,51
2020,368911,41,0,73,22,51
2020,368911,41,4,73,22,51
2020,368911,45,0,73,22,51
2020,368911,45,4,73,22,51
2020,369002,0,0,12,8,4
2020,369002,10,0,12,8,4
2020,369002,10,1,5,3,2
2020,369002,10,2,3,3,0
2020,369002,10,3,4,2,2
2020,369002,20,0,5,3,2
2020,369002,20,1,5,3,2
2020,369002,30,0,7,5,2
2020,369002,30,2,3,3,0
2020,369002,30,3,4,2,2
2020,369400,0,0,50,50,0
2020,369400,50,0,50,50,0
2020,369516,0,0,6,4,2
2020,369516,50,0,6,4,2
2020,369659,0,0,4,2,2
2020,369659,10,0,4,2,2
2020,369659,10,6,4,2,2
2020,369659,40,0,4,2,2
2020,369659,40,6,4,2,2
2020,369659,42,0,4,2,2
2020,369659,42,6,4,2,2
2020,369668,0,0,20,13,7
2020,369668,10,0,20,13,7
2020,369668,10,4,20,13,7
2020,369668,40,0,20,13,7
2020,369668,40,4,20,13,7
2020,369668,41,0,20,13,7
2020,369668,41,4,20,13,7
2020,369668,44,0,20,13,7
2020,369668,44,4,20,13,7
2020,371964,0,0,10,7,3
2020,371964,10,0,10,7,3
2020,371964,10,6,10,7,3
2020,371964,40,0,10,7,3
2020,371964,40,6,10,7,3
2020,371964,41,0,10,7,3
2020,371964,41,6,10,7,3
2020,371964,45,0,10,7,3
2020,371964,45,6,10,7,3
2020,372073,0,0,2,1,1
2020,372073,10,0,2,1,1
2020,372073,10,4,2,1,1
2020,372073,40,0,2,1,1
2020,372073,40,4,2,1,1
2020,372073,41,0,2,1,1
2020,372073,41,4,2,1,1
2020,372073,45,0,2,1,1
2020,372073,45,4,2,1,1
2020,372329,0,0,23,4,19
2020,372329,10,0,23,4,19
2020,372329,10,4,23,4,19
2020,372329,40,0,23,4,19
2020,372329,40,4,23,4,19
2020,372329,41,0,23,4,19
2020,372329,41,4,23,4,19
2020,372329,44,0,23,4,19
2020,372329,44,4,23,4,19
2020,372718,0,0,8,1,7
2020,372718,50,0,8,1,7
2020,372921,0,0,10,3,7
2020,372921,10,0,10,3,7
2020,372921,10,4,10,3,7
2020,372921,40,0,10,3,7
2020,372921,40,4,10,3,7
2020,372921,41,0,10,3,7
2020,372921,41,4,10,3,7
2020,372921,45,0,10,3,7
2020,372921,45,4,10,3,7
2020,374024,0,0,14,3,11
2020,374024,10,0,14,3,11
2020,374024,10,4,14,3,11
2020,374024,40,0,14,3,11
2020,374024,40,4,14,3,11
2020,374024,41,0,14,3,11
2020,374024,41,4,14,3,11
2020,374024,45,0,14,3,11
2020,374024,45,4,14,3,11
2020,375416,0,0,12,3,9
2020,375416,50,0,12,3,9
2020,376224,0,0,2,0,2
2020,376224,10,0,2,0,2
2020,376224,10,1,2,0,2
2020,376224,20,0,2,0,2
2020,376224,20,1,2,0,2
2020,376321,0,0,46,10,36
2020,376321,10,0,35,7,28
2020,376321,10,1,35,7,28
2020,376321,40,0,35,7,28
2020,376321,40,1,35,7,28
2020,376321,41,0,35,7,28
2020,376321,41,1,35,7,28
2020,376321,44,0,35,7,28
2020,376321,44,1,35,7,28
2020,376321,50,0,11,3,8
2020,376385,0,0,17,10,7
2020,376385,10,0,17,10,7
2020,376385,10,1,17,10,7
2020,376385,40,0,17,10,7
2020,376385,40,1,17,10,7
2020,376385,43,0,17,10,7
2020,376385,43,1,17,10,7
2020,376695,0,0,57,36,21
2020,376695,10,0,57,36,21
2020,376695,10,4,57,36,21
2020,376695,40,0,57,36,21
2020,376695,40,4,57,36,21
2020,376695,41,0,55,35,20
2020,376695,41,4,55,35,20
2020,376695,42,0,2,1,1
2020,376695,42,4,2,1,1
2020,376695,44,0,55,35,20
2020,376695,44,4,55,35,20
2020,377111,0,0,16,8,8
2020,377111,50,0,16,8,8
2020,377218,0,0,6,6,0
2020,377218,50,0,6,6,0
2020,377342,0,0,1,0,1
2020,377342,50,0,1,0,1
2020,377449,0,0,10,4,6
2020,377449,50,0,10,4,6
2020,377458,0,0,15,6,9
2020,377458,50,0,15,6,9
2020,377555,0,0,211,104,107
2020,377555,10,0,211,104,107
2020,377555,10,1,40,23,17
2020,377555,10,2,92,46,46
2020,377555,10,3,72,32,40
2020,377555,10,5,7,3,4
2020,377555,20,0,91,50,41
2020,377555,20,1,33,19,14
2020,377555,20,2,58,31,27
2020,377555,30,0,47,21,26
2020,377555,30,3,47,21,26
2020,377555,40,0,73,33,40
2020,377555,40,1,7,4,3
2020,377555,40,2,34,15,19
2020,377555,40,3,25,11,14
2020,377555,40,5,7,3,4
2020,377555,41,0,68,32,36
2020,377555,41,1,7,4,3
2020,377555,41,2,34,15,19
2020,377555,41,3,24,11,13
2020,377555,41,5,3,2,1
2020,377555,42,0,5,1,4
2020,377555,42,3,1,0,1
2020,377555,42,5,4,1,3
2020,377555,44,0,68,32,36
2020,377555,44,1,7,4,3
2020,377555,44,2,34,15,19
2020,377555,44,3,24,11,13
2020,377555,44,5,3,2,1
2020,377564,0,0,273,128,145
2020,377564,10,0,273,128,145
2020,377564,10,1,53,30,23
2020,377564,10,2,111,49,62
2020,377564,10,3,93,44,49
2020,377564,10,5,16,5,11
2020,377564,20,0,126,67,59
2020,377564,20,1,48,28,20
2020,377564,20,2,78,39,39
2020,377564,30,0,57,22,35
2020,377564,30,3,57,22,35
2020,377564,40,0,90,39,51
2020,377564,40,1,5,2,3
2020,377564,40,2,33,10,23
2020,377564,40,3,36,22,14
2020,377564,40,5,16,5,11
2020,377564,41,0,75,35,40
2020,377564,41,1,5,2,3
2020,377564,41,2,33,10,23
2020,377564,41,3,36,22,14
2020,377564,41,5,1,1,0
2020,377564,42,0,15,4,11
2020,377564,42,5,15,4,11
2020,377564,44,0,75,35,40
2020,377564,44,1,5,2,3
2020,377564,44,2,33,10,23
2020,377564,44,3,36,22,14
2020,377564,44,5,1,1,0
2020,377661,0,0,2,0,2
2020,377661,50,0,2,0,2
2020,378105,0,0,5,0,5
2020,378105,10,0,5,0,5
2020,378105,10,4,5,0,5
2020,378105,40,0,5,0,5
2020,378105,40,4,5,0,5
2020,378105,41,0,5,0,5
2020,378105,41,4,5,0,5
2020,378105,45,0,5,0,5
2020,378105,45,4,5,0,5
2020,378576,0,0,14,9,5
2020,378576,10,0,14,9,5
2020,378576,10,4,14,9,5
2020,378576,40,0,14,9,5
2020,378576,40,4,14,9,5
2020,378576,42,0,9,5,4
2020,378576,42,4,9,5,4
2020,378576,43,0,5,4,1
2020,378576,43,4,5,4,1
2020,380359,0,0,15,8,7
2020,380359,10,0,15,8,7
2020,380359,10,6,15,8,7
2020,380359,40,0,15,8,7
2020,380359,40,6,15,8,7
2020,380359,42,0,15,8,7
2020,380359,42,6,15,8,7
2020,380368,0,0,25,13,12
2020,380368,10,0,25,13,12
2020,380368,10,4,25,13,12
2020,380368,20,0,20,11,9
2020,380368,20,4,20,11,9
2020,380368,30,0,5,2,3
2020,380368,30,4,5,2,3
2020,380377,0,0,26,11,15
2020,380377,10,0,26,11,15
2020,380377,10,6,26,11,15
2020,380377,40,0,26,11,15
2020,380377,40,6,26,11,15
2020,380377,42,0,26,11,15
2020,380377,42,6,26,11,15
2020,380438,0,0,12,1,11
2020,380438,10,0,12,1,11
2020,380438,10,4,12,1,11
2020,380438,40,0,12,1,11
2020,380438,40,4,12,1,11
2020,380438,41,0,12,1,11
2020,380438,41,4,12,1,11
2020,380438,45,0,12,1,11
2020,380438,45,4,12,1,11
2020,381459,0,0,6,6,0
2020,381459,10,0,6,6,0
2020,381459,10,1,4,4,0
2020,381459,10,2,1,1,0
2020,381459,10,3,1,1,0
2020,381459,40,0,6,6,0
2020,381459,40,1,4,4,0
2020,381459,40,2,1,1,0
2020,381459,40,3,1,1,0
2020,381459,41,0,6,6,0
2020,381459,41,1,4,4,0
2020,381459,41,2,1,1,0
2020,381459,41,3,1,1,0
2020,381459,44,0,6,6,0
2020,381459,44,1,4,4,0
2020,381459,44,2,1,1,0
2020,381459,44,3,1,1,0
2020,382957,0,0,13,3,10
2020,382957,10,0,13,3,10
2020,382957,10,4,13,3,10
2020,382957,40,0,13,3,10
2020,382957,40,4,13,3,10
2020,382957,41,0,13,3,10
2020,382957,41,4,13,3,10
2020,382957,45,0,13,3,10
2020,382957,45,4,13,3,10
2020,383084,0,0,18,7,11
2020,383084,10,0,18,7,11
2020,383084,10,4,18,7,11
2020,383084,20,0,14,5,9
2020,383084,20,4,14,5,9
2020,383084,30,0,4,2,2
2020,383084,30,4,4,2,2
2020,383190,0,0,82,31,51
2020,383190,10,0,82,31,51
2020,383190,10,1,10,3,7
2020,383190,10,2,14,7,7
2020,383190,10,3,23,11,12
2020,383190,10,4,35,10,25
2020,383190,20,0,44,19,25
2020,383190,20,1,10,3,7
2020,383190,20,2,13,6,7
2020,383190,20,3,21,10,11
2020,383190,30,0,31,7,24
2020,383190,30,3,1,0,1
2020,383190,30,4,30,7,23
2020,383190,40,0,7,5,2
2020,383190,40,2,1,1,0
2020,383190,40,3,1,1,0
2020,383190,40,4,5,3,2
2020,383190,41,0,1,0,1
2020,383190,41,4,1,0,1
2020,383190,42,0,6,5,1
2020,383190,42,2,1,1,0
2020,383190,42,3,1,1,0
2020,383190,42,4,4,3,1
2020,383190,44,0,1,0,1
2020,383190,44,4,1,0,1
2020,383996,0,0,7,5,2
2020,383996,10,0,7,5,2
2020,383996,10,1,5,3,2
2020,383996,10,2,2,2,0
2020,383996,20,0,4,2,2
2020,383996,20,1,3,1,2
2020,383996,20,2,1,1,0
2020,383996,30,0,3,3,0
2020,383996,30,1,2,2,0
2020,383996,30,2,1,1,0
2020,384254,0,0,36,17,19
2020,384254,10,0,36,17,19
2020,384254,10,1,3,2,1
2020,384254,10,2,9,5,4
2020,384254,10,3,10,4,6
2020,384254,10,4,14,6,8
2020,384254,40,0,36,17,19
2020,384254,40,1,3,2,1
2020,384254,40,2,9,5,4
2020,384254,40,3,10,4,6
2020,384254,40,4,14,6,8
2020,384254,41,0,20,12,8
2020,384254,41,1,3,2,1
2020,384254,41,2,7,5,2
2020,384254,41,3,4,1,3
2020,384254,41,4,6,4,2
2020,384254,42,0,16,5,11
2020,384254,42,2,2,0,2
2020,384254,42,3,6,3,3
2020,384254,42,4,8,2,6
2020,384254,44,0,20,12,8
2020,384254,44,1,3,2,1
2020,384254,44,2,7,5,2
2020,384254,44,3,4,1,3
2020,384254,44,4,6,4,2
2020,384333,0,0,104,42,62
2020,384333,10,0,104,42,62
2020,384333,10,6,104,42,62
2020,384333,20,0,58,21,37
2020,384333,20,6,58,21,37
2020,384333,30,0,36,17,19
2020,384333,30,6,36,17,19
2020,384333,40,0,10,4,6
2020,384333,40,6,10,4,6
2020,384333,42,0,7,3,4
2020,384333,42,6,7,3,4
2020,384333,43,0,3,1,2
2020,384333,43,6,3,1,2
2020,384342,0,0,80,33,47
2020,384342,10,0,79,32,47
2020,384342,10,1,40,19,21
2020,384342,10,2,13,5,8
2020,384342,10,3,12,4,8
2020,384342,10,4,14,4,10
2020,384342,20,0,65,28,37
2020,384342,20,1,40,19,21
2020,384342,20,2,13,5,8
2020,384342,20,3,12,4,8
2020,384342,30,0,14,4,10
2020,384342,30,4,14,4,10
2020,384342,50,0,1,1,0
2020,384412,0,0,1,1,0
2020,384412,10,0,1,1,0
2020,384412,10,4,1,1,0
2020,384412,40,0,1,1,0
2020,384412,40,4,1,1,0
2020,384412,41,0,1,1,0
2020,384412,41,4,1,1,0
2020,384412,45,0,1,1,0
2020,384412,45,4,1,1,0
2020,385415,0,0,43,19,24
2020,385415,10,0,43,19,24
2020,385415,10,1,11,5,6
2020,385415,10,2,19,10,9
2020,385415,10,3,11,3,8
2020,385415,10,4,2,1,1
2020,385415,20,0,1,1,0
2020,385415,20,1,1,1,0
2020,385415,30,0,2,2,0
2020,385415,30,2,2,2,0
2020,385415,40,0,40,16,24
2020,385415,40,1,10,4,6
2020,385415,40,2,17,8,9
2020,385415,40,3,11,3,8
2020,385415,40,4,2,1,1
2020,385415,41,0,38,15,23
2020,385415,41,1,10,4,6
2020,385415,41,2,17,8,9
2020,385415,41,3,11,3,8
2020,385415,42,0,2,1,1
2020,385415,42,4,2,1,1
2020,385415,44,0,28,11,17
2020,385415,44,2,17,8,9
2020,385415,44,3,11,3,8
2020,385415,45,0,10,4,6
2020,385415,45,1,10,4,6
2020,385503,0,0,5,0,5
2020,385503,10,0,5,0,5
2020,385503,10,4,5,0,5
2020,385503,40,0,5,0,5
2020,385503,40,4,5,0,5
2020,385503,41,0,5,0,5
2020,385503,41,4,5,0,5
2020,385503,45,0,5,0,5
2020,385503,45,4,5,0,5
2020,385619,0,0,48,34,14
2020,385619,10,0,48,34,14
2020,385619,10,4,48,34,14
2020,385619,40,0,48,34,14
2020,385619,40,4,48,34,14
2020,385619,41,0,48,34,14
2020,385619,41,4,48,34,14
2020,385619,45,0,48,34,14
2020,385619,45,4,48,34,14
2020,386153,0,0,5,0,5
2020,386153,10,0,5,0,5
2020,386153,10,4,5,0,5
2020,386153,40,0,5,0,5
2020,386153,40,4,5,0,5
2020,386153,42,0,5,0,5
2020,386153,42,4,5,0,5
2020,386472,0,0,18,2,16
2020,386472,10,0,18,2,16
2020,386472,10,1,1,0,1
2020,386472,10,2,4,0,4
2020,386472,10,3,12,2,10
2020,386472,10,4,1,0,1
2020,386472,40,0,18,2,16
2020,386472,40,1,1,0,1
2020,386472,40,2,4,0,4
2020,386472,40,3,12,2,10
2020,386472,40,4,1,0,1
2020,386472,41,0,18,2,16
2020,386472,41,1,1,0,1
2020,386472,41,2,4,0,4
2020,386472,41,3,12,2,10
2020,386472,41,4,1,0,1
2020,386472,45,0,18,2,16
2020,386472,45,1,1,0,1
2020,386472,45,2,4,0,4
2020,386472,45,3,12,2,10
2020,386472,45,4,1,0,1
2020,388520,0,0,10,8,2
2020,388520,10,0,10,8,2
2020,388520,10,1,7,6,1
2020,388520,10,2,1,1,0
2020,388520,10,3,2,1,1
2020,388520,40,0,10,8,2
2020,388520,40,1,7,6,1
2020,388520,40,2,1,1,0
2020,388520,40,3,2,1,1
2020,388520,42,0,10,8,2
2020,388520,42,1,7,6,1
2020,388520,42,2,1,1,0
2020,388520,42,3,2,1,1
2020,392257,0,0,48,12,36
2020,392257,10,0,48,12,36
2020,392257,10,4,48,12,36
2020,392257,40,0,48,12,36
2020,392257,40,4,48,12,36
2020,392257,41,0,48,12,36
2020,392257,41,4,48,12,36
2020,392257,45,0,48,12,36
2020,392257,45,4,48,12,36
2020,392415,0,0,4,1,3
2020,392415,10,0,4,1,3
2020,392415,10,4,4,1,3
2020,392415,40,0,4,1,3
2020,392415,40,4,4,1,3
2020,392415,41,0,4,1,3
2020,392415,41,4,4,1,3
2020,392415,45,0,4,1,3
2020,392415,45,4,4,1,3
2020,395362,0,0,29,15,14
2020,395362,10,0,29,15,14
2020,395362,10,4,29,15,14
2020,395362,20,0,27,15,12
2020,395362,20,4,27,15,12
2020,395362,30,0,1,0,1
2020,395362,30,4,1,0,1
2020,395362,40,0,1,0,1
2020,395362,40,4,1,0,1
2020,395362,42,0,1,0,1
2020,395362,42,4,1,0,1
2020,399212,0,0,113,37,76
2020,399212,10,0,113,37,76
2020,399212,10,4,113,37,76
2020,399212,20,0,34,12,22
2020,399212,20,4,34,12,22
2020,399212,30,0,72,23,49
2020,399212,30,4,72,23,49
2020,399212,40,0,7,2,5
2020,399212,40,4,7,2,5
2020,399212,42,0,6,2,4
2020,399212,42,4,6,2,4
2020,399212,43,0,1,0,1
2020,399212,43,4,1,0,1
2020,399869,0,0,11,10,1
2020,399869,10,0,10,9,1
2020,399869,10,1,1,1,0
2020,399869,10,2,1,1,0
2020,399869,10,3,1,1,0
2020,399869,10,4,4,4,0
2020,399869,10,5,3,2,1
2020,399869,40,0,10,9,1
2020,399869,40,1,1,1,0
2020,399869,40,2,1,1,0
2020,399869,40,3,1,1,0
2020,399869,40,4,4,4,0
2020,399869,40,5,3,2,1
2020,399869,41,0,10,9,1
2020,399869,41,1,1,1,0
2020,399869,41,2,1,1,0
2020,399869,41,3,1,1,0
2020,399869,41,4,4,4,0
2020,399869,41,5,3,2,1
2020,399869,45,0,10,9,1
2020,399869,45,1,1,1,0
2020,399869,45,2,1,1,0
2020,399869,45,3,1,1,0
2020,399869,45,4,4,4,0
2020,399869,45,5,3,2,1
2020,399869,50,0,1,1,0
2020,399911,0,0,54,27,27
2020,399911,10,0,54,27,27
2020,399911,10,1,14,10,4
2020,399911,10,2,23,10,13
2020,399911,10,3,13,5,8
2020,399911,10,4,3,1,2
2020,399911,10,5,1,1,0
2020,399911,20,0,37,20,17
2020,399911,20,1,14,10,4
2020,399911,20,2,23,10,13
2020,399911,30,0,10,3,7
2020,399911,30,3,10,3,7
2020,399911,40,0,7,4,3
2020,399911,40,3,3,2,1
2020,399911,40,4,3,1,2
2020,399911,40,5,1,1,0
2020,399911,41,0,3,3,0
2020,399911,41,3,2,2,0
2020,399911,41,5,1,1,0
2020,399911,42,0,4,1,3
2020,399911,42,3,1,0,1
2020,399911,42,4,3,1,2
2020,399911,44,0,3,3,0
2020,399911,44,3,2,2,0
2020,399911,44,5,1,1,0
2020,403469,0,0,6,2,4
2020,403469,10,0,6,2,4
2020,403469,10,2,2,0,2
2020,403469,10,3,2,1,1
2020,403469,10,4,2,1,1
2020,403469,20,0,5,1,4
2020,403469,20,2,2,0,2
2020,403469,20,3,2,1,1
2020,403469,20,4,1,0,1
2020,403469,30,0,1,1,0
2020,403469,30,4,1,1,0
2020,403478,0,0,14,7,7
2020,403478,10,0,14,7,7
2020,403478,10,1,2,0,2
2020,403478,10,2,1,0,1
2020,403478,10,3,4,2,2
2020,403478,10,4,7,5,2
2020,403478,20,0,9,3,6
2020,403478,20,1,2,0,2
2020,403478,20,2,1,0,1
2020,403478,20,3,4,2,2
2020,403478,20,4,2,1,1
2020,403478,30,0,5,4,1
2020,403478,30,4,5,4,1
2020,403487,0,0,28,21,7
2020,403487,10,0,28,21,7
2020,403487,10,1,2,1,1
2020,403487,10,2,3,3,0
2020,403487,10,3,8,6,2
2020,403487,10,4,15,11,4
2020,403487,20,0,20,17,3
2020,403487,20,1,2,1,1
2020,403487,20,2,3,3,0
2020,403487,20,3,8,6,2
2020,403487,20,4,7,7,0
2020,403487,30,0,8,4,4
2020,403487,30,4,8,4,4
2020,404055,0,0,8,0,8
2020,404055,10,0,8,0,8
2020,404055,10,4,8,0,8
2020,404055,40,0,8,0,8
2020,404055,40,4,8,0,8
2020,404055,41,0,8,0,8
2020,404055,41,4,8,0,8
2020,404055,45,0,8,0,8
2020,404055,45,4,8,0,8
2020,404222,0,0,18,9,9
2020,404222,10,0,18,9,9
2020,404222,10,1,3,2,1
2020,404222,10,2,2,1,1
2020,404222,10,3,11,5,6
2020,404222,10,4,2,1,1
2020,404222,20,0,8,5,3
2020,404222,20,1,3,2,1
2020,404222,20,2,1,1,0
2020,404222,20,3,4,2,2
2020,404222,30,0,8,4,4
2020,404222,30,2,1,0,1
2020,404222,30,3,6,3,3
2020,404222,30,4,1,1,0
2020,404222,40,0,2,0,2
2020,404222,40,3,1,0,1
2020,404222,40,4,1,0,1
2020,404222,42,0,2,0,2
2020,404222,42,3,1,0,1
2020,404222,42,4,1,0,1
2020,404426,0,0,41,21,20
2020,404426,10,0,41,21,20
2020,404426,10,6,41,21,20
2020,404426,40,0,41,21,20
2020,404426,40,6,41,21,20
2020,404426,42,0,41,21,20
2020,404426,42,6,41,21,20
2020,404806,0,0,8,2,6
2020,404806,10,0,8,2,6
2020,404806,10,1,8,2,6
2020,404806,40,0,8,2,6
2020,404806,40,1,8,2,6
2020,404806,42,0,8,2,6
2020,404806,42,1,8,2,6
2020,404912,0,0,44,7,37
2020,404912,10,0,44,7,37
2020,404912,10,4,44,7,37
2020,404912,40,0,44,7,37
2020,404912,40,4,44,7,37
2020,404912,41,0,44,7,37
2020,404912,41,4,44,7,37
2020,404912,45,0,44,7,37
2020,404912,45,4,44,7,37
2020,404994,0,0,165,76,89
2020,404994,10,0,161,74,87
2020,404994,10,2,8,2,6
2020,404994,10,3,38,20,18
2020,404994,10,4,115,52,63
2020,404994,40,0,161,74,87
2020,404994,40,2,8,2,6
2020,404994,40,3,38,20,18
2020,404994,40,4,115,52,63
2020,404994,41,0,43,18,25
2020,404994,41,2,3,0,3
2020,404994,41,3,19,9,10
2020,404994,41,4,21,9,12
2020,404994,43,0,118,56,62
2020,404994,43,2,5,2,3
2020,404994,43,3,19,11,8
2020,404994,43,4,94,43,51
2020,404994,45,0,43,18,25
2020,404994,45,2,3,0,3
2020,404994,45,3,19,9,10
2020,404994,45,4,21,9,12
2020,404994,50,0,4,2,2
2020,405058,0,0,6,6,0
2020,405058,10,0,6,6,0
2020,405058,10,4,6,6,0
2020,405058,40,0,6,6,0
2020,405058,40,4,6,6,0
2020,405058,42,0,6,6,0
2020,405058,42,4,6,6,0
2020,405872,0,0,80,22,58
2020,405872,10,0,80,22,58
2020,405872,10,1,11,2,9
2020,405872,10,2,25,10,15
2020,405872,10,3,42,8,34
2020,405872,10,5,2,2,0
2020,405872,40,0,80,22,58
2020,405872,40,1,11,2,9
2020,405872,40,2,25,10,15
2020,405872,40,3,42,8,34
2020,405872,40,5,2,2,0
2020,405872,41,0,60,17,43
2020,405872,41,1,11,2,9
2020,405872,41,2,25,10,15
2020,405872,41,3,23,4,19
2020,405872,41,5,1,1,0
2020,405872,42,0,20,5,15
2020,405872,42,3,19,4,15
2020,405872,42,5,1,1,0
2020,405872,44,0,60,17,43
2020,405872,44,1,11,2,9
2020,405872,44,2,25,10,15
2020,405872,44,3,23,4,19
2020,405872,44,5,1,1,0
2020,406024,0,0,77,14,63
2020,406024,10,0,77,14,63
2020,406024,10,3,6,1,5
2020,406024,10,4,71,13,58
2020,406024,40,0,77,14,63
2020,406024,40,3,6,1,5
2020,406024,40,4,71,13,58
2020,406024,41,0,77,14,63
2020,406024,41,3,6,1,5
2020,406024,41,4,71,13,58
2020,406024,45,0,77,14,63
2020,406024,45,3,6,1,5
2020,406024,45,4,71,13,58
2020,406033,0,0,82,11,71
2020,406033,10,0,82,11,71
2020,406033,10,2,1,1,0
2020,406033,10,3,6,0,6
2020,406033,10,4,75,10,65
2020,406033,40,0,82,11,71
2020,406033,40,2,1,1,0
2020,406033,40,3,6,0,6
2020,406033,40,4,75,10,65
2020,406033,41,0,82,11,71
2020,406033,41,2,1,1,0
2020,406033,41,3,6,0,6
2020,406033,41,4,75,10,65
2020,406033,45,0,82,11,71
2020,406033,45,2,1,1,0
2020,406033,45,3,6,0,6
2020,406033,45,4,75,10,65
2020,406547,0,0,2,1,1
2020,406547,10,0,2,1,1
2020,406547,10,4,2,1,1
2020,406547,40,0,2,1,1
2020,406547,40,4,2,1,1
2020,406547,41,0,2,1,1
2020,406547,41,4,2,1,1
2020,406547,45,0,2,1,1
2020,406547,45,4,2,1,1
2020,407629,0,0,161,96,65
2020,407629,10,0,161,96,65
2020,407629,10,1,33,26,7
2020,407629,10,2,27,13,14
2020,407629,10,3,98,56,42
2020,407629,10,4,3,1,2
2020,407629,40,0,161,96,65
2020,407629,40,1,33,26,7
2020,407629,40,2,27,13,14
2020,407629,40,3,98,56,42
2020,407629,40,4,3,1,2
2020,407629,41,0,161,96,65
2020,407629,41,1,33,26,7
2020,407629,41,2,27,13,14
2020,407629,41,3,98,56,42
2020,407629,41,4,3,1,2
2020,407629,44,0,161,96,65
2020,407629,44,1,33,26,7
2020,407629,44,2,27,13,14
2020,407629,44,3,98,56,42
2020,407629,44,4,3,1,2
2020,408729,0,0,9,1,8
2020,408729,10,0,9,1,8
2020,408729,10,4,9,1,8
2020,408729,40,0,9,1,8
2020,408729,40,4,9,1,8
2020,408729,41,0,9,1,8
2020,408729,41,4,9,1,8
2020,408729,45,0,9,1,8
2020,408729,45,4,9,1,8
2020,408844,0,0,88,40,48
2020,408844,10,0,88,40,48
2020,408844,10,4,88,40,48
2020,408844,40,0,88,40,48
2020,408844,40,4,88,40,48
2020,408844,43,0,88,40,48
2020,408844,43,4,88,40,48
2020,409254,0,0,21,2,19
2020,409254,10,0,21,2,19
2020,409254,10,1,4,0,4
2020,409254,10,2,8,1,7
2020,409254,10,3,2,1,1
2020,409254,10,4,7,0,7
2020,409254,20,0,7,1,6
2020,409254,20,1,3,0,3
2020,409254,20,2,4,1,3
2020,409254,30,0,2,1,1
2020,409254,30,2,1,0,1
2020,409254,30,3,1,1,0
2020,409254,40,0,12,0,12
2020,409254,40,1,1,0,1
2020,409254,40,2,3,0,3
2020,409254,40,3,1,0,1
2020,409254,40,4,7,0,7
2020,409254,41,0,12,0,12
2020,409254,41,1,1,0,1
2020,409254,41,2,3,0,3
2020,409254,41,3,1,0,1
2020,409254,41,4,7,0,7
2020,409254,44,0,12,0,12
2020,409254,44,1,1,0,1
2020,409254,44,2,3,0,3
2020,409254,44,3,1,0,1
2020,409254,44,4,7,0,7
2020,409315,0,0,574,334,240
2020,409315,10,0,574,334,240
2020,409315,10,1,8,4,4
2020,409315,10,2,30,18,12
2020,409315,10,3,44,26,18
2020,409315,10,4,420,237,183
2020,409315,10,5,72,49,23
2020,409315,40,0,574,334,240
2020,409315,40,1,8,4,4
2020,409315,40,2,30,18,12
2020,409315,40,3,44,26,18
2020,409315,40,4,420,237,183
2020,409315,40,5,72,49,23
2020,409315,42,0,541,312,229
2020,409315,42,1,8,4,4
2020,409315,42,2,30,18,12
2020,409315,42,3,44,26,18
2020,409315,42,4,420,237,183
2020,409315,42,5,39,27,12
2020,409315,43,0,33,22,11
2020,409315,43,5,33,22,11
2020,409616,0,0,23,8,15
2020,409616,10,0,23,8,15
2020,409616,10,1,18,7,11
2020,409616,10,2,3,1,2
2020,409616,10,3,2,0,2
2020,409616,20,0,14,7,7
2020,409616,20,1,14,7,7
2020,409616,30,0,2,1,1
2020,409616,30,2,2,1,1
2020,409616,40,0,7,0,7
2020,409616,40,1,4,0,4
2020,409616,40,2,1,0,1
2020,409616,40,3,2,0,2
2020,409616,41,0,7,0,7
2020,409616,41,1,4,0,4
2020,409616,41,2,1,0,1
2020,409616,41,3,2,0,2
2020,409616,44,0,7,0,7
2020,409616,44,1,4,0,4
2020,409616,44,2,1,0,1
2020,409616,44,3,2,0,2
2020,409698,0,0,212,91,121
2020,409698,10,0,212,91,121
2020,409698,10,1,58,32,26
2020,409698,10,2,44,23,21
2020,409698,10,3,72,20,52
2020,409698,10,5,38,16,22
2020,409698,20,0,99,54,45
2020,409698,20,1,58,32,26
2020,409698,20,2,41,22,19
2020,409698,30,0,75,21,54
2020,409698,30,2,3,1,2
2020,409698,30,3,72,20,52
2020,409698,40,0,38,16,22
2020,409698,40,5,38,16,22
2020,409698,41,0,25,12,13
2020,409698,41,5,25,12,13
2020,409698,42,0,13,4,9
2020,409698,42,5,13,4,9
2020,409698,44,0,25,12,13
2020,409698,44,5,25,12,13
2020,412173,0,0,17,6,11
2020,412173,10,0,17,6,11
2020,412173,10,6,17,6,11
2020,412173,40,0,17,6,11
2020,412173,40,6,17,6,11
2020,412173,41,0,17,6,11
2020,412173,41,6,17,6,11
2020,412173,45,0,17,6,11
2020,412173,45,6,17,6,11
2020,412599,0,0,18,7,11
2020,412599,50,0,18,7,11
2020,413413,0,0,177,48,129
2020,413413,10,0,177,48,129
2020,413413,10,6,177,48,129
2020,413413,40,0,177,48,129
2020,413413,40,6,177,48,129
2020,413413,42,0,177,48,129
2020,413413,42,6,177,48,129
2020,413617,0,0,18,7,11
2020,413617,10,0,18,7,11
2020,413617,10,4,18,7,11
2020,413617,40,0,18,7,11
2020,413617,40,4,18,7,11
2020,413617,42,0,18,7,11
2020,413617,42,4,18,7,11
2020,413626,0,0,16,8,8
2020,413626,10,0,16,8,8
2020,413626,10,4,16,8,8
2020,413626,40,0,16,8,8
2020,413626,40,4,16,8,8
2020,413626,42,0,16,8,8
2020,413626,42,4,16,8,8
2020,413680,0,0,23,22,1
2020,413680,50,0,23,22,1
2020,414461,0,0,62,59,3
2020,414461,10,0,62,59,3
2020,414461,10,1,12,10,2
2020,414461,10,4,50,49,1
2020,414461,40,0,62,59,3
2020,414461,40,1,12,10,2
2020,414461,40,4,50,49,1
2020,414461,41,0,62,59,3
2020,414461,41,1,12,10,2
2020,414461,41,4,50,49,1
2020,414461,44,0,62,59,3
2020,414461,44,1,12,10,2
2020,414461,44,4,50,49,1
2020,414595,0,0,4,0,4
2020,414595,10,0,4,0,4
2020,414595,10,4,4,0,4
2020,414595,40,0,4,0,4
2020,414595,40,4,4,0,4
2020,414595,42,0,3,0,3
2020,414595,42,4,3,0,3
2020,414595,43,0,1,0,1
2020,414595,43,4,1,0,1
2020,414823,0,0,42,27,15
2020,414823,10,0,42,27,15
2020,414823,10,1,11,6,5
2020,414823,10,2,16,9,7
2020,414823,10,3,8,6,2
2020,414823,10,4,7,6,1
2020,414823,40,0,42,27,15
2020,414823,40,1,11,6,5
2020,414823,40,2,16,9,7
2020,414823,40,3,8,6,2
2020,414823,40,4,7,6,1
2020,414823,41,0,2,2,0
2020,414823,41,1,1,1,0
2020,414823,41,2,1,1,0
2020,414823,42,0,40,25,15
2020,414823,42,1,10,5,5
2020,414823,42,2,15,8,7
2020,414823,42,3,8,6,2
2020,414823,42,4,7,6,1
2020,414823,44,0,2,2,0
2020,414823,44,1,1,1,0
2020,414823,44,2,1,1,0
2020,414911,0,0,26,10,16
2020,414911,10,0,26,10,16
2020,414911,10,1,7,2,5
2020,414911,10,2,8,4,4
2020,414911,10,3,4,1,3
2020,414911,10,4,5,2,3
2020,414911,10,5,2,1,1
2020,414911,20,0,15,5,10
2020,414911,20,1,7,2,5
2020,414911,20,2,7,3,4
2020,414911,20,4,1,0,1
2020,414911,30,0,6,2,4
2020,414911,30,2,1,1,0
2020,414911,30,3,3,0,3
2020,414911,30,4,2,1,1
2020,414911,40,0,5,3,2
2020,414911,40,3,1,1,0
2020,414911,40,4,2,1,1
2020,414911,40,5,2,1,1
2020,414911,41,0,4,2,2
2020,414911,41,3,1,1,0
2020,414911,41,4,2,1,1
2020,414911,41,5,1,0,1
2020,414911,42,0,1,1,0
2020,414911,42,5,1,1,0
2020,414911,45,0,4,2,2
2020,414911,45,3,1,1,0
2020,414911,45,4,2,1,1
2020,414911,45,5,1,0,1
2020,414939,0,0,4,1,3
2020,414939,10,0,4,1,3
2020,414939,10,4,4,1,3
2020,414939,40,0,4,1,3
2020,414939,40,4,4,1,3
2020,414939,41,0,4,1,3
2020,414939,41,4,4,1,3
2020,414939,45,0,4,1,3
2020,414939,45,4,4,1,3
2020,414966,0,0,12,5,7
2020,414966,10,0,12,5,7
2020,414966,10,1,3,2,1
2020,414966,10,2,3,1,2
2020,414966,10,3,5,2,3
2020,414966,10,4,1,0,1
2020,414966,20,0,6,3,3
2020,414966,20,1,3,2,1
2020,414966,20,2,3,1,2
2020,414966,30,0,4,2,2
2020,414966,30,3,4,2,2
2020,414966,40,0,2,0,2
2020,414966,40,3,1,0,1
2020,414966,40,4,1,0,1
2020,414966,41,0,1,0,1
2020,414966,41,3,1,0,1
2020,414966,42,0,1,0,1
2020,414966,42,4,1,0,1
2020,414966,44,0,1,0,1
2020,414966,44,3,1,0,1
2020,416801,0,0,22,10,12
2020,416801,10,0,22,10,12
2020,416801,10,1,1,1,0
2020,416801,10,5,21,9,12
2020,416801,20,0,1,1,0
2020,416801,20,1,1,1,0
2020,416801,40,0,21,9,12
2020,416801,40,5,21,9,12
2020,416801,42,0,21,9,12
2020,416801,42,5,21,9,12
2020,417327,0,0,2,1,1
2020,417327,10,0,2,1,1
2020,417327,10,4,2,1,1
2020,417327,40,0,2,1,1
2020,417327,40,4,2,1,1
2020,417327,41,0,2,1,1
2020,417327,41,4,2,1,1
2020,417327,45,0,2,1,1
2020,417327,45,4,2,1,1
2020,417734,0,0,17,2,15
2020,417734,10,0,17,2,15
2020,417734,10,2,1,1,0
2020,417734,10,3,6,1,5
2020,417734,10,4,10,0,10
2020,417734,40,0,17,2,15
2020,417734,40,2,1,1,0
2020,417734,40,3,6,1,5
2020,417734,40,4,10,0,10
2020,417734,42,0,17,2,15
2020,417734,42,2,1,1,0
2020,417734,42,3,6,1,5
2020,417734,42,4,10,0,10
2020,418533,0,0,81,49,32
2020,418533,50,0,81,49,32
2020,419244,0,0,7,7,0
2020,419244,10,0,7,7,0
2020,419244,10,6,7,7,0
2020,419244,40,0,7,7,0
2020,419244,40,6,7,7,0
2020,419244,41,0,7,7,0
2020,419244,41,6,7,7,0
2020,419244,45,0,7,7,0
2020,419244,45,6,7,7,0
2020,420024,0,0,4,1,3
2020,420024,50,0,4,1,3
2020,420246,0,0,17,8,9
2020,420246,10,0,17,8,9
2020,420246,10,1,9,6,3
2020,420246,10,2,3,0,3
2020,420246,10,3,5,2,3
2020,420246,40,0,17,8,9
2020,420246,40,1,9,6,3
2020,420246,40,2,3,0,3
2020,420246,40,3,5,2,3
2020,420246,42,0,17,8,9
2020,420246,42,1,9,6,3
2020,420246,42,2,3,0,3
2020,420246,42,3,5,2,3
2020,420370,0,0,9,3,6
2020,420370,50,0,9,3,6
2020,420398,0,0,190,94,96
2020,420398,10,0,174,86,88
2020,420398,10,1,40,23,17
2020,420398,10,2,30,12,18
2020,420398,10,3,50,22,28
2020,420398,10,4,54,29,25
2020,420398,20,0,100,54,46
2020,420398,20,1,40,23,17
2020,420398,20,2,26,11,15
2020,420398,20,3,12,5,7
2020,420398,20,4,22,15,7
2020,420398,40,0,74,32,42
2020,420398,40,2,4,1,3
2020,420398,40,3,38,17,21
2020,420398,40,4,32,14,18
2020,420398,42,0,74,32,42
2020,420398,42,2,4,1,3
2020,420398,42,3,38,17,21
2020,420398,42,4,32,14,18
2020,420398,50,0,16,8,8
2020,420431,0,0,58,24,34
2020,420431,50,0,58,24,34
2020,420440,0,0,18,8,10
2020,420440,10,0,18,8,10
2020,420440,10,4,18,8,10
2020,420440,40,0,18,8,10
2020,420440,40,4,18,8,10
2020,420440,42,0,18,8,10
2020,420440,42,4,18,8,10
2020,420538,0,0,41,17,24
2020,420538,10,0,41,17,24
2020,420538,10,3,6,3,3
2020,420538,10,4,35,14,21
2020,420538,40,0,41,17,24
2020,420538,40,3,6,3,3
2020,420538,40,4,35,14,21
2020,420538,42,0,41,17,24
2020,420538,42,3,6,3,3
2020,420538,42,4,35,14,21
2020,420556,0,0,22,9,13
2020,420556,10,0,22,9,13
2020,420556,10,4,22,9,13
2020,420556,40,0,22,9,13
2020,420556,40,4,22,9,13
2020,420556,42,0,22,9,13
2020,420556,42,4,22,9,13
2020,420723,0,0,10,8,2
2020,420723,10,0,10,8,2
2020,420723,10,4,10,8,2
2020,420723,40,0,10,8,2
2020,420723,40,4,10,8,2
2020,420723,43,0,10,8,2
2020,420723,43,4,10,8,2
2020,421708,0,0,10,2,8
2020,421708,50,0,10,2,8
2020,421832,0,0,18,10,8
2020,421832,10,0,18,10,8
2020,421832,10,4,18,10,8
2020,421832,40,0,18,10,8
2020,421832,40,4,18,10,8
2020,421832,42,0,18,10,8
2020,421832,42,4,18,10,8
2020,421841,0,0,4,2,2
2020,421841,10,0,4,2,2
2020,421841,10,6,4,2,2
2020,421841,40,0,4,2,2
2020,421841,40,6,4,2,2
2020,421841,43,0,4,2,2
2020,421841,43,6,4,2,2
2020,421878,0,0,18,5,13
2020,421878,10,0,18,5,13
2020,421878,10,4,18,5,13
2020,421878,40,0,18,5,13
2020,421878,40,4,18,5,13
2020,421878,42,0,18,5,13
2020,421878,42,4,18,5,13
2020,422695,0,0,7,2,5
2020,422695,10,0,7,2,5
2020,422695,10,6,7,2,5
2020,422695,40,0,7,2,5
2020,422695,40,6,7,2,5
2020,422695,41,0,7,2,5
2020,422695,41,6,7,2,5
2020,422695,45,0,7,2,5
2020,422695,45,6,7,2,5
2020,423643,0,0,302,136,166
2020,423643,10,0,291,134,157
2020,423643,10,1,41,23,18
2020,423643,10,2,83,38,45
2020,423643,10,3,162,71,91
2020,423643,10,4,5,2,3
2020,423643,20,0,77,44,33
2020,423643,20,1,29,19,10
2020,423643,20,2,48,25,23
2020,423643,30,0,56,23,33
2020,423643,30,1,5,3,2
2020,423643,30,2,4,3,1
2020,423643,30,3,47,17,30
2020,423643,40,0,158,67,91
2020,423643,40,1,7,1,6
2020,423643,40,2,31,10,21
2020,423643,40,3,115,54,61
2020,423643,40,4,5,2,3
2020,423643,41,0,158,67,91
2020,423643,41,1,7,1,6
2020,423643,41,2,31,10,21
2020,423643,41,3,115,54,61
2020,423643,41,4,5,2,3
2020,423643,44,0,158,67,91
2020,423643,44,1,7,1,6
2020,423643,44,2,31,10,21
2020,423643,44,3,115,54,61
2020,423643,44,4,5,2,3
2020,423643,50,0,11,2,9
2020,423652,0,0,9,5,4
2020,423652,10,0,9,5,4
2020,423652,10,4,9,5,4
2020,423652,40,0,9,5,4
2020,423652,40,4,9,5,4
2020,423652,41,0,9,5,4
2020,423652,41,4,9,5,4
2020,423652,45,0,9,5,4
2020,423652,45,4,9,5,4
2020,426314,0,0,128,79,49
2020,426314,10,0,128,79,49
2020,426314,10,1,3,3,0
2020,426314,10,2,34,26,8
2020,426314,10,3,63,29,34
2020,426314,10,4,28,21,7
2020,426314,20,0,18,13,5
2020,426314,20,1,1,1,0
2020,426314,20,2,17,12,5
2020,426314,30,0,31,11,20
2020,426314,30,2,3,3,0
2020,426314,30,3,28,8,20
2020,426314,40,0,79,55,24
2020,426314,40,1,2,2,0
2020,426314,40,2,14,11,3
2020,426314,40,3,35,21,14
2020,426314,40,4,28,21,7
2020,426314,42,0,79,55,24
2020,426314,42,1,2,2,0
2020,426314,42,2,14,11,3
2020,426314,42,3,35,21,14
2020,426314,42,4,28,21,7
2020,427982,0,0,9,8,1
2020,427982,50,0,9,8,1
2020,428170,0,0,53,8,45
2020,428170,10,0,53,8,45
2020,428170,10,4,53,8,45
2020,428170,40,0,53,8,45
2020,428170,40,4,53,8,45
2020,428170,41,0,53,8,45
2020,428170,41,4,53,8,45
2020,428170,45,0,53,8,45
2020,428170,45,4,53,8,45
2020,428392,0,0,32,14,18
2020,428392,10,0,32,14,18
2020,428392,10,6,32,14,18
2020,428392,40,0,32,14,18
2020,428392,40,6,32,14,18
2020,428392,41,0,32,14,18
2020,428392,41,6,32,14,18
2020,428392,44,0,32,14,18
2020,428392,44,6,32,14,18
2020,429085,0,0,8,5,3
2020,429085,10,0,8,5,3
2020,429085,10,1,2,1,1
2020,429085,10,3,2,1,1
2020,429085,10,4,2,2,0
2020,429085,10,5,2,1,1
2020,429085,40,0,8,5,3
2020,429085,40,1,2,1,1
2020,429085,40,3,2,1,1
2020,429085,40,4,2,2,0
2020,429085,40,5,2,1,1
2020,429085,42,0,8,5,3
2020,429085,42,1,2,1,1
2020,429085,42,3,2,1,1
2020,429085,42,4,2,2,0
2020,429085,42,5,2,1,1
2020,429094,0,0,9,5,4
2020,429094,10,0,9,5,4
2020,429094,10,1,8,5,3
2020,429094,10,4,1,0,1
2020,429094,40,0,9,5,4
2020,429094,40,1,8,5,3
2020,429094,40,4,1,0,1
2020,429094,41,0,9,5,4
2020,429094,41,1,8,5,3
2020,429094,41,4,1,0,1
2020,429094,44,0,9,5,4
2020,429094,44,1,8,5,3
2020,429094,44,4,1,0,1
2020,430670,0,0,41,25,16
2020,430670,10,0,41,25,16
2020,430670,10,1,1,1,0
2020,430670,10,2,8,7,1
2020,430670,10,3,23,13,10
2020,430670,10,4,9,4,5
2020,430670,20,0,11,6,5
2020,430670,20,2,5,5,0
2020,430670,20,3,5,1,4
2020,430670,20,4,1,0,1
2020,430670,30,0,10,3,7
2020,430670,30,2,1,0,1
2020,430670,30,3,3,0,3
2020,430670,30,4,6,3,3
2020,430670,40,0,20,16,4
2020,430670,40,1,1,1,0
2020,430670,40,2,2,2,0
2020,430670,40,3,15,12,3
2020,430670,40,4,2,1,1
2020,430670,42,0,18,14,4
2020,430670,42,1,1,1,0
2020,430670,42,2,2,2,0
2020,430670,42,3,13,10,3
2020,430670,42,4,2,1,1
2020,430670,43,0,2,2,0
2020,430670,43,3,2,2,0
2020,430704,0,0,8,4,4
2020,430704,10,0,8,4,4
2020,430704,10,4,8,4,4
2020,430704,40,0,8,4,4
2020,430704,40,4,8,4,4
2020,430704,41,0,8,4,4
2020,430704,41,4,8,4,4
2020,430704,44,0,8,4,4
2020,430704,44,4,8,4,4
2020,430795,0,0,11,5,6
2020,430795,10,0,11,5,6
2020,430795,10,4,11,5,6
2020,430795,40,0,11,5,6
2020,430795,40,4,11,5,6
2020,430795,42,0,11,5,6
2020,430795,42,4,11,5,6
2020,430935,0,0,12,7,5
2020,430935,10,0,10,6,4
2020,430935,10,1,10,6,4
2020,430935,40,0,10,6,4
2020,430935,40,1,10,6,4
2020,430935,41,0,7,4,3
2020,430935,41,1,7,4,3
2020,430935,42,0,3,2,1
2020,430935,42,1,3,2,1
2020,430935,44,0,5,3,2
2020,430935,44,1,5,3,2
2020,430935,45,0,2,1,1
2020,430935,45,1,2,1,1
2020,430935,50,0,2,1,1
2020,431141,0,0,54,17,37
2020,431141,10,0,54,17,37
2020,431141,10,4,54,17,37
2020,431141,40,0,54,17,37
2020,431141,40,4,54,17,37
2020,431141,41,0,54,17,37
2020,431141,41,4,54,17,37
2020,431141,45,0,54,17,37
2020,431141,45,4,54,17,37
2020,431929,0,0,10,1,9
2020,431929,10,0,10,1,9
2020,431929,10,1,10,1,9
2020,431929,40,0,10,1,9
2020,431929,40,1,10,1,9
2020,431929,42,0,10,1,9
2020,431929,42,1,10,1,9
2020,432348,0,0,20,10,10
2020,432348,10,0,19,10,9
2020,432348,10,1,2,1,1
2020,432348,10,2,2,2,0
2020,432348,10,3,8,4,4
2020,432348,10,6,7,3,4
2020,432348,20,0,3,2,1
2020,432348,20,1,2,1,1
2020,432348,20,2,1,1,0
2020,432348,30,0,1,1,0
2020,432348,30,2,1,1,0
2020,432348,40,0,15,7,8
2020,432348,40,3,8,4,4
2020,432348,40,6,7,3,4
2020,432348,41,0,8,4,4
2020,432348,41,3,8,4,4
2020,432348,42,0,1,1,0
2020,432348,42,6,1,1,0
2020,432348,43,0,6,2,4
2020,432348,43,6,6,2,4
2020,432348,44,0,8,4,4
2020,432348,44,3,8,4,4
2020,432348,50,0,1,0,1
2020,432384,0,0,17,9,8
2020,432384,10,0,17,9,8
2020,432384,10,4,17,9,8
2020,432384,40,0,17,9,8
2020,432384,40,4,17,9,8
2020,432384,41,0,17,9,8
2020,432384,41,4,17,9,8
2020,432384,45,0,17,9,8
2020,432384,45,4,17,9,8
2020,432524,0,0,6,4,2
2020,432524,10,0,6,4,2
2020,432524,10,1,6,4,2
2020,432524,40,0,6,4,2
2020,432524,40,1,6,4,2
2020,432524,42,0,6,4,2
2020,432524,42,1,6,4,2
2020,433004,0,0,38,19,19
2020,433004,10,0,38,19,19
2020,433004,10,1,7,6,1
2020,433004,10,2,8,5,3
2020,433004,10,3,15,6,9
2020,433004,10,4,8,2,6
2020,433004,40,0,38,19,19
2020,433004,40,1,7,6,1
2020,433004,40,2,8,5,3
2020,433004,40,3,15,6,9
2020,433004,40,4,8,2,6
2020,433004,41,0,38,19,19
2020,433004,41,1,7,6,1
2020,433004,41,2,8,5,3
2020,433004,41,3,15,6,9
2020,433004,41,4,8,2,6
2020,433004,44,0,38,19,19
2020,433004,44,1,7,6,1
2020,433004,44,2,8,5,3
2020,433004,44,3,15,6,9
2020,433004,44,4,8,2,6
2020,433013,0,0,16,7,9
2020,433013,10,0,16,7,9
2020,433013,10,4,16,7,9
2020,433013,40,0,16,7,9
2020,433013,40,4,16,7,9
2020,433013,41,0,16,7,9
2020,433013,41,4,16,7,9
2020,433013,45,0,16,7,9
2020,433013,45,4,16,7,9
2020,433174,0,0,27,2,25
2020,433174,10,0,27,2,25
2020,433174,10,6,27,2,25
2020,433174,40,0,27,2,25
2020,433174,40,6,27,2,25
2020,433174,41,0,27,2,25
2020,433174,41,6,27,2,25
2020,433174,45,0,27,2,25
2020,433174,45,6,27,2,25
2020,433387,0,0,3093,808,2285
2020,433387,10,0,3093,808,2285
2020,433387,10,6,3093,808,2285
2020,433387,40,0,3093,808,2285
2020,433387,40,6,3093,808,2285
2020,433387,41,0,3093,808,2285
2020,433387,41,6,3093,808,2285
2020,433387,45,0,3093,808,2285
2020,433387,45,6,3093,808,2285
2020,433420,0,0,27,25,2
2020,433420,10,0,27,25,2
2020,433420,10,4,27,25,2
2020,433420,40,0,27,25,2
2020,433420,40,4,27,25,2
2020,433420,41,0,27,25,2
2020,433420,41,4,27,25,2
2020,433420,45,0,27,25,2
2020,433420,45,4,27,25,2
2020,433536,0,0,6,0,6
2020,433536,10,0,6,0,6
2020,433536,10,1,2,0,2
2020,433536,10,2,2,0,2
2020,433536,10,3,1,0,1
2020,433536,10,4,1,0,1
2020,433536,40,0,6,0,6
2020,433536,40,1,2,0,2
2020,433536,40,2,2,0,2
2020,433536,40,3,1,0,1
2020,433536,40,4,1,0,1
2020,433536,41,0,6,0,6
2020,433536,41,1,2,0,2
2020,433536,41,2,2,0,2
2020,433536,41,3,1,0,1
2020,433536,41,4,1,0,1
2020,433536,45,0,6,0,6
2020,433536,45,1,2,0,2
2020,433536,45,2,2,0,2
2020,433536,45,3,1,0,1
2020,433536,45,4,1,0,1
2020,433660,0,0,516,283,233
2020,433660,10,0,516,283,233
2020,433660,10,1,101,72,29
2020,433660,10,2,134,85,49
2020,433660,10,3,146,70,76
2020,433660,10,4,134,56,78
2020,433660,10,5,1,0,1
2020,433660,20,0,3,1,2
2020,433660,20,1,2,1,1
2020,433660,20,2,1,0,1
2020,433660,40,0,513,282,231
2020,433660,40,1,99,71,28
2020,433660,40,2,133,85,48
2020,433660,40,3,146,70,76
2020,433660,40,4,134,56,78
2020,433660,40,5,1,0,1
2020,433660,41,0,492,274,218
2020,433660,41,1,97,70,27
2020,433660,41,2,133,85,48
2020,433660,41,3,140,68,72
2020,433660,41,4,121,51,70
2020,433660,41,5,1,0,1
2020,433660,42,0,21,8,13
2020,433660,42,1,2,1,1
2020,433660,42,3,6,2,4
2020,433660,42,4,13,5,8
2020,433660,44,0,492,274,218
2020,433660,44,1,97,70,27
2020,433660,44,2,133,85,48
2020,433660,44,3,140,68,72
2020,433660,44,4,121,51,70
2020,433660,44,5,1,0,1
2020,434016,0,0,6,3,3
2020,434016,10,0,6,3,3
2020,434016,10,4,6,3,3
2020,434016,40,0,6,3,3
2020,434016,40,4,6,3,3
2020,434016,42,0,6,3,3
2020,434016,42,4,6,3,3
2020,434061,0,0,154,71,83
2020,434061,10,0,154,71,83
2020,434061,10,1,10,3,7
2020,434061,10,2,9,6,3
2020,434061,10,3,23,11,12
2020,434061,10,4,110,49,61
2020,434061,10,5,2,2,0
2020,434061,20,0,5,4,1
2020,434061,20,1,1,1,0
2020,434061,20,2,1,1,0
2020,434061,20,4,3,2,1
2020,434061,40,0,149,67,82
2020,434061,40,1,9,2,7
2020,434061,40,2,8,5,3
2020,434061,40,3,23,11,12
2020,434061,40,4,107,47,60
2020,434061,40,5,2,2,0
2020,434061,42,0,149,67,82
2020,434061,42,1,9,2,7
2020,434061,42,2,8,5,3
2020,434061,42,3,23,11,12
2020,434061,42,4,107,47,60
2020,434061,42,5,2,2,0
2020,434140,0,0,34,5,29
2020,434140,10,0,34,5,29
2020,434140,10,4,34,5,29
2020,434140,40,0,34,5,29
2020,434140,40,4,34,5,29
2020,434140,41,0,34,5,29
2020,434140,41,4,34,5,29
2020,434140,45,0,34,5,29
2020,434140,45,4,34,5,29
2020,434159,0,0,9,7,2
2020,434159,10,0,9,7,2
2020,434159,10,4,9,7,2
2020,434159,40,0,9,7,2
2020,434159,40,4,9,7,2
2020,434159,41,0,9,7,2
2020,434159,41,4,9,7,2
2020,434159,45,0,9,7,2
2020,434159,45,4,9,7,2
2020,434584,0,0,13,7,6
2020,434584,10,0,13,7,6
2020,434584,10,2,2,1,1
2020,434584,10,3,9,4,5
2020,434584,10,4,2,2,0
2020,434584,40,0,13,7,6
2020,434584,40,2,2,1,1
2020,434584,40,3,9,4,5
2020,434584,40,4,2,2,0
2020,434584,42,0,13,7,6
2020,434584,42,2,2,1,1
2020,434584,42,3,9,4,5
2020,434584,42,4,2,2,0
2020,434672,0,0,399,159,240
2020,434672,10,0,399,159,240
2020,434672,10,1,68,22,46
2020,434672,10,2,133,57,76
2020,434672,10,3,161,61,100
2020,434672,10,4,37,19,18
2020,434672,20,0,25,12,13
2020,434672,20,1,15,7,8
2020,434672,20,2,9,5,4
2020,434672,20,3,1,0,1
2020,434672,40,0,374,147,227
2020,434672,40,1,53,15,38
2020,434672,40,2,124,52,72
2020,434672,40,3,160,61,99
2020,434672,40,4,37,19,18
2020,434672,41,0,319,125,194
2020,434672,41,1,53,15,38
2020,434672,41,2,123,52,71
2020,434672,41,3,134,51,83
2020,434672,41,4,9,7,2
2020,434672,42,0,53,21,32
2020,434672,42,2,1,0,1
2020,434672,42,3,24,9,15
2020,434672,42,4,28,12,16
2020,434672,43,0,2,1,1
2020,434672,43,3,2,1,1
2020,434672,44,0,319,125,194
2020,434672,44,1,53,15,38
2020,434672,44,2,123,52,71
2020,434672,44,3,134,51,83
2020,434672,44,4,9,7,2
2020,434715,0,0,8,4,4
2020,434715,10,0,8,4,4
2020,434715,10,1,8,4,4
2020,434715,20,0,2,2,0
2020,434715,20,1,2,2,0
2020,434715,30,0,1,0,1
2020,434715,30,1,1,0,1
2020,434715,40,0,5,2,3
2020,434715,40,1,5,2,3
2020,434715,41,0,4,1,3
2020,434715,41,1,4,1,3
2020,434715,42,0,1,1,0
2020,434715,42,1,1,1,0
2020,434715,44,0,4,1,3
2020,434715,44,1,4,1,3
2020,434751,0,0,2,1,1
2020,434751,10,0,2,1,1
2020,434751,10,4,2,1,1
2020,434751,40,0,2,1,1
2020,434751,40,4,2,1,1
2020,434751,42,0,2,1,1
2020,434751,42,4,2,1,1
2020,434821,0,0,25,1,24
2020,434821,50,0,25,1,24
2020,434900,0,0,24,12,12
2020,434900,10,0,24,12,12
2020,434900,10,1,24,12,12
2020,434900,40,0,24,12,12
2020,434900,40,1,24,12,12
2020,434900,41,0,24,12,12
2020,434900,41,1,24,12,12
2020,434900,44,0,24,12,12
2020,434900,44,1,24,12,12
2020,435000,0,0,409,226,183
2020,435000,10,0,409,226,183
2020,435000,10,1,45,29,16
2020,435000,10,2,82,57,25
2020,435000,10,3,210,118,92
2020,435000,10,4,72,22,50
2020,435000,20,0,68,53,15
2020,435000,20,1,29,22,7
2020,435000,20,2,30,24,6
2020,435000,20,3,8,6,2
2020,435000,20,4,1,1,0
2020,435000,30,0,44,29,15
2020,435000,30,1,1,0,1
2020,435000,30,2,3,3,0
2020,435000,30,3,40,26,14
2020,435000,40,0,297,144,153
2020,435000,40,1,15,7,8
2020,435000,40,2,49,30,19
2020,435000,40,3,162,86,76
2020,435000,40,4,71,21,50
2020,435000,42,0,297,144,153
2020,435000,42,1,15,7,8
2020,435000,42,2,49,30,19
2020,435000,42,3,162,86,76
2020,435000,42,4,71,21,50
2020,436304,0,0,56,22,34
2020,436304,10,0,56,22,34
2020,436304,10,1,5,2,3
2020,436304,10,2,6,0,6
2020,436304,10,3,11,3,8
2020,436304,10,4,33,16,17
2020,436304,10,6,1,1,0
2020,436304,40,0,56,22,34
2020,436304,40,1,5,2,3
2020,436304,40,2,6,0,6
2020,436304,40,3,11,3,8
2020,436304,40,4,33,16,17
2020,436304,40,6,1,1,0
2020,436304,42,0,53,20,33
2020,436304,42,1,5,2,3
2020,436304,42,2,6,0,6
2020,436304,42,3,10,3,7
2020,436304,42,4,31,14,17
2020,436304,42,6,1,1,0
2020,436304,43,0,3,2,1
2020,436304,43,3,1,0,1
2020,436304,43,4,2,2,0
2020,436429,0,0,176,124,52
2020,436429,10,0,176,124,52
2020,436429,10,4,176,124,52
2020,436429,40,0,176,124,52
2020,436429,40,4,176,124,52
2020,436429,41,0,176,124,52
2020,436429,41,4,176,124,52
2020,436429,45,0,176,124,52
2020,436429,45,4,176,124,52
2020,436614,0,0,7,5,2
2020,436614,10,0,7,5,2
2020,436614,10,1,7,5,2
2020,436614,40,0,7,5,2
2020,436614,40,1,7,5,2
2020,436614,42,0,7,5,2
2020,436614,42,1,7,5,2
2020,437097,0,0,24,18,6
2020,437097,10,0,22,17,5
2020,437097,10,1,2,2,0
2020,437097,10,4,14,10,4
2020,437097,10,5,6,5,1
2020,437097,40,0,22,17,5
2020,437097,40,1,2,2,0
2020,437097,40,4,14,10,4
2020,437097,40,5,6,5,1
2020,437097,41,0,16,12,4
2020,437097,41,1,2,2,0
2020,437097,41,4,14,10,4
2020,437097,42,0,6,5,1
2020,437097,42,5,6,5,1
2020,437097,44,0,16,12,4
2020,437097,44,1,2,2,0
2020,437097,44,4,14,10,4
2020,437097,50,0,2,1,1
2020,437103,0,0,149,67,82
2020,437103,10,0,149,67,82
2020,437103,10,1,26,7,19
2020,437103,10,2,41,16,25
2020,437103,10,3,30,17,13
2020,437103,10,4,51,26,25
2020,437103,10,6,1,1,0
2020,437103,40,0,149,67,82
2020,437103,40,1,26,7,19
2020,437103,40,2,41,16,25
2020,437103,40,3,30,17,13
2020,437103,40,4,51,26,25
2020,437103,40,6,1,1,0
2020,437103,42,0,148,66,82
2020,437103,42,1,26,7,19
2020,437103,42,2,41,16,25
2020,437103,42,3,30,17,13
2020,437103,42,4,50,25,25
2020,437103,42,6,1,1,0
2020,437103,43,0,1,1,0
2020,437103,43,4,1,1,0
2020,437635,0,0,26,3,23
2020,437635,10,0,26,3,23
2020,437635,10,4,26,3,23
2020,437635,40,0,26,3,23
2020,437635,40,4,26,3,23
2020,437635,41,0,26,3,23
2020,437635,41,4,26,3,23
2020,437635,45,0,26,3,23
2020,437635,45,4,26,3,23
2020,437732,0,0,9,2,7
2020,437732,10,0,9,2,7
2020,437732,10,2,1,1,0
2020,437732,10,3,8,1,7
2020,437732,40,0,9,2,7
2020,437732,40,2,1,1,0
2020,437732,40,3,8,1,7
2020,437732,41,0,9,2,7
2020,437732,41,2,1,1,0
2020,437732,41,3,8,1,7
2020,437732,44,0,9,2,7
2020,437732,44,2,1,1,0
2020,437732,44,3,8,1,7
2020,437769,0,0,2,0,2
2020,437769,10,0,2,0,2
2020,437769,10,4,2,0,2
2020,437769,40,0,2,0,2
2020,437769,40,4,2,0,2
2020,437769,41,0,2,0,2
2020,437769,41,4,2,0,2
2020,437769,45,0,2,0,2
2020,437769,45,4,2,0,2
2020,437936,0,0,22,2,20
2020,437936,10,0,22,2,20
2020,437936,10,4,22,2,20
2020,437936,40,0,22,2,20
2020,437936,40,4,22,2,20
2020,437936,41,0,22,2,20
2020,437936,41,4,22,2,20
2020,437936,45,0,22,2,20
2020,437936,45,4,22,2,20
2020,438151,0,0,4,1,3
2020,438151,10,0,4,1,3
2020,438151,10,6,4,1,3
2020,438151,40,0,4,1,3
2020,438151,40,6,4,1,3
2020,438151,41,0,4,1,3
2020,438151,41,6,4,1,3
2020,438151,45,0,4,1,3
2020,438151,45,6,4,1,3
2020,438179,0,0,2,0,2
2020,438179,10,0,2,0,2
2020,438179,10,4,2,0,2
2020,438179,40,0,2,0,2
2020,438179,40,4,2,0,2
2020,438179,41,0,2,0,2
2020,438179,41,4,2,0,2
2020,438179,45,0,2,0,2
2020,438179,45,4,2,0,2
2020,438258,0,0,10,4,6
2020,438258,10,0,10,4,6
2020,438258,10,4,10,4,6
2020,438258,40,0,10,4,6
2020,438258,40,4,10,4,6
2020,438258,41,0,10,4,6
2020,438258,41,4,10,4,6
2020,438258,45,0,10,4,6
2020,438258,45,4,10,4,6
2020,438498,0,0,53,24,29
2020,438498,50,0,53,24,29
2020,438504,0,0,30,30,0
2020,438504,50,0,30,30,0
2020,438586,0,0,6,5,1
2020,438586,50,0,6,5,1
2020,438708,0,0,13,6,7
2020,438708,10,0,13,6,7
2020,438708,10,2,3,1,2
2020,438708,10,3,3,2,1
2020,438708,10,4,7,3,4
2020,438708,40,0,13,6,7
2020,438708,40,2,3,1,2
2020,438708,40,3,3,2,1
2020,438708,40,4,7,3,4
2020,438708,42,0,13,6,7
2020,438708,42,2,3,1,2
2020,438708,42,3,3,2,1
2020,438708,42,4,7,3,4
2020,439118,0,0,6,0,6
2020,439118,10,0,6,0,6
2020,439118,10,4,6,0,6
2020,439118,40,0,6,0,6
2020,439118,40,4,6,0,6
2020,439118,41,0,6,0,6
2020,439118,41,4,6,0,6
2020,439118,45,0,6,0,6
2020,439118,45,4,6,0,6
2020,439190,0,0,48,20,28
2020,439190,10,0,48,20,28
2020,439190,10,6,48,20,28
2020,439190,20,0,43,19,24
2020,439190,20,6,43,19,24
2020,439190,30,0,3,1,2
2020,439190,30,6,3,1,2
2020,439190,40,0,2,0,2
2020,439190,40,6,2,0,2
2020,439190,42,0,2,0,2
2020,439190,42,6,2,0,2
2020,439288,0,0,40,18,22
2020,439288,10,0,40,18,22
2020,439288,10,1,6,1,5
2020,439288,10,2,21,12,9
2020,439288,10,3,8,4,4
2020,439288,10,4,3,1,2
2020,439288,10,5,2,0,2
2020,439288,40,0,40,18,22
2020,439288,40,1,6,1,5
2020,439288,40,2,21,12,9
2020,439288,40,3,8,4,4
2020,439288,40,4,3,1,2
2020,439288,40,5,2,0,2
2020,439288,41,0,15,9,6
2020,439288,41,1,3,1,2
2020,439288,41,2,11,7,4
2020,439288,41,3,1,1,0
2020,439288,42,0,25,9,16
2020,439288,42,1,3,0,3
2020,439288,42,2,10,5,5
2020,439288,42,3,7,3,4
2020,439288,42,4,3,1,2
2020,439288,42,5,2,0,2
2020,439288,44,0,15,9,6
2020,439288,44,1,3,1,2
2020,439288,44,2,11,7,4
2020,439288,44,3,1,1,0
2020,439367,0,0,24,6,18
2020,439367,10,0,24,6,18
2020,439367,10,4,24,6,18
2020,439367,40,0,24,6,18
2020,439367,40,4,24,6,18
2020,439367,41,0,24,6,18
2020,439367,41,4,24,6,18
2020,439367,45,0,24,6,18
2020,439367,45,4,24,6,18
2020,439446,0,0,6,4,2
2020,439446,10,0,6,4,2
2020,439446,10,4,6,4,2
2020,439446,40,0,6,4,2
2020,439446,40,4,6,4,2
2020,439446,41,0,6,4,2
2020,439446,41,4,6,4,2
2020,439446,44,0,6,4,2
2020,439446,44,4,6,4,2
2020,439507,0,0,1,1,0
2020,439507,10,0,1,1,0
2020,439507,10,4,1,1,0
2020,439507,40,0,1,1,0
2020,439507,40,4,1,1,0
2020,439507,41,0,1,1,0
2020,439507,41,4,1,1,0
2020,439507,45,0,1,1,0
2020,439507,45,4,1,1,0
2020,439570,0,0,23,5,18
2020,439570,10,0,20,3,17
2020,439570,10,4,20,3,17
2020,439570,40,0,20,3,17
2020,439570,40,4,20,3,17
2020,439570,41,0,20,3,17
2020,439570,41,4,20,3,17
2020,439570,45,0,20,3,17
2020,439570,45,4,20,3,17
2020,439570,50,0,3,2,1
2020,439701,0,0,12,10,2
2020,439701,10,0,12,10,2
2020,439701,10,1,6,6,0
2020,439701,10,2,3,2,1
2020,439701,10,3,3,2,1
2020,439701,40,0,12,10,2
2020,439701,40,1,6,6,0
2020,439701,40,2,3,2,1
2020,439701,40,3,3,2,1
2020,439701,41,0,3,3,0
2020,439701,41,1,3,3,0
2020,439701,42,0,4,4,0
2020,439701,42,1,2,2,0
2020,439701,42,2,2,2,0
2020,439701,43,0,5,3,2
2020,439701,43,1,1,1,0
2020,439701,43,2,1,0,1
2020,439701,43,3,3,2,1
2020,439701,44,0,3,3,0
2020,439701,44,1,3,3,0
2020,439738,0,0,13,4,9
2020,439738,10,0,13,4,9
2020,439738,10,4,13,4,9
2020,439738,40,0,13,4,9
2020,439738,40,4,13,4,9
2020,439738,41,0,13,4,9
2020,439738,41,4,13,4,9
2020,439738,45,0,13,4,9
2020,439738,45,4,13,4,9
2020,439792,0,0,7,1,6
2020,439792,10,0,7,1,6
2020,439792,10,4,7,1,6
2020,439792,40,0,7,1,6
2020,439792,40,4,7,1,6
2020,439792,41,0,7,1,6
2020,439792,41,4,7,1,6
2020,439792,45,0,7,1,6
2020,439792,45,4,7,1,6
2020,440031,0,0,57,25,32
2020,440031,10,0,52,23,29
2020,440031,10,1,24,13,11
2020,440031,10,2,11,6,5
2020,440031,10,3,17,4,13
2020,440031,40,0,52,23,29
2020,440031,40,1,24,13,11
2020,440031,40,2,11,6,5
2020,440031,40,3,17,4,13
2020,440031,41,0,52,23,29
2020,440031,41,1,24,13,11
2020,440031,41,2,11,6,5
2020,440031,41,3,17,4,13
2020,440031,44,0,52,23,29
2020,440031,44,1,24,13,11
2020,440031,44,2,11,6,5
2020,440031,44,3,17,4,13
2020,440031,50,0,5,2,3
2020,440059,0,0,47,45,2
2020,440059,50,0,47,45,2
2020,440138,0,0,1,0,1
2020,440138,50,0,1,0,1
2020,440262,0,0,16,15,1
2020,440262,10,0,16,15,1
2020,440262,10,1,4,3,1
2020,440262,10,4,12,12,0
2020,440262,40,0,16,15,1
2020,440262,40,1,4,3,1
2020,440262,40,4,12,12,0
2020,440262,43,0,16,15,1
2020,440262,43,1,4,3,1
2020,440262,43,4,12,12,0
2020,440402,0,0,69,27,42
2020,440402,10,0,69,27,42
2020,440402,10,1,1,1,0
2020,440402,10,2,4,1,3
2020,440402,10,3,27,5,22
2020,440402,10,4,37,20,17
2020,440402,20,0,3,1,2
2020,440402,20,1,1,1,0
2020,440402,20,3,2,0,2
2020,440402,40,0,66,26,40
2020,440402,40,2,4,1,3
2020,440402,40,3,25,5,20
2020,440402,40,4,37,20,17
2020,440402,42,0,66,26,40
2020,440402,42,2,4,1,3
2020,440402,42,3,25,5,20
2020,440402,42,4,37,20,17
2020,440651,0,0,19,4,15
2020,440651,10,0,19,4,15
2020,440651,10,1,19,4,15
2020,440651,20,0,14,2,12
2020,440651,20,1,14,2,12
2020,440651,40,0,5,2,3
2020,440651,40,1,5,2,3
2020,440651,43,0,5,2,3
2020,440651,43,1,5,2,3
2020,440794,0,0,14,7,7
2020,440794,10,0,14,7,7
2020,440794,10,1,4,3,1
2020,440794,10,2,4,2,2
2020,440794,10,3,6,2,4
2020,440794,40,0,14,7,7
2020,440794,40,1,4,3,1
2020,440794,40,2,4,2,2
2020,440794,40,3,6,2,4
2020,440794,41,0,14,7,7
2020,440794,41,1,4,3,1
2020,440794,41,2,4,2,2
2020,440794,41,3,6,2,4
2020,440794,44,0,14,7,7
2020,440794,44,1,4,3,1
2020,440794,44,2,4,2,2
2020,440794,44,3,6,2,4
2020,440916,0,0,25,11,14
2020,440916,10,0,25,11,14
2020,440916,10,1,2,2,0
2020,440916,10,2,15,7,8
2020,440916,10,4,8,2,6
2020,440916,20,0,11,4,7
2020,440916,20,1,2,2,0
2020,440916,20,2,9,2,7
2020,440916,30,0,6,5,1
2020,440916,30,2,6,5,1
2020,440916,40,0,8,2,6
2020,440916,40,4,8,2,6
2020,440916,43,0,8,2,6
2020,440916,43,4,8,2,6
2020,441025,0,0,5,3,2
2020,441025,10,0,5,3,2
2020,441025,10,4,5,3,2
2020,441025,40,0,5,3,2
2020,441025,40,4,5,3,2
2020,441025,41,0,5,3,2
2020,441025,41,4,5,3,2
2020,441025,45,0,5,3,2
2020,441025,45,4,5,3,2
2020,441052,0,0,29,5,24
2020,441052,50,0,29,5,24
2020,441070,0,0,8,5,3
2020,441070,10,0,6,4,2
2020,441070,10,4,6,4,2
2020,441070,40,0,6,4,2
2020,441070,40,4,6,4,2
2020,441070,41,0,6,4,2
2020,441070,41,4,6,4,2
2020,441070,45,0,6,4,2
2020,441070,45,4,6,4,2
2020,441070,50,0,2,1,1
2020,441104,0,0,14,7,7
2020,441104,10,0,14,7,7
2020,441104,10,1,6,3,3
2020,441104,10,2,6,2,4
2020,441104,10,3,2,2,0
2020,441104,40,0,14,7,7
2020,441104,40,1,6,3,3
2020,441104,40,2,6,2,4
2020,441104,40,3,2,2,0
2020,441104,41,0,14,7,7
2020,441104,41,1,6,3,3
2020,441104,41,2,6,2,4
2020,441104,41,3,2,2,0
2020,441104,44,0,14,7,7
2020,441104,44,1,6,3,3
2020,441104,44,2,6,2,4
2020,441104,44,3,2,2,0
2020,441131,0,0,8,5,3
2020,441131,10,0,8,5,3
2020,441131,10,1,2,2,0
2020,441131,10,2,5,2,3
2020,441131,10,3,1,1,0
2020,441131,40,0,8,5,3
2020,441131,40,1,2,2,0
2020,441131,40,2,5,2,3
2020,441131,40,3,1,1,0
2020,441131,42,0,8,5,3
2020,441131,42,1,2,2,0
2020,441131,42,2,5,2,3
2020,441131,42,3,1,1,0
2020,441229,0,0,76,42,34
2020,441229,50,0,76,42,34
2020,441371,0,0,311,62,249
2020,441371,10,0,311,62,249
2020,441371,10,4,311,62,249
2020,441371,40,0,311,62,249
2020,441371,40,4,311,62,249
2020,441371,41,0,311,62,249
2020,441371,41,4,311,62,249
2020,441371,45,0,311,62,249
2020,441371,45,4,311,62,249
2020,441423,0,0,8,3,5
2020,441423,10,0,8,3,5
2020,441423,10,4,8,3,5
2020,441423,40,0,8,3,5
2020,441423,40,4,8,3,5
2020,441423,41,0,8,3,5
2020,441423,41,4,8,3,5
2020,441423,45,0,8,3,5
2020,441423,45,4,8,3,5
2020,441609,0,0,11,11,0
2020,441609,10,0,11,11,0
2020,441609,10,4,11,11,0
2020,441609,40,0,11,11,0
2020,441609,40,4,11,11,0
2020,441609,42,0,11,11,0
2020,441609,42,4,11,11,0
2020,441636,0,0,14,3,11
2020,441636,10,0,14,3,11
2020,441636,10,4,14,3,11
2020,441636,40,0,14,3,11
2020,441636,40,4,14,3,11
2020,441636,41,0,14,3,11
2020,441636,41,4,14,3,11
2020,441636,45,0,14,3,11
2020,441636,45,4,14,3,11
2020,441742,0,0,15,4,11
2020,441742,10,0,15,4,11
2020,441742,10,4,15,4,11
2020,441742,40,0,15,4,11
2020,441742,40,4,15,4,11
2020,441742,41,0,15,4,11
2020,441742,41,4,15,4,11
2020,441742,45,0,15,4,11
2020,441742,45,4,15,4,11
2020,441760,0,0,71,29,42
2020,441760,10,0,71,29,42
2020,441760,10,4,71,29,42
2020,441760,20,0,50,19,31
2020,441760,20,4,50,19,31
2020,441760,30,0,14,8,6
2020,441760,30,4,14,8,6
2020,441760,40,0,7,2,5
2020,441760,40,4,7,2,5
2020,441760,42,0,6,2,4
2020,441760,42,4,6,2,4
2020,441760,43,0,1,0,1
2020,441760,43,4,1,0,1
2020,441858,0,0,7,0,7
2020,441858,10,0,7,0,7
2020,441858,10,4,7,0,7
2020,441858,40,0,7,0,7
2020,441858,40,4,7,0,7
2020,441858,41,0,7,0,7
2020,441858,41,4,7,0,7
2020,441858,45,0,7,0,7
2020,441858,45,4,7,0,7
2020,441900,0,0,106,35,71
2020,441900,10,0,106,35,71
2020,441900,10,1,6,3,3
2020,441900,10,2,24,11,13
2020,441900,10,3,38,9,29
2020,441900,10,5,38,12,26
2020,441900,20,0,30,14,16
2020,441900,20,1,6,3,3
2020,441900,20,2,24,11,13
2020,441900,30,0,38,9,29
2020,441900,30,3,38,9,29
2020,441900,40,0,38,12,26
2020,441900,40,5,38,12,26
2020,441900,42,0,38,12,26
2020,441900,42,5,38,12,26
2020,441937,0,0,223,91,132
2020,441937,10,0,223,91,132
2020,441937,10,1,57,29,28
2020,441937,10,2,32,13,19
2020,441937,10,3,63,21,42
2020,441937,10,5,71,28,43
2020,441937,20,0,89,42,47
2020,441937,20,1,57,29,28
2020,441937,20,2,32,13,19
2020,441937,30,0,63,21,42
2020,441937,30,3,63,21,42
2020,441937,40,0,71,28,43
2020,441937,40,5,71,28,43
2020,441937,41,0,52,22,30
2020,441937,41,5,52,22,30
2020,441937,42,0,18,6,12
2020,441937,42,5,18,6,12
2020,441937,43,0,1,0,1
2020,441937,43,5,1,0,1
2020,441937,44,0,52,22,30
2020,441937,44,5,52,22,30
2020,441982,0,0,47,24,23
2020,441982,10,0,47,24,23
2020,441982,10,1,19,10,9
2020,441982,10,2,9,6,3
2020,441982,10,3,13,5,8
2020,441982,10,4,6,3,3
2020,441982,40,0,47,24,23
2020,441982,40,1,19,10,9
2020,441982,40,2,9,6,3
2020,441982,40,3,13,5,8
2020,441982,40,4,6,3,3
2020,441982,41,0,43,22,21
2020,441982,41,1,19,10,9
2020,441982,41,2,9,6,3
2020,441982,41,3,11,4,7
2020,441982,41,4,4,2,2
2020,441982,42,0,4,2,2
2020,441982,42,3,2,1,1
2020,441982,42,4,2,1,1
2020,441982,44,0,40,20,20
2020,441982,44,1,19,10,9
2020,441982,44,2,9,6,3
2020,441982,44,3,11,4,7
2020,441982,44,4,1,0,1
2020,441982,45,0,3,2,1
2020,441982,45,4,3,2,1
2020,442064,0,0,7,2,5
2020,442064,10,0,7,2,5
2020,442064,10,2,2,0,2
2020,442064,10,3,5,2,3
2020,442064,40,0,7,2,5
2020,442064,40,2,2,0,2
2020,442064,40,3,5,2,3
2020,442064,41,0,7,2,5
2020,442064,41,2,2,0,2
2020,442064,41,3,5,2,3
2020,442064,44,0,6,2,4
2020,442064,44,2,1,0,1
2020,442064,44,3,5,2,3
2020,442064,45,0,1,0,1
2020,442064,45,2,1,0,1
2020,442134,0,0,19,2,17
2020,442134,10,0,19,2,17
2020,442134,10,4,19,2,17
2020,442134,40,0,19,2,17
2020,442134,40,4,19,2,17
2020,442134,41,0,19,2,17
2020,442134,41,4,19,2,17
2020,442134,45,0,19,2,17
2020,442134,45,4,19,2,17
2020,442295,0,0,26,17,9
2020,442295,10,0,24,15,9
2020,442295,10,1,17,12,5
2020,442295,10,3,7,3,4
2020,442295,20,0,10,7,3
2020,442295,20,1,10,7,3
2020,442295,30,0,3,2,1
2020,442295,30,1,3,2,1
2020,442295,40,0,11,6,5
2020,442295,40,1,4,3,1
2020,442295,40,3,7,3,4
2020,442295,41,0,11,6,5
2020,442295,41,1,4,3,1
2020,442295,41,3,7,3,4
2020,442295,44,0,11,6,5
2020,442295,44,1,4,3,1
2020,442295,44,3,7,3,4
2020,442295,50,0,2,2,0
2020,442356,0,0,71,9,62
2020,442356,10,0,71,9,62
2020,442356,10,1,3,1,2
2020,442356,10,2,10,0,10
2020,442356,10,3,14,2,12
2020,442356,10,4,41,5,36
2020,442356,10,5,3,1,2
2020,442356,40,0,71,9,62
2020,442356,40,1,3,1,2
2020,442356,40,2,10,0,10
2020,442356,40,3,14,2,12
2020,442356,40,4,41,5,36
2020,442356,40,5,3,1,2
2020,442356,42,0,71,9,62
2020,442356,42,1,3,1,2
2020,442356,42,2,10,0,10
2020,442356,42,3,14,2,12
2020,442356,42,4,41,5,36
2020,442356,42,5,3,1,2
2020,442426,0,0,19,5,14
2020,442426,10,0,19,5,14
2020,442426,10,4,19,5,14
2020,442426,40,0,19,5,14
2020,442426,40,4,19,5,14
2020,442426,41,0,19,5,14
2020,442426,41,4,19,5,14
2020,442426,45,0,19,5,14
2020,442426,45,4,19,5,14
2020,442444,0,0,25,9,16
2020,442444,10,0,25,9,16
2020,442444,10,4,25,9,16
2020,442444,40,0,25,9,16
2020,442444,40,4,25,9,16
2020,442444,41,0,25,9,16
2020,442444,41,4,25,9,16
2020,442444,45,0,25,9,16
2020,442444,45,4,25,9,16
2020,442569,0,0,21,8,13
2020,442569,10,0,21,8,13
2020,442569,10,1,1,0,1
2020,442569,10,2,6,2,4
2020,442569,10,3,11,6,5
2020,442569,10,4,2,0,2
2020,442569,10,6,1,0,1
2020,442569,40,0,21,8,13
2020,442569,40,1,1,0,1
2020,442569,40,2,6,2,4
2020,442569,40,3,11,6,5
2020,442569,40,4,2,0,2
2020,442569,40,6,1,0,1
2020,442569,41,0,21,8,13
2020,442569,41,1,1,0,1
2020,442569,41,2,6,2,4
2020,442569,41,3,11,6,5
2020,442569,41,4,2,0,2
2020,442569,41,6,1,0,1
2020,442569,45,0,21,8,13
2020,442569,45,1,1,0,1
2020,442569,45,2,6,2,4
2020,442569,45,3,11,6,5
2020,442569,45,4,2,0,2
2020,442569,45,6,1,0,1
2020,442602,0,0,7,1,6
2020,442602,10,0,7,1,6
2020,442602,10,4,7,1,6
2020,442602,40,0,7,1,6
2020,442602,40,4,7,1,6
2020,442602,41,0,7,1,6
2020,442602,41,4,7,1,6
2020,442602,45,0,7,1,6
2020,442602,45,4,7,1,6
2020,442781,0,0,14,8,6
2020,442781,10,0,14,8,6
2020,442781,10,4,14,8,6
2020,442781,40,0,14,8,6
2020,442781,40,4,14,8,6
2020,442781,42,0,14,8,6
2020,442781,42,4,14,8,6
2020,442806,0,0,154,94,60
2020,442806,10,0,154,94,60
2020,442806,10,1,23,15,8
2020,442806,10,2,36,28,8
2020,442806,10,3,80,45,35
2020,442806,10,4,15,6,9
2020,442806,20,0,2,2,0
2020,442806,20,1,2,2,0
2020,442806,30,0,131,78,53
2020,442806,30,1,21,13,8
2020,442806,30,2,34,26,8
2020,442806,30,3,72,38,34
2020,442806,30,4,4,1,3
2020,442806,40,0,21,14,7
2020,442806,40,2,2,2,0
2020,442806,40,3,8,7,1
2020,442806,40,4,11,5,6
2020,442806,42,0,12,11,1
2020,442806,42,2,2,2,0
2020,442806,42,3,8,7,1
2020,442806,42,4,2,2,0
2020,442806,43,0,9,3,6
2020,442806,43,4,9,3,6
2020,442842,0,0,4,2,2
2020,442842,10,0,4,2,2
2020,442842,10,4,4,2,2
2020,442842,40,0,4,2,2
2020,442842,40,4,4,2,2
2020,442842,42,0,4,2,2
2020,442842,42,4,4,2,2
2020,442879,0,0,1,0,1
2020,442879,50,0,1,0,1
2020,442930,0,0,10,8,2
2020,442930,10,0,10,8,2
2020,442930,10,4,10,8,2
2020,442930,40,0,10,8,2
2020,442930,40,4,10,8,2
2020,442930,41,0,10,8,2
2020,442930,41,4,10,8,2
2020,442930,45,0,10,8,2
2020,442930,45,4,10,8,2
2020,443049,0,0,8,7,1
2020,443049,10,0,8,7,1
2020,443049,10,1,5,4,1
2020,443049,10,2,1,1,0
2020,443049,10,4,2,2,0
2020,443049,40,0,8,7,1
2020,443049,40,1,5,4,1
2020,443049,40,2,1,1,0
2020,443049,40,4,2,2,0
2020,443049,42,0,8,7,1
2020,443049,42,1,5,4,1
2020,443049,42,2,1,1,0
2020,443049,42,4,2,2,0
2020,443076,0,0,4,1,3
2020,443076,10,0,3,1,2
2020,443076,10,1,1,0,1
2020,443076,10,2,1,1,0
2020,443076,10,3,1,0,1
2020,443076,20,0,1,0,1
2020,443076,20,1,1,0,1
2020,443076,30,0,2,1,1
2020,443076,30,2,1,1,0
2020,443076,30,3,1,0,1
2020,443076,50,0,1,0,1
2020,443128,0,0,9,9,0
2020,443128,10,0,9,9,0
2020,443128,10,1,9,9,0
2020,443128,40,0,9,9,0
2020,443128,40,1,9,9,0
2020,443128,41,0,9,9,0
2020,443128,41,1,9,9,0
2020,443128,45,0,9,9,0
2020,443128,45,1,9,9,0
2020,443261,0,0,12,4,8
2020,443261,10,0,12,4,8
2020,443261,10,4,12,4,8
2020,443261,40,0,12,4,8
2020,443261,40,4,12,4,8
2020,443261,41,0,12,4,8
2020,443261,41,4,12,4,8
2020,443261,45,0,12,4,8
2020,443261,45,4,12,4,8
2020,443331,0,0,47,20,27
2020,443331,10,0,45,18,27
2020,443331,10,2,10,5,5
2020,443331,10,3,12,6,6
2020,443331,10,4,23,7,16
2020,443331,40,0,45,18,27
2020,443331,40,2,10,5,5
2020,443331,40,3,12,6,6
2020,443331,40,4,23,7,16
2020,443331,41,0,45,18,27
2020,443331,41,2,10,5,5
2020,443331,41,3,12,6,6
2020,443331,41,4,23,7,16
2020,443331,45,0,45,18,27
2020,443331,45,2,10,5,5
2020,443331,45,3,12,6,6
2020,443331,45,4,23,7,16
2020,443331,50,0,2,2,0
2020,443377,0,0,10,8,2
2020,443377,10,0,10,8,2
2020,443377,10,4,10,8,2
2020,443377,40,0,10,8,2
2020,443377,40,4,10,8,2
2020,443377,41,0,10,8,2
2020,443377,41,4,10,8,2
2020,443377,45,0,10,8,2
2020,443377,45,4,10,8,2
2020,443410,0,0,71,56,15
2020,443410,10,0,71,56,15
2020,443410,10,1,7,5,2
2020,443410,10,2,9,6,3
2020,443410,10,3,16,13,3
2020,443410,10,5,39,32,7
2020,443410,40,0,71,56,15
2020,443410,40,1,7,5,2
2020,443410,40,2,9,6,3
2020,443410,40,3,16,13,3
2020,443410,40,5,39,32,7
2020,443410,41,0,71,56,15
2020,443410,41,1,7,5,2
2020,443410,41,2,9,6,3
2020,443410,41,3,16,13,3
2020,443410,41,5,39,32,7
2020,443410,45,0,71,56,15
2020,443410,45,1,7,5,2
2020,443410,45,2,9,6,3
2020,443410,45,3,16,13,3
2020,443410,45,5,39,32,7
2020,443492,0,0,59,20,39
2020,443492,10,0,58,20,38
2020,443492,10,1,10,3,7
2020,443492,10,2,11,1,10
2020,443492,10,3,25,8,17
2020,443492,10,4,11,8,3
2020,443492,10,6,1,0,1
2020,443492,20,0,8,2,6
2020,443492,20,1,7,2,5
2020,443492,20,2,1,0,1
2020,443492,30,0,9,3,6
2020,443492,30,1,1,0,1
2020,443492,30,2,2,0,2
2020,443492,30,3,6,3,3
2020,443492,40,0,41,15,26
2020,443492,40,1,2,1,1
2020,443492,40,2,8,1,7
2020,443492,40,3,19,5,14
2020,443492,40,4,11,8,3
2020,443492,40,6,1,0,1
2020,443492,42,0,41,15,26
2020,443492,42,1,2,1,1
2020,443492,42,2,8,1,7
2020,443492,42,3,19,5,14
2020,443492,42,4,11,8,3
2020,443492,42,6,1,0,1
2020,443492,50,0,1,0,1
2020,443562,0,0,43,21,22
2020,443562,10,0,43,21,22
2020,443562,10,1,43,21,22
2020,443562,40,0,43,21,22
2020,443562,40,1,43,21,22
2020,443562,41,0,43,21,22
2020,443562,41,1,43,21,22
2020,443562,44,0,43,21,22
2020,443562,44,1,43,21,22
2020,443571,0,0,5,4,1
2020,443571,10,0,5,4,1
2020,443571,10,4,5,4,1
2020,443571,40,0,5,4,1
2020,443571,40,4,5,4,1
2020,443571,41,0,5,4,1
2020,443571,41,4,5,4,1
2020,443571,45,0,5,4,1
2020,443571,45,4,5,4,1
2020,443599,0,0,17,7,10
2020,443599,10,0,17,7,10
2020,443599,10,1,15,7,8
2020,443599,10,2,1,0,1
2020,443599,10,3,1,0,1
2020,443599,40,0,17,7,10
2020,443599,40,1,15,7,8
2020,443599,40,2,1,0,1
2020,443599,40,3,1,0,1
2020,443599,41,0,17,7,10
2020,443599,41,1,15,7,8
2020,443599,41,2,1,0,1
2020,443599,41,3,1,0,1
2020,443599,45,0,17,7,10
2020,443599,45,1,15,7,8
2020,443599,45,2,1,0,1
2020,443599,45,3,1,0,1
2020,443650,0,0,7,2,5
2020,443650,10,0,7,2,5
2020,443650,10,4,7,2,5
2020,443650,40,0,7,2,5
2020,443650,40,4,7,2,5
2020,443650,41,0,7,2,5
2020,443650,41,4,7,2,5
2020,443650,45,0,7,2,5
2020,443650,45,4,7,2,5
2020,443748,0,0,15,5,10
2020,443748,10,0,15,5,10
2020,443748,10,4,15,5,10
2020,443748,40,0,15,5,10
2020,443748,40,4,15,5,10
2020,443748,41,0,15,5,10
2020,443748,41,4,15,5,10
2020,443748,45,0,15,5,10
2020,443748,45,4,15,5,10
2020,444088,0,0,14,2,12
2020,444088,10,0,14,2,12
2020,444088,10,4,14,2,12
2020,444088,40,0,14,2,12
2020,444088,40,4,14,2,12
2020,444088,41,0,14,2,12
2020,444088,41,4,14,2,12
2020,444088,45,0,14,2,12
2020,444088,45,4,14,2,12
2020,444130,0,0,94,40,54
2020,444130,10,0,94,40,54
2020,444130,10,1,59,27,32
2020,444130,10,2,25,7,18
2020,444130,10,3,10,6,4
2020,444130,40,0,94,40,54
2020,444130,40,1,59,27,32
2020,444130,40,2,25,7,18
2020,444130,40,3,10,6,4
2020,444130,41,0,94,40,54
2020,444130,41,1,59,27,32
2020,444130,41,2,25,7,18
2020,444130,41,3,10,6,4
2020,444130,45,0,94,40,54
2020,444130,45,1,59,27,32
2020,444130,45,2,25,7,18
2020,444130,45,3,10,6,4
2020,444219,0,0,126,58,68
2020,444219,10,0,126,58,68
2020,444219,10,4,126,58,68
2020,444219,20,0,95,49,46
2020,444219,20,4,95,49,46
2020,444219,30,0,31,9,22
2020,444219,30,4,31,9,22
2020,444343,0,0,5,0,5
2020,444343,10,0,5,0,5
2020,444343,10,4,5,0,5
2020,444343,40,0,5,0,5
2020,444343,40,4,5,0,5
2020,444343,41,0,5,0,5
2020,444343,41,4,5,0,5
2020,444343,45,0,5,0,5
2020,444343,45,4,5,0,5
2020,444398,0,0,4,2,2
2020,444398,10,0,4,2,2
2020,444398,10,1,1,0,1
2020,444398,10,3,3,2,1
2020,444398,40,0,4,2,2
2020,444398,40,1,1,0,1
2020,444398,40,3,3,2,1
2020,444398,42,0,4,2,2
2020,444398,42,1,1,0,1
2020,444398,42,3,3,2,1
2020,444556,0,0,18,11,7
2020,444556,10,0,18,11,7
2020,444556,10,4,18,11,7
2020,444556,40,0,18,11,7
2020,444556,40,4,18,11,7
2020,444556,41,0,18,11,7
2020,444556,41,4,18,11,7
2020,444556,45,0,18,11,7
2020,444556,45,4,18,11,7
2020,444565,0,0,22,14,8
2020,444565,10,0,15,12,3
2020,444565,10,4,15,12,3
2020,444565,40,0,15,12,3
2020,444565,40,4,15,12,3
2020,444565,41,0,15,12,3
2020,444565,41,4,15,12,3
2020,444565,45,0,15,12,3
2020,444565,45,4,15,12,3
2020,444565,50,0,7,2,5
2020,444787,0,0,88,15,73
2020,444787,10,0,88,15,73
2020,444787,10,3,87,15,72
2020,444787,10,4,1,0,1
2020,444787,40,0,88,15,73
2020,444787,40,3,87,15,72
2020,444787,40,4,1,0,1
2020,444787,41,0,88,15,73
2020,444787,41,3,87,15,72
2020,444787,41,4,1,0,1
2020,444787,45,0,88,15,73
2020,444787,45,3,87,15,72
2020,444787,45,4,1,0,1
2020,444811,0,0,1,0,1
2020,444811,50,0,1,0,1
2020,444866,0,0,10,1,9
2020,444866,10,0,10,1,9
2020,444866,10,4,10,1,9
2020,444866,40,0,10,1,9
2020,444866,40,4,10,1,9
2020,444866,41,0,10,1,9
2020,444866,41,4,10,1,9
2020,444866,45,0,10,1,9
2020,444866,45,4,10,1,9
2020,444954,0,0,51,20,31
2020,444954,10,0,51,20,31
2020,444954,10,1,13,6,7
2020,444954,10,2,15,6,9
2020,444954,10,3,18,5,13
2020,444954,10,4,5,3,2
2020,444954,20,0,4,2,2
2020,444954,20,1,4,2,2
2020,444954,40,0,47,18,29
2020,444954,40,1,9,4,5
2020,444954,40,2,15,6,9
2020,444954,40,3,18,5,13
2020,444954,40,4,5,3,2
2020,444954,42,0,47,18,29
2020,444954,42,1,9,4,5
2020,444954,42,2,15,6,9
2020,444954,42,3,18,5,13
2020,444954,42,4,5,3,2
2020,445027,0,0,90,34,56
2020,445027,50,0,90,34,56
2020,445054,0,0,11,9,2
2020,445054,10,0,11,9,2
2020,445054,10,1,7,6,1
2020,445054,10,2,2,1,1
2020,445054,10,3,2,2,0
2020,445054,20,0,9,7,2
2020,445054,20,1,7,6,1
2020,445054,20,2,2,1,1
2020,445054,30,0,2,2,0
2020,445054,30,3,2,2,0
2020,445133,0,0,2,2,0
2020,445133,50,0,2,2,0
2020,445188,0,0,450,240,210
2020,445188,10,0,450,240,210
2020,445188,10,1,89,57,32
2020,445188,10,2,81,47,34
2020,445188,10,3,121,55,66
2020,445188,10,5,159,81,78
2020,445188,20,0,186,113,73
2020,445188,20,1,89,57,32
2020,445188,20,2,81,47,34
2020,445188,20,5,16,9,7
2020,445188,30,0,129,60,69
2020,445188,30,3,121,55,66
2020,445188,30,5,8,5,3
2020,445188,40,0,135,67,68
2020,445188,40,5,135,67,68
2020,445188,41,0,68,32,36
2020,445188,41,5,68,32,36
2020,445188,42,0,67,35,32
2020,445188,42,5,67,35,32
2020,445188,44,0,68,32,36
2020,445188,44,5,68,32,36
2020,445203,0,0,8,0,8
2020,445203,50,0,8,0,8
2020,445230,0,0,36,17,19
2020,445230,10,0,36,17,19
2020,445230,10,4,36,17,19
2020,445230,40,0,36,17,19
2020,445230,40,4,36,17,19
2020,445230,41,0,36,17,19
2020,445230,41,4,36,17,19
2020,445230,45,0,36,17,19
2020,445230,45,4,36,17,19
2020,445249,0,0,11,4,7
2020,445249,50,0,11,4,7
2020,445267,0,0,14,2,12
2020,445267,10,0,14,2,12
2020,445267,10,2,5,0,5
2020,445267,10,3,9,2,7
2020,445267,30,0,4,1,3
2020,445267,30,3,4,1,3
2020,445267,40,0,10,1,9
2020,445267,40,2,5,0,5
2020,445267,40,3,5,1,4
2020,445267,42,0,10,1,9
2020,445267,42,2,5,0,5
2020,445267,42,3,5,1,4
2020,445461,0,0,7,3,4
2020,445461,10,0,7,3,4
2020,445461,10,4,7,3,4
2020,445461,40,0,7,3,4
2020,445461,40,4,7,3,4
2020,445461,41,0,7,3,4
2020,445461,41,4,7,3,4
2020,445461,45,0,7,3,4
2020,445461,45,4,7,3,4
2020,445692,0,0,12,12,0
2020,445692,10,0,12,12,0
2020,445692,10,4,12,12,0
2020,445692,40,0,12,12,0
2020,445692,40,4,12,12,0
2020,445692,41,0,12,12,0
2020,445692,41,4,12,12,0
2020,445692,45,0,12,12,0
2020,445692,45,4,12,12,0
2020,445708,0,0,80,42,38
2020,445708,10,0,80,42,38
2020,445708,10,1,20,13,7
2020,445708,10,2,38,15,23
2020,445708,10,3,18,14,4
2020,445708,10,4,1,0,1
2020,445708,10,5,3,0,3
2020,445708,40,0,80,42,38
2020,445708,40,1,20,13,7
2020,445708,40,2,38,15,23
2020,445708,40,3,18,14,4
2020,445708,40,4,1,0,1
2020,445708,40,5,3,0,3
2020,445708,41,0,38,16,22
2020,445708,41,1,12,7,5
2020,445708,41,2,26,9,17
2020,445708,42,0,42,26,16
2020,445708,42,1,8,6,2
2020,445708,42,2,12,6,6
2020,445708,42,3,18,14,4
2020,445708,42,4,1,0,1
2020,445708,42,5,3,0,3
2020,445708,44,0,38,16,22
2020,445708,44,1,12,7,5
2020,445708,44,2,26,9,17
2020,445735,0,0,123,66,57
2020,445735,10,0,123,66,57
2020,445735,10,1,4,3,1
2020,445735,10,2,44,33,11
2020,445735,10,3,72,29,43
2020,445735,10,4,3,1,2
2020,445735,40,0,123,66,57
2020,445735,40,1,4,3,1
2020,445735,40,2,44,33,11
2020,445735,40,3,72,29,43
2020,445735,40,4,3,1,2
2020,445735,41,0,118,64,54
2020,445735,41,1,4,3,1
2020,445735,41,2,44,33,11
2020,445735,41,3,70,28,42
2020,445735,42,0,5,2,3
2020,445735,42,3,2,1,1
2020,445735,42,4,3,1,2
2020,445735,44,0,118,64,54
2020,445735,44,1,4,3,1
2020,445735,44,2,44,33,11
2020,445735,44,3,70,28,42
2020,445744,0,0,12,1,11
2020,445744,10,0,12,1,11
2020,445744,10,4,12,1,11
2020,445744,40,0,12,1,11
2020,445744,40,4,12,1,11
2020,445744,41,0,12,1,11
2020,445744,41,4,12,1,11
2020,445744,45,0,12,1,11
2020,445744,45,4,12,1,11
2020,445869,0,0,24,12,12
2020,445869,10,0,24,12,12
2020,445869,10,1,6,5,1
2020,445869,10,2,11,4,7
2020,445869,10,3,7,3,4
2020,445869,40,0,24,12,12
2020,445869,40,1,6,5,1
2020,445869,40,2,11,4,7
2020,445869,40,3,7,3,4
2020,445869,41,0,24,12,12
2020,445869,41,1,6,5,1
2020,445869,41,2,11,4,7
2020,445869,41,3,7,3,4
2020,445869,44,0,24,12,12
2020,445869,44,1,6,5,1
2020,445869,44,2,11,4,7
2020,445869,44,3,7,3,4
2020,445948,0,0,43,7,36
2020,445948,10,0,43,7,36
2020,445948,10,6,43,7,36
2020,445948,40,0,43,7,36
2020,445948,40,6,43,7,36
2020,445948,41,0,43,7,36
2020,445948,41,6,43,7,36
2020,445948,45,0,43,7,36
2020,445948,45,6,43,7,36
2020,446048,0,0,61,44,17
2020,446048,10,0,61,44,17
2020,446048,10,1,7,6,1
2020,446048,10,2,27,22,5
2020,446048,10,3,23,13,10
2020,446048,10,4,4,3,1
2020,446048,40,0,61,44,17
2020,446048,40,1,7,6,1
2020,446048,40,2,27,22,5
2020,446048,40,3,23,13,10
2020,446048,40,4,4,3,1
2020,446048,41,0,27,22,5
2020,446048,41,1,6,5,1
2020,446048,41,2,20,16,4
2020,446048,41,4,1,1,0
2020,446048,42,0,34,22,12
2020,446048,42,1,1,1,0
2020,446048,42,2,7,6,1
2020,446048,42,3,23,13,10
2020,446048,42,4,3,2,1
2020,446048,44,0,27,22,5
2020,446048,44,1,6,5,1
2020,446048,44,2,20,16,4
2020,446048,44,4,1,1,0
2020,446109,0,0,16,4,12
2020,446109,50,0,16,4,12
2020,446118,0,0,27,7,20
2020,446118,10,0,27,7,20
2020,446118,10,4,27,7,20
2020,446118,40,0,27,7,20
2020,446118,40,4,27,7,20
2020,446118,41,0,27,7,20
2020,446118,41,4,27,7,20
2020,446118,45,0,27,7,20
2020,446118,45,4,27,7,20
2020,446127,0,0,6,1,5
2020,446127,10,0,6,1,5
2020,446127,10,4,6,1,5
2020,446127,40,0,6,1,5
2020,446127,40,4,6,1,5
2020,446127,41,0,6,1,5
2020,446127,41,4,6,1,5
2020,446127,45,0,6,1,5
2020,446127,45,4,6,1,5
2020,446136,0,0,10,5,5
2020,446136,50,0,10,5,5
2020,446163,0,0,1,1,0
2020,446163,10,0,1,1,0
2020,446163,10,1,1,1,0
2020,446163,40,0,1,1,0
2020,446163,40,1,1,1,0
2020,446163,41,0,1,1,0
2020,446163,41,1,1,1,0
2020,446163,45,0,1,1,0
2020,446163,45,1,1,1,0
2020,446233,0,0,8,5,3
2020,446233,10,0,8,5,3
2020,446233,10,4,8,5,3
2020,446233,40,0,8,5,3
2020,446233,40,4,8,5,3
2020,446233,43,0,8,5,3
2020,446233,43,4,8,5,3
2020,446385,0,0,9,7,2
2020,446385,10,0,9,7,2
2020,446385,10,6,9,7,2
2020,446385,40,0,9,7,2
2020,446385,40,6,9,7,2
2020,446385,41,0,9,7,2
2020,446385,41,6,9,7,2
2020,446385,44,0,9,7,2
2020,446385,44,6,9,7,2
2020,446394,0,0,10,3,7
2020,446394,10,0,10,3,7
2020,446394,10,1,1,1,0
2020,446394,10,2,2,0,2
2020,446394,10,3,4,1,3
2020,446394,10,4,3,1,2
2020,446394,40,0,10,3,7
2020,446394,40,1,1,1,0
2020,446394,40,2,2,0,2
2020,446394,40,3,4,1,3
2020,446394,40,4,3,1,2
2020,446394,41,0,10,3,7
2020,446394,41,1,1,1,0
2020,446394,41,2,2,0,2
2020,446394,41,3,4,1,3
2020,446394,41,4,3,1,2
2020,446394,44,0,10,3,7
2020,446394,44,1,1,1,0
2020,446394,44,2,2,0,2
2020,446394,44,3,4,1,3
2020,446394,44,4,3,1,2
2020,446525,0,0,6,4,2
2020,446525,10,0,6,4,2
2020,446525,10,4,6,4,2
2020,446525,40,0,6,4,2
2020,446525,40,4,6,4,2
2020,446525,41,0,6,4,2
2020,446525,41,4,6,4,2
2020,446525,45,0,6,4,2
2020,446525,45,4,6,4,2
2020,446552,0,0,62,33,29
2020,446552,10,0,62,33,29
2020,446552,10,4,62,33,29
2020,446552,40,0,62,33,29
2020,446552,40,4,62,33,29
2020,446552,41,0,62,33,29
2020,446552,41,4,62,33,29
2020,446552,45,0,62,33,29
2020,446552,45,4,62,33,29
2020,446561,0,0,47,15,32
2020,446561,10,0,47,15,32
2020,446561,10,4,47,15,32
2020,446561,40,0,47,15,32
2020,446561,40,4,47,15,32
2020,446561,41,0,47,15,32
2020,446561,41,4,47,15,32
2020,446561,45,0,47,15,32
2020,446561,45,4,47,15,32
2020,446589,0,0,7,3,4
2020,446589,10,0,7,3,4
2020,446589,10,4,7,3,4
2020,446589,40,0,7,3,4
2020,446589,40,4,7,3,4
2020,446589,43,0,7,3,4
2020,446589,43,4,7,3,4
2020,446604,0,0,170,170,0
2020,446604,10,0,170,170,0
2020,446604,10,1,12,12,0
2020,446604,10,4,88,88,0
2020,446604,10,5,56,56,0
2020,446604,10,6,14,14,0
2020,446604,40,0,170,170,0
2020,446604,40,1,12,12,0
2020,446604,40,4,88,88,0
2020,446604,40,5,56,56,0
2020,446604,40,6,14,14,0
2020,446604,41,0,170,170,0
2020,446604,41,1,12,12,0
2020,446604,41,4,88,88,0
2020,446604,41,5,56,56,0
2020,446604,41,6,14,14,0
2020,446604,45,0,170,170,0
2020,446604,45,1,12,12,0
2020,446604,45,4,88,88,0
2020,446604,45,5,56,56,0
2020,446604,45,6,14,14,0
2020,446640,0,0,143,103,40
2020,446640,10,0,143,103,40
2020,446640,10,1,12,10,2
2020,446640,10,2,22,16,6
2020,446640,10,3,45,29,16
2020,446640,10,4,26,21,5
2020,446640,10,6,38,27,11
2020,446640,40,0,143,103,40
2020,446640,40,1,12,10,2
2020,446640,40,2,22,16,6
2020,446640,40,3,45,29,16
2020,446640,40,4,26,21,5
2020,446640,40,6,38,27,11
2020,446640,41,0,143,103,40
2020,446640,41,1,12,10,2
2020,446640,41,2,22,16,6
2020,446640,41,3,45,29,16
2020,446640,41,4,26,21,5
2020,446640,41,6,38,27,11
2020,446640,45,0,143,103,40
2020,446640,45,1,12,10,2
2020,446640,45,2,22,16,6
2020,446640,45,3,45,29,16
2020,446640,45,4,26,21,5
2020,446640,45,6,38,27,11
2020,446774,0,0,89,33,56
2020,446774,10,0,89,33,56
2020,446774,10,1,6,2,4
2020,446774,10,2,12,2,10
2020,446774,10,3,20,4,16
2020,446774,10,4,27,14,13
2020,446774,10,5,24,11,13
2020,446774,20,0,1,0,1
2020,446774,20,1,1,0,1
2020,446774,40,0,88,33,55
2020,446774,40,1,5,2,3
2020,446774,40,2,12,2,10
2020,446774,40,3,20,4,16
2020,446774,40,4,27,14,13
2020,446774,40,5,24,11,13
2020,446774,42,0,68,26,42
2020,446774,42,1,5,2,3
2020,446774,42,2,10,2,8
2020,446774,42,3,13,2,11
2020,446774,42,4,22,12,10
2020,446774,42,5,18,8,10
2020,446774,43,0,20,7,13
2020,446774,43,2,2,0,2
2020,446774,43,3,7,2,5
2020,446774,43,4,5,2,3
2020,446774,43,5,6,3,3
2020,447014,0,0,10,4,6
2020,447014,10,0,8,3,5
2020,447014,10,4,8,3,5
2020,447014,40,0,8,3,5
2020,447014,40,4,8,3,5
2020,447014,41,0,8,3,5
2020,447014,41,4,8,3,5
2020,447014,45,0,8,3,5
2020,447014,45,4,8,3,5
2020,447014,50,0,2,1,1
2020,447050,0,0,8,1,7
2020,447050,10,0,8,1,7
2020,447050,10,3,1,0,1
2020,447050,10,4,7,1,6
2020,447050,40,0,8,1,7
2020,447050,40,3,1,0,1
2020,447050,40,4,7,1,6
2020,447050,41,0,8,1,7
2020,447050,41,3,1,0,1
2020,447050,41,4,7,1,6
2020,447050,45,0,8,1,7
2020,447050,45,3,1,0,1
2020,447050,45,4,7,1,6
2020,447263,0,0,50,11,39
2020,447263,50,0,50,11,39
2020,447351,0,0,9,5,4
2020,447351,10,0,9,5,4
2020,447351,10,4,9,5,4
2020,447351,40,0,9,5,4
2020,447351,40,4,9,5,4
2020,447351,41,0,9,5,4
2020,447351,41,4,9,5,4
2020,447351,45,0,9,5,4
2020,447351,45,4,9,5,4
2020,447458,0,0,6,6,0
2020,447458,10,0,6,6,0
2020,447458,10,3,2,2,0
2020,447458,10,4,4,4,0
2020,447458,40,0,6,6,0
2020,447458,40,3,2,2,0
2020,447458,40,4,4,4,0
2020,447458,41,0,6,6,0
2020,447458,41,3,2,2,0
2020,447458,41,4,4,4,0
2020,447458,45,0,6,6,0
2020,447458,45,3,2,2,0
2020,447458,45,4,4,4,0
2020,447582,0,0,47,24,23
2020,447582,10,0,47,24,23
2020,447582,10,1,3,3,0
2020,447582,10,2,3,1,2
2020,447582,10,3,5,1,4
2020,447582,10,4,36,19,17
2020,447582,20,0,3,3,0
2020,447582,20,1,3,3,0
2020,447582,40,0,44,21,23
2020,447582,40,2,3,1,2
2020,447582,40,3,5,1,4
2020,447582,40,4,36,19,17
2020,447582,42,0,44,21,23
2020,447582,42,2,3,1,2
2020,447582,42,3,5,1,4
2020,447582,42,4,36,19,17
2020,447591,0,0,25,5,20
2020,447591,10,0,25,5,20
2020,447591,10,4,25,5,20
2020,447591,40,0,25,5,20
2020,447591,40,4,25,5,20
2020,447591,41,0,25,5,20
2020,447591,41,4,25,5,20
2020,447591,45,0,25,5,20
2020,447591,45,4,25,5,20
2020,447689,0,0,453,217,236
2020,447689,10,0,453,217,236
2020,447689,10,1,57,34,23
2020,447689,10,2,184,93,91
2020,447689,10,3,154,73,81
2020,447689,10,4,31,5,26
2020,447689,10,5,27,12,15
2020,447689,40,0,453,217,236
2020,447689,40,1,57,34,23
2020,447689,40,2,184,93,91
2020,447689,40,3,154,73,81
2020,447689,40,4,31,5,26
2020,447689,40,5,27,12,15
2020,447689,42,0,453,217,236
2020,447689,42,1,57,34,23
2020,447689,42,2,184,93,91
2020,447689,42,3,154,73,81
2020,447689,42,4,31,5,26
2020,447689,42,5,27,12,15
2020,447759,0,0,4,3,1
2020,447759,10,0,4,3,1
2020,447759,10,4,4,3,1
2020,447759,40,0,4,3,1
2020,447759,40,4,4,3,1
2020,447759,41,0,4,3,1
2020,447759,41,4,4,3,1
2020,447759,45,0,4,3,1
2020,447759,45,4,4,3,1
2020,447768,0,0,27,11,16
2020,447768,50,0,27,11,16
2020,447777,0,0,20,10,10
2020,447777,50,0,20,10,10
2020,447847,0,0,63,54,9
2020,447847,10,0,62,54,8
2020,447847,10,1,8,6,2
2020,447847,10,4,54,48,6
2020,447847,40,0,62,54,8
2020,447847,40,1,8,6,2
2020,447847,40,4,54,48,6
2020,447847,41,0,62,54,8
2020,447847,41,1,8,6,2
2020,447847,41,4,54,48,6
2020,447847,45,0,62,54,8
2020,447847,45,1,8,6,2
2020,447847,45,4,54,48,6
2020,447847,50,0,1,0,1
2020,447935,0,0,10,3,7
2020,447935,10,0,10,3,7
2020,447935,10,4,10,3,7
2020,447935,40,0,10,3,7
2020,447935,40,4,10,3,7
2020,447935,41,0,10,3,7
2020,447935,41,4,10,3,7
2020,447935,45,0,10,3,7
2020,447935,45,4,10,3,7
2020,447953,0,0,8,7,1
2020,447953,10,0,8,7,1
2020,447953,10,6,8,7,1
2020,447953,40,0,8,7,1
2020,447953,40,6,8,7,1
2020,447953,43,0,8,7,1
2020,447953,43,6,8,7,1
2020,448354,0,0,6,2,4
2020,448354,10,0,6,2,4
2020,448354,10,4,6,2,4
2020,448354,40,0,6,2,4
2020,448354,40,4,6,2,4
2020,448354,42,0,6,2,4
2020,448354,42,4,6,2,4
2020,448372,0,0,8,3,5
2020,448372,10,0,8,3,5
2020,448372,10,4,8,3,5
2020,448372,40,0,8,3,5
2020,448372,40,4,8,3,5
2020,448372,41,0,8,3,5
2020,448372,41,4,8,3,5
2020,448372,45,0,8,3,5
2020,448372,45,4,8,3,5
2020,448433,0,0,35,35,0
2020,448433,50,0,35,35,0
2020,448594,0,0,35,18,17
2020,448594,10,0,35,18,17
2020,448594,10,4,35,18,17
2020,448594,20,0,26,15,11
2020,448594,20,4,26,15,11
2020,448594,30,0,7,2,5
2020,448594,30,4,7,2,5
2020,448594,40,0,2,1,1
2020,448594,40,4,2,1,1
2020,448594,42,0,2,1,1
2020,448594,42,4,2,1,1
2020,448600,0,0,12,1,11
2020,448600,10,0,12,1,11
2020,448600,10,6,12,1,11
2020,448600,40,0,12,1,11
2020,448600,40,6,12,1,11
2020,448600,41,0,12,1,11
2020,448600,41,6,12,1,11
2020,448600,45,0,12,1,11
2020,448600,45,6,12,1,11
2020,448673,0,0,48,5,43
2020,448673,10,0,48,5,43
2020,448673,10,4,48,5,43
2020,448673,40,0,48,5,43
2020,448673,40,4,48,5,43
2020,448673,41,0,48,5,43
2020,448673,41,4,48,5,43
2020,448673,45,0,48,5,43
2020,448673,45,4,48,5,43
2020,448691,0,0,6,0,6
2020,448691,10,0,6,0,6
2020,448691,10,1,1,0,1
2020,448691,10,2,1,0,1
2020,448691,10,3,2,0,2
2020,448691,10,5,2,0,2
2020,448691,40,0,6,0,6
2020,448691,40,1,1,0,1
2020,448691,40,2,1,0,1
2020,448691,40,3,2,0,2
2020,448691,40,5,2,0,2
2020,448691,41,0,6,0,6
2020,448691,41,1,1,0,1
2020,448691,41,2,1,0,1
2020,448691,41,3,2,0,2
2020,448691,41,5,2,0,2
2020,448691,45,0,6,0,6
2020,448691,45,1,1,0,1
2020,448691,45,2,1,0,1
2020,448691,45,3,2,0,2
2020,448691,45,5,2,0,2
2020,448859,0,0,14,13,1
2020,448859,10,0,14,13,1
2020,448859,10,4,14,13,1
2020,448859,40,0,14,13,1
2020,448859,40,4,14,13,1
2020,448859,41,0,14,13,1
2020,448859,41,4,14,13,1
2020,448859,45,0,14,13,1
2020,448859,45,4,14,13,1
2020,449074,0,0,22,4,18
2020,449074,10,0,22,4,18
2020,449074,10,4,22,4,18
2020,449074,40,0,22,4,18
2020,449074,40,4,22,4,18
2020,449074,41,0,22,4,18
2020,449074,41,4,22,4,18
2020,449074,45,0,22,4,18
2020,449074,45,4,22,4,18
2020,449135,0,0,12,5,7
2020,449135,10,0,12,5,7
2020,449135,10,1,12,5,7
2020,449135,40,0,12,5,7
2020,449135,40,1,12,5,7
2020,449135,41,0,12,5,7
2020,449135,41,1,12,5,7
2020,449135,44,0,12,5,7
2020,449135,44,1,12,5,7
2020,449250,0,0,27,11,16
2020,449250,10,0,27,11,16
2020,449250,10,4,27,11,16
2020,449250,40,0,27,11,16
2020,449250,40,4,27,11,16
2020,449250,41,0,27,11,16
2020,449250,41,4,27,11,16
2020,449250,45,0,27,11,16
2020,449250,45,4,27,11,16
2020,449339,0,0,345,155,190
2020,449339,10,0,345,155,190
2020,449339,10,1,48,21,27
2020,449339,10,2,151,75,76
2020,449339,10,3,59,21,38
2020,449339,10,4,87,38,49
2020,449339,40,0,345,155,190
2020,449339,40,1,48,21,27
2020,449339,40,2,151,75,76
2020,449339,40,3,59,21,38
2020,449339,40,4,87,38,49
2020,449339,41,0,345,155,190
2020,449339,41,1,48,21,27
2020,449339,41,2,151,75,76
2020,449339,41,3,59,21,38
2020,449339,41,4,87,38,49
2020,449339,45,0,345,155,190
2020,449339,45,1,48,21,27
2020,449339,45,2,151,75,76
2020,449339,45,3,59,21,38
2020,449339,45,4,87,38,49
2020,449384,0,0,6,6,0
2020,449384,10,0,1,1,0
2020,449384,10,4,1,1,0
2020,449384,40,0,1,1,0
2020,449384,40,4,1,1,0
2020,449384,41,0,1,1,0
2020,449384,41,4,1,1,0
2020,449384,45,0,1,1,0
2020,449384,45,4,1,1,0
2020,449384,50,0,5,5,0
2020,449524,0,0,8,2,6
2020,449524,10,0,8,2,6
2020,449524,10,4,8,2,6
2020,449524,40,0,8,2,6
2020,449524,40,4,8,2,6
2020,449524,42,0,8,2,6
2020,449524,42,4,8,2,6
2020,449612,0,0,6,4,2
2020,449612,50,0,6,4,2
2020,449764,0,0,9,7,2
2020,449764,10,0,9,7,2
2020,449764,10,1,4,3,1
2020,449764,10,2,2,2,0
2020,449764,10,3,2,1,1
2020,449764,10,4,1,1,0
2020,449764,40,0,9,7,2
2020,449764,40,1,4,3,1
2020,449764,40,2,2,2,0
2020,449764,40,3,2,1,1
2020,449764,40,4,1,1,0
2020,449764,41,0,6,5,1
2020,449764,41,1,4,3,1
2020,449764,41,2,1,1,0
2020,449764,41,3,1,1,0
2020,449764,43,0,3,2,1
2020,449764,43,2,1,1,0
2020,449764,43,3,1,0,1
2020,449764,43,4,1,1,0
2020,449764,45,0,6,5,1
2020,449764,45,1,4,3,1
2020,449764,45,2,1,1,0
2020,449764,45,3,1,1,0
2020,449861,0,0,10,2,8
2020,449861,10,0,10,2,8
2020,449861,10,4,10,2,8
2020,449861,40,0,10,2,8
2020,449861,40,4,10,2,8
2020,449861,41,0,10,2,8
2020,449861,41,4,10,2,8
2020,449861,45,0,10,2,8
2020,449861,45,4,10,2,8
2020,449870,0,0,15,9,6
2020,449870,10,0,15,9,6
2020,449870,10,1,4,4,0
2020,449870,10,2,2,1,1
2020,449870,10,3,7,3,4
2020,449870,10,4,2,1,1
2020,449870,20,0,6,5,1
2020,449870,20,1,4,4,0
2020,449870,20,2,2,1,1
2020,449870,30,0,4,2,2
2020,449870,30,3,4,2,2
2020,449870,40,0,5,2,3
2020,449870,40,3,3,1,2
2020,449870,40,4,2,1,1
2020,449870,42,0,5,2,3
2020,449870,42,3,3,1,2
2020,449870,42,4,2,1,1
2020,449889,0,0,90,27,63
2020,449889,10,0,90,27,63
2020,449889,10,4,90,27,63
2020,449889,40,0,90,27,63
2020,449889,40,4,90,27,63
2020,449889,41,0,90,27,63
2020,449889,41,4,90,27,63
2020,449889,45,0,90,27,63
2020,449889,45,4,90,27,63
2020,449898,0,0,25,4,21
2020,449898,10,0,25,4,21
2020,449898,10,2,3,0,3
2020,449898,10,3,18,4,14
2020,449898,10,4,4,0,4
2020,449898,40,0,25,4,21
2020,449898,40,2,3,0,3
2020,449898,40,3,18,4,14
2020,449898,40,4,4,0,4
2020,449898,41,0,25,4,21
2020,449898,41,2,3,0,3
2020,449898,41,3,18,4,14
2020,449898,41,4,4,0,4
2020,449898,45,0,25,4,21
2020,449898,45,2,3,0,3
2020,449898,45,3,18,4,14
2020,449898,45,4,4,0,4
2020,449922,0,0,22,15,7
2020,449922,10,0,22,15,7
2020,449922,10,1,1,1,0
2020,449922,10,2,4,3,1
2020,449922,10,3,17,11,6
2020,449922,40,0,22,15,7
2020,449922,40,1,1,1,0
2020,449922,40,2,4,3,1
2020,449922,40,3,17,11,6
2020,449922,41,0,8,7,1
2020,449922,41,1,1,1,0
2020,449922,41,2,3,2,1
2020,449922,41,3,4,4,0
2020,449922,42,0,14,8,6
2020,449922,42,2,1,1,0
2020,449922,42,3,13,7,6
2020,449922,44,0,7,6,1
2020,449922,44,1,1,1,0
2020,449922,44,2,3,2,1
2020,449922,44,3,3,3,0
2020,449922,45,0,1,1,0
2020,449922,45,3,1,1,0
2020,449931,0,0,2,2,0
2020,449931,10,0,2,2,0
2020,449931,10,2,2,2,0
2020,449931,40,0,2,2,0
2020,449931,40,2,2,2,0
2020,449931,41,0,2,2,0
2020,449931,41,2,2,2,0
2020,449931,44,0,2,2,0
2020,449931,44,2,2,2,0
2020,450058,0,0,31,8,23
2020,450058,10,0,31,8,23
2020,450058,10,4,31,8,23
2020,450058,40,0,31,8,23
2020,450058,40,4,31,8,23
2020,450058,41,0,31,8,23
2020,450058,41,4,31,8,23
2020,450058,45,0,31,8,23
2020,450058,45,4,31,8,23
2020,450067,0,0,19,7,12
2020,450067,10,0,19,7,12
2020,450067,10,4,19,7,12
2020,450067,40,0,19,7,12
2020,450067,40,4,19,7,12
2020,450067,41,0,19,7,12
2020,450067,41,4,19,7,12
2020,450067,45,0,19,7,12
2020,450067,45,4,19,7,12
2020,450128,0,0,16,1,15
2020,450128,50,0,16,1,15
2020,450304,0,0,16,9,7
2020,450304,10,0,16,9,7
2020,450304,10,1,7,3,4
2020,450304,10,2,6,5,1
2020,450304,10,3,3,1,2
2020,450304,20,0,13,8,5
2020,450304,20,1,7,3,4
2020,450304,20,2,6,5,1
2020,450304,30,0,3,1,2
2020,450304,30,3,3,1,2
2020,450571,0,0,18,4,14
2020,450571,10,0,18,4,14
2020,450571,10,4,18,4,14
2020,450571,40,0,18,4,14
2020,450571,40,4,18,4,14
2020,450571,41,0,18,4,14
2020,450571,41,4,18,4,14
2020,450571,45,0,18,4,14
2020,450571,45,4,18,4,14
2020,450696,0,0,7,1,6
2020,450696,10,0,7,1,6
2020,450696,10,4,7,1,6
2020,450696,40,0,7,1,6
2020,450696,40,4,7,1,6
2020,450696,41,0,7,1,6
2020,450696,41,4,7,1,6
2020,450696,45,0,7,1,6
2020,450696,45,4,7,1,6
2020,450702,0,0,7,1,6
2020,450702,10,0,7,1,6
2020,450702,10,4,7,1,6
2020,450702,40,0,7,1,6
2020,450702,40,4,7,1,6
2020,450702,41,0,7,1,6
2020,450702,41,4,7,1,6
2020,450702,45,0,7,1,6
2020,450702,45,4,7,1,6
2020,450933,0,0,308,177,131
2020,450933,10,0,308,177,131
2020,450933,10,4,308,177,131
2020,450933,40,0,308,177,131
2020,450933,40,4,308,177,131
2020,450933,41,0,308,177,131
2020,450933,41,4,308,177,131
2020,450933,45,0,308,177,131
2020,450933,45,4,308,177,131
2020,450960,0,0,8,1,7
2020,450960,10,0,8,1,7
2020,450960,10,6,8,1,7
2020,450960,40,0,8,1,7
2020,450960,40,6,8,1,7
2020,450960,41,0,8,1,7
2020,450960,41,6,8,1,7
2020,450960,45,0,8,1,7
2020,450960,45,6,8,1,7
2020,451103,0,0,71,33,38
2020,451103,10,0,71,33,38
2020,451103,10,1,1,0,1
2020,451103,10,2,3,1,2
2020,451103,10,3,67,32,35
2020,451103,40,0,71,33,38
2020,451103,40,1,1,0,1
2020,451103,40,2,3,1,2
2020,451103,40,3,67,32,35
2020,451103,41,0,71,33,38
2020,451103,41,1,1,0,1
2020,451103,41,2,3,1,2
2020,451103,41,3,67,32,35
2020,451103,45,0,71,33,38
2020,451103,45,1,1,0,1
2020,451103,45,2,3,1,2
2020,451103,45,3,67,32,35
2020,451398,0,0,7,7,0
2020,451398,10,0,7,7,0
2020,451398,10,4,7,7,0
2020,451398,40,0,7,7,0
2020,451398,40,4,7,7,0
2020,451398,42,0,7,7,0
2020,451398,42,4,7,7,0
2020,451404,0,0,31,31,0
2020,451404,10,0,31,31,0
2020,451404,10,4,31,31,0
2020,451404,40,0,31,31,0
2020,451404,40,4,31,31,0
2020,451404,42,0,31,31,0
2020,451404,42,4,31,31,0
2020,451477,0,0,81,71,10
2020,451477,50,0,81,71,10
2020,451510,0,0,22,11,11
2020,451510,10,0,22,11,11
2020,451510,10,1,10,5,5
2020,451510,10,2,7,3,4
2020,451510,10,3,3,2,1
2020,451510,10,4,2,1,1
2020,451510,20,0,13,6,7
2020,451510,20,1,9,5,4
2020,451510,20,2,4,1,3
2020,451510,30,0,4,2,2
2020,451510,30,2,3,2,1
2020,451510,30,3,1,0,1
2020,451510,40,0,5,3,2
2020,451510,40,1,1,0,1
2020,451510,40,3,2,2,0
2020,451510,40,4,2,1,1
2020,451510,42,0,5,3,2
2020,451510,42,1,1,0,1
2020,451510,42,3,2,2,0
2020,451510,42,4,2,1,1
2020,451556,0,0,87,48,39
2020,451556,50,0,87,48,39
2020,451741,0,0,2,1,1
2020,451741,10,0,2,1,1
2020,451741,10,1,2,1,1
2020,451741,20,0,2,1,1
2020,451741,20,1,2,1,1
2020,451750,0,0,47,9,38
2020,451750,10,0,47,9,38
2020,451750,10,4,47,9,38
2020,451750,40,0,47,9,38
2020,451750,40,4,47,9,38
2020,451750,41,0,47,9,38
2020,451750,41,4,47,9,38
2020,451750,45,0,47,9,38
2020,451750,45,4,47,9,38
2020,451820,0,0,2,2,0
2020,451820,10,0,2,2,0
2020,451820,10,4,2,2,0
2020,451820,40,0,2,2,0
2020,451820,40,4,2,2,0
2020,451820,41,0,2,2,0
2020,451820,41,4,2,2,0
2020,451820,45,0,2,2,0
2020,451820,45,4,2,2,0
2020,451857,0,0,5,1,4
2020,451857,50,0,5,1,4
2020,451866,0,0,7,3,4
2020,451866,50,0,7,3,4
2020,451927,0,0,18,14,4
2020,451927,10,0,18,14,4
2020,451927,10,1,8,8,0
2020,451927,10,2,5,4,1
2020,451927,10,3,5,2,3
2020,451927,40,0,18,14,4
2020,451927,40,1,8,8,0
2020,451927,40,2,5,4,1
2020,451927,40,3,5,2,3
2020,451927,41,0,13,12,1
2020,451927,41,1,8,8,0
2020,451927,41,2,5,4,1
2020,451927,42,0,5,2,3
2020,451927,42,3,5,2,3
2020,451927,44,0,13,12,1
2020,451927,44,1,8,8,0
2020,451927,44,2,5,4,1
2020,452124,0,0,14,4,10
2020,452124,10,0,14,4,10
2020,452124,10,4,14,4,10
2020,452124,40,0,14,4,10
2020,452124,40,4,14,4,10
2020,452124,41,0,14,4,10
2020,452124,41,4,14,4,10
2020,452124,45,0,14,4,10
2020,452124,45,4,14,4,10
2020,452373,0,0,7,0,7
2020,452373,10,0,7,0,7
2020,452373,10,4,7,0,7
2020,452373,40,0,7,0,7
2020,452373,40,4,7,0,7
2020,452373,41,0,7,0,7
2020,452373,41,4,7,0,7
2020,452373,45,0,7,0,7
2020,452373,45,4,7,0,7
2020,452948,0,0,26,3,23
2020,452948,10,0,26,3,23
2020,452948,10,3,3,0,3
2020,452948,10,4,23,3,20
2020,452948,40,0,26,3,23
2020,452948,40,3,3,0,3
2020,452948,40,4,23,3,20
2020,452948,41,0,26,3,23
2020,452948,41,3,3,0,3
2020,452948,41,4,23,3,20
2020,452948,45,0,26,3,23
2020,452948,45,3,3,0,3
2020,452948,45,4,23,3,20
2020,454184,0,0,28,22,6
2020,454184,10,0,28,22,6
2020,454184,10,1,5,4,1
2020,454184,10,2,15,12,3
2020,454184,10,3,8,6,2
2020,454184,40,0,28,22,6
2020,454184,40,1,5,4,1
2020,454184,40,2,15,12,3
2020,454184,40,3,8,6,2
2020,454184,41,0,28,22,6
2020,454184,41,1,5,4,1
2020,454184,41,2,15,12,3
2020,454184,41,3,8,6,2
2020,454184,44,0,28,22,6
2020,454184,44,1,5,4,1
2020,454184,44,2,15,12,3
2020,454184,44,3,8,6,2
2020,454218,0,0,334,26,308
2020,454218,10,0,334,26,308
2020,454218,10,1,17,3,14
2020,454218,10,2,40,5,35
2020,454218,10,3,127,8,119
2020,454218,10,4,150,10,140
2020,454218,40,0,334,26,308
2020,454218,40,1,17,3,14
2020,454218,40,2,40,5,35
2020,454218,40,3,127,8,119
2020,454218,40,4,150,10,140
2020,454218,41,0,334,26,308
2020,454218,41,1,17,3,14
2020,454218,41,2,40,5,35
2020,454218,41,3,127,8,119
2020,454218,41,4,150,10,140
2020,454218,45,0,334,26,308
2020,454218,45,1,17,3,14
2020,454218,45,2,40,5,35
2020,454218,45,3,127,8,119
2020,454218,45,4,150,10,140
2020,454616,0,0,6,5,1
2020,454616,50,0,6,5,1
2020,454689,0,0,1,0,1
2020,454689,10,0,1,0,1
2020,454689,10,1,1,0,1
2020,454689,40,0,1,0,1
2020,454689,40,1,1,0,1
2020,454689,42,0,1,0,1
2020,454689,42,1,1,0,1
2020,454698,0,0,13,6,7
2020,454698,10,0,13,6,7
2020,454698,10,4,13,6,7
2020,454698,40,0,13,6,7
2020,454698,40,4,13,6,7
2020,454698,41,0,13,6,7
2020,454698,41,4,13,6,7
2020,454698,45,0,13,6,7
2020,454698,45,4,13,6,7
2020,454786,0,0,34,19,15
2020,454786,10,0,34,19,15
2020,454786,10,4,34,19,15
2020,454786,40,0,34,19,15
2020,454786,40,4,34,19,15
2020,454786,41,0,34,19,15
2020,454786,41,4,34,19,15
2020,454786,45,0,34,19,15
2020,454786,45,4,34,19,15
2020,454810,0,0,87,37,50
2020,454810,10,0,74,34,40
2020,454810,10,4,74,34,40
2020,454810,40,0,74,34,40
2020,454810,40,4,74,34,40
2020,454810,41,0,74,34,40
2020,454810,41,4,74,34,40
2020,454810,45,0,74,34,40
2020,454810,45,4,74,34,40
2020,454810,50,0,13,3,10
2020,454829,0,0,34,3,31
2020,454829,10,0,34,3,31
2020,454829,10,4,34,3,31
2020,454829,40,0,34,3,31
2020,454829,40,4,34,3,31
2020,454829,41,0,34,3,31
2020,454829,41,4,34,3,31
2020,454829,45,0,34,3,31
2020,454829,45,4,34,3,31
2020,454856,0,0,25,4,21
2020,454856,10,0,25,4,21
2020,454856,10,4,25,4,21
2020,454856,40,0,25,4,21
2020,454856,40,4,25,4,21
2020,454856,41,0,25,4,21
2020,454856,41,4,25,4,21
2020,454856,45,0,25,4,21
2020,454856,45,4,25,4,21
2020,454865,0,0,28,3,25
2020,454865,50,0,28,3,25
2020,455114,0,0,164,88,76
2020,455114,10,0,164,88,76
2020,455114,10,2,37,13,24
2020,455114,10,3,49,28,21
2020,455114,10,4,73,46,27
2020,455114,10,6,5,1,4
2020,455114,40,0,164,88,76
2020,455114,40,2,37,13,24
2020,455114,40,3,49,28,21
2020,455114,40,4,73,46,27
2020,455114,40,6,5,1,4
2020,455114,42,0,164,88,76
2020,455114,42,2,37,13,24
2020,455114,42,3,49,28,21
2020,455114,42,4,73,46,27
2020,455114,42,6,5,1,4
2020,455178,0,0,2,2,0
2020,455178,10,0,2,2,0
2020,455178,10,4,2,2,0
2020,455178,40,0,2,2,0
2020,455178,40,4,2,2,0
2020,455178,41,0,2,2,0
2020,455178,41,4,2,2,0
2020,455178,45,0,2,2,0
2020,455178,45,4,2,2,0
2020,455196,0,0,98,13,85
2020,455196,10,0,98,13,85
2020,455196,10,4,98,13,85
2020,455196,40,0,98,13,85
2020,455196,40,4,98,13,85
2020,455196,41,0,98,13,85
2020,455196,41,4,98,13,85
2020,455196,45,0,98,13,85
2020,455196,45,4,98,13,85
2020,455257,0,0,16,16,0
2020,455257,10,0,16,16,0
2020,455257,10,4,16,16,0
2020,455257,40,0,16,16,0
2020,455257,40,4,16,16,0
2020,455257,42,0,16,16,0
2020,455257,42,4,16,16,0
2020,455336,0,0,6,4,2
2020,455336,10,0,6,4,2
2020,455336,10,4,6,4,2
2020,455336,40,0,6,4,2
2020,455336,40,4,6,4,2
2020,455336,41,0,6,4,2
2020,455336,41,4,6,4,2
2020,455336,45,0,6,4,2
2020,455336,45,4,6,4,2
2020,455406,0,0,26,16,10
2020,455406,10,0,26,16,10
2020,455406,10,1,3,2,1
2020,455406,10,2,10,6,4
2020,455406,10,3,13,8,5
2020,455406,40,0,26,16,10
2020,455406,40,1,3,2,1
2020,455406,40,2,10,6,4
2020,455406,40,3,13,8,5
2020,455406,41,0,26,16,10
2020,455406,41,1,3,2,1
2020,455406,41,2,10,6,4
2020,455406,41,3,13,8,5
2020,455406,44,0,26,16,10
2020,455406,44,1,3,2,1
2020,455406,44,2,10,6,4
2020,455406,44,3,13,8,5
2020,455433,0,0,19,9,10
2020,455433,10,0,19,9,10
2020,455433,10,1,5,3,2
2020,455433,10,2,6,3,3
2020,455433,10,3,8,3,5
2020,455433,40,0,19,9,10
2020,455433,40,1,5,3,2
2020,455433,40,2,6,3,3
2020,455433,40,3,8,3,5
2020,455433,41,0,19,9,10
2020,455433,41,1,5,3,2
2020,455433,41,2,6,3,3
2020,455433,41,3,8,3,5
2020,455433,44,0,19,9,10
2020,455433,44,1,5,3,2
2020,455433,44,2,6,3,3
2020,455433,44,3,8,3,5
2020,455479,0,0,15,3,12
2020,455479,10,0,15,3,12
2020,455479,10,4,15,3,12
2020,455479,40,0,15,3,12
2020,455479,40,4,15,3,12
2020,455479,41,0,15,3,12
2020,455479,41,4,15,3,12
2020,455479,45,0,15,3,12
2020,455479,45,4,15,3,12
2020,455512,0,0,49,18,31
2020,455512,10,0,49,18,31
2020,455512,10,1,49,18,31
2020,455512,20,0,32,15,17
2020,455512,20,1,32,15,17
2020,455512,30,0,12,3,9
2020,455512,30,1,12,3,9
2020,455512,40,0,5,0,5
2020,455512,40,1,5,0,5
2020,455512,42,0,5,0,5
2020,455512,42,1,5,0,5
2020,455628,0,0,10,2,8
2020,455628,10,0,10,2,8
2020,455628,10,4,10,2,8
2020,455628,40,0,10,2,8
2020,455628,40,4,10,2,8
2020,455628,41,0,10,2,8
2020,455628,41,4,10,2,8
2020,455628,45,0,10,2,8
2020,455628,45,4,10,2,8
2020,455664,0,0,28,15,13
2020,455664,10,0,28,15,13
2020,455664,10,1,6,6,0
2020,455664,10,2,14,7,7
2020,455664,10,3,8,2,6
2020,455664,40,0,28,15,13
2020,455664,40,1,6,6,0
2020,455664,40,2,14,7,7
2020,455664,40,3,8,2,6
2020,455664,41,0,28,15,13
2020,455664,41,1,6,6,0
2020,455664,41,2,14,7,7
2020,455664,41,3,8,2,6
2020,455664,44,0,28,15,13
2020,455664,44,1,6,6,0
2020,455664,44,2,14,7,7
2020,455664,44,3,8,2,6
2020,455770,0,0,4,4,0
2020,455770,10,0,4,4,0
2020,455770,10,1,1,1,0
2020,455770,10,2,2,2,0
2020,455770,10,3,1,1,0
2020,455770,40,0,4,4,0
2020,455770,40,1,1,1,0
2020,455770,40,2,2,2,0
2020,455770,40,3,1,1,0
2020,455770,42,0,4,4,0
2020,455770,42,1,1,1,0
2020,455770,42,2,2,2,0
2020,455770,42,3,1,1,0
2020,455804,0,0,40,30,10
2020,455804,10,0,40,30,10
2020,455804,10,1,40,30,10
2020,455804,40,0,40,30,10
2020,455804,40,1,40,30,10
2020,455804,41,0,9,9,0
2020,455804,41,1,9,9,0
2020,455804,42,0,31,21,10
2020,455804,42,1,31,21,10
2020,455804,45,0,9,9,0
2020,455804,45,1,9,9,0
2020,455868,0,0,10,1,9
2020,455868,10,0,7,0,7
2020,455868,10,4,7,0,7
2020,455868,40,0,7,0,7
2020,455868,40,4,7,0,7
2020,455868,41,0,7,0,7
2020,455868,41,4,7,0,7
2020,455868,45,0,7,0,7
2020,455868,45,4,7,0,7
2020,455868,50,0,3,1,2
2020,455983,0,0,2,1,1
2020,455983,10,0,2,1,1
2020,455983,10,4,2,1,1
2020,455983,40,0,2,1,1
2020,455983,40,4,2,1,1
2020,455983,41,0,2,1,1
2020,455983,41,4,2,1,1
2020,455983,45,0,2,1,1
2020,455983,45,4,2,1,1
2020,456038,0,0,10,0,10
2020,456038,10,0,10,0,10
2020,456038,10,4,10,0,10
2020,456038,40,0,10,0,10
2020,456038,40,4,10,0,10
2020,456038,41,0,10,0,10
2020,456038,41,4,10,0,10
2020,456038,45,0,10,0,10
2020,456038,45,4,10,0,10
2020,456205,0,0,6,4,2
2020,456205,10,0,6,4,2
2020,456205,10,4,6,4,2
2020,456205,40,0,6,4,2
2020,456205,40,4,6,4,2
2020,456205,41,0,6,4,2
2020,456205,41,4,6,4,2
2020,456205,45,0,6,4,2
2020,456205,45,4,6,4,2
2020,456454,0,0,13,3,10
2020,456454,10,0,13,3,10
2020,456454,10,4,13,3,10
2020,456454,40,0,13,3,10
2020,456454,40,4,13,3,10
2020,456454,41,0,13,3,10
2020,456454,41,4,13,3,10
2020,456454,45,0,13,3,10
2020,456454,45,4,13,3,10
2020,456490,0,0,7,6,1
2020,456490,10,0,7,6,1
2020,456490,10,1,1,0,1
2020,456490,10,2,6,6,0
2020,456490,40,0,7,6,1
2020,456490,40,1,1,0,1
2020,456490,40,2,6,6,0
2020,456490,42,0,7,6,1
2020,456490,42,1,1,0,1
2020,456490,42,2,6,6,0
2020,456542,0,0,36,20,16
2020,456542,10,0,36,20,16
2020,456542,10,1,12,7,5
2020,456542,10,2,23,13,10
2020,456542,10,4,1,0,1
2020,456542,20,0,4,1,3
2020,456542,20,1,4,1,3
2020,456542,30,0,29,19,10
2020,456542,30,1,8,6,2
2020,456542,30,2,21,13,8
2020,456542,40,0,3,0,3
2020,456542,40,2,2,0,2
2020,456542,40,4,1,0,1
2020,456542,41,0,3,0,3
2020,456542,41,2,2,0,2
2020,456542,41,4,1,0,1
2020,456542,44,0,3,0,3
2020,456542,44,2,2,0,2
2020,456542,44,4,1,0,1
2020,456579,0,0,4,1,3
2020,456579,10,0,4,1,3
2020,456579,10,4,4,1,3
2020,456579,40,0,4,1,3
2020,456579,40,4,4,1,3
2020,456579,41,0,4,1,3
2020,456579,41,4,4,1,3
2020,456579,45,0,4,1,3
2020,456579,45,4,4,1,3
2020,456852,0,0,4,2,2
2020,456852,10,0,4,2,2
2020,456852,10,4,4,2,2
2020,456852,40,0,4,2,2
2020,456852,40,4,4,2,2
2020,456852,41,0,4,2,2
2020,456852,41,4,4,2,2
2020,456852,45,0,4,2,2
2020,456852,45,4,4,2,2
2020,456959,0,0,40,20,20
2020,456959,10,0,13,6,7
2020,456959,10,2,6,3,3
2020,456959,10,3,7,3,4
2020,456959,20,0,5,3,2
2020,456959,20,2,5,3,2
2020,456959,30,0,7,3,4
2020,456959,30,2,1,0,1
2020,456959,30,3,6,3,3
2020,456959,40,0,1,0,1
2020,456959,40,3,1,0,1
2020,456959,42,0,1,0,1
2020,456959,42,3,1,0,1
2020,456959,50,0,27,14,13
2020,457101,0,0,6,3,3
2020,457101,10,0,6,3,3
2020,457101,10,4,6,3,3
2020,457101,40,0,6,3,3
2020,457101,40,4,6,3,3
2020,457101,41,0,6,3,3
2020,457101,41,4,6,3,3
2020,457101,45,0,6,3,3
2020,457101,45,4,6,3,3
2020,457110,0,0,14,1,13
2020,457110,10,0,14,1,13
2020,457110,10,4,14,1,13
2020,457110,40,0,14,1,13
2020,457110,40,4,14,1,13
2020,457110,41,0,14,1,13
2020,457110,41,4,14,1,13
2020,457110,45,0,14,1,13
2020,457110,45,4,14,1,13
2020,457299,0,0,8,4,4
2020,457299,10,0,8,4,4
2020,457299,10,1,3,2,1
2020,457299,10,2,1,0,1
2020,457299,10,4,4,2,2
2020,457299,40,0,8,4,4
2020,457299,40,1,3,2,1
2020,457299,40,2,1,0,1
2020,457299,40,4,4,2,2
2020,457299,41,0,8,4,4
2020,457299,41,1,3,2,1
2020,457299,41,2,1,0,1
2020,457299,41,4,4,2,2
2020,457299,44,0,8,4,4
2020,457299,44,1,3,2,1
2020,457299,44,2,1,0,1
2020,457299,44,4,4,2,2
2020,457527,0,0,7,0,7
2020,457527,10,0,7,0,7
2020,457527,10,1,2,0,2
2020,457527,10,2,1,0,1
2020,457527,10,3,1,0,1
2020,457527,10,4,3,0,3
2020,457527,40,0,7,0,7
2020,457527,40,1,2,0,2
2020,457527,40,2,1,0,1
2020,457527,40,3,1,0,1
2020,457527,40,4,3,0,3
2020,457527,41,0,3,0,3
2020,457527,41,1,2,0,2
2020,457527,41,2,1,0,1
2020,457527,42,0,4,0,4
2020,457527,42,3,1,0,1
2020,457527,42,4,3,0,3
2020,457527,45,0,3,0,3
2020,457527,45,1,2,0,2
2020,457527,45,2,1,0,1
2020,457536,0,0,9,7,2
2020,457536,10,0,9,7,2
2020,457536,10,4,9,7,2
2020,457536,40,0,9,7,2
2020,457536,40,4,9,7,2
2020,457536,41,0,9,7,2
2020,457536,41,4,9,7,2
2020,457536,45,0,9,7,2
2020,457536,45,4,9,7,2
2020,458210,0,0,56,22,34
2020,458210,10,0,54,22,32
2020,458210,10,1,2,2,0
2020,458210,10,2,5,2,3
2020,458210,10,3,16,6,10
2020,458210,10,4,31,12,19
2020,458210,40,0,54,22,32
2020,458210,40,1,2,2,0
2020,458210,40,2,5,2,3
2020,458210,40,3,16,6,10
2020,458210,40,4,31,12,19
2020,458210,41,0,54,22,32
2020,458210,41,1,2,2,0
2020,458210,41,2,5,2,3
2020,458210,41,3,16,6,10
2020,458210,41,4,31,12,19
2020,458210,45,0,54,22,32
2020,458210,45,1,2,2,0
2020,458210,45,2,5,2,3
2020,458210,45,3,16,6,10
2020,458210,45,4,31,12,19
2020,458210,50,0,2,0,2
2020,458229,0,0,42,9,33
2020,458229,10,0,40,9,31
2020,458229,10,1,1,0,1
2020,458229,10,2,3,0,3
2020,458229,10,3,6,2,4
2020,458229,10,4,30,7,23
2020,458229,40,0,40,9,31
2020,458229,40,1,1,0,1
2020,458229,40,2,3,0,3
2020,458229,40,3,6,2,4
2020,458229,40,4,30,7,23
2020,458229,41,0,40,9,31
2020,458229,41,1,1,0,1
2020,458229,41,2,3,0,3
2020,458229,41,3,6,2,4
2020,458229,41,4,30,7,23
2020,458229,45,0,40,9,31
2020,458229,45,1,1,0,1
2020,458229,45,2,3,0,3
2020,458229,45,3,6,2,4
2020,458229,45,4,30,7,23
2020,458229,50,0,2,0,2
2020,458405,0,0,8,6,2
2020,458405,10,0,8,6,2
2020,458405,10,4,8,6,2
2020,458405,40,0,8,6,2
2020,458405,40,4,8,6,2
2020,458405,41,0,8,6,2
2020,458405,41,4,8,6,2
2020,458405,45,0,8,6,2
2020,458405,45,4,8,6,2
2020,458441,0,0,5,0,5
2020,458441,10,0,5,0,5
2020,458441,10,4,5,0,5
2020,458441,40,0,5,0,5
2020,458441,40,4,5,0,5
2020,458441,41,0,5,0,5
2020,458441,41,4,5,0,5
2020,458441,45,0,5,0,5
2020,458441,45,4,5,0,5
2020,458681,0,0,9,1,8
2020,458681,10,0,9,1,8
2020,458681,10,4,9,1,8
2020,458681,40,0,9,1,8
2020,458681,40,4,9,1,8
2020,458681,41,0,9,1,8
2020,458681,41,4,9,1,8
2020,458681,45,0,9,1,8
2020,458681,45,4,9,1,8
2020,459204,0,0,58,10,48
2020,459204,10,0,58,10,48
2020,459204,10,6,58,10,48
2020,459204,40,0,58,10,48
2020,459204,40,6,58,10,48
2020,459204,41,0,58,10,48
2020,459204,41,6,58,10,48
2020,459204,45,0,58,10,48
2020,459204,45,6,58,10,48
2020,459213,0,0,85,23,62
2020,459213,10,0,85,23,62
2020,459213,10,4,85,23,62
2020,459213,40,0,85,23,62
2020,459213,40,4,85,23,62
2020,459213,41,0,85,23,62
2020,459213,41,4,85,23,62
2020,459213,45,0,85,23,62
2020,459213,45,4,85,23,62
2020,459259,0,0,19,0,19
2020,459259,10,0,19,0,19
2020,459259,10,3,12,0,12
2020,459259,10,4,7,0,7
2020,459259,40,0,19,0,19
2020,459259,40,3,12,0,12
2020,459259,40,4,7,0,7
2020,459259,41,0,19,0,19
2020,459259,41,3,12,0,12
2020,459259,41,4,7,0,7
2020,459259,45,0,19,0,19
2020,459259,45,3,12,0,12
2020,459259,45,4,7,0,7
2020,459268,0,0,12,2,10
2020,459268,10,0,12,2,10
2020,459268,10,2,1,0,1
2020,459268,10,3,7,2,5
2020,459268,10,4,4,0,4
2020,459268,40,0,12,2,10
2020,459268,40,2,1,0,1
2020,459268,40,3,7,2,5
2020,459268,40,4,4,0,4
2020,459268,41,0,12,2,10
2020,459268,41,2,1,0,1
2020,459268,41,3,7,2,5
2020,459268,41,4,4,0,4
2020,459268,45,0,12,2,10
2020,459268,45,2,1,0,1
2020,459268,45,3,7,2,5
2020,459268,45,4,4,0,4
2020,459727,0,0,13,9,4
2020,459727,10,0,13,9,4
2020,459727,10,1,3,3,0
2020,459727,10,2,4,0,4
2020,459727,10,3,5,5,0
2020,459727,10,4,1,1,0
2020,459727,40,0,13,9,4
2020,459727,40,1,3,3,0
2020,459727,40,2,4,0,4
2020,459727,40,3,5,5,0
2020,459727,40,4,1,1,0
2020,459727,41,0,13,9,4
2020,459727,41,1,3,3,0
2020,459727,41,2,4,0,4
2020,459727,41,3,5,5,0
2020,459727,41,4,1,1,0
2020,459727,45,0,13,9,4
2020,459727,45,1,3,3,0
2020,459727,45,2,4,0,4
2020,459727,45,3,5,5,0
2020,459727,45,4,1,1,0
2020,459736,0,0,118,43,75
2020,459736,10,0,118,43,75
2020,459736,10,1,25,13,12
2020,459736,10,2,38,13,25
2020,459736,10,3,50,15,35
2020,459736,10,4,1,1,0
2020,459736,10,6,4,1,3
2020,459736,40,0,118,43,75
2020,459736,40,1,25,13,12
2020,459736,40,2,38,13,25
2020,459736,40,3,50,15,35
2020,459736,40,4,1,1,0
2020,459736,40,6,4,1,3
2020,459736,41,0,65,22,43
2020,459736,41,1,15,8,7
2020,459736,41,2,25,8,17
2020,459736,41,3,24,5,19
2020,459736,41,4,1,1,0
2020,459736,42,0,53,21,32
2020,459736,42,1,10,5,5
2020,459736,42,2,13,5,8
2020,459736,42,3,26,10,16
2020,459736,42,6,4,1,3
2020,459736,44,0,65,22,43
2020,459736,44,1,15,8,7
2020,459736,44,2,25,8,17
2020,459736,44,3,24,5,19
2020,459736,44,4,1,1,0
2020,459745,0,0,31,12,19
2020,459745,10,0,31,12,19
2020,459745,10,1,8,4,4
2020,459745,10,2,8,3,5
2020,459745,10,3,15,5,10
2020,459745,40,0,31,12,19
2020,459745,40,1,8,4,4
2020,459745,40,2,8,3,5
2020,459745,40,3,15,5,10
2020,459745,41,0,31,12,19
2020,459745,41,1,8,4,4
2020,459745,41,2,8,3,5
2020,459745,41,3,15,5,10
2020,459745,44,0,31,12,19
2020,459745,44,1,8,4,4
2020,459745,44,2,8,3,5
2020,459745,44,3,15,5,10
2020,459824,0,0,82,33,49
2020,459824,10,0,82,33,49
2020,459824,10,1,10,4,6
2020,459824,10,2,22,11,11
2020,459824,10,3,49,17,32
2020,459824,10,4,1,1,0
2020,459824,40,0,82,33,49
2020,459824,40,1,10,4,6
2020,459824,40,2,22,11,11
2020,459824,40,3,49,17,32
2020,459824,40,4,1,1,0
2020,459824,41,0,59,25,34
2020,459824,41,1,9,3,6
2020,459824,41,2,19,10,9
2020,459824,41,3,31,12,19
2020,459824,42,0,23,8,15
2020,459824,42,1,1,1,0
2020,459824,42,2,3,1,2
2020,459824,42,3,18,5,13
2020,459824,42,4,1,1,0
2020,459824,44,0,59,25,34
2020,459824,44,1,9,3,6
2020,459824,44,2,19,10,9
2020,459824,44,3,31,12,19
2020,459842,0,0,16,2,14
2020,459842,10,0,16,2,14
2020,459842,10,1,3,1,2
2020,459842,10,2,1,0,1
2020,459842,10,3,10,1,9
2020,459842,10,4,2,0,2
2020,459842,40,0,16,2,14
2020,459842,40,1,3,1,2
2020,459842,40,2,1,0,1
2020,459842,40,3,10,1,9
2020,459842,40,4,2,0,2
2020,459842,41,0,16,2,14
2020,459842,41,1,3,1,2
2020,459842,41,2,1,0,1
2020,459842,41,3,10,1,9
2020,459842,41,4,2,0,2
2020,459842,45,0,16,2,14
2020,459842,45,1,3,1,2
2020,459842,45,2,1,0,1
2020,459842,45,3,10,1,9
2020,459842,45,4,2,0,2
2020,459851,0,0,14,0,14
2020,459851,10,0,14,0,14
2020,459851,10,1,2,0,2
2020,459851,10,2,4,0,4
2020,459851,10,3,4,0,4
2020,459851,10,4,4,0,4
2020,459851,40,0,14,0,14
2020,459851,40,1,2,0,2
2020,459851,40,2,4,0,4
2020,459851,40,3,4,0,4
2020,459851,40,4,4,0,4
2020,459851,41,0,14,0,14
2020,459851,41,1,2,0,2
2020,459851,41,2,4,0,4
2020,459851,41,3,4,0,4
2020,459851,41,4,4,0,4
2020,459851,45,0,14,0,14
2020,459851,45,1,2,0,2
2020,459851,45,2,4,0,4
2020,459851,45,3,4,0,4
2020,459851,45,4,4,0,4
2020,459949,0,0,216,104,112
2020,459949,10,0,216,104,112
2020,459949,10,1,21,14,7
2020,459949,10,2,47,22,25
2020,459949,10,3,63,30,33
2020,459949,10,4,23,13,10
2020,459949,10,5,62,25,37
2020,459949,20,0,63,33,30
2020,459949,20,1,20,13,7
2020,459949,20,2,43,20,23
2020,459949,30,0,67,32,35
2020,459949,30,1,1,1,0
2020,459949,30,2,4,2,2
2020,459949,30,3,62,29,33
2020,459949,40,0,86,39,47
2020,459949,40,3,1,1,0
2020,459949,40,4,23,13,10
2020,459949,40,5,62,25,37
2020,459949,41,0,23,13,10
2020,459949,41,4,23,13,10
2020,459949,42,0,63,26,37
2020,459949,42,3,1,1,0
2020,459949,42,5,62,25,37
2020,459949,45,0,23,13,10
2020,459949,45,4,23,13,10
2020,459958,0,0,9,4,5
2020,459958,10,0,9,4,5
2020,459958,10,4,9,4,5
2020,459958,40,0,9,4,5
2020,459958,40,4,9,4,5
2020,459958,41,0,9,4,5
2020,459958,41,4,9,4,5
2020,459958,45,0,9,4,5
2020,459958,45,4,9,4,5
2020,460020,0,0,10,2,8
2020,460020,10,0,10,2,8
2020,460020,10,4,10,2,8
2020,460020,40,0,10,2,8
2020,460020,40,4,10,2,8
2020,460020,41,0,10,2,8
2020,460020,41,4,10,2,8
2020,460020,45,0,10,2,8
2020,460020,45,4,10,2,8
2020,460136,0,0,39,6,33
2020,460136,10,0,39,6,33
2020,460136,10,4,39,6,33
2020,460136,40,0,39,6,33
2020,460136,40,4,39,6,33
2020,460136,41,0,39,6,33
2020,460136,41,4,39,6,33
2020,460136,45,0,39,6,33
2020,460136,45,4,39,6,33
2020,460181,0,0,17,4,13
2020,460181,10,0,17,4,13
2020,460181,10,4,17,4,13
2020,460181,40,0,17,4,13
2020,460181,40,4,17,4,13
2020,460181,41,0,17,4,13
2020,460181,41,4,17,4,13
2020,460181,45,0,17,4,13
2020,460181,45,4,17,4,13
2020,460190,0,0,3,1,2
2020,460190,10,0,3,1,2
2020,460190,10,4,3,1,2
2020,460190,40,0,3,1,2
2020,460190,40,4,3,1,2
2020,460190,41,0,3,1,2
2020,460190,41,4,3,1,2
2020,460190,45,0,3,1,2
2020,460190,45,4,3,1,2
2020,460206,0,0,12,3,9
2020,460206,10,0,12,3,9
2020,460206,10,4,12,3,9
2020,460206,40,0,12,3,9
2020,460206,40,4,12,3,9
2020,460206,41,0,12,3,9
2020,460206,41,4,12,3,9
2020,460206,45,0,12,3,9
2020,460206,45,4,12,3,9
2020,460349,0,0,2,2,0
2020,460349,10,0,2,2,0
2020,460349,10,1,1,1,0
2020,460349,10,5,1,1,0
2020,460349,40,0,2,2,0
2020,460349,40,1,1,1,0
2020,460349,40,5,1,1,0
2020,460349,42,0,2,2,0
2020,460349,42,1,1,1,0
2020,460349,42,5,1,1,0
2020,460376,0,0,5,4,1
2020,460376,10,0,5,4,1
2020,460376,10,1,1,1,0
2020,460376,10,2,1,0,1
2020,460376,10,3,2,2,0
2020,460376,10,4,1,1,0
2020,460376,40,0,5,4,1
2020,460376,40,1,1,1,0
2020,460376,40,2,1,0,1
2020,460376,40,3,2,2,0
2020,460376,40,4,1,1,0
2020,460376,41,0,5,4,1
2020,460376,41,1,1,1,0
2020,460376,41,2,1,0,1
2020,460376,41,3,2,2,0
2020,460376,41,4,1,1,0
2020,460376,45,0,5,4,1
2020,460376,45,1,1,1,0
2020,460376,45,2,1,0,1
2020,460376,45,3,2,2,0
2020,460376,45,4,1,1,0
2020,460394,0,0,105,42,63
2020,460394,10,0,105,42,63
2020,460394,10,4,105,42,63
2020,460394,20,0,67,28,39
2020,460394,20,4,67,28,39
2020,460394,30,0,30,13,17
2020,460394,30,4,30,13,17
2020,460394,40,0,8,1,7
2020,460394,40,4,8,1,7
2020,460394,42,0,6,1,5
2020,460394,42,4,6,1,5
2020,460394,43,0,2,0,2
2020,460394,43,4,2,0,2
2020,460464,0,0,99,47,52
2020,460464,10,0,99,47,52
2020,460464,10,4,99,47,52
2020,460464,20,0,65,30,35
2020,460464,20,4,65,30,35
2020,460464,30,0,28,14,14
2020,460464,30,4,28,14,14
2020,460464,40,0,6,3,3
2020,460464,40,4,6,3,3
2020,460464,42,0,6,3,3
2020,460464,42,4,6,3,3
2020,460543,0,0,41,41,0
2020,460543,50,0,41,41,0
2020,460677,0,0,10,3,7
2020,460677,10,0,10,3,7
2020,460677,10,4,10,3,7
2020,460677,40,0,10,3,7
2020,460677,40,4,10,3,7
2020,460677,43,0,10,3,7
2020,460677,43,4,10,3,7
2020,460738,0,0,19,0,19
2020,460738,10,0,15,0,15
2020,460738,10,1,1,0,1
2020,460738,10,2,8,0,8
2020,460738,10,3,6,0,6
2020,460738,40,0,15,0,15
2020,460738,40,1,1,0,1
2020,460738,40,2,8,0,8
2020,460738,40,3,6,0,6
2020,460738,41,0,15,0,15
2020,460738,41,1,1,0,1
2020,460738,41,2,8,0,8
2020,460738,41,3,6,0,6
2020,460738,44,0,15,0,15
2020,460738,44,1,1,0,1
2020,460738,44,2,8,0,8
2020,460738,44,3,6,0,6
2020,460738,50,0,4,0,4
2020,460756,0,0,11,4,7
2020,460756,10,0,11,4,7
2020,460756,10,4,11,4,7
2020,460756,40,0,11,4,7
2020,460756,40,4,11,4,7
2020,460756,41,0,11,4,7
2020,460756,41,4,11,4,7
2020,460756,45,0,11,4,7
2020,460756,45,4,11,4,7
2020,460817,0,0,6,4,2
2020,460817,10,0,6,4,2
2020,460817,10,4,6,4,2
2020,460817,40,0,6,4,2
2020,460817,40,4,6,4,2
2020,460817,41,0,6,4,2
2020,460817,41,4,6,4,2
2020,460817,45,0,6,4,2
2020,460817,45,4,6,4,2
2020,460826,0,0,7,4,3
2020,460826,10,0,7,4,3
2020,460826,10,4,7,4,3
2020,460826,40,0,7,4,3
2020,460826,40,4,7,4,3
2020,460826,41,0,7,4,3
2020,460826,41,4,7,4,3
2020,460826,45,0,7,4,3
2020,460826,45,4,7,4,3
2020,460835,0,0,4,2,2
2020,460835,10,0,4,2,2
2020,460835,10,4,4,2,2
2020,460835,40,0,4,2,2
2020,460835,40,4,4,2,2
2020,460835,41,0,4,2,2
2020,460835,41,4,4,2,2
2020,460835,45,0,4,2,2
2020,460835,45,4,4,2,2
2020,460899,0,0,5,4,1
2020,460899,10,0,5,4,1
2020,460899,10,6,5,4,1
2020,460899,40,0,5,4,1
2020,460899,40,6,5,4,1
2020,460899,41,0,5,4,1
2020,460899,41,6,5,4,1
2020,460899,45,0,5,4,1
2020,460899,45,6,5,4,1
2020,461014,0,0,15,8,7
2020,461014,50,0,15,8,7
2020,461148,0,0,138,92,46
2020,461148,10,0,95,71,24
2020,461148,10,4,95,71,24
2020,461148,40,0,95,71,24
2020,461148,40,4,95,71,24
2020,461148,41,0,57,43,14
2020,461148,41,4,57,43,14
2020,461148,43,0,38,28,10
2020,461148,43,4,38,28,10
2020,461148,45,0,57,43,14
2020,461148,45,4,57,43,14
2020,461148,50,0,43,21,22
2020,461218,0,0,4,0,4
2020,461218,10,0,4,0,4
2020,461218,10,4,4,0,4
2020,461218,40,0,4,0,4
2020,461218,40,4,4,0,4
2020,461218,41,0,4,0,4
2020,461218,41,4,4,0,4
2020,461218,45,0,4,0,4
2020,461218,45,4,4,0,4
2020,461315,0,0,4,1,3
2020,461315,10,0,4,1,3
2020,461315,10,4,4,1,3
2020,461315,40,0,4,1,3
2020,461315,40,4,4,1,3
2020,461315,42,0,4,1,3
2020,461315,42,4,4,1,3
2020,461324,0,0,11,5,6
2020,461324,10,0,11,5,6
2020,461324,10,1,4,4,0
2020,461324,10,4,7,1,6
2020,461324,40,0,11,5,6
2020,461324,40,1,4,4,0
2020,461324,40,4,7,1,6
2020,461324,41,0,11,5,6
2020,461324,41,1,4,4,0
2020,461324,41,4,7,1,6
2020,461324,45,0,11,5,6
2020,461324,45,1,4,4,0
2020,461324,45,4,7,1,6
2020,461689,0,0,18,2,16
2020,461689,10,0,18,2,16
2020,461689,10,4,18,2,16
2020,461689,40,0,18,2,16
2020,461689,40,4,18,2,16
2020,461689,41,0,18,2,16
2020,461689,41,4,18,2,16
2020,461689,45,0,18,2,16
2020,461689,45,4,18,2,16
2020,461759,0,0,6,4,2
2020,461759,10,0,6,4,2
2020,461759,10,6,6,4,2
2020,461759,40,0,6,4,2
2020,461759,40,6,6,4,2
2020,461759,41,0,6,4,2
2020,461759,41,6,6,4,2
2020,461759,45,0,6,4,2
2020,461759,45,6,6,4,2
2020,461795,0,0,19,13,6
2020,461795,10,0,19,13,6
2020,461795,10,1,1,1,0
2020,461795,10,2,3,2,1
2020,461795,10,3,6,4,2
2020,461795,10,4,4,1,3
2020,461795,10,5,5,5,0
2020,461795,40,0,19,13,6
2020,461795,40,1,1,1,0
2020,461795,40,2,3,2,1
2020,461795,40,3,6,4,2
2020,461795,40,4,4,1,3
2020,461795,40,5,5,5,0
2020,461795,42,0,19,13,6
2020,461795,42,1,1,1,0
2020,461795,42,2,3,2,1
2020,461795,42,3,6,4,2
2020,461795,42,4,4,1,3
2020,461795,42,5,5,5,0
2020,462354,0,0,9,8,1
2020,462354,10,0,9,8,1
2020,462354,10,1,9,8,1
2020,462354,40,0,9,8,1
2020,462354,40,1,9,8,1
2020,462354,41,0,9,8,1
2020,462354,41,1,9,8,1
2020,462354,45,0,9,8,1
2020,462354,45,1,9,8,1
2020,464226,0,0,10,3,7
2020,464226,10,0,10,3,7
2020,464226,10,1,1,0,1
2020,464226,10,2,1,1,0
2020,464226,10,3,7,2,5
2020,464226,10,4,1,0,1
2020,464226,20,0,2,1,1
2020,464226,20,1,1,0,1
2020,464226,20,2,1,1,0
2020,464226,40,0,8,2,6
2020,464226,40,3,7,2,5
2020,464226,40,4,1,0,1
2020,464226,42,0,8,2,6
2020,464226,42,3,7,2,5
2020,464226,42,4,1,0,1
2020,465812,0,0,232,80,152
2020,465812,10,0,232,80,152
2020,465812,10,6,232,80,152
2020,465812,40,0,232,80,152
2020,465812,40,6,232,80,152
2020,465812,41,0,232,80,152
2020,465812,41,6,232,80,152
2020,465812,45,0,232,80,152
2020,465812,45,6,232,80,152
2020,469416,0,0,27,12,15
2020,469416,10,0,27,12,15
2020,469416,10,1,27,12,15
2020,469416,40,0,27,12,15
2020,469416,40,1,27,12,15
2020,469416,41,0,27,12,15
2020,469416,41,1,27,12,15
2020,469416,44,0,27,12,15
2020,469416,44,1,27,12,15
2020,469629,0,0,11,10,1
2020,469629,10,0,11,10,1
2020,469629,10,4,11,10,1
2020,469629,40,0,11,10,1
2020,469629,40,4,11,10,1
2020,469629,41,0,11,10,1
2020,469629,41,4,11,10,1
2020,469629,45,0,11,10,1
2020,469629,45,4,11,10,1
2020,474863,0,0,11,6,5
2020,474863,10,0,11,6,5
2020,474863,10,5,11,6,5
2020,474863,40,0,11,6,5
2020,474863,40,5,11,6,5
2020,474863,41,0,11,6,5
2020,474863,41,5,11,6,5
2020,474863,45,0,11,6,5
2020,474863,45,5,11,6,5
2020,474890,0,0,5,3,2
2020,474890,10,0,5,3,2
2020,474890,10,6,5,3,2
2020,474890,40,0,5,3,2
2020,474890,40,6,5,3,2
2020,474890,41,0,5,3,2
2020,474890,41,6,5,3,2
2020,474890,45,0,5,3,2
2020,474890,45,6,5,3,2
2020,475033,0,0,121,23,98
2020,475033,10,0,112,20,92
2020,475033,10,2,2,0,2
2020,475033,10,3,107,20,87
2020,475033,10,4,3,0,3
2020,475033,40,0,112,20,92
2020,475033,40,2,2,0,2
2020,475033,40,3,107,20,87
2020,475033,40,4,3,0,3
2020,475033,41,0,110,20,90
2020,475033,41,2,2,0,2
2020,475033,41,3,105,20,85
2020,475033,41,4,3,0,3
2020,475033,42,0,2,0,2
2020,475033,42,3,2,0,2
2020,475033,45,0,110,20,90
2020,475033,45,2,2,0,2
2020,475033,45,3,105,20,85
2020,475033,45,4,3,0,3
2020,475033,50,0,9,3,6
2020,475176,0,0,18,11,7
2020,475176,10,0,18,11,7
2020,475176,10,4,18,11,7
2020,475176,40,0,18,11,7
2020,475176,40,4,18,11,7
2020,475176,41,0,18,11,7
2020,475176,41,4,18,11,7
2020,475176,45,0,18,11,7
2020,475176,45,4,18,11,7
2020,475200,0,0,2,1,1
2020,475200,10,0,2,1,1
2020,475200,10,5,2,1,1
2020,475200,40,0,2,1,1
2020,475200,40,5,2,1,1
2020,475200,42,0,2,1,1
2020,475200,42,5,2,1,1
2020,475273,0,0,16,8,8
2020,475273,10,0,16,8,8
2020,475273,10,1,6,4,2
2020,475273,10,2,2,0,2
2020,475273,10,3,8,4,4
2020,475273,20,0,4,2,2
2020,475273,20,1,4,2,2
2020,475273,30,0,3,1,2
2020,475273,30,2,1,0,1
2020,475273,30,3,2,1,1
2020,475273,40,0,9,5,4
2020,475273,40,1,2,2,0
2020,475273,40,2,1,0,1
2020,475273,40,3,6,3,3
2020,475273,41,0,9,5,4
2020,475273,41,1,2,2,0
2020,475273,41,2,1,0,1
2020,475273,41,3,6,3,3
2020,475273,44,0,9,5,4
2020,475273,44,1,2,2,0
2020,475273,44,2,1,0,1
2020,475273,44,3,6,3,3
2020,475398,0,0,7,5,2
2020,475398,10,0,7,5,2
2020,475398,10,6,7,5,2
2020,475398,40,0,7,5,2
2020,475398,40,6,7,5,2
2020,475398,41,0,2,1,1
2020,475398,41,6,2,1,1
2020,475398,42,0,5,4,1
2020,475398,42,6,5,4,1
2020,475398,45,0,2,1,1
2020,475398,45,6,2,1,1
2020,475422,0,0,12,1,11
2020,475422,10,0,12,1,11
2020,475422,10,2,3,1,2
2020,475422,10,3,9,0,9
2020,475422,40,0,12,1,11
2020,475422,40,2,3,1,2
2020,475422,40,3,9,0,9
2020,475422,42,0,12,1,11
2020,475422,42,2,3,1,2
2020,475422,42,3,9,0,9
2020,475495,0,0,63,31,32
2020,475495,10,0,63,31,32
2020,475495,10,1,10,8,2
2020,475495,10,2,18,6,12
2020,475495,10,3,25,12,13
2020,475495,10,4,10,5,5
2020,475495,40,0,63,31,32
2020,475495,40,1,10,8,2
2020,475495,40,2,18,6,12
2020,475495,40,3,25,12,13
2020,475495,40,4,10,5,5
2020,475495,41,0,63,31,32
2020,475495,41,1,10,8,2
2020,475495,41,2,18,6,12
2020,475495,41,3,25,12,13
2020,475495,41,4,10,5,5
2020,475495,45,0,63,31,32
2020,475495,45,1,10,8,2
2020,475495,45,2,18,6,12
2020,475495,45,3,25,12,13
2020,475495,45,4,10,5,5
2020,475565,0,0,48,19,29
2020,475565,10,0,48,19,29
2020,475565,10,1,7,4,3
2020,475565,10,2,12,2,10
2020,475565,10,3,21,6,15
2020,475565,10,4,2,2,0
2020,475565,10,5,6,5,1
2020,475565,20,0,14,6,8
2020,475565,20,1,6,4,2
2020,475565,20,2,5,0,5
2020,475565,20,5,3,2,1
2020,475565,30,0,31,11,20
2020,475565,30,2,7,2,5
2020,475565,30,3,21,6,15
2020,475565,30,5,3,3,0
2020,475565,40,0,3,2,1
2020,475565,40,1,1,0,1
2020,475565,40,4,2,2,0
2020,475565,42,0,3,2,1
2020,475565,42,1,1,0,1
2020,475565,42,4,2,2,0
2020,475608,0,0,13,11,2
2020,475608,10,0,13,11,2
2020,475608,10,1,6,6,0
2020,475608,10,2,5,5,0
2020,475608,10,3,2,0,2
2020,475608,40,0,13,11,2
2020,475608,40,1,6,6,0
2020,475608,40,2,5,5,0
2020,475608,40,3,2,0,2
2020,475608,41,0,13,11,2
2020,475608,41,1,6,6,0
2020,475608,41,2,5,5,0
2020,475608,41,3,2,0,2
2020,475608,44,0,13,11,2
2020,475608,44,1,6,6,0
2020,475608,44,2,5,5,0
2020,475608,44,3,2,0,2
2020,475714,0,0,6,3,3
2020,475714,10,0,6,3,3
2020,475714,10,4,6,3,3
2020,475714,40,0,6,3,3
2020,475714,40,4,6,3,3
2020,475714,41,0,6,3,3
2020,475714,41,4,6,3,3
2020,475714,45,0,6,3,3
2020,475714,45,4,6,3,3
2020,476683,0,0,6,1,5
2020,476683,50,0,6,1,5
2020,476717,0,0,28,28,0
2020,476717,10,0,28,28,0
2020,476717,10,4,28,28,0
2020,476717,40,0,28,28,0
2020,476717,40,4,28,28,0
2020,476717,42,0,28,28,0
2020,476717,42,4,28,28,0
2020,476726,0,0,19,8,11
2020,476726,10,0,19,8,11
2020,476726,10,1,2,1,1
2020,476726,10,4,17,7,10
2020,476726,40,0,19,8,11
2020,476726,40,1,2,1,1
2020,476726,40,4,17,7,10
2020,476726,41,0,19,8,11
2020,476726,41,1,2,1,1
2020,476726,41,4,17,7,10
2020,476726,45,0,19,8,11
2020,476726,45,1,2,1,1
2020,476726,45,4,17,7,10
2020,476939,0,0,20,6,14
2020,476939,10,0,20,6,14
2020,476939,10,4,20,6,14
2020,476939,40,0,20,6,14
2020,476939,40,4,20,6,14
2020,476939,41,0,20,6,14
2020,476939,41,4,20,6,14
2020,476939,45,0,20,6,14
2020,476939,45,4,20,6,14
2020,476948,0,0,3,3,0
2020,476948,10,0,3,3,0
2020,476948,10,4,3,3,0
2020,476948,40,0,3,3,0
2020,476948,40,4,3,3,0
2020,476948,41,0,3,3,0
2020,476948,41,4,3,3,0
2020,476948,45,0,3,3,0
2020,476948,45,4,3,3,0
2020,476975,0,0,32,13,19
2020,476975,10,0,32,13,19
2020,476975,10,6,32,13,19
2020,476975,40,0,32,13,19
2020,476975,40,6,32,13,19
2020,476975,41,0,32,13,19
2020,476975,41,6,32,13,19
2020,476975,45,0,32,13,19
2020,476975,45,6,32,13,19
2020,477039,0,0,24,4,20
2020,477039,10,0,23,4,19
2020,477039,10,2,1,1,0
2020,477039,10,3,1,0,1
2020,477039,10,4,21,3,18
2020,477039,40,0,23,4,19
2020,477039,40,2,1,1,0
2020,477039,40,3,1,0,1
2020,477039,40,4,21,3,18
2020,477039,41,0,23,4,19
2020,477039,41,2,1,1,0
2020,477039,41,3,1,0,1
2020,477039,41,4,21,3,18
2020,477039,45,0,23,4,19
2020,477039,45,2,1,1,0
2020,477039,45,3,1,0,1
2020,477039,45,4,21,3,18
2020,477039,50,0,1,0,1
2020,478634,0,0,4,2,2
2020,478634,10,0,4,2,2
2020,478634,10,6,4,2,2
2020,478634,40,0,4,2,2
2020,478634,40,6,4,2,2
2020,478634,41,0,4,2,2
2020,478634,41,6,4,2,2
2020,478634,45,0,4,2,2
2020,478634,45,6,4,2,2
2020,480073,0,0,8,1,7
2020,480073,10,0,8,1,7
2020,480073,10,3,2,0,2
2020,480073,10,4,6,1,5
2020,480073,40,0,8,1,7
2020,480073,40,3,2,0,2
2020,480073,40,4,6,1,5
2020,480073,41,0,8,1,7
2020,480073,41,3,2,0,2
2020,480073,41,4,6,1,5
2020,480073,45,0,8,1,7
2020,480073,45,3,2,0,2
2020,480073,45,4,6,1,5
2020,480091,0,0,40,6,34
2020,480091,10,0,40,6,34
2020,480091,10,4,40,6,34
2020,480091,40,0,40,6,34
2020,480091,40,4,40,6,34
2020,480091,41,0,40,6,34
2020,480091,41,4,40,6,34
2020,480091,45,0,40,6,34
2020,480091,45,4,40,6,34
2020,480189,0,0,17,2,15
2020,480189,10,0,17,2,15
2020,480189,10,3,5,0,5
2020,480189,10,4,10,2,8
2020,480189,10,5,2,0,2
2020,480189,40,0,17,2,15
2020,480189,40,3,5,0,5
2020,480189,40,4,10,2,8
2020,480189,40,5,2,0,2
2020,480189,42,0,17,2,15
2020,480189,42,3,5,0,5
2020,480189,42,4,10,2,8
2020,480189,42,5,2,0,2
2020,480204,0,0,13,3,10
2020,480204,10,0,13,3,10
2020,480204,10,4,13,3,10
2020,480204,40,0,13,3,10
2020,480204,40,4,13,3,10
2020,480204,41,0,13,3,10
2020,480204,41,4,13,3,10
2020,480204,45,0,13,3,10
2020,480204,45,4,13,3,10
2020,480569,0,0,10,5,5
2020,480569,10,0,10,5,5
2020,480569,10,2,3,1,2
2020,480569,10,3,5,3,2
2020,480569,10,4,2,1,1
2020,480569,20,0,1,1,0
2020,480569,20,2,1,1,0
2020,480569,40,0,9,4,5
2020,480569,40,2,2,0,2
2020,480569,40,3,5,3,2
2020,480569,40,4,2,1,1
2020,480569,42,0,9,4,5
2020,480569,42,2,2,0,2
2020,480569,42,3,5,3,2
2020,480569,42,4,2,1,1
2020,480657,0,0,14,1,13
2020,480657,10,0,14,1,13
2020,480657,10,4,14,1,13
2020,480657,40,0,14,1,13
2020,480657,40,4,14,1,13
2020,480657,41,0,14,1,13
2020,480657,41,4,14,1,13
2020,480657,45,0,14,1,13
2020,480657,45,4,14,1,13
2020,480790,0,0,79,44,35
2020,480790,10,0,79,44,35
2020,480790,10,1,16,13,3
2020,480790,10,2,16,8,8
2020,480790,10,3,37,19,18
2020,480790,10,4,10,4,6
2020,480790,40,0,79,44,35
2020,480790,40,1,16,13,3
2020,480790,40,2,16,8,8
2020,480790,40,3,37,19,18
2020,480790,40,4,10,4,6
2020,480790,41,0,50,28,22
2020,480790,41,1,13,10,3
2020,480790,41,2,11,5,6
2020,480790,41,3,21,11,10
2020,480790,41,4,5,2,3
2020,480790,42,0,29,16,13
2020,480790,42,1,3,3,0
2020,480790,42,2,5,3,2
2020,480790,42,3,16,8,8
2020,480790,42,4,5,2,3
2020,480790,44,0,48,27,21
2020,480790,44,1,13,10,3
2020,480790,44,2,11,5,6
2020,480790,44,3,21,11,10
2020,480790,44,4,3,1,2
2020,480790,45,0,2,1,1
2020,480790,45,4,2,1,1
2020,480824,0,0,10,0,10
2020,480824,10,0,10,0,10
2020,480824,10,4,10,0,10
2020,480824,40,0,10,0,10
2020,480824,40,4,10,0,10
2020,480824,41,0,10,0,10
2020,480824,41,4,10,0,10
2020,480824,45,0,10,0,10
2020,480824,45,4,10,0,10
2020,480833,0,0,30,5,25
2020,480833,10,0,30,5,25
2020,480833,10,4,30,5,25
2020,480833,40,0,30,5,25
2020,480833,40,4,30,5,25
2020,480833,41,0,30,5,25
2020,480833,41,4,30,5,25
2020,480833,45,0,30,5,25
2020,480833,45,4,30,5,25
2020,480967,0,0,10,4,6
2020,480967,10,0,10,4,6
2020,480967,10,4,10,4,6
2020,480967,40,0,10,4,6
2020,480967,40,4,10,4,6
2020,480967,41,0,10,4,6
2020,480967,41,4,10,4,6
2020,480967,45,0,10,4,6
2020,480967,45,4,10,4,6
2020,481030,0,0,7,4,3
2020,481030,10,0,7,4,3
2020,481030,10,1,3,3,0
2020,481030,10,2,1,0,1
2020,481030,10,3,1,0,1
2020,481030,10,4,2,1,1
2020,481030,40,0,7,4,3
2020,481030,40,1,3,3,0
2020,481030,40,2,1,0,1
2020,481030,40,3,1,0,1
2020,481030,40,4,2,1,1
2020,481030,42,0,3,1,2
2020,481030,42,2,1,0,1
2020,481030,42,4,2,1,1
2020,481030,43,0,4,3,1
2020,481030,43,1,3,3,0
2020,481030,43,3,1,0,1
2020,481094,0,0,6,2,4
2020,481094,10,0,6,2,4
2020,481094,10,6,6,2,4
2020,481094,40,0,6,2,4
2020,481094,40,6,6,2,4
2020,481094,41,0,4,1,3
2020,481094,41,6,4,1,3
2020,481094,42,0,2,1,1
2020,481094,42,6,2,1,1
2020,481094,44,0,4,1,3
2020,481094,44,6,4,1,3
2020,481155,0,0,13,4,9
2020,481155,10,0,13,4,9
2020,481155,10,4,13,4,9
2020,481155,40,0,13,4,9
2020,481155,40,4,13,4,9
2020,481155,41,0,13,4,9
2020,481155,41,4,13,4,9
2020,481155,44,0,13,4,9
2020,481155,44,4,13,4,9
2020,481225,0,0,3,3,0
2020,481225,10,0,3,3,0
2020,481225,10,6,3,3,0
2020,481225,40,0,3,3,0
2020,481225,40,6,3,3,0
2020,481225,42,0,3,3,0
2020,481225,42,6,3,3,0
2020,481401,0,0,7,7,0
2020,481401,10,0,7,7,0
2020,481401,10,1,5,5,0
2020,481401,10,2,1,1,0
2020,481401,10,3,1,1,0
2020,481401,40,0,7,7,0
2020,481401,40,1,5,5,0
2020,481401,40,2,1,1,0
2020,481401,40,3,1,1,0
2020,481401,41,0,7,7,0
2020,481401,41,1,5,5,0
2020,481401,41,2,1,1,0
2020,481401,41,3,1,1,0
2020,481401,45,0,7,7,0
2020,481401,45,1,5,5,0
2020,481401,45,2,1,1,0
2020,481401,45,3,1,1,0
2020,481438,0,0,8,8,0
2020,481438,10,0,8,8,0
2020,481438,10,4,8,8,0
2020,481438,40,0,8,8,0
2020,481438,40,4,8,8,0
2020,481438,42,0,8,8,0
2020,481438,42,4,8,8,0
2020,481535,0,0,39,28,11
2020,481535,10,0,39,28,11
2020,481535,10,1,24,19,5
2020,481535,10,2,7,5,2
2020,481535,10,3,8,4,4
2020,481535,40,0,39,28,11
2020,481535,40,1,24,19,5
2020,481535,40,2,7,5,2
2020,481535,40,3,8,4,4
2020,481535,41,0,39,28,11
2020,481535,41,1,24,19,5
2020,481535,41,2,7,5,2
2020,481535,41,3,8,4,4
2020,481535,45,0,39,28,11
2020,481535,45,1,24,19,5
2020,481535,45,2,7,5,2
2020,481535,45,3,8,4,4
2020,482149,0,0,959,510,449
2020,482149,10,0,899,493,406
2020,482149,10,1,202,145,57
2020,482149,10,2,244,132,112
2020,482149,10,3,363,181,182
2020,482149,10,4,39,13,26
2020,482149,10,5,50,21,29
2020,482149,10,6,1,1,0
2020,482149,20,0,183,112,71
2020,482149,20,1,95,65,30
2020,482149,20,2,79,44,35
2020,482149,20,3,9,3,6
2020,482149,30,0,73,35,38
2020,482149,30,1,3,3,0
2020,482149,30,2,3,2,1
2020,482149,30,3,67,30,37
2020,482149,40,0,643,346,297
2020,482149,40,1,104,77,27
2020,482149,40,2,162,86,76
2020,482149,40,3,287,148,139
2020,482149,40,4,39,13,26
2020,482149,40,5,50,21,29
2020,482149,40,6,1,1,0
2020,482149,42,0,643,346,297
2020,482149,42,1,104,77,27
2020,482149,42,2,162,86,76
2020,482149,42,3,287,148,139
2020,482149,42,4,39,13,26
2020,482149,42,5,50,21,29
2020,482149,42,6,1,1,0
2020,482149,50,0,60,17,43
2020,482158,0,0,267,134,133
2020,482158,10,0,267,134,133
2020,482158,10,1,57,35,22
2020,482158,10,2,70,32,38
2020,482158,10,3,93,40,53
2020,482158,10,4,3,1,2
2020,482158,10,5,44,26,18
2020,482158,20,0,137,72,65
2020,482158,20,1,57,35,22
2020,482158,20,2,69,31,38
2020,482158,20,3,11,6,5
2020,482158,30,0,83,35,48
2020,482158,30,2,1,1,0
2020,482158,30,3,82,34,48
2020,482158,40,0,47,27,20
2020,482158,40,4,3,1,2
2020,482158,40,5,44,26,18
2020,482158,42,0,47,27,20
2020,482158,42,4,3,1,2
2020,482158,42,5,44,26,18
2020,482228,0,0,7,5,2
2020,482228,10,0,7,5,2
2020,482228,10,1,5,4,1
2020,482228,10,2,1,0,1
2020,482228,10,4,1,1,0
2020,482228,40,0,7,5,2
2020,482228,40,1,5,4,1
2020,482228,40,2,1,0,1
2020,482228,40,4,1,1,0
2020,482228,42,0,7,5,2
2020,482228,42,1,5,4,1
2020,482228,42,2,1,0,1
2020,482228,42,4,1,1,0
2020,482413,0,0,11,9,2
2020,482413,10,0,11,9,2
2020,482413,10,1,11,9,2
2020,482413,40,0,11,9,2
2020,482413,40,1,11,9,2
2020,482413,41,0,11,9,2
2020,482413,41,1,11,9,2
2020,482413,45,0,11,9,2
2020,482413,45,1,11,9,2
2020,482422,0,0,6,3,3
2020,482422,10,0,6,3,3
2020,482422,10,1,4,3,1
2020,482422,10,2,1,0,1
2020,482422,10,3,1,0,1
2020,482422,40,0,6,3,3
2020,482422,40,1,4,3,1
2020,482422,40,2,1,0,1
2020,482422,40,3,1,0,1
2020,482422,41,0,6,3,3
2020,482422,41,1,4,3,1
2020,482422,41,2,1,0,1
2020,482422,41,3,1,0,1
2020,482422,45,0,6,3,3
2020,482422,45,1,4,3,1
2020,482422,45,2,1,0,1
2020,482422,45,3,1,0,1
2020,482431,0,0,27,22,5
2020,482431,10,0,27,22,5
2020,482431,10,1,23,19,4
2020,482431,10,2,4,3,1
2020,482431,40,0,27,22,5
2020,482431,40,1,23,19,4
2020,482431,40,2,4,3,1
2020,482431,41,0,27,22,5
2020,482431,41,1,23,19,4
2020,482431,41,2,4,3,1
2020,482431,45,0,27,22,5
2020,482431,45,1,23,19,4
2020,482431,45,2,4,3,1
2020,482459,0,0,6,5,1
2020,482459,10,0,6,5,1
2020,482459,10,1,6,5,1
2020,482459,40,0,6,5,1
2020,482459,40,1,6,5,1
2020,482459,41,0,6,5,1
2020,482459,41,1,6,5,1
2020,482459,45,0,6,5,1
2020,482459,45,1,6,5,1
2020,482468,0,0,8,6,2
2020,482468,10,0,8,6,2
2020,482468,10,1,7,5,2
2020,482468,10,2,1,1,0
2020,482468,40,0,8,6,2
2020,482468,40,1,7,5,2
2020,482468,40,2,1,1,0
2020,482468,41,0,8,6,2
2020,482468,41,1,7,5,2
2020,482468,41,2,1,1,0
2020,482468,45,0,8,6,2
2020,482468,45,1,7,5,2
2020,482468,45,2,1,1,0
2020,482477,0,0,62,39,23
2020,482477,10,0,62,39,23
2020,482477,10,1,46,30,16
2020,482477,10,2,11,5,6
2020,482477,10,3,5,4,1
2020,482477,40,0,62,39,23
2020,482477,40,1,46,30,16
2020,482477,40,2,11,5,6
2020,482477,40,3,5,4,1
2020,482477,41,0,62,39,23
2020,482477,41,1,46,30,16
2020,482477,41,2,11,5,6
2020,482477,41,3,5,4,1
2020,482477,45,0,62,39,23
2020,482477,45,1,46,30,16
2020,482477,45,2,11,5,6
2020,482477,45,3,5,4,1
2020,482556,0,0,8,5,3
2020,482556,10,0,8,5,3
2020,482556,10,1,8,5,3
2020,482556,40,0,8,5,3
2020,482556,40,1,8,5,3
2020,482556,41,0,8,5,3
2020,482556,41,1,8,5,3
2020,482556,45,0,8,5,3
2020,482556,45,1,8,5,3
2020,482574,0,0,9,7,2
2020,482574,10,0,9,7,2
2020,482574,10,1,9,7,2
2020,482574,40,0,9,7,2
2020,482574,40,1,9,7,2
2020,482574,41,0,9,7,2
2020,482574,41,1,9,7,2
2020,482574,45,0,9,7,2
2020,482574,45,1,9,7,2
2020,482608,0,0,3,2,1
2020,482608,10,0,3,2,1
2020,482608,10,1,3,2,1
2020,482608,40,0,3,2,1
2020,482608,40,1,3,2,1
2020,482608,41,0,3,2,1
2020,482608,41,1,3,2,1
2020,482608,45,0,3,2,1
2020,482608,45,1,3,2,1
2020,482635,0,0,16,9,7
2020,482635,10,0,16,9,7
2020,482635,10,1,11,6,5
2020,482635,10,2,5,3,2
2020,482635,40,0,16,9,7
2020,482635,40,1,11,6,5
2020,482635,40,2,5,3,2
2020,482635,41,0,16,9,7
2020,482635,41,1,11,6,5
2020,482635,41,2,5,3,2
2020,482635,45,0,16,9,7
2020,482635,45,1,11,6,5
2020,482635,45,2,5,3,2
2020,482653,0,0,3,2,1
2020,482653,10,0,3,2,1
2020,482653,10,1,3,2,1
2020,482653,40,0,3,2,1
2020,482653,40,1,3,2,1
2020,482653,41,0,3,2,1
2020,482653,41,1,3,2,1
2020,482653,45,0,3,2,1
2020,482653,45,1,3,2,1
2020,482680,0,0,724,367,357
2020,482680,10,0,724,367,357
2020,482680,10,1,135,83,52
2020,482680,10,2,154,92,62
2020,482680,10,3,213,102,111
2020,482680,10,4,1,1,0
2020,482680,10,5,187,70,117
2020,482680,10,6,34,19,15
2020,482680,20,0,292,176,116
2020,482680,20,1,133,82,51
2020,482680,20,2,144,86,58
2020,482680,20,3,15,8,7
2020,482680,30,0,196,97,99
2020,482680,30,1,1,0,1
2020,482680,30,2,10,6,4
2020,482680,30,3,185,91,94
2020,482680,40,0,236,94,142
2020,482680,40,1,1,1,0
2020,482680,40,3,13,3,10
2020,482680,40,4,1,1,0
2020,482680,40,5,187,70,117
2020,482680,40,6,34,19,15
2020,482680,42,0,236,94,142
2020,482680,42,1,1,1,0
2020,482680,42,3,13,3,10
2020,482680,42,4,1,1,0
2020,482680,42,5,187,70,117
2020,482680,42,6,34,19,15
2020,482699,0,0,63,29,34
2020,482699,10,0,63,29,34
2020,482699,10,1,11,4,7
2020,482699,10,2,20,10,10
2020,482699,10,3,20,8,12
2020,482699,10,4,2,2,0
2020,482699,10,5,10,5,5
2020,482699,20,0,30,12,18
2020,482699,20,1,10,4,6
2020,482699,20,2,18,8,10
2020,482699,20,3,2,0,2
2020,482699,30,0,23,12,11
2020,482699,30,1,1,0,1
2020,482699,30,2,2,2,0
2020,482699,30,3,18,8,10
2020,482699,30,4,2,2,0
2020,482699,40,0,10,5,5
2020,482699,40,5,10,5,5
2020,482699,42,0,10,5,5
2020,482699,42,5,10,5,5
2020,482705,0,0,128,52,76
2020,482705,10,0,128,52,76
2020,482705,10,1,10,6,4
2020,482705,10,2,52,19,33
2020,482705,10,3,41,16,25
2020,482705,10,4,22,10,12
2020,482705,10,5,1,0,1
2020,482705,10,6,2,1,1
2020,482705,40,0,128,52,76
2020,482705,40,1,10,6,4
2020,482705,40,2,52,19,33
2020,482705,40,3,41,16,25
2020,482705,40,4,22,10,12
2020,482705,40,5,1,0,1
2020,482705,40,6,2,1,1
2020,482705,41,0,8,5,3
2020,482705,41,1,1,1,0
2020,482705,41,2,2,2,0
2020,482705,41,3,2,1,1
2020,482705,41,4,3,1,2
2020,482705,42,0,120,47,73
2020,482705,42,1,9,5,4
2020,482705,42,2,50,17,33
2020,482705,42,3,39,15,24
2020,482705,42,4,19,9,10
2020,482705,42,5,1,0,1
2020,482705,42,6,2,1,1
2020,482705,44,0,8,5,3
2020,482705,44,1,1,1,0
2020,482705,44,2,2,2,0
2020,482705,44,3,2,1,1
2020,482705,44,4,3,1,2
2020,482936,0,0,71,53,18
2020,482936,10,0,71,53,18
2020,482936,10,1,3,2,1
2020,482936,10,2,13,11,2
2020,482936,10,3,41,32,9
2020,482936,10,4,14,8,6
2020,482936,40,0,71,53,18
2020,482936,40,1,3,2,1
2020,482936,40,2,13,11,2
2020,482936,40,3,41,32,9
2020,482936,40,4,14,8,6
2020,482936,41,0,68,51,17
2020,482936,41,1,3,2,1
2020,482936,41,2,13,11,2
2020,482936,41,3,38,30,8
2020,482936,41,4,14,8,6
2020,482936,43,0,3,2,1
2020,482936,43,3,3,2,1
2020,482936,44,0,54,43,11
2020,482936,44,1,3,2,1
2020,482936,44,2,13,11,2
2020,482936,44,3,38,30,8
2020,482936,45,0,14,8,6
2020,482936,45,4,14,8,6
2020,482990,0,0,5,1,4
2020,482990,50,0,5,1,4
2020,483018,0,0,16,8,8
2020,483018,10,0,16,8,8
2020,483018,10,2,7,3,4
2020,483018,10,3,9,5,4
2020,483018,20,0,3,1,2
2020,483018,20,2,3,1,2
2020,483018,30,0,3,3,0
2020,483018,30,3,3,3,0
2020,483018,40,0,10,4,6
2020,483018,40,2,4,2,2
2020,483018,40,3,6,2,4
2020,483018,41,0,10,4,6
2020,483018,41,2,4,2,2
2020,483018,41,3,6,2,4
2020,483018,44,0,10,4,6
2020,483018,44,2,4,2,2
2020,483018,44,3,6,2,4
2020,483036,0,0,94,47,47
2020,483036,10,0,94,47,47
2020,483036,10,1,6,6,0
2020,483036,10,2,31,11,20
2020,483036,10,3,45,24,21
2020,483036,10,4,1,0,1
2020,483036,10,5,11,6,5
2020,483036,20,0,24,14,10
2020,483036,20,1,5,5,0
2020,483036,20,2,19,9,10
2020,483036,30,0,44,21,23
2020,483036,30,2,5,1,4
2020,483036,30,3,36,19,17
2020,483036,30,4,1,0,1
2020,483036,30,5,2,1,1
2020,483036,40,0,26,12,14
2020,483036,40,1,1,1,0
2020,483036,40,2,7,1,6
2020,483036,40,3,9,5,4
2020,483036,40,5,9,5,4
2020,483036,42,0,9,2,7
2020,483036,42,1,1,1,0
2020,483036,42,2,4,0,4
2020,483036,42,3,2,0,2
2020,483036,42,5,2,1,1
2020,483036,43,0,17,10,7
2020,483036,43,2,3,1,2
2020,483036,43,3,7,5,2
2020,483036,43,5,7,4,3
2020,483045,0,0,227,97,130
2020,483045,10,0,227,97,130
2020,483045,10,6,227,97,130
2020,483045,40,0,227,97,130
2020,483045,40,6,227,97,130
2020,483045,41,0,27,15,12
2020,483045,41,6,27,15,12
2020,483045,42,0,196,80,116
2020,483045,42,6,196,80,116
2020,483045,43,0,4,2,2
2020,483045,43,6,4,2,2
2020,483045,45,0,27,15,12
2020,483045,45,6,27,15,12
2020,483124,0,0,1003,462,541
2020,483124,10,0,1003,462,541
2020,483124,10,1,188,117,71
2020,483124,10,2,209,94,115
2020,483124,10,3,156,70,86
2020,483124,10,4,174,62,112
2020,483124,10,5,275,119,156
2020,483124,10,6,1,0,1
2020,483124,20,0,300,169,131
2020,483124,20,1,146,94,52
2020,483124,20,2,154,75,79
2020,483124,30,0,86,41,45
2020,483124,30,2,4,0,4
2020,483124,30,3,82,41,41
2020,483124,40,0,617,252,365
2020,483124,40,1,42,23,19
2020,483124,40,2,51,19,32
2020,483124,40,3,74,29,45
2020,483124,40,4,174,62,112
2020,483124,40,5,275,119,156
2020,483124,40,6,1,0,1
2020,483124,41,0,77,37,40
2020,483124,41,1,11,7,4
2020,483124,41,2,7,6,1
2020,483124,41,3,3,1,2
2020,483124,41,5,56,23,33
2020,483124,42,0,539,215,324
2020,483124,42,1,31,16,15
2020,483124,42,2,44,13,31
2020,483124,42,3,71,28,43
2020,483124,42,4,174,62,112
2020,483124,42,5,219,96,123
2020,483124,43,0,1,0,1
2020,483124,43,6,1,0,1
2020,483124,44,0,77,37,40
2020,483124,44,1,11,7,4
2020,483124,44,2,7,6,1
2020,483124,44,3,3,1,2
2020,483124,44,5,56,23,33
2020,483212,0,0,89,39,50
2020,483212,10,0,89,39,50
2020,483212,10,1,1,0,1
2020,483212,10,2,7,3,4
2020,483212,10,3,8,2,6
2020,483212,10,4,73,34,39
2020,483212,20,0,2,0,2
2020,483212,20,1,1,0,1
2020,483212,20,4,1,0,1
2020,483212,40,0,87,39,48
2020,483212,40,2,7,3,4
2020,483212,40,3,8,2,6
2020,483212,40,4,72,34,38
2020,483212,42,0,87,39,48
2020,483212,42,2,7,3,4
2020,483212,42,3,8,2,6
2020,483212,42,4,72,34,38
2020,483814,0,0,8,0,8
2020,483814,10,0,8,0,8
2020,483814,10,4,8,0,8
2020,483814,40,0,8,0,8
2020,483814,40,4,8,0,8
2020,483814,41,0,8,0,8
2020,483814,41,4,8,0,8
2020,483814,45,0,8,0,8
2020,483814,45,4,8,0,8
2020,483975,0,0,29,18,11
2020,483975,10,0,29,18,11
2020,483975,10,1,3,2,1
2020,483975,10,2,12,9,3
2020,483975,10,3,9,6,3
2020,483975,10,4,5,1,4
2020,483975,40,0,29,18,11
2020,483975,40,1,3,2,1
2020,483975,40,2,12,9,3
2020,483975,40,3,9,6,3
2020,483975,40,4,5,1,4
2020,483975,41,0,29,18,11
2020,483975,41,1,3,2,1
2020,483975,41,2,12,9,3
2020,483975,41,3,9,6,3
2020,483975,41,4,5,1,4
2020,483975,44,0,29,18,11
2020,483975,44,1,3,2,1
2020,483975,44,2,12,9,3
2020,483975,44,3,9,6,3
2020,483975,44,4,5,1,4
2020,484002,0,0,30,5,25
2020,484002,10,0,30,5,25
2020,484002,10,4,30,5,25
2020,484002,40,0,30,5,25
2020,484002,40,4,30,5,25
2020,484002,41,0,30,5,25
2020,484002,41,4,30,5,25
2020,484002,45,0,30,5,25
2020,484002,45,4,30,5,25
2020,484066,0,0,27,2,25
2020,484066,10,0,27,2,25
2020,484066,10,4,27,2,25
2020,484066,40,0,27,2,25
2020,484066,40,4,27,2,25
2020,484066,41,0,27,2,25
2020,484066,41,4,27,2,25
2020,484066,45,0,27,2,25
2020,484066,45,4,27,2,25
2020,484473,0,0,10,3,7
2020,484473,10,0,10,3,7
2020,484473,10,5,6,2,4
2020,484473,10,6,4,1,3
2020,484473,40,0,10,3,7
2020,484473,40,5,6,2,4
2020,484473,40,6,4,1,3
2020,484473,42,0,10,3,7
2020,484473,42,5,6,2,4
2020,484473,42,6,4,1,3
2020,484613,0,0,80,10,70
2020,484613,10,0,80,10,70
2020,484613,10,6,80,10,70
2020,484613,40,0,80,10,70
2020,484613,40,6,80,10,70
2020,484613,41,0,80,10,70
2020,484613,41,6,80,10,70
2020,484613,45,0,80,10,70
2020,484613,45,6,80,10,70
2020,484835,0,0,1,1,0
2020,484835,10,0,1,1,0
2020,484835,10,1,1,1,0
2020,484835,20,0,1,1,0
2020,484835,20,1,1,1,0
2020,484862,0,0,8,6,2
2020,484862,10,0,8,6,2
2020,484862,10,1,8,6,2
2020,484862,40,0,8,6,2
2020,484862,40,1,8,6,2
2020,484862,42,0,1,1,0
2020,484862,42,1,1,1,0
2020,484862,43,0,7,5,2
2020,484862,43,1,7,5,2
2020,484905,0,0,126,59,67
2020,484905,10,0,117,56,61
2020,484905,10,1,11,5,6
2020,484905,10,2,19,11,8
2020,484905,10,3,37,19,18
2020,484905,10,4,7,3,4
2020,484905,10,5,43,18,25
2020,484905,20,0,22,11,11
2020,484905,20,1,7,3,4
2020,484905,20,2,15,8,7
2020,484905,30,0,34,18,16
2020,484905,30,2,3,2,1
2020,484905,30,3,31,16,15
2020,484905,40,0,61,27,34
2020,484905,40,1,4,2,2
2020,484905,40,2,1,1,0
2020,484905,40,3,6,3,3
2020,484905,40,4,7,3,4
2020,484905,40,5,43,18,25
2020,484905,42,0,61,27,34
2020,484905,42,1,4,2,2
2020,484905,42,2,1,1,0
2020,484905,42,3,6,3,3
2020,484905,42,4,7,3,4
2020,484905,42,5,43,18,25
2020,484905,50,0,9,3,6
2020,484932,0,0,77,31,46
2020,484932,10,0,75,31,44
2020,484932,10,1,16,6,10
2020,484932,10,2,11,7,4
2020,484932,10,3,22,6,16
2020,484932,10,4,24,12,12
2020,484932,10,6,2,0,2
2020,484932,40,0,75,31,44
2020,484932,40,1,16,6,10
2020,484932,40,2,11,7,4
2020,484932,40,3,22,6,16
2020,484932,40,4,24,12,12
2020,484932,40,6,2,0,2
2020,484932,42,0,75,31,44
2020,484932,42,1,16,6,10
2020,484932,42,2,11,7,4
2020,484932,42,3,22,6,16
2020,484932,42,4,24,12,12
2020,484932,42,6,2,0,2
2020,484932,50,0,2,0,2
2020,485111,0,0,125,57,68
2020,485111,10,0,125,57,68
2020,485111,10,1,31,15,16
2020,485111,10,2,14,7,7
2020,485111,10,3,80,35,45
2020,485111,40,0,125,57,68
2020,485111,40,1,31,15,16
2020,485111,40,2,14,7,7
2020,485111,40,3,80,35,45
2020,485111,42,0,125,57,68
2020,485111,42,1,31,15,16
2020,485111,42,2,14,7,7
2020,485111,42,3,80,35,45
2020,485139,0,0,1,1,0
2020,485139,10,0,1,1,0
2020,485139,10,4,1,1,0
2020,485139,40,0,1,1,0
2020,485139,40,4,1,1,0
2020,485139,41,0,1,1,0
2020,485139,41,4,1,1,0
2020,485139,45,0,1,1,0
2020,485139,45,4,1,1,0
2020,485263,0,0,13,7,6
2020,485263,10,0,13,7,6
2020,485263,10,6,13,7,6
2020,485263,40,0,13,7,6
2020,485263,40,6,13,7,6
2020,485263,41,0,13,7,6
2020,485263,41,6,13,7,6
2020,485263,45,0,13,7,6
2020,485263,45,6,13,7,6
2020,485272,0,0,34,7,27
2020,485272,10,0,33,6,27
2020,485272,10,2,2,2,0
2020,485272,10,3,3,0,3
2020,485272,10,4,28,4,24
2020,485272,40,0,33,6,27
2020,485272,40,2,2,2,0
2020,485272,40,3,3,0,3
2020,485272,40,4,28,4,24
2020,485272,41,0,33,6,27
2020,485272,41,2,2,2,0
2020,485272,41,3,3,0,3
2020,485272,41,4,28,4,24
2020,485272,45,0,33,6,27
2020,485272,45,2,2,2,0
2020,485272,45,3,3,0,3
2020,485272,45,4,28,4,24
2020,485272,50,0,1,1,0
2020,485458,0,0,96,46,50
2020,485458,10,0,96,46,50
2020,485458,10,6,96,46,50
2020,485458,40,0,96,46,50
2020,485458,40,6,96,46,50
2020,485458,41,0,79,38,41
2020,485458,41,6,79,38,41
2020,485458,43,0,17,8,9
2020,485458,43,6,17,8,9
2020,485458,45,0,79,38,41
2020,485458,45,6,79,38,41
2020,485519,0,0,1,1,0
2020,485519,50,0,1,1,0
2020,485537,0,0,75,49,26
2020,485537,10,0,51,32,19
2020,485537,10,1,12,11,1
2020,485537,10,2,16,9,7
2020,485537,10,3,20,11,9
2020,485537,10,4,3,1,2
2020,485537,20,0,10,10,0
2020,485537,20,1,10,10,0
2020,485537,30,0,17,11,6
2020,485537,30,1,2,1,1
2020,485537,30,2,9,6,3
2020,485537,30,3,6,4,2
2020,485537,40,0,24,11,13
2020,485537,40,2,7,3,4
2020,485537,40,3,14,7,7
2020,485537,40,4,3,1,2
2020,485537,42,0,24,11,13
2020,485537,42,2,7,3,4
2020,485537,42,3,14,7,7
2020,485537,42,4,3,1,2
2020,485537,50,0,24,17,7
2020,485546,0,0,3,3,0
2020,485546,50,0,3,3,0
2020,485698,0,0,9,8,1
2020,485698,10,0,9,8,1
2020,485698,10,1,9,8,1
2020,485698,40,0,9,8,1
2020,485698,40,1,9,8,1
2020,485698,42,0,9,8,1
2020,485698,42,1,9,8,1
2020,485768,0,0,1,0,1
2020,485768,50,0,1,0,1
2020,485908,0,0,8,4,4
2020,485908,50,0,8,4,4
2020,485999,0,0,12,12,0
2020,485999,10,0,12,12,0
2020,485999,10,4,12,12,0
2020,485999,40,0,12,12,0
2020,485999,40,4,12,12,0
2020,485999,42,0,12,12,0
2020,485999,42,4,12,12,0
2020,486053,0,0,12,12,0
2020,486053,10,0,12,12,0
2020,486053,10,2,4,4,0
2020,486053,10,3,8,8,0
2020,486053,40,0,12,12,0
2020,486053,40,2,4,4,0
2020,486053,40,3,8,8,0
2020,486053,41,0,12,12,0
2020,486053,41,2,4,4,0
2020,486053,41,3,8,8,0
2020,486053,45,0,12,12,0
2020,486053,45,2,4,4,0
2020,486053,45,3,8,8,0
2020,486196,0,0,10,10,0
2020,486196,10,0,10,10,0
2020,486196,10,4,10,10,0
2020,486196,40,0,10,10,0
2020,486196,40,4,10,10,0
2020,486196,42,0,10,10,0
2020,486196,42,4,10,10,0
2020,486257,0,0,3,2,1
2020,486257,10,0,3,2,1
2020,486257,10,3,3,2,1
2020,486257,40,0,3,2,1
2020,486257,40,3,3,2,1
2020,486257,43,0,3,2,1
2020,486257,43,3,3,2,1
2020,486284,0,0,6,5,1
2020,486284,10,0,6,5,1
2020,486284,10,6,6,5,1
2020,486284,40,0,6,5,1
2020,486284,40,6,6,5,1
2020,486284,41,0,6,5,1
2020,486284,41,6,6,5,1
2020,486284,45,0,6,5,1
2020,486284,45,6,6,5,1
2020,486433,0,0,2,2,0
2020,486433,10,0,2,2,0
2020,486433,10,1,2,2,0
2020,486433,40,0,2,2,0
2020,486433,40,1,2,2,0
2020,486433,41,0,2,2,0
2020,486433,41,1,2,2,0
2020,486433,45,0,2,2,0
2020,486433,45,1,2,2,0
2020,486813,0,0,26,10,16
2020,486813,10,0,26,10,16
2020,486813,10,4,26,10,16
2020,486813,40,0,26,10,16
2020,486813,40,4,26,10,16
2020,486813,41,0,26,10,16
2020,486813,41,4,26,10,16
2020,486813,45,0,26,10,16
2020,486813,45,4,26,10,16
2020,486822,0,0,34,5,29
2020,486822,10,0,34,5,29
2020,486822,10,4,34,5,29
2020,486822,40,0,34,5,29
2020,486822,40,4,34,5,29
2020,486822,41,0,34,5,29
2020,486822,41,4,34,5,29
2020,486822,45,0,34,5,29
2020,486822,45,4,34,5,29
2020,486840,0,0,1246,646,600
2020,486840,10,0,1245,645,600
2020,486840,10,1,278,171,107
2020,486840,10,2,292,161,131
2020,486840,10,3,366,187,179
2020,486840,10,4,51,20,31
2020,486840,10,5,258,106,152
2020,486840,20,0,574,332,242
2020,486840,20,1,276,169,107
2020,486840,20,2,282,154,128
2020,486840,20,3,16,9,7
2020,486840,30,0,256,139,117
2020,486840,30,2,5,3,2
2020,486840,30,3,251,136,115
2020,486840,40,0,415,174,241
2020,486840,40,1,2,2,0
2020,486840,40,2,5,4,1
2020,486840,40,3,99,42,57
2020,486840,40,4,51,20,31
2020,486840,40,5,258,106,152
2020,486840,42,0,415,174,241
2020,486840,42,1,2,2,0
2020,486840,42,2,5,4,1
2020,486840,42,3,99,42,57
2020,486840,42,4,51,20,31
2020,486840,42,5,258,106,152
2020,486840,50,0,1,1,0
2020,486901,0,0,97,55,42
2020,486901,10,0,97,55,42
2020,486901,10,1,38,24,14
2020,486901,10,2,29,15,14
2020,486901,10,3,28,14,14
2020,486901,10,4,2,2,0
2020,486901,20,0,60,34,26
2020,486901,20,1,37,23,14
2020,486901,20,2,23,11,12
2020,486901,30,0,33,18,15
2020,486901,30,1,1,1,0
2020,486901,30,2,6,4,2
2020,486901,30,3,25,12,13
2020,486901,30,4,1,1,0
2020,486901,40,0,4,3,1
2020,486901,40,3,3,2,1
2020,486901,40,4,1,1,0
2020,486901,42,0,4,3,1
2020,486901,42,3,3,2,1
2020,486901,42,4,1,1,0
2020,486965,0,0,7,5,2
2020,486965,10,0,7,5,2
2020,486965,10,4,7,5,2
2020,486965,40,0,7,5,2
2020,486965,40,4,7,5,2
2020,486965,41,0,7,5,2
2020,486965,41,4,7,5,2
2020,486965,45,0,7,5,2
2020,486965,45,4,7,5,2
2020,487010,0,0,1349,775,574
2020,487010,10,0,1349,775,574
2020,487010,10,1,295,220,75
2020,487010,10,2,340,205,135
2020,487010,10,3,636,327,309
2020,487010,10,4,78,23,55
2020,487010,20,0,290,209,81
2020,487010,20,1,194,150,44
2020,487010,20,2,94,59,35
2020,487010,20,3,2,0,2
2020,487010,30,0,71,41,30
2020,487010,30,1,12,7,5
2020,487010,30,2,19,13,6
2020,487010,30,3,40,21,19
2020,487010,40,0,988,525,463
2020,487010,40,1,89,63,26
2020,487010,40,2,227,133,94
2020,487010,40,3,594,306,288
2020,487010,40,4,78,23,55
2020,487010,42,0,988,525,463
2020,487010,42,1,89,63,26
2020,487010,42,2,227,133,94
2020,487010,42,3,594,306,288
2020,487010,42,4,78,23,55
2020,487092,0,0,97,48,49
2020,487092,10,0,97,48,49
2020,487092,10,1,13,5,8
2020,487092,10,2,24,12,12
2020,487092,10,3,38,20,18
2020,487092,10,5,22,11,11
2020,487092,20,0,35,17,18
2020,487092,20,1,11,5,6
2020,487092,20,2,24,12,12
2020,487092,30,0,28,14,14
2020,487092,30,3,28,14,14
2020,487092,40,0,34,17,17
2020,487092,40,1,2,0,2
2020,487092,40,3,10,6,4
2020,487092,40,5,22,11,11
2020,487092,41,0,19,7,12
2020,487092,41,1,2,0,2
2020,487092,41,5,17,7,10
2020,487092,42,0,10,7,3
2020,487092,42,3,8,5,3
2020,487092,42,5,2,2,0
2020,487092,43,0,5,3,2
2020,487092,43,3,2,1,1
2020,487092,43,5,3,2,1
2020,487092,44,0,19,7,12
2020,487092,44,1,2,0,2
2020,487092,44,5,17,7,10
2020,487162,0,0,147,52,95
2020,487162,10,0,147,52,95
2020,487162,10,6,147,52,95
2020,487162,40,0,147,52,95
2020,487162,40,6,147,52,95
2020,487162,41,0,147,52,95
2020,487162,41,6,147,52,95
2020,487162,45,0,147,52,95
2020,487162,45,6,147,52,95
2020,487296,0,0,24,14,10
2020,487296,10,0,24,14,10
2020,487296,10,1,2,0,2
2020,487296,10,2,2,1,1
2020,487296,10,3,19,13,6
2020,487296,10,5,1,0,1
2020,487296,20,0,4,1,3
2020,487296,20,1,2,0,2
2020,487296,20,2,2,1,1
2020,487296,40,0,20,13,7
2020,487296,40,3,19,13,6
2020,487296,40,5,1,0,1
2020,487296,42,0,20,13,7
2020,487296,42,3,19,13,6
2020,487296,42,5,1,0,1
2020,487302,0,0,9,2,7
2020,487302,10,0,9,2,7
2020,487302,10,4,9,2,7
2020,487302,40,0,9,2,7
2020,487302,40,4,9,2,7
2020,487302,41,0,9,2,7
2020,487302,41,4,9,2,7
2020,487302,45,0,9,2,7
2020,487302,45,4,9,2,7
2020,487311,0,0,23,22,1
2020,487311,50,0,23,22,1
2020,487320,0,0,541,399,142
2020,487320,10,0,541,399,142
2020,487320,10,1,4,3,1
2020,487320,10,2,30,15,15
2020,487320,10,4,507,381,126
2020,487320,40,0,541,399,142
2020,487320,40,1,4,3,1
2020,487320,40,2,30,15,15
2020,487320,40,4,507,381,126
2020,487320,42,0,514,387,127
2020,487320,42,1,4,3,1
2020,487320,42,2,28,14,14
2020,487320,42,4,482,370,112
2020,487320,43,0,27,12,15
2020,487320,43,2,2,1,1
2020,487320,43,4,25,11,14
2020,487375,0,0,17,3,14
2020,487375,10,0,15,3,12
2020,487375,10,6,15,3,12
2020,487375,40,0,15,3,12
2020,487375,40,6,15,3,12
2020,487375,41,0,15,3,12
2020,487375,41,6,15,3,12
2020,487375,45,0,15,3,12
2020,487375,45,6,15,3,12
2020,487375,50,0,2,0,2
2020,487384,0,0,3,1,2
2020,487384,50,0,3,1,2
2020,487393,0,0,14,5,9
2020,487393,50,0,14,5,9
2020,487409,0,0,8,5,3
2020,487409,50,0,8,5,3
2020,487418,0,0,7,5,2
2020,487418,50,0,7,5,2
2020,487427,0,0,16,7,9
2020,487427,50,0,16,7,9
2020,487436,0,0,7,3,4
2020,487436,50,0,7,3,4
2020,487445,0,0,7,2,5
2020,487445,50,0,7,2,5
2020,487454,0,0,2,0,2
2020,487454,50,0,2,0,2
2020,487472,0,0,21,10,11
2020,487472,50,0,21,10,11
2020,487490,0,0,17,6,11
2020,487490,50,0,17,6,11
2020,487524,0,0,139,71,68
2020,487524,10,0,139,71,68
2020,487524,10,1,16,9,7
2020,487524,10,2,38,21,17
2020,487524,10,3,53,23,30
2020,487524,10,4,32,18,14
2020,487524,40,0,139,71,68
2020,487524,40,1,16,9,7
2020,487524,40,2,38,21,17
2020,487524,40,3,53,23,30
2020,487524,40,4,32,18,14
2020,487524,41,0,56,32,24
2020,487524,41,1,15,9,6
2020,487524,41,2,27,15,12
2020,487524,41,3,11,7,4
2020,487524,41,4,3,1,2
2020,487524,42,0,83,39,44
2020,487524,42,1,1,0,1
2020,487524,42,2,11,6,5
2020,487524,42,3,42,16,26
2020,487524,42,4,29,17,12
2020,487524,44,0,56,32,24
2020,487524,44,1,15,9,6
2020,487524,44,2,27,15,12
2020,487524,44,3,11,7,4
2020,487524,44,4,3,1,2
2020,487588,0,0,6,0,6
2020,487588,10,0,6,0,6
2020,487588,10,4,6,0,6
2020,487588,40,0,6,0,6
2020,487588,40,4,6,0,6
2020,487588,41,0,6,0,6
2020,487588,41,4,6,0,6
2020,487588,45,0,6,0,6
2020,487588,45,4,6,0,6
2020,487597,0,0,25,24,1
2020,487597,50,0,25,24,1
2020,487649,0,0,5,4,1
2020,487649,10,0,3,3,0
2020,487649,10,1,3,3,0
2020,487649,40,0,3,3,0
2020,487649,40,1,3,3,0
2020,487649,41,0,3,3,0
2020,487649,41,1,3,3,0
2020,487649,45,0,3,3,0
2020,487649,45,1,3,3,0
2020,487649,50,0,2,1,1
2020,487861,0,0,9,1,8
2020,487861,10,0,9,1,8
2020,487861,10,4,9,1,8
2020,487861,40,0,9,1,8
2020,487861,40,4,9,1,8
2020,487861,41,0,9,1,8
2020,487861,41,4,9,1,8
2020,487861,45,0,9,1,8
2020,487861,45,4,9,1,8
2020,487977,0,0,20,2,18
2020,487977,10,0,20,2,18
2020,487977,10,4,20,2,18
2020,487977,40,0,20,2,18
2020,487977,40,4,20,2,18
2020,487977,41,0,20,2,18
2020,487977,41,4,20,2,18
2020,487977,45,0,20,2,18
2020,487977,45,4,20,2,18
2020,488077,0,0,34,29,5
2020,488077,10,0,34,29,5
2020,488077,10,6,34,29,5
2020,488077,40,0,34,29,5
2020,488077,40,6,34,29,5
2020,488077,41,0,34,29,5
2020,488077,41,6,34,29,5
2020,488077,45,0,34,29,5
2020,488077,45,6,34,29,5
2020,488305,0,0,4,3,1
2020,488305,10,0,4,3,1
2020,488305,10,4,4,3,1
2020,488305,40,0,4,3,1
2020,488305,40,4,4,3,1
2020,488305,41,0,4,3,1
2020,488305,41,4,4,3,1
2020,488305,45,0,4,3,1
2020,488305,45,4,4,3,1
2020,488527,0,0,38,23,15
2020,488527,10,0,38,23,15
2020,488527,10,1,5,5,0
2020,488527,10,2,11,8,3
2020,488527,10,3,20,9,11
2020,488527,10,4,2,1,1
2020,488527,40,0,38,23,15
2020,488527,40,1,5,5,0
2020,488527,40,2,11,8,3
2020,488527,40,3,20,9,11
2020,488527,40,4,2,1,1
2020,488527,42,0,38,23,15
2020,488527,42,1,5,5,0
2020,488527,42,2,11,8,3
2020,488527,42,3,20,9,11
2020,488527,42,4,2,1,1
2020,488554,0,0,21,12,9
2020,488554,10,0,21,12,9
2020,488554,10,1,5,3,2
2020,488554,10,2,11,6,5
2020,488554,10,3,3,2,1
2020,488554,10,4,2,1,1
2020,488554,40,0,21,12,9
2020,488554,40,1,5,3,2
2020,488554,40,2,11,6,5
2020,488554,40,3,3,2,1
2020,488554,40,4,2,1,1
2020,488554,41,0,21,12,9
2020,488554,41,1,5,3,2
2020,488554,41,2,11,6,5
2020,488554,41,3,3,2,1
2020,488554,41,4,2,1,1
2020,488554,44,0,21,12,9
2020,488554,44,1,5,3,2
2020,488554,44,2,11,6,5
2020,488554,44,3,3,2,1
2020,488554,44,4,2,1,1
2020,488572,0,0,43,25,18
2020,488572,10,0,43,25,18
2020,488572,10,1,5,4,1
2020,488572,10,2,14,10,4
2020,488572,10,3,24,11,13
2020,488572,40,0,43,25,18
2020,488572,40,1,5,4,1
2020,488572,40,2,14,10,4
2020,488572,40,3,24,11,13
2020,488572,41,0,5,4,1
2020,488572,41,1,1,1,0
2020,488572,41,2,3,3,0
2020,488572,41,3,1,0,1
2020,488572,42,0,38,21,17
2020,488572,42,1,4,3,1
2020,488572,42,2,11,7,4
2020,488572,42,3,23,11,12
2020,488572,44,0,5,4,1
2020,488572,44,1,1,1,0
2020,488572,44,2,3,3,0
2020,488572,44,3,1,0,1
2020,488730,0,0,77,30,47
2020,488730,10,0,75,29,46
2020,488730,10,1,16,9,7
2020,488730,10,2,20,4,16
2020,488730,10,3,18,8,10
2020,488730,10,4,21,8,13
2020,488730,20,0,48,20,28
2020,488730,20,1,16,9,7
2020,488730,20,2,17,4,13
2020,488730,20,3,8,4,4
2020,488730,20,4,7,3,4
2020,488730,40,0,27,9,18
2020,488730,40,2,3,0,3
2020,488730,40,3,10,4,6
2020,488730,40,4,14,5,9
2020,488730,42,0,27,9,18
2020,488730,42,2,3,0,3
2020,488730,42,3,10,4,6
2020,488730,42,4,14,5,9
2020,488730,50,0,2,1,1
2020,488785,0,0,7,4,3
2020,488785,10,0,7,4,3
2020,488785,10,3,6,3,3
2020,488785,10,5,1,1,0
2020,488785,40,0,7,4,3
2020,488785,40,3,6,3,3
2020,488785,40,5,1,1,0
2020,488785,41,0,7,4,3
2020,488785,41,3,6,3,3
2020,488785,41,5,1,1,0
2020,488785,44,0,7,4,3
2020,488785,44,3,6,3,3
2020,488785,44,5,1,1,0
2020,488800,0,0,12,0,12
2020,488800,10,0,12,0,12
2020,488800,10,4,12,0,12
2020,488800,40,0,12,0,12
2020,488800,40,4,12,0,12
2020,488800,42,0,12,0,12
2020,488800,42,4,12,0,12
2020,489201,0,0,101,45,56
2020,489201,10,0,101,45,56
2020,489201,10,4,101,45,56
2020,489201,20,0,64,32,32
2020,489201,20,4,64,32,32
2020,489201,30,0,30,11,19
2020,489201,30,4,30,11,19
2020,489201,40,0,7,2,5
2020,489201,40,4,7,2,5
2020,489201,42,0,7,2,5
2020,489201,42,4,7,2,5
2020,489283,0,0,21,8,13
2020,489283,10,0,21,8,13
2020,489283,10,4,21,8,13
2020,489283,40,0,21,8,13
2020,489283,40,4,21,8,13
2020,489283,41,0,21,8,13
2020,489283,41,4,21,8,13
2020,489283,45,0,21,8,13
2020,489283,45,4,21,8,13
2020,489779,0,0,335,114,221
2020,489779,10,0,335,114,221
2020,489779,10,6,335,114,221
2020,489779,40,0,335,114,221
2020,489779,40,6,335,114,221
2020,489779,41,0,335,114,221
2020,489779,41,6,335,114,221
2020,489779,45,0,335,114,221
2020,489779,45,6,335,114,221
2020,489858,0,0,35,13,22
2020,489858,10,0,34,13,21
2020,489858,10,1,2,1,1
2020,489858,10,2,8,2,6
2020,489858,10,3,24,10,14
2020,489858,40,0,34,13,21
2020,489858,40,1,2,1,1
2020,489858,40,2,8,2,6
2020,489858,40,3,24,10,14
2020,489858,41,0,34,13,21
2020,489858,41,1,2,1,1
2020,489858,41,2,8,2,6
2020,489858,41,3,24,10,14
2020,489858,45,0,34,13,21
2020,489858,45,1,2,1,1
2020,489858,45,2,8,2,6
2020,489858,45,3,24,10,14
2020,489858,50,0,1,0,1
2020,489937,0,0,29,13,16
2020,489937,10,0,29,13,16
2020,489937,10,1,20,11,9
2020,489937,10,3,8,2,6
2020,489937,10,5,1,0,1
2020,489937,40,0,29,13,16
2020,489937,40,1,20,11,9
2020,489937,40,3,8,2,6
2020,489937,40,5,1,0,1
2020,489937,42,0,29,13,16
2020,489937,42,1,20,11,9
2020,489937,42,3,8,2,6
2020,489937,42,5,1,0,1
2020,490054,0,0,19,1,18
2020,490054,10,0,19,1,18
2020,490054,10,4,19,1,18
2020,490054,40,0,19,1,18
2020,490054,40,4,19,1,18
2020,490054,41,0,19,1,18
2020,490054,41,4,19,1,18
2020,490054,45,0,19,1,18
2020,490054,45,4,19,1,18
2020,490106,0,0,2,1,1
2020,490106,10,0,2,1,1
2020,490106,10,1,2,1,1
2020,490106,40,0,2,1,1
2020,490106,40,1,2,1,1
2020,490106,41,0,2,1,1
2020,490106,41,1,2,1,1
2020,490106,45,0,2,1,1
2020,490106,45,1,2,1,1
2020,490133,0,0,48,26,22
2020,490133,10,0,48,26,22
2020,490133,10,1,16,10,6
2020,490133,10,3,32,16,16
2020,490133,20,0,9,5,4
2020,490133,20,1,9,5,4
2020,490133,30,0,1,1,0
2020,490133,30,1,1,1,0
2020,490133,40,0,38,20,18
2020,490133,40,1,6,4,2
2020,490133,40,3,32,16,16
2020,490133,41,0,38,20,18
2020,490133,41,1,6,4,2
2020,490133,41,3,32,16,16
2020,490133,44,0,1,0,1
2020,490133,44,3,1,0,1
2020,490133,45,0,37,20,17
2020,490133,45,1,6,4,2
2020,490133,45,3,31,16,15
2020,490203,0,0,8,1,7
2020,490203,10,0,8,1,7
2020,490203,10,4,8,1,7
2020,490203,40,0,8,1,7
2020,490203,40,4,8,1,7
2020,490203,41,0,8,1,7
2020,490203,41,4,8,1,7
2020,490203,44,0,8,1,7
2020,490203,44,4,8,1,7
2020,490276,0,0,13,13,0
2020,490276,10,0,13,13,0
2020,490276,10,4,13,13,0
2020,490276,40,0,13,13,0
2020,490276,40,4,13,13,0
2020,490276,42,0,13,13,0
2020,490276,42,4,13,13,0
2020,490285,0,0,2,2,0
2020,490285,10,0,2,2,0
2020,490285,10,4,2,2,0
2020,490285,40,0,2,2,0
2020,490285,40,4,2,2,0
2020,490285,41,0,2,2,0
2020,490285,41,4,2,2,0
2020,490285,45,0,2,2,0
2020,490285,45,4,2,2,0
2020,490373,0,0,124,65,59
2020,490373,10,0,124,65,59
2020,490373,10,1,25,20,5
2020,490373,10,2,24,10,14
2020,490373,10,3,75,35,40
2020,490373,40,0,124,65,59
2020,490373,40,1,25,20,5
2020,490373,40,2,24,10,14
2020,490373,40,3,75,35,40
2020,490373,41,0,124,65,59
2020,490373,41,1,25,20,5
2020,490373,41,2,24,10,14
2020,490373,41,3,75,35,40
2020,490373,45,0,124,65,59
2020,490373,45,1,25,20,5
2020,490373,45,2,24,10,14
2020,490373,45,3,75,35,40
2020,490559,0,0,25,6,19
2020,490559,50,0,25,6,19
2020,490805,0,0,267,148,119
2020,490805,10,0,239,142,97
2020,490805,10,1,79,53,26
2020,490805,10,2,92,53,39
2020,490805,10,3,55,29,26
2020,490805,10,4,13,7,6
2020,490805,20,0,165,101,64
2020,490805,20,1,79,53,26
2020,490805,20,2,86,48,38
2020,490805,30,0,58,32,26
2020,490805,30,2,6,5,1
2020,490805,30,3,52,27,25
2020,490805,40,0,16,9,7
2020,490805,40,3,3,2,1
2020,490805,40,4,13,7,6
2020,490805,42,0,12,6,6
2020,490805,42,3,3,2,1
2020,490805,42,4,9,4,5
2020,490805,43,0,4,3,1
2020,490805,43,4,4,3,1
2020,490805,50,0,28,6,22
2020,490878,0,0,10,3,7
2020,490878,10,0,10,3,7
2020,490878,10,4,10,3,7
2020,490878,40,0,10,3,7
2020,490878,40,4,10,3,7
2020,490878,41,0,10,3,7
2020,490878,41,4,10,3,7
2020,490878,45,0,10,3,7
2020,490878,45,4,10,3,7
2020,490975,0,0,3,0,3
2020,490975,10,0,3,0,3
2020,490975,10,4,3,0,3
2020,490975,40,0,3,0,3
2020,490975,40,4,3,0,3
2020,490975,41,0,3,0,3
2020,490975,41,4,3,0,3
2020,490975,45,0,3,0,3
2020,490975,45,4,3,0,3
2020,491057,0,0,9,9,0
2020,491057,10,0,9,9,0
2020,491057,10,4,9,9,0
2020,491057,40,0,9,9,0
2020,491057,40,4,9,9,0
2020,491057,42,0,9,9,0
2020,491057,42,4,9,9,0
2020,491181,0,0,14,1,13
2020,491181,10,0,14,1,13
2020,491181,10,4,14,1,13
2020,491181,40,0,14,1,13
2020,491181,40,4,14,1,13
2020,491181,41,0,14,1,13
2020,491181,41,4,14,1,13
2020,491181,45,0,14,1,13
2020,491181,45,4,14,1,13
2020,491525,0,0,6,4,2
2020,491525,10,0,6,4,2
2020,491525,10,1,6,4,2
2020,491525,40,0,6,4,2
2020,491525,40,1,6,4,2
2020,491525,41,0,6,4,2
2020,491525,41,1,6,4,2
2020,491525,44,0,6,4,2
2020,491525,44,1,6,4,2
2020,491808,0,0,4,2,2
2020,491808,10,0,4,2,2
2020,491808,10,1,4,2,2
2020,491808,40,0,4,2,2
2020,491808,40,1,4,2,2
2020,491808,41,0,4,2,2
2020,491808,41,1,4,2,2
2020,491808,45,0,4,2,2
2020,491808,45,1,4,2,2
2020,491844,0,0,7,4,3
2020,491844,10,0,7,4,3
2020,491844,10,4,7,4,3
2020,491844,40,0,7,4,3
2020,491844,40,4,7,4,3
2020,491844,41,0,1,0,1
2020,491844,41,4,1,0,1
2020,491844,42,0,6,4,2
2020,491844,42,4,6,4,2
2020,491844,44,0,1,0,1
2020,491844,44,4,1,0,1
2020,491941,0,0,8,0,8
2020,491941,50,0,8,0,8
2020,492449,0,0,23,5,18
2020,492449,10,0,23,5,18
2020,492449,10,4,23,5,18
2020,492449,40,0,23,5,18
2020,492449,40,4,23,5,18
2020,492449,41,0,23,5,18
2020,492449,41,4,23,5,18
2020,492449,45,0,23,5,18
2020,492449,45,4,23,5,18
2020,492476,0,0,1,0,1
2020,492476,10,0,1,0,1
2020,492476,10,4,1,0,1
2020,492476,40,0,1,0,1
2020,492476,40,4,1,0,1
2020,492476,42,0,1,0,1
2020,492476,42,4,1,0,1
2020,492689,0,0,286,152,134
2020,492689,10,0,284,152,132
2020,492689,10,1,33,24,9
2020,492689,10,2,53,34,19
2020,492689,10,3,167,85,82
2020,492689,10,4,13,3,10
2020,492689,10,5,18,6,12
2020,492689,20,0,27,22,5
2020,492689,20,1,20,17,3
2020,492689,20,2,7,5,2
2020,492689,30,0,14,5,9
2020,492689,30,1,2,2,0
2020,492689,30,2,3,1,2
2020,492689,30,3,9,2,7
2020,492689,40,0,243,125,118
2020,492689,40,1,11,5,6
2020,492689,40,2,43,28,15
2020,492689,40,3,158,83,75
2020,492689,40,4,13,3,10
2020,492689,40,5,18,6,12
2020,492689,42,0,243,125,118
2020,492689,42,1,11,5,6
2020,492689,42,2,43,28,15
2020,492689,42,3,158,83,75
2020,492689,42,4,13,3,10
2020,492689,42,5,18,6,12
2020,492689,50,0,2,0,2
2020,492722,0,0,12,3,9
2020,492722,10,0,12,3,9
2020,492722,10,4,12,3,9
2020,492722,40,0,12,3,9
2020,492722,40,4,12,3,9
2020,492722,41,0,12,3,9
2020,492722,41,4,12,3,9
2020,492722,45,0,12,3,9
2020,492722,45,4,12,3,9
2020,492801,0,0,8,2,6
2020,492801,10,0,8,2,6
2020,492801,10,1,2,1,1
2020,492801,10,2,2,1,1
2020,492801,10,4,4,0,4
2020,492801,20,0,4,2,2
2020,492801,20,1,2,1,1
2020,492801,20,2,2,1,1
2020,492801,40,0,4,0,4
2020,492801,40,4,4,0,4
2020,492801,41,0,1,0,1
2020,492801,41,4,1,0,1
2020,492801,42,0,3,0,3
2020,492801,42,4,3,0,3
2020,492801,45,0,1,0,1
2020,492801,45,4,1,0,1
2020,493600,0,0,19,19,0
2020,493600,10,0,19,19,0
2020,493600,10,4,19,19,0
2020,493600,40,0,19,19,0
2020,493600,40,4,19,19,0
2020,493600,42,0,19,19,0
2020,493600,42,4,19,19,0
2020,493646,0,0,17,0,17
2020,493646,10,0,17,0,17
2020,493646,10,4,17,0,17
2020,493646,40,0,17,0,17
2020,493646,40,4,17,0,17
2020,493646,42,0,17,0,17
2020,493646,42,4,17,0,17
2020,493947,0,0,32,19,13
2020,493947,10,0,32,19,13
2020,493947,10,1,1,1,0
2020,493947,10,2,11,9,2
2020,493947,10,3,19,9,10
2020,493947,10,4,1,0,1
2020,493947,40,0,32,19,13
2020,493947,40,1,1,1,0
2020,493947,40,2,11,9,2
2020,493947,40,3,19,9,10
2020,493947,40,4,1,0,1
2020,493947,41,0,32,19,13
2020,493947,41,1,1,1,0
2020,493947,41,2,11,9,2
2020,493947,41,3,19,9,10
2020,493947,41,4,1,0,1
2020,493947,44,0,32,19,13
2020,493947,44,1,1,1,0
2020,493947,44,2,11,9,2
2020,493947,44,3,19,9,10
2020,493947,44,4,1,0,1
2020,494010,0,0,11,6,5
2020,494010,10,0,11,6,5
2020,494010,10,1,1,1,0
2020,494010,10,2,4,1,3
2020,494010,10,3,6,4,2
2020,494010,40,0,11,6,5
2020,494010,40,1,1,1,0
2020,494010,40,2,4,1,3
2020,494010,40,3,6,4,2
2020,494010,41,0,11,6,5
2020,494010,41,1,1,1,0
2020,494010,41,2,4,1,3
2020,494010,41,3,6,4,2
2020,494010,45,0,11,6,5
2020,494010,45,1,1,1,0
2020,494010,45,2,4,1,3
2020,494010,45,3,6,4,2
2020,494162,0,0,2,0,2
2020,494162,10,0,2,0,2
2020,494162,10,6,2,0,2
2020,494162,40,0,2,0,2
2020,494162,40,6,2,0,2
2020,494162,41,0,2,0,2
2020,494162,41,6,2,0,2
2020,494162,45,0,2,0,2
2020,494162,45,6,2,0,2
2020,494171,0,0,11,2,9
2020,494171,10,0,11,2,9
2020,494171,10,6,11,2,9
2020,494171,40,0,11,2,9
2020,494171,40,6,11,2,9
2020,494171,41,0,11,2,9
2020,494171,41,6,11,2,9
2020,494171,45,0,11,2,9
2020,494171,45,6,11,2,9
2020,494250,0,0,14,5,9
2020,494250,50,0,14,5,9
2020,494278,0,0,2,1,1
2020,494278,10,0,2,1,1
2020,494278,10,4,2,1,1
2020,494278,40,0,2,1,1
2020,494278,40,4,2,1,1
2020,494278,42,0,2,1,1
2020,494278,42,4,2,1,1
2020,494287,0,0,6,0,6
2020,494287,10,0,6,0,6
2020,494287,10,4,6,0,6
2020,494287,40,0,6,0,6
2020,494287,40,4,6,0,6
2020,494287,42,0,6,0,6
2020,494287,42,4,6,0,6
2020,494436,0,0,13,2,11
2020,494436,10,0,13,2,11
2020,494436,10,4,13,2,11
2020,494436,40,0,13,2,11
2020,494436,40,4,13,2,11
2020,494436,41,0,13,2,11
2020,494436,41,4,13,2,11
2020,494436,45,0,13,2,11
2020,494436,45,4,13,2,11
2020,494588,0,0,11,4,7
2020,494588,10,0,11,4,7
2020,494588,10,4,11,4,7
2020,494588,40,0,11,4,7
2020,494588,40,4,11,4,7
2020,494588,41,0,11,4,7
2020,494588,41,4,11,4,7
2020,494588,45,0,11,4,7
2020,494588,45,4,11,4,7
2020,494737,0,0,19,19,0
2020,494737,10,0,19,19,0
2020,494737,10,4,19,19,0
2020,494737,40,0,19,19,0
2020,494737,40,4,19,19,0
2020,494737,42,0,19,19,0
2020,494737,42,4,19,19,0
2020,494746,0,0,8,2,6
2020,494746,10,0,8,2,6
2020,494746,10,4,8,2,6
2020,494746,40,0,8,2,6
2020,494746,40,4,8,2,6
2020,494746,41,0,8,2,6
2020,494746,41,4,8,2,6
2020,494746,45,0,8,2,6
2020,494746,45,4,8,2,6
2020,494843,0,0,16,2,14
2020,494843,10,0,16,2,14
2020,494843,10,4,16,2,14
2020,494843,40,0,16,2,14
2020,494843,40,4,16,2,14
2020,494843,41,0,16,2,14
2020,494843,41,4,16,2,14
2020,494843,45,0,16,2,14
2020,494843,45,4,16,2,14
2020,494852,0,0,28,10,18
2020,494852,10,0,28,10,18
2020,494852,10,6,28,10,18
2020,494852,40,0,28,10,18
2020,494852,40,6,28,10,18
2020,494852,41,0,28,10,18
2020,494852,41,6,28,10,18
2020,494852,45,0,28,10,18
2020,494852,45,6,28,10,18
2020,494959,0,0,4,3,1
2020,494959,10,0,4,3,1
2020,494959,10,4,4,3,1
2020,494959,40,0,4,3,1
2020,494959,40,4,4,3,1
2020,494959,41,0,4,3,1
2020,494959,41,4,4,3,1
2020,494959,45,0,4,3,1
2020,494959,45,4,4,3,1
2020,495192,0,0,5,1,4
2020,495192,10,0,5,1,4
2020,495192,10,6,5,1,4
2020,495192,40,0,5,1,4
2020,495192,40,6,5,1,4
2020,495192,41,0,5,1,4
2020,495192,41,6,5,1,4
2020,495192,45,0,5,1,4
2020,495192,45,6,5,1,4
2020,495314,0,0,10,5,5
2020,495314,10,0,10,5,5
2020,495314,10,1,5,3,2
2020,495314,10,2,2,1,1
2020,495314,10,3,3,1,2
2020,495314,40,0,10,5,5
2020,495314,40,1,5,3,2
2020,495314,40,2,2,1,1
2020,495314,40,3,3,1,2
2020,495314,41,0,10,5,5
2020,495314,41,1,5,3,2
2020,495314,41,2,2,1,1
2020,495314,41,3,3,1,2
2020,495314,44,0,10,5,5
2020,495314,44,1,5,3,2
2020,495314,44,2,2,1,1
2020,495314,44,3,3,1,2
2020,495448,0,0,3,1,2
2020,495448,10,0,3,1,2
2020,495448,10,6,3,1,2
2020,495448,40,0,3,1,2
2020,495448,40,6,3,1,2
2020,495448,41,0,3,1,2
2020,495448,41,6,3,1,2
2020,495448,45,0,3,1,2
2020,495448,45,6,3,1,2
2020,495767,0,0,5929,3349,2580
2020,495767,10,0,5858,3303,2555
2020,495767,10,1,1501,1076,425
2020,495767,10,2,1601,901,700
2020,495767,10,3,2178,1069,1109
2020,495767,10,4,199,72,127
2020,495767,10,5,372,178,194
2020,495767,10,6,7,7,0
2020,495767,20,0,2161,1454,707
2020,495767,20,1,1200,878,322
2020,495767,20,2,949,566,383
2020,495767,20,3,12,10,2
2020,495767,30,0,909,493,416
2020,495767,30,1,11,8,3
2020,495767,30,2,60,38,22
2020,495767,30,3,838,447,391
2020,495767,40,0,2788,1356,1432
2020,495767,40,1,290,190,100
2020,495767,40,2,592,297,295
2020,495767,40,3,1328,612,716
2020,495767,40,4,199,72,127
2020,495767,40,5,372,178,194
2020,495767,40,6,7,7,0
2020,495767,41,0,1158,544,614
2020,495767,41,1,141,83,58
2020,495767,41,2,325,146,179
2020,495767,41,3,459,204,255
2020,495767,41,4,46,18,28
2020,495767,41,5,186,92,94
2020,495767,41,6,1,1,0
2020,495767,42,0,1627,812,815
2020,495767,42,1,149,107,42
2020,495767,42,2,267,151,116
2020,495767,42,3,869,408,461
2020,495767,42,4,151,54,97
2020,495767,42,5,185,86,99
2020,495767,42,6,6,6,0
2020,495767,43,0,3,0,3
2020,495767,43,4,2,0,2
2020,495767,43,5,1,0,1
2020,495767,44,0,1087,498,589
2020,495767,44,1,125,73,52
2020,495767,44,2,311,135,176
2020,495767,44,3,425,184,241
2020,495767,44,4,43,17,26
2020,495767,44,5,183,89,94
2020,495767,45,0,71,46,25
2020,495767,45,1,16,10,6
2020,495767,45,2,14,11,3
2020,495767,45,3,34,20,14
2020,495767,45,4,3,1,2
2020,495767,45,5,3,3,0
2020,495767,45,6,1,1,0
2020,495767,50,0,71,46,25
2020,496043,0,0,42,25,17
2020,496043,10,0,42,25,17
2020,496043,10,1,18,15,3
2020,496043,10,2,9,5,4
2020,496043,10,3,14,5,9
2020,496043,10,4,1,0,1
2020,496043,40,0,42,25,17
2020,496043,40,1,18,15,3
2020,496043,40,2,9,5,4
2020,496043,40,3,14,5,9
2020,496043,40,4,1,0,1
2020,496043,41,0,41,24,17
2020,496043,41,1,18,15,3
2020,496043,41,2,9,5,4
2020,496043,41,3,13,4,9
2020,496043,41,4,1,0,1
2020,496043,42,0,1,1,0
2020,496043,42,3,1,1,0
2020,496043,44,0,40,24,16
2020,496043,44,1,18,15,3
2020,496043,44,2,9,5,4
2020,496043,44,3,13,4,9
2020,496043,45,0,1,0,1
2020,496043,45,4,1,0,1
2020,496326,0,0,3,1,2
2020,496326,50,0,3,1,2
