Year,UNITID,FACSTAT,ARANK,HRTOTLT,HRTOTLM,HRTOTLW
2019,100654,0,0,242,131,111
2019,100654,10,0,242,131,111
2019,100654,10,1,49,37,12
2019,100654,10,2,50,34,16
2019,100654,10,3,98,46,52
2019,100654,10,4,38,11,27
2019,100654,10,5,7,3,4
2019,100654,20,0,99,68,31
2019,100654,20,1,49,37,12
2019,100654,20,2,32,22,10
2019,100654,20,3,18,9,9
2019,100654,30,0,39,16,23
2019,100654,30,2,9,5,4
2019,100654,30,3,30,11,19
2019,100654,40,0,104,47,57
2019,100654,40,2,9,7,2
2019,100654,40,3,50,26,24
2019,100654,40,4,38,11,27
2019,100654,40,5,7,3,4
2019,100654,42,0,104,47,57
2019,100654,42,2,9,7,2
2019,100654,42,3,50,26,24
2019,100654,42,4,38,11,27
2019,100654,42,5,7,3,4
2019,100663,0,0,2523,1441,1082
2019,100663,10,0,2523,1441,1082
2019,100663,10,1,735,507,228
2019,100663,10,2,677,411,266
2019,100663,10,3,893,439,454
2019,100663,10,4,218,84,134
2019,100663,20,0,900,619,281
2019,100663,20,1,604,430,174
2019,100663,20,2,295,189,106
2019,100663,20,3,1,0,1
2019,100663,30,0,515,278,237
2019,100663,30,1,9,6,3
2019,100663,30,2,109,67,42
2019,100663,30,3,397,205,192
2019,100663,40,0,1108,544,564
2019,100663,40,1,122,71,51
2019,100663,40,2,273,155,118
2019,100663,40,3,495,234,261
2019,100663,40,4,218,84,134
2019,100663,42,0,1108,544,564
2019,100663,42,1,122,71,51
2019,100663,42,2,273,155,118
2019,100663,42,3,495,234,261
2019,100663,42,4,218,84,134
2019,100690,0,0,30,24,6
2019,100690,10,0,30,24,6
2019,100690,10,1,13,10,3
2019,100690,10,2,10,9,1
2019,100690,10,3,5,4,1
2019,100690,10,4,2,1,1
2019,100690,40,0,30,24,6
2019,100690,40,1,13,10,3
2019,100690,40,2,10,9,1
2019,100690,40,3,5,4,1
2019,100690,40,4,2,1,1
2019,100690,42,0,24,18,6
2019,100690,42,1,11,8,3
2019,100690,42,2,9,8,1
2019,100690,42,3,3,2,1
2019,100690,42,4,1,0,1
2019,100690,43,0,6,6,0
2019,100690,43,1,2,2,0
2019,100690,43,2,1,1,0
2019,100690,43,3,2,2,0
2019,100690,43,4,1,1,0
2019,100706,0,0,363,196,167
2019,100706,10,0,363,196,167
2019,100706,10,1,75,60,15
2019,100706,10,2,101,70,31
2019,100706,10,3,97,40,57
2019,100706,10,4,16,1,15
2019,100706,10,5,74,25,49
2019,100706,20,0,164,125,39
2019,100706,20,1,74,60,14
2019,100706,20,2,89,65,24
2019,100706,20,3,1,0,1
2019,100706,30,0,72,39,33
2019,100706,30,2,6,4,2
2019,100706,30,3,66,35,31
2019,100706,40,0,127,32,95
2019,100706,40,1,1,0,1
2019,100706,40,2,6,1,5
2019,100706,40,3,30,5,25
2019,100706,40,4,16,1,15
2019,100706,40,5,74,25,49
2019,100706,41,0,123,31,92
2019,100706,41,1,1,0,1
2019,100706,41,2,6,1,5
2019,100706,41,3,30,5,25
2019,100706,41,4,14,1,13
2019,100706,41,5,72,24,48
2019,100706,42,0,4,1,3
2019,100706,42,4,2,0,2
2019,100706,42,5,2,1,1
2019,100706,44,0,123,31,92
2019,100706,44,1,1,0,1
2019,100706,44,2,6,1,5
2019,100706,44,3,30,5,25
2019,100706,44,4,14,1,13
2019,100706,44,5,72,24,48
2019,100724,0,0,226,114,112
2019,100724,10,0,222,114,108
2019,100724,10,1,56,30,26
2019,100724,10,2,63,35,28
2019,100724,10,3,67,35,32
2019,100724,10,4,36,14,22
2019,100724,20,0,105,56,49
2019,100724,20,1,56,30,26
2019,100724,20,2,46,25,21
2019,100724,20,3,3,1,2
2019,100724,30,0,66,38,28
2019,100724,30,2,15,9,6
2019,100724,30,3,51,29,22
2019,100724,40,0,51,20,31
2019,100724,40,2,2,1,1
2019,100724,40,3,13,5,8
2019,100724,40,4,36,14,22
2019,100724,42,0,51,20,31
2019,100724,42,2,2,1,1
2019,100724,42,3,13,5,8
2019,100724,42,4,36,14,22
2019,100724,50,0,4,0,4
2019,100751,0,0,1528,834,694
2019,100751,10,0,1528,834,694
2019,100751,10,1,319,231,88
2019,100751,10,2,363,202,161
2019,100751,10,3,502,253,249
2019,100751,10,4,328,136,192
2019,100751,10,5,16,12,4
2019,100751,20,0,597,393,204
2019,100751,20,1,287,214,73
2019,100751,20,2,305,177,128
2019,100751,20,3,5,2,3
2019,100751,30,0,408,231,177
2019,100751,30,1,20,11,9
2019,100751,30,2,19,13,6
2019,100751,30,3,369,207,162
2019,100751,40,0,523,210,313
2019,100751,40,1,12,6,6
2019,100751,40,2,39,12,27
2019,100751,40,3,128,44,84
2019,100751,40,4,328,136,192
2019,100751,40,5,16,12,4
2019,100751,42,0,521,210,311
2019,100751,42,1,12,6,6
2019,100751,42,2,39,12,27
2019,100751,42,3,127,44,83
2019,100751,42,4,327,136,191
2019,100751,42,5,16,12,4
2019,100751,43,0,2,0,2
2019,100751,43,3,1,0,1
2019,100751,43,4,1,0,1
2019,100760,0,0,47,24,23
2019,100760,10,0,43,23,20
2019,100760,10,6,43,23,20
2019,100760,20,0,38,23,15
2019,100760,20,6,38,23,15
2019,100760,30,0,4,0,4
2019,100760,30,6,4,0,4
2019,100760,40,0,1,0,1
2019,100760,40,6,1,0,1
2019,100760,42,0,1,0,1
2019,100760,42,6,1,0,1
2019,100760,50,0,4,1,3
2019,100812,0,0,89,40,49
2019,100812,10,0,89,40,49
2019,100812,10,1,26,15,11
2019,100812,10,2,28,9,19
2019,100812,10,3,30,12,18
2019,100812,10,4,4,4,0
2019,100812,10,6,1,0,1
2019,100812,20,0,61,29,32
2019,100812,20,1,26,15,11
2019,100812,20,2,28,9,19
2019,100812,20,3,7,5,2
2019,100812,30,0,23,7,16
2019,100812,30,3,23,7,16
2019,100812,40,0,5,4,1
2019,100812,40,4,4,4,0
2019,100812,40,6,1,0,1
2019,100812,42,0,4,4,0
2019,100812,42,4,4,4,0
2019,100812,43,0,1,0,1
2019,100812,43,6,1,0,1
2019,100830,0,0,216,119,97
2019,100830,10,0,216,119,97
2019,100830,10,1,57,41,16
2019,100830,10,2,63,40,23
2019,100830,10,3,64,29,35
2019,100830,10,5,32,9,23
2019,100830,20,0,113,78,35
2019,100830,20,1,52,36,16
2019,100830,20,2,52,35,17
2019,100830,20,3,9,7,2
2019,100830,30,0,60,28,32
2019,100830,30,1,5,5,0
2019,100830,30,2,10,4,6
2019,100830,30,3,45,19,26
2019,100830,40,0,43,13,30
2019,100830,40,2,1,1,0
2019,100830,40,3,10,3,7
2019,100830,40,5,32,9,23
2019,100830,41,0,10,3,7
2019,100830,41,3,10,3,7
2019,100830,42,0,33,10,23
2019,100830,42,2,1,1,0
2019,100830,42,5,32,9,23
2019,100830,44,0,10,3,7
2019,100830,44,3,10,3,7
2019,100858,0,0,1425,840,585
2019,100858,10,0,1425,840,585
2019,100858,10,1,403,302,101
2019,100858,10,2,394,223,171
2019,100858,10,3,375,194,181
2019,100858,10,4,78,39,39
2019,100858,10,5,165,76,89
2019,100858,10,6,10,6,4
2019,100858,20,0,718,489,229
2019,100858,20,1,391,298,93
2019,100858,20,2,326,190,136
2019,100858,20,4,1,1,0
2019,100858,30,0,352,200,152
2019,100858,30,1,5,3,2
2019,100858,30,2,30,21,9
2019,100858,30,3,317,176,141
2019,100858,40,0,355,151,204
2019,100858,40,1,7,1,6
2019,100858,40,2,38,12,26
2019,100858,40,3,58,18,40
2019,100858,40,4,77,38,39
2019,100858,40,5,165,76,89
2019,100858,40,6,10,6,4
2019,100858,43,0,355,151,204
2019,100858,43,1,7,1,6
2019,100858,43,2,38,12,26
2019,100858,43,3,58,18,40
2019,100858,43,4,77,38,39
2019,100858,43,5,165,76,89
2019,100858,43,6,10,6,4
2019,100937,0,0,101,55,46
2019,100937,10,0,101,55,46
2019,100937,10,1,38,27,11
2019,100937,10,2,23,14,9
2019,100937,10,3,23,7,16
2019,100937,10,4,8,3,5
2019,100937,10,5,9,4,5
2019,100937,20,0,60,40,20
2019,100937,20,1,38,27,11
2019,100937,20,2,22,13,9
2019,100937,30,0,21,7,14
2019,100937,30,2,1,1,0
2019,100937,30,3,20,6,14
2019,100937,40,0,20,8,12
2019,100937,40,3,3,1,2
2019,100937,40,4,8,3,5
2019,100937,40,5,9,4,5
2019,100937,42,0,20,8,12
2019,100937,42,3,3,1,2
2019,100937,42,4,8,3,5
2019,100937,42,5,9,4,5
2019,101028,0,0,43,14,29
2019,101028,10,0,43,14,29
2019,101028,10,6,43,14,29
2019,101028,20,0,30,11,19
2019,101028,20,6,30,11,19
2019,101028,30,0,12,2,10
2019,101028,30,6,12,2,10
2019,101028,40,0,1,1,0
2019,101028,40,6,1,1,0
2019,101028,43,0,1,1,0
2019,101028,43,6,1,1,0
2019,101116,0,0,4,1,3
2019,101116,10,0,4,1,3
2019,101116,10,4,4,1,3
2019,101116,40,0,4,1,3
2019,101116,40,4,4,1,3
2019,101116,41,0,4,1,3
2019,101116,41,4,4,1,3
2019,101116,45,0,4,1,3
2019,101116,45,4,4,1,3
2019,101143,0,0,46,22,24
2019,101143,10,0,46,22,24
2019,101143,10,6,46,22,24
2019,101143,20,0,29,12,17
2019,101143,20,6,29,12,17
2019,101143,30,0,15,9,6
2019,101143,30,6,15,9,6
2019,101143,40,0,2,1,1
2019,101143,40,6,2,1,1
2019,101143,42,0,2,1,1
2019,101143,42,6,2,1,1
2019,101161,0,0,164,73,91
2019,101161,10,0,164,73,91
2019,101161,10,6,164,73,91
2019,101161,20,0,109,47,62
2019,101161,20,6,109,47,62
2019,101161,30,0,54,26,28
2019,101161,30,6,54,26,28
2019,101161,40,0,1,0,1
2019,101161,40,6,1,0,1
2019,101161,42,0,1,0,1
2019,101161,42,6,1,0,1
2019,101189,0,0,120,65,55
2019,101189,10,0,120,65,55
2019,101189,10,1,34,24,10
2019,101189,10,2,28,19,9
2019,101189,10,3,33,12,21
2019,101189,10,4,2,0,2
2019,101189,10,5,22,10,12
2019,101189,10,6,1,0,1
2019,101189,20,0,46,36,10
2019,101189,20,1,29,22,7
2019,101189,20,2,15,12,3
2019,101189,20,3,2,2,0
2019,101189,30,0,48,17,31
2019,101189,30,1,5,2,3
2019,101189,30,2,11,5,6
2019,101189,30,3,29,10,19
2019,101189,30,4,2,0,2
2019,101189,30,6,1,0,1
2019,101189,40,0,26,12,14
2019,101189,40,2,2,2,0
2019,101189,40,3,2,0,2
2019,101189,40,5,22,10,12
2019,101189,42,0,26,12,14
2019,101189,42,2,2,2,0
2019,101189,42,3,2,0,2
2019,101189,42,5,22,10,12
2019,101240,0,0,133,58,75
2019,101240,10,0,133,58,75
2019,101240,10,6,133,58,75
2019,101240,20,0,114,52,62
2019,101240,20,6,114,52,62
2019,101240,30,0,16,6,10
2019,101240,30,6,16,6,10
2019,101240,40,0,3,0,3
2019,101240,40,6,3,0,3
2019,101240,42,0,3,0,3
2019,101240,42,6,3,0,3
2019,101286,0,0,139,49,90
2019,101286,10,0,139,49,90
2019,101286,10,6,139,49,90
2019,101286,20,0,105,35,70
2019,101286,20,6,105,35,70
2019,101286,30,0,34,14,20
2019,101286,30,6,34,14,20
2019,101295,0,0,118,40,78
2019,101295,10,0,118,40,78
2019,101295,10,6,118,40,78
2019,101295,20,0,83,26,57
2019,101295,20,6,83,26,57
2019,101295,30,0,34,13,21
2019,101295,30,6,34,13,21
2019,101295,40,0,1,1,0
2019,101295,40,6,1,1,0
2019,101295,43,0,1,1,0
2019,101295,43,6,1,1,0
2019,101301,0,0,46,15,31
2019,101301,10,0,46,15,31
2019,101301,10,6,46,15,31
2019,101301,20,0,17,6,11
2019,101301,20,6,17,6,11
2019,101301,30,0,22,8,14
2019,101301,30,6,22,8,14
2019,101301,40,0,7,1,6
2019,101301,40,6,7,1,6
2019,101301,42,0,7,1,6
2019,101301,42,6,7,1,6
2019,101365,0,0,17,2,15
2019,101365,10,0,17,2,15
2019,101365,10,1,1,0,1
2019,101365,10,3,8,1,7
2019,101365,10,4,8,1,7
2019,101365,40,0,17,2,15
2019,101365,40,1,1,0,1
2019,101365,40,3,8,1,7
2019,101365,40,4,8,1,7
2019,101365,41,0,17,2,15
2019,101365,41,1,1,0,1
2019,101365,41,3,8,1,7
2019,101365,41,4,8,1,7
2019,101365,45,0,17,2,15
2019,101365,45,1,1,0,1
2019,101365,45,3,8,1,7
2019,101365,45,4,8,1,7
2019,101435,0,0,52,26,26
2019,101435,10,0,52,26,26
2019,101435,10,1,17,11,6
2019,101435,10,2,7,3,4
2019,101435,10,3,19,9,10
2019,101435,10,4,9,3,6
2019,101435,20,0,21,13,8
2019,101435,20,1,16,11,5
2019,101435,20,2,5,2,3
2019,101435,30,0,18,7,11
2019,101435,30,3,15,6,9
2019,101435,30,4,3,1,2
2019,101435,40,0,13,6,7
2019,101435,40,1,1,0,1
2019,101435,40,2,2,1,1
2019,101435,40,3,4,3,1
2019,101435,40,4,6,2,4
2019,101435,41,0,4,2,2
2019,101435,41,2,2,1,1
2019,101435,41,3,1,1,0
2019,101435,41,4,1,0,1
2019,101435,42,0,9,4,5
2019,101435,42,1,1,0,1
2019,101435,42,3,3,2,1
2019,101435,42,4,5,2,3
2019,101435,44,0,4,2,2
2019,101435,44,2,2,1,1
2019,101435,44,3,1,1,0
2019,101435,44,4,1,0,1
2019,101453,0,0,4,3,1
2019,101453,10,0,4,3,1
2019,101453,10,6,4,3,1
2019,101453,40,0,4,3,1
2019,101453,40,6,4,3,1
2019,101453,42,0,4,3,1
2019,101453,42,6,4,3,1
2019,101462,0,0,19,11,8
2019,101462,10,0,19,11,8
2019,101462,10,6,19,11,8
2019,101462,20,0,10,6,4
2019,101462,20,6,10,6,4
2019,101462,30,0,8,5,3
2019,101462,30,6,8,5,3
2019,101462,40,0,1,0,1
2019,101462,40,6,1,0,1
2019,101462,42,0,1,0,1
2019,101462,42,6,1,0,1
2019,101471,0,0,55,40,15
2019,101471,10,0,55,40,15
2019,101471,10,6,55,40,15
2019,101471,20,0,23,16,7
2019,101471,20,6,23,16,7
2019,101471,30,0,1,0,1
2019,101471,30,6,1,0,1
2019,101471,40,0,31,24,7
2019,101471,40,6,31,24,7
2019,101471,42,0,31,24,7
2019,101471,42,6,31,24,7
2019,101480,0,0,341,174,167
2019,101480,10,0,341,174,167
2019,101480,10,1,96,62,34
2019,101480,10,2,66,38,28
2019,101480,10,3,88,45,43
2019,101480,10,4,91,29,62
2019,101480,20,0,146,90,56
2019,101480,20,1,91,59,32
2019,101480,20,2,55,31,24
2019,101480,30,0,128,64,64
2019,101480,30,1,5,3,2
2019,101480,30,2,11,7,4
2019,101480,30,3,88,45,43
2019,101480,30,4,24,9,15
2019,101480,40,0,67,20,47
2019,101480,40,4,67,20,47
2019,101480,42,0,67,20,47
2019,101480,42,4,67,20,47
2019,101505,0,0,147,48,99
2019,101505,10,0,147,48,99
2019,101505,10,6,147,48,99
2019,101505,20,0,121,35,86
2019,101505,20,6,121,35,86
2019,101505,30,0,26,13,13
2019,101505,30,6,26,13,13
2019,101514,0,0,155,70,85
2019,101514,10,0,155,70,85
2019,101514,10,6,155,70,85
2019,101514,20,0,108,46,62
2019,101514,20,6,108,46,62
2019,101514,30,0,35,18,17
2019,101514,30,6,35,18,17
2019,101514,40,0,12,6,6
2019,101514,40,6,12,6,6
2019,101514,42,0,12,6,6
2019,101514,42,6,12,6,6
2019,101541,0,0,27,8,19
2019,101541,10,0,27,8,19
2019,101541,10,1,3,2,1
2019,101541,10,2,5,1,4
2019,101541,10,3,18,5,13
2019,101541,10,4,1,0,1
2019,101541,20,0,4,2,2
2019,101541,20,1,2,1,1
2019,101541,20,2,2,1,1
2019,101541,30,0,23,6,17
2019,101541,30,1,1,1,0
2019,101541,30,2,3,0,3
2019,101541,30,3,18,5,13
2019,101541,30,4,1,0,1
2019,101569,0,0,87,44,43
2019,101569,10,0,87,44,43
2019,101569,10,6,87,44,43
2019,101569,20,0,70,38,32
2019,101569,20,6,70,38,32
2019,101569,30,0,17,6,11
2019,101569,30,6,17,6,11
2019,101587,0,0,116,47,69
2019,101587,10,0,116,47,69
2019,101587,10,1,24,14,10
2019,101587,10,2,33,12,21
2019,101587,10,3,37,14,23
2019,101587,10,4,18,6,12
2019,101587,10,5,4,1,3
2019,101587,20,0,55,26,29
2019,101587,20,1,20,11,9
2019,101587,20,2,24,9,15
2019,101587,20,3,11,6,5
2019,101587,30,0,25,11,14
2019,101587,30,1,4,3,1
2019,101587,30,2,6,3,3
2019,101587,30,3,15,5,10
2019,101587,40,0,36,10,26
2019,101587,40,2,3,0,3
2019,101587,40,3,11,3,8
2019,101587,40,4,18,6,12
2019,101587,40,5,4,1,3
2019,101587,42,0,36,10,26
2019,101587,42,2,3,0,3
2019,101587,42,3,11,3,8
2019,101587,42,4,18,6,12
2019,101587,42,5,4,1,3
2019,101602,0,0,56,23,33
2019,101602,10,0,56,23,33
2019,101602,10,6,56,23,33
2019,101602,20,0,39,15,24
2019,101602,20,6,39,15,24
2019,101602,30,0,15,7,8
2019,101602,30,6,15,7,8
2019,101602,40,0,2,1,1
2019,101602,40,6,2,1,1
2019,101602,42,0,2,1,1
2019,101602,42,6,2,1,1
2019,101648,0,0,20,10,10
2019,101648,10,0,20,10,10
2019,101648,10,6,20,10,10
2019,101648,20,0,10,5,5
2019,101648,20,6,10,5,5
2019,101648,30,0,4,3,1
2019,101648,30,6,4,3,1
2019,101648,40,0,6,2,4
2019,101648,40,6,6,2,4
2019,101648,42,0,6,2,4
2019,101648,42,6,6,2,4
2019,101675,0,0,77,32,45
2019,101675,10,0,77,32,45
2019,101675,10,1,7,6,1
2019,101675,10,2,7,5,2
2019,101675,10,3,17,3,14
2019,101675,10,4,46,18,28
2019,101675,20,0,7,6,1
2019,101675,20,1,7,6,1
2019,101675,30,0,70,26,44
2019,101675,30,2,7,5,2
2019,101675,30,3,17,3,14
2019,101675,30,4,46,18,28
2019,101693,0,0,73,30,43
2019,101693,10,0,73,30,43
2019,101693,10,1,14,7,7
2019,101693,10,2,20,8,12
2019,101693,10,3,30,10,20
2019,101693,10,4,8,4,4
2019,101693,10,6,1,1,0
2019,101693,20,0,5,3,2
2019,101693,20,1,5,3,2
2019,101693,30,0,59,22,37
2019,101693,30,1,9,4,5
2019,101693,30,2,20,8,12
2019,101693,30,3,30,10,20
2019,101693,40,0,9,5,4
2019,101693,40,4,8,4,4
2019,101693,40,6,1,1,0
2019,101693,42,0,9,5,4
2019,101693,42,4,8,4,4
2019,101693,42,6,1,1,0
2019,101709,0,0,153,78,75
2019,101709,10,0,153,78,75
2019,101709,10,1,49,30,19
2019,101709,10,2,46,25,21
2019,101709,10,3,45,20,25
2019,101709,10,4,13,3,10
2019,101709,20,0,98,54,44
2019,101709,20,1,49,30,19
2019,101709,20,2,45,24,21
2019,101709,20,3,4,0,4
2019,101709,30,0,40,19,21
2019,101709,30,2,1,1,0
2019,101709,30,3,39,18,21
2019,101709,40,0,15,5,10
2019,101709,40,3,2,2,0
2019,101709,40,4,13,3,10
2019,101709,41,0,13,3,10
2019,101709,41,4,13,3,10
2019,101709,42,0,2,2,0
2019,101709,42,3,2,2,0
2019,101709,45,0,13,3,10
2019,101709,45,4,13,3,10
2019,101736,0,0,82,36,46
2019,101736,10,0,82,36,46
2019,101736,10,6,82,36,46
2019,101736,20,0,53,23,30
2019,101736,20,6,53,23,30
2019,101736,30,0,20,10,10
2019,101736,30,6,20,10,10
2019,101736,40,0,9,3,6
2019,101736,40,6,9,3,6
2019,101736,42,0,9,3,6
2019,101736,42,6,9,3,6
2019,101879,0,0,272,138,134
2019,101879,10,0,272,138,134
2019,101879,10,1,72,44,28
2019,101879,10,2,76,42,34
2019,101879,10,3,75,35,40
2019,101879,10,4,3,2,1
2019,101879,10,5,46,15,31
2019,101879,20,0,141,74,67
2019,101879,20,1,70,42,28
2019,101879,20,2,61,30,31
2019,101879,20,3,10,2,8
2019,101879,30,0,75,42,33
2019,101879,30,1,2,2,0
2019,101879,30,2,13,10,3
2019,101879,30,3,60,30,30
2019,101879,40,0,56,22,34
2019,101879,40,2,2,2,0
2019,101879,40,3,5,3,2
2019,101879,40,4,3,2,1
2019,101879,40,5,46,15,31
2019,101879,41,0,10,3,7
2019,101879,41,2,1,1,0
2019,101879,41,3,1,1,0
2019,101879,41,5,8,1,7
2019,101879,42,0,46,19,27
2019,101879,42,2,1,1,0
2019,101879,42,3,4,2,2
2019,101879,42,4,3,2,1
2019,101879,42,5,38,14,24
2019,101879,44,0,10,3,7
2019,101879,44,2,1,1,0
2019,101879,44,3,1,1,0
2019,101879,44,5,8,1,7
2019,101897,0,0,56,24,32
2019,101897,10,0,56,24,32
2019,101897,10,6,56,24,32
2019,101897,20,0,36,16,20
2019,101897,20,6,36,16,20
2019,101897,40,0,20,8,12
2019,101897,40,6,20,8,12
2019,101897,42,0,19,8,11
2019,101897,42,6,19,8,11
2019,101897,43,0,1,0,1
2019,101897,43,6,1,0,1
2019,101912,0,0,95,56,39
2019,101912,10,0,95,56,39
2019,101912,10,1,16,13,3
2019,101912,10,2,37,22,15
2019,101912,10,3,42,21,21
2019,101912,20,0,9,7,2
2019,101912,20,1,3,2,1
2019,101912,20,2,6,5,1
2019,101912,30,0,50,32,18
2019,101912,30,1,12,10,2
2019,101912,30,2,19,11,8
2019,101912,30,3,19,11,8
2019,101912,40,0,36,17,19
2019,101912,40,1,1,1,0
2019,101912,40,2,12,6,6
2019,101912,40,3,23,10,13
2019,101912,42,0,18,9,9
2019,101912,42,1,1,1,0
2019,101912,42,2,5,1,4
2019,101912,42,3,12,7,5
2019,101912,43,0,18,8,10
2019,101912,43,2,7,5,2
2019,101912,43,3,11,3,8
2019,101994,0,0,16,6,10
2019,101994,10,0,16,6,10
2019,101994,10,6,16,6,10
2019,101994,20,0,12,5,7
2019,101994,20,6,12,5,7
2019,101994,30,0,4,1,3
2019,101994,30,6,4,1,3
2019,102030,0,0,65,24,41
2019,102030,10,0,65,24,41
2019,102030,10,6,65,24,41
2019,102030,20,0,41,14,27
2019,102030,20,6,41,14,27
2019,102030,30,0,14,7,7
2019,102030,30,6,14,7,7
2019,102030,40,0,10,3,7
2019,102030,40,6,10,3,7
2019,102030,42,0,10,3,7
2019,102030,42,6,10,3,7
2019,102049,0,0,368,182,186
2019,102049,10,0,368,182,186
2019,102049,10,1,138,87,51
2019,102049,10,2,78,39,39
2019,102049,10,3,119,48,71
2019,102049,10,4,33,8,25
2019,102049,20,0,180,114,66
2019,102049,20,1,124,81,43
2019,102049,20,2,53,31,22
2019,102049,20,3,3,2,1
2019,102049,30,0,87,40,47
2019,102049,30,1,5,4,1
2019,102049,30,2,13,5,8
2019,102049,30,3,69,31,38
2019,102049,40,0,101,28,73
2019,102049,40,1,9,2,7
2019,102049,40,2,12,3,9
2019,102049,40,3,47,15,32
2019,102049,40,4,33,8,25
2019,102049,42,0,49,14,35
2019,102049,42,1,7,1,6
2019,102049,42,2,9,1,8
2019,102049,42,3,21,9,12
2019,102049,42,4,12,3,9
2019,102049,43,0,52,14,38
2019,102049,43,1,2,1,1
2019,102049,43,2,3,2,1
2019,102049,43,3,26,6,20
2019,102049,43,4,21,5,16
2019,102058,0,0,6,2,4
2019,102058,10,0,6,2,4
2019,102058,10,3,1,1,0
2019,102058,10,4,3,1,2
2019,102058,10,5,2,0,2
2019,102058,40,0,6,2,4
2019,102058,40,3,1,1,0
2019,102058,40,4,3,1,2
2019,102058,40,5,2,0,2
2019,102058,42,0,6,2,4
2019,102058,42,3,1,1,0
2019,102058,42,4,3,1,2
2019,102058,42,5,2,0,2
2019,102067,0,0,98,46,52
2019,102067,10,0,98,46,52
2019,102067,10,6,98,46,52
2019,102067,20,0,79,39,40
2019,102067,20,6,79,39,40
2019,102067,30,0,15,7,8
2019,102067,30,6,15,7,8
2019,102067,40,0,4,0,4
2019,102067,40,6,4,0,4
2019,102067,42,0,4,0,4
2019,102067,42,6,4,0,4
2019,102076,0,0,37,19,18
2019,102076,10,0,37,19,18
2019,102076,10,6,37,19,18
2019,102076,20,0,34,17,17
2019,102076,20,6,34,17,17
2019,102076,30,0,3,2,1
2019,102076,30,6,3,2,1
2019,102094,0,0,811,431,380
2019,102094,10,0,811,431,380
2019,102094,10,1,163,124,39
2019,102094,10,2,176,97,79
2019,102094,10,3,342,172,170
2019,102094,10,4,129,38,91
2019,102094,10,5,1,0,1
2019,102094,20,0,247,164,83
2019,102094,20,1,130,99,31
2019,102094,20,2,113,63,50
2019,102094,20,3,4,2,2
2019,102094,30,0,134,82,52
2019,102094,30,1,1,1,0
2019,102094,30,2,12,7,5
2019,102094,30,3,121,74,47
2019,102094,40,0,430,185,245
2019,102094,40,1,32,24,8
2019,102094,40,2,51,27,24
2019,102094,40,3,217,96,121
2019,102094,40,4,129,38,91
2019,102094,40,5,1,0,1
2019,102094,42,0,430,185,245
2019,102094,42,1,32,24,8
2019,102094,42,2,51,27,24
2019,102094,42,3,217,96,121
2019,102094,42,4,129,38,91
2019,102094,42,5,1,0,1
2019,102234,0,0,83,42,41
2019,102234,10,0,83,42,41
2019,102234,10,1,13,6,7
2019,102234,10,2,36,20,16
2019,102234,10,3,27,14,13
2019,102234,10,4,7,2,5
2019,102234,20,0,46,25,21
2019,102234,20,1,12,6,6
2019,102234,20,2,34,19,15
2019,102234,30,0,22,12,10
2019,102234,30,1,1,0,1
2019,102234,30,2,1,1,0
2019,102234,30,3,20,11,9
2019,102234,40,0,15,5,10
2019,102234,40,2,1,0,1
2019,102234,40,3,7,3,4
2019,102234,40,4,7,2,5
2019,102234,42,0,15,5,10
2019,102234,42,2,1,0,1
2019,102234,42,3,7,3,4
2019,102234,42,4,7,2,5
2019,102270,0,0,41,20,21
2019,102270,10,0,40,20,20
2019,102270,10,1,7,1,6
2019,102270,10,2,11,9,2
2019,102270,10,3,18,9,9
2019,102270,10,4,4,1,3
2019,102270,20,0,16,7,9
2019,102270,20,1,7,1,6
2019,102270,20,2,7,6,1
2019,102270,20,3,2,0,2
2019,102270,30,0,24,13,11
2019,102270,30,2,4,3,1
2019,102270,30,3,16,9,7
2019,102270,30,4,4,1,3
2019,102270,50,0,1,0,1
2019,102298,0,0,42,21,21
2019,102298,10,0,42,21,21
2019,102298,10,1,5,4,1
2019,102298,10,2,10,7,3
2019,102298,10,3,20,8,12
2019,102298,10,4,7,2,5
2019,102298,20,0,8,6,2
2019,102298,20,1,4,4,0
2019,102298,20,2,4,2,2
2019,102298,30,0,34,15,19
2019,102298,30,1,1,0,1
2019,102298,30,2,6,5,1
2019,102298,30,3,20,8,12
2019,102298,30,4,7,2,5
2019,102313,0,0,62,35,27
2019,102313,10,0,62,35,27
2019,102313,10,6,62,35,27
2019,102313,20,0,31,18,13
2019,102313,20,6,31,18,13
2019,102313,30,0,31,17,14
2019,102313,30,6,31,17,14
2019,102368,0,0,526,255,271
2019,102368,10,0,526,255,271
2019,102368,10,1,62,49,13
2019,102368,10,2,144,87,57
2019,102368,10,3,154,59,95
2019,102368,10,5,161,55,106
2019,102368,10,6,5,5,0
2019,102368,20,0,228,140,88
2019,102368,20,1,57,44,13
2019,102368,20,2,134,80,54
2019,102368,20,3,36,15,21
2019,102368,20,6,1,1,0
2019,102368,30,0,112,45,67
2019,102368,30,1,2,2,0
2019,102368,30,2,10,7,3
2019,102368,30,3,100,36,64
2019,102368,40,0,186,70,116
2019,102368,40,1,3,3,0
2019,102368,40,3,18,8,10
2019,102368,40,5,161,55,106
2019,102368,40,6,4,4,0
2019,102368,41,0,186,70,116
2019,102368,41,1,3,3,0
2019,102368,41,3,18,8,10
2019,102368,41,5,161,55,106
2019,102368,41,6,4,4,0
2019,102368,45,0,186,70,116
2019,102368,45,1,3,3,0
2019,102368,45,3,18,8,10
2019,102368,45,5,161,55,106
2019,102368,45,6,4,4,0
2019,102377,0,0,236,132,104
2019,102377,10,0,236,132,104
2019,102377,10,1,52,40,12
2019,102377,10,2,83,44,39
2019,102377,10,3,86,42,44
2019,102377,10,4,13,5,8
2019,102377,10,5,2,1,1
2019,102377,20,0,107,68,39
2019,102377,20,1,48,36,12
2019,102377,20,2,53,29,24
2019,102377,20,3,6,3,3
2019,102377,30,0,69,39,30
2019,102377,30,1,2,2,0
2019,102377,30,2,13,8,5
2019,102377,30,3,53,29,24
2019,102377,30,4,1,0,1
2019,102377,40,0,60,25,35
2019,102377,40,1,2,2,0
2019,102377,40,2,17,7,10
2019,102377,40,3,27,10,17
2019,102377,40,4,12,5,7
2019,102377,40,5,2,1,1
2019,102377,42,0,60,25,35
2019,102377,42,1,2,2,0
2019,102377,42,2,17,7,10
2019,102377,42,3,27,10,17
2019,102377,42,4,12,5,7
2019,102377,42,5,2,1,1
2019,102395,0,0,7,5,2
2019,102395,10,0,7,5,2
2019,102395,10,2,4,4,0
2019,102395,10,3,1,0,1
2019,102395,10,5,2,1,1
2019,102395,40,0,7,5,2
2019,102395,40,2,4,4,0
2019,102395,40,3,1,0,1
2019,102395,40,5,2,1,1
2019,102395,41,0,7,5,2
2019,102395,41,2,4,4,0
2019,102395,41,3,1,0,1
2019,102395,41,5,2,1,1
2019,102395,45,0,7,5,2
2019,102395,45,2,4,4,0
2019,102395,45,3,1,0,1
2019,102395,45,5,2,1,1
2019,102429,0,0,104,48,56
2019,102429,10,0,104,48,56
2019,102429,10,4,104,48,56
2019,102429,20,0,94,42,52
2019,102429,20,4,94,42,52
2019,102429,30,0,10,6,4
2019,102429,30,4,10,6,4
2019,102553,0,0,449,221,228
2019,102553,10,0,437,218,219
2019,102553,10,1,106,63,43
2019,102553,10,2,123,65,58
2019,102553,10,3,175,77,98
2019,102553,10,4,32,13,19
2019,102553,10,6,1,0,1
2019,102553,20,0,229,128,101
2019,102553,20,1,103,61,42
2019,102553,20,2,115,59,56
2019,102553,20,3,11,8,3
2019,102553,30,0,98,43,55
2019,102553,30,1,1,0,1
2019,102553,30,2,4,3,1
2019,102553,30,3,93,40,53
2019,102553,40,0,110,47,63
2019,102553,40,1,2,2,0
2019,102553,40,2,4,3,1
2019,102553,40,3,71,29,42
2019,102553,40,4,32,13,19
2019,102553,40,6,1,0,1
2019,102553,41,0,9,3,6
2019,102553,41,1,1,1,0
2019,102553,41,3,8,2,6
2019,102553,42,0,95,41,54
2019,102553,42,1,1,1,0
2019,102553,42,2,4,3,1
2019,102553,42,3,61,26,35
2019,102553,42,4,29,11,18
2019,102553,43,0,6,3,3
2019,102553,43,3,2,1,1
2019,102553,43,4,3,2,1
2019,102553,43,6,1,0,1
2019,102553,44,0,9,3,6
2019,102553,44,1,1,1,0
2019,102553,44,3,8,2,6
2019,102553,50,0,12,3,9
2019,102614,0,0,338,188,150
2019,102614,10,0,315,175,140
2019,102614,10,1,91,62,29
2019,102614,10,2,105,57,48
2019,102614,10,3,88,41,47
2019,102614,10,4,25,13,12
2019,102614,10,6,6,2,4
2019,102614,20,0,184,115,69
2019,102614,20,1,91,62,29
2019,102614,20,2,92,53,39
2019,102614,20,3,1,0,1
2019,102614,30,0,52,25,27
2019,102614,30,2,5,3,2
2019,102614,30,3,47,22,25
2019,102614,40,0,79,35,44
2019,102614,40,2,8,1,7
2019,102614,40,3,40,19,21
2019,102614,40,4,25,13,12
2019,102614,40,6,6,2,4
2019,102614,41,0,2,0,2
2019,102614,41,3,2,0,2
2019,102614,42,0,20,10,10
2019,102614,42,2,1,0,1
2019,102614,42,3,14,6,8
2019,102614,42,4,3,2,1
2019,102614,42,6,2,2,0
2019,102614,43,0,57,25,32
2019,102614,43,2,7,1,6
2019,102614,43,3,24,13,11
2019,102614,43,4,22,11,11
2019,102614,43,6,4,0,4
2019,102614,44,0,2,0,2
2019,102614,44,3,2,0,2
2019,102614,50,0,23,13,10
2019,102632,0,0,94,51,43
2019,102632,10,0,90,50,40
2019,102632,10,1,20,14,6
2019,102632,10,2,29,13,16
2019,102632,10,3,40,23,17
2019,102632,10,4,1,0,1
2019,102632,20,0,47,27,20
2019,102632,20,1,19,14,5
2019,102632,20,2,27,12,15
2019,102632,20,3,1,1,0
2019,102632,30,0,8,5,3
2019,102632,30,3,8,5,3
2019,102632,40,0,35,18,17
2019,102632,40,1,1,0,1
2019,102632,40,2,2,1,1
2019,102632,40,3,31,17,14
2019,102632,40,4,1,0,1
2019,102632,41,0,9,6,3
2019,102632,41,1,1,0,1
2019,102632,41,2,1,1,0
2019,102632,41,3,7,5,2
2019,102632,42,0,19,8,11
2019,102632,42,2,1,0,1
2019,102632,42,3,18,8,10
2019,102632,43,0,7,4,3
2019,102632,43,3,6,4,2
2019,102632,43,4,1,0,1
2019,102632,44,0,3,2,1
2019,102632,44,3,3,2,1
2019,102632,45,0,6,4,2
2019,102632,45,1,1,0,1
2019,102632,45,2,1,1,0
2019,102632,45,3,4,3,1
2019,102632,50,0,4,1,3
2019,102669,0,0,38,17,21
2019,102669,10,0,38,17,21
2019,102669,10,1,6,5,1
2019,102669,10,2,11,5,6
2019,102669,10,3,20,6,14
2019,102669,10,6,1,1,0
2019,102669,40,0,38,17,21
2019,102669,40,1,6,5,1
2019,102669,40,2,11,5,6
2019,102669,40,3,20,6,14
2019,102669,40,6,1,1,0
2019,102669,41,0,30,14,16
2019,102669,41,1,6,5,1
2019,102669,41,2,11,5,6
2019,102669,41,3,13,4,9
2019,102669,42,0,8,3,5
2019,102669,42,3,7,2,5
2019,102669,42,6,1,1,0
2019,102669,44,0,30,14,16
2019,102669,44,1,6,5,1
2019,102669,44,2,11,5,6
2019,102669,44,3,13,4,9
2019,102845,0,0,87,32,55
2019,102845,10,0,87,32,55
2019,102845,10,4,87,32,55
2019,102845,40,0,87,32,55
2019,102845,40,4,87,32,55
2019,102845,41,0,87,32,55
2019,102845,41,4,87,32,55
2019,102845,45,0,87,32,55
2019,102845,45,4,87,32,55
2019,103501,0,0,7,5,2
2019,103501,10,0,7,5,2
2019,103501,10,4,7,5,2
2019,103501,40,0,7,5,2
2019,103501,40,4,7,5,2
2019,103501,42,0,7,5,2
2019,103501,42,4,7,5,2
2019,103893,0,0,46,4,42
2019,103893,10,0,46,4,42
2019,103893,10,4,46,4,42
2019,103893,40,0,46,4,42
2019,103893,40,4,46,4,42
2019,103893,41,0,46,4,42
2019,103893,41,4,46,4,42
2019,103893,45,0,46,4,42
2019,103893,45,4,46,4,42
2019,104090,0,0,21,4,17
2019,104090,10,0,21,4,17
2019,104090,10,4,21,4,17
2019,104090,40,0,21,4,17
2019,104090,40,4,21,4,17
2019,104090,41,0,21,4,17
2019,104090,41,4,21,4,17
2019,104090,45,0,21,4,17
2019,104090,45,4,21,4,17
2019,104151,0,0,2195,1304,891
2019,104151,10,0,2195,1304,891
2019,104151,10,1,635,458,177
2019,104151,10,2,517,323,194
2019,104151,10,3,487,259,228
2019,104151,10,4,219,95,124
2019,104151,10,5,332,165,167
2019,104151,10,6,5,4,1
2019,104151,20,0,1017,686,331
2019,104151,20,1,573,414,159
2019,104151,20,2,444,272,172
2019,104151,30,0,366,206,160
2019,104151,30,1,1,1,0
2019,104151,30,2,14,11,3
2019,104151,30,3,351,194,157
2019,104151,40,0,812,412,400
2019,104151,40,1,61,43,18
2019,104151,40,2,59,40,19
2019,104151,40,3,136,65,71
2019,104151,40,4,219,95,124
2019,104151,40,5,332,165,167
2019,104151,40,6,5,4,1
2019,104151,41,0,151,78,73
2019,104151,41,1,16,13,3
2019,104151,41,2,17,13,4
2019,104151,41,3,3,2,1
2019,104151,41,5,115,50,65
2019,104151,42,0,661,334,327
2019,104151,42,1,45,30,15
2019,104151,42,2,42,27,15
2019,104151,42,3,133,63,70
2019,104151,42,4,219,95,124
2019,104151,42,5,217,115,102
2019,104151,42,6,5,4,1
2019,104151,44,0,151,78,73
2019,104151,44,1,16,13,3
2019,104151,44,2,17,13,4
2019,104151,44,3,3,2,1
2019,104151,44,5,115,50,65
2019,104160,0,0,117,63,54
2019,104160,10,0,117,63,54
2019,104160,10,6,117,63,54
2019,104160,40,0,117,63,54
2019,104160,40,6,117,63,54
2019,104160,42,0,117,63,54
2019,104160,42,6,117,63,54
2019,104179,0,0,2118,1238,880
2019,104179,10,0,2094,1230,864
2019,104179,10,1,781,536,245
2019,104179,10,2,507,290,217
2019,104179,10,3,540,272,268
2019,104179,10,4,77,38,39
2019,104179,10,5,189,94,95
2019,104179,20,0,1141,751,390
2019,104179,20,1,725,502,223
2019,104179,20,2,416,249,167
2019,104179,30,0,406,238,168
2019,104179,30,1,2,2,0
2019,104179,30,2,27,18,9
2019,104179,30,3,377,218,159
2019,104179,40,0,547,241,306
2019,104179,40,1,54,32,22
2019,104179,40,2,64,23,41
2019,104179,40,3,163,54,109
2019,104179,40,4,77,38,39
2019,104179,40,5,189,94,95
2019,104179,41,0,106,56,50
2019,104179,41,1,10,5,5
2019,104179,41,2,19,7,12
2019,104179,41,3,21,9,12
2019,104179,41,5,56,35,21
2019,104179,42,0,441,185,256
2019,104179,42,1,44,27,17
2019,104179,42,2,45,16,29
2019,104179,42,3,142,45,97
2019,104179,42,4,77,38,39
2019,104179,42,5,133,59,74
2019,104179,44,0,106,56,50
2019,104179,44,1,10,5,5
2019,104179,44,2,19,7,12
2019,104179,44,3,21,9,12
2019,104179,44,5,56,35,21
2019,104179,50,0,24,8,16
2019,104346,0,0,99,45,54
2019,104346,10,0,99,45,54
2019,104346,10,1,99,45,54
2019,104346,40,0,99,45,54
2019,104346,40,1,99,45,54
2019,104346,42,0,7,7,0
2019,104346,42,1,7,7,0
2019,104346,43,0,92,38,54
2019,104346,43,1,92,38,54
2019,104425,0,0,109,47,62
2019,104425,10,0,109,47,62
2019,104425,10,6,109,47,62
2019,104425,40,0,109,47,62
2019,104425,40,6,109,47,62
2019,104425,42,0,109,47,62
2019,104425,42,6,109,47,62
2019,104577,0,0,91,58,33
2019,104577,10,0,91,58,33
2019,104577,10,1,23,14,9
2019,104577,10,2,68,44,24
2019,104577,40,0,91,58,33
2019,104577,40,1,23,14,9
2019,104577,40,2,68,44,24
2019,104577,42,0,91,58,33
2019,104577,42,1,23,14,9
2019,104577,42,2,68,44,24
2019,104586,0,0,137,100,37
2019,104586,10,0,137,100,37
2019,104586,10,1,22,17,5
2019,104586,10,2,31,24,7
2019,104586,10,3,68,49,19
2019,104586,10,4,16,10,6
2019,104586,20,0,48,37,11
2019,104586,20,1,22,17,5
2019,104586,20,2,23,17,6
2019,104586,20,3,3,3,0
2019,104586,30,0,51,36,15
2019,104586,30,2,4,3,1
2019,104586,30,3,47,33,14
2019,104586,40,0,38,27,11
2019,104586,40,2,4,4,0
2019,104586,40,3,18,13,5
2019,104586,40,4,16,10,6
2019,104586,42,0,38,27,11
2019,104586,42,2,4,4,0
2019,104586,42,3,18,13,5
2019,104586,42,4,16,10,6
2019,104708,0,0,262,120,142
2019,104708,10,0,261,120,141
2019,104708,10,6,261,120,141
2019,104708,20,0,170,81,89
2019,104708,20,6,170,81,89
2019,104708,30,0,73,34,39
2019,104708,30,6,73,34,39
2019,104708,40,0,18,5,13
2019,104708,40,6,18,5,13
2019,104708,42,0,15,4,11
2019,104708,42,6,15,4,11
2019,104708,43,0,3,1,2
2019,104708,43,6,3,1,2
2019,104708,50,0,1,0,1
2019,104717,0,0,441,213,228
2019,104717,10,0,441,213,228
2019,104717,10,1,12,7,5
2019,104717,10,2,53,26,27
2019,104717,10,3,89,41,48
2019,104717,10,4,279,135,144
2019,104717,10,5,6,4,2
2019,104717,10,6,2,0,2
2019,104717,20,0,4,3,1
2019,104717,20,1,2,2,0
2019,104717,20,2,2,1,1
2019,104717,40,0,437,210,227
2019,104717,40,1,10,5,5
2019,104717,40,2,51,25,26
2019,104717,40,3,89,41,48
2019,104717,40,4,279,135,144
2019,104717,40,5,6,4,2
2019,104717,40,6,2,0,2
2019,104717,41,0,191,84,107
2019,104717,41,1,4,3,1
2019,104717,41,2,21,6,15
2019,104717,41,3,25,9,16
2019,104717,41,4,140,66,74
2019,104717,41,6,1,0,1
2019,104717,42,0,246,126,120
2019,104717,42,1,6,2,4
2019,104717,42,2,30,19,11
2019,104717,42,3,64,32,32
2019,104717,42,4,139,69,70
2019,104717,42,5,6,4,2
2019,104717,42,6,1,0,1
2019,104717,44,0,10,5,5
2019,104717,44,1,4,3,1
2019,104717,44,2,6,2,4
2019,104717,45,0,181,79,102
2019,104717,45,2,15,4,11
2019,104717,45,3,25,9,16
2019,104717,45,4,140,66,74
2019,104717,45,6,1,0,1
2019,105145,0,0,103,39,64
2019,105145,10,0,100,38,62
2019,105145,10,6,100,38,62
2019,105145,20,0,53,18,35
2019,105145,20,6,53,18,35
2019,105145,30,0,42,18,24
2019,105145,30,6,42,18,24
2019,105145,40,0,5,2,3
2019,105145,40,6,5,2,3
2019,105145,42,0,3,2,1
2019,105145,42,6,3,2,1
2019,105145,43,0,2,0,2
2019,105145,43,6,2,0,2
2019,105145,50,0,3,1,2
2019,105154,0,0,300,136,164
2019,105154,10,0,300,136,164
2019,105154,10,6,300,136,164
2019,105154,20,0,218,101,117
2019,105154,20,6,218,101,117
2019,105154,30,0,59,24,35
2019,105154,30,6,59,24,35
2019,105154,40,0,23,11,12
2019,105154,40,6,23,11,12
2019,105154,42,0,19,9,10
2019,105154,42,6,19,9,10
2019,105154,43,0,4,2,2
2019,105154,43,6,4,2,2
2019,105206,0,0,82,37,45
2019,105206,10,0,82,37,45
2019,105206,10,4,82,37,45
2019,105206,40,0,82,37,45
2019,105206,40,4,82,37,45
2019,105206,42,0,82,37,45
2019,105206,42,4,82,37,45
2019,105297,0,0,64,42,22
2019,105297,10,0,64,42,22
2019,105297,10,1,12,8,4
2019,105297,10,2,10,10,0
2019,105297,10,3,6,3,3
2019,105297,10,4,36,21,15
2019,105297,40,0,64,42,22
2019,105297,40,1,12,8,4
2019,105297,40,2,10,10,0
2019,105297,40,3,6,3,3
2019,105297,40,4,36,21,15
2019,105297,41,0,56,36,20
2019,105297,41,1,9,5,4
2019,105297,41,2,9,9,0
2019,105297,41,3,3,2,1
2019,105297,41,4,35,20,15
2019,105297,42,0,8,6,2
2019,105297,42,1,3,3,0
2019,105297,42,2,1,1,0
2019,105297,42,3,3,1,2
2019,105297,42,4,1,1,0
2019,105297,44,0,56,36,20
2019,105297,44,1,9,5,4
2019,105297,44,2,9,9,0
2019,105297,44,3,3,2,1
2019,105297,44,4,35,20,15
2019,105330,0,0,1151,554,597
2019,105330,10,0,1151,554,597
2019,105330,10,1,291,172,119
2019,105330,10,2,205,104,101
2019,105330,10,3,288,119,169
2019,105330,10,4,50,26,24
2019,105330,10,5,317,133,184
2019,105330,20,0,411,242,169
2019,105330,20,1,272,167,105
2019,105330,20,2,139,75,64
2019,105330,30,0,134,74,60
2019,105330,30,2,7,6,1
2019,105330,30,3,127,68,59
2019,105330,40,0,606,238,368
2019,105330,40,1,19,5,14
2019,105330,40,2,59,23,36
2019,105330,40,3,161,51,110
2019,105330,40,4,50,26,24
2019,105330,40,5,317,133,184
2019,105330,41,0,65,31,34
2019,105330,41,1,4,2,2
2019,105330,41,2,10,6,4
2019,105330,41,3,4,3,1
2019,105330,41,5,47,20,27
2019,105330,42,0,541,207,334
2019,105330,42,1,15,3,12
2019,105330,42,2,49,17,32
2019,105330,42,3,157,48,109
2019,105330,42,4,50,26,24
2019,105330,42,5,270,113,157
2019,105330,44,0,65,31,34
2019,105330,44,1,4,2,2
2019,105330,44,2,10,6,4
2019,105330,44,3,4,3,1
2019,105330,44,5,47,20,27
2019,105349,0,0,68,30,38
2019,105349,10,0,68,30,38
2019,105349,10,4,68,30,38
2019,105349,40,0,68,30,38
2019,105349,40,4,68,30,38
2019,105349,42,0,68,30,38
2019,105349,42,4,68,30,38
2019,105367,0,0,4,1,3
2019,105367,10,0,4,1,3
2019,105367,10,1,1,0,1
2019,105367,10,2,1,0,1
2019,105367,10,3,2,1,1
2019,105367,20,0,1,0,1
2019,105367,20,1,1,0,1
2019,105367,40,0,3,1,2
2019,105367,40,2,1,0,1
2019,105367,40,3,2,1,1
2019,105367,42,0,3,1,2
2019,105367,42,2,1,0,1
2019,105367,42,3,2,1,1
2019,105428,0,0,152,62,90
2019,105428,10,0,148,62,86
2019,105428,10,6,148,62,86
2019,105428,20,0,74,36,38
2019,105428,20,6,74,36,38
2019,105428,30,0,60,23,37
2019,105428,30,6,60,23,37
2019,105428,40,0,14,3,11
2019,105428,40,6,14,3,11
2019,105428,42,0,13,3,10
2019,105428,42,6,13,3,10
2019,105428,43,0,1,0,1
2019,105428,43,6,1,0,1
2019,105428,50,0,4,0,4
2019,105525,0,0,258,111,147
2019,105525,10,0,258,111,147
2019,105525,10,6,258,111,147
2019,105525,40,0,258,111,147
2019,105525,40,6,258,111,147
2019,105525,42,0,258,111,147
2019,105525,42,6,258,111,147
2019,105534,0,0,55,6,49
2019,105534,10,0,55,6,49
2019,105534,10,4,55,6,49
2019,105534,40,0,55,6,49
2019,105534,40,4,55,6,49
2019,105534,41,0,55,6,49
2019,105534,41,4,55,6,49
2019,105534,45,0,55,6,49
2019,105534,45,4,55,6,49
2019,105543,0,0,37,7,30
2019,105543,10,0,37,7,30
2019,105543,10,4,37,7,30
2019,105543,40,0,37,7,30
2019,105543,40,4,37,7,30
2019,105543,41,0,37,7,30
2019,105543,41,4,37,7,30
2019,105543,45,0,37,7,30
2019,105543,45,4,37,7,30
2019,105589,0,0,44,15,29
2019,105589,10,0,44,15,29
2019,105589,10,2,21,9,12
2019,105589,10,3,4,3,1
2019,105589,10,4,19,3,16
2019,105589,40,0,44,15,29
2019,105589,40,2,21,9,12
2019,105589,40,3,4,3,1
2019,105589,40,4,19,3,16
2019,105589,41,0,21,12,9
2019,105589,41,2,16,8,8
2019,105589,41,3,4,3,1
2019,105589,41,4,1,1,0
2019,105589,42,0,15,2,13
2019,105589,42,2,2,0,2
2019,105589,42,4,13,2,11
2019,105589,43,0,8,1,7
2019,105589,43,2,3,1,2
2019,105589,43,4,5,0,5
2019,105589,44,0,21,12,9
2019,105589,44,2,16,8,8
2019,105589,44,3,4,3,1
2019,105589,44,4,1,1,0
2019,105659,0,0,24,23,1
2019,105659,10,0,24,23,1
2019,105659,10,4,24,23,1
2019,105659,40,0,24,23,1
2019,105659,40,4,24,23,1
2019,105659,41,0,24,23,1
2019,105659,41,4,24,23,1
2019,105659,45,0,24,23,1
2019,105659,45,4,24,23,1
2019,105668,0,0,47,17,30
2019,105668,10,0,20,5,15
2019,105668,10,6,20,5,15
2019,105668,20,0,13,5,8
2019,105668,20,6,13,5,8
2019,105668,30,0,7,0,7
2019,105668,30,6,7,0,7
2019,105668,50,0,27,12,15
2019,105747,0,0,143,72,71
2019,105747,10,0,143,72,71
2019,105747,10,6,143,72,71
2019,105747,20,0,101,57,44
2019,105747,20,6,101,57,44
2019,105747,30,0,37,13,24
2019,105747,30,6,37,13,24
2019,105747,40,0,5,2,3
2019,105747,40,6,5,2,3
2019,105747,42,0,5,2,3
2019,105747,42,6,5,2,3
2019,105792,0,0,61,29,32
2019,105792,10,0,61,29,32
2019,105792,10,6,61,29,32
2019,105792,20,0,35,17,18
2019,105792,20,6,35,17,18
2019,105792,30,0,21,10,11
2019,105792,30,6,21,10,11
2019,105792,40,0,5,2,3
2019,105792,40,6,5,2,3
2019,105792,42,0,4,2,2
2019,105792,42,6,4,2,2
2019,105792,43,0,1,0,1
2019,105792,43,6,1,0,1
2019,105899,0,0,24,16,8
2019,105899,10,0,24,16,8
2019,105899,10,1,2,1,1
2019,105899,10,2,8,4,4
2019,105899,10,3,11,9,2
2019,105899,10,4,3,2,1
2019,105899,40,0,24,16,8
2019,105899,40,1,2,1,1
2019,105899,40,2,8,4,4
2019,105899,40,3,11,9,2
2019,105899,40,4,3,2,1
2019,105899,42,0,24,16,8
2019,105899,42,1,2,1,1
2019,105899,42,2,8,4,4
2019,105899,42,3,11,9,2
2019,105899,42,4,3,2,1
2019,106041,0,0,47,47,0
2019,106041,50,0,47,47,0
2019,106148,0,0,115,58,57
2019,106148,10,0,115,58,57
2019,106148,10,4,115,58,57
2019,106148,40,0,115,58,57
2019,106148,40,4,115,58,57
2019,106148,42,0,115,58,57
2019,106148,42,4,115,58,57
2019,106245,0,0,394,236,158
2019,106245,10,0,394,236,158
2019,106245,10,1,124,88,36
2019,106245,10,2,101,63,38
2019,106245,10,3,97,49,48
2019,106245,10,4,72,36,36
2019,106245,20,0,222,147,75
2019,106245,20,1,124,88,36
2019,106245,20,2,95,59,36
2019,106245,20,3,3,0,3
2019,106245,30,0,89,51,38
2019,106245,30,2,5,4,1
2019,106245,30,3,84,47,37
2019,106245,40,0,83,38,45
2019,106245,40,2,1,0,1
2019,106245,40,3,10,2,8
2019,106245,40,4,72,36,36
2019,106245,42,0,83,38,45
2019,106245,42,2,1,0,1
2019,106245,42,3,10,2,8
2019,106245,42,4,72,36,36
2019,106263,0,0,220,100,120
2019,106263,10,0,215,97,118
2019,106263,10,1,41,29,12
2019,106263,10,2,52,32,20
2019,106263,10,3,100,29,71
2019,106263,10,4,17,4,13
2019,106263,10,6,5,3,2
2019,106263,20,0,64,42,22
2019,106263,20,1,35,24,11
2019,106263,20,2,29,18,11
2019,106263,30,0,126,44,82
2019,106263,30,1,4,3,1
2019,106263,30,2,19,12,7
2019,106263,30,3,93,28,65
2019,106263,30,4,10,1,9
2019,106263,40,0,25,11,14
2019,106263,40,1,2,2,0
2019,106263,40,2,4,2,2
2019,106263,40,3,7,1,6
2019,106263,40,4,7,3,4
2019,106263,40,6,5,3,2
2019,106263,42,0,25,11,14
2019,106263,42,1,2,2,0
2019,106263,42,2,4,2,2
2019,106263,42,3,7,1,6
2019,106263,42,4,7,3,4
2019,106263,42,6,5,3,2
2019,106263,50,0,5,3,2
2019,106306,0,0,8,4,4
2019,106306,10,0,8,4,4
2019,106306,10,1,1,1,0
2019,106306,10,4,7,3,4
2019,106306,40,0,8,4,4
2019,106306,40,1,1,1,0
2019,106306,40,4,7,3,4
2019,106306,42,0,8,4,4
2019,106306,42,1,1,1,0
2019,106306,42,4,7,3,4
2019,106342,0,0,52,33,19
2019,106342,10,0,52,33,19
2019,106342,10,1,9,8,1
2019,106342,10,2,13,9,4
2019,106342,10,3,29,15,14
2019,106342,10,4,1,1,0
2019,106342,20,0,27,21,6
2019,106342,20,1,9,8,1
2019,106342,20,2,12,9,3
2019,106342,20,3,6,4,2
2019,106342,30,0,17,9,8
2019,106342,30,2,1,0,1
2019,106342,30,3,16,9,7
2019,106342,40,0,8,3,5
2019,106342,40,3,7,2,5
2019,106342,40,4,1,1,0
2019,106342,41,0,8,3,5
2019,106342,41,3,7,2,5
2019,106342,41,4,1,1,0
2019,106342,44,0,8,3,5
2019,106342,44,3,7,2,5
2019,106342,44,4,1,1,0
2019,106397,0,0,1217,718,499
2019,106397,10,0,1217,718,499
2019,106397,10,1,320,247,73
2019,106397,10,2,271,177,94
2019,106397,10,3,235,136,99
2019,106397,10,4,281,114,167
2019,106397,10,5,110,44,66
2019,106397,20,0,569,408,161
2019,106397,20,1,312,241,71
2019,106397,20,2,257,167,90
2019,106397,30,0,237,137,100
2019,106397,30,2,5,3,2
2019,106397,30,3,232,134,98
2019,106397,40,0,411,173,238
2019,106397,40,1,8,6,2
2019,106397,40,2,9,7,2
2019,106397,40,3,3,2,1
2019,106397,40,4,281,114,167
2019,106397,40,5,110,44,66
2019,106397,41,0,188,85,103
2019,106397,41,1,7,5,2
2019,106397,41,2,9,7,2
2019,106397,41,3,3,2,1
2019,106397,41,4,107,47,60
2019,106397,41,5,62,24,38
2019,106397,42,0,176,65,111
2019,106397,42,4,145,52,93
2019,106397,42,5,31,13,18
2019,106397,43,0,47,23,24
2019,106397,43,1,1,1,0
2019,106397,43,4,29,15,14
2019,106397,43,5,17,7,10
2019,106397,44,0,188,85,103
2019,106397,44,1,7,5,2
2019,106397,44,2,9,7,2
2019,106397,44,3,3,2,1
2019,106397,44,4,107,47,60
2019,106397,44,5,62,24,38
2019,106412,0,0,153,89,64
2019,106412,10,0,153,89,64
2019,106412,10,1,19,13,6
2019,106412,10,2,26,18,8
2019,106412,10,3,49,32,17
2019,106412,10,4,59,26,33
2019,106412,20,0,47,32,15
2019,106412,20,1,19,13,6
2019,106412,20,2,20,15,5
2019,106412,20,3,8,4,4
2019,106412,30,0,44,24,20
2019,106412,30,2,6,3,3
2019,106412,30,3,33,20,13
2019,106412,30,4,5,1,4
2019,106412,40,0,62,33,29
2019,106412,40,3,8,8,0
2019,106412,40,4,54,25,29
2019,106412,42,0,62,33,29
2019,106412,42,3,8,8,0
2019,106412,42,4,54,25,29
2019,106449,0,0,103,49,54
2019,106449,10,0,103,49,54
2019,106449,10,1,3,3,0
2019,106449,10,2,11,4,7
2019,106449,10,3,32,17,15
2019,106449,10,4,57,25,32
2019,106449,20,0,16,13,3
2019,106449,20,1,3,3,0
2019,106449,20,2,7,4,3
2019,106449,20,3,6,6,0
2019,106449,30,0,2,0,2
2019,106449,30,2,1,0,1
2019,106449,30,3,1,0,1
2019,106449,40,0,85,36,49
2019,106449,40,2,3,0,3
2019,106449,40,3,25,11,14
2019,106449,40,4,57,25,32
2019,106449,42,0,85,36,49
2019,106449,42,2,3,0,3
2019,106449,42,3,25,11,14
2019,106449,42,4,57,25,32
2019,106458,0,0,518,239,279
2019,106458,10,0,518,239,279
2019,106458,10,1,110,66,44
2019,106458,10,2,125,64,61
2019,106458,10,3,150,59,91
2019,106458,10,4,133,50,83
2019,106458,20,0,225,122,103
2019,106458,20,1,108,65,43
2019,106458,20,2,109,55,54
2019,106458,20,3,8,2,6
2019,106458,30,0,108,54,54
2019,106458,30,1,1,0,1
2019,106458,30,2,16,9,7
2019,106458,30,3,89,44,45
2019,106458,30,4,2,1,1
2019,106458,40,0,185,63,122
2019,106458,40,1,1,1,0
2019,106458,40,3,53,13,40
2019,106458,40,4,131,49,82
2019,106458,42,0,185,63,122
2019,106458,42,1,1,1,0
2019,106458,42,3,53,13,40
2019,106458,42,4,131,49,82
2019,106467,0,0,355,176,179
2019,106467,10,0,352,174,178
2019,106467,10,1,81,53,28
2019,106467,10,2,73,40,33
2019,106467,10,3,93,48,45
2019,106467,10,4,44,10,34
2019,106467,10,6,61,23,38
2019,106467,20,0,143,85,58
2019,106467,20,1,74,46,28
2019,106467,20,2,64,36,28
2019,106467,20,3,5,3,2
2019,106467,30,0,87,51,36
2019,106467,30,1,5,5,0
2019,106467,30,2,8,4,4
2019,106467,30,3,74,42,32
2019,106467,40,0,122,38,84
2019,106467,40,1,2,2,0
2019,106467,40,2,1,0,1
2019,106467,40,3,14,3,11
2019,106467,40,4,44,10,34
2019,106467,40,6,61,23,38
2019,106467,42,0,122,38,84
2019,106467,42,1,2,2,0
2019,106467,42,2,1,0,1
2019,106467,42,3,14,3,11
2019,106467,42,4,44,10,34
2019,106467,42,6,61,23,38
2019,106467,50,0,3,2,1
2019,106485,0,0,158,78,80
2019,106485,10,0,158,78,80
2019,106485,10,1,26,23,3
2019,106485,10,2,32,15,17
2019,106485,10,3,30,15,15
2019,106485,10,4,70,25,45
2019,106485,20,0,61,38,23
2019,106485,20,1,26,23,3
2019,106485,20,2,32,15,17
2019,106485,20,4,3,0,3
2019,106485,30,0,29,14,15
2019,106485,30,3,29,14,15
2019,106485,40,0,68,26,42
2019,106485,40,3,1,1,0
2019,106485,40,4,67,25,42
2019,106485,42,0,68,26,42
2019,106485,42,3,1,1,0
2019,106485,42,4,67,25,42
2019,106546,0,0,53,3,50
2019,106546,10,0,53,3,50
2019,106546,10,6,53,3,50
2019,106546,40,0,53,3,50
2019,106546,40,6,53,3,50
2019,106546,41,0,53,3,50
2019,106546,41,6,53,3,50
2019,106546,45,0,53,3,50
2019,106546,45,6,53,3,50
2019,106625,0,0,64,23,41
2019,106625,10,0,64,23,41
2019,106625,10,6,64,23,41
2019,106625,40,0,64,23,41
2019,106625,40,6,64,23,41
2019,106625,42,0,64,23,41
2019,106625,42,6,64,23,41
2019,106704,0,0,550,265,285
2019,106704,10,0,550,265,285
2019,106704,10,1,100,67,33
2019,106704,10,2,138,78,60
2019,106704,10,3,130,64,66
2019,106704,10,4,67,12,55
2019,106704,10,5,85,33,52
2019,106704,10,6,30,11,19
2019,106704,20,0,245,150,95
2019,106704,20,1,99,67,32
2019,106704,20,2,137,77,60
2019,106704,20,3,9,6,3
2019,106704,30,0,124,60,64
2019,106704,30,3,121,58,63
2019,106704,30,4,3,2,1
2019,106704,40,0,181,55,126
2019,106704,40,1,1,0,1
2019,106704,40,2,1,1,0
2019,106704,40,4,64,10,54
2019,106704,40,5,85,33,52
2019,106704,40,6,30,11,19
2019,106704,41,0,151,44,107
2019,106704,41,1,1,0,1
2019,106704,41,2,1,1,0
2019,106704,41,4,64,10,54
2019,106704,41,5,85,33,52
2019,106704,42,0,30,11,19
2019,106704,42,6,30,11,19
2019,106704,45,0,151,44,107
2019,106704,45,1,1,0,1
2019,106704,45,2,1,1,0
2019,106704,45,4,64,10,54
2019,106704,45,5,85,33,52
2019,106713,0,0,28,16,12
2019,106713,10,0,28,16,12
2019,106713,10,1,8,4,4
2019,106713,10,2,5,4,1
2019,106713,10,3,14,7,7
2019,106713,10,4,1,1,0
2019,106713,40,0,28,16,12
2019,106713,40,1,8,4,4
2019,106713,40,2,5,4,1
2019,106713,40,3,14,7,7
2019,106713,40,4,1,1,0
2019,106713,41,0,28,16,12
2019,106713,41,1,8,4,4
2019,106713,41,2,5,4,1
2019,106713,41,3,14,7,7
2019,106713,41,4,1,1,0
2019,106713,45,0,28,16,12
2019,106713,45,1,8,4,4
2019,106713,45,2,5,4,1
2019,106713,45,3,14,7,7
2019,106713,45,4,1,1,0
2019,106795,0,0,39,10,29
2019,106795,10,0,39,10,29
2019,106795,10,4,39,10,29
2019,106795,40,0,39,10,29
2019,106795,40,4,39,10,29
2019,106795,42,0,39,10,29
2019,106795,42,4,39,10,29
2019,106810,0,0,13,8,5
2019,106810,10,0,13,8,5
2019,106810,10,2,2,2,0
2019,106810,10,3,9,5,4
2019,106810,10,4,2,1,1
2019,106810,40,0,13,8,5
2019,106810,40,2,2,2,0
2019,106810,40,3,9,5,4
2019,106810,40,4,2,1,1
2019,106810,42,0,13,8,5
2019,106810,42,2,2,2,0
2019,106810,42,3,9,5,4
2019,106810,42,4,2,1,1
2019,106883,0,0,46,24,22
2019,106883,10,0,46,24,22
2019,106883,10,6,46,24,22
2019,106883,40,0,46,24,22
2019,106883,40,6,46,24,22
2019,106883,42,0,5,4,1
2019,106883,42,6,5,4,1
2019,106883,43,0,41,20,21
2019,106883,43,6,41,20,21
2019,106980,0,0,99,35,64
2019,106980,10,0,99,35,64
2019,106980,10,4,99,35,64
2019,106980,40,0,99,35,64
2019,106980,40,4,99,35,64
2019,106980,42,0,5,2,3
2019,106980,42,4,5,2,3
2019,106980,43,0,94,33,61
2019,106980,43,4,94,33,61
2019,106999,0,0,47,14,33
2019,106999,10,0,40,12,28
2019,106999,10,6,40,12,28
2019,106999,40,0,40,12,28
2019,106999,40,6,40,12,28
2019,106999,42,0,40,12,28
2019,106999,42,6,40,12,28
2019,106999,50,0,7,2,5
2019,107044,0,0,322,200,122
2019,107044,10,0,322,200,122
2019,107044,10,1,69,60,9
2019,107044,10,2,103,62,41
2019,107044,10,3,113,63,50
2019,107044,10,4,29,12,17
2019,107044,10,5,8,3,5
2019,107044,40,0,322,200,122
2019,107044,40,1,69,60,9
2019,107044,40,2,103,62,41
2019,107044,40,3,113,63,50
2019,107044,40,4,29,12,17
2019,107044,40,5,8,3,5
2019,107044,41,0,255,162,93
2019,107044,41,1,64,55,9
2019,107044,41,2,97,59,38
2019,107044,41,3,86,47,39
2019,107044,41,4,8,1,7
2019,107044,42,0,67,38,29
2019,107044,42,1,5,5,0
2019,107044,42,2,6,3,3
2019,107044,42,3,27,16,11
2019,107044,42,4,21,11,10
2019,107044,42,5,8,3,5
2019,107044,44,0,130,73,57
2019,107044,44,1,2,2,0
2019,107044,44,2,53,30,23
2019,107044,44,3,67,40,27
2019,107044,44,4,8,1,7
2019,107044,45,0,125,89,36
2019,107044,45,1,62,53,9
2019,107044,45,2,44,29,15
2019,107044,45,3,19,7,12
2019,107071,0,0,187,96,91
2019,107071,10,0,187,96,91
2019,107071,10,1,52,40,12
2019,107071,10,2,42,18,24
2019,107071,10,3,63,22,41
2019,107071,10,4,26,12,14
2019,107071,10,5,4,4,0
2019,107071,20,0,78,53,25
2019,107071,20,1,51,39,12
2019,107071,20,2,26,13,13
2019,107071,20,3,1,1,0
2019,107071,30,0,58,18,40
2019,107071,30,1,1,1,0
2019,107071,30,2,14,4,10
2019,107071,30,3,43,13,30
2019,107071,40,0,51,25,26
2019,107071,40,2,2,1,1
2019,107071,40,3,19,8,11
2019,107071,40,4,26,12,14
2019,107071,40,5,4,4,0
2019,107071,42,0,51,25,26
2019,107071,42,2,2,1,1
2019,107071,42,3,19,8,11
2019,107071,42,4,26,12,14
2019,107071,42,5,4,4,0
2019,107080,0,0,104,56,48
2019,107080,10,0,104,56,48
2019,107080,10,1,44,26,18
2019,107080,10,2,27,16,11
2019,107080,10,3,24,10,14
2019,107080,10,4,9,4,5
2019,107080,20,0,71,42,29
2019,107080,20,1,44,26,18
2019,107080,20,2,27,16,11
2019,107080,30,0,19,9,10
2019,107080,30,3,19,9,10
2019,107080,40,0,14,5,9
2019,107080,40,3,5,1,4
2019,107080,40,4,9,4,5
2019,107080,41,0,9,3,6
2019,107080,41,3,2,0,2
2019,107080,41,4,7,3,4
2019,107080,42,0,5,2,3
2019,107080,42,3,3,1,2
2019,107080,42,4,2,1,1
2019,107080,44,0,5,2,3
2019,107080,44,3,2,0,2
2019,107080,44,4,3,2,1
2019,107080,45,0,4,1,3
2019,107080,45,4,4,1,3
2019,107141,0,0,86,60,26
2019,107141,10,0,86,60,26
2019,107141,10,1,23,23,0
2019,107141,10,2,35,26,9
2019,107141,10,3,26,9,17
2019,107141,10,4,2,2,0
2019,107141,40,0,86,60,26
2019,107141,40,1,23,23,0
2019,107141,40,2,35,26,9
2019,107141,40,3,26,9,17
2019,107141,40,4,2,2,0
2019,107141,41,0,86,60,26
2019,107141,41,1,23,23,0
2019,107141,41,2,35,26,9
2019,107141,41,3,26,9,17
2019,107141,41,4,2,2,0
2019,107141,44,0,86,60,26
2019,107141,44,1,23,23,0
2019,107141,44,2,35,26,9
2019,107141,44,3,26,9,17
2019,107141,44,4,2,2,0
2019,107318,0,0,43,26,17
2019,107318,10,0,43,26,17
2019,107318,10,4,43,26,17
2019,107318,40,0,43,26,17
2019,107318,40,4,43,26,17
2019,107318,42,0,43,26,17
2019,107318,42,4,43,26,17
2019,107327,0,0,50,24,26
2019,107327,10,0,50,24,26
2019,107327,10,1,1,0,1
2019,107327,10,2,6,4,2
2019,107327,10,3,3,0,3
2019,107327,10,6,40,20,20
2019,107327,40,0,50,24,26
2019,107327,40,1,1,0,1
2019,107327,40,2,6,4,2
2019,107327,40,3,3,0,3
2019,107327,40,6,40,20,20
2019,107327,42,0,50,24,26
2019,107327,42,1,1,0,1
2019,107327,42,2,6,4,2
2019,107327,42,3,3,0,3
2019,107327,42,6,40,20,20
2019,107460,0,0,65,32,33
2019,107460,10,0,65,32,33
2019,107460,10,1,6,0,6
2019,107460,10,2,8,3,5
2019,107460,10,3,13,6,7
2019,107460,10,4,38,23,15
2019,107460,40,0,65,32,33
2019,107460,40,1,6,0,6
2019,107460,40,2,8,3,5
2019,107460,40,3,13,6,7
2019,107460,40,4,38,23,15
2019,107460,42,0,65,32,33
2019,107460,42,1,6,0,6
2019,107460,42,2,8,3,5
2019,107460,42,3,13,6,7
2019,107460,42,4,38,23,15
2019,107512,0,0,103,62,41
2019,107512,10,0,103,62,41
2019,107512,10,1,40,33,7
2019,107512,10,2,27,13,14
2019,107512,10,3,24,10,14
2019,107512,10,4,6,3,3
2019,107512,10,5,6,3,3
2019,107512,20,0,66,47,19
2019,107512,20,1,40,33,7
2019,107512,20,2,22,12,10
2019,107512,20,3,4,2,2
2019,107512,30,0,20,7,13
2019,107512,30,2,5,1,4
2019,107512,30,3,13,5,8
2019,107512,30,4,2,1,1
2019,107512,40,0,17,8,9
2019,107512,40,3,7,3,4
2019,107512,40,4,4,2,2
2019,107512,40,5,6,3,3
2019,107512,42,0,17,8,9
2019,107512,42,3,7,3,4
2019,107512,42,4,4,2,2
2019,107512,42,5,6,3,3
2019,107521,0,0,38,12,26
2019,107521,10,0,35,12,23
2019,107521,10,4,35,12,23
2019,107521,40,0,35,12,23
2019,107521,40,4,35,12,23
2019,107521,42,0,35,12,23
2019,107521,42,4,35,12,23
2019,107521,50,0,3,0,3
2019,107549,0,0,34,15,19
2019,107549,10,0,34,15,19
2019,107549,10,4,34,15,19
2019,107549,40,0,34,15,19
2019,107549,40,4,34,15,19
2019,107549,42,0,34,15,19
2019,107549,42,4,34,15,19
2019,107558,0,0,50,28,22
2019,107558,10,0,50,28,22
2019,107558,10,1,17,12,5
2019,107558,10,2,7,1,6
2019,107558,10,3,17,11,6
2019,107558,10,4,9,4,5
2019,107558,20,0,21,13,8
2019,107558,20,1,17,12,5
2019,107558,20,2,4,1,3
2019,107558,30,0,18,10,8
2019,107558,30,2,3,0,3
2019,107558,30,3,15,10,5
2019,107558,40,0,11,5,6
2019,107558,40,3,2,1,1
2019,107558,40,4,9,4,5
2019,107558,41,0,4,2,2
2019,107558,41,4,4,2,2
2019,107558,42,0,7,3,4
2019,107558,42,3,2,1,1
2019,107558,42,4,5,2,3
2019,107558,45,0,4,2,2
2019,107558,45,4,4,2,2
2019,107585,0,0,55,26,29
2019,107585,10,0,55,26,29
2019,107585,10,6,55,26,29
2019,107585,40,0,55,26,29
2019,107585,40,6,55,26,29
2019,107585,42,0,55,26,29
2019,107585,42,6,55,26,29
2019,107600,0,0,48,22,26
2019,107600,10,0,48,22,26
2019,107600,10,1,2,1,1
2019,107600,10,2,12,8,4
2019,107600,10,3,20,9,11
2019,107600,10,4,14,4,10
2019,107600,20,0,8,3,5
2019,107600,20,1,1,0,1
2019,107600,20,2,7,3,4
2019,107600,30,0,20,11,9
2019,107600,30,1,1,1,0
2019,107600,30,2,3,3,0
2019,107600,30,3,15,7,8
2019,107600,30,4,1,0,1
2019,107600,40,0,20,8,12
2019,107600,40,2,2,2,0
2019,107600,40,3,5,2,3
2019,107600,40,4,13,4,9
2019,107600,42,0,20,8,12
2019,107600,42,2,2,2,0
2019,107600,42,3,5,2,3
2019,107600,42,4,13,4,9
2019,107619,0,0,59,22,37
2019,107619,10,0,59,22,37
2019,107619,10,4,59,22,37
2019,107619,40,0,59,22,37
2019,107619,40,4,59,22,37
2019,107619,42,0,59,22,37
2019,107619,42,4,59,22,37
2019,107637,0,0,47,17,30
2019,107637,10,0,47,17,30
2019,107637,10,4,47,17,30
2019,107637,40,0,47,17,30
2019,107637,40,4,47,17,30
2019,107637,42,0,7,0,7
2019,107637,42,4,7,0,7
2019,107637,43,0,40,17,23
2019,107637,43,4,40,17,23
2019,107664,0,0,170,81,89
2019,107664,10,0,170,81,89
2019,107664,10,6,170,81,89
2019,107664,40,0,170,81,89
2019,107664,40,6,170,81,89
2019,107664,42,0,11,5,6
2019,107664,42,6,11,5,6
2019,107664,43,0,159,76,83
2019,107664,43,6,159,76,83
2019,107725,0,0,47,14,33
2019,107725,10,0,45,14,31
2019,107725,10,4,45,14,31
2019,107725,40,0,45,14,31
2019,107725,40,4,45,14,31
2019,107725,42,0,45,14,31
2019,107725,42,4,45,14,31
2019,107725,50,0,2,0,2
2019,107743,0,0,18,6,12
2019,107743,10,0,18,6,12
2019,107743,10,4,18,6,12
2019,107743,40,0,18,6,12
2019,107743,40,4,18,6,12
2019,107743,42,0,18,6,12
2019,107743,42,4,18,6,12
2019,107840,0,0,11,5,6
2019,107840,10,0,11,5,6
2019,107840,10,6,11,5,6
2019,107840,40,0,11,5,6
2019,107840,40,6,11,5,6
2019,107840,42,0,11,5,6
2019,107840,42,6,11,5,6
2019,107877,0,0,30,17,13
2019,107877,10,0,28,16,12
2019,107877,10,1,5,4,1
2019,107877,10,2,5,3,2
2019,107877,10,3,15,7,8
2019,107877,10,4,3,2,1
2019,107877,20,0,10,6,4
2019,107877,20,1,5,4,1
2019,107877,20,2,3,1,2
2019,107877,20,3,2,1,1
2019,107877,30,0,14,7,7
2019,107877,30,2,2,2,0
2019,107877,30,3,12,5,7
2019,107877,40,0,4,3,1
2019,107877,40,3,1,1,0
2019,107877,40,4,3,2,1
2019,107877,42,0,4,3,1
2019,107877,42,3,1,1,0
2019,107877,42,4,3,2,1
2019,107877,50,0,2,1,1
2019,107974,0,0,51,18,33
2019,107974,10,0,47,16,31
2019,107974,10,1,8,2,6
2019,107974,10,2,2,0,2
2019,107974,10,3,5,0,5
2019,107974,10,4,32,14,18
2019,107974,20,0,5,1,4
2019,107974,20,1,5,1,4
2019,107974,40,0,42,15,27
2019,107974,40,1,3,1,2
2019,107974,40,2,2,0,2
2019,107974,40,3,5,0,5
2019,107974,40,4,32,14,18
2019,107974,42,0,42,15,27
2019,107974,42,1,3,1,2
2019,107974,42,2,2,0,2
2019,107974,42,3,5,0,5
2019,107974,42,4,32,14,18
2019,107974,50,0,4,2,2
2019,107983,0,0,166,90,76
2019,107983,10,0,166,90,76
2019,107983,10,1,21,13,8
2019,107983,10,2,41,24,17
2019,107983,10,3,61,33,28
2019,107983,10,4,43,20,23
2019,107983,20,0,61,34,27
2019,107983,20,1,21,13,8
2019,107983,20,2,37,21,16
2019,107983,20,3,3,0,3
2019,107983,30,0,52,31,21
2019,107983,30,2,3,3,0
2019,107983,30,3,48,27,21
2019,107983,30,4,1,1,0
2019,107983,40,0,53,25,28
2019,107983,40,2,1,0,1
2019,107983,40,3,10,6,4
2019,107983,40,4,42,19,23
2019,107983,42,0,53,25,28
2019,107983,42,2,1,0,1
2019,107983,42,3,10,6,4
2019,107983,42,4,42,19,23
2019,107992,0,0,39,19,20
2019,107992,10,0,39,19,20
2019,107992,10,6,39,19,20
2019,107992,40,0,39,19,20
2019,107992,40,6,39,19,20
2019,107992,42,0,39,19,20
2019,107992,42,6,39,19,20
2019,108092,0,0,225,106,119
2019,108092,10,0,225,106,119
2019,108092,10,1,34,20,14
2019,108092,10,2,52,31,21
2019,108092,10,3,75,33,42
2019,108092,10,4,51,14,37
2019,108092,10,6,13,8,5
2019,108092,20,0,13,10,3
2019,108092,20,1,6,5,1
2019,108092,20,2,4,4,0
2019,108092,20,3,3,1,2
2019,108092,40,0,212,96,116
2019,108092,40,1,28,15,13
2019,108092,40,2,48,27,21
2019,108092,40,3,72,32,40
2019,108092,40,4,51,14,37
2019,108092,40,6,13,8,5
2019,108092,41,0,134,70,64
2019,108092,41,1,28,15,13
2019,108092,41,2,46,25,21
2019,108092,41,3,60,30,30
2019,108092,42,0,78,26,52
2019,108092,42,2,2,2,0
2019,108092,42,3,12,2,10
2019,108092,42,4,51,14,37
2019,108092,42,6,13,8,5
2019,108092,44,0,134,70,64
2019,108092,44,1,28,15,13
2019,108092,44,2,46,25,21
2019,108092,44,3,60,30,30
2019,108232,0,0,219,124,95
2019,108232,10,0,219,124,95
2019,108232,10,6,219,124,95
2019,108232,40,0,219,124,95
2019,108232,40,6,219,124,95
2019,108232,41,0,219,124,95
2019,108232,41,6,219,124,95
2019,108232,45,0,219,124,95
2019,108232,45,6,219,124,95
2019,108667,0,0,77,37,40
2019,108667,10,0,77,37,40
2019,108667,10,4,77,37,40
2019,108667,20,0,45,29,16
2019,108667,20,4,45,29,16
2019,108667,30,0,21,5,16
2019,108667,30,4,21,5,16
2019,108667,40,0,11,3,8
2019,108667,40,4,11,3,8
2019,108667,43,0,11,3,8
2019,108667,43,4,11,3,8
2019,108807,0,0,169,78,91
2019,108807,10,0,169,78,91
2019,108807,10,4,169,78,91
2019,108807,20,0,100,47,53
2019,108807,20,4,100,47,53
2019,108807,30,0,58,26,32
2019,108807,30,4,58,26,32
2019,108807,40,0,11,5,6
2019,108807,40,4,11,5,6
2019,108807,42,0,5,3,2
2019,108807,42,4,5,3,2
2019,108807,43,0,6,2,4
2019,108807,43,4,6,2,4
2019,108852,0,0,8,2,6
2019,108852,10,0,8,2,6
2019,108852,10,4,8,2,6
2019,108852,40,0,8,2,6
2019,108852,40,4,8,2,6
2019,108852,43,0,8,2,6
2019,108852,43,4,8,2,6
2019,108861,0,0,5,2,3
2019,108861,10,0,5,2,3
2019,108861,10,1,3,1,2
2019,108861,10,2,2,1,1
2019,108861,20,0,3,1,2
2019,108861,20,1,3,1,2
2019,108861,40,0,2,1,1
2019,108861,40,2,2,1,1
2019,108861,41,0,2,1,1
2019,108861,41,2,2,1,1
2019,108861,44,0,2,1,1
2019,108861,44,2,2,1,1
2019,108870,0,0,12,8,4
2019,108870,10,0,12,8,4
2019,108870,10,1,6,4,2
2019,108870,10,5,6,4,2
2019,108870,40,0,12,8,4
2019,108870,40,1,6,4,2
2019,108870,40,5,6,4,2
2019,108870,42,0,12,8,4
2019,108870,42,1,6,4,2
2019,108870,42,5,6,4,2
2019,109040,0,0,32,12,20
2019,109040,50,0,32,12,20
2019,109086,0,0,5,2,3
2019,109086,10,0,5,2,3
2019,109086,10,6,5,2,3
2019,109086,40,0,5,2,3
2019,109086,40,6,5,2,3
2019,109086,41,0,1,1,0
2019,109086,41,6,1,1,0
2019,109086,43,0,4,1,3
2019,109086,43,6,4,1,3
2019,109086,45,0,1,1,0
2019,109086,45,6,1,1,0
2019,109208,0,0,400,172,228
2019,109208,10,0,400,172,228
2019,109208,10,4,400,172,228
2019,109208,20,0,302,135,167
2019,109208,20,4,302,135,167
2019,109208,30,0,91,34,57
2019,109208,30,4,91,34,57
2019,109208,40,0,7,3,4
2019,109208,40,4,7,3,4
2019,109208,43,0,7,3,4
2019,109208,43,4,7,3,4
2019,109350,0,0,168,96,72
2019,109350,10,0,162,93,69
2019,109350,10,1,51,26,25
2019,109350,10,2,65,42,23
2019,109350,10,4,24,13,11
2019,109350,10,6,22,12,10
2019,109350,20,0,130,76,54
2019,109350,20,1,50,26,24
2019,109350,20,2,65,42,23
2019,109350,20,4,12,6,6
2019,109350,20,6,3,2,1
2019,109350,30,0,32,17,15
2019,109350,30,1,1,0,1
2019,109350,30,4,12,7,5
2019,109350,30,6,19,10,9
2019,109350,50,0,6,3,3
2019,109651,0,0,134,92,42
2019,109651,10,0,134,92,42
2019,109651,10,1,56,38,18
2019,109651,10,2,63,44,19
2019,109651,10,3,13,9,4
2019,109651,10,4,2,1,1
2019,109651,40,0,134,92,42
2019,109651,40,1,56,38,18
2019,109651,40,2,63,44,19
2019,109651,40,3,13,9,4
2019,109651,40,4,2,1,1
2019,109651,41,0,69,44,25
2019,109651,41,1,36,23,13
2019,109651,41,2,30,20,10
2019,109651,41,3,3,1,2
2019,109651,42,0,65,48,17
2019,109651,42,1,20,15,5
2019,109651,42,2,33,24,9
2019,109651,42,3,10,8,2
2019,109651,42,4,2,1,1
2019,109651,44,0,69,44,25
2019,109651,44,1,36,23,13
2019,109651,44,2,30,20,10
2019,109651,44,3,3,1,2
2019,109785,0,0,449,194,255
2019,109785,10,0,447,193,254
2019,109785,10,1,135,78,57
2019,109785,10,2,117,60,57
2019,109785,10,3,175,54,121
2019,109785,10,4,20,1,19
2019,109785,40,0,447,193,254
2019,109785,40,1,135,78,57
2019,109785,40,2,117,60,57
2019,109785,40,3,175,54,121
2019,109785,40,4,20,1,19
2019,109785,41,0,273,132,141
2019,109785,41,1,119,66,53
2019,109785,41,2,91,49,42
2019,109785,41,3,60,17,43
2019,109785,41,4,3,0,3
2019,109785,42,0,174,61,113
2019,109785,42,1,16,12,4
2019,109785,42,2,26,11,15
2019,109785,42,3,115,37,78
2019,109785,42,4,17,1,16
2019,109785,44,0,273,132,141
2019,109785,44,1,119,66,53
2019,109785,44,2,91,49,42
2019,109785,44,3,60,17,43
2019,109785,44,4,3,0,3
2019,109785,50,0,2,1,1
2019,109819,0,0,367,193,174
2019,109819,10,0,367,193,174
2019,109819,10,4,367,193,174
2019,109819,20,0,178,95,83
2019,109819,20,4,178,95,83
2019,109819,30,0,153,79,74
2019,109819,30,4,153,79,74
2019,109819,40,0,36,19,17
2019,109819,40,4,36,19,17
2019,109819,42,0,2,1,1
2019,109819,42,4,2,1,1
2019,109819,43,0,34,18,16
2019,109819,43,4,34,18,16
2019,109907,0,0,43,24,19
2019,109907,10,0,43,24,19
2019,109907,10,1,21,12,9
2019,109907,10,2,12,7,5
2019,109907,10,3,9,4,5
2019,109907,10,4,1,1,0
2019,109907,20,0,25,15,10
2019,109907,20,1,16,10,6
2019,109907,20,2,6,4,2
2019,109907,20,3,3,1,2
2019,109907,30,0,18,9,9
2019,109907,30,1,5,2,3
2019,109907,30,2,6,3,3
2019,109907,30,3,6,3,3
2019,109907,30,4,1,1,0
2019,110060,0,0,8,7,1
2019,110060,10,0,8,7,1
2019,110060,10,6,8,7,1
2019,110060,40,0,8,7,1
2019,110060,40,6,8,7,1
2019,110060,42,0,8,7,1
2019,110060,42,6,8,7,1
2019,110097,0,0,276,172,104
2019,110097,10,0,276,172,104
2019,110097,10,1,67,61,6
2019,110097,10,2,142,80,62
2019,110097,10,3,47,21,26
2019,110097,10,4,20,10,10
2019,110097,20,0,235,152,83
2019,110097,20,1,67,61,6
2019,110097,20,2,136,75,61
2019,110097,20,3,32,16,16
2019,110097,30,0,41,20,21
2019,110097,30,2,6,5,1
2019,110097,30,3,15,5,10
2019,110097,30,4,20,10,10
2019,110219,0,0,12,6,6
2019,110219,10,0,12,6,6
2019,110219,10,4,12,6,6
2019,110219,40,0,12,6,6
2019,110219,40,4,12,6,6
2019,110219,41,0,12,6,6
2019,110219,41,4,12,6,6
2019,110219,45,0,12,6,6
2019,110219,45,4,12,6,6
2019,110246,0,0,214,99,115
2019,110246,10,0,214,99,115
2019,110246,10,4,214,99,115
2019,110246,20,0,130,62,68
2019,110246,20,4,130,62,68
2019,110246,30,0,65,29,36
2019,110246,30,4,65,29,36
2019,110246,40,0,19,8,11
2019,110246,40,4,19,8,11
2019,110246,42,0,19,8,11
2019,110246,42,4,19,8,11
2019,110316,0,0,58,27,31
2019,110316,10,0,58,27,31
2019,110316,10,1,26,17,9
2019,110316,10,2,13,5,8
2019,110316,10,3,11,2,9
2019,110316,10,5,8,3,5
2019,110316,40,0,58,27,31
2019,110316,40,1,26,17,9
2019,110316,40,2,13,5,8
2019,110316,40,3,11,2,9
2019,110316,40,5,8,3,5
2019,110316,41,0,48,23,25
2019,110316,41,1,25,16,9
2019,110316,41,2,11,4,7
2019,110316,41,3,9,2,7
2019,110316,41,5,3,1,2
2019,110316,42,0,10,4,6
2019,110316,42,1,1,1,0
2019,110316,42,2,2,1,1
2019,110316,42,3,2,0,2
2019,110316,42,5,5,2,3
2019,110316,44,0,48,23,25
2019,110316,44,1,25,16,9
2019,110316,44,2,11,4,7
2019,110316,44,3,9,2,7
2019,110316,44,5,3,1,2
2019,110334,0,0,211,85,126
2019,110334,10,0,211,85,126
2019,110334,10,4,211,85,126
2019,110334,20,0,108,53,55
2019,110334,20,4,108,53,55
2019,110334,30,0,59,20,39
2019,110334,30,4,59,20,39
2019,110334,40,0,44,12,32
2019,110334,40,4,44,12,32
2019,110334,42,0,44,12,32
2019,110334,42,4,44,12,32
2019,110361,0,0,353,191,162
2019,110361,10,0,353,191,162
2019,110361,10,1,112,76,36
2019,110361,10,2,95,47,48
2019,110361,10,3,121,54,67
2019,110361,10,4,10,5,5
2019,110361,10,5,15,9,6
2019,110361,20,0,136,77,59
2019,110361,20,1,93,60,33
2019,110361,20,2,43,17,26
2019,110361,30,0,192,100,92
2019,110361,30,1,19,16,3
2019,110361,30,2,52,30,22
2019,110361,30,3,121,54,67
2019,110361,40,0,25,14,11
2019,110361,40,4,10,5,5
2019,110361,40,5,15,9,6
2019,110361,42,0,25,14,11
2019,110361,42,4,10,5,5
2019,110361,42,5,15,9,6
2019,110370,0,0,111,53,58
2019,110370,10,0,111,53,58
2019,110370,10,1,31,18,13
2019,110370,10,2,53,27,26
2019,110370,10,3,27,8,19
2019,110370,20,0,48,28,20
2019,110370,20,1,26,16,10
2019,110370,20,2,22,12,10
2019,110370,30,0,31,13,18
2019,110370,30,2,9,6,3
2019,110370,30,3,22,7,15
2019,110370,40,0,32,12,20
2019,110370,40,1,5,2,3
2019,110370,40,2,22,9,13
2019,110370,40,3,5,1,4
2019,110370,41,0,32,12,20
2019,110370,41,1,5,2,3
2019,110370,41,2,22,9,13
2019,110370,41,3,5,1,4
2019,110370,44,0,32,12,20
2019,110370,44,1,5,2,3
2019,110370,44,2,22,9,13
2019,110370,44,3,5,1,4
2019,110398,0,0,65,30,35
2019,110398,10,0,65,30,35
2019,110398,10,1,43,22,21
2019,110398,10,2,6,1,5
2019,110398,10,5,16,7,9
2019,110398,20,0,37,21,16
2019,110398,20,1,37,21,16
2019,110398,30,0,3,1,2
2019,110398,30,2,3,1,2
2019,110398,40,0,25,8,17
2019,110398,40,1,6,1,5
2019,110398,40,2,3,0,3
2019,110398,40,5,16,7,9
2019,110398,41,0,22,7,15
2019,110398,41,1,5,0,5
2019,110398,41,2,3,0,3
2019,110398,41,5,14,7,7
2019,110398,42,0,2,0,2
2019,110398,42,5,2,0,2
2019,110398,43,0,1,1,0
2019,110398,43,1,1,1,0
2019,110398,44,0,22,7,15
2019,110398,44,1,5,0,5
2019,110398,44,2,3,0,3
2019,110398,44,5,14,7,7
2019,110404,0,0,348,269,79
2019,110404,10,0,338,262,76
2019,110404,10,1,255,205,50
2019,110404,10,2,2,1,1
2019,110404,10,3,44,30,14
2019,110404,10,4,15,10,5
2019,110404,10,5,18,12,6
2019,110404,10,6,4,4,0
2019,110404,20,0,255,205,50
2019,110404,20,1,255,205,50
2019,110404,30,0,46,31,15
2019,110404,30,2,2,1,1
2019,110404,30,3,44,30,14
2019,110404,40,0,37,26,11
2019,110404,40,4,15,10,5
2019,110404,40,5,18,12,6
2019,110404,40,6,4,4,0
2019,110404,41,0,28,18,10
2019,110404,41,4,12,8,4
2019,110404,41,5,16,10,6
2019,110404,42,0,2,2,0
2019,110404,42,4,1,1,0
2019,110404,42,5,1,1,0
2019,110404,43,0,7,6,1
2019,110404,43,4,2,1,1
2019,110404,43,5,1,1,0
2019,110404,43,6,4,4,0
2019,110404,44,0,28,18,10
2019,110404,44,4,12,8,4
2019,110404,44,5,16,10,6
2019,110404,50,0,10,7,3
2019,110413,0,0,196,96,100
2019,110413,10,0,196,96,100
2019,110413,10,1,63,34,29
2019,110413,10,2,52,24,28
2019,110413,10,3,49,25,24
2019,110413,10,4,2,1,1
2019,110413,10,5,30,12,18
2019,110413,20,0,111,56,55
2019,110413,20,1,57,30,27
2019,110413,20,2,50,23,27
2019,110413,20,3,4,3,1
2019,110413,30,0,39,18,21
2019,110413,30,1,1,1,0
2019,110413,30,2,2,1,1
2019,110413,30,3,34,15,19
2019,110413,30,4,1,0,1
2019,110413,30,5,1,1,0
2019,110413,40,0,46,22,24
2019,110413,40,1,5,3,2
2019,110413,40,3,11,7,4
2019,110413,40,4,1,1,0
2019,110413,40,5,29,11,18
2019,110413,41,0,5,3,2
2019,110413,41,1,5,3,2
2019,110413,42,0,41,19,22
2019,110413,42,3,11,7,4
2019,110413,42,4,1,1,0
2019,110413,42,5,29,11,18
2019,110413,44,0,5,3,2
2019,110413,44,1,5,3,2
2019,110422,0,0,894,564,330
2019,110422,10,0,894,564,330
2019,110422,10,1,330,235,95
2019,110422,10,2,141,89,52
2019,110422,10,3,201,103,98
2019,110422,10,5,218,135,83
2019,110422,10,6,4,2,2
2019,110422,20,0,449,306,143
2019,110422,20,1,326,232,94
2019,110422,20,2,119,72,47
2019,110422,20,6,4,2,2
2019,110422,30,0,227,123,104
2019,110422,30,1,4,3,1
2019,110422,30,2,22,17,5
2019,110422,30,3,201,103,98
2019,110422,40,0,218,135,83
2019,110422,40,5,218,135,83
2019,110422,41,0,93,51,42
2019,110422,41,5,93,51,42
2019,110422,42,0,116,80,36
2019,110422,42,5,116,80,36
2019,110422,43,0,9,4,5
2019,110422,43,5,9,4,5
2019,110422,44,0,93,51,42
2019,110422,44,5,93,51,42
2019,110468,0,0,112,52,60
2019,110468,10,0,112,52,60
2019,110468,10,1,44,30,14
2019,110468,10,2,32,14,18
2019,110468,10,3,34,8,26
2019,110468,10,6,2,0,2
2019,110468,40,0,112,52,60
2019,110468,40,1,44,30,14
2019,110468,40,2,32,14,18
2019,110468,40,3,34,8,26
2019,110468,40,6,2,0,2
2019,110468,41,0,112,52,60
2019,110468,41,1,44,30,14
2019,110468,41,2,32,14,18
2019,110468,41,3,34,8,26
2019,110468,41,6,2,0,2
2019,110468,44,0,112,52,60
2019,110468,44,1,44,30,14
2019,110468,44,2,32,14,18
2019,110468,44,3,34,8,26
2019,110468,44,6,2,0,2
2019,110486,0,0,318,176,142
2019,110486,10,0,318,176,142
2019,110486,10,1,77,47,30
2019,110486,10,2,44,25,19
2019,110486,10,3,100,58,42
2019,110486,10,5,97,46,51
2019,110486,20,0,119,72,47
2019,110486,20,1,77,47,30
2019,110486,20,2,42,25,17
2019,110486,30,0,102,58,44
2019,110486,30,2,2,0,2
2019,110486,30,3,100,58,42
2019,110486,40,0,97,46,51
2019,110486,40,5,97,46,51
2019,110486,41,0,44,16,28
2019,110486,41,5,44,16,28
2019,110486,42,0,50,28,22
2019,110486,42,5,50,28,22
2019,110486,43,0,3,2,1
2019,110486,43,5,3,2,1
2019,110486,44,0,44,16,28
2019,110486,44,5,44,16,28
2019,110495,0,0,355,190,165
2019,110495,10,0,355,190,165
2019,110495,10,1,134,79,55
2019,110495,10,2,53,33,20
2019,110495,10,3,83,37,46
2019,110495,10,5,85,41,44
2019,110495,20,0,183,110,73
2019,110495,20,1,134,79,55
2019,110495,20,2,49,31,18
2019,110495,30,0,87,39,48
2019,110495,30,2,4,2,2
2019,110495,30,3,83,37,46
2019,110495,40,0,85,41,44
2019,110495,40,5,85,41,44
2019,110495,41,0,54,29,25
2019,110495,41,5,54,29,25
2019,110495,42,0,29,11,18
2019,110495,42,5,29,11,18
2019,110495,43,0,2,1,1
2019,110495,43,5,2,1,1
2019,110495,44,0,54,29,25
2019,110495,44,5,54,29,25
2019,110510,0,0,504,249,255
2019,110510,10,0,504,249,255
2019,110510,10,1,192,112,80
2019,110510,10,2,67,31,36
2019,110510,10,3,125,59,66
2019,110510,10,5,120,47,73
2019,110510,20,0,255,144,111
2019,110510,20,1,191,112,79
2019,110510,20,2,60,29,31
2019,110510,20,3,4,3,1
2019,110510,30,0,129,58,71
2019,110510,30,1,1,0,1
2019,110510,30,2,7,2,5
2019,110510,30,3,121,56,65
2019,110510,40,0,120,47,73
2019,110510,40,5,120,47,73
2019,110510,41,0,69,22,47
2019,110510,41,5,69,22,47
2019,110510,42,0,45,21,24
2019,110510,42,5,45,21,24
2019,110510,43,0,6,4,2
2019,110510,43,5,6,4,2
2019,110510,44,0,69,22,47
2019,110510,44,5,69,22,47
2019,110529,0,0,640,370,270
2019,110529,10,0,640,370,270
2019,110529,10,1,252,155,97
2019,110529,10,2,97,53,44
2019,110529,10,3,177,101,76
2019,110529,10,5,114,61,53
2019,110529,20,0,340,204,136
2019,110529,20,1,252,155,97
2019,110529,20,2,88,49,39
2019,110529,30,0,186,105,81
2019,110529,30,2,9,4,5
2019,110529,30,3,177,101,76
2019,110529,40,0,114,61,53
2019,110529,40,5,114,61,53
2019,110529,41,0,72,41,31
2019,110529,41,5,72,41,31
2019,110529,42,0,37,17,20
2019,110529,42,5,37,17,20
2019,110529,43,0,5,3,2
2019,110529,43,5,5,3,2
2019,110529,44,0,72,41,31
2019,110529,44,5,72,41,31
2019,110538,0,0,530,269,261
2019,110538,10,0,530,269,261
2019,110538,10,1,188,114,74
2019,110538,10,2,83,40,43
2019,110538,10,3,152,68,84
2019,110538,10,5,107,47,60
2019,110538,20,0,265,150,115
2019,110538,20,1,188,114,74
2019,110538,20,2,76,36,40
2019,110538,20,3,1,0,1
2019,110538,30,0,158,72,86
2019,110538,30,2,7,4,3
2019,110538,30,3,151,68,83
2019,110538,40,0,107,47,60
2019,110538,40,5,107,47,60
2019,110538,41,0,64,31,33
2019,110538,41,5,64,31,33
2019,110538,42,0,41,15,26
2019,110538,42,5,41,15,26
2019,110538,43,0,2,1,1
2019,110538,43,5,2,1,1
2019,110538,44,0,64,31,33
2019,110538,44,5,64,31,33
2019,110547,0,0,403,187,216
2019,110547,10,0,403,187,216
2019,110547,10,1,103,60,43
2019,110547,10,2,62,24,38
2019,110547,10,3,110,44,66
2019,110547,10,5,128,59,69
2019,110547,20,0,155,78,77
2019,110547,20,1,101,58,43
2019,110547,20,2,54,20,34
2019,110547,30,0,120,50,70
2019,110547,30,1,2,2,0
2019,110547,30,2,8,4,4
2019,110547,30,3,110,44,66
2019,110547,40,0,128,59,69
2019,110547,40,5,128,59,69
2019,110547,41,0,71,44,27
2019,110547,41,5,71,44,27
2019,110547,42,0,48,12,36
2019,110547,42,5,48,12,36
2019,110547,43,0,9,3,6
2019,110547,43,5,9,3,6
2019,110547,44,0,71,44,27
2019,110547,44,5,71,44,27
2019,110556,0,0,787,412,375
2019,110556,10,0,787,412,375
2019,110556,10,1,228,154,74
2019,110556,10,2,128,61,67
2019,110556,10,3,227,113,114
2019,110556,10,5,199,80,119
2019,110556,10,6,5,4,1
2019,110556,20,0,349,212,137
2019,110556,20,1,227,153,74
2019,110556,20,2,119,56,63
2019,110556,20,6,3,3,0
2019,110556,30,0,239,120,119
2019,110556,30,1,1,1,0
2019,110556,30,2,9,5,4
2019,110556,30,3,227,113,114
2019,110556,30,6,2,1,1
2019,110556,40,0,199,80,119
2019,110556,40,5,199,80,119
2019,110556,41,0,140,56,84
2019,110556,41,5,140,56,84
2019,110556,42,0,57,23,34
2019,110556,42,5,57,23,34
2019,110556,43,0,2,1,1
2019,110556,43,5,2,1,1
2019,110556,44,0,140,56,84
2019,110556,44,5,140,56,84
2019,110565,0,0,1007,498,509
2019,110565,10,0,1007,498,509
2019,110565,10,1,348,200,148
2019,110565,10,2,220,105,115
2019,110565,10,3,222,103,119
2019,110565,10,5,217,90,127
2019,110565,20,0,552,295,257
2019,110565,20,1,348,200,148
2019,110565,20,2,204,95,109
2019,110565,30,0,238,113,125
2019,110565,30,2,16,10,6
2019,110565,30,3,222,103,119
2019,110565,40,0,217,90,127
2019,110565,40,5,217,90,127
2019,110565,41,0,147,65,82
2019,110565,41,5,147,65,82
2019,110565,42,0,67,22,45
2019,110565,42,5,67,22,45
2019,110565,43,0,3,3,0
2019,110565,43,5,3,3,0
2019,110565,44,0,147,65,82
2019,110565,44,5,147,65,82
2019,110574,0,0,383,187,196
2019,110574,10,0,383,187,196
2019,110574,10,1,126,68,58
2019,110574,10,2,74,37,37
2019,110574,10,3,126,61,65
2019,110574,10,5,57,21,36
2019,110574,20,0,193,98,95
2019,110574,20,1,123,67,56
2019,110574,20,2,67,30,37
2019,110574,20,3,3,1,2
2019,110574,30,0,133,68,65
2019,110574,30,1,3,1,2
2019,110574,30,2,7,7,0
2019,110574,30,3,123,60,63
2019,110574,40,0,57,21,36
2019,110574,40,5,57,21,36
2019,110574,41,0,46,15,31
2019,110574,41,5,46,15,31
2019,110574,42,0,11,6,5
2019,110574,42,5,11,6,5
2019,110574,44,0,46,15,31
2019,110574,44,5,46,15,31
2019,110583,0,0,1077,520,557
2019,110583,10,0,1077,520,557
2019,110583,10,1,381,212,169
2019,110583,10,2,177,86,91
2019,110583,10,3,227,94,133
2019,110583,10,5,290,128,162
2019,110583,10,6,2,0,2
2019,110583,20,0,557,296,261
2019,110583,20,1,381,212,169
2019,110583,20,2,172,84,88
2019,110583,20,3,2,0,2
2019,110583,20,6,2,0,2
2019,110583,30,0,230,96,134
2019,110583,30,2,5,2,3
2019,110583,30,3,225,94,131
2019,110583,40,0,290,128,162
2019,110583,40,5,290,128,162
2019,110583,41,0,217,93,124
2019,110583,41,5,217,93,124
2019,110583,42,0,63,32,31
2019,110583,42,5,63,32,31
2019,110583,43,0,10,3,7
2019,110583,43,5,10,3,7
2019,110583,44,0,217,93,124
2019,110583,44,5,217,93,124
2019,110592,0,0,681,326,355
2019,110592,10,0,681,326,355
2019,110592,10,1,256,144,112
2019,110592,10,2,84,36,48
2019,110592,10,3,175,75,100
2019,110592,10,5,166,71,95
2019,110592,20,0,339,179,160
2019,110592,20,1,256,144,112
2019,110592,20,2,83,35,48
2019,110592,30,0,176,76,100
2019,110592,30,2,1,1,0
2019,110592,30,3,175,75,100
2019,110592,40,0,166,71,95
2019,110592,40,5,166,71,95
2019,110592,41,0,76,33,43
2019,110592,41,5,76,33,43
2019,110592,42,0,84,34,50
2019,110592,42,5,84,34,50
2019,110592,43,0,6,4,2
2019,110592,43,5,6,4,2
2019,110592,44,0,76,33,43
2019,110592,44,5,76,33,43
2019,110608,0,0,902,449,453
2019,110608,10,0,902,449,453
2019,110608,10,1,394,212,182
2019,110608,10,2,166,74,92
2019,110608,10,3,184,93,91
2019,110608,10,5,148,66,82
2019,110608,10,6,10,4,6
2019,110608,20,0,549,282,267
2019,110608,20,1,393,212,181
2019,110608,20,2,147,67,80
2019,110608,20,3,1,0,1
2019,110608,20,6,8,3,5
2019,110608,30,0,205,101,104
2019,110608,30,1,1,0,1
2019,110608,30,2,19,7,12
2019,110608,30,3,183,93,90
2019,110608,30,6,2,1,1
2019,110608,40,0,148,66,82
2019,110608,40,5,148,66,82
2019,110608,41,0,117,52,65
2019,110608,41,5,117,52,65
2019,110608,42,0,19,8,11
2019,110608,42,5,19,8,11
2019,110608,43,0,12,6,6
2019,110608,43,5,12,6,6
2019,110608,44,0,117,52,65
2019,110608,44,5,117,52,65
2019,110617,0,0,830,401,429
2019,110617,10,0,830,401,429
2019,110617,10,1,332,181,151
2019,110617,10,2,99,53,46
2019,110617,10,3,243,104,139
2019,110617,10,5,150,59,91
2019,110617,10,6,6,4,2
2019,110617,20,0,429,233,196
2019,110617,20,1,325,177,148
2019,110617,20,2,97,51,46
2019,110617,20,3,2,1,1
2019,110617,20,6,5,4,1
2019,110617,30,0,251,109,142
2019,110617,30,1,7,4,3
2019,110617,30,2,2,2,0
2019,110617,30,3,241,103,138
2019,110617,30,6,1,0,1
2019,110617,40,0,150,59,91
2019,110617,40,5,150,59,91
2019,110617,41,0,105,40,65
2019,110617,41,5,105,40,65
2019,110617,42,0,43,18,25
2019,110617,42,5,43,18,25
2019,110617,43,0,2,1,1
2019,110617,43,5,2,1,1
2019,110617,44,0,105,40,65
2019,110617,44,5,105,40,65
2019,110635,0,0,1822,1111,711
2019,110635,10,0,1820,1110,710
2019,110635,10,1,882,635,247
2019,110635,10,2,319,180,139
2019,110635,10,3,289,161,128
2019,110635,10,4,3,2,1
2019,110635,10,5,318,130,188
2019,110635,10,6,9,2,7
2019,110635,20,0,1157,794,363
2019,110635,20,1,836,610,226
2019,110635,20,2,299,171,128
2019,110635,20,5,22,13,9
2019,110635,30,0,245,138,107
2019,110635,30,1,7,2,5
2019,110635,30,3,235,135,100
2019,110635,30,5,3,1,2
2019,110635,40,0,418,178,240
2019,110635,40,1,39,23,16
2019,110635,40,2,20,9,11
2019,110635,40,3,54,26,28
2019,110635,40,4,3,2,1
2019,110635,40,5,293,116,177
2019,110635,40,6,9,2,7
2019,110635,41,0,233,92,141
2019,110635,41,1,33,17,16
2019,110635,41,2,20,9,11
2019,110635,41,3,40,15,25
2019,110635,41,4,3,2,1
2019,110635,41,5,136,49,87
2019,110635,41,6,1,0,1
2019,110635,42,0,181,83,98
2019,110635,42,1,6,6,0
2019,110635,42,3,14,11,3
2019,110635,42,5,153,64,89
2019,110635,42,6,8,2,6
2019,110635,43,0,4,3,1
2019,110635,43,5,4,3,1
2019,110635,44,0,233,92,141
2019,110635,44,1,33,17,16
2019,110635,44,2,20,9,11
2019,110635,44,3,40,15,25
2019,110635,44,4,3,2,1
2019,110635,44,5,136,49,87
2019,110635,44,6,1,0,1
2019,110635,50,0,2,1,1
2019,110644,0,0,2593,1504,1089
2019,110644,10,0,2591,1504,1087
2019,110644,10,1,1218,814,404
2019,110644,10,2,497,269,228
2019,110644,10,3,613,305,308
2019,110644,10,5,263,116,147
2019,110644,20,0,1262,809,453
2019,110644,20,1,936,631,305
2019,110644,20,2,312,172,140
2019,110644,20,5,14,6,8
2019,110644,30,0,337,177,160
2019,110644,30,1,6,4,2
2019,110644,30,3,301,161,140
2019,110644,30,5,30,12,18
2019,110644,40,0,992,518,474
2019,110644,40,1,276,179,97
2019,110644,40,2,185,97,88
2019,110644,40,3,312,144,168
2019,110644,40,5,219,98,121
2019,110644,41,0,840,446,394
2019,110644,41,1,275,178,97
2019,110644,41,2,185,97,88
2019,110644,41,3,287,123,164
2019,110644,41,5,93,48,45
2019,110644,42,0,149,71,78
2019,110644,42,1,1,1,0
2019,110644,42,3,25,21,4
2019,110644,42,5,123,49,74
2019,110644,43,0,3,1,2
2019,110644,43,5,3,1,2
2019,110644,44,0,840,446,394
2019,110644,44,1,275,178,97
2019,110644,44,2,185,97,88
2019,110644,44,3,287,123,164
2019,110644,44,5,93,48,45
2019,110644,50,0,2,0,2
2019,110653,0,0,2074,1226,848
2019,110653,10,0,2074,1226,848
2019,110653,10,1,912,636,276
2019,110653,10,2,387,209,178
2019,110653,10,3,445,227,218
2019,110653,10,4,50,28,22
2019,110653,10,5,280,126,154
2019,110653,20,0,1051,685,366
2019,110653,20,1,731,521,210
2019,110653,20,2,263,140,123
2019,110653,20,5,57,24,33
2019,110653,30,0,282,143,139
2019,110653,30,1,4,1,3
2019,110653,30,3,239,122,117
2019,110653,30,5,39,20,19
2019,110653,40,0,741,398,343
2019,110653,40,1,177,114,63
2019,110653,40,2,124,69,55
2019,110653,40,3,206,105,101
2019,110653,40,4,50,28,22
2019,110653,40,5,184,82,102
2019,110653,41,0,617,338,279
2019,110653,41,1,173,113,60
2019,110653,41,2,123,69,54
2019,110653,41,3,188,92,96
2019,110653,41,4,50,28,22
2019,110653,41,5,83,36,47
2019,110653,42,0,123,60,63
2019,110653,42,1,4,1,3
2019,110653,42,2,1,0,1
2019,110653,42,3,18,13,5
2019,110653,42,5,100,46,54
2019,110653,43,0,1,0,1
2019,110653,43,5,1,0,1
2019,110653,44,0,617,338,279
2019,110653,44,1,173,113,60
2019,110653,44,2,123,69,54
2019,110653,44,3,188,92,96
2019,110653,44,4,50,28,22
2019,110653,44,5,83,36,47
2019,110662,0,0,4025,2403,1622
2019,110662,10,0,4009,2392,1617
2019,110662,10,1,1721,1189,532
2019,110662,10,2,591,326,265
2019,110662,10,3,983,532,451
2019,110662,10,4,412,214,198
2019,110662,10,5,296,127,169
2019,110662,10,6,6,4,2
2019,110662,20,0,1499,1007,492
2019,110662,20,1,1226,858,368
2019,110662,20,2,265,145,120
2019,110662,20,5,8,4,4
2019,110662,30,0,275,146,129
2019,110662,30,1,4,1,3
2019,110662,30,3,267,142,125
2019,110662,30,5,4,3,1
2019,110662,40,0,2235,1239,996
2019,110662,40,1,491,330,161
2019,110662,40,2,326,181,145
2019,110662,40,3,716,390,326
2019,110662,40,4,412,214,198
2019,110662,40,5,284,120,164
2019,110662,40,6,6,4,2
2019,110662,41,0,2051,1160,891
2019,110662,41,1,484,328,156
2019,110662,41,2,325,180,145
2019,110662,41,3,714,389,325
2019,110662,41,4,412,214,198
2019,110662,41,5,112,47,65
2019,110662,41,6,4,2,2
2019,110662,42,0,184,79,105
2019,110662,42,1,7,2,5
2019,110662,42,2,1,1,0
2019,110662,42,3,2,1,1
2019,110662,42,5,172,73,99
2019,110662,42,6,2,2,0
2019,110662,44,0,2051,1160,891
2019,110662,44,1,484,328,156
2019,110662,44,2,325,180,145
2019,110662,44,3,714,389,325
2019,110662,44,4,412,214,198
2019,110662,44,5,112,47,65
2019,110662,44,6,4,2,2
2019,110662,50,0,16,11,5
2019,110671,0,0,1062,666,396
2019,110671,10,0,1062,666,396
2019,110671,10,1,375,281,94
2019,110671,10,2,227,132,95
2019,110671,10,3,308,180,128
2019,110671,10,4,3,1,2
2019,110671,10,5,142,70,72
2019,110671,10,6,7,2,5
2019,110671,20,0,586,404,182
2019,110671,20,1,363,272,91
2019,110671,20,2,213,124,89
2019,110671,20,5,10,8,2
2019,110671,30,0,267,155,112
2019,110671,30,3,249,147,102
2019,110671,30,5,18,8,10
2019,110671,40,0,209,107,102
2019,110671,40,1,12,9,3
2019,110671,40,2,14,8,6
2019,110671,40,3,59,33,26
2019,110671,40,4,3,1,2
2019,110671,40,5,114,54,60
2019,110671,40,6,7,2,5
2019,110671,41,0,140,69,71
2019,110671,41,1,12,9,3
2019,110671,41,2,14,8,6
2019,110671,41,3,37,18,19
2019,110671,41,4,3,1,2
2019,110671,41,5,69,31,38
2019,110671,41,6,5,2,3
2019,110671,42,0,69,38,31
2019,110671,42,3,22,15,7
2019,110671,42,5,45,23,22
2019,110671,42,6,2,0,2
2019,110671,44,0,140,69,71
2019,110671,44,1,12,9,3
2019,110671,44,2,14,8,6
2019,110671,44,3,37,18,19
2019,110671,44,4,3,1,2
2019,110671,44,5,69,31,38
2019,110671,44,6,5,2,3
2019,110680,0,0,2748,1680,1068
2019,110680,10,0,2721,1666,1055
2019,110680,10,1,1233,898,335
2019,110680,10,2,527,296,231
2019,110680,10,3,700,349,351
2019,110680,10,5,261,123,138
2019,110680,20,0,1119,828,291
2019,110680,20,1,835,657,178
2019,110680,20,2,234,142,92
2019,110680,20,5,50,29,21
2019,110680,30,0,315,176,139
2019,110680,30,3,274,152,122
2019,110680,30,5,41,24,17
2019,110680,40,0,1287,662,625
2019,110680,40,1,398,241,157
2019,110680,40,2,293,154,139
2019,110680,40,3,426,197,229
2019,110680,40,5,170,70,100
2019,110680,41,0,1147,596,551
2019,110680,41,1,394,239,155
2019,110680,41,2,286,147,139
2019,110680,41,3,412,187,225
2019,110680,41,5,55,23,32
2019,110680,42,0,139,66,73
2019,110680,42,1,4,2,2
2019,110680,42,2,7,7,0
2019,110680,42,3,14,10,4
2019,110680,42,5,114,47,67
2019,110680,43,0,1,0,1
2019,110680,43,5,1,0,1
2019,110680,44,0,1147,596,551
2019,110680,44,1,394,239,155
2019,110680,44,2,286,147,139
2019,110680,44,3,412,187,225
2019,110680,44,5,55,23,32
2019,110680,50,0,27,14,13
2019,110699,0,0,2737,1337,1400
2019,110699,10,0,2737,1337,1400
2019,110699,10,1,1083,656,427
2019,110699,10,2,566,236,330
2019,110699,10,3,976,391,585
2019,110699,10,4,112,54,58
2019,110699,20,0,291,191,100
2019,110699,20,1,258,176,82
2019,110699,20,2,33,15,18
2019,110699,30,0,33,18,15
2019,110699,30,3,33,18,15
2019,110699,40,0,2413,1128,1285
2019,110699,40,1,825,480,345
2019,110699,40,2,533,221,312
2019,110699,40,3,943,373,570
2019,110699,40,4,112,54,58
2019,110699,41,0,2404,1121,1283
2019,110699,41,1,823,478,345
2019,110699,41,2,533,221,312
2019,110699,41,3,936,368,568
2019,110699,41,4,112,54,58
2019,110699,42,0,9,7,2
2019,110699,42,1,2,2,0
2019,110699,42,3,7,5,2
2019,110699,44,0,2404,1121,1283
2019,110699,44,1,823,478,345
2019,110699,44,2,533,221,312
2019,110699,44,3,936,368,568
2019,110699,44,4,112,54,58
2019,110705,0,0,1078,634,444
2019,110705,10,0,1078,634,444
2019,110705,10,1,506,345,161
2019,110705,10,2,154,82,72
2019,110705,10,3,206,117,89
2019,110705,10,5,212,90,122
2019,110705,20,0,688,443,245
2019,110705,20,1,506,345,161
2019,110705,20,2,154,82,72
2019,110705,20,5,28,16,12
2019,110705,30,0,206,113,93
2019,110705,30,3,188,105,83
2019,110705,30,5,18,8,10
2019,110705,40,0,184,78,106
2019,110705,40,3,18,12,6
2019,110705,40,5,166,66,100
2019,110705,41,0,87,33,54
2019,110705,41,5,87,33,54
2019,110705,42,0,96,45,51
2019,110705,42,3,18,12,6
2019,110705,42,5,78,33,45
2019,110705,43,0,1,0,1
2019,110705,43,5,1,0,1
2019,110705,44,0,87,33,54
2019,110705,44,5,87,33,54
2019,110714,0,0,684,386,298
2019,110714,10,0,679,384,295
2019,110714,10,1,299,198,101
2019,110714,10,2,124,64,60
2019,110714,10,3,146,77,69
2019,110714,10,5,105,43,62
2019,110714,10,6,5,2,3
2019,110714,20,0,434,266,168
2019,110714,20,1,298,197,101
2019,110714,20,2,124,64,60
2019,110714,20,5,12,5,7
2019,110714,30,0,145,76,69
2019,110714,30,3,137,73,64
2019,110714,30,5,8,3,5
2019,110714,40,0,100,42,58
2019,110714,40,1,1,1,0
2019,110714,40,3,9,4,5
2019,110714,40,5,85,35,50
2019,110714,40,6,5,2,3
2019,110714,41,0,42,17,25
2019,110714,41,1,1,1,0
2019,110714,41,3,3,1,2
2019,110714,41,5,36,14,22
2019,110714,41,6,2,1,1
2019,110714,42,0,58,25,33
2019,110714,42,3,6,3,3
2019,110714,42,5,49,21,28
2019,110714,42,6,3,1,2
2019,110714,44,0,42,17,25
2019,110714,44,1,1,1,0
2019,110714,44,3,3,1,2
2019,110714,44,5,36,14,22
2019,110714,44,6,2,1,1
2019,110714,50,0,5,2,3
2019,110778,0,0,17,7,10
2019,110778,10,0,17,7,10
2019,110778,10,6,17,7,10
2019,110778,40,0,17,7,10
2019,110778,40,6,17,7,10
2019,110778,41,0,3,1,2
2019,110778,41,6,3,1,2
2019,110778,42,0,14,6,8
2019,110778,42,6,14,6,8
2019,110778,45,0,3,1,2
2019,110778,45,6,3,1,2
2019,111081,0,0,159,89,70
2019,111081,10,0,159,89,70
2019,111081,10,6,159,89,70
2019,111081,40,0,159,89,70
2019,111081,40,6,159,89,70
2019,111081,41,0,142,82,60
2019,111081,41,6,142,82,60
2019,111081,42,0,17,7,10
2019,111081,42,6,17,7,10
2019,111081,44,0,142,82,60
2019,111081,44,6,142,82,60
2019,111188,0,0,71,51,20
2019,111188,10,0,71,51,20
2019,111188,10,1,16,12,4
2019,111188,10,2,18,15,3
2019,111188,10,3,21,13,8
2019,111188,10,5,16,11,5
2019,111188,20,0,35,28,7
2019,111188,20,1,16,12,4
2019,111188,20,2,18,15,3
2019,111188,20,3,1,1,0
2019,111188,30,0,20,12,8
2019,111188,30,3,20,12,8
2019,111188,40,0,16,11,5
2019,111188,40,5,16,11,5
2019,111188,41,0,8,3,5
2019,111188,41,5,8,3,5
2019,111188,42,0,8,8,0
2019,111188,42,5,8,8,0
2019,111188,44,0,8,3,5
2019,111188,44,5,8,3,5
2019,111391,0,0,35,19,16
2019,111391,10,0,35,19,16
2019,111391,10,1,27,15,12
2019,111391,10,2,4,2,2
2019,111391,10,3,1,0,1
2019,111391,10,4,3,2,1
2019,111391,20,0,19,14,5
2019,111391,20,1,18,13,5
2019,111391,20,2,1,1,0
2019,111391,30,0,4,1,3
2019,111391,30,2,3,1,2
2019,111391,30,3,1,0,1
2019,111391,40,0,12,4,8
2019,111391,40,1,9,2,7
2019,111391,40,4,3,2,1
2019,111391,41,0,12,4,8
2019,111391,41,1,9,2,7
2019,111391,41,4,3,2,1
2019,111391,44,0,12,4,8
2019,111391,44,1,9,2,7
2019,111391,44,4,3,2,1
2019,111434,0,0,89,29,60
2019,111434,10,0,89,29,60
2019,111434,10,4,89,29,60
2019,111434,20,0,62,21,41
2019,111434,20,4,62,21,41
2019,111434,30,0,20,6,14
2019,111434,30,4,20,6,14
2019,111434,40,0,7,2,5
2019,111434,40,4,7,2,5
2019,111434,43,0,7,2,5
2019,111434,43,4,7,2,5
2019,111461,0,0,193,88,105
2019,111461,10,0,193,88,105
2019,111461,10,1,156,72,84
2019,111461,10,2,25,11,14
2019,111461,10,3,12,5,7
2019,111461,20,0,156,72,84
2019,111461,20,1,156,72,84
2019,111461,30,0,37,16,21
2019,111461,30,2,25,11,14
2019,111461,30,3,12,5,7
2019,111638,0,0,10,6,4
2019,111638,10,0,10,6,4
2019,111638,10,4,10,6,4
2019,111638,40,0,10,6,4
2019,111638,40,4,10,6,4
2019,111638,41,0,10,6,4
2019,111638,41,4,10,6,4
2019,111638,45,0,10,6,4
2019,111638,45,4,10,6,4
2019,111887,0,0,312,133,179
2019,111887,10,0,312,133,179
2019,111887,10,4,312,133,179
2019,111887,20,0,209,93,116
2019,111887,20,4,209,93,116
2019,111887,30,0,61,28,33
2019,111887,30,4,61,28,33
2019,111887,40,0,42,12,30
2019,111887,40,4,42,12,30
2019,111887,43,0,42,12,30
2019,111887,43,4,42,12,30
2019,111896,0,0,66,36,30
2019,111896,10,0,66,36,30
2019,111896,10,4,66,36,30
2019,111896,20,0,46,25,21
2019,111896,20,4,46,25,21
2019,111896,30,0,18,9,9
2019,111896,30,4,18,9,9
2019,111896,40,0,2,2,0
2019,111896,40,4,2,2,0
2019,111896,43,0,2,2,0
2019,111896,43,4,2,2,0
2019,111920,0,0,194,96,98
2019,111920,10,0,194,96,98
2019,111920,10,4,194,96,98
2019,111920,20,0,118,63,55
2019,111920,20,4,118,63,55
2019,111920,30,0,61,29,32
2019,111920,30,4,61,29,32
2019,111920,40,0,15,4,11
2019,111920,40,4,15,4,11
2019,111920,43,0,15,4,11
2019,111920,43,4,15,4,11
2019,111939,0,0,246,100,146
2019,111939,10,0,246,100,146
2019,111939,10,4,246,100,146
2019,111939,20,0,186,79,107
2019,111939,20,4,186,79,107
2019,111939,30,0,59,21,38
2019,111939,30,4,59,21,38
2019,111939,40,0,1,0,1
2019,111939,40,4,1,0,1
2019,111939,43,0,1,0,1
2019,111939,43,4,1,0,1
2019,111948,0,0,536,305,231
2019,111948,10,0,536,305,231
2019,111948,10,1,160,113,47
2019,111948,10,2,149,81,68
2019,111948,10,3,195,90,105
2019,111948,10,4,28,17,11
2019,111948,10,6,4,4,0
2019,111948,20,0,247,162,85
2019,111948,20,1,139,104,35
2019,111948,20,2,108,58,50
2019,111948,30,0,101,51,50
2019,111948,30,2,8,4,4
2019,111948,30,3,93,47,46
2019,111948,40,0,188,92,96
2019,111948,40,1,21,9,12
2019,111948,40,2,33,19,14
2019,111948,40,3,102,43,59
2019,111948,40,4,28,17,11
2019,111948,40,6,4,4,0
2019,111948,41,0,152,71,81
2019,111948,41,1,20,9,11
2019,111948,41,2,30,16,14
2019,111948,41,3,81,33,48
2019,111948,41,4,17,9,8
2019,111948,41,6,4,4,0
2019,111948,42,0,33,21,12
2019,111948,42,1,1,0,1
2019,111948,42,2,3,3,0
2019,111948,42,3,19,10,9
2019,111948,42,4,10,8,2
2019,111948,43,0,3,0,3
2019,111948,43,3,2,0,2
2019,111948,43,4,1,0,1
2019,111948,44,0,152,71,81
2019,111948,44,1,20,9,11
2019,111948,44,2,30,16,14
2019,111948,44,3,81,33,48
2019,111948,44,4,17,9,8
2019,111948,44,6,4,4,0
2019,111966,0,0,55,20,35
2019,111966,10,0,55,20,35
2019,111966,10,1,5,3,2
2019,111966,10,2,12,6,6
2019,111966,10,3,26,7,19
2019,111966,10,4,12,4,8
2019,111966,40,0,55,20,35
2019,111966,40,1,5,3,2
2019,111966,40,2,12,6,6
2019,111966,40,3,26,7,19
2019,111966,40,4,12,4,8
2019,111966,41,0,35,14,21
2019,111966,41,1,4,3,1
2019,111966,41,2,11,5,6
2019,111966,41,3,15,4,11
2019,111966,41,4,5,2,3
2019,111966,42,0,20,6,14
2019,111966,42,1,1,0,1
2019,111966,42,2,1,1,0
2019,111966,42,3,11,3,8
2019,111966,42,4,7,2,5
2019,111966,44,0,35,14,21
2019,111966,44,1,4,3,1
2019,111966,44,2,11,5,6
2019,111966,44,3,15,4,11
2019,111966,44,4,5,2,3
2019,112075,0,0,109,54,55
2019,112075,10,0,109,54,55
2019,112075,10,1,35,23,12
2019,112075,10,2,25,11,14
2019,112075,10,3,49,20,29
2019,112075,40,0,109,54,55
2019,112075,40,1,35,23,12
2019,112075,40,2,25,11,14
2019,112075,40,3,49,20,29
2019,112075,41,0,84,49,35
2019,112075,41,1,35,23,12
2019,112075,41,2,20,10,10
2019,112075,41,3,29,16,13
2019,112075,42,0,25,5,20
2019,112075,42,2,5,1,4
2019,112075,42,3,20,4,16
2019,112075,44,0,84,49,35
2019,112075,44,1,35,23,12
2019,112075,44,2,20,10,10
2019,112075,44,3,29,16,13
2019,112084,0,0,10,7,3
2019,112084,10,0,10,7,3
2019,112084,10,1,2,2,0
2019,112084,10,2,2,1,1
2019,112084,10,3,6,4,2
2019,112084,40,0,10,7,3
2019,112084,40,1,2,2,0
2019,112084,40,2,2,1,1
2019,112084,40,3,6,4,2
2019,112084,42,0,10,7,3
2019,112084,42,1,2,2,0
2019,112084,42,2,2,1,1
2019,112084,42,3,6,4,2
2019,112127,0,0,5,2,3
2019,112127,10,0,5,2,3
2019,112127,10,1,1,0,1
2019,112127,10,2,1,0,1
2019,112127,10,3,3,2,1
2019,112127,20,0,1,0,1
2019,112127,20,1,1,0,1
2019,112127,30,0,2,2,0
2019,112127,30,3,2,2,0
2019,112127,40,0,2,0,2
2019,112127,40,2,1,0,1
2019,112127,40,3,1,0,1
2019,112127,41,0,2,0,2
2019,112127,41,2,1,0,1
2019,112127,41,3,1,0,1
2019,112127,44,0,2,0,2
2019,112127,44,2,1,0,1
2019,112127,44,3,1,0,1
2019,112172,0,0,176,78,98
2019,112172,10,0,176,78,98
2019,112172,10,4,176,78,98
2019,112172,20,0,126,64,62
2019,112172,20,4,126,64,62
2019,112172,30,0,50,14,36
2019,112172,30,4,50,14,36
2019,112190,0,0,570,230,340
2019,112190,10,0,570,230,340
2019,112190,10,4,570,230,340
2019,112190,20,0,404,180,224
2019,112190,20,4,404,180,224
2019,112190,30,0,144,47,97
2019,112190,30,4,144,47,97
2019,112190,40,0,22,3,19
2019,112190,40,4,22,3,19
2019,112190,43,0,22,3,19
2019,112190,43,4,22,3,19
2019,112251,0,0,95,53,42
2019,112251,10,0,95,53,42
2019,112251,10,1,48,34,14
2019,112251,10,2,30,10,20
2019,112251,10,3,17,9,8
2019,112251,20,0,63,38,25
2019,112251,20,1,39,29,10
2019,112251,20,2,24,9,15
2019,112251,30,0,9,5,4
2019,112251,30,3,9,5,4
2019,112251,40,0,23,10,13
2019,112251,40,1,9,5,4
2019,112251,40,2,6,1,5
2019,112251,40,3,8,4,4
2019,112251,41,0,21,8,13
2019,112251,41,1,9,5,4
2019,112251,41,2,6,1,5
2019,112251,41,3,6,2,4
2019,112251,42,0,1,1,0
2019,112251,42,3,1,1,0
2019,112251,43,0,1,1,0
2019,112251,43,3,1,1,0
2019,112251,44,0,21,8,13
2019,112251,44,1,9,5,4
2019,112251,44,2,6,1,5
2019,112251,44,3,6,2,4
2019,112260,0,0,164,103,61
2019,112260,10,0,164,103,61
2019,112260,10,1,66,46,20
2019,112260,10,2,52,32,20
2019,112260,10,3,46,25,21
2019,112260,20,0,113,74,39
2019,112260,20,1,63,44,19
2019,112260,20,2,50,30,20
2019,112260,30,0,23,12,11
2019,112260,30,3,23,12,11
2019,112260,40,0,28,17,11
2019,112260,40,1,3,2,1
2019,112260,40,2,2,2,0
2019,112260,40,3,23,13,10
2019,112260,41,0,22,15,7
2019,112260,41,1,2,1,1
2019,112260,41,2,2,2,0
2019,112260,41,3,18,12,6
2019,112260,42,0,6,2,4
2019,112260,42,1,1,1,0
2019,112260,42,3,5,1,4
2019,112260,44,0,22,15,7
2019,112260,44,1,2,1,1
2019,112260,44,2,2,2,0
2019,112260,44,3,18,12,6
2019,112385,0,0,56,25,31
2019,112385,10,0,56,25,31
2019,112385,10,4,56,25,31
2019,112385,20,0,28,15,13
2019,112385,20,4,28,15,13
2019,112385,30,0,27,10,17
2019,112385,30,4,27,10,17
2019,112385,40,0,1,0,1
2019,112385,40,4,1,0,1
2019,112385,43,0,1,0,1
2019,112385,43,4,1,0,1
2019,112394,0,0,19,13,6
2019,112394,10,0,19,13,6
2019,112394,10,1,5,3,2
2019,112394,10,2,8,4,4
2019,112394,10,3,4,4,0
2019,112394,10,4,2,2,0
2019,112394,40,0,19,13,6
2019,112394,40,1,5,3,2
2019,112394,40,2,8,4,4
2019,112394,40,3,4,4,0
2019,112394,40,4,2,2,0
2019,112394,41,0,15,10,5
2019,112394,41,1,4,2,2
2019,112394,41,2,7,4,3
2019,112394,41,3,4,4,0
2019,112394,42,0,4,3,1
2019,112394,42,1,1,1,0
2019,112394,42,2,1,0,1
2019,112394,42,4,2,2,0
2019,112394,45,0,15,10,5
2019,112394,45,1,4,2,2
2019,112394,45,2,7,4,3
2019,112394,45,3,4,4,0
2019,112525,0,0,303,141,162
2019,112525,10,0,303,141,162
2019,112525,10,1,52,32,20
2019,112525,10,2,101,48,53
2019,112525,10,3,136,57,79
2019,112525,10,4,14,4,10
2019,112525,20,0,69,42,27
2019,112525,20,1,42,27,15
2019,112525,20,2,27,15,12
2019,112525,30,0,33,14,19
2019,112525,30,1,2,1,1
2019,112525,30,2,10,4,6
2019,112525,30,3,21,9,12
2019,112525,40,0,201,85,116
2019,112525,40,1,8,4,4
2019,112525,40,2,64,29,35
2019,112525,40,3,115,48,67
2019,112525,40,4,14,4,10
2019,112525,42,0,194,85,109
2019,112525,42,1,8,4,4
2019,112525,42,2,64,29,35
2019,112525,42,3,112,48,64
2019,112525,42,4,10,4,6
2019,112525,43,0,7,0,7
2019,112525,43,3,3,0,3
2019,112525,43,4,4,0,4
2019,112561,0,0,58,30,28
2019,112561,10,0,58,30,28
2019,112561,10,4,58,30,28
2019,112561,20,0,27,12,15
2019,112561,20,4,27,12,15
2019,112561,30,0,8,4,4
2019,112561,30,4,8,4,4
2019,112561,40,0,23,14,9
2019,112561,40,4,23,14,9
2019,112561,42,0,20,12,8
2019,112561,42,4,20,12,8
2019,112561,43,0,3,2,1
2019,112561,43,4,3,2,1
2019,112570,0,0,12,9,3
2019,112570,10,0,12,9,3
2019,112570,10,4,12,9,3
2019,112570,40,0,12,9,3
2019,112570,40,4,12,9,3
2019,112570,41,0,12,9,3
2019,112570,41,4,12,9,3
2019,112570,45,0,12,9,3
2019,112570,45,4,12,9,3
2019,112686,0,0,99,43,56
2019,112686,10,0,99,43,56
2019,112686,10,4,99,43,56
2019,112686,20,0,66,32,34
2019,112686,20,4,66,32,34
2019,112686,30,0,31,11,20
2019,112686,30,4,31,11,20
2019,112686,40,0,2,0,2
2019,112686,40,4,2,0,2
2019,112686,43,0,2,0,2
2019,112686,43,4,2,0,2
2019,112826,0,0,112,47,65
2019,112826,10,0,112,47,65
2019,112826,10,4,112,47,65
2019,112826,20,0,53,19,34
2019,112826,20,4,53,19,34
2019,112826,30,0,30,15,15
2019,112826,30,4,30,15,15
2019,112826,40,0,29,13,16
2019,112826,40,4,29,13,16
2019,112826,42,0,9,5,4
2019,112826,42,4,9,5,4
2019,112826,43,0,20,8,12
2019,112826,43,4,20,8,12
2019,113096,0,0,212,100,112
2019,113096,10,0,212,100,112
2019,113096,10,4,212,100,112
2019,113096,20,0,140,62,78
2019,113096,20,4,140,62,78
2019,113096,30,0,64,33,31
2019,113096,30,4,64,33,31
2019,113096,40,0,8,5,3
2019,113096,40,4,8,5,3
2019,113096,43,0,8,5,3
2019,113096,43,4,8,5,3
2019,113111,0,0,78,36,42
2019,113111,10,0,60,30,30
2019,113111,10,4,60,30,30
2019,113111,20,0,42,23,19
2019,113111,20,4,42,23,19
2019,113111,30,0,18,7,11
2019,113111,30,4,18,7,11
2019,113111,50,0,18,6,12
2019,113193,0,0,154,78,76
2019,113193,10,0,154,78,76
2019,113193,10,4,154,78,76
2019,113193,20,0,122,65,57
2019,113193,20,4,122,65,57
2019,113193,30,0,17,6,11
2019,113193,30,4,17,6,11
2019,113193,40,0,15,7,8
2019,113193,40,4,15,7,8
2019,113193,43,0,15,7,8
2019,113193,43,4,15,7,8
2019,113218,0,0,117,51,66
2019,113218,10,0,117,51,66
2019,113218,10,4,117,51,66
2019,113218,20,0,64,30,34
2019,113218,20,4,64,30,34
2019,113218,30,0,24,8,16
2019,113218,30,4,24,8,16
2019,113218,40,0,29,13,16
2019,113218,40,4,29,13,16
2019,113218,42,0,19,7,12
2019,113218,42,4,19,7,12
2019,113218,43,0,10,6,4
2019,113218,43,4,10,6,4
2019,113236,0,0,218,90,128
2019,113236,10,0,218,90,128
2019,113236,10,4,218,90,128
2019,113236,20,0,154,66,88
2019,113236,20,4,154,66,88
2019,113236,30,0,64,24,40
2019,113236,30,4,64,24,40
2019,113333,0,0,249,105,144
2019,113333,10,0,249,105,144
2019,113333,10,4,249,105,144
2019,113333,20,0,189,83,106
2019,113333,20,4,189,83,106
2019,113333,30,0,52,19,33
2019,113333,30,4,52,19,33
2019,113333,40,0,8,3,5
2019,113333,40,4,8,3,5
2019,113333,42,0,8,3,5
2019,113333,42,4,8,3,5
2019,113573,0,0,158,74,84
2019,113573,10,0,158,74,84
2019,113573,10,4,158,74,84
2019,113573,20,0,89,43,46
2019,113573,20,4,89,43,46
2019,113573,30,0,49,20,29
2019,113573,30,4,49,20,29
2019,113573,40,0,20,11,9
2019,113573,40,4,20,11,9
2019,113573,42,0,7,4,3
2019,113573,42,4,7,4,3
2019,113573,43,0,13,7,6
2019,113573,43,4,13,7,6
2019,113634,0,0,300,143,157
2019,113634,10,0,300,143,157
2019,113634,10,4,300,143,157
2019,113634,20,0,183,89,94
2019,113634,20,4,183,89,94
2019,113634,30,0,80,37,43
2019,113634,30,4,80,37,43
2019,113634,40,0,37,17,20
2019,113634,40,4,37,17,20
2019,113634,42,0,1,1,0
2019,113634,42,4,1,1,0
2019,113634,43,0,36,16,20
2019,113634,43,4,36,16,20
2019,113698,0,0,106,47,59
2019,113698,10,0,106,47,59
2019,113698,10,1,29,12,17
2019,113698,10,2,18,7,11
2019,113698,10,3,59,28,31
2019,113698,20,0,42,18,24
2019,113698,20,1,27,12,15
2019,113698,20,2,15,6,9
2019,113698,30,0,35,16,19
2019,113698,30,1,1,0,1
2019,113698,30,2,1,0,1
2019,113698,30,3,33,16,17
2019,113698,40,0,29,13,16
2019,113698,40,1,1,0,1
2019,113698,40,2,2,1,1
2019,113698,40,3,26,12,14
2019,113698,42,0,29,13,16
2019,113698,42,1,1,0,1
2019,113698,42,2,2,1,1
2019,113698,42,3,26,12,14
2019,113704,0,0,13,11,2
2019,113704,10,0,13,11,2
2019,113704,10,1,8,7,1
2019,113704,10,2,2,1,1
2019,113704,10,3,3,3,0
2019,113704,40,0,13,11,2
2019,113704,40,1,8,7,1
2019,113704,40,2,2,1,1
2019,113704,40,3,3,3,0
2019,113704,42,0,13,11,2
2019,113704,42,1,8,7,1
2019,113704,42,2,2,1,1
2019,113704,42,3,3,3,0
2019,113856,0,0,328,153,175
2019,113856,10,0,328,153,175
2019,113856,10,4,328,153,175
2019,113856,20,0,256,118,138
2019,113856,20,4,256,118,138
2019,113856,30,0,69,34,35
2019,113856,30,4,69,34,35
2019,113856,40,0,3,1,2
2019,113856,40,4,3,1,2
2019,113856,42,0,1,1,0
2019,113856,42,4,1,1,0
2019,113856,43,0,2,0,2
2019,113856,43,4,2,0,2
2019,113980,0,0,348,171,177
2019,113980,10,0,348,171,177
2019,113980,10,4,348,171,177
2019,113980,20,0,282,135,147
2019,113980,20,4,282,135,147
2019,113980,30,0,54,30,24
2019,113980,30,4,54,30,24
2019,113980,40,0,12,6,6
2019,113980,40,4,12,6,6
2019,113980,42,0,5,2,3
2019,113980,42,4,5,2,3
2019,113980,43,0,7,4,3
2019,113980,43,4,7,4,3
2019,114123,0,0,14,4,10
2019,114123,10,0,14,4,10
2019,114123,10,4,14,4,10
2019,114123,40,0,14,4,10
2019,114123,40,4,14,4,10
2019,114123,41,0,14,4,10
2019,114123,41,4,14,4,10
2019,114123,44,0,14,4,10
2019,114123,44,4,14,4,10
2019,114266,0,0,113,46,67
2019,114266,10,0,113,46,67
2019,114266,10,4,113,46,67
2019,114266,20,0,43,24,19
2019,114266,20,4,43,24,19
2019,114266,30,0,55,19,36
2019,114266,30,4,55,19,36
2019,114266,40,0,15,3,12
2019,114266,40,4,15,3,12
2019,114266,42,0,10,1,9
2019,114266,42,4,10,1,9
2019,114266,43,0,5,2,3
2019,114266,43,4,5,2,3
2019,114354,0,0,23,8,15
2019,114354,10,0,23,8,15
2019,114354,10,4,23,8,15
2019,114354,40,0,23,8,15
2019,114354,40,4,23,8,15
2019,114354,43,0,23,8,15
2019,114354,43,4,23,8,15
2019,114433,0,0,21,12,9
2019,114433,10,0,21,12,9
2019,114433,10,4,21,12,9
2019,114433,20,0,13,7,6
2019,114433,20,4,13,7,6
2019,114433,30,0,8,5,3
2019,114433,30,4,8,5,3
2019,114549,0,0,52,18,34
2019,114549,10,0,52,18,34
2019,114549,10,6,52,18,34
2019,114549,40,0,52,18,34
2019,114549,40,6,52,18,34
2019,114549,41,0,49,17,32
2019,114549,41,6,49,17,32
2019,114549,42,0,3,1,2
2019,114549,42,6,3,1,2
2019,114549,44,0,49,17,32
2019,114549,44,6,49,17,32
2019,114585,0,0,2,1,1
2019,114585,10,0,2,1,1
2019,114585,10,1,1,1,0
2019,114585,10,4,1,0,1
2019,114585,40,0,2,1,1
2019,114585,40,1,1,1,0
2019,114585,40,4,1,0,1
2019,114585,41,0,2,1,1
2019,114585,41,1,1,1,0
2019,114585,41,4,1,0,1
2019,114585,44,0,2,1,1
2019,114585,44,1,1,1,0
2019,114585,44,4,1,0,1
2019,114716,0,0,169,71,98
2019,114716,10,0,169,71,98
2019,114716,10,4,169,71,98
2019,114716,20,0,137,57,80
2019,114716,20,4,137,57,80
2019,114716,30,0,30,14,16
2019,114716,30,4,30,14,16
2019,114716,40,0,2,0,2
2019,114716,40,4,2,0,2
2019,114716,42,0,2,0,2
2019,114716,42,4,2,0,2
2019,114789,0,0,381,182,199
2019,114789,10,0,381,182,199
2019,114789,10,4,381,182,199
2019,114789,20,0,232,112,120
2019,114789,20,4,232,112,120
2019,114789,30,0,80,43,37
2019,114789,30,4,80,43,37
2019,114789,40,0,69,27,42
2019,114789,40,4,69,27,42
2019,114789,42,0,49,16,33
2019,114789,42,4,49,16,33
2019,114789,43,0,20,11,9
2019,114789,43,4,20,11,9
2019,114813,0,0,106,48,58
2019,114813,10,0,106,48,58
2019,114813,10,1,16,11,5
2019,114813,10,2,43,27,16
2019,114813,10,3,41,8,33
2019,114813,10,4,6,2,4
2019,114813,20,0,53,34,19
2019,114813,20,1,13,9,4
2019,114813,20,2,38,24,14
2019,114813,20,3,2,1,1
2019,114813,30,0,29,8,21
2019,114813,30,2,2,1,1
2019,114813,30,3,24,5,19
2019,114813,30,4,3,2,1
2019,114813,40,0,24,6,18
2019,114813,40,1,3,2,1
2019,114813,40,2,3,2,1
2019,114813,40,3,15,2,13
2019,114813,40,4,3,0,3
2019,114813,42,0,24,6,18
2019,114813,42,1,3,2,1
2019,114813,42,2,3,2,1
2019,114813,42,3,15,2,13
2019,114813,42,4,3,0,3
2019,114840,0,0,58,37,21
2019,114840,10,0,58,37,21
2019,114840,10,1,21,15,6
2019,114840,10,2,20,13,7
2019,114840,10,3,17,9,8
2019,114840,20,0,36,25,11
2019,114840,20,1,20,15,5
2019,114840,20,2,16,10,6
2019,114840,30,0,18,10,8
2019,114840,30,1,1,0,1
2019,114840,30,2,4,3,1
2019,114840,30,3,13,7,6
2019,114840,40,0,4,2,2
2019,114840,40,3,4,2,2
2019,114840,42,0,4,2,2
2019,114840,42,3,4,2,2
2019,114859,0,0,321,164,157
2019,114859,10,0,321,164,157
2019,114859,10,4,321,164,157
2019,114859,20,0,227,115,112
2019,114859,20,4,227,115,112
2019,114859,30,0,94,49,45
2019,114859,30,4,94,49,45
2019,114938,0,0,78,36,42
2019,114938,10,0,78,36,42
2019,114938,10,4,78,36,42
2019,114938,20,0,49,20,29
2019,114938,20,4,49,20,29
2019,114938,30,0,23,12,11
2019,114938,30,4,23,12,11
2019,114938,40,0,6,4,2
2019,114938,40,4,6,4,2
2019,114938,41,0,3,1,2
2019,114938,41,4,3,1,2
2019,114938,43,0,3,3,0
2019,114938,43,4,3,3,0
2019,114938,44,0,2,0,2
2019,114938,44,4,2,0,2
2019,114938,45,0,1,1,0
2019,114938,45,4,1,1,0
2019,115001,0,0,235,101,134
2019,115001,10,0,235,101,134
2019,115001,10,4,235,101,134
2019,115001,20,0,146,69,77
2019,115001,20,4,146,69,77
2019,115001,30,0,58,24,34
2019,115001,30,4,58,24,34
2019,115001,40,0,31,8,23
2019,115001,40,4,31,8,23
2019,115001,42,0,9,1,8
2019,115001,42,4,9,1,8
2019,115001,43,0,22,7,15
2019,115001,43,4,22,7,15
2019,115010,0,0,19,10,9
2019,115010,50,0,19,10,9
2019,115083,0,0,65,29,36
2019,115083,10,0,59,25,34
2019,115083,10,1,31,13,18
2019,115083,10,2,21,9,12
2019,115083,10,3,1,0,1
2019,115083,10,4,4,2,2
2019,115083,10,5,2,1,1
2019,115083,20,0,21,10,11
2019,115083,20,1,19,9,10
2019,115083,20,2,2,1,1
2019,115083,30,0,5,1,4
2019,115083,30,2,5,1,4
2019,115083,40,0,33,14,19
2019,115083,40,1,12,4,8
2019,115083,40,2,14,7,7
2019,115083,40,3,1,0,1
2019,115083,40,4,4,2,2
2019,115083,40,5,2,1,1
2019,115083,41,0,25,10,15
2019,115083,41,1,10,3,7
2019,115083,41,2,14,7,7
2019,115083,41,3,1,0,1
2019,115083,42,0,8,4,4
2019,115083,42,1,2,1,1
2019,115083,42,4,4,2,2
2019,115083,42,5,2,1,1
2019,115083,44,0,25,10,15
2019,115083,44,1,10,3,7
2019,115083,44,2,14,7,7
2019,115083,44,3,1,0,1
2019,115083,50,0,6,4,2
2019,115126,0,0,138,57,81
2019,115126,10,0,138,57,81
2019,115126,10,4,138,57,81
2019,115126,20,0,81,35,46
2019,115126,20,4,81,35,46
2019,115126,30,0,54,21,33
2019,115126,30,4,54,21,33
2019,115126,40,0,3,1,2
2019,115126,40,4,3,1,2
2019,115126,43,0,3,1,2
2019,115126,43,4,3,1,2
2019,115214,0,0,8,5,3
2019,115214,10,0,8,5,3
2019,115214,10,1,2,2,0
2019,115214,10,2,4,2,2
2019,115214,10,3,1,1,0
2019,115214,10,5,1,0,1
2019,115214,20,0,2,1,1
2019,115214,20,2,2,1,1
2019,115214,30,0,1,1,0
2019,115214,30,3,1,1,0
2019,115214,40,0,5,3,2
2019,115214,40,1,2,2,0
2019,115214,40,2,2,1,1
2019,115214,40,5,1,0,1
2019,115214,41,0,4,3,1
2019,115214,41,1,2,2,0
2019,115214,41,2,2,1,1
2019,115214,42,0,1,0,1
2019,115214,42,5,1,0,1
2019,115214,44,0,4,3,1
2019,115214,44,1,2,2,0
2019,115214,44,2,2,1,1
2019,115296,0,0,270,117,153
2019,115296,10,0,270,117,153
2019,115296,10,4,270,117,153
2019,115296,20,0,165,80,85
2019,115296,20,4,165,80,85
2019,115296,30,0,53,18,35
2019,115296,30,4,53,18,35
2019,115296,40,0,52,19,33
2019,115296,40,4,52,19,33
2019,115296,42,0,30,9,21
2019,115296,42,4,30,9,21
2019,115296,43,0,22,10,12
2019,115296,43,4,22,10,12
2019,115393,0,0,130,59,71
2019,115393,10,0,130,59,71
2019,115393,10,4,130,59,71
2019,115393,20,0,89,42,47
2019,115393,20,4,89,42,47
2019,115393,30,0,35,14,21
2019,115393,30,4,35,14,21
2019,115393,40,0,6,3,3
2019,115393,40,4,6,3,3
2019,115393,42,0,6,3,3
2019,115393,42,4,6,3,3
2019,115409,0,0,108,64,44
2019,115409,10,0,106,64,42
2019,115409,10,1,55,40,15
2019,115409,10,2,20,9,11
2019,115409,10,3,24,15,9
2019,115409,10,4,7,0,7
2019,115409,20,0,72,47,25
2019,115409,20,1,55,40,15
2019,115409,20,2,17,7,10
2019,115409,30,0,26,16,10
2019,115409,30,2,2,1,1
2019,115409,30,3,24,15,9
2019,115409,40,0,8,1,7
2019,115409,40,2,1,1,0
2019,115409,40,4,7,0,7
2019,115409,41,0,1,1,0
2019,115409,41,2,1,1,0
2019,115409,42,0,7,0,7
2019,115409,42,4,7,0,7
2019,115409,45,0,1,1,0
2019,115409,45,2,1,1,0
2019,115409,50,0,2,0,2
2019,115728,0,0,42,18,24
2019,115728,10,0,42,18,24
2019,115728,10,1,6,3,3
2019,115728,10,2,14,9,5
2019,115728,10,3,18,4,14
2019,115728,10,4,4,2,2
2019,115728,20,0,17,11,6
2019,115728,20,1,6,3,3
2019,115728,20,2,11,8,3
2019,115728,30,0,8,2,6
2019,115728,30,2,2,0,2
2019,115728,30,3,6,2,4
2019,115728,40,0,17,5,12
2019,115728,40,2,1,1,0
2019,115728,40,3,12,2,10
2019,115728,40,4,4,2,2
2019,115728,42,0,17,5,12
2019,115728,42,2,1,1,0
2019,115728,42,3,12,2,10
2019,115728,42,4,4,2,2
2019,115746,0,0,33,17,16
2019,115746,10,0,33,17,16
2019,115746,10,1,33,17,16
2019,115746,40,0,33,17,16
2019,115746,40,1,33,17,16
2019,115746,41,0,28,15,13
2019,115746,41,1,28,15,13
2019,115746,42,0,5,2,3
2019,115746,42,1,5,2,3
2019,115746,44,0,28,15,13
2019,115746,44,1,28,15,13
2019,115755,0,0,292,138,154
2019,115755,10,0,292,138,154
2019,115755,10,1,104,62,42
2019,115755,10,2,58,22,36
2019,115755,10,3,76,31,45
2019,115755,10,5,54,23,31
2019,115755,20,0,159,83,76
2019,115755,20,1,104,62,42
2019,115755,20,2,54,20,34
2019,115755,20,3,1,1,0
2019,115755,30,0,79,32,47
2019,115755,30,2,4,2,2
2019,115755,30,3,75,30,45
2019,115755,40,0,54,23,31
2019,115755,40,5,54,23,31
2019,115755,41,0,36,16,20
2019,115755,41,5,36,16,20
2019,115755,42,0,12,4,8
2019,115755,42,5,12,4,8
2019,115755,43,0,6,3,3
2019,115755,43,5,6,3,3
2019,115755,44,0,36,16,20
2019,115755,44,5,36,16,20
2019,115773,0,0,12,2,10
2019,115773,10,0,12,2,10
2019,115773,10,1,4,2,2
2019,115773,10,2,6,0,6
2019,115773,10,4,2,0,2
2019,115773,40,0,12,2,10
2019,115773,40,1,4,2,2
2019,115773,40,2,6,0,6
2019,115773,40,4,2,0,2
2019,115773,41,0,12,2,10
2019,115773,41,1,4,2,2
2019,115773,41,2,6,0,6
2019,115773,41,4,2,0,2
2019,115773,44,0,12,2,10
2019,115773,44,1,4,2,2
2019,115773,44,2,6,0,6
2019,115773,44,4,2,0,2
2019,115861,0,0,177,86,91
2019,115861,10,0,177,86,91
2019,115861,10,4,177,86,91
2019,115861,20,0,100,56,44
2019,115861,20,4,100,56,44
2019,115861,30,0,51,18,33
2019,115861,30,4,51,18,33
2019,115861,40,0,26,12,14
2019,115861,40,4,26,12,14
2019,115861,43,0,26,12,14
2019,115861,43,4,26,12,14
2019,115931,0,0,11,9,2
2019,115931,10,0,11,9,2
2019,115931,10,6,11,9,2
2019,115931,40,0,11,9,2
2019,115931,40,6,11,9,2
2019,115931,41,0,11,9,2
2019,115931,41,6,11,9,2
2019,115931,45,0,11,9,2
2019,115931,45,6,11,9,2
2019,116439,0,0,154,85,69
2019,116439,10,0,154,85,69
2019,116439,10,4,154,85,69
2019,116439,20,0,115,63,52
2019,116439,20,4,115,63,52
2019,116439,30,0,39,22,17
2019,116439,30,4,39,22,17
2019,116712,0,0,27,14,13
2019,116712,10,0,27,14,13
2019,116712,10,1,15,7,8
2019,116712,10,2,4,2,2
2019,116712,10,3,8,5,3
2019,116712,40,0,27,14,13
2019,116712,40,1,15,7,8
2019,116712,40,2,4,2,2
2019,116712,40,3,8,5,3
2019,116712,41,0,27,14,13
2019,116712,41,1,15,7,8
2019,116712,41,2,4,2,2
2019,116712,41,3,8,5,3
2019,116712,44,0,27,14,13
2019,116712,44,1,15,7,8
2019,116712,44,2,4,2,2
2019,116712,44,3,8,5,3
2019,116846,0,0,14,7,7
2019,116846,10,0,14,7,7
2019,116846,10,1,4,3,1
2019,116846,10,4,10,4,6
2019,116846,20,0,4,3,1
2019,116846,20,1,4,3,1
2019,116846,40,0,10,4,6
2019,116846,40,4,10,4,6
2019,116846,41,0,10,4,6
2019,116846,41,4,10,4,6
2019,116846,45,0,10,4,6
2019,116846,45,4,10,4,6
2019,117052,0,0,202,97,105
2019,117052,10,0,202,97,105
2019,117052,10,4,202,97,105
2019,117052,20,0,120,67,53
2019,117052,20,4,120,67,53
2019,117052,30,0,51,24,27
2019,117052,30,4,51,24,27
2019,117052,40,0,31,6,25
2019,117052,40,4,31,6,25
2019,117052,42,0,30,6,24
2019,117052,42,4,30,6,24
2019,117052,43,0,1,0,1
2019,117052,43,4,1,0,1
2019,117104,0,0,15,11,4
2019,117104,10,0,15,11,4
2019,117104,10,1,3,3,0
2019,117104,10,2,5,4,1
2019,117104,10,3,5,3,2
2019,117104,10,4,2,1,1
2019,117104,40,0,15,11,4
2019,117104,40,1,3,3,0
2019,117104,40,2,5,4,1
2019,117104,40,3,5,3,2
2019,117104,40,4,2,1,1
2019,117104,41,0,4,4,0
2019,117104,41,1,3,3,0
2019,117104,41,2,1,1,0
2019,117104,42,0,11,7,4
2019,117104,42,2,4,3,1
2019,117104,42,3,5,3,2
2019,117104,42,4,2,1,1
2019,117104,44,0,4,4,0
2019,117104,44,1,3,3,0
2019,117104,44,2,1,1,0
2019,117140,0,0,254,114,140
2019,117140,10,0,254,114,140
2019,117140,10,1,85,48,37
2019,117140,10,2,69,24,45
2019,117140,10,3,76,33,43
2019,117140,10,4,24,9,15
2019,117140,20,0,133,67,66
2019,117140,20,1,73,44,29
2019,117140,20,2,49,18,31
2019,117140,20,3,11,5,6
2019,117140,30,0,58,27,31
2019,117140,30,1,4,2,2
2019,117140,30,2,11,5,6
2019,117140,30,3,43,20,23
2019,117140,40,0,63,20,43
2019,117140,40,1,8,2,6
2019,117140,40,2,9,1,8
2019,117140,40,3,22,8,14
2019,117140,40,4,24,9,15
2019,117140,42,0,63,20,43
2019,117140,42,1,8,2,6
2019,117140,42,2,9,1,8
2019,117140,42,3,22,8,14
2019,117140,42,4,24,9,15
2019,117168,0,0,26,20,6
2019,117168,10,0,26,20,6
2019,117168,10,1,7,4,3
2019,117168,10,2,13,10,3
2019,117168,10,3,6,6,0
2019,117168,40,0,26,20,6
2019,117168,40,1,7,4,3
2019,117168,40,2,13,10,3
2019,117168,40,3,6,6,0
2019,117168,41,0,26,20,6
2019,117168,41,1,7,4,3
2019,117168,41,2,13,10,3
2019,117168,41,3,6,6,0
2019,117168,44,0,26,20,6
2019,117168,44,1,7,4,3
2019,117168,44,2,13,10,3
2019,117168,44,3,6,6,0
2019,117195,0,0,37,19,18
2019,117195,10,0,37,19,18
2019,117195,10,4,37,19,18
2019,117195,20,0,28,16,12
2019,117195,20,4,28,16,12
2019,117195,30,0,9,3,6
2019,117195,30,4,9,3,6
2019,117247,0,0,129,61,68
2019,117247,10,0,129,61,68
2019,117247,10,4,129,61,68
2019,117247,20,0,97,49,48
2019,117247,20,4,97,49,48
2019,117247,30,0,20,6,14
2019,117247,30,4,20,6,14
2019,117247,40,0,12,6,6
2019,117247,40,4,12,6,6
2019,117247,42,0,1,0,1
2019,117247,42,4,1,0,1
2019,117247,43,0,11,6,5
2019,117247,43,4,11,6,5
2019,117274,0,0,42,20,22
2019,117274,10,0,42,20,22
2019,117274,10,4,42,20,22
2019,117274,20,0,25,13,12
2019,117274,20,4,25,13,12
2019,117274,30,0,16,7,9
2019,117274,30,4,16,7,9
2019,117274,40,0,1,0,1
2019,117274,40,4,1,0,1
2019,117274,42,0,1,0,1
2019,117274,42,4,1,0,1
2019,117520,0,0,34,17,17
2019,117520,10,0,34,17,17
2019,117520,10,1,25,13,12
2019,117520,10,2,8,3,5
2019,117520,10,4,1,1,0
2019,117520,40,0,34,17,17
2019,117520,40,1,25,13,12
2019,117520,40,2,8,3,5
2019,117520,40,4,1,1,0
2019,117520,41,0,34,17,17
2019,117520,41,1,25,13,12
2019,117520,41,2,8,3,5
2019,117520,41,4,1,1,0
2019,117520,44,0,34,17,17
2019,117520,44,1,25,13,12
2019,117520,44,2,8,3,5
2019,117520,44,4,1,1,0
2019,117557,0,0,22,18,4
2019,117557,10,0,22,18,4
2019,117557,10,1,6,5,1
2019,117557,10,2,13,11,2
2019,117557,10,3,1,0,1
2019,117557,10,5,2,2,0
2019,117557,40,0,22,18,4
2019,117557,40,1,6,5,1
2019,117557,40,2,13,11,2
2019,117557,40,3,1,0,1
2019,117557,40,5,2,2,0
2019,117557,42,0,22,18,4
2019,117557,42,1,6,5,1
2019,117557,42,2,13,11,2
2019,117557,42,3,1,0,1
2019,117557,42,5,2,2,0
2019,117575,0,0,6,6,0
2019,117575,10,0,6,6,0
2019,117575,10,1,6,6,0
2019,117575,40,0,6,6,0
2019,117575,40,1,6,6,0
2019,117575,41,0,6,6,0
2019,117575,41,1,6,6,0
2019,117575,45,0,6,6,0
2019,117575,45,1,6,6,0
2019,117627,0,0,92,53,39
2019,117627,10,0,92,53,39
2019,117627,10,1,22,17,5
2019,117627,10,2,31,18,13
2019,117627,10,3,29,15,14
2019,117627,10,4,2,1,1
2019,117627,10,5,8,2,6
2019,117627,20,0,33,24,9
2019,117627,20,1,16,13,3
2019,117627,20,2,16,10,6
2019,117627,20,3,1,1,0
2019,117627,30,0,23,12,11
2019,117627,30,1,4,3,1
2019,117627,30,2,8,6,2
2019,117627,30,3,9,3,6
2019,117627,30,5,2,0,2
2019,117627,40,0,36,17,19
2019,117627,40,1,2,1,1
2019,117627,40,2,7,2,5
2019,117627,40,3,19,11,8
2019,117627,40,4,2,1,1
2019,117627,40,5,6,2,4
2019,117627,41,0,36,17,19
2019,117627,41,1,2,1,1
2019,117627,41,2,7,2,5
2019,117627,41,3,19,11,8
2019,117627,41,4,2,1,1
2019,117627,41,5,6,2,4
2019,117627,45,0,36,17,19
2019,117627,45,1,2,1,1
2019,117627,45,2,7,2,5
2019,117627,45,3,19,11,8
2019,117627,45,4,2,1,1
2019,117627,45,5,6,2,4
2019,117636,0,0,400,174,226
2019,117636,10,0,400,174,226
2019,117636,10,1,58,39,19
2019,117636,10,2,79,32,47
2019,117636,10,3,220,91,129
2019,117636,10,4,43,12,31
2019,117636,20,0,19,13,6
2019,117636,20,1,13,10,3
2019,117636,20,2,1,1,0
2019,117636,20,3,5,2,3
2019,117636,30,0,51,23,28
2019,117636,30,1,14,9,5
2019,117636,30,2,14,5,9
2019,117636,30,3,22,9,13
2019,117636,30,4,1,0,1
2019,117636,40,0,330,138,192
2019,117636,40,1,31,20,11
2019,117636,40,2,64,26,38
2019,117636,40,3,193,80,113
2019,117636,40,4,42,12,30
2019,117636,41,0,133,66,67
2019,117636,41,1,22,14,8
2019,117636,41,2,31,16,15
2019,117636,41,3,77,36,41
2019,117636,41,4,3,0,3
2019,117636,42,0,197,72,125
2019,117636,42,1,9,6,3
2019,117636,42,2,33,10,23
2019,117636,42,3,116,44,72
2019,117636,42,4,39,12,27
2019,117636,44,0,133,66,67
2019,117636,44,1,22,14,8
2019,117636,44,2,31,16,15
2019,117636,44,3,77,36,41
2019,117636,44,4,3,0,3
2019,117645,0,0,326,138,188
2019,117645,10,0,326,138,188
2019,117645,10,4,326,138,188
2019,117645,20,0,261,111,150
2019,117645,20,4,261,111,150
2019,117645,30,0,61,25,36
2019,117645,30,4,61,25,36
2019,117645,40,0,4,2,2
2019,117645,40,4,4,2,2
2019,117645,42,0,4,2,2
2019,117645,42,4,4,2,2
2019,117672,0,0,46,25,21
2019,117672,10,0,42,23,19
2019,117672,10,1,6,4,2
2019,117672,10,2,9,6,3
2019,117672,10,3,21,10,11
2019,117672,10,4,5,2,3
2019,117672,10,6,1,1,0
2019,117672,40,0,42,23,19
2019,117672,40,1,6,4,2
2019,117672,40,2,9,6,3
2019,117672,40,3,21,10,11
2019,117672,40,4,5,2,3
2019,117672,40,6,1,1,0
2019,117672,42,0,42,23,19
2019,117672,42,1,6,4,2
2019,117672,42,2,9,6,3
2019,117672,42,3,21,10,11
2019,117672,42,4,5,2,3
2019,117672,42,6,1,1,0
2019,117672,50,0,4,2,2
2019,117681,0,0,28,9,19
2019,117681,10,0,28,9,19
2019,117681,10,4,28,9,19
2019,117681,20,0,23,8,15
2019,117681,20,4,23,8,15
2019,117681,30,0,5,1,4
2019,117681,30,4,5,1,4
2019,117690,0,0,99,47,52
2019,117690,10,0,99,47,52
2019,117690,10,4,99,47,52
2019,117690,20,0,82,35,47
2019,117690,20,4,82,35,47
2019,117690,30,0,16,11,5
2019,117690,30,4,16,11,5
2019,117690,40,0,1,1,0
2019,117690,40,4,1,1,0
2019,117690,42,0,1,1,0
2019,117690,42,4,1,1,0
2019,117706,0,0,241,95,146
2019,117706,10,0,241,95,146
2019,117706,10,4,241,95,146
2019,117706,20,0,183,69,114
2019,117706,20,4,183,69,114
2019,117706,30,0,52,24,28
2019,117706,30,4,52,24,28
2019,117706,40,0,6,2,4
2019,117706,40,4,6,2,4
2019,117706,42,0,6,2,4
2019,117706,42,4,6,2,4
2019,117715,0,0,94,35,59
2019,117715,10,0,94,35,59
2019,117715,10,4,94,35,59
2019,117715,20,0,67,27,40
2019,117715,20,4,67,27,40
2019,117715,30,0,20,7,13
2019,117715,30,4,20,7,13
2019,117715,40,0,7,1,6
2019,117715,40,4,7,1,6
2019,117715,42,0,4,1,3
2019,117715,42,4,4,1,3
2019,117715,43,0,3,0,3
2019,117715,43,4,3,0,3
2019,117724,0,0,183,91,92
2019,117724,10,0,183,91,92
2019,117724,10,4,183,91,92
2019,117724,20,0,138,72,66
2019,117724,20,4,138,72,66
2019,117724,30,0,43,19,24
2019,117724,30,4,43,19,24
2019,117724,40,0,2,0,2
2019,117724,40,4,2,0,2
2019,117724,42,0,1,0,1
2019,117724,42,4,1,0,1
2019,117724,43,0,1,0,1
2019,117724,43,4,1,0,1
2019,117733,0,0,200,91,109
2019,117733,10,0,200,91,109
2019,117733,10,4,200,91,109
2019,117733,20,0,149,72,77
2019,117733,20,4,149,72,77
2019,117733,30,0,46,19,27
2019,117733,30,4,46,19,27
2019,117733,40,0,5,0,5
2019,117733,40,4,5,0,5
2019,117733,42,0,4,0,4
2019,117733,42,4,4,0,4
2019,117733,43,0,1,0,1
2019,117733,43,4,1,0,1
2019,117751,0,0,62,52,10
2019,117751,10,0,62,52,10
2019,117751,10,1,24,23,1
2019,117751,10,2,17,15,2
2019,117751,10,3,16,11,5
2019,117751,10,4,5,3,2
2019,117751,40,0,62,52,10
2019,117751,40,1,24,23,1
2019,117751,40,2,17,15,2
2019,117751,40,3,16,11,5
2019,117751,40,4,5,3,2
2019,117751,42,0,62,52,10
2019,117751,42,1,24,23,1
2019,117751,42,2,17,15,2
2019,117751,42,3,16,11,5
2019,117751,42,4,5,3,2
2019,117788,0,0,186,83,103
2019,117788,10,0,186,83,103
2019,117788,10,4,186,83,103
2019,117788,20,0,161,78,83
2019,117788,20,4,161,78,83
2019,117788,30,0,20,5,15
2019,117788,30,4,20,5,15
2019,117788,40,0,5,0,5
2019,117788,40,4,5,0,5
2019,117788,42,0,3,0,3
2019,117788,42,4,3,0,3
2019,117788,43,0,2,0,2
2019,117788,43,4,2,0,2
2019,117803,0,0,23,3,20
2019,117803,10,0,23,3,20
2019,117803,10,6,23,3,20
2019,117803,40,0,23,3,20
2019,117803,40,6,23,3,20
2019,117803,41,0,23,3,20
2019,117803,41,6,23,3,20
2019,117803,45,0,23,3,20
2019,117803,45,6,23,3,20
2019,117867,0,0,105,48,57
2019,117867,10,0,105,48,57
2019,117867,10,4,105,48,57
2019,117867,20,0,81,40,41
2019,117867,20,4,81,40,41
2019,117867,30,0,21,8,13
2019,117867,30,4,21,8,13
2019,117867,40,0,3,0,3
2019,117867,40,4,3,0,3
2019,117867,42,0,3,0,3
2019,117867,42,4,3,0,3
2019,117894,0,0,157,75,82
2019,117894,10,0,157,75,82
2019,117894,10,4,157,75,82
2019,117894,20,0,70,37,33
2019,117894,20,4,70,37,33
2019,117894,30,0,46,20,26
2019,117894,30,4,46,20,26
2019,117894,40,0,41,18,23
2019,117894,40,4,41,18,23
2019,117894,42,0,8,4,4
2019,117894,42,4,8,4,4
2019,117894,43,0,33,14,19
2019,117894,43,4,33,14,19
2019,117946,0,0,621,320,301
2019,117946,10,0,621,320,301
2019,117946,10,1,243,154,89
2019,117946,10,2,153,59,94
2019,117946,10,3,191,94,97
2019,117946,10,4,33,12,21
2019,117946,10,6,1,1,0
2019,117946,20,0,351,197,154
2019,117946,20,1,228,145,83
2019,117946,20,2,118,49,69
2019,117946,20,3,5,3,2
2019,117946,30,0,104,48,56
2019,117946,30,2,3,1,2
2019,117946,30,3,101,47,54
2019,117946,40,0,166,75,91
2019,117946,40,1,15,9,6
2019,117946,40,2,32,9,23
2019,117946,40,3,85,44,41
2019,117946,40,4,33,12,21
2019,117946,40,6,1,1,0
2019,117946,41,0,166,75,91
2019,117946,41,1,15,9,6
2019,117946,41,2,32,9,23
2019,117946,41,3,85,44,41
2019,117946,41,4,33,12,21
2019,117946,41,6,1,1,0
2019,117946,44,0,166,75,91
2019,117946,44,1,15,9,6
2019,117946,44,2,32,9,23
2019,117946,44,3,85,44,41
2019,117946,44,4,33,12,21
2019,117946,44,6,1,1,0
2019,118198,0,0,18,7,11
2019,118198,10,0,18,7,11
2019,118198,10,4,18,7,11
2019,118198,40,0,18,7,11
2019,118198,40,4,18,7,11
2019,118198,41,0,18,7,11
2019,118198,41,4,18,7,11
2019,118198,45,0,18,7,11
2019,118198,45,4,18,7,11
2019,118347,0,0,119,50,69
2019,118347,10,0,119,50,69
2019,118347,10,4,119,50,69
2019,118347,20,0,92,41,51
2019,118347,20,4,92,41,51
2019,118347,30,0,17,5,12
2019,118347,30,4,17,5,12
2019,118347,40,0,10,4,6
2019,118347,40,4,10,4,6
2019,118347,43,0,10,4,6
2019,118347,43,4,10,4,6
2019,118541,0,0,31,17,14
2019,118541,10,0,31,17,14
2019,118541,10,1,14,9,5
2019,118541,10,2,12,5,7
2019,118541,10,3,5,3,2
2019,118541,40,0,31,17,14
2019,118541,40,1,14,9,5
2019,118541,40,2,12,5,7
2019,118541,40,3,5,3,2
2019,118541,41,0,31,17,14
2019,118541,41,1,14,9,5
2019,118541,41,2,12,5,7
2019,118541,41,3,5,3,2
2019,118541,44,0,31,17,14
2019,118541,44,1,14,9,5
2019,118541,44,2,12,5,7
2019,118541,44,3,5,3,2
2019,118684,0,0,56,29,27
2019,118684,10,0,56,29,27
2019,118684,10,4,56,29,27
2019,118684,20,0,22,12,10
2019,118684,20,4,22,12,10
2019,118684,30,0,25,13,12
2019,118684,30,4,25,13,12
2019,118684,40,0,9,4,5
2019,118684,40,4,9,4,5
2019,118684,42,0,9,4,5
2019,118684,42,4,9,4,5
2019,118693,0,0,23,11,12
2019,118693,10,0,23,11,12
2019,118693,10,1,10,4,6
2019,118693,10,2,6,4,2
2019,118693,10,3,4,1,3
2019,118693,10,4,1,1,0
2019,118693,10,5,2,1,1
2019,118693,40,0,23,11,12
2019,118693,40,1,10,4,6
2019,118693,40,2,6,4,2
2019,118693,40,3,4,1,3
2019,118693,40,4,1,1,0
2019,118693,40,5,2,1,1
2019,118693,41,0,22,11,11
2019,118693,41,1,10,4,6
2019,118693,41,2,6,4,2
2019,118693,41,3,4,1,3
2019,118693,41,4,1,1,0
2019,118693,41,5,1,1,0
2019,118693,42,0,1,0,1
2019,118693,42,5,1,0,1
2019,118693,44,0,22,11,11
2019,118693,44,1,10,4,6
2019,118693,44,2,6,4,2
2019,118693,44,3,4,1,3
2019,118693,44,4,1,1,0
2019,118693,44,5,1,1,0
2019,118718,0,0,199,91,108
2019,118718,10,0,199,91,108
2019,118718,10,4,199,91,108
2019,118718,20,0,132,64,68
2019,118718,20,4,132,64,68
2019,118718,30,0,57,22,35
2019,118718,30,4,57,22,35
2019,118718,40,0,10,5,5
2019,118718,40,4,10,5,5
2019,118718,42,0,10,5,5
2019,118718,42,4,10,5,5
2019,118772,0,0,77,33,44
2019,118772,10,0,77,33,44
2019,118772,10,4,77,33,44
2019,118772,20,0,50,21,29
2019,118772,20,4,50,21,29
2019,118772,30,0,19,9,10
2019,118772,30,4,19,9,10
2019,118772,40,0,8,3,5
2019,118772,40,4,8,3,5
2019,118772,43,0,8,3,5
2019,118772,43,4,8,3,5
2019,118888,0,0,83,22,61
2019,118888,10,0,83,22,61
2019,118888,10,1,41,8,33
2019,118888,10,2,20,6,14
2019,118888,10,3,22,8,14
2019,118888,20,0,44,10,34
2019,118888,20,1,30,6,24
2019,118888,20,2,14,4,10
2019,118888,30,0,11,3,8
2019,118888,30,1,1,0,1
2019,118888,30,2,3,1,2
2019,118888,30,3,7,2,5
2019,118888,40,0,28,9,19
2019,118888,40,1,10,2,8
2019,118888,40,2,3,1,2
2019,118888,40,3,15,6,9
2019,118888,41,0,11,6,5
2019,118888,41,1,3,2,1
2019,118888,41,2,3,1,2
2019,118888,41,3,5,3,2
2019,118888,42,0,17,3,14
2019,118888,42,1,7,0,7
2019,118888,42,3,10,3,7
2019,118888,44,0,11,6,5
2019,118888,44,1,3,2,1
2019,118888,44,2,3,1,2
2019,118888,44,3,5,3,2
2019,118912,0,0,186,86,100
2019,118912,10,0,186,86,100
2019,118912,10,4,186,86,100
2019,118912,20,0,125,63,62
2019,118912,20,4,125,63,62
2019,118912,30,0,16,6,10
2019,118912,30,4,16,6,10
2019,118912,40,0,45,17,28
2019,118912,40,4,45,17,28
2019,118912,42,0,38,16,22
2019,118912,42,4,38,16,22
2019,118912,43,0,7,1,6
2019,118912,43,4,7,1,6
2019,118930,0,0,210,69,141
2019,118930,10,0,210,69,141
2019,118930,10,4,210,69,141
2019,118930,20,0,106,37,69
2019,118930,20,4,106,37,69
2019,118930,30,0,29,13,16
2019,118930,30,4,29,13,16
2019,118930,40,0,75,19,56
2019,118930,40,4,75,19,56
2019,118930,43,0,75,19,56
2019,118930,43,4,75,19,56
2019,118976,0,0,255,115,140
2019,118976,10,0,255,115,140
2019,118976,10,4,255,115,140
2019,118976,20,0,96,41,55
2019,118976,20,4,96,41,55
2019,118976,30,0,53,36,17
2019,118976,30,4,53,36,17
2019,118976,40,0,106,38,68
2019,118976,40,4,106,38,68
2019,118976,42,0,101,35,66
2019,118976,42,4,101,35,66
2019,118976,43,0,5,3,2
2019,118976,43,4,5,3,2
2019,119058,0,0,74,36,38
2019,119058,10,0,74,36,38
2019,119058,10,1,16,10,6
2019,119058,10,2,12,4,8
2019,119058,10,3,20,8,12
2019,119058,10,4,1,0,1
2019,119058,10,6,25,14,11
2019,119058,40,0,74,36,38
2019,119058,40,1,16,10,6
2019,119058,40,2,12,4,8
2019,119058,40,3,20,8,12
2019,119058,40,4,1,0,1
2019,119058,40,6,25,14,11
2019,119058,41,0,69,35,34
2019,119058,41,1,16,10,6
2019,119058,41,2,12,4,8
2019,119058,41,3,20,8,12
2019,119058,41,4,1,0,1
2019,119058,41,6,20,13,7
2019,119058,42,0,2,1,1
2019,119058,42,6,2,1,1
2019,119058,43,0,3,0,3
2019,119058,43,6,3,0,3
2019,119058,44,0,69,35,34
2019,119058,44,1,16,10,6
2019,119058,44,2,12,4,8
2019,119058,44,3,20,8,12
2019,119058,44,4,1,0,1
2019,119058,44,6,20,13,7
2019,119067,0,0,131,60,71
2019,119067,10,0,131,60,71
2019,119067,10,4,131,60,71
2019,119067,20,0,77,42,35
2019,119067,20,4,77,42,35
2019,119067,30,0,33,12,21
2019,119067,30,4,33,12,21
2019,119067,40,0,21,6,15
2019,119067,40,4,21,6,15
2019,119067,42,0,2,0,2
2019,119067,42,4,2,0,2
2019,119067,43,0,19,6,13
2019,119067,43,4,19,6,13
2019,119137,0,0,168,74,94
2019,119137,10,0,168,74,94
2019,119137,10,4,168,74,94
2019,119137,20,0,124,56,68
2019,119137,20,4,124,56,68
2019,119137,30,0,41,17,24
2019,119137,30,4,41,17,24
2019,119137,40,0,3,1,2
2019,119137,40,4,3,1,2
2019,119137,42,0,2,1,1
2019,119137,42,4,2,1,1
2019,119137,43,0,1,0,1
2019,119137,43,4,1,0,1
2019,119164,0,0,454,212,242
2019,119164,10,0,454,212,242
2019,119164,10,4,454,212,242
2019,119164,20,0,347,164,183
2019,119164,20,4,347,164,183
2019,119164,30,0,91,45,46
2019,119164,30,4,91,45,46
2019,119164,40,0,16,3,13
2019,119164,40,4,16,3,13
2019,119164,42,0,3,0,3
2019,119164,42,4,3,0,3
2019,119164,43,0,13,3,10
2019,119164,43,4,13,3,10
2019,119173,0,0,132,38,94
2019,119173,10,0,132,38,94
2019,119173,10,1,31,11,20
2019,119173,10,2,33,10,23
2019,119173,10,3,56,12,44
2019,119173,10,4,12,5,7
2019,119173,20,0,57,17,40
2019,119173,20,1,29,10,19
2019,119173,20,2,20,5,15
2019,119173,20,3,8,2,6
2019,119173,30,0,27,8,19
2019,119173,30,2,9,4,5
2019,119173,30,3,18,4,14
2019,119173,40,0,48,13,35
2019,119173,40,1,2,1,1
2019,119173,40,2,4,1,3
2019,119173,40,3,30,6,24
2019,119173,40,4,12,5,7
2019,119173,42,0,47,13,34
2019,119173,42,1,2,1,1
2019,119173,42,2,4,1,3
2019,119173,42,3,30,6,24
2019,119173,42,4,11,5,6
2019,119173,43,0,1,0,1
2019,119173,43,4,1,0,1
2019,119216,0,0,196,88,108
2019,119216,10,0,196,88,108
2019,119216,10,4,196,88,108
2019,119216,20,0,125,55,70
2019,119216,20,4,125,55,70
2019,119216,30,0,56,28,28
2019,119216,30,4,56,28,28
2019,119216,40,0,15,5,10
2019,119216,40,4,15,5,10
2019,119216,42,0,15,5,10
2019,119216,42,4,15,5,10
2019,119270,0,0,65,53,12
2019,119270,10,0,65,53,12
2019,119270,10,4,65,53,12
2019,119270,40,0,65,53,12
2019,119270,40,4,65,53,12
2019,119270,41,0,65,53,12
2019,119270,41,4,65,53,12
2019,119270,45,0,65,53,12
2019,119270,45,4,65,53,12
2019,119331,0,0,120,46,74
2019,119331,10,0,120,46,74
2019,119331,10,4,120,46,74
2019,119331,20,0,76,29,47
2019,119331,20,4,76,29,47
2019,119331,30,0,38,15,23
2019,119331,30,4,38,15,23
2019,119331,40,0,6,2,4
2019,119331,40,4,6,2,4
2019,119331,42,0,3,0,3
2019,119331,42,4,3,0,3
2019,119331,43,0,3,2,1
2019,119331,43,4,3,2,1
2019,119605,0,0,250,126,124
2019,119605,10,0,237,120,117
2019,119605,10,1,126,71,55
2019,119605,10,2,72,29,43
2019,119605,10,3,39,20,19
2019,119605,40,0,237,120,117
2019,119605,40,1,126,71,55
2019,119605,40,2,72,29,43
2019,119605,40,3,39,20,19
2019,119605,41,0,237,120,117
2019,119605,41,1,126,71,55
2019,119605,41,2,72,29,43
2019,119605,41,3,39,20,19
2019,119605,44,0,237,120,117
2019,119605,44,1,126,71,55
2019,119605,44,2,72,29,43
2019,119605,44,3,39,20,19
2019,119605,50,0,13,6,7
2019,119678,0,0,284,230,54
2019,119678,10,0,284,230,54
2019,119678,10,1,83,70,13
2019,119678,10,2,74,58,16
2019,119678,10,3,44,33,11
2019,119678,10,5,83,69,14
2019,119678,20,0,134,107,27
2019,119678,20,1,68,57,11
2019,119678,20,2,66,50,16
2019,119678,30,0,52,41,11
2019,119678,30,2,8,8,0
2019,119678,30,3,44,33,11
2019,119678,40,0,98,82,16
2019,119678,40,1,15,13,2
2019,119678,40,5,83,69,14
2019,119678,42,0,98,82,16
2019,119678,42,1,15,13,2
2019,119678,42,5,83,69,14
2019,119775,0,0,17,10,7
2019,119775,10,0,17,10,7
2019,119775,10,1,4,2,2
2019,119775,10,2,7,3,4
2019,119775,10,3,5,4,1
2019,119775,10,5,1,1,0
2019,119775,40,0,17,10,7
2019,119775,40,1,4,2,2
2019,119775,40,2,7,3,4
2019,119775,40,3,5,4,1
2019,119775,40,5,1,1,0
2019,119775,41,0,17,10,7
2019,119775,41,1,4,2,2
2019,119775,41,2,7,3,4
2019,119775,41,3,5,4,1
2019,119775,41,5,1,1,0
2019,119775,45,0,17,10,7
2019,119775,45,1,4,2,2
2019,119775,45,2,7,3,4
2019,119775,45,3,5,4,1
2019,119775,45,5,1,1,0
2019,120078,0,0,6,1,5
2019,120078,50,0,6,1,5
2019,120166,0,0,4,4,0
2019,120166,10,0,4,4,0
2019,120166,10,4,4,4,0
2019,120166,40,0,4,4,0
2019,120166,40,4,4,4,0
2019,120166,41,0,4,4,0
2019,120166,41,4,4,4,0
2019,120166,45,0,4,4,0
2019,120166,45,4,4,4,0
2019,120184,0,0,35,14,21
2019,120184,10,0,35,14,21
2019,120184,10,1,19,11,8
2019,120184,10,2,7,2,5
2019,120184,10,3,8,1,7
2019,120184,10,4,1,0,1
2019,120184,20,0,22,11,11
2019,120184,20,1,19,11,8
2019,120184,20,2,3,0,3
2019,120184,30,0,3,0,3
2019,120184,30,2,1,0,1
2019,120184,30,3,2,0,2
2019,120184,40,0,10,3,7
2019,120184,40,2,3,2,1
2019,120184,40,3,6,1,5
2019,120184,40,4,1,0,1
2019,120184,42,0,10,3,7
2019,120184,42,2,3,2,1
2019,120184,42,3,6,1,5
2019,120184,42,4,1,0,1
2019,120254,0,0,195,97,98
2019,120254,10,0,195,97,98
2019,120254,10,1,72,36,36
2019,120254,10,2,44,19,25
2019,120254,10,3,31,15,16
2019,120254,10,6,48,27,21
2019,120254,20,0,113,54,59
2019,120254,20,1,72,36,36
2019,120254,20,2,41,18,23
2019,120254,30,0,34,16,18
2019,120254,30,2,3,1,2
2019,120254,30,3,31,15,16
2019,120254,40,0,48,27,21
2019,120254,40,6,48,27,21
2019,120254,41,0,38,20,18
2019,120254,41,6,38,20,18
2019,120254,42,0,10,7,3
2019,120254,42,6,10,7,3
2019,120254,44,0,38,20,18
2019,120254,44,6,38,20,18
2019,120290,0,0,128,55,73
2019,120290,10,0,128,55,73
2019,120290,10,4,128,55,73
2019,120290,20,0,88,35,53
2019,120290,20,4,88,35,53
2019,120290,30,0,30,14,16
2019,120290,30,4,30,14,16
2019,120290,40,0,10,6,4
2019,120290,40,4,10,6,4
2019,120290,42,0,1,1,0
2019,120290,42,4,1,1,0
2019,120290,43,0,9,5,4
2019,120290,43,4,9,5,4
2019,120342,0,0,283,135,148
2019,120342,10,0,283,135,148
2019,120342,10,4,283,135,148
2019,120342,20,0,189,95,94
2019,120342,20,4,189,95,94
2019,120342,30,0,89,39,50
2019,120342,30,4,89,39,50
2019,120342,40,0,5,1,4
2019,120342,40,4,5,1,4
2019,120342,43,0,5,1,4
2019,120342,43,4,5,1,4
2019,120403,0,0,53,23,30
2019,120403,10,0,53,23,30
2019,120403,10,1,16,6,10
2019,120403,10,2,18,9,9
2019,120403,10,3,19,8,11
2019,120403,40,0,53,23,30
2019,120403,40,1,16,6,10
2019,120403,40,2,18,9,9
2019,120403,40,3,19,8,11
2019,120403,41,0,30,15,15
2019,120403,41,1,14,5,9
2019,120403,41,2,13,8,5
2019,120403,41,3,3,2,1
2019,120403,42,0,23,8,15
2019,120403,42,1,2,1,1
2019,120403,42,2,5,1,4
2019,120403,42,3,16,6,10
2019,120403,44,0,30,15,15
2019,120403,44,1,14,5,9
2019,120403,44,2,13,8,5
2019,120403,44,3,3,2,1
2019,120421,0,0,96,48,48
2019,120421,10,0,96,48,48
2019,120421,10,4,96,48,48
2019,120421,20,0,57,31,26
2019,120421,20,4,57,31,26
2019,120421,30,0,34,16,18
2019,120421,30,4,34,16,18
2019,120421,40,0,5,1,4
2019,120421,40,4,5,1,4
2019,120421,42,0,2,0,2
2019,120421,42,4,2,0,2
2019,120421,43,0,3,1,2
2019,120421,43,4,3,1,2
2019,120537,0,0,34,17,17
2019,120537,10,0,34,17,17
2019,120537,10,1,5,2,3
2019,120537,10,2,20,11,9
2019,120537,10,3,9,4,5
2019,120537,40,0,34,17,17
2019,120537,40,1,5,2,3
2019,120537,40,2,20,11,9
2019,120537,40,3,9,4,5
2019,120537,42,0,34,17,17
2019,120537,42,1,5,2,3
2019,120537,42,2,20,11,9
2019,120537,42,3,9,4,5
2019,120661,0,0,23,7,16
2019,120661,10,0,23,7,16
2019,120661,10,4,23,7,16
2019,120661,40,0,23,7,16
2019,120661,40,4,23,7,16
2019,120661,41,0,23,7,16
2019,120661,41,4,23,7,16
2019,120661,45,0,23,7,16
2019,120661,45,4,23,7,16
2019,120698,0,0,50,17,33
2019,120698,10,0,50,17,33
2019,120698,10,1,18,7,11
2019,120698,10,2,14,5,9
2019,120698,10,3,6,1,5
2019,120698,10,6,12,4,8
2019,120698,20,0,13,6,7
2019,120698,20,1,9,5,4
2019,120698,20,2,3,1,2
2019,120698,20,3,1,0,1
2019,120698,30,0,6,2,4
2019,120698,30,2,4,1,3
2019,120698,30,3,2,1,1
2019,120698,40,0,31,9,22
2019,120698,40,1,9,2,7
2019,120698,40,2,7,3,4
2019,120698,40,3,3,0,3
2019,120698,40,6,12,4,8
2019,120698,42,0,31,9,22
2019,120698,42,1,9,2,7
2019,120698,42,2,7,3,4
2019,120698,42,3,3,0,3
2019,120698,42,6,12,4,8
2019,120768,0,0,20,5,15
2019,120768,10,0,20,5,15
2019,120768,10,6,20,5,15
2019,120768,40,0,20,5,15
2019,120768,40,6,20,5,15
2019,120768,42,0,20,5,15
2019,120768,42,6,20,5,15
2019,120795,0,0,9,4,5
2019,120795,10,0,8,3,5
2019,120795,10,1,2,1,1
2019,120795,10,2,1,1,0
2019,120795,10,3,4,0,4
2019,120795,10,4,1,1,0
2019,120795,20,0,1,1,0
2019,120795,20,1,1,1,0
2019,120795,30,0,1,0,1
2019,120795,30,1,1,0,1
2019,120795,40,0,6,2,4
2019,120795,40,2,1,1,0
2019,120795,40,3,4,0,4
2019,120795,40,4,1,1,0
2019,120795,41,0,5,1,4
2019,120795,41,2,1,1,0
2019,120795,41,3,4,0,4
2019,120795,42,0,1,1,0
2019,120795,42,4,1,1,0
2019,120795,44,0,5,1,4
2019,120795,44,2,1,1,0
2019,120795,44,3,4,0,4
2019,120795,50,0,1,1,0
2019,120865,0,0,77,36,41
2019,120865,10,0,77,36,41
2019,120865,10,1,30,16,14
2019,120865,10,2,16,9,7
2019,120865,10,3,26,8,18
2019,120865,10,4,5,3,2
2019,120865,20,0,30,16,14
2019,120865,20,1,22,12,10
2019,120865,20,2,8,4,4
2019,120865,30,0,25,14,11
2019,120865,30,1,7,4,3
2019,120865,30,2,4,4,0
2019,120865,30,3,12,4,8
2019,120865,30,4,2,2,0
2019,120865,40,0,22,6,16
2019,120865,40,1,1,0,1
2019,120865,40,2,4,1,3
2019,120865,40,3,14,4,10
2019,120865,40,4,3,1,2
2019,120865,42,0,22,6,16
2019,120865,42,1,1,0,1
2019,120865,42,2,4,1,3
2019,120865,42,3,14,4,10
2019,120865,42,4,3,1,2
2019,120883,0,0,410,224,186
2019,120883,10,0,410,224,186
2019,120883,10,1,148,93,55
2019,120883,10,2,123,62,61
2019,120883,10,3,110,53,57
2019,120883,10,4,12,7,5
2019,120883,10,5,17,9,8
2019,120883,20,0,232,139,93
2019,120883,20,1,126,85,41
2019,120883,20,2,101,51,50
2019,120883,20,3,5,3,2
2019,120883,30,0,58,28,30
2019,120883,30,2,2,0,2
2019,120883,30,3,56,28,28
2019,120883,40,0,120,57,63
2019,120883,40,1,22,8,14
2019,120883,40,2,20,11,9
2019,120883,40,3,49,22,27
2019,120883,40,4,12,7,5
2019,120883,40,5,17,9,8
2019,120883,41,0,120,57,63
2019,120883,41,1,22,8,14
2019,120883,41,2,20,11,9
2019,120883,41,3,49,22,27
2019,120883,41,4,12,7,5
2019,120883,41,5,17,9,8
2019,120883,44,0,120,57,63
2019,120883,44,1,22,8,14
2019,120883,44,2,20,11,9
2019,120883,44,3,49,22,27
2019,120883,44,4,12,7,5
2019,120883,44,5,17,9,8
2019,120953,0,0,32,18,14
2019,120953,10,0,32,18,14
2019,120953,10,4,32,18,14
2019,120953,20,0,22,14,8
2019,120953,20,4,22,14,8
2019,120953,30,0,10,4,6
2019,120953,30,4,10,4,6
2019,120971,0,0,314,152,162
2019,120971,10,0,314,152,162
2019,120971,10,4,314,152,162
2019,120971,20,0,144,71,73
2019,120971,20,4,144,71,73
2019,120971,30,0,164,76,88
2019,120971,30,4,164,76,88
2019,120971,40,0,6,5,1
2019,120971,40,4,6,5,1
2019,120971,42,0,2,1,1
2019,120971,42,4,2,1,1
2019,120971,43,0,4,4,0
2019,120971,43,4,4,4,0
2019,121044,0,0,444,190,254
2019,121044,10,0,444,190,254
2019,121044,10,4,444,190,254
2019,121044,20,0,238,96,142
2019,121044,20,4,238,96,142
2019,121044,30,0,193,89,104
2019,121044,30,4,193,89,104
2019,121044,40,0,13,5,8
2019,121044,40,4,13,5,8
2019,121044,42,0,4,2,2
2019,121044,42,4,4,2,2
2019,121044,43,0,9,3,6
2019,121044,43,4,9,3,6
2019,121150,0,0,400,220,180
2019,121150,10,0,400,220,180
2019,121150,10,1,138,93,45
2019,121150,10,2,79,37,42
2019,121150,10,3,104,49,55
2019,121150,10,4,42,20,22
2019,121150,10,5,20,10,10
2019,121150,10,6,17,11,6
2019,121150,20,0,192,122,70
2019,121150,20,1,126,88,38
2019,121150,20,2,64,32,32
2019,121150,20,3,2,2,0
2019,121150,30,0,69,37,32
2019,121150,30,1,1,0,1
2019,121150,30,2,13,4,9
2019,121150,30,3,55,33,22
2019,121150,40,0,139,61,78
2019,121150,40,1,11,5,6
2019,121150,40,2,2,1,1
2019,121150,40,3,47,14,33
2019,121150,40,4,42,20,22
2019,121150,40,5,20,10,10
2019,121150,40,6,17,11,6
2019,121150,42,0,139,61,78
2019,121150,42,1,11,5,6
2019,121150,42,2,2,1,1
2019,121150,42,3,47,14,33
2019,121150,42,4,42,20,22
2019,121150,42,5,20,10,10
2019,121150,42,6,17,11,6
2019,121178,0,0,4,2,2
2019,121178,10,0,4,2,2
2019,121178,10,4,4,2,2
2019,121178,20,0,2,1,1
2019,121178,20,4,2,1,1
2019,121178,30,0,2,1,1
2019,121178,30,4,2,1,1
2019,121257,0,0,101,43,58
2019,121257,10,0,101,43,58
2019,121257,10,1,41,21,20
2019,121257,10,2,26,11,15
2019,121257,10,3,27,8,19
2019,121257,10,4,1,1,0
2019,121257,10,5,6,2,4
2019,121257,20,0,66,32,34
2019,121257,20,1,41,21,20
2019,121257,20,2,25,11,14
2019,121257,30,0,12,2,10
2019,121257,30,3,12,2,10
2019,121257,40,0,23,9,14
2019,121257,40,2,1,0,1
2019,121257,40,3,15,6,9
2019,121257,40,4,1,1,0
2019,121257,40,5,6,2,4
2019,121257,41,0,5,1,4
2019,121257,41,2,1,0,1
2019,121257,41,5,4,1,3
2019,121257,42,0,18,8,10
2019,121257,42,3,15,6,9
2019,121257,42,4,1,1,0
2019,121257,42,5,2,1,1
2019,121257,44,0,4,1,3
2019,121257,44,2,1,0,1
2019,121257,44,5,3,1,2
2019,121257,45,0,1,0,1
2019,121257,45,5,1,0,1
2019,121275,0,0,7,5,2
2019,121275,10,0,7,5,2
2019,121275,10,4,7,5,2
2019,121275,40,0,7,5,2
2019,121275,40,4,7,5,2
2019,121275,41,0,7,5,2
2019,121275,41,4,7,5,2
2019,121275,45,0,7,5,2
2019,121275,45,4,7,5,2
2019,121309,0,0,149,75,74
2019,121309,10,0,149,75,74
2019,121309,10,1,78,49,29
2019,121309,10,2,46,18,28
2019,121309,10,3,25,8,17
2019,121309,20,0,73,45,28
2019,121309,20,1,67,42,25
2019,121309,20,2,6,3,3
2019,121309,30,0,61,24,37
2019,121309,30,1,10,6,4
2019,121309,30,2,31,12,19
2019,121309,30,3,20,6,14
2019,121309,40,0,15,6,9
2019,121309,40,1,1,1,0
2019,121309,40,2,9,3,6
2019,121309,40,3,5,2,3
2019,121309,41,0,1,1,0
2019,121309,41,1,1,1,0
2019,121309,42,0,14,5,9
2019,121309,42,2,9,3,6
2019,121309,42,3,5,2,3
2019,121309,44,0,1,1,0
2019,121309,44,1,1,1,0
2019,121345,0,0,219,111,108
2019,121345,10,0,180,99,81
2019,121345,10,1,88,48,40
2019,121345,10,2,58,32,26
2019,121345,10,3,34,19,15
2019,121345,20,0,144,80,64
2019,121345,20,1,86,48,38
2019,121345,20,2,58,32,26
2019,121345,30,0,34,19,15
2019,121345,30,3,34,19,15
2019,121345,40,0,2,0,2
2019,121345,40,1,2,0,2
2019,121345,41,0,2,0,2
2019,121345,41,1,2,0,2
2019,121345,44,0,2,0,2
2019,121345,44,1,2,0,2
2019,121345,50,0,39,12,27
2019,121363,0,0,70,31,39
2019,121363,10,0,70,31,39
2019,121363,10,4,70,31,39
2019,121363,20,0,47,20,27
2019,121363,20,4,47,20,27
2019,121363,30,0,22,10,12
2019,121363,30,4,22,10,12
2019,121363,40,0,1,1,0
2019,121363,40,4,1,1,0
2019,121363,42,0,1,1,0
2019,121363,42,4,1,1,0
2019,121619,0,0,248,109,139
2019,121619,10,0,248,109,139
2019,121619,10,4,248,109,139
2019,121619,20,0,110,46,64
2019,121619,20,4,110,46,64
2019,121619,30,0,137,62,75
2019,121619,30,4,137,62,75
2019,121619,40,0,1,1,0
2019,121619,40,4,1,1,0
2019,121619,42,0,1,1,0
2019,121619,42,4,1,1,0
2019,121691,0,0,217,103,114
2019,121691,10,0,217,103,114
2019,121691,10,1,118,57,61
2019,121691,10,2,36,20,16
2019,121691,10,3,18,8,10
2019,121691,10,5,9,4,5
2019,121691,10,6,36,14,22
2019,121691,20,0,147,72,75
2019,121691,20,1,116,55,61
2019,121691,20,2,31,17,14
2019,121691,30,0,23,11,12
2019,121691,30,2,5,3,2
2019,121691,30,3,18,8,10
2019,121691,40,0,47,20,27
2019,121691,40,1,2,2,0
2019,121691,40,5,9,4,5
2019,121691,40,6,36,14,22
2019,121691,41,0,14,7,7
2019,121691,41,1,2,2,0
2019,121691,41,5,9,4,5
2019,121691,41,6,3,1,2
2019,121691,42,0,33,13,20
2019,121691,42,6,33,13,20
2019,121691,44,0,14,7,7
2019,121691,44,1,2,2,0
2019,121691,44,5,9,4,5
2019,121691,44,6,3,1,2
2019,121707,0,0,77,41,36
2019,121707,10,0,77,41,36
2019,121707,10,4,77,41,36
2019,121707,20,0,54,30,24
2019,121707,20,4,54,30,24
2019,121707,30,0,21,11,10
2019,121707,30,4,21,11,10
2019,121707,40,0,2,0,2
2019,121707,40,4,2,0,2
2019,121707,42,0,2,0,2
2019,121707,42,4,2,0,2
2019,121886,0,0,206,99,107
2019,121886,10,0,206,99,107
2019,121886,10,4,206,99,107
2019,121886,20,0,143,75,68
2019,121886,20,4,143,75,68
2019,121886,30,0,62,23,39
2019,121886,30,4,62,23,39
2019,121886,40,0,1,1,0
2019,121886,40,4,1,1,0
2019,121886,43,0,1,1,0
2019,121886,43,4,1,1,0
2019,121901,0,0,265,125,140
2019,121901,10,0,265,125,140
2019,121901,10,4,265,125,140
2019,121901,20,0,191,92,99
2019,121901,20,4,191,92,99
2019,121901,30,0,64,29,35
2019,121901,30,4,64,29,35
2019,121901,40,0,10,4,6
2019,121901,40,4,10,4,6
2019,121901,42,0,7,1,6
2019,121901,42,4,7,1,6
2019,121901,43,0,3,3,0
2019,121901,43,4,3,3,0
2019,122180,0,0,322,148,174
2019,122180,10,0,322,148,174
2019,122180,10,4,322,148,174
2019,122180,20,0,226,102,124
2019,122180,20,4,226,102,124
2019,122180,30,0,86,40,46
2019,122180,30,4,86,40,46
2019,122180,40,0,10,6,4
2019,122180,40,4,10,6,4
2019,122180,43,0,10,6,4
2019,122180,43,4,10,6,4
2019,122205,0,0,245,100,145
2019,122205,10,0,245,100,145
2019,122205,10,4,245,100,145
2019,122205,20,0,193,88,105
2019,122205,20,4,193,88,105
2019,122205,30,0,50,12,38
2019,122205,30,4,50,12,38
2019,122205,40,0,2,0,2
2019,122205,40,4,2,0,2
2019,122205,43,0,2,0,2
2019,122205,43,4,2,0,2
2019,122296,0,0,171,42,129
2019,122296,10,0,171,42,129
2019,122296,10,1,16,6,10
2019,122296,10,2,22,4,18
2019,122296,10,3,96,21,75
2019,122296,10,4,37,11,26
2019,122296,40,0,171,42,129
2019,122296,40,1,16,6,10
2019,122296,40,2,22,4,18
2019,122296,40,3,96,21,75
2019,122296,40,4,37,11,26
2019,122296,41,0,147,33,114
2019,122296,41,1,16,6,10
2019,122296,41,2,22,4,18
2019,122296,41,3,95,20,75
2019,122296,41,4,14,3,11
2019,122296,42,0,24,9,15
2019,122296,42,3,1,1,0
2019,122296,42,4,23,8,15
2019,122296,44,0,147,33,114
2019,122296,44,1,16,6,10
2019,122296,44,2,22,4,18
2019,122296,44,3,95,20,75
2019,122296,44,4,14,3,11
2019,122320,0,0,2,0,2
2019,122320,10,0,2,0,2
2019,122320,10,4,2,0,2
2019,122320,30,0,2,0,2
2019,122320,30,4,2,0,2
2019,122339,0,0,198,78,120
2019,122339,10,0,198,78,120
2019,122339,10,4,198,78,120
2019,122339,20,0,7,5,2
2019,122339,20,4,7,5,2
2019,122339,30,0,174,68,106
2019,122339,30,4,174,68,106
2019,122339,40,0,17,5,12
2019,122339,40,4,17,5,12
2019,122339,43,0,17,5,12
2019,122339,43,4,17,5,12
2019,122375,0,0,262,116,146
2019,122375,10,0,262,116,146
2019,122375,10,4,262,116,146
2019,122375,20,0,17,11,6
2019,122375,20,4,17,11,6
2019,122375,30,0,239,104,135
2019,122375,30,4,239,104,135
2019,122375,40,0,6,1,5
2019,122375,40,4,6,1,5
2019,122375,43,0,6,1,5
2019,122375,43,4,6,1,5
2019,122384,0,0,126,69,57
2019,122384,10,0,126,69,57
2019,122384,10,4,126,69,57
2019,122384,20,0,5,2,3
2019,122384,20,4,5,2,3
2019,122384,30,0,121,67,54
2019,122384,30,4,121,67,54
2019,122409,0,0,963,519,444
2019,122409,10,0,963,519,444
2019,122409,10,1,325,202,123
2019,122409,10,2,226,129,97
2019,122409,10,3,213,109,104
2019,122409,10,5,199,79,120
2019,122409,20,0,543,326,217
2019,122409,20,1,324,201,123
2019,122409,20,2,219,125,94
2019,122409,30,0,221,114,107
2019,122409,30,1,1,1,0
2019,122409,30,2,7,4,3
2019,122409,30,3,213,109,104
2019,122409,40,0,199,79,120
2019,122409,40,5,199,79,120
2019,122409,41,0,123,46,77
2019,122409,41,5,123,46,77
2019,122409,42,0,59,26,33
2019,122409,42,5,59,26,33
2019,122409,43,0,17,7,10
2019,122409,43,5,17,7,10
2019,122409,44,0,123,46,77
2019,122409,44,5,123,46,77
2019,122436,0,0,484,252,232
2019,122436,10,0,484,252,232
2019,122436,10,1,203,120,83
2019,122436,10,2,140,65,75
2019,122436,10,3,122,59,63
2019,122436,10,4,15,8,7
2019,122436,10,6,4,0,4
2019,122436,20,0,283,160,123
2019,122436,20,1,161,100,61
2019,122436,20,2,122,60,62
2019,122436,30,0,96,47,49
2019,122436,30,1,1,0,1
2019,122436,30,2,8,2,6
2019,122436,30,3,86,44,42
2019,122436,30,4,1,1,0
2019,122436,40,0,105,45,60
2019,122436,40,1,41,20,21
2019,122436,40,2,10,3,7
2019,122436,40,3,36,15,21
2019,122436,40,4,14,7,7
2019,122436,40,6,4,0,4
2019,122436,41,0,32,11,21
2019,122436,41,1,12,3,9
2019,122436,41,2,7,2,5
2019,122436,41,3,9,3,6
2019,122436,41,4,4,3,1
2019,122436,42,0,73,34,39
2019,122436,42,1,29,17,12
2019,122436,42,2,3,1,2
2019,122436,42,3,27,12,15
2019,122436,42,4,10,4,6
2019,122436,42,6,4,0,4
2019,122436,45,0,32,11,21
2019,122436,45,1,12,3,9
2019,122436,45,2,7,2,5
2019,122436,45,3,9,3,6
2019,122436,45,4,4,3,1
2019,122454,0,0,16,10,6
2019,122454,10,0,16,10,6
2019,122454,10,1,3,2,1
2019,122454,10,2,10,6,4
2019,122454,10,3,3,2,1
2019,122454,20,0,13,8,5
2019,122454,20,1,3,2,1
2019,122454,20,2,10,6,4
2019,122454,30,0,3,2,1
2019,122454,30,3,3,2,1
2019,122506,0,0,30,23,7
2019,122506,10,0,30,23,7
2019,122506,10,6,30,23,7
2019,122506,40,0,30,23,7
2019,122506,40,6,30,23,7
2019,122506,41,0,7,6,1
2019,122506,41,6,7,6,1
2019,122506,42,0,23,17,6
2019,122506,42,6,23,17,6
2019,122506,44,0,5,5,0
2019,122506,44,6,5,5,0
2019,122506,45,0,2,1,1
2019,122506,45,6,2,1,1
2019,122597,0,0,870,414,456
2019,122597,10,0,870,414,456
2019,122597,10,1,348,188,160
2019,122597,10,2,169,73,96
2019,122597,10,3,199,66,133
2019,122597,10,5,152,86,66
2019,122597,10,6,2,1,1
2019,122597,20,0,516,261,255
2019,122597,20,1,347,188,159
2019,122597,20,2,164,71,93
2019,122597,20,3,3,1,2
2019,122597,20,6,2,1,1
2019,122597,30,0,202,67,135
2019,122597,30,1,1,0,1
2019,122597,30,2,5,2,3
2019,122597,30,3,196,65,131
2019,122597,40,0,152,86,66
2019,122597,40,5,152,86,66
2019,122597,41,0,84,46,38
2019,122597,41,5,84,46,38
2019,122597,42,0,58,35,23
2019,122597,42,5,58,35,23
2019,122597,43,0,10,5,5
2019,122597,43,5,10,5,5
2019,122597,44,0,84,46,38
2019,122597,44,5,84,46,38
2019,122612,0,0,471,218,253
2019,122612,10,0,471,218,253
2019,122612,10,1,150,89,61
2019,122612,10,2,158,64,94
2019,122612,10,3,149,56,93
2019,122612,10,4,14,9,5
2019,122612,20,0,259,131,128
2019,122612,20,1,133,79,54
2019,122612,20,2,124,50,74
2019,122612,20,3,2,2,0
2019,122612,30,0,89,34,55
2019,122612,30,1,1,0,1
2019,122612,30,2,6,3,3
2019,122612,30,3,82,31,51
2019,122612,40,0,123,53,70
2019,122612,40,1,16,10,6
2019,122612,40,2,28,11,17
2019,122612,40,3,65,23,42
2019,122612,40,4,14,9,5
2019,122612,41,0,85,34,51
2019,122612,41,1,13,8,5
2019,122612,41,2,26,10,16
2019,122612,41,3,39,12,27
2019,122612,41,4,7,4,3
2019,122612,42,0,37,19,18
2019,122612,42,1,3,2,1
2019,122612,42,2,2,1,1
2019,122612,42,3,25,11,14
2019,122612,42,4,7,5,2
2019,122612,43,0,1,0,1
2019,122612,43,3,1,0,1
2019,122612,44,0,84,34,50
2019,122612,44,1,13,8,5
2019,122612,44,2,26,10,16
2019,122612,44,3,38,12,26
2019,122612,44,4,7,4,3
2019,122612,45,0,1,0,1
2019,122612,45,3,1,0,1
2019,122649,0,0,5,2,3
2019,122649,10,0,5,2,3
2019,122649,10,1,5,2,3
2019,122649,40,0,5,2,3
2019,122649,40,1,5,2,3
2019,122649,41,0,4,2,2
2019,122649,41,1,4,2,2
2019,122649,42,0,1,0,1
2019,122649,42,1,1,0,1
2019,122649,44,0,4,2,2
2019,122649,44,1,4,2,2
2019,122658,0,0,271,129,142
2019,122658,10,0,271,129,142
2019,122658,10,4,271,129,142
2019,122658,20,0,147,79,68
2019,122658,20,4,147,79,68
2019,122658,30,0,62,23,39
2019,122658,30,4,62,23,39
2019,122658,40,0,62,27,35
2019,122658,40,4,62,27,35
2019,122658,43,0,62,27,35
2019,122658,43,4,62,27,35
2019,122685,0,0,202,69,133
2019,122685,10,0,202,69,133
2019,122685,10,4,202,69,133
2019,122685,40,0,202,69,133
2019,122685,40,4,202,69,133
2019,122685,41,0,202,69,133
2019,122685,41,4,202,69,133
2019,122685,45,0,202,69,133
2019,122685,45,4,202,69,133
2019,122728,0,0,49,34,15
2019,122728,10,0,49,34,15
2019,122728,10,1,4,3,1
2019,122728,10,2,18,12,6
2019,122728,10,3,24,16,8
2019,122728,10,6,3,3,0
2019,122728,20,0,11,9,2
2019,122728,20,1,4,3,1
2019,122728,20,2,7,6,1
2019,122728,30,0,34,21,13
2019,122728,30,2,11,6,5
2019,122728,30,3,23,15,8
2019,122728,40,0,4,4,0
2019,122728,40,3,1,1,0
2019,122728,40,6,3,3,0
2019,122728,42,0,4,4,0
2019,122728,42,3,1,1,0
2019,122728,42,6,3,3,0
2019,122746,0,0,123,46,77
2019,122746,10,0,123,46,77
2019,122746,10,4,123,46,77
2019,122746,20,0,38,13,25
2019,122746,20,4,38,13,25
2019,122746,30,0,57,22,35
2019,122746,30,4,57,22,35
2019,122746,40,0,28,11,17
2019,122746,40,4,28,11,17
2019,122746,42,0,24,9,15
2019,122746,42,4,24,9,15
2019,122746,43,0,4,2,2
2019,122746,43,4,4,2,2
2019,122755,0,0,852,399,453
2019,122755,10,0,852,399,453
2019,122755,10,1,292,163,129
2019,122755,10,2,135,51,84
2019,122755,10,3,251,114,137
2019,122755,10,5,171,70,101
2019,122755,10,6,3,1,2
2019,122755,20,0,426,217,209
2019,122755,20,1,292,163,129
2019,122755,20,2,128,50,78
2019,122755,20,3,3,3,0
2019,122755,20,6,3,1,2
2019,122755,30,0,255,112,143
2019,122755,30,2,7,1,6
2019,122755,30,3,248,111,137
2019,122755,40,0,171,70,101
2019,122755,40,5,171,70,101
2019,122755,41,0,123,48,75
2019,122755,41,5,123,48,75
2019,122755,42,0,46,21,25
2019,122755,42,5,46,21,25
2019,122755,43,0,2,1,1
2019,122755,43,5,2,1,1
2019,122755,44,0,123,48,75
2019,122755,44,5,123,48,75
2019,122782,0,0,1,1,0
2019,122782,10,0,1,1,0
2019,122782,10,4,1,1,0
2019,122782,20,0,1,1,0
2019,122782,20,4,1,1,0
2019,122791,0,0,149,69,80
2019,122791,10,0,149,69,80
2019,122791,10,4,149,69,80
2019,122791,20,0,95,44,51
2019,122791,20,4,95,44,51
2019,122791,30,0,47,20,27
2019,122791,30,4,47,20,27
2019,122791,40,0,7,5,2
2019,122791,40,4,7,5,2
2019,122791,43,0,7,5,2
2019,122791,43,4,7,5,2
2019,122834,0,0,10,5,5
2019,122834,10,0,10,5,5
2019,122834,10,4,10,5,5
2019,122834,40,0,10,5,5
2019,122834,40,4,10,5,5
2019,122834,41,0,10,5,5
2019,122834,41,4,10,5,5
2019,122834,45,0,10,5,5
2019,122834,45,4,10,5,5
2019,122889,0,0,687,291,396
2019,122889,10,0,687,291,396
2019,122889,10,4,687,291,396
2019,122889,20,0,189,88,101
2019,122889,20,4,189,88,101
2019,122889,30,0,45,18,27
2019,122889,30,4,45,18,27
2019,122889,40,0,453,185,268
2019,122889,40,4,453,185,268
2019,122889,42,0,2,1,1
2019,122889,42,4,2,1,1
2019,122889,43,0,451,184,267
2019,122889,43,4,451,184,267
2019,122931,0,0,568,306,262
2019,122931,10,0,568,306,262
2019,122931,10,1,147,92,55
2019,122931,10,2,145,91,54
2019,122931,10,3,97,43,54
2019,122931,10,5,179,80,99
2019,122931,20,0,291,182,109
2019,122931,20,1,147,92,55
2019,122931,20,2,144,90,54
2019,122931,30,0,98,44,54
2019,122931,30,2,1,1,0
2019,122931,30,3,97,43,54
2019,122931,40,0,179,80,99
2019,122931,40,5,179,80,99
2019,122931,41,0,160,69,91
2019,122931,41,5,160,69,91
2019,122931,42,0,19,11,8
2019,122931,42,5,19,11,8
2019,122931,44,0,118,54,64
2019,122931,44,5,118,54,64
2019,122931,45,0,42,15,27
2019,122931,45,5,42,15,27
2019,122977,0,0,352,151,201
2019,122977,10,0,352,151,201
2019,122977,10,4,352,151,201
2019,122977,20,0,211,97,114
2019,122977,20,4,211,97,114
2019,122977,30,0,125,49,76
2019,122977,30,4,125,49,76
2019,122977,40,0,16,5,11
2019,122977,40,4,16,5,11
2019,122977,42,0,3,3,0
2019,122977,42,4,3,3,0
2019,122977,43,0,13,2,11
2019,122977,43,4,13,2,11
2019,123013,0,0,293,114,179
2019,123013,10,0,293,114,179
2019,123013,10,4,293,114,179
2019,123013,20,0,229,92,137
2019,123013,20,4,229,92,137
2019,123013,30,0,52,18,34
2019,123013,30,4,52,18,34
2019,123013,40,0,12,4,8
2019,123013,40,4,12,4,8
2019,123013,42,0,3,0,3
2019,123013,42,4,3,0,3
2019,123013,43,0,9,4,5
2019,123013,43,4,9,4,5
2019,123095,0,0,14,3,11
2019,123095,10,0,13,3,10
2019,123095,10,6,13,3,10
2019,123095,40,0,13,3,10
2019,123095,40,6,13,3,10
2019,123095,42,0,13,3,10
2019,123095,42,6,13,3,10
2019,123095,50,0,1,0,1
2019,123165,0,0,102,44,58
2019,123165,10,0,102,44,58
2019,123165,10,1,28,10,18
2019,123165,10,2,31,16,15
2019,123165,10,3,41,18,23
2019,123165,10,4,1,0,1
2019,123165,10,6,1,0,1
2019,123165,20,0,59,26,33
2019,123165,20,1,28,10,18
2019,123165,20,2,31,16,15
2019,123165,30,0,30,11,19
2019,123165,30,3,30,11,19
2019,123165,40,0,13,7,6
2019,123165,40,3,11,7,4
2019,123165,40,4,1,0,1
2019,123165,40,6,1,0,1
2019,123165,41,0,2,1,1
2019,123165,41,3,1,1,0
2019,123165,41,6,1,0,1
2019,123165,42,0,11,6,5
2019,123165,42,3,10,6,4
2019,123165,42,4,1,0,1
2019,123165,44,0,2,1,1
2019,123165,44,3,1,1,0
2019,123165,44,6,1,0,1
2019,123217,0,0,241,119,122
2019,123217,10,0,241,119,122
2019,123217,10,4,241,119,122
2019,123217,20,0,137,60,77
2019,123217,20,4,137,60,77
2019,123217,30,0,48,29,19
2019,123217,30,4,48,29,19
2019,123217,40,0,56,30,26
2019,123217,40,4,56,30,26
2019,123217,42,0,15,7,8
2019,123217,42,4,15,7,8
2019,123217,43,0,41,23,18
2019,123217,43,4,41,23,18
2019,123299,0,0,160,86,74
2019,123299,10,0,160,86,74
2019,123299,10,4,160,86,74
2019,123299,20,0,54,34,20
2019,123299,20,4,54,34,20
2019,123299,30,0,32,19,13
2019,123299,30,4,32,19,13
2019,123299,40,0,74,33,41
2019,123299,40,4,74,33,41
2019,123299,42,0,74,33,41
2019,123299,42,4,74,33,41
2019,123341,0,0,249,98,151
2019,123341,10,0,249,98,151
2019,123341,10,4,249,98,151
2019,123341,20,0,178,70,108
2019,123341,20,4,178,70,108
2019,123341,30,0,52,19,33
2019,123341,30,4,52,19,33
2019,123341,40,0,19,9,10
2019,123341,40,4,19,9,10
2019,123341,42,0,19,9,10
2019,123341,42,4,19,9,10
2019,123448,0,0,7,6,1
2019,123448,10,0,7,6,1
2019,123448,10,1,1,1,0
2019,123448,10,2,1,0,1
2019,123448,10,3,4,4,0
2019,123448,10,6,1,1,0
2019,123448,20,0,1,0,1
2019,123448,20,2,1,0,1
2019,123448,40,0,6,6,0
2019,123448,40,1,1,1,0
2019,123448,40,3,4,4,0
2019,123448,40,6,1,1,0
2019,123448,42,0,6,6,0
2019,123448,42,1,1,1,0
2019,123448,42,3,4,4,0
2019,123448,42,6,1,1,0
2019,123457,0,0,34,21,13
2019,123457,10,0,34,21,13
2019,123457,10,1,8,6,2
2019,123457,10,2,6,4,2
2019,123457,10,3,13,7,6
2019,123457,10,6,7,4,3
2019,123457,40,0,34,21,13
2019,123457,40,1,8,6,2
2019,123457,40,2,6,4,2
2019,123457,40,3,13,7,6
2019,123457,40,6,7,4,3
2019,123457,41,0,34,21,13
2019,123457,41,1,8,6,2
2019,123457,41,2,6,4,2
2019,123457,41,3,13,7,6
2019,123457,41,6,7,4,3
2019,123457,44,0,31,19,12
2019,123457,44,1,8,6,2
2019,123457,44,2,6,4,2
2019,123457,44,3,13,7,6
2019,123457,44,6,4,2,2
2019,123457,45,0,3,2,1
2019,123457,45,6,3,2,1
2019,123484,0,0,42,18,24
2019,123484,10,0,42,18,24
2019,123484,10,4,42,18,24
2019,123484,20,0,27,14,13
2019,123484,20,4,27,14,13
2019,123484,30,0,12,3,9
2019,123484,30,4,12,3,9
2019,123484,40,0,3,1,2
2019,123484,40,4,3,1,2
2019,123484,43,0,3,1,2
2019,123484,43,4,3,1,2
2019,123509,0,0,147,68,79
2019,123509,10,0,147,68,79
2019,123509,10,4,147,68,79
2019,123509,20,0,91,44,47
2019,123509,20,4,91,44,47
2019,123509,30,0,40,13,27
2019,123509,30,4,40,13,27
2019,123509,40,0,16,11,5
2019,123509,40,4,16,11,5
2019,123509,43,0,16,11,5
2019,123509,43,4,16,11,5
2019,123527,0,0,182,79,103
2019,123527,10,0,142,70,72
2019,123527,10,4,142,70,72
2019,123527,20,0,121,56,65
2019,123527,20,4,121,56,65
2019,123527,30,0,21,14,7
2019,123527,30,4,21,14,7
2019,123527,50,0,40,9,31
2019,123554,0,0,216,90,126
2019,123554,10,0,216,90,126
2019,123554,10,1,75,40,35
2019,123554,10,2,86,33,53
2019,123554,10,3,55,17,38
2019,123554,20,0,131,60,71
2019,123554,20,1,75,40,35
2019,123554,20,2,56,20,36
2019,123554,30,0,55,19,36
2019,123554,30,2,17,8,9
2019,123554,30,3,38,11,27
2019,123554,40,0,30,11,19
2019,123554,40,2,13,5,8
2019,123554,40,3,17,6,11
2019,123554,42,0,30,11,19
2019,123554,42,2,13,5,8
2019,123554,42,3,17,6,11
2019,123563,0,0,137,60,77
2019,123563,10,0,137,60,77
2019,123563,10,4,137,60,77
2019,123563,20,0,112,49,63
2019,123563,20,4,112,49,63
2019,123563,30,0,25,11,14
2019,123563,30,4,25,11,14
2019,123572,0,0,276,135,141
2019,123572,10,0,276,135,141
2019,123572,10,1,135,73,62
2019,123572,10,2,39,20,19
2019,123572,10,3,70,25,45
2019,123572,10,5,32,17,15
2019,123572,20,0,170,91,79
2019,123572,20,1,135,73,62
2019,123572,20,2,35,18,17
2019,123572,30,0,74,27,47
2019,123572,30,2,4,2,2
2019,123572,30,3,70,25,45
2019,123572,40,0,32,17,15
2019,123572,40,5,32,17,15
2019,123572,41,0,21,10,11
2019,123572,41,5,21,10,11
2019,123572,42,0,10,7,3
2019,123572,42,5,10,7,3
2019,123572,43,0,1,0,1
2019,123572,43,5,1,0,1
2019,123572,44,0,21,10,11
2019,123572,44,5,21,10,11
2019,123633,0,0,24,16,8
2019,123633,10,0,24,16,8
2019,123633,10,6,24,16,8
2019,123633,40,0,24,16,8
2019,123633,40,6,24,16,8
2019,123633,41,0,24,16,8
2019,123633,41,6,24,16,8
2019,123633,45,0,24,16,8
2019,123633,45,6,24,16,8
2019,123651,0,0,85,36,49
2019,123651,10,0,85,36,49
2019,123651,10,1,26,17,9
2019,123651,10,2,22,7,15
2019,123651,10,3,32,10,22
2019,123651,10,4,5,2,3
2019,123651,20,0,39,18,21
2019,123651,20,1,25,16,9
2019,123651,20,2,13,2,11
2019,123651,20,3,1,0,1
2019,123651,30,0,23,10,13
2019,123651,30,1,1,1,0
2019,123651,30,2,5,3,2
2019,123651,30,3,17,6,11
2019,123651,40,0,23,8,15
2019,123651,40,2,4,2,2
2019,123651,40,3,14,4,10
2019,123651,40,4,5,2,3
2019,123651,42,0,23,8,15
2019,123651,42,2,4,2,2
2019,123651,42,3,14,4,10
2019,123651,42,4,5,2,3
2019,123679,0,0,25,7,18
2019,123679,10,0,25,7,18
2019,123679,10,4,25,7,18
2019,123679,40,0,25,7,18
2019,123679,40,4,25,7,18
2019,123679,41,0,25,7,18
2019,123679,41,4,25,7,18
2019,123679,45,0,25,7,18
2019,123679,45,4,25,7,18
2019,123800,0,0,198,79,119
2019,123800,10,0,193,79,114
2019,123800,10,1,150,65,85
2019,123800,10,3,43,14,29
2019,123800,20,0,150,65,85
2019,123800,20,1,150,65,85
2019,123800,30,0,43,14,29
2019,123800,30,3,43,14,29
2019,123800,50,0,5,0,5
2019,123855,0,0,24,20,4
2019,123855,10,0,24,20,4
2019,123855,10,1,6,6,0
2019,123855,10,2,1,1,0
2019,123855,10,3,16,13,3
2019,123855,10,4,1,0,1
2019,123855,40,0,24,20,4
2019,123855,40,1,6,6,0
2019,123855,40,2,1,1,0
2019,123855,40,3,16,13,3
2019,123855,40,4,1,0,1
2019,123855,42,0,24,20,4
2019,123855,42,1,6,6,0
2019,123855,42,2,1,1,0
2019,123855,42,3,16,13,3
2019,123855,42,4,1,0,1
2019,123916,0,0,6,1,5
2019,123916,10,0,6,1,5
2019,123916,10,1,1,0,1
2019,123916,10,2,3,1,2
2019,123916,10,3,2,0,2
2019,123916,40,0,6,1,5
2019,123916,40,1,1,0,1
2019,123916,40,2,3,1,2
2019,123916,40,3,2,0,2
2019,123916,41,0,3,0,3
2019,123916,41,1,1,0,1
2019,123916,41,2,1,0,1
2019,123916,41,3,1,0,1
2019,123916,42,0,3,1,2
2019,123916,42,2,2,1,1
2019,123916,42,3,1,0,1
2019,123916,44,0,3,0,3
2019,123916,44,1,1,0,1
2019,123916,44,2,1,0,1
2019,123916,44,3,1,0,1
2019,123943,0,0,58,25,33
2019,123943,10,0,58,25,33
2019,123943,10,1,6,5,1
2019,123943,10,2,17,11,6
2019,123943,10,3,35,9,26
2019,123943,20,0,17,11,6
2019,123943,20,1,6,5,1
2019,123943,20,2,11,6,5
2019,123943,30,0,24,7,17
2019,123943,30,2,6,5,1
2019,123943,30,3,18,2,16
2019,123943,40,0,17,7,10
2019,123943,40,3,17,7,10
2019,123943,41,0,17,7,10
2019,123943,41,3,17,7,10
2019,123943,44,0,17,7,10
2019,123943,44,3,17,7,10
2019,123952,0,0,40,26,14
2019,123952,10,0,40,26,14
2019,123952,10,6,40,26,14
2019,123952,40,0,40,26,14
2019,123952,40,6,40,26,14
2019,123952,41,0,40,26,14
2019,123952,41,6,40,26,14
2019,123952,44,0,40,26,14
2019,123952,44,6,40,26,14
2019,123961,0,0,2481,1493,988
2019,123961,10,0,2481,1493,988
2019,123961,10,1,1034,733,301
2019,123961,10,2,666,359,307
2019,123961,10,3,538,286,252
2019,123961,10,4,7,3,4
2019,123961,10,5,236,112,124
2019,123961,20,0,1179,846,333
2019,123961,20,1,825,625,200
2019,123961,20,2,354,221,133
2019,123961,30,0,315,182,133
2019,123961,30,1,1,0,1
2019,123961,30,2,5,2,3
2019,123961,30,3,308,179,129
2019,123961,30,4,1,1,0
2019,123961,40,0,987,465,522
2019,123961,40,1,208,108,100
2019,123961,40,2,307,136,171
2019,123961,40,3,230,107,123
2019,123961,40,4,6,2,4
2019,123961,40,5,236,112,124
2019,123961,42,0,987,465,522
2019,123961,42,1,208,108,100
2019,123961,42,2,307,136,171
2019,123961,42,3,230,107,123
2019,123961,42,4,6,2,4
2019,123961,42,5,236,112,124
2019,123970,0,0,56,28,28
2019,123970,10,0,56,28,28
2019,123970,10,1,38,24,14
2019,123970,10,2,18,4,14
2019,123970,20,0,28,21,7
2019,123970,20,1,28,21,7
2019,123970,30,0,1,0,1
2019,123970,30,2,1,0,1
2019,123970,40,0,27,7,20
2019,123970,40,1,10,3,7
2019,123970,40,2,17,4,13
2019,123970,41,0,11,2,9
2019,123970,41,1,8,1,7
2019,123970,41,2,3,1,2
2019,123970,42,0,16,5,11
2019,123970,42,1,2,2,0
2019,123970,42,2,14,3,11
2019,123970,44,0,11,2,9
2019,123970,44,1,8,1,7
2019,123970,44,2,3,1,2
2019,124113,0,0,43,20,23
2019,124113,10,0,42,20,22
2019,124113,10,1,33,15,18
2019,124113,10,2,9,5,4
2019,124113,20,0,33,15,18
2019,124113,20,1,33,15,18
2019,124113,30,0,9,5,4
2019,124113,30,2,9,5,4
2019,124113,50,0,1,0,1
2019,124283,0,0,13,10,3
2019,124283,10,0,13,10,3
2019,124283,10,1,11,9,2
2019,124283,10,2,2,1,1
2019,124283,20,0,13,10,3
2019,124283,20,1,11,9,2
2019,124283,20,2,2,1,1
2019,124292,0,0,39,35,4
2019,124292,10,0,39,35,4
2019,124292,10,6,39,35,4
2019,124292,40,0,39,35,4
2019,124292,40,6,39,35,4
2019,124292,41,0,28,25,3
2019,124292,41,6,28,25,3
2019,124292,42,0,11,10,1
2019,124292,42,6,11,10,1
2019,124292,44,0,4,4,0
2019,124292,44,6,4,4,0
2019,124292,45,0,24,21,3
2019,124292,45,6,24,21,3
2019,124487,0,0,7,5,2
2019,124487,10,0,7,5,2
2019,124487,10,6,7,5,2
2019,124487,40,0,7,5,2
2019,124487,40,6,7,5,2
2019,124487,43,0,7,5,2
2019,124487,43,6,7,5,2
2019,124557,0,0,240,131,109
2019,124557,10,0,4,3,1
2019,124557,10,1,2,1,1
2019,124557,10,3,2,2,0
2019,124557,20,0,1,1,0
2019,124557,20,1,1,1,0
2019,124557,30,0,2,2,0
2019,124557,30,3,2,2,0
2019,124557,40,0,1,0,1
2019,124557,40,1,1,0,1
2019,124557,41,0,1,0,1
2019,124557,41,1,1,0,1
2019,124557,44,0,1,0,1
2019,124557,44,1,1,0,1
2019,124557,50,0,236,128,108
2019,124706,0,0,28,7,21
2019,124706,10,0,28,7,21
2019,124706,10,4,28,7,21
2019,124706,40,0,28,7,21
2019,124706,40,4,28,7,21
2019,124706,41,0,28,7,21
2019,124706,41,4,28,7,21
2019,124706,45,0,28,7,21
2019,124706,45,4,28,7,21
2019,124937,0,0,23,6,17
2019,124937,10,0,23,6,17
2019,124937,10,4,23,6,17
2019,124937,40,0,23,6,17
2019,124937,40,4,23,6,17
2019,124937,41,0,23,6,17
2019,124937,41,4,23,6,17
2019,124937,45,0,23,6,17
2019,124937,45,4,23,6,17
2019,125028,0,0,167,78,89
2019,125028,10,0,167,78,89
2019,125028,10,4,167,78,89
2019,125028,20,0,109,55,54
2019,125028,20,4,109,55,54
2019,125028,30,0,50,19,31
2019,125028,30,4,50,19,31
2019,125028,40,0,8,4,4
2019,125028,40,4,8,4,4
2019,125028,42,0,4,2,2
2019,125028,42,4,4,2,2
2019,125028,43,0,4,2,2
2019,125028,43,4,4,2,2
2019,125091,0,0,141,79,62
2019,125091,10,0,113,66,47
2019,125091,10,4,113,66,47
2019,125091,20,0,71,45,26
2019,125091,20,4,71,45,26
2019,125091,30,0,41,21,20
2019,125091,30,4,41,21,20
2019,125091,40,0,1,0,1
2019,125091,40,4,1,0,1
2019,125091,42,0,1,0,1
2019,125091,42,4,1,0,1
2019,125091,50,0,28,13,15
2019,125170,0,0,71,38,33
2019,125170,10,0,71,38,33
2019,125170,10,4,71,38,33
2019,125170,20,0,47,28,19
2019,125170,20,4,47,28,19
2019,125170,30,0,12,3,9
2019,125170,30,4,12,3,9
2019,125170,40,0,12,7,5
2019,125170,40,4,12,7,5
2019,125170,42,0,1,0,1
2019,125170,42,4,1,0,1
2019,125170,43,0,11,7,4
2019,125170,43,4,11,7,4
2019,125231,0,0,219,65,154
2019,125231,10,0,219,65,154
2019,125231,10,6,219,65,154
2019,125231,40,0,219,65,154
2019,125231,40,6,219,65,154
2019,125231,41,0,219,65,154
2019,125231,41,6,219,65,154
2019,125231,45,0,219,65,154
2019,125231,45,6,219,65,154
2019,125462,0,0,35,22,13
2019,125462,10,0,35,22,13
2019,125462,10,4,35,22,13
2019,125462,20,0,27,16,11
2019,125462,20,4,27,16,11
2019,125462,30,0,8,6,2
2019,125462,30,4,8,6,2
2019,125471,0,0,127,57,70
2019,125471,10,0,127,57,70
2019,125471,10,4,127,57,70
2019,125471,20,0,94,44,50
2019,125471,20,4,94,44,50
2019,125471,30,0,27,10,17
2019,125471,30,4,27,10,17
2019,125471,40,0,6,3,3
2019,125471,40,4,6,3,3
2019,125471,42,0,2,0,2
2019,125471,42,4,2,0,2
2019,125471,43,0,4,3,1
2019,125471,43,4,4,3,1
2019,125499,0,0,214,87,127
2019,125499,10,0,214,87,127
2019,125499,10,4,214,87,127
2019,125499,20,0,119,44,75
2019,125499,20,4,119,44,75
2019,125499,30,0,49,22,27
2019,125499,30,4,49,22,27
2019,125499,40,0,46,21,25
2019,125499,40,4,46,21,25
2019,125499,43,0,46,21,25
2019,125499,43,4,46,21,25
2019,125532,0,0,99,18,81
2019,125532,10,0,99,18,81
2019,125532,10,4,99,18,81
2019,125532,40,0,99,18,81
2019,125532,40,4,99,18,81
2019,125532,41,0,99,18,81
2019,125532,41,4,99,18,81
2019,125532,45,0,99,18,81
2019,125532,45,4,99,18,81
2019,125718,0,0,11,11,0
2019,125718,10,0,11,11,0
2019,125718,10,1,10,10,0
2019,125718,10,3,1,1,0
2019,125718,20,0,10,10,0
2019,125718,20,1,10,10,0
2019,125718,30,0,1,1,0
2019,125718,30,3,1,1,0
2019,125727,0,0,85,49,36
2019,125727,10,0,85,49,36
2019,125727,10,1,49,36,13
2019,125727,10,2,19,8,11
2019,125727,10,3,14,5,9
2019,125727,10,4,1,0,1
2019,125727,10,6,2,0,2
2019,125727,20,0,59,39,20
2019,125727,20,1,47,35,12
2019,125727,20,2,10,4,6
2019,125727,20,6,2,0,2
2019,125727,30,0,16,4,12
2019,125727,30,1,2,1,1
2019,125727,30,2,4,1,3
2019,125727,30,3,10,2,8
2019,125727,40,0,10,6,4
2019,125727,40,2,5,3,2
2019,125727,40,3,4,3,1
2019,125727,40,4,1,0,1
2019,125727,41,0,1,1,0
2019,125727,41,2,1,1,0
2019,125727,42,0,9,5,4
2019,125727,42,2,4,2,2
2019,125727,42,3,4,3,1
2019,125727,42,4,1,0,1
2019,125727,45,0,1,1,0
2019,125727,45,2,1,1,0
2019,125763,0,0,129,66,63
2019,125763,10,0,129,66,63
2019,125763,10,1,39,23,16
2019,125763,10,2,42,20,22
2019,125763,10,3,36,17,19
2019,125763,10,4,7,3,4
2019,125763,10,5,5,3,2
2019,125763,20,0,71,37,34
2019,125763,20,1,35,21,14
2019,125763,20,2,36,16,20
2019,125763,30,0,21,9,12
2019,125763,30,2,3,2,1
2019,125763,30,3,18,7,11
2019,125763,40,0,37,20,17
2019,125763,40,1,4,2,2
2019,125763,40,2,3,2,1
2019,125763,40,3,18,10,8
2019,125763,40,4,7,3,4
2019,125763,40,5,5,3,2
2019,125763,42,0,37,20,17
2019,125763,42,1,4,2,2
2019,125763,42,2,3,2,1
2019,125763,42,3,18,10,8
2019,125763,42,4,7,3,4
2019,125763,42,5,5,3,2
2019,125897,0,0,67,39,28
2019,125897,10,0,67,39,28
2019,125897,10,1,27,17,10
2019,125897,10,2,28,15,13
2019,125897,10,3,12,7,5
2019,125897,40,0,67,39,28
2019,125897,40,1,27,17,10
2019,125897,40,2,28,15,13
2019,125897,40,3,12,7,5
2019,125897,41,0,53,30,23
2019,125897,41,1,27,17,10
2019,125897,41,2,26,13,13
2019,125897,42,0,14,9,5
2019,125897,42,2,2,2,0
2019,125897,42,3,12,7,5
2019,125897,44,0,53,30,23
2019,125897,44,1,27,17,10
2019,125897,44,2,26,13,13
2019,126012,0,0,31,7,24
2019,126012,10,0,27,5,22
2019,126012,10,1,3,0,3
2019,126012,10,2,1,0,1
2019,126012,10,3,4,0,4
2019,126012,10,4,1,0,1
2019,126012,10,6,18,5,13
2019,126012,20,0,4,0,4
2019,126012,20,1,2,0,2
2019,126012,20,2,1,0,1
2019,126012,20,3,1,0,1
2019,126012,30,0,4,0,4
2019,126012,30,1,1,0,1
2019,126012,30,3,3,0,3
2019,126012,40,0,19,5,14
2019,126012,40,4,1,0,1
2019,126012,40,6,18,5,13
2019,126012,41,0,19,5,14
2019,126012,41,4,1,0,1
2019,126012,41,6,18,5,13
2019,126012,45,0,19,5,14
2019,126012,45,4,1,0,1
2019,126012,45,6,18,5,13
2019,126012,50,0,4,2,2
2019,126049,0,0,10,7,3
2019,126049,10,0,10,7,3
2019,126049,10,1,6,5,1
2019,126049,10,2,4,2,2
2019,126049,20,0,10,7,3
2019,126049,20,1,6,5,1
2019,126049,20,2,4,2,2
2019,126076,0,0,7,7,0
2019,126076,10,0,7,7,0
2019,126076,10,4,7,7,0
2019,126076,40,0,7,7,0
2019,126076,40,4,7,7,0
2019,126076,42,0,7,7,0
2019,126076,42,4,7,7,0
2019,126100,0,0,10,8,2
2019,126100,10,0,10,8,2
2019,126100,10,4,10,8,2
2019,126100,20,0,7,6,1
2019,126100,20,4,7,6,1
2019,126100,30,0,2,2,0
2019,126100,30,4,2,2,0
2019,126100,40,0,1,0,1
2019,126100,40,4,1,0,1
2019,126100,42,0,1,0,1
2019,126100,42,4,1,0,1
2019,126119,0,0,75,38,37
2019,126119,10,0,75,38,37
2019,126119,10,4,75,38,37
2019,126119,20,0,60,32,28
2019,126119,20,4,60,32,28
2019,126119,30,0,10,5,5
2019,126119,30,4,10,5,5
2019,126119,40,0,5,1,4
2019,126119,40,4,5,1,4
2019,126119,42,0,5,1,4
2019,126119,42,4,5,1,4
2019,126182,0,0,103,46,57
2019,126182,10,0,103,46,57
2019,126182,10,1,22,11,11
2019,126182,10,2,13,5,8
2019,126182,10,3,18,9,9
2019,126182,10,6,50,21,29
2019,126182,20,0,38,19,19
2019,126182,20,1,22,11,11
2019,126182,20,2,12,5,7
2019,126182,20,3,4,3,1
2019,126182,30,0,15,6,9
2019,126182,30,2,1,0,1
2019,126182,30,3,13,5,8
2019,126182,30,6,1,1,0
2019,126182,40,0,50,21,29
2019,126182,40,3,1,1,0
2019,126182,40,6,49,20,29
2019,126182,42,0,50,21,29
2019,126182,42,3,1,1,0
2019,126182,42,6,49,20,29
2019,126207,0,0,120,54,66
2019,126207,10,0,120,54,66
2019,126207,10,1,62,26,36
2019,126207,10,2,6,3,3
2019,126207,10,3,3,1,2
2019,126207,10,4,49,24,25
2019,126207,20,0,77,34,43
2019,126207,20,1,62,26,36
2019,126207,20,2,6,3,3
2019,126207,20,3,3,1,2
2019,126207,20,4,6,4,2
2019,126207,30,0,38,17,21
2019,126207,30,4,38,17,21
2019,126207,40,0,5,3,2
2019,126207,40,4,5,3,2
2019,126207,41,0,5,3,2
2019,126207,41,4,5,3,2
2019,126207,45,0,5,3,2
2019,126207,45,4,5,3,2
2019,126289,0,0,102,40,62
2019,126289,10,0,102,40,62
2019,126289,10,1,102,40,62
2019,126289,20,0,80,29,51
2019,126289,20,1,80,29,51
2019,126289,30,0,22,11,11
2019,126289,30,1,22,11,11
2019,126359,0,0,9,2,7
2019,126359,10,0,9,2,7
2019,126359,10,1,1,1,0
2019,126359,10,4,8,1,7
2019,126359,40,0,9,2,7
2019,126359,40,1,1,1,0
2019,126359,40,4,8,1,7
2019,126359,41,0,9,2,7
2019,126359,41,1,1,1,0
2019,126359,41,4,8,1,7
2019,126359,45,0,9,2,7
2019,126359,45,1,1,1,0
2019,126359,45,4,8,1,7
2019,126562,0,0,4481,1882,2599
2019,126562,10,0,4481,1882,2599
2019,126562,10,1,676,448,228
2019,126562,10,2,915,483,432
2019,126562,10,3,1221,500,721
2019,126562,10,4,1669,451,1218
2019,126562,20,0,603,399,204
2019,126562,20,1,391,263,128
2019,126562,20,2,212,136,76
2019,126562,30,0,2003,954,1049
2019,126562,30,1,270,180,90
2019,126562,30,2,628,312,316
2019,126562,30,3,1105,462,643
2019,126562,40,0,1875,529,1346
2019,126562,40,1,15,5,10
2019,126562,40,2,75,35,40
2019,126562,40,3,116,38,78
2019,126562,40,4,1669,451,1218
2019,126562,41,0,1624,402,1222
2019,126562,41,1,11,3,8
2019,126562,41,2,45,21,24
2019,126562,41,3,75,22,53
2019,126562,41,4,1493,356,1137
2019,126562,42,0,250,126,124
2019,126562,42,1,4,2,2
2019,126562,42,2,30,14,16
2019,126562,42,3,41,16,25
2019,126562,42,4,175,94,81
2019,126562,43,0,1,1,0
2019,126562,43,4,1,1,0
2019,126562,45,0,1624,402,1222
2019,126562,45,1,11,3,8
2019,126562,45,2,45,21,24
2019,126562,45,3,75,22,53
2019,126562,45,4,1493,356,1137
2019,126580,0,0,444,218,226
2019,126580,10,0,444,218,226
2019,126580,10,1,70,50,20
2019,126580,10,2,83,44,39
2019,126580,10,3,111,53,58
2019,126580,10,4,177,71,106
2019,126580,10,6,3,0,3
2019,126580,20,0,153,94,59
2019,126580,20,1,70,50,20
2019,126580,20,2,83,44,39
2019,126580,30,0,111,53,58
2019,126580,30,3,111,53,58
2019,126580,40,0,180,71,109
2019,126580,40,4,177,71,106
2019,126580,40,6,3,0,3
2019,126580,42,0,177,71,106
2019,126580,42,4,177,71,106
2019,126580,43,0,3,0,3
2019,126580,43,6,3,0,3
2019,126605,0,0,29,28,1
2019,126605,50,0,29,28,1
2019,126614,0,0,1670,999,671
2019,126614,10,0,1670,999,671
2019,126614,10,1,514,377,137
2019,126614,10,2,378,209,169
2019,126614,10,3,320,187,133
2019,126614,10,4,458,226,232
2019,126614,20,0,870,573,297
2019,126614,20,1,514,377,137
2019,126614,20,2,355,196,159
2019,126614,20,3,1,0,1
2019,126614,30,0,342,200,142
2019,126614,30,2,23,13,10
2019,126614,30,3,319,187,132
2019,126614,40,0,458,226,232
2019,126614,40,4,458,226,232
2019,126614,41,0,5,2,3
2019,126614,41,4,5,2,3
2019,126614,42,0,453,224,229
2019,126614,42,4,453,224,229
2019,126614,45,0,5,2,3
2019,126614,45,4,5,2,3
2019,126669,0,0,111,68,43
2019,126669,10,0,111,68,43
2019,126669,10,1,32,19,13
2019,126669,10,2,21,13,8
2019,126669,10,3,58,36,22
2019,126669,40,0,111,68,43
2019,126669,40,1,32,19,13
2019,126669,40,2,21,13,8
2019,126669,40,3,58,36,22
2019,126669,41,0,50,28,22
2019,126669,41,1,11,3,8
2019,126669,41,2,7,6,1
2019,126669,41,3,32,19,13
2019,126669,42,0,61,40,21
2019,126669,42,1,21,16,5
2019,126669,42,2,14,7,7
2019,126669,42,3,26,17,9
2019,126669,45,0,50,28,22
2019,126669,45,1,11,3,8
2019,126669,45,2,7,6,1
2019,126669,45,3,32,19,13
2019,126678,0,0,223,113,110
2019,126678,10,0,223,113,110
2019,126678,10,1,69,41,28
2019,126678,10,2,58,29,29
2019,126678,10,3,87,36,51
2019,126678,10,4,2,1,1
2019,126678,10,5,3,2,1
2019,126678,10,6,4,4,0
2019,126678,20,0,123,69,54
2019,126678,20,1,66,40,26
2019,126678,20,2,57,29,28
2019,126678,30,0,61,23,38
2019,126678,30,2,1,0,1
2019,126678,30,3,60,23,37
2019,126678,40,0,39,21,18
2019,126678,40,1,3,1,2
2019,126678,40,3,27,13,14
2019,126678,40,4,2,1,1
2019,126678,40,5,3,2,1
2019,126678,40,6,4,4,0
2019,126678,41,0,2,1,1
2019,126678,41,5,2,1,1
2019,126678,42,0,37,20,17
2019,126678,42,1,3,1,2
2019,126678,42,3,27,13,14
2019,126678,42,4,2,1,1
2019,126678,42,5,1,1,0
2019,126678,42,6,4,4,0
2019,126678,45,0,2,1,1
2019,126678,45,5,2,1,1
2019,126687,0,0,25,6,19
2019,126687,10,0,25,6,19
2019,126687,10,4,25,6,19
2019,126687,40,0,25,6,19
2019,126687,40,4,25,6,19
2019,126687,41,0,25,6,19
2019,126687,41,4,25,6,19
2019,126687,45,0,25,6,19
2019,126687,45,4,25,6,19
2019,126711,0,0,117,59,58
2019,126711,10,0,117,59,58
2019,126711,10,1,50,26,24
2019,126711,10,2,44,20,24
2019,126711,10,3,23,13,10
2019,126711,40,0,117,59,58
2019,126711,40,1,50,26,24
2019,126711,40,2,44,20,24
2019,126711,40,3,23,13,10
2019,126711,42,0,117,59,58
2019,126711,42,1,50,26,24
2019,126711,42,2,44,20,24
2019,126711,42,3,23,13,10
2019,126748,0,0,37,19,18
2019,126748,10,0,37,19,18
2019,126748,10,4,37,19,18
2019,126748,40,0,37,19,18
2019,126748,40,4,37,19,18
2019,126748,42,0,37,19,18
2019,126748,42,4,37,19,18
2019,126775,0,0,327,226,101
2019,126775,10,0,323,222,101
2019,126775,10,1,98,80,18
2019,126775,10,2,70,49,21
2019,126775,10,3,54,38,16
2019,126775,10,4,75,40,35
2019,126775,10,5,11,5,6
2019,126775,10,6,15,10,5
2019,126775,20,0,157,121,36
2019,126775,20,1,92,75,17
2019,126775,20,2,65,46,19
2019,126775,30,0,63,44,19
2019,126775,30,1,4,3,1
2019,126775,30,2,5,3,2
2019,126775,30,3,54,38,16
2019,126775,40,0,103,57,46
2019,126775,40,1,2,2,0
2019,126775,40,4,75,40,35
2019,126775,40,5,11,5,6
2019,126775,40,6,15,10,5
2019,126775,42,0,103,57,46
2019,126775,42,1,2,2,0
2019,126775,42,4,75,40,35
2019,126775,42,5,11,5,6
2019,126775,42,6,15,10,5
2019,126775,50,0,4,4,0
2019,126784,0,0,9,9,0
2019,126784,50,0,9,9,0
2019,126818,0,0,1648,914,734
2019,126818,10,0,1453,804,649
2019,126818,10,1,477,329,148
2019,126818,10,2,352,191,161
2019,126818,10,3,411,193,218
2019,126818,10,4,213,91,122
2019,126818,20,0,761,493,268
2019,126818,20,1,462,322,140
2019,126818,20,2,299,171,128
2019,126818,30,0,318,166,152
2019,126818,30,1,8,4,4
2019,126818,30,2,22,10,12
2019,126818,30,3,288,152,136
2019,126818,40,0,374,145,229
2019,126818,40,1,7,3,4
2019,126818,40,2,31,10,21
2019,126818,40,3,123,41,82
2019,126818,40,4,213,91,122
2019,126818,41,0,341,129,212
2019,126818,41,1,6,3,3
2019,126818,41,2,31,10,21
2019,126818,41,3,122,40,82
2019,126818,41,4,182,76,106
2019,126818,42,0,33,16,17
2019,126818,42,1,1,0,1
2019,126818,42,3,1,1,0
2019,126818,42,4,31,15,16
2019,126818,44,0,341,129,212
2019,126818,44,1,6,3,3
2019,126818,44,2,31,10,21
2019,126818,44,3,122,40,82
2019,126818,44,4,182,76,106
2019,126818,50,0,195,110,85
2019,126827,0,0,52,22,30
2019,126827,50,0,52,22,30
2019,126863,0,0,61,26,35
2019,126863,10,0,61,26,35
2019,126863,10,6,61,26,35
2019,126863,40,0,61,26,35
2019,126863,40,6,61,26,35
2019,126863,42,0,61,26,35
2019,126863,42,6,61,26,35
2019,126942,0,0,111,55,56
2019,126942,10,0,111,55,56
2019,126942,10,1,39,20,19
2019,126942,10,2,30,14,16
2019,126942,10,3,5,4,1
2019,126942,10,4,37,17,20
2019,126942,40,0,111,55,56
2019,126942,40,1,39,20,19
2019,126942,40,2,30,14,16
2019,126942,40,3,5,4,1
2019,126942,40,4,37,17,20
2019,126942,42,0,111,55,56
2019,126942,42,1,39,20,19
2019,126942,42,2,30,14,16
2019,126942,42,3,5,4,1
2019,126942,42,4,37,17,20
2019,126951,0,0,39,37,2
2019,126951,10,0,39,37,2
2019,126951,10,4,39,37,2
2019,126951,40,0,39,37,2
2019,126951,40,4,39,37,2
2019,126951,41,0,39,37,2
2019,126951,41,4,39,37,2
2019,126951,45,0,39,37,2
2019,126951,45,4,39,37,2
2019,126979,0,0,26,18,8
2019,126979,10,0,26,18,8
2019,126979,10,1,12,10,2
2019,126979,10,2,6,4,2
2019,126979,10,3,4,3,1
2019,126979,10,4,2,0,2
2019,126979,10,5,2,1,1
2019,126979,20,0,17,13,4
2019,126979,20,1,11,9,2
2019,126979,20,2,5,3,2
2019,126979,20,3,1,1,0
2019,126979,30,0,5,4,1
2019,126979,30,1,1,1,0
2019,126979,30,2,1,1,0
2019,126979,30,3,3,2,1
2019,126979,40,0,4,1,3
2019,126979,40,4,2,0,2
2019,126979,40,5,2,1,1
2019,126979,42,0,4,1,3
2019,126979,42,4,2,0,2
2019,126979,42,5,2,1,1
2019,127060,0,0,751,384,367
2019,127060,10,0,751,384,367
2019,127060,10,1,195,127,68
2019,127060,10,2,209,103,106
2019,127060,10,3,153,72,81
2019,127060,10,5,194,82,112
2019,127060,20,0,350,205,145
2019,127060,20,1,170,111,59
2019,127060,20,2,180,94,86
2019,127060,30,0,127,65,62
2019,127060,30,3,127,65,62
2019,127060,40,0,274,114,160
2019,127060,40,1,25,16,9
2019,127060,40,2,29,9,20
2019,127060,40,3,26,7,19
2019,127060,40,5,194,82,112
2019,127060,41,0,219,92,127
2019,127060,41,1,25,16,9
2019,127060,41,2,29,9,20
2019,127060,41,3,26,7,19
2019,127060,41,5,139,60,79
2019,127060,42,0,55,22,33
2019,127060,42,5,55,22,33
2019,127060,44,0,219,92,127
2019,127060,44,1,25,16,9
2019,127060,44,2,29,9,20
2019,127060,44,3,26,7,19
2019,127060,44,5,139,60,79
2019,127185,0,0,177,87,90
2019,127185,10,0,177,87,90
2019,127185,10,1,56,30,26
2019,127185,10,2,30,14,16
2019,127185,10,3,55,26,29
2019,127185,10,4,14,8,6
2019,127185,10,5,22,9,13
2019,127185,20,0,83,42,41
2019,127185,20,1,55,30,25
2019,127185,20,2,28,12,16
2019,127185,30,0,58,28,30
2019,127185,30,1,1,0,1
2019,127185,30,2,2,2,0
2019,127185,30,3,55,26,29
2019,127185,40,0,36,17,19
2019,127185,40,4,14,8,6
2019,127185,40,5,22,9,13
2019,127185,41,0,22,9,13
2019,127185,41,5,22,9,13
2019,127185,42,0,14,8,6
2019,127185,42,4,14,8,6
2019,127185,45,0,22,9,13
2019,127185,45,5,22,9,13
2019,127200,0,0,246,107,139
2019,127200,10,0,246,107,139
2019,127200,10,1,246,107,139
2019,127200,20,0,183,80,103
2019,127200,20,1,183,80,103
2019,127200,30,0,49,19,30
2019,127200,30,1,49,19,30
2019,127200,40,0,14,8,6
2019,127200,40,1,14,8,6
2019,127200,42,0,14,8,6
2019,127200,42,1,14,8,6
2019,127273,0,0,17,9,8
2019,127273,10,0,17,9,8
2019,127273,10,1,9,5,4
2019,127273,10,2,3,2,1
2019,127273,10,3,3,2,1
2019,127273,10,4,2,0,2
2019,127273,20,0,12,7,5
2019,127273,20,1,9,5,4
2019,127273,20,2,3,2,1
2019,127273,30,0,3,2,1
2019,127273,30,3,3,2,1
2019,127273,40,0,2,0,2
2019,127273,40,4,2,0,2
2019,127273,41,0,2,0,2
2019,127273,41,4,2,0,2
2019,127273,44,0,2,0,2
2019,127273,44,4,2,0,2
2019,127389,0,0,21,11,10
2019,127389,10,0,21,11,10
2019,127389,10,4,21,11,10
2019,127389,40,0,21,11,10
2019,127389,40,4,21,11,10
2019,127389,42,0,21,11,10
2019,127389,42,4,21,11,10
2019,127556,0,0,304,161,143
2019,127556,10,0,304,161,143
2019,127556,10,1,55,36,19
2019,127556,10,2,52,31,21
2019,127556,10,3,79,34,45
2019,127556,10,4,108,55,53
2019,127556,10,5,6,1,5
2019,127556,10,6,4,4,0
2019,127556,20,0,102,63,39
2019,127556,20,1,55,36,19
2019,127556,20,2,46,26,20
2019,127556,20,3,1,1,0
2019,127556,30,0,85,39,46
2019,127556,30,2,6,5,1
2019,127556,30,3,78,33,45
2019,127556,30,6,1,1,0
2019,127556,40,0,117,59,58
2019,127556,40,4,108,55,53
2019,127556,40,5,6,1,5
2019,127556,40,6,3,3,0
2019,127556,42,0,112,56,56
2019,127556,42,4,108,55,53
2019,127556,42,5,3,0,3
2019,127556,42,6,1,1,0
2019,127556,43,0,5,3,2
2019,127556,43,5,3,1,2
2019,127556,43,6,2,2,0
2019,127565,0,0,590,288,302
2019,127565,10,0,590,288,302
2019,127565,10,1,200,115,85
2019,127565,10,2,156,77,79
2019,127565,10,3,102,39,63
2019,127565,10,5,132,57,75
2019,127565,20,0,356,191,165
2019,127565,20,1,199,115,84
2019,127565,20,2,155,76,79
2019,127565,20,3,2,0,2
2019,127565,30,0,99,39,60
2019,127565,30,2,1,1,0
2019,127565,30,3,98,38,60
2019,127565,40,0,135,58,77
2019,127565,40,1,1,0,1
2019,127565,40,3,2,1,1
2019,127565,40,5,132,57,75
2019,127565,42,0,135,58,77
2019,127565,42,1,1,0,1
2019,127565,42,3,2,1,1
2019,127565,42,5,132,57,75
2019,127617,0,0,38,21,17
2019,127617,10,0,38,21,17
2019,127617,10,6,38,21,17
2019,127617,40,0,38,21,17
2019,127617,40,6,38,21,17
2019,127617,42,0,38,21,17
2019,127617,42,6,38,21,17
2019,127653,0,0,58,21,37
2019,127653,10,0,58,21,37
2019,127653,10,1,14,5,9
2019,127653,10,2,16,9,7
2019,127653,10,3,20,6,14
2019,127653,10,4,8,1,7
2019,127653,40,0,58,21,37
2019,127653,40,1,14,5,9
2019,127653,40,2,16,9,7
2019,127653,40,3,20,6,14
2019,127653,40,4,8,1,7
2019,127653,41,0,50,20,30
2019,127653,41,1,14,5,9
2019,127653,41,2,16,9,7
2019,127653,41,3,20,6,14
2019,127653,42,0,8,1,7
2019,127653,42,4,8,1,7
2019,127653,44,0,50,20,30
2019,127653,44,1,14,5,9
2019,127653,44,2,16,9,7
2019,127653,44,3,20,6,14
2019,127714,0,0,7,6,1
2019,127714,10,0,7,6,1
2019,127714,10,6,7,6,1
2019,127714,40,0,7,6,1
2019,127714,40,6,7,6,1
2019,127714,42,0,7,6,1
2019,127714,42,6,7,6,1
2019,127732,0,0,52,25,27
2019,127732,10,0,52,25,27
2019,127732,10,1,12,7,5
2019,127732,10,2,26,13,13
2019,127732,10,3,13,5,8
2019,127732,10,6,1,0,1
2019,127732,40,0,52,25,27
2019,127732,40,1,12,7,5
2019,127732,40,2,26,13,13
2019,127732,40,3,13,5,8
2019,127732,40,6,1,0,1
2019,127732,42,0,52,25,27
2019,127732,42,1,12,7,5
2019,127732,42,2,26,13,13
2019,127732,42,3,13,5,8
2019,127732,42,6,1,0,1
2019,127741,0,0,482,230,252
2019,127741,10,0,482,230,252
2019,127741,10,1,188,108,80
2019,127741,10,2,110,54,56
2019,127741,10,3,120,49,71
2019,127741,10,4,8,3,5
2019,127741,10,5,56,16,40
2019,127741,20,0,281,155,126
2019,127741,20,1,186,106,80
2019,127741,20,2,95,49,46
2019,127741,30,0,88,42,46
2019,127741,30,1,1,1,0
2019,127741,30,2,5,2,3
2019,127741,30,3,81,38,43
2019,127741,30,5,1,1,0
2019,127741,40,0,113,33,80
2019,127741,40,1,1,1,0
2019,127741,40,2,10,3,7
2019,127741,40,3,39,11,28
2019,127741,40,4,8,3,5
2019,127741,40,5,55,15,40
2019,127741,42,0,113,33,80
2019,127741,42,1,1,1,0
2019,127741,42,2,10,3,7
2019,127741,42,3,39,11,28
2019,127741,42,4,8,3,5
2019,127741,42,5,55,15,40
2019,127778,0,0,32,13,19
2019,127778,10,0,32,13,19
2019,127778,10,6,32,13,19
2019,127778,40,0,32,13,19
2019,127778,40,6,32,13,19
2019,127778,42,0,32,13,19
2019,127778,42,6,32,13,19
2019,127820,0,0,188,70,118
2019,127820,10,0,188,70,118
2019,127820,10,6,188,70,118
2019,127820,40,0,188,70,118
2019,127820,40,6,188,70,118
2019,127820,42,0,188,70,118
2019,127820,42,6,188,70,118
2019,127884,0,0,89,39,50
2019,127884,10,0,89,39,50
2019,127884,10,6,89,39,50
2019,127884,40,0,89,39,50
2019,127884,40,6,89,39,50
2019,127884,43,0,89,39,50
2019,127884,43,6,89,39,50
2019,127909,0,0,97,38,59
2019,127909,10,0,97,38,59
2019,127909,10,4,97,38,59
2019,127909,40,0,97,38,59
2019,127909,40,4,97,38,59
2019,127909,42,0,97,38,59
2019,127909,42,4,97,38,59
2019,127918,0,0,330,136,194
2019,127918,10,0,330,136,194
2019,127918,10,1,73,30,43
2019,127918,10,2,102,52,50
2019,127918,10,3,91,27,64
2019,127918,10,4,40,15,25
2019,127918,10,5,22,12,10
2019,127918,10,6,2,0,2
2019,127918,20,0,71,41,30
2019,127918,20,1,28,14,14
2019,127918,20,2,43,27,16
2019,127918,30,0,39,12,27
2019,127918,30,1,1,0,1
2019,127918,30,2,3,1,2
2019,127918,30,3,35,11,24
2019,127918,40,0,220,83,137
2019,127918,40,1,44,16,28
2019,127918,40,2,56,24,32
2019,127918,40,3,56,16,40
2019,127918,40,4,40,15,25
2019,127918,40,5,22,12,10
2019,127918,40,6,2,0,2
2019,127918,41,0,134,48,86
2019,127918,41,1,40,13,27
2019,127918,41,2,48,21,27
2019,127918,41,3,34,9,25
2019,127918,41,4,11,5,6
2019,127918,41,6,1,0,1
2019,127918,42,0,86,35,51
2019,127918,42,1,4,3,1
2019,127918,42,2,8,3,5
2019,127918,42,3,22,7,15
2019,127918,42,4,29,10,19
2019,127918,42,5,22,12,10
2019,127918,42,6,1,0,1
2019,127918,44,0,134,48,86
2019,127918,44,1,40,13,27
2019,127918,44,2,48,21,27
2019,127918,44,3,34,9,25
2019,127918,44,4,11,5,6
2019,127918,44,6,1,0,1
2019,127945,0,0,52,31,21
2019,127945,10,0,52,31,21
2019,127945,10,1,8,3,5
2019,127945,10,2,12,8,4
2019,127945,10,3,26,16,10
2019,127945,10,4,6,4,2
2019,127945,40,0,52,31,21
2019,127945,40,1,8,3,5
2019,127945,40,2,12,8,4
2019,127945,40,3,26,16,10
2019,127945,40,4,6,4,2
2019,127945,41,0,52,31,21
2019,127945,41,1,8,3,5
2019,127945,41,2,12,8,4
2019,127945,41,3,26,16,10
2019,127945,41,4,6,4,2
2019,127945,45,0,52,31,21
2019,127945,45,1,8,3,5
2019,127945,45,2,12,8,4
2019,127945,45,3,26,16,10
2019,127945,45,4,6,4,2
2019,128106,0,0,164,94,70
2019,128106,10,0,164,94,70
2019,128106,10,1,42,31,11
2019,128106,10,2,35,20,15
2019,128106,10,3,56,28,28
2019,128106,10,4,1,0,1
2019,128106,10,5,26,11,15
2019,128106,10,6,4,4,0
2019,128106,20,0,82,54,28
2019,128106,20,1,42,31,11
2019,128106,20,2,35,20,15
2019,128106,20,3,5,3,2
2019,128106,30,0,35,17,18
2019,128106,30,3,35,17,18
2019,128106,40,0,47,23,24
2019,128106,40,3,16,8,8
2019,128106,40,4,1,0,1
2019,128106,40,5,26,11,15
2019,128106,40,6,4,4,0
2019,128106,41,0,24,8,16
2019,128106,41,3,10,2,8
2019,128106,41,4,1,0,1
2019,128106,41,5,13,6,7
2019,128106,42,0,22,14,8
2019,128106,42,3,5,5,0
2019,128106,42,5,13,5,8
2019,128106,42,6,4,4,0
2019,128106,43,0,1,1,0
2019,128106,43,3,1,1,0
2019,128106,45,0,24,8,16
2019,128106,45,3,10,2,8
2019,128106,45,4,1,0,1
2019,128106,45,5,13,6,7
2019,128179,0,0,16,13,3
2019,128179,10,0,16,13,3
2019,128179,10,4,16,13,3
2019,128179,40,0,16,13,3
2019,128179,40,4,16,13,3
2019,128179,41,0,16,13,3
2019,128179,41,4,16,13,3
2019,128179,45,0,16,13,3
2019,128179,45,4,16,13,3
2019,128188,0,0,34,16,18
2019,128188,10,0,34,16,18
2019,128188,10,4,34,16,18
2019,128188,40,0,34,16,18
2019,128188,40,4,34,16,18
2019,128188,41,0,34,16,18
2019,128188,41,4,34,16,18
2019,128188,45,0,34,16,18
2019,128188,45,4,34,16,18
2019,128258,0,0,48,24,24
2019,128258,10,0,48,24,24
2019,128258,10,6,48,24,24
2019,128258,40,0,48,24,24
2019,128258,40,6,48,24,24
2019,128258,42,0,48,24,24
2019,128258,42,6,48,24,24
2019,128328,0,0,207,143,64
2019,128328,10,0,207,143,64
2019,128328,10,1,57,46,11
2019,128328,10,2,40,29,11
2019,128328,10,3,95,58,37
2019,128328,10,4,15,10,5
2019,128328,40,0,207,143,64
2019,128328,40,1,57,46,11
2019,128328,40,2,40,29,11
2019,128328,40,3,95,58,37
2019,128328,40,4,15,10,5
2019,128328,41,0,182,127,55
2019,128328,41,1,57,46,11
2019,128328,41,2,40,29,11
2019,128328,41,3,83,51,32
2019,128328,41,4,2,1,1
2019,128328,42,0,20,14,6
2019,128328,42,3,10,6,4
2019,128328,42,4,10,8,2
2019,128328,43,0,5,2,3
2019,128328,43,3,2,1,1
2019,128328,43,4,3,1,2
2019,128328,44,0,182,127,55
2019,128328,44,1,57,46,11
2019,128328,44,2,40,29,11
2019,128328,44,3,83,51,32
2019,128328,44,4,2,1,1
2019,128391,0,0,127,74,53
2019,128391,10,0,127,74,53
2019,128391,10,1,45,29,16
2019,128391,10,2,14,8,6
2019,128391,10,3,25,15,10
2019,128391,10,5,43,22,21
2019,128391,20,0,56,36,20
2019,128391,20,1,44,28,16
2019,128391,20,2,12,8,4
2019,128391,30,0,28,16,12
2019,128391,30,1,1,1,0
2019,128391,30,2,2,0,2
2019,128391,30,3,25,15,10
2019,128391,40,0,43,22,21
2019,128391,40,5,43,22,21
2019,128391,42,0,43,22,21
2019,128391,42,5,43,22,21
2019,128498,0,0,52,28,24
2019,128498,10,0,52,28,24
2019,128498,10,1,22,14,8
2019,128498,10,2,8,3,5
2019,128498,10,3,20,10,10
2019,128498,10,4,1,0,1
2019,128498,10,6,1,1,0
2019,128498,20,0,7,3,4
2019,128498,20,1,6,2,4
2019,128498,20,2,1,1,0
2019,128498,40,0,45,25,20
2019,128498,40,1,16,12,4
2019,128498,40,2,7,2,5
2019,128498,40,3,20,10,10
2019,128498,40,4,1,0,1
2019,128498,40,6,1,1,0
2019,128498,41,0,3,1,2
2019,128498,41,3,3,1,2
2019,128498,42,0,42,24,18
2019,128498,42,1,16,12,4
2019,128498,42,2,7,2,5
2019,128498,42,3,17,9,8
2019,128498,42,4,1,0,1
2019,128498,42,6,1,1,0
2019,128498,44,0,3,1,2
2019,128498,44,3,3,1,2
2019,128577,0,0,34,22,12
2019,128577,10,0,25,13,12
2019,128577,10,1,12,6,6
2019,128577,10,2,4,2,2
2019,128577,10,3,6,3,3
2019,128577,10,5,3,2,1
2019,128577,20,0,12,6,6
2019,128577,20,1,12,6,6
2019,128577,30,0,10,5,5
2019,128577,30,2,4,2,2
2019,128577,30,3,6,3,3
2019,128577,40,0,3,2,1
2019,128577,40,5,3,2,1
2019,128577,42,0,3,2,1
2019,128577,42,5,3,2,1
2019,128577,50,0,9,9,0
2019,128744,0,0,151,79,72
2019,128744,10,0,149,78,71
2019,128744,10,1,22,15,7
2019,128744,10,2,53,32,21
2019,128744,10,3,40,13,27
2019,128744,10,5,19,11,8
2019,128744,10,6,15,7,8
2019,128744,20,0,69,44,25
2019,128744,20,1,21,15,6
2019,128744,20,2,41,27,14
2019,128744,20,3,5,1,4
2019,128744,20,6,2,1,1
2019,128744,30,0,39,13,26
2019,128744,30,1,1,0,1
2019,128744,30,2,8,2,6
2019,128744,30,3,24,8,16
2019,128744,30,5,1,0,1
2019,128744,30,6,5,3,2
2019,128744,40,0,41,21,20
2019,128744,40,2,4,3,1
2019,128744,40,3,11,4,7
2019,128744,40,5,18,11,7
2019,128744,40,6,8,3,5
2019,128744,41,0,37,18,19
2019,128744,41,2,4,3,1
2019,128744,41,3,8,2,6
2019,128744,41,5,18,11,7
2019,128744,41,6,7,2,5
2019,128744,43,0,4,3,1
2019,128744,43,3,3,2,1
2019,128744,43,6,1,1,0
2019,128744,45,0,37,18,19
2019,128744,45,2,4,3,1
2019,128744,45,3,8,2,6
2019,128744,45,5,18,11,7
2019,128744,45,6,7,2,5
2019,128744,50,0,2,1,1
2019,128771,0,0,440,246,194
2019,128771,10,0,440,246,194
2019,128771,10,1,196,120,76
2019,128771,10,2,137,74,63
2019,128771,10,3,101,50,51
2019,128771,10,4,6,2,4
2019,128771,20,0,315,183,132
2019,128771,20,1,196,120,76
2019,128771,20,2,111,59,52
2019,128771,20,3,8,4,4
2019,128771,30,0,101,48,53
2019,128771,30,2,22,12,10
2019,128771,30,3,79,36,43
2019,128771,40,0,24,15,9
2019,128771,40,2,4,3,1
2019,128771,40,3,14,10,4
2019,128771,40,4,6,2,4
2019,128771,42,0,24,15,9
2019,128771,42,2,4,3,1
2019,128771,42,3,14,10,4
2019,128771,42,4,6,2,4
2019,128902,0,0,208,103,105
2019,128902,10,0,208,103,105
2019,128902,10,1,69,39,30
2019,128902,10,2,59,30,29
2019,128902,10,3,55,23,32
2019,128902,10,4,8,6,2
2019,128902,10,5,17,5,12
2019,128902,20,0,116,59,57
2019,128902,20,1,61,32,29
2019,128902,20,2,55,27,28
2019,128902,30,0,32,10,22
2019,128902,30,3,32,10,22
2019,128902,40,0,60,34,26
2019,128902,40,1,8,7,1
2019,128902,40,2,4,3,1
2019,128902,40,3,23,13,10
2019,128902,40,4,8,6,2
2019,128902,40,5,17,5,12
2019,128902,41,0,49,27,22
2019,128902,41,1,8,7,1
2019,128902,41,2,4,3,1
2019,128902,41,3,15,9,6
2019,128902,41,4,5,3,2
2019,128902,41,5,17,5,12
2019,128902,42,0,11,7,4
2019,128902,42,3,8,4,4
2019,128902,42,4,3,3,0
2019,128902,44,0,13,7,6
2019,128902,44,3,11,7,4
2019,128902,44,4,1,0,1
2019,128902,44,5,1,0,1
2019,128902,45,0,36,20,16
2019,128902,45,1,8,7,1
2019,128902,45,2,4,3,1
2019,128902,45,3,4,2,2
2019,128902,45,4,4,3,1
2019,128902,45,5,16,5,11
2019,129020,0,0,1936,1136,800
2019,129020,10,0,1936,1136,800
2019,129020,10,1,584,410,174
2019,129020,10,2,576,321,255
2019,129020,10,3,670,360,310
2019,129020,10,4,56,26,30
2019,129020,10,5,50,19,31
2019,129020,20,0,948,621,327
2019,129020,20,1,533,376,157
2019,129020,20,2,411,243,168
2019,129020,20,3,4,2,2
2019,129020,30,0,283,162,121
2019,129020,30,1,4,2,2
2019,129020,30,2,28,21,7
2019,129020,30,3,248,138,110
2019,129020,30,4,3,1,2
2019,129020,40,0,705,353,352
2019,129020,40,1,47,32,15
2019,129020,40,2,137,57,80
2019,129020,40,3,418,220,198
2019,129020,40,4,53,25,28
2019,129020,40,5,50,19,31
2019,129020,41,0,162,69,93
2019,129020,41,1,12,6,6
2019,129020,41,2,44,12,32
2019,129020,41,3,60,30,30
2019,129020,41,4,11,6,5
2019,129020,41,5,35,15,20
2019,129020,42,0,535,277,258
2019,129020,42,1,35,26,9
2019,129020,42,2,93,45,48
2019,129020,42,3,351,184,167
2019,129020,42,4,42,19,23
2019,129020,42,5,14,3,11
2019,129020,43,0,8,7,1
2019,129020,43,3,7,6,1
2019,129020,43,5,1,1,0
2019,129020,44,0,162,69,93
2019,129020,44,1,12,6,6
2019,129020,44,2,44,12,32
2019,129020,44,3,60,30,30
2019,129020,44,4,11,6,5
2019,129020,44,5,35,15,20
2019,129154,0,0,92,29,63
2019,129154,10,0,92,29,63
2019,129154,10,1,2,1,1
2019,129154,10,2,24,8,16
2019,129154,10,3,48,14,34
2019,129154,10,4,18,6,12
2019,129154,40,0,92,29,63
2019,129154,40,1,2,1,1
2019,129154,40,2,24,8,16
2019,129154,40,3,48,14,34
2019,129154,40,4,18,6,12
2019,129154,41,0,17,3,14
2019,129154,41,1,2,1,1
2019,129154,41,2,15,2,13
2019,129154,42,0,75,26,49
2019,129154,42,2,9,6,3
2019,129154,42,3,48,14,34
2019,129154,42,4,18,6,12
2019,129154,44,0,17,3,14
2019,129154,44,1,2,1,1
2019,129154,44,2,15,2,13
2019,129215,0,0,204,116,88
2019,129215,10,0,204,116,88
2019,129215,10,1,95,55,40
2019,129215,10,2,43,26,17
2019,129215,10,3,63,33,30
2019,129215,10,4,3,2,1
2019,129215,20,0,142,84,58
2019,129215,20,1,95,55,40
2019,129215,20,2,43,26,17
2019,129215,20,3,4,3,1
2019,129215,30,0,44,20,24
2019,129215,30,3,44,20,24
2019,129215,40,0,18,12,6
2019,129215,40,3,15,10,5
2019,129215,40,4,3,2,1
2019,129215,42,0,18,12,6
2019,129215,42,3,15,10,5
2019,129215,42,4,3,2,1
2019,129242,0,0,300,133,167
2019,129242,10,0,300,133,167
2019,129242,10,1,73,38,35
2019,129242,10,2,101,47,54
2019,129242,10,3,99,38,61
2019,129242,10,4,27,10,17
2019,129242,20,0,171,84,87
2019,129242,20,1,73,38,35
2019,129242,20,2,94,45,49
2019,129242,20,3,4,1,3
2019,129242,30,0,55,21,34
2019,129242,30,2,2,0,2
2019,129242,30,3,53,21,32
2019,129242,40,0,74,28,46
2019,129242,40,2,5,2,3
2019,129242,40,3,42,16,26
2019,129242,40,4,27,10,17
2019,129242,42,0,74,28,46
2019,129242,42,2,5,2,3
2019,129242,42,3,42,16,26
2019,129242,42,4,27,10,17
2019,129367,0,0,65,27,38
2019,129367,10,0,65,27,38
2019,129367,10,1,30,15,15
2019,129367,10,2,14,7,7
2019,129367,10,3,16,4,12
2019,129367,10,4,4,1,3
2019,129367,10,5,1,0,1
2019,129367,20,0,35,17,18
2019,129367,20,1,29,14,15
2019,129367,20,2,6,3,3
2019,129367,30,0,28,9,19
2019,129367,30,1,1,1,0
2019,129367,30,2,8,4,4
2019,129367,30,3,15,3,12
2019,129367,30,4,4,1,3
2019,129367,40,0,2,1,1
2019,129367,40,3,1,1,0
2019,129367,40,5,1,0,1
2019,129367,41,0,1,1,0
2019,129367,41,3,1,1,0
2019,129367,42,0,1,0,1
2019,129367,42,5,1,0,1
2019,129367,44,0,1,1,0
2019,129367,44,3,1,1,0
2019,129428,0,0,3,3,0
2019,129428,10,0,3,3,0
2019,129428,10,1,2,2,0
2019,129428,10,5,1,1,0
2019,129428,40,0,3,3,0
2019,129428,40,1,2,2,0
2019,129428,40,5,1,1,0
2019,129428,41,0,3,3,0
2019,129428,41,1,2,2,0
2019,129428,41,5,1,1,0
2019,129428,44,0,3,3,0
2019,129428,44,1,2,2,0
2019,129428,44,5,1,1,0
2019,129491,0,0,7,5,2
2019,129491,10,0,7,5,2
2019,129491,10,1,3,3,0
2019,129491,10,2,4,2,2
2019,129491,40,0,7,5,2
2019,129491,40,1,3,3,0
2019,129491,40,2,4,2,2
2019,129491,41,0,7,5,2
2019,129491,41,1,3,3,0
2019,129491,41,2,4,2,2
2019,129491,44,0,7,5,2
2019,129491,44,1,3,3,0
2019,129491,44,2,4,2,2
2019,129525,0,0,357,193,164
2019,129525,10,0,357,193,164
2019,129525,10,1,89,63,26
2019,129525,10,2,123,65,58
2019,129525,10,3,115,52,63
2019,129525,10,4,9,4,5
2019,129525,10,5,2,1,1
2019,129525,10,6,19,8,11
2019,129525,20,0,194,116,78
2019,129525,20,1,88,62,26
2019,129525,20,2,103,53,50
2019,129525,20,3,3,1,2
2019,129525,30,0,66,29,37
2019,129525,30,2,7,5,2
2019,129525,30,3,57,23,34
2019,129525,30,6,2,1,1
2019,129525,40,0,97,48,49
2019,129525,40,1,1,1,0
2019,129525,40,2,13,7,6
2019,129525,40,3,55,28,27
2019,129525,40,4,9,4,5
2019,129525,40,5,2,1,1
2019,129525,40,6,17,7,10
2019,129525,41,0,51,26,25
2019,129525,41,1,1,1,0
2019,129525,41,2,11,6,5
2019,129525,41,3,33,15,18
2019,129525,41,4,5,3,2
2019,129525,41,6,1,1,0
2019,129525,42,0,39,19,20
2019,129525,42,2,2,1,1
2019,129525,42,3,22,13,9
2019,129525,42,4,4,1,3
2019,129525,42,5,2,1,1
2019,129525,42,6,9,3,6
2019,129525,43,0,7,3,4
2019,129525,43,6,7,3,4
2019,129525,44,0,51,26,25
2019,129525,44,1,1,1,0
2019,129525,44,2,11,6,5
2019,129525,44,3,33,15,18
2019,129525,44,4,5,3,2
2019,129525,44,6,1,1,0
2019,129534,0,0,14,7,7
2019,129534,10,0,14,7,7
2019,129534,10,1,4,2,2
2019,129534,10,2,4,1,3
2019,129534,10,3,3,2,1
2019,129534,10,4,3,2,1
2019,129534,40,0,14,7,7
2019,129534,40,1,4,2,2
2019,129534,40,2,4,1,3
2019,129534,40,3,3,2,1
2019,129534,40,4,3,2,1
2019,129534,41,0,9,4,5
2019,129534,41,1,2,0,2
2019,129534,41,2,2,0,2
2019,129534,41,3,2,2,0
2019,129534,41,4,3,2,1
2019,129534,42,0,1,0,1
2019,129534,42,2,1,0,1
2019,129534,43,0,4,3,1
2019,129534,43,1,2,2,0
2019,129534,43,2,1,1,0
2019,129534,43,3,1,0,1
2019,129534,44,0,9,4,5
2019,129534,44,1,2,0,2
2019,129534,44,2,2,0,2
2019,129534,44,3,2,2,0
2019,129534,44,4,3,2,1
2019,129543,0,0,74,34,40
2019,129543,10,0,74,34,40
2019,129543,10,1,32,14,18
2019,129543,10,2,19,10,9
2019,129543,10,3,12,5,7
2019,129543,10,4,8,5,3
2019,129543,10,5,3,0,3
2019,129543,20,0,49,21,28
2019,129543,20,1,32,14,18
2019,129543,20,2,15,6,9
2019,129543,20,3,2,1,1
2019,129543,30,0,22,13,9
2019,129543,30,2,4,4,0
2019,129543,30,3,10,4,6
2019,129543,30,4,8,5,3
2019,129543,40,0,3,0,3
2019,129543,40,5,3,0,3
2019,129543,42,0,3,0,3
2019,129543,42,5,3,0,3
2019,129695,0,0,96,37,59
2019,129695,10,0,96,37,59
2019,129695,10,1,55,23,32
2019,129695,10,2,19,5,14
2019,129695,10,3,13,4,9
2019,129695,10,4,9,5,4
2019,129695,20,0,67,28,39
2019,129695,20,1,55,23,32
2019,129695,20,2,9,4,5
2019,129695,20,3,3,1,2
2019,129695,30,0,29,9,20
2019,129695,30,2,10,1,9
2019,129695,30,3,10,3,7
2019,129695,30,4,9,5,4
2019,129729,0,0,95,36,59
2019,129729,10,0,95,36,59
2019,129729,10,1,58,16,42
2019,129729,10,2,21,12,9
2019,129729,10,3,13,6,7
2019,129729,10,4,3,2,1
2019,129729,20,0,70,23,47
2019,129729,20,1,57,16,41
2019,129729,20,2,13,7,6
2019,129729,30,0,25,13,12
2019,129729,30,1,1,0,1
2019,129729,30,2,8,5,3
2019,129729,30,3,13,6,7
2019,129729,30,4,3,2,1
2019,129756,0,0,46,24,22
2019,129756,10,0,46,24,22
2019,129756,10,1,27,14,13
2019,129756,10,2,10,6,4
2019,129756,10,3,6,3,3
2019,129756,10,5,3,1,2
2019,129756,20,0,29,16,13
2019,129756,20,1,26,14,12
2019,129756,20,2,1,1,0
2019,129756,20,3,2,1,1
2019,129756,30,0,14,7,7
2019,129756,30,1,1,0,1
2019,129756,30,2,9,5,4
2019,129756,30,3,4,2,2
2019,129756,40,0,3,1,2
2019,129756,40,5,3,1,2
2019,129756,43,0,3,1,2
2019,129756,43,5,3,1,2
2019,129774,0,0,16,7,9
2019,129774,10,0,16,7,9
2019,129774,10,1,2,1,1
2019,129774,10,2,6,3,3
2019,129774,10,3,8,3,5
2019,129774,40,0,16,7,9
2019,129774,40,1,2,1,1
2019,129774,40,2,6,3,3
2019,129774,40,3,8,3,5
2019,129774,41,0,13,7,6
2019,129774,41,1,2,1,1
2019,129774,41,2,6,3,3
2019,129774,41,3,5,3,2
2019,129774,42,0,3,0,3
2019,129774,42,3,3,0,3
2019,129774,44,0,13,7,6
2019,129774,44,1,2,1,1
2019,129774,44,2,6,3,3
2019,129774,44,3,5,3,2
2019,129808,0,0,70,33,37
2019,129808,10,0,70,33,37
2019,129808,10,1,40,18,22
2019,129808,10,2,6,2,4
2019,129808,10,3,18,8,10
2019,129808,10,4,1,1,0
2019,129808,10,5,5,4,1
2019,129808,20,0,45,21,24
2019,129808,20,1,40,18,22
2019,129808,20,2,4,2,2
2019,129808,20,3,1,1,0
2019,129808,30,0,20,8,12
2019,129808,30,2,2,0,2
2019,129808,30,3,17,7,10
2019,129808,30,4,1,1,0
2019,129808,40,0,5,4,1
2019,129808,40,5,5,4,1
2019,129808,42,0,5,4,1
2019,129808,42,5,5,4,1
2019,129941,0,0,271,169,102
2019,129941,10,0,271,169,102
2019,129941,10,1,48,37,11
2019,129941,10,2,71,46,25
2019,129941,10,3,75,42,33
2019,129941,10,5,77,44,33
2019,129941,20,0,116,78,38
2019,129941,20,1,48,37,11
2019,129941,20,2,65,41,24
2019,129941,20,3,3,0,3
2019,129941,30,0,61,37,24
2019,129941,30,2,5,4,1
2019,129941,30,3,56,33,23
2019,129941,40,0,94,54,40
2019,129941,40,2,1,1,0
2019,129941,40,3,16,9,7
2019,129941,40,5,77,44,33
2019,129941,41,0,51,35,16
2019,129941,41,2,1,1,0
2019,129941,41,3,6,4,2
2019,129941,41,5,44,30,14
2019,129941,42,0,43,19,24
2019,129941,42,3,10,5,5
2019,129941,42,5,33,14,19
2019,129941,44,0,51,35,16
2019,129941,44,2,1,1,0
2019,129941,44,3,6,4,2
2019,129941,44,5,44,30,14
2019,130004,0,0,88,40,48
2019,130004,10,0,88,40,48
2019,130004,10,1,62,32,30
2019,130004,10,2,8,4,4
2019,130004,10,3,7,2,5
2019,130004,10,4,4,1,3
2019,130004,10,5,7,1,6
2019,130004,20,0,62,31,31
2019,130004,20,1,59,29,30
2019,130004,20,2,3,2,1
2019,130004,30,0,15,8,7
2019,130004,30,1,3,3,0
2019,130004,30,2,5,2,3
2019,130004,30,3,6,2,4
2019,130004,30,4,1,1,0
2019,130004,40,0,11,1,10
2019,130004,40,3,1,0,1
2019,130004,40,4,3,0,3
2019,130004,40,5,7,1,6
2019,130004,42,0,11,1,10
2019,130004,42,3,1,0,1
2019,130004,42,4,3,0,3
2019,130004,42,5,7,1,6
2019,130040,0,0,28,9,19
2019,130040,10,0,28,9,19
2019,130040,10,1,14,4,10
2019,130040,10,2,7,2,5
2019,130040,10,3,6,3,3
2019,130040,10,4,1,0,1
2019,130040,20,0,17,6,11
2019,130040,20,1,14,4,10
2019,130040,20,2,3,2,1
2019,130040,30,0,11,3,8
2019,130040,30,2,4,0,4
2019,130040,30,3,6,3,3
2019,130040,30,4,1,0,1
2019,130183,0,0,49,18,31
2019,130183,10,0,49,18,31
2019,130183,10,4,3,3,0
2019,130183,10,6,46,15,31
2019,130183,40,0,49,18,31
2019,130183,40,4,3,3,0
2019,130183,40,6,46,15,31
2019,130183,41,0,49,18,31
2019,130183,41,4,3,3,0
2019,130183,41,6,46,15,31
2019,130183,44,0,49,18,31
2019,130183,44,4,3,3,0
2019,130183,44,6,46,15,31
2019,130217,0,0,27,13,14
2019,130217,10,0,26,12,14
2019,130217,10,1,17,6,11
2019,130217,10,2,4,2,2
2019,130217,10,3,5,4,1
2019,130217,20,0,21,8,13
2019,130217,20,1,17,6,11
2019,130217,20,2,3,1,2
2019,130217,20,3,1,1,0
2019,130217,30,0,5,4,1
2019,130217,30,2,1,1,0
2019,130217,30,3,4,3,1
2019,130217,50,0,1,1,0
2019,130226,0,0,447,195,252
2019,130226,10,0,447,195,252
2019,130226,10,1,126,72,54
2019,130226,10,2,151,58,93
2019,130226,10,3,154,59,95
2019,130226,10,4,16,6,10
2019,130226,20,0,201,100,101
2019,130226,20,1,110,63,47
2019,130226,20,2,91,37,54
2019,130226,30,0,70,32,38
2019,130226,30,2,7,3,4
2019,130226,30,3,63,29,34
2019,130226,40,0,176,63,113
2019,130226,40,1,16,9,7
2019,130226,40,2,53,18,35
2019,130226,40,3,91,30,61
2019,130226,40,4,16,6,10
2019,130226,41,0,158,57,101
2019,130226,41,1,16,9,7
2019,130226,41,2,52,18,34
2019,130226,41,3,76,25,51
2019,130226,41,4,14,5,9
2019,130226,42,0,18,6,12
2019,130226,42,2,1,0,1
2019,130226,42,3,15,5,10
2019,130226,42,4,2,1,1
2019,130226,44,0,158,57,101
2019,130226,44,1,16,9,7
2019,130226,44,2,52,18,34
2019,130226,44,3,76,25,51
2019,130226,44,4,14,5,9
2019,130253,0,0,329,132,197
2019,130253,10,0,329,132,197
2019,130253,10,1,47,28,19
2019,130253,10,2,100,45,55
2019,130253,10,3,130,41,89
2019,130253,10,4,27,8,19
2019,130253,10,5,25,10,15
2019,130253,20,0,110,60,50
2019,130253,20,1,44,27,17
2019,130253,20,2,65,33,32
2019,130253,20,3,1,0,1
2019,130253,30,0,61,28,33
2019,130253,30,1,1,0,1
2019,130253,30,2,4,3,1
2019,130253,30,3,56,25,31
2019,130253,40,0,158,44,114
2019,130253,40,1,2,1,1
2019,130253,40,2,31,9,22
2019,130253,40,3,73,16,57
2019,130253,40,4,27,8,19
2019,130253,40,5,25,10,15
2019,130253,42,0,158,44,114
2019,130253,42,1,2,1,1
2019,130253,42,2,31,9,22
2019,130253,42,3,73,16,57
2019,130253,42,4,27,8,19
2019,130253,42,5,25,10,15
2019,130314,0,0,139,41,98
2019,130314,10,0,139,41,98
2019,130314,10,1,20,11,9
2019,130314,10,2,42,15,27
2019,130314,10,3,70,15,55
2019,130314,10,4,7,0,7
2019,130314,20,0,56,25,31
2019,130314,20,1,20,11,9
2019,130314,20,2,35,14,21
2019,130314,20,3,1,0,1
2019,130314,30,0,41,10,31
2019,130314,30,2,1,0,1
2019,130314,30,3,40,10,30
2019,130314,40,0,42,6,36
2019,130314,40,2,6,1,5
2019,130314,40,3,29,5,24
2019,130314,40,4,7,0,7
2019,130314,41,0,37,4,33
2019,130314,41,2,6,1,5
2019,130314,41,3,24,3,21
2019,130314,41,4,7,0,7
2019,130314,42,0,5,2,3
2019,130314,42,3,5,2,3
2019,130314,44,0,37,4,33
2019,130314,44,2,6,1,5
2019,130314,44,3,24,3,21
2019,130314,44,4,7,0,7
2019,130396,0,0,102,45,57
2019,130396,10,0,102,45,57
2019,130396,10,1,58,25,33
2019,130396,10,2,12,4,8
2019,130396,10,3,12,4,8
2019,130396,10,4,17,11,6
2019,130396,10,5,3,1,2
2019,130396,20,0,69,29,40
2019,130396,20,1,58,25,33
2019,130396,20,2,11,4,7
2019,130396,30,0,30,15,15
2019,130396,30,2,1,0,1
2019,130396,30,3,12,4,8
2019,130396,30,4,17,11,6
2019,130396,40,0,3,1,2
2019,130396,40,5,3,1,2
2019,130396,42,0,3,1,2
2019,130396,42,5,3,1,2
2019,130493,0,0,423,202,221
2019,130493,10,0,423,202,221
2019,130493,10,1,169,94,75
2019,130493,10,2,139,62,77
2019,130493,10,3,106,44,62
2019,130493,10,4,9,2,7
2019,130493,20,0,299,152,147
2019,130493,20,1,168,93,75
2019,130493,20,2,127,58,69
2019,130493,20,3,4,1,3
2019,130493,30,0,105,45,60
2019,130493,30,1,1,1,0
2019,130493,30,2,12,4,8
2019,130493,30,3,92,40,52
2019,130493,40,0,19,5,14
2019,130493,40,3,10,3,7
2019,130493,40,4,9,2,7
2019,130493,42,0,19,5,14
2019,130493,42,3,10,3,7
2019,130493,42,4,9,2,7
2019,130590,0,0,223,124,99
2019,130590,10,0,223,124,99
2019,130590,10,1,62,45,17
2019,130590,10,2,59,26,33
2019,130590,10,3,36,17,19
2019,130590,10,5,25,10,15
2019,130590,10,6,41,26,15
2019,130590,20,0,112,66,46
2019,130590,20,1,57,41,16
2019,130590,20,2,55,25,30
2019,130590,30,0,36,17,19
2019,130590,30,3,36,17,19
2019,130590,40,0,75,41,34
2019,130590,40,1,5,4,1
2019,130590,40,2,4,1,3
2019,130590,40,5,25,10,15
2019,130590,40,6,41,26,15
2019,130590,41,0,59,30,29
2019,130590,41,1,5,4,1
2019,130590,41,2,4,1,3
2019,130590,41,5,25,10,15
2019,130590,41,6,25,15,10
2019,130590,42,0,16,11,5
2019,130590,42,6,16,11,5
2019,130590,44,0,59,30,29
2019,130590,44,1,5,4,1
2019,130590,44,2,4,1,3
2019,130590,44,5,25,10,15
2019,130590,44,6,25,15,10
2019,130606,0,0,54,25,29
2019,130606,10,0,54,25,29
2019,130606,10,1,36,18,18
2019,130606,10,2,7,3,4
2019,130606,10,3,3,0,3
2019,130606,10,4,3,2,1
2019,130606,10,5,5,2,3
2019,130606,20,0,41,21,20
2019,130606,20,1,35,18,17
2019,130606,20,2,6,3,3
2019,130606,30,0,8,2,6
2019,130606,30,1,1,0,1
2019,130606,30,2,1,0,1
2019,130606,30,3,3,0,3
2019,130606,30,4,3,2,1
2019,130606,40,0,5,2,3
2019,130606,40,5,5,2,3
2019,130606,42,0,5,2,3
2019,130606,42,5,5,2,3
2019,130624,0,0,142,97,45
2019,130624,10,0,142,97,45
2019,130624,10,1,32,22,10
2019,130624,10,2,18,10,8
2019,130624,10,3,9,6,3
2019,130624,10,4,79,57,22
2019,130624,10,6,4,2,2
2019,130624,20,0,68,45,23
2019,130624,20,1,32,22,10
2019,130624,20,2,17,9,8
2019,130624,20,3,4,3,1
2019,130624,20,4,15,11,4
2019,130624,30,0,5,3,2
2019,130624,30,2,1,1,0
2019,130624,30,3,4,2,2
2019,130624,40,0,69,49,20
2019,130624,40,3,1,1,0
2019,130624,40,4,64,46,18
2019,130624,40,6,4,2,2
2019,130624,41,0,60,44,16
2019,130624,41,4,60,44,16
2019,130624,42,0,9,5,4
2019,130624,42,3,1,1,0
2019,130624,42,4,4,2,2
2019,130624,42,6,4,2,2
2019,130624,44,0,60,44,16
2019,130624,44,4,60,44,16
2019,130697,0,0,378,205,173
2019,130697,10,0,378,205,173
2019,130697,10,1,108,78,30
2019,130697,10,2,81,35,46
2019,130697,10,3,79,36,43
2019,130697,10,6,110,56,54
2019,130697,20,0,189,113,76
2019,130697,20,1,108,78,30
2019,130697,20,2,81,35,46
2019,130697,30,0,79,36,43
2019,130697,30,3,79,36,43
2019,130697,40,0,110,56,54
2019,130697,40,6,110,56,54
2019,130697,41,0,76,36,40
2019,130697,41,6,76,36,40
2019,130697,42,0,34,20,14
2019,130697,42,6,34,20,14
2019,130697,44,0,76,36,40
2019,130697,44,6,76,36,40
2019,130776,0,0,224,110,114
2019,130776,10,0,224,110,114
2019,130776,10,1,102,56,46
2019,130776,10,2,56,27,29
2019,130776,10,3,62,27,35
2019,130776,10,4,4,0,4
2019,130776,20,0,154,76,78
2019,130776,20,1,102,56,46
2019,130776,20,2,48,20,28
2019,130776,20,3,4,0,4
2019,130776,30,0,62,31,31
2019,130776,30,2,8,7,1
2019,130776,30,3,53,24,29
2019,130776,30,4,1,0,1
2019,130776,40,0,8,3,5
2019,130776,40,3,5,3,2
2019,130776,40,4,3,0,3
2019,130776,42,0,8,3,5
2019,130776,42,3,5,3,2
2019,130776,42,4,3,0,3
2019,130794,0,0,2720,1642,1078
2019,130794,10,0,2720,1642,1078
2019,130794,10,1,1024,757,267
2019,130794,10,2,527,310,217
2019,130794,10,3,695,346,349
2019,130794,10,5,474,229,245
2019,130794,20,0,1065,780,285
2019,130794,20,1,955,711,244
2019,130794,20,2,110,69,41
2019,130794,30,0,1080,571,509
2019,130794,30,2,404,232,172
2019,130794,30,3,676,339,337
2019,130794,40,0,575,291,284
2019,130794,40,1,69,46,23
2019,130794,40,2,13,9,4
2019,130794,40,3,19,7,12
2019,130794,40,5,474,229,245
2019,130794,41,0,298,159,139
2019,130794,41,1,62,43,19
2019,130794,41,2,13,9,4
2019,130794,41,3,17,6,11
2019,130794,41,5,206,101,105
2019,130794,42,0,254,115,139
2019,130794,42,1,5,1,4
2019,130794,42,3,1,0,1
2019,130794,42,5,248,114,134
2019,130794,43,0,23,17,6
2019,130794,43,1,2,2,0
2019,130794,43,3,1,1,0
2019,130794,43,5,20,14,6
2019,130794,44,0,292,154,138
2019,130794,44,1,56,38,18
2019,130794,44,2,13,9,4
2019,130794,44,3,17,6,11
2019,130794,44,5,206,101,105
2019,130794,45,0,6,5,1
2019,130794,45,1,6,5,1
2019,130907,0,0,388,134,254
2019,130907,10,0,388,134,254
2019,130907,10,4,388,134,254
2019,130907,40,0,388,134,254
2019,130907,40,4,388,134,254
2019,130907,41,0,388,134,254
2019,130907,41,4,388,134,254
2019,130907,45,0,388,134,254
2019,130907,45,4,388,134,254
2019,130934,0,0,220,114,106
2019,130934,10,0,214,111,103
2019,130934,10,1,49,34,15
2019,130934,10,2,88,46,42
2019,130934,10,3,50,21,29
2019,130934,10,4,3,3,0
2019,130934,10,5,24,7,17
2019,130934,20,0,124,75,49
2019,130934,20,1,49,34,15
2019,130934,20,2,75,41,34
2019,130934,30,0,48,20,28
2019,130934,30,2,13,5,8
2019,130934,30,3,35,15,20
2019,130934,40,0,42,16,26
2019,130934,40,3,15,6,9
2019,130934,40,4,3,3,0
2019,130934,40,5,24,7,17
2019,130934,42,0,42,16,26
2019,130934,42,3,15,6,9
2019,130934,42,4,3,3,0
2019,130934,42,5,24,7,17
2019,130934,50,0,6,3,3
2019,130943,0,0,1265,698,567
2019,130943,10,0,1265,698,567
2019,130943,10,1,400,284,116
2019,130943,10,2,375,205,170
2019,130943,10,3,394,184,210
2019,130943,10,4,96,25,71
2019,130943,20,0,670,432,238
2019,130943,20,1,374,267,107
2019,130943,20,2,296,165,131
2019,130943,30,0,232,115,117
2019,130943,30,1,3,2,1
2019,130943,30,2,11,6,5
2019,130943,30,3,216,106,110
2019,130943,30,4,2,1,1
2019,130943,40,0,363,151,212
2019,130943,40,1,23,15,8
2019,130943,40,2,68,34,34
2019,130943,40,3,178,78,100
2019,130943,40,4,94,24,70
2019,130943,41,0,271,110,161
2019,130943,41,1,18,10,8
2019,130943,41,2,53,24,29
2019,130943,41,3,132,56,76
2019,130943,41,4,68,20,48
2019,130943,42,0,92,41,51
2019,130943,42,1,5,5,0
2019,130943,42,2,15,10,5
2019,130943,42,3,46,22,24
2019,130943,42,4,26,4,22
2019,130943,44,0,271,110,161
2019,130943,44,1,18,10,8
2019,130943,44,2,53,24,29
2019,130943,44,3,132,56,76
2019,130943,44,4,68,20,48
2019,130989,0,0,21,13,8
2019,130989,10,0,21,13,8
2019,130989,10,1,6,3,3
2019,130989,10,2,6,5,1
2019,130989,10,3,9,5,4
2019,130989,40,0,21,13,8
2019,130989,40,1,6,3,3
2019,130989,40,2,6,5,1
2019,130989,40,3,9,5,4
2019,130989,42,0,21,13,8
2019,130989,42,1,6,3,3
2019,130989,42,2,6,5,1
2019,130989,42,3,9,5,4
2019,131098,0,0,80,33,47
2019,131098,10,0,75,31,44
2019,131098,10,1,27,14,13
2019,131098,10,2,20,7,13
2019,131098,10,3,17,6,11
2019,131098,10,4,11,4,7
2019,131098,20,0,40,18,22
2019,131098,20,1,27,14,13
2019,131098,20,2,13,4,9
2019,131098,30,0,24,9,15
2019,131098,30,2,7,3,4
2019,131098,30,3,17,6,11
2019,131098,40,0,11,4,7
2019,131098,40,4,11,4,7
2019,131098,42,0,11,4,7
2019,131098,42,4,11,4,7
2019,131098,50,0,5,2,3
2019,131113,0,0,92,36,56
2019,131113,10,0,92,36,56
2019,131113,10,1,7,2,5
2019,131113,10,2,29,11,18
2019,131113,10,3,56,23,33
2019,131113,40,0,92,36,56
2019,131113,40,1,7,2,5
2019,131113,40,2,29,11,18
2019,131113,40,3,56,23,33
2019,131113,41,0,92,36,56
2019,131113,41,1,7,2,5
2019,131113,41,2,29,11,18
2019,131113,41,3,56,23,33
2019,131113,44,0,92,36,56
2019,131113,44,1,7,2,5
2019,131113,44,2,29,11,18
2019,131113,44,3,56,23,33
2019,131159,0,0,840,425,415
2019,131159,10,0,840,425,415
2019,131159,10,1,194,127,67
2019,131159,10,2,168,85,83
2019,131159,10,3,150,74,76
2019,131159,10,4,328,139,189
2019,131159,20,0,347,207,140
2019,131159,20,1,185,123,62
2019,131159,20,2,158,84,74
2019,131159,20,3,4,0,4
2019,131159,30,0,93,44,49
2019,131159,30,2,1,0,1
2019,131159,30,3,92,44,48
2019,131159,40,0,400,174,226
2019,131159,40,1,9,4,5
2019,131159,40,2,9,1,8
2019,131159,40,3,54,30,24
2019,131159,40,4,328,139,189
2019,131159,41,0,193,81,112
2019,131159,41,1,6,3,3
2019,131159,41,2,7,1,6
2019,131159,41,3,37,19,18
2019,131159,41,4,143,58,85
2019,131159,42,0,207,93,114
2019,131159,42,1,3,1,2
2019,131159,42,2,2,0,2
2019,131159,42,3,17,11,6
2019,131159,42,4,185,81,104
2019,131159,44,0,193,81,112
2019,131159,44,1,6,3,3
2019,131159,44,2,7,1,6
2019,131159,44,3,37,19,18
2019,131159,44,4,143,58,85
2019,131283,0,0,381,240,141
2019,131283,10,0,381,240,141
2019,131283,10,1,115,85,30
2019,131283,10,2,146,87,59
2019,131283,10,3,110,65,45
2019,131283,10,4,10,3,7
2019,131283,20,0,215,141,74
2019,131283,20,1,110,81,29
2019,131283,20,2,104,59,45
2019,131283,20,3,1,1,0
2019,131283,30,0,69,49,20
2019,131283,30,1,2,2,0
2019,131283,30,2,22,17,5
2019,131283,30,3,45,30,15
2019,131283,40,0,97,50,47
2019,131283,40,1,3,2,1
2019,131283,40,2,20,11,9
2019,131283,40,3,64,34,30
2019,131283,40,4,10,3,7
2019,131283,42,0,97,50,47
2019,131283,42,1,3,2,1
2019,131283,42,2,20,11,9
2019,131283,42,3,64,34,30
2019,131283,42,4,10,3,7
2019,131399,0,0,204,92,112
2019,131399,10,0,204,92,112
2019,131399,10,1,46,22,24
2019,131399,10,2,74,37,37
2019,131399,10,3,73,28,45
2019,131399,10,4,11,5,6
2019,131399,20,0,106,53,53
2019,131399,20,1,46,22,24
2019,131399,20,2,44,23,21
2019,131399,20,3,12,6,6
2019,131399,20,4,4,2,2
2019,131399,30,0,77,30,47
2019,131399,30,2,21,9,12
2019,131399,30,3,53,18,35
2019,131399,30,4,3,3,0
2019,131399,40,0,21,9,12
2019,131399,40,2,9,5,4
2019,131399,40,3,8,4,4
2019,131399,40,4,4,0,4
2019,131399,41,0,11,4,7
2019,131399,41,2,5,3,2
2019,131399,41,3,2,1,1
2019,131399,41,4,4,0,4
2019,131399,42,0,10,5,5
2019,131399,42,2,4,2,2
2019,131399,42,3,6,3,3
2019,131399,44,0,11,4,7
2019,131399,44,2,5,3,2
2019,131399,44,3,2,1,1
2019,131399,44,4,4,0,4
2019,131405,0,0,17,16,1
2019,131405,10,0,17,16,1
2019,131405,10,1,2,2,0
2019,131405,10,2,3,3,0
2019,131405,10,3,11,10,1
2019,131405,10,4,1,1,0
2019,131405,40,0,17,16,1
2019,131405,40,1,2,2,0
2019,131405,40,2,3,3,0
2019,131405,40,3,11,10,1
2019,131405,40,4,1,1,0
2019,131405,41,0,15,15,0
2019,131405,41,1,2,2,0
2019,131405,41,2,2,2,0
2019,131405,41,3,10,10,0
2019,131405,41,4,1,1,0
2019,131405,42,0,2,1,1
2019,131405,42,2,1,1,0
2019,131405,42,3,1,0,1
2019,131405,44,0,15,15,0
2019,131405,44,1,2,2,0
2019,131405,44,2,2,2,0
2019,131405,44,3,10,10,0
2019,131405,44,4,1,1,0
2019,131450,0,0,189,71,118
2019,131450,10,0,185,69,116
2019,131450,10,1,70,28,42
2019,131450,10,2,36,11,25
2019,131450,10,3,42,14,28
2019,131450,10,4,17,8,9
2019,131450,10,5,20,8,12
2019,131450,20,0,88,33,55
2019,131450,20,1,66,25,41
2019,131450,20,2,18,6,12
2019,131450,20,3,4,2,2
2019,131450,30,0,70,25,45
2019,131450,30,1,4,3,1
2019,131450,30,2,18,5,13
2019,131450,30,3,38,12,26
2019,131450,30,4,8,5,3
2019,131450,30,5,2,0,2
2019,131450,40,0,27,11,16
2019,131450,40,4,9,3,6
2019,131450,40,5,18,8,10
2019,131450,42,0,27,11,16
2019,131450,42,4,9,3,6
2019,131450,42,5,18,8,10
2019,131450,50,0,4,2,2
2019,131469,0,0,1275,678,597
2019,131469,10,0,1275,678,597
2019,131469,10,1,418,287,131
2019,131469,10,2,394,200,194
2019,131469,10,3,285,124,161
2019,131469,10,4,2,0,2
2019,131469,10,6,176,67,109
2019,131469,20,0,654,407,247
2019,131469,20,1,374,255,119
2019,131469,20,2,280,152,128
2019,131469,30,0,174,84,90
2019,131469,30,1,3,2,1
2019,131469,30,2,15,5,10
2019,131469,30,3,156,77,79
2019,131469,40,0,447,187,260
2019,131469,40,1,41,30,11
2019,131469,40,2,99,43,56
2019,131469,40,3,129,47,82
2019,131469,40,4,2,0,2
2019,131469,40,6,176,67,109
2019,131469,41,0,267,119,148
2019,131469,41,1,26,21,5
2019,131469,41,2,67,29,38
2019,131469,41,3,89,34,55
2019,131469,41,6,85,35,50
2019,131469,42,0,177,65,112
2019,131469,42,1,15,9,6
2019,131469,42,2,32,14,18
2019,131469,42,3,40,13,27
2019,131469,42,4,2,0,2
2019,131469,42,6,88,29,59
2019,131469,43,0,3,3,0
2019,131469,43,6,3,3,0
2019,131469,44,0,267,119,148
2019,131469,44,1,26,21,5
2019,131469,44,2,67,29,38
2019,131469,44,3,89,34,55
2019,131469,44,6,85,35,50
2019,131496,0,0,1227,669,558
2019,131496,10,0,1213,659,554
2019,131496,10,1,433,280,153
2019,131496,10,2,247,132,115
2019,131496,10,3,102,53,49
2019,131496,10,6,431,194,237
2019,131496,20,0,655,403,252
2019,131496,20,1,426,276,150
2019,131496,20,2,227,126,101
2019,131496,20,3,2,1,1
2019,131496,30,0,128,63,65
2019,131496,30,1,7,4,3
2019,131496,30,2,20,6,14
2019,131496,30,3,100,52,48
2019,131496,30,6,1,1,0
2019,131496,40,0,430,193,237
2019,131496,40,6,430,193,237
2019,131496,41,0,242,113,129
2019,131496,41,6,242,113,129
2019,131496,42,0,184,76,108
2019,131496,42,6,184,76,108
2019,131496,43,0,4,4,0
2019,131496,43,6,4,4,0
2019,131496,44,0,242,113,129
2019,131496,44,6,242,113,129
2019,131496,50,0,14,10,4
2019,131520,0,0,950,501,449
2019,131520,10,0,950,501,449
2019,131520,10,1,235,157,78
2019,131520,10,2,306,163,143
2019,131520,10,3,254,112,142
2019,131520,10,4,58,23,35
2019,131520,10,5,93,45,48
2019,131520,10,6,4,1,3
2019,131520,20,0,475,286,189
2019,131520,20,1,225,151,74
2019,131520,20,2,244,131,113
2019,131520,20,3,6,4,2
2019,131520,30,0,176,82,94
2019,131520,30,1,4,3,1
2019,131520,30,2,16,7,9
2019,131520,30,3,154,71,83
2019,131520,30,4,2,1,1
2019,131520,40,0,299,133,166
2019,131520,40,1,6,3,3
2019,131520,40,2,46,25,21
2019,131520,40,3,94,37,57
2019,131520,40,4,56,22,34
2019,131520,40,5,93,45,48
2019,131520,40,6,4,1,3
2019,131520,41,0,166,74,92
2019,131520,41,1,4,3,1
2019,131520,41,2,42,21,21
2019,131520,41,3,74,32,42
2019,131520,41,4,42,17,25
2019,131520,41,6,4,1,3
2019,131520,42,0,133,59,74
2019,131520,42,1,2,0,2
2019,131520,42,2,4,4,0
2019,131520,42,3,20,5,15
2019,131520,42,4,14,5,9
2019,131520,42,5,93,45,48
2019,131520,44,0,166,74,92
2019,131520,44,1,4,3,1
2019,131520,44,2,42,21,21
2019,131520,44,3,74,32,42
2019,131520,44,4,42,17,25
2019,131520,44,6,4,1,3
2019,131876,0,0,68,19,49
2019,131876,10,0,60,17,43
2019,131876,10,1,3,0,3
2019,131876,10,2,24,8,16
2019,131876,10,3,33,9,24
2019,131876,20,0,24,7,17
2019,131876,20,1,3,0,3
2019,131876,20,2,21,7,14
2019,131876,30,0,15,3,12
2019,131876,30,2,3,1,2
2019,131876,30,3,12,2,10
2019,131876,40,0,21,7,14
2019,131876,40,3,21,7,14
2019,131876,42,0,21,7,14
2019,131876,42,3,21,7,14
2019,131876,50,0,8,2,6
2019,131973,0,0,23,14,9
2019,131973,10,0,23,14,9
2019,131973,10,1,16,10,6
2019,131973,10,2,4,2,2
2019,131973,10,3,3,2,1
2019,131973,20,0,11,6,5
2019,131973,20,1,11,6,5
2019,131973,30,0,6,3,3
2019,131973,30,2,4,2,2
2019,131973,30,3,2,1,1
2019,131973,40,0,6,5,1
2019,131973,40,1,5,4,1
2019,131973,40,3,1,1,0
2019,131973,41,0,4,3,1
2019,131973,41,1,3,2,1
2019,131973,41,3,1,1,0
2019,131973,42,0,2,2,0
2019,131973,42,1,2,2,0
2019,131973,44,0,3,2,1
2019,131973,44,1,2,1,1
2019,131973,44,3,1,1,0
2019,131973,45,0,1,1,0
2019,131973,45,1,1,1,0
2019,132408,0,0,23,16,7
2019,132408,10,0,23,16,7
2019,132408,10,1,12,11,1
2019,132408,10,2,4,3,1
2019,132408,10,3,4,2,2
2019,132408,10,4,3,0,3
2019,132408,20,0,5,4,1
2019,132408,20,1,5,4,1
2019,132408,30,0,1,1,0
2019,132408,30,2,1,1,0
2019,132408,40,0,17,11,6
2019,132408,40,1,7,7,0
2019,132408,40,2,3,2,1
2019,132408,40,3,4,2,2
2019,132408,40,4,3,0,3
2019,132408,42,0,17,11,6
2019,132408,42,1,7,7,0
2019,132408,42,2,3,2,1
2019,132408,42,3,4,2,2
2019,132408,42,4,3,0,3
2019,132471,0,0,303,130,173
2019,132471,10,0,303,130,173
2019,132471,10,1,77,46,31
2019,132471,10,2,99,39,60
2019,132471,10,3,104,35,69
2019,132471,10,4,23,10,13
2019,132471,20,0,17,8,9
2019,132471,20,1,8,5,3
2019,132471,20,2,9,3,6
2019,132471,30,0,11,5,6
2019,132471,30,2,4,2,2
2019,132471,30,3,7,3,4
2019,132471,40,0,275,117,158
2019,132471,40,1,69,41,28
2019,132471,40,2,86,34,52
2019,132471,40,3,97,32,65
2019,132471,40,4,23,10,13
2019,132471,41,0,187,86,101
2019,132471,41,1,66,38,28
2019,132471,41,2,77,32,45
2019,132471,41,3,44,16,28
2019,132471,42,0,88,31,57
2019,132471,42,1,3,3,0
2019,132471,42,2,9,2,7
2019,132471,42,3,53,16,37
2019,132471,42,4,23,10,13
2019,132471,44,0,187,86,101
2019,132471,44,1,66,38,28
2019,132471,44,2,77,32,45
2019,132471,44,3,44,16,28
2019,132602,0,0,168,91,77
2019,132602,10,0,168,91,77
2019,132602,10,1,16,10,6
2019,132602,10,2,33,16,17
2019,132602,10,3,79,45,34
2019,132602,10,4,40,20,20
2019,132602,20,0,40,22,18
2019,132602,20,1,16,10,6
2019,132602,20,2,22,10,12
2019,132602,20,3,2,2,0
2019,132602,30,0,69,41,28
2019,132602,30,2,11,6,5
2019,132602,30,3,58,35,23
2019,132602,40,0,59,28,31
2019,132602,40,3,19,8,11
2019,132602,40,4,40,20,20
2019,132602,42,0,59,28,31
2019,132602,42,3,19,8,11
2019,132602,42,4,40,20,20
2019,132657,0,0,135,79,56
2019,132657,10,0,135,79,56
2019,132657,10,1,28,16,12
2019,132657,10,2,51,32,19
2019,132657,10,3,42,20,22
2019,132657,10,4,11,8,3
2019,132657,10,6,3,3,0
2019,132657,40,0,135,79,56
2019,132657,40,1,28,16,12
2019,132657,40,2,51,32,19
2019,132657,40,3,42,20,22
2019,132657,40,4,11,8,3
2019,132657,40,6,3,3,0
2019,132657,41,0,135,79,56
2019,132657,41,1,28,16,12
2019,132657,41,2,51,32,19
2019,132657,41,3,42,20,22
2019,132657,41,4,11,8,3
2019,132657,41,6,3,3,0
2019,132657,44,0,135,79,56
2019,132657,44,1,28,16,12
2019,132657,44,2,51,32,19
2019,132657,44,3,42,20,22
2019,132657,44,4,11,8,3
2019,132657,44,6,3,3,0
2019,132693,0,0,269,117,152
2019,132693,10,0,269,117,152
2019,132693,10,1,51,21,30
2019,132693,10,2,49,21,28
2019,132693,10,3,54,22,32
2019,132693,10,4,115,53,62
2019,132693,20,0,168,72,96
2019,132693,20,1,51,21,30
2019,132693,20,2,47,21,26
2019,132693,20,3,50,21,29
2019,132693,20,4,20,9,11
2019,132693,30,0,84,36,48
2019,132693,30,2,1,0,1
2019,132693,30,4,83,36,47
2019,132693,40,0,17,9,8
2019,132693,40,2,1,0,1
2019,132693,40,3,4,1,3
2019,132693,40,4,12,8,4
2019,132693,43,0,17,9,8
2019,132693,43,2,1,0,1
2019,132693,43,3,4,1,3
2019,132693,43,4,12,8,4
2019,132709,0,0,363,164,199
2019,132709,10,0,363,164,199
2019,132709,10,1,51,30,21
2019,132709,10,2,30,9,21
2019,132709,10,3,258,113,145
2019,132709,10,4,24,12,12
2019,132709,20,0,283,133,150
2019,132709,20,1,51,30,21
2019,132709,20,2,30,9,21
2019,132709,20,3,186,87,99
2019,132709,20,4,16,7,9
2019,132709,30,0,80,31,49
2019,132709,30,3,72,26,46
2019,132709,30,4,8,5,3
2019,132842,0,0,21,6,15
2019,132842,10,0,21,6,15
2019,132842,10,1,5,2,3
2019,132842,10,2,6,2,4
2019,132842,10,3,10,2,8
2019,132842,40,0,21,6,15
2019,132842,40,1,5,2,3
2019,132842,40,2,6,2,4
2019,132842,40,3,10,2,8
2019,132842,41,0,20,6,14
2019,132842,41,1,5,2,3
2019,132842,41,2,5,2,3
2019,132842,41,3,10,2,8
2019,132842,42,0,1,0,1
2019,132842,42,2,1,0,1
2019,132842,44,0,20,6,14
2019,132842,44,1,5,2,3
2019,132842,44,2,5,2,3
2019,132842,44,3,10,2,8
2019,132851,0,0,126,50,76
2019,132851,10,0,126,50,76
2019,132851,10,1,22,7,15
2019,132851,10,2,60,27,33
2019,132851,10,3,31,10,21
2019,132851,10,4,9,5,4
2019,132851,10,6,4,1,3
2019,132851,20,0,51,21,30
2019,132851,20,1,22,7,15
2019,132851,20,2,21,10,11
2019,132851,20,3,6,3,3
2019,132851,20,4,2,1,1
2019,132851,30,0,38,11,27
2019,132851,30,2,23,8,15
2019,132851,30,3,12,2,10
2019,132851,30,4,3,1,2
2019,132851,40,0,37,18,19
2019,132851,40,2,16,9,7
2019,132851,40,3,13,5,8
2019,132851,40,4,4,3,1
2019,132851,40,6,4,1,3
2019,132851,43,0,37,18,19
2019,132851,43,2,16,9,7
2019,132851,43,3,13,5,8
2019,132851,43,4,4,3,1
2019,132851,43,6,4,1,3
2019,132879,0,0,12,6,6
2019,132879,10,0,12,6,6
2019,132879,10,1,5,1,4
2019,132879,10,2,5,3,2
2019,132879,10,3,2,2,0
2019,132879,40,0,12,6,6
2019,132879,40,1,5,1,4
2019,132879,40,2,5,3,2
2019,132879,40,3,2,2,0
2019,132879,42,0,12,6,6
2019,132879,42,1,5,1,4
2019,132879,42,2,5,3,2
2019,132879,42,3,2,2,0
2019,132903,0,0,1624,933,691
2019,132903,10,0,1624,933,691
2019,132903,10,1,346,259,87
2019,132903,10,2,396,241,155
2019,132903,10,3,390,218,172
2019,132903,10,4,215,83,132
2019,132903,10,5,277,132,145
2019,132903,20,0,700,478,222
2019,132903,20,1,334,251,83
2019,132903,20,2,364,225,139
2019,132903,20,3,2,2,0
2019,132903,30,0,356,205,151
2019,132903,30,2,9,7,2
2019,132903,30,3,347,198,149
2019,132903,40,0,568,250,318
2019,132903,40,1,12,8,4
2019,132903,40,2,23,9,14
2019,132903,40,3,41,18,23
2019,132903,40,4,215,83,132
2019,132903,40,5,277,132,145
2019,132903,41,0,73,38,35
2019,132903,41,1,10,8,2
2019,132903,41,2,17,8,9
2019,132903,41,3,27,10,17
2019,132903,41,4,11,7,4
2019,132903,41,5,8,5,3
2019,132903,42,0,495,212,283
2019,132903,42,1,2,0,2
2019,132903,42,2,6,1,5
2019,132903,42,3,14,8,6
2019,132903,42,4,204,76,128
2019,132903,42,5,269,127,142
2019,132903,44,0,73,38,35
2019,132903,44,1,10,8,2
2019,132903,44,2,17,8,9
2019,132903,44,3,27,10,17
2019,132903,44,4,11,7,4
2019,132903,44,5,8,5,3
2019,133021,0,0,39,13,26
2019,133021,10,0,39,13,26
2019,133021,10,1,10,5,5
2019,133021,10,2,1,0,1
2019,133021,10,3,11,5,6
2019,133021,10,4,17,3,14
2019,133021,20,0,23,9,14
2019,133021,20,1,10,5,5
2019,133021,20,2,1,0,1
2019,133021,20,3,10,4,6
2019,133021,20,4,2,0,2
2019,133021,30,0,14,4,10
2019,133021,30,3,1,1,0
2019,133021,30,4,13,3,10
2019,133021,40,0,2,0,2
2019,133021,40,4,2,0,2
2019,133021,42,0,2,0,2
2019,133021,42,4,2,0,2
2019,133386,0,0,231,120,111
2019,133386,10,0,231,120,111
2019,133386,10,1,112,64,48
2019,133386,10,2,71,33,38
2019,133386,10,3,39,14,25
2019,133386,10,4,9,9,0
2019,133386,20,0,183,100,83
2019,133386,20,1,112,64,48
2019,133386,20,2,62,30,32
2019,133386,20,3,9,6,3
2019,133386,30,0,48,20,28
2019,133386,30,2,9,3,6
2019,133386,30,3,30,8,22
2019,133386,30,4,9,9,0
2019,133465,0,0,19,5,14
2019,133465,10,0,19,5,14
2019,133465,10,2,1,0,1
2019,133465,10,3,4,0,4
2019,133465,10,4,14,5,9
2019,133465,40,0,19,5,14
2019,133465,40,2,1,0,1
2019,133465,40,3,4,0,4
2019,133465,40,4,14,5,9
2019,133465,41,0,19,5,14
2019,133465,41,2,1,0,1
2019,133465,41,3,4,0,4
2019,133465,41,4,14,5,9
2019,133465,45,0,19,5,14
2019,133465,45,2,1,0,1
2019,133465,45,3,4,0,4
2019,133465,45,4,14,5,9
2019,133492,0,0,162,85,77
2019,133492,10,0,162,85,77
2019,133492,10,1,47,31,16
2019,133492,10,2,27,15,12
2019,133492,10,3,67,29,38
2019,133492,10,4,21,10,11
2019,133492,20,0,82,50,32
2019,133492,20,1,47,31,16
2019,133492,20,2,27,15,12
2019,133492,20,3,8,4,4
2019,133492,30,0,39,13,26
2019,133492,30,3,39,13,26
2019,133492,40,0,41,22,19
2019,133492,40,3,20,12,8
2019,133492,40,4,21,10,11
2019,133492,42,0,41,22,19
2019,133492,42,3,20,12,8
2019,133492,42,4,21,10,11
2019,133508,0,0,195,91,104
2019,133508,10,0,194,90,104
2019,133508,10,6,194,90,104
2019,133508,20,0,104,49,55
2019,133508,20,6,104,49,55
2019,133508,30,0,79,36,43
2019,133508,30,6,79,36,43
2019,133508,40,0,11,5,6
2019,133508,40,6,11,5,6
2019,133508,42,0,11,5,6
2019,133508,42,6,11,5,6
2019,133508,50,0,1,1,0
2019,133526,0,0,60,34,26
2019,133526,10,0,60,34,26
2019,133526,10,1,11,8,3
2019,133526,10,2,11,8,3
2019,133526,10,3,26,12,14
2019,133526,10,4,12,6,6
2019,133526,20,0,10,7,3
2019,133526,20,1,10,7,3
2019,133526,30,0,29,13,16
2019,133526,30,1,1,1,0
2019,133526,30,2,8,5,3
2019,133526,30,3,19,7,12
2019,133526,30,4,1,0,1
2019,133526,40,0,21,14,7
2019,133526,40,2,3,3,0
2019,133526,40,3,7,5,2
2019,133526,40,4,11,6,5
2019,133526,43,0,21,14,7
2019,133526,43,2,3,3,0
2019,133526,43,3,7,5,2
2019,133526,43,4,11,6,5
2019,133553,0,0,335,238,97
2019,133553,10,0,335,238,97
2019,133553,10,1,91,74,17
2019,133553,10,2,102,80,22
2019,133553,10,3,116,70,46
2019,133553,10,4,26,14,12
2019,133553,20,0,147,113,34
2019,133553,20,1,85,70,15
2019,133553,20,2,62,43,19
2019,133553,30,0,63,41,22
2019,133553,30,1,1,1,0
2019,133553,30,2,4,3,1
2019,133553,30,3,58,37,21
2019,133553,40,0,125,84,41
2019,133553,40,1,5,3,2
2019,133553,40,2,36,34,2
2019,133553,40,3,58,33,25
2019,133553,40,4,26,14,12
2019,133553,42,0,125,84,41
2019,133553,42,1,5,3,2
2019,133553,42,2,36,34,2
2019,133553,42,3,58,33,25
2019,133553,42,4,26,14,12
2019,133650,0,0,586,300,286
2019,133650,10,0,547,291,256
2019,133650,10,1,159,109,50
2019,133650,10,2,159,81,78
2019,133650,10,3,146,66,80
2019,133650,10,4,83,35,48
2019,133650,20,0,300,182,118
2019,133650,20,1,150,106,44
2019,133650,20,2,139,70,69
2019,133650,20,3,11,6,5
2019,133650,30,0,114,58,56
2019,133650,30,1,1,0,1
2019,133650,30,2,17,11,6
2019,133650,30,3,95,46,49
2019,133650,30,4,1,1,0
2019,133650,40,0,133,51,82
2019,133650,40,1,8,3,5
2019,133650,40,2,3,0,3
2019,133650,40,3,40,14,26
2019,133650,40,4,82,34,48
2019,133650,42,0,133,51,82
2019,133650,42,1,8,3,5
2019,133650,42,2,3,0,3
2019,133650,42,3,40,14,26
2019,133650,42,4,82,34,48
2019,133650,50,0,39,9,30
2019,133669,0,0,887,484,403
2019,133669,10,0,887,484,403
2019,133669,10,1,249,178,71
2019,133669,10,2,220,118,102
2019,133669,10,3,193,99,94
2019,133669,10,4,224,89,135
2019,133669,10,5,1,0,1
2019,133669,20,0,429,272,157
2019,133669,20,1,240,172,68
2019,133669,20,2,189,100,89
2019,133669,30,0,176,96,80
2019,133669,30,1,2,2,0
2019,133669,30,2,16,10,6
2019,133669,30,3,158,84,74
2019,133669,40,0,282,116,166
2019,133669,40,1,7,4,3
2019,133669,40,2,15,8,7
2019,133669,40,3,35,15,20
2019,133669,40,4,224,89,135
2019,133669,40,5,1,0,1
2019,133669,42,0,282,116,166
2019,133669,42,1,7,4,3
2019,133669,42,2,15,8,7
2019,133669,42,3,35,15,20
2019,133669,42,4,224,89,135
2019,133669,42,5,1,0,1
2019,133702,0,0,350,160,190
2019,133702,10,0,350,160,190
2019,133702,10,6,350,160,190
2019,133702,20,0,220,96,124
2019,133702,20,6,220,96,124
2019,133702,30,0,123,62,61
2019,133702,30,6,123,62,61
2019,133702,40,0,7,2,5
2019,133702,40,6,7,2,5
2019,133702,43,0,7,2,5
2019,133702,43,6,7,2,5
2019,133711,0,0,126,55,71
2019,133711,10,0,126,55,71
2019,133711,10,1,18,9,9
2019,133711,10,2,40,18,22
2019,133711,10,3,60,25,35
2019,133711,10,4,5,3,2
2019,133711,10,5,3,0,3
2019,133711,40,0,126,55,71
2019,133711,40,1,18,9,9
2019,133711,40,2,40,18,22
2019,133711,40,3,60,25,35
2019,133711,40,4,5,3,2
2019,133711,40,5,3,0,3
2019,133711,41,0,90,41,49
2019,133711,41,1,13,7,6
2019,133711,41,2,34,15,19
2019,133711,41,3,40,18,22
2019,133711,41,4,3,1,2
2019,133711,42,0,36,14,22
2019,133711,42,1,5,2,3
2019,133711,42,2,6,3,3
2019,133711,42,3,20,7,13
2019,133711,42,4,2,2,0
2019,133711,42,5,3,0,3
2019,133711,44,0,90,41,49
2019,133711,44,1,13,7,6
2019,133711,44,2,34,15,19
2019,133711,44,3,40,18,22
2019,133711,44,4,3,1,2
2019,133809,0,0,36,27,9
2019,133809,10,0,36,27,9
2019,133809,10,1,36,27,9
2019,133809,20,0,23,17,6
2019,133809,20,1,23,17,6
2019,133809,30,0,13,10,3
2019,133809,30,1,13,10,3
2019,133845,0,0,18,1,17
2019,133845,10,0,18,1,17
2019,133845,10,4,18,1,17
2019,133845,40,0,18,1,17
2019,133845,40,4,18,1,17
2019,133845,41,0,18,1,17
2019,133845,41,4,18,1,17
2019,133845,45,0,18,1,17
2019,133845,45,4,18,1,17
2019,133854,0,0,13,4,9
2019,133854,10,0,13,4,9
2019,133854,10,4,13,4,9
2019,133854,40,0,13,4,9
2019,133854,40,4,13,4,9
2019,133854,41,0,13,4,9
2019,133854,41,4,13,4,9
2019,133854,45,0,13,4,9
2019,133854,45,4,13,4,9
2019,133863,0,0,8,1,7
2019,133863,10,0,8,1,7
2019,133863,10,4,8,1,7
2019,133863,40,0,8,1,7
2019,133863,40,4,8,1,7
2019,133863,41,0,8,1,7
2019,133863,41,4,8,1,7
2019,133863,45,0,8,1,7
2019,133863,45,4,8,1,7
2019,133872,0,0,91,25,66
2019,133872,10,0,91,25,66
2019,133872,10,1,14,6,8
2019,133872,10,2,27,4,23
2019,133872,10,3,37,12,25
2019,133872,10,4,13,3,10
2019,133872,40,0,91,25,66
2019,133872,40,1,14,6,8
2019,133872,40,2,27,4,23
2019,133872,40,3,37,12,25
2019,133872,40,4,13,3,10
2019,133872,41,0,16,7,9
2019,133872,41,1,7,5,2
2019,133872,41,2,6,2,4
2019,133872,41,3,3,0,3
2019,133872,42,0,74,17,57
2019,133872,42,1,7,1,6
2019,133872,42,2,20,1,19
2019,133872,42,3,34,12,22
2019,133872,42,4,13,3,10
2019,133872,43,0,1,1,0
2019,133872,43,2,1,1,0
2019,133872,44,0,16,7,9
2019,133872,44,1,7,5,2
2019,133872,44,2,6,2,4
2019,133872,44,3,3,0,3
2019,133881,0,0,288,211,77
2019,133881,10,0,288,211,77
2019,133881,10,1,77,63,14
2019,133881,10,2,88,73,15
2019,133881,10,3,99,65,34
2019,133881,10,4,24,10,14
2019,133881,20,0,44,35,9
2019,133881,20,1,43,35,8
2019,133881,20,2,1,0,1
2019,133881,30,0,20,15,5
2019,133881,30,1,4,4,0
2019,133881,30,2,3,2,1
2019,133881,30,3,11,8,3
2019,133881,30,4,2,1,1
2019,133881,40,0,224,161,63
2019,133881,40,1,30,24,6
2019,133881,40,2,84,71,13
2019,133881,40,3,88,57,31
2019,133881,40,4,22,9,13
2019,133881,42,0,224,161,63
2019,133881,42,1,30,24,6
2019,133881,42,2,84,71,13
2019,133881,42,3,88,57,31
2019,133881,42,4,22,9,13
2019,133951,0,0,1362,773,589
2019,133951,10,0,1356,772,584
2019,133951,10,1,283,208,75
2019,133951,10,2,341,204,137
2019,133951,10,3,293,137,156
2019,133951,10,4,388,197,191
2019,133951,10,5,34,17,17
2019,133951,10,6,17,9,8
2019,133951,20,0,532,361,171
2019,133951,20,1,256,190,66
2019,133951,20,2,276,171,105
2019,133951,30,0,177,99,78
2019,133951,30,1,1,1,0
2019,133951,30,2,19,13,6
2019,133951,30,3,157,85,72
2019,133951,40,0,647,312,335
2019,133951,40,1,26,17,9
2019,133951,40,2,46,20,26
2019,133951,40,3,136,52,84
2019,133951,40,4,388,197,191
2019,133951,40,5,34,17,17
2019,133951,40,6,17,9,8
2019,133951,41,0,26,13,13
2019,133951,41,1,8,5,3
2019,133951,41,2,6,3,3
2019,133951,41,3,8,2,6
2019,133951,41,4,4,3,1
2019,133951,42,0,621,299,322
2019,133951,42,1,18,12,6
2019,133951,42,2,40,17,23
2019,133951,42,3,128,50,78
2019,133951,42,4,384,194,190
2019,133951,42,5,34,17,17
2019,133951,42,6,17,9,8
2019,133951,44,0,26,13,13
2019,133951,44,1,8,5,3
2019,133951,44,2,6,3,3
2019,133951,44,3,8,2,6
2019,133951,44,4,4,3,1
2019,133951,50,0,6,1,5
2019,133960,0,0,26,11,15
2019,133960,10,0,26,11,15
2019,133960,10,1,10,5,5
2019,133960,10,2,10,3,7
2019,133960,10,3,5,2,3
2019,133960,10,4,1,1,0
2019,133960,20,0,7,1,6
2019,133960,20,1,5,1,4
2019,133960,20,2,2,0,2
2019,133960,30,0,19,10,9
2019,133960,30,1,5,4,1
2019,133960,30,2,8,3,5
2019,133960,30,3,5,2,3
2019,133960,30,4,1,1,0
2019,133979,0,0,68,41,27
2019,133979,10,0,68,41,27
2019,133979,10,1,7,4,3
2019,133979,10,2,32,20,12
2019,133979,10,3,21,11,10
2019,133979,10,4,8,6,2
2019,133979,20,0,26,16,10
2019,133979,20,1,7,4,3
2019,133979,20,2,19,12,7
2019,133979,30,0,34,19,15
2019,133979,30,2,13,8,5
2019,133979,30,3,21,11,10
2019,133979,40,0,8,6,2
2019,133979,40,4,8,6,2
2019,133979,42,0,8,6,2
2019,133979,42,4,8,6,2
2019,133997,0,0,6,2,4
2019,133997,50,0,6,2,4
2019,134079,0,0,158,80,78
2019,134079,10,0,158,80,78
2019,134079,10,1,20,15,5
2019,134079,10,2,50,25,25
2019,134079,10,3,72,33,39
2019,134079,10,4,16,7,9
2019,134079,20,0,42,23,19
2019,134079,20,1,14,10,4
2019,134079,20,2,28,13,15
2019,134079,30,0,61,32,29
2019,134079,30,2,9,4,5
2019,134079,30,3,51,27,24
2019,134079,30,4,1,1,0
2019,134079,40,0,55,25,30
2019,134079,40,1,6,5,1
2019,134079,40,2,13,8,5
2019,134079,40,3,21,6,15
2019,134079,40,4,15,6,9
2019,134079,41,0,43,21,22
2019,134079,41,1,6,5,1
2019,134079,41,2,12,8,4
2019,134079,41,3,14,4,10
2019,134079,41,4,11,4,7
2019,134079,42,0,12,4,8
2019,134079,42,2,1,0,1
2019,134079,42,3,7,2,5
2019,134079,42,4,4,2,2
2019,134079,44,0,1,1,0
2019,134079,44,1,1,1,0
2019,134079,45,0,42,20,22
2019,134079,45,1,5,4,1
2019,134079,45,2,12,8,4
2019,134079,45,3,14,4,10
2019,134079,45,4,11,4,7
2019,134097,0,0,1655,952,703
2019,134097,10,0,1622,932,690
2019,134097,10,1,516,368,148
2019,134097,10,2,355,212,143
2019,134097,10,3,368,187,181
2019,134097,10,6,383,165,218
2019,134097,20,0,821,553,268
2019,134097,20,1,501,362,139
2019,134097,20,2,320,191,129
2019,134097,30,0,351,187,164
2019,134097,30,1,2,1,1
2019,134097,30,2,18,11,7
2019,134097,30,3,331,175,156
2019,134097,40,0,450,192,258
2019,134097,40,1,13,5,8
2019,134097,40,2,17,10,7
2019,134097,40,3,37,12,25
2019,134097,40,6,383,165,218
2019,134097,42,0,450,192,258
2019,134097,42,1,13,5,8
2019,134097,42,2,17,10,7
2019,134097,42,3,37,12,25
2019,134097,42,6,383,165,218
2019,134097,50,0,33,20,13
2019,134112,0,0,13,5,8
2019,134112,10,0,13,5,8
2019,134112,10,4,13,5,8
2019,134112,40,0,13,5,8
2019,134112,40,4,13,5,8
2019,134112,41,0,13,5,8
2019,134112,41,4,13,5,8
2019,134112,45,0,13,5,8
2019,134112,45,4,13,5,8
2019,134130,0,0,2906,1787,1119
2019,134130,10,0,2906,1787,1119
2019,134130,10,1,1041,792,249
2019,134130,10,2,616,388,228
2019,134130,10,3,691,376,315
2019,134130,10,5,466,191,275
2019,134130,10,6,92,40,52
2019,134130,20,0,1525,1092,433
2019,134130,20,1,989,754,235
2019,134130,20,2,533,335,198
2019,134130,20,3,3,3,0
2019,134130,30,0,653,396,257
2019,134130,30,1,23,20,3
2019,134130,30,2,65,46,19
2019,134130,30,3,565,330,235
2019,134130,40,0,728,299,429
2019,134130,40,1,29,18,11
2019,134130,40,2,18,7,11
2019,134130,40,3,123,43,80
2019,134130,40,5,466,191,275
2019,134130,40,6,92,40,52
2019,134130,42,0,728,299,429
2019,134130,42,1,29,18,11
2019,134130,42,2,18,7,11
2019,134130,42,3,123,43,80
2019,134130,42,5,466,191,275
2019,134130,42,6,92,40,52
2019,134237,0,0,735,537,198
2019,134237,10,0,735,537,198
2019,134237,10,1,471,330,141
2019,134237,10,2,124,82,42
2019,134237,10,6,140,125,15
2019,134237,40,0,735,537,198
2019,134237,40,1,471,330,141
2019,134237,40,2,124,82,42
2019,134237,40,6,140,125,15
2019,134237,41,0,735,537,198
2019,134237,41,1,471,330,141
2019,134237,41,2,124,82,42
2019,134237,41,6,140,125,15
2019,134237,45,0,735,537,198
2019,134237,45,1,471,330,141
2019,134237,45,2,124,82,42
2019,134237,45,6,140,125,15
2019,134343,0,0,132,54,78
2019,134343,10,0,132,54,78
2019,134343,10,1,23,11,12
2019,134343,10,2,25,10,15
2019,134343,10,3,29,11,18
2019,134343,10,4,9,2,7
2019,134343,10,6,46,20,26
2019,134343,20,0,44,20,24
2019,134343,20,1,21,11,10
2019,134343,20,2,22,9,13
2019,134343,20,3,1,0,1
2019,134343,30,0,29,7,22
2019,134343,30,1,2,0,2
2019,134343,30,2,3,1,2
2019,134343,30,3,21,6,15
2019,134343,30,4,3,0,3
2019,134343,40,0,59,27,32
2019,134343,40,3,7,5,2
2019,134343,40,4,6,2,4
2019,134343,40,6,46,20,26
2019,134343,43,0,59,27,32
2019,134343,43,3,7,5,2
2019,134343,43,4,6,2,4
2019,134343,43,6,46,20,26
2019,134495,0,0,298,129,169
2019,134495,10,0,296,128,168
2019,134495,10,1,12,6,6
2019,134495,10,2,21,10,11
2019,134495,10,3,102,38,64
2019,134495,10,4,67,31,36
2019,134495,10,6,94,43,51
2019,134495,20,0,214,89,125
2019,134495,20,1,12,6,6
2019,134495,20,2,21,10,11
2019,134495,20,3,102,38,64
2019,134495,20,6,79,35,44
2019,134495,30,0,76,37,39
2019,134495,30,4,67,31,36
2019,134495,30,6,9,6,3
2019,134495,40,0,6,2,4
2019,134495,40,6,6,2,4
2019,134495,42,0,1,1,0
2019,134495,42,6,1,1,0
2019,134495,43,0,5,1,4
2019,134495,43,6,5,1,4
2019,134495,50,0,2,1,1
2019,134510,0,0,6,5,1
2019,134510,10,0,6,5,1
2019,134510,10,1,6,5,1
2019,134510,40,0,6,5,1
2019,134510,40,1,6,5,1
2019,134510,42,0,6,5,1
2019,134510,42,1,6,5,1
2019,134608,0,0,246,114,132
2019,134608,10,0,246,114,132
2019,134608,10,1,37,17,20
2019,134608,10,2,49,29,20
2019,134608,10,3,72,32,40
2019,134608,10,6,88,36,52
2019,134608,20,0,151,75,76
2019,134608,20,1,37,17,20
2019,134608,20,2,47,28,19
2019,134608,20,3,47,22,25
2019,134608,20,6,20,8,12
2019,134608,30,0,68,29,39
2019,134608,30,2,2,1,1
2019,134608,30,3,23,9,14
2019,134608,30,6,43,19,24
2019,134608,40,0,27,10,17
2019,134608,40,3,2,1,1
2019,134608,40,6,25,9,16
2019,134608,43,0,27,10,17
2019,134608,43,3,2,1,1
2019,134608,43,6,25,9,16
2019,134811,0,0,10,8,2
2019,134811,10,0,10,8,2
2019,134811,10,4,10,8,2
2019,134811,40,0,10,8,2
2019,134811,40,4,10,8,2
2019,134811,41,0,10,8,2
2019,134811,41,4,10,8,2
2019,134811,45,0,10,8,2
2019,134811,45,4,10,8,2
2019,134945,0,0,246,114,132
2019,134945,10,0,246,114,132
2019,134945,10,1,62,34,28
2019,134945,10,2,54,30,24
2019,134945,10,3,96,32,64
2019,134945,10,4,34,18,16
2019,134945,20,0,108,58,50
2019,134945,20,1,60,33,27
2019,134945,20,2,45,24,21
2019,134945,20,3,3,1,2
2019,134945,30,0,59,28,31
2019,134945,30,1,1,0,1
2019,134945,30,2,6,3,3
2019,134945,30,3,51,25,26
2019,134945,30,4,1,0,1
2019,134945,40,0,79,28,51
2019,134945,40,1,1,1,0
2019,134945,40,2,3,3,0
2019,134945,40,3,42,6,36
2019,134945,40,4,33,18,15
2019,134945,42,0,79,28,51
2019,134945,42,1,1,1,0
2019,134945,42,2,3,3,0
2019,134945,42,3,42,6,36
2019,134945,42,4,33,18,15
2019,135081,0,0,1253,467,786
2019,135081,10,0,1253,467,786
2019,135081,10,4,1253,467,786
2019,135081,40,0,1253,467,786
2019,135081,40,4,1253,467,786
2019,135081,41,0,1253,467,786
2019,135081,41,4,1253,467,786
2019,135081,45,0,1253,467,786
2019,135081,45,4,1253,467,786
2019,135160,0,0,64,26,38
2019,135160,10,0,64,26,38
2019,135160,10,6,64,26,38
2019,135160,20,0,27,12,15
2019,135160,20,6,27,12,15
2019,135160,30,0,24,8,16
2019,135160,30,6,24,8,16
2019,135160,40,0,13,6,7
2019,135160,40,6,13,6,7
2019,135160,42,0,13,6,7
2019,135160,42,6,13,6,7
2019,135188,0,0,80,31,49
2019,135188,10,0,80,31,49
2019,135188,10,1,3,0,3
2019,135188,10,2,5,2,3
2019,135188,10,3,13,4,9
2019,135188,10,4,54,22,32
2019,135188,10,6,5,3,2
2019,135188,20,0,33,11,22
2019,135188,20,1,3,0,3
2019,135188,20,2,5,2,3
2019,135188,20,3,8,2,6
2019,135188,20,4,17,7,10
2019,135188,30,0,41,18,23
2019,135188,30,3,5,2,3
2019,135188,30,4,31,13,18
2019,135188,30,6,5,3,2
2019,135188,40,0,6,2,4
2019,135188,40,4,6,2,4
2019,135188,43,0,6,2,4
2019,135188,43,4,6,2,4
2019,135364,0,0,15,14,1
2019,135364,10,0,15,14,1
2019,135364,10,1,5,5,0
2019,135364,10,2,5,4,1
2019,135364,10,3,5,5,0
2019,135364,40,0,15,14,1
2019,135364,40,1,5,5,0
2019,135364,40,2,5,4,1
2019,135364,40,3,5,5,0
2019,135364,42,0,15,14,1
2019,135364,42,1,5,5,0
2019,135364,42,2,5,4,1
2019,135364,42,3,5,5,0
2019,135391,0,0,135,55,80
2019,135391,10,0,135,55,80
2019,135391,10,1,42,23,19
2019,135391,10,2,32,9,23
2019,135391,10,3,25,10,15
2019,135391,10,4,17,10,7
2019,135391,10,5,5,3,2
2019,135391,10,6,14,0,14
2019,135391,20,0,81,36,45
2019,135391,20,1,42,23,19
2019,135391,20,2,26,8,18
2019,135391,20,3,10,5,5
2019,135391,20,4,3,0,3
2019,135391,30,0,22,9,13
2019,135391,30,2,6,1,5
2019,135391,30,3,8,3,5
2019,135391,30,4,8,5,3
2019,135391,40,0,32,10,22
2019,135391,40,3,7,2,5
2019,135391,40,4,6,5,1
2019,135391,40,5,5,3,2
2019,135391,40,6,14,0,14
2019,135391,42,0,32,10,22
2019,135391,42,3,7,2,5
2019,135391,42,4,6,5,1
2019,135391,42,5,5,3,2
2019,135391,42,6,14,0,14
2019,135717,0,0,708,344,364
2019,135717,10,0,708,344,364
2019,135717,10,1,178,87,91
2019,135717,10,2,267,131,136
2019,135717,10,3,161,74,87
2019,135717,10,4,102,52,50
2019,135717,20,0,537,266,271
2019,135717,20,1,164,82,82
2019,135717,20,2,261,130,131
2019,135717,20,3,102,48,54
2019,135717,20,4,10,6,4
2019,135717,30,0,171,78,93
2019,135717,30,1,14,5,9
2019,135717,30,2,6,1,5
2019,135717,30,3,59,26,33
2019,135717,30,4,92,46,46
2019,135726,0,0,1486,942,544
2019,135726,10,0,1486,942,544
2019,135726,10,1,589,451,138
2019,135726,10,2,345,213,132
2019,135726,10,3,243,129,114
2019,135726,10,5,309,149,160
2019,135726,20,0,825,595,230
2019,135726,20,1,558,427,131
2019,135726,20,2,267,168,99
2019,135726,30,0,193,114,79
2019,135726,30,1,8,6,2
2019,135726,30,2,28,18,10
2019,135726,30,3,157,90,67
2019,135726,40,0,468,233,235
2019,135726,40,1,23,18,5
2019,135726,40,2,50,27,23
2019,135726,40,3,86,39,47
2019,135726,40,5,309,149,160
2019,135726,41,0,67,30,37
2019,135726,41,5,67,30,37
2019,135726,42,0,401,203,198
2019,135726,42,1,23,18,5
2019,135726,42,2,50,27,23
2019,135726,42,3,86,39,47
2019,135726,42,5,242,119,123
2019,135726,44,0,67,30,37
2019,135726,44,5,67,30,37
2019,136145,0,0,29,14,15
2019,136145,10,0,29,14,15
2019,136145,10,6,29,14,15
2019,136145,20,0,14,10,4
2019,136145,20,6,14,10,4
2019,136145,30,0,2,0,2
2019,136145,30,6,2,0,2
2019,136145,40,0,13,4,9
2019,136145,40,6,13,4,9
2019,136145,43,0,13,4,9
2019,136145,43,6,13,4,9
2019,136172,0,0,520,266,254
2019,136172,10,0,520,266,254
2019,136172,10,1,93,58,35
2019,136172,10,2,167,91,76
2019,136172,10,3,109,46,63
2019,136172,10,4,120,52,68
2019,136172,10,5,28,17,11
2019,136172,10,6,3,2,1
2019,136172,20,0,258,149,109
2019,136172,20,1,93,58,35
2019,136172,20,2,165,91,74
2019,136172,30,0,100,43,57
2019,136172,30,2,1,0,1
2019,136172,30,3,99,43,56
2019,136172,40,0,162,74,88
2019,136172,40,2,1,0,1
2019,136172,40,3,10,3,7
2019,136172,40,4,120,52,68
2019,136172,40,5,28,17,11
2019,136172,40,6,3,2,1
2019,136172,42,0,162,74,88
2019,136172,42,2,1,0,1
2019,136172,42,3,10,3,7
2019,136172,42,4,120,52,68
2019,136172,42,5,28,17,11
2019,136172,42,6,3,2,1
2019,136215,0,0,830,374,456
2019,136215,10,0,830,374,456
2019,136215,10,1,198,112,86
2019,136215,10,2,265,121,144
2019,136215,10,3,329,130,199
2019,136215,10,4,35,11,24
2019,136215,10,5,3,0,3
2019,136215,20,0,29,16,13
2019,136215,20,1,28,15,13
2019,136215,20,2,1,1,0
2019,136215,40,0,801,358,443
2019,136215,40,1,170,97,73
2019,136215,40,2,264,120,144
2019,136215,40,3,329,130,199
2019,136215,40,4,35,11,24
2019,136215,40,5,3,0,3
2019,136215,41,0,390,190,200
2019,136215,41,1,140,84,56
2019,136215,41,2,196,86,110
2019,136215,41,3,54,20,34
2019,136215,42,0,411,168,243
2019,136215,42,1,30,13,17
2019,136215,42,2,68,34,34
2019,136215,42,3,275,110,165
2019,136215,42,4,35,11,24
2019,136215,42,5,3,0,3
2019,136215,44,0,390,190,200
2019,136215,44,1,140,84,56
2019,136215,44,2,196,86,110
2019,136215,44,3,54,20,34
2019,136233,0,0,86,35,51
2019,136233,10,0,86,35,51
2019,136233,10,1,44,24,20
2019,136233,10,3,17,6,11
2019,136233,10,6,25,5,20
2019,136233,20,0,45,25,20
2019,136233,20,1,44,24,20
2019,136233,20,3,1,1,0
2019,136233,30,0,10,2,8
2019,136233,30,3,10,2,8
2019,136233,40,0,31,8,23
2019,136233,40,3,6,3,3
2019,136233,40,6,25,5,20
2019,136233,42,0,31,8,23
2019,136233,42,3,6,3,3
2019,136233,42,6,25,5,20
2019,136330,0,0,178,97,81
2019,136330,10,0,178,97,81
2019,136330,10,1,51,38,13
2019,136330,10,2,62,32,30
2019,136330,10,3,58,25,33
2019,136330,10,4,7,2,5
2019,136330,40,0,178,97,81
2019,136330,40,1,51,38,13
2019,136330,40,2,62,32,30
2019,136330,40,3,58,25,33
2019,136330,40,4,7,2,5
2019,136330,42,0,178,97,81
2019,136330,42,1,51,38,13
2019,136330,42,2,62,32,30
2019,136330,42,3,58,25,33
2019,136330,42,4,7,2,5
2019,136358,0,0,356,154,202
2019,136358,10,0,356,154,202
2019,136358,10,1,58,26,32
2019,136358,10,2,42,19,23
2019,136358,10,3,89,37,52
2019,136358,10,4,167,72,95
2019,136358,20,0,163,71,92
2019,136358,20,1,47,21,26
2019,136358,20,2,16,6,10
2019,136358,20,3,33,17,16
2019,136358,20,4,67,27,40
2019,136358,30,0,154,66,88
2019,136358,30,1,10,4,6
2019,136358,30,2,26,13,13
2019,136358,30,3,54,20,34
2019,136358,30,4,64,29,35
2019,136358,40,0,39,17,22
2019,136358,40,1,1,1,0
2019,136358,40,3,2,0,2
2019,136358,40,4,36,16,20
2019,136358,42,0,39,17,22
2019,136358,42,1,1,1,0
2019,136358,42,3,2,0,2
2019,136358,42,4,36,16,20
2019,136400,0,0,160,58,102
2019,136400,10,0,160,58,102
2019,136400,10,1,34,14,20
2019,136400,10,2,33,12,21
2019,136400,10,3,36,11,25
2019,136400,10,4,51,17,34
2019,136400,10,6,6,4,2
2019,136400,20,0,91,31,60
2019,136400,20,1,30,12,18
2019,136400,20,2,31,10,21
2019,136400,20,3,26,9,17
2019,136400,20,4,4,0,4
2019,136400,30,0,63,23,40
2019,136400,30,1,4,2,2
2019,136400,30,2,2,2,0
2019,136400,30,3,10,2,8
2019,136400,30,4,47,17,30
2019,136400,40,0,6,4,2
2019,136400,40,6,6,4,2
2019,136400,42,0,6,4,2
2019,136400,42,6,6,4,2
2019,136473,0,0,169,73,96
2019,136473,10,0,169,73,96
2019,136473,10,1,45,22,23
2019,136473,10,2,28,9,19
2019,136473,10,3,27,15,12
2019,136473,10,4,57,23,34
2019,136473,10,5,12,4,8
2019,136473,20,0,93,43,50
2019,136473,20,1,45,22,23
2019,136473,20,2,27,8,19
2019,136473,20,3,15,9,6
2019,136473,20,4,6,4,2
2019,136473,30,0,68,27,41
2019,136473,30,2,1,1,0
2019,136473,30,3,12,6,6
2019,136473,30,4,51,19,32
2019,136473,30,5,4,1,3
2019,136473,40,0,8,3,5
2019,136473,40,5,8,3,5
2019,136473,42,0,8,3,5
2019,136473,42,5,8,3,5
2019,136516,0,0,159,72,87
2019,136516,10,0,159,72,87
2019,136516,10,6,159,72,87
2019,136516,20,0,116,51,65
2019,136516,20,6,116,51,65
2019,136516,30,0,43,21,22
2019,136516,30,6,43,21,22
2019,136701,0,0,13,10,3
2019,136701,10,0,13,10,3
2019,136701,10,1,7,6,1
2019,136701,10,2,1,0,1
2019,136701,10,3,5,4,1
2019,136701,40,0,13,10,3
2019,136701,40,1,7,6,1
2019,136701,40,2,1,0,1
2019,136701,40,3,5,4,1
2019,136701,42,0,13,10,3
2019,136701,42,1,7,6,1
2019,136701,42,2,1,0,1
2019,136701,42,3,5,4,1
2019,136774,0,0,120,84,36
2019,136774,10,0,120,84,36
2019,136774,10,6,120,84,36
2019,136774,40,0,120,84,36
2019,136774,40,6,120,84,36
2019,136774,42,0,120,84,36
2019,136774,42,6,120,84,36
2019,136950,0,0,225,108,117
2019,136950,10,0,225,108,117
2019,136950,10,1,75,41,34
2019,136950,10,2,52,27,25
2019,136950,10,3,62,25,37
2019,136950,10,4,1,0,1
2019,136950,10,5,35,15,20
2019,136950,20,0,118,64,54
2019,136950,20,1,73,40,33
2019,136950,20,2,45,24,21
2019,136950,30,0,58,24,34
2019,136950,30,1,1,0,1
2019,136950,30,2,7,3,4
2019,136950,30,3,50,21,29
2019,136950,40,0,49,20,29
2019,136950,40,1,1,1,0
2019,136950,40,3,12,4,8
2019,136950,40,4,1,0,1
2019,136950,40,5,35,15,20
2019,136950,41,0,49,20,29
2019,136950,41,1,1,1,0
2019,136950,41,3,12,4,8
2019,136950,41,4,1,0,1
2019,136950,41,5,35,15,20
2019,136950,44,0,14,5,9
2019,136950,44,1,1,1,0
2019,136950,44,3,12,4,8
2019,136950,44,4,1,0,1
2019,136950,45,0,35,15,20
2019,136950,45,5,35,15,20
2019,137032,0,0,161,86,75
2019,137032,10,0,161,86,75
2019,137032,10,1,26,16,10
2019,137032,10,2,56,35,21
2019,137032,10,3,56,29,27
2019,137032,10,4,23,6,17
2019,137032,20,0,72,44,28
2019,137032,20,1,23,14,9
2019,137032,20,2,41,27,14
2019,137032,20,3,8,3,5
2019,137032,30,0,51,24,27
2019,137032,30,1,1,0,1
2019,137032,30,2,14,7,7
2019,137032,30,3,36,17,19
2019,137032,40,0,38,18,20
2019,137032,40,1,2,2,0
2019,137032,40,2,1,1,0
2019,137032,40,3,12,9,3
2019,137032,40,4,23,6,17
2019,137032,42,0,38,18,20
2019,137032,42,1,2,2,0
2019,137032,42,2,1,1,0
2019,137032,42,3,12,9,3
2019,137032,42,4,23,6,17
2019,137078,0,0,340,144,196
2019,137078,10,0,340,144,196
2019,137078,10,6,340,144,196
2019,137078,20,0,266,121,145
2019,137078,20,6,266,121,145
2019,137078,30,0,74,23,51
2019,137078,30,6,74,23,51
2019,137096,0,0,244,106,138
2019,137096,10,0,244,106,138
2019,137096,10,6,244,106,138
2019,137096,20,0,160,69,91
2019,137096,20,6,160,69,91
2019,137096,30,0,84,37,47
2019,137096,30,6,84,37,47
2019,137209,0,0,214,82,132
2019,137209,10,0,214,82,132
2019,137209,10,6,214,82,132
2019,137209,20,0,144,54,90
2019,137209,20,6,144,54,90
2019,137209,30,0,70,28,42
2019,137209,30,6,70,28,42
2019,137272,0,0,6,4,2
2019,137272,10,0,6,4,2
2019,137272,10,1,6,4,2
2019,137272,40,0,6,4,2
2019,137272,40,1,6,4,2
2019,137272,41,0,6,4,2
2019,137272,41,1,6,4,2
2019,137272,44,0,6,4,2
2019,137272,44,1,6,4,2
2019,137281,0,0,139,70,69
2019,137281,10,0,137,68,69
2019,137281,10,1,24,11,13
2019,137281,10,4,55,31,24
2019,137281,10,6,58,26,32
2019,137281,20,0,53,30,23
2019,137281,20,1,24,11,13
2019,137281,20,4,27,17,10
2019,137281,20,6,2,2,0
2019,137281,30,0,23,10,13
2019,137281,30,4,22,10,12
2019,137281,30,6,1,0,1
2019,137281,40,0,61,28,33
2019,137281,40,4,6,4,2
2019,137281,40,6,55,24,31
2019,137281,42,0,61,28,33
2019,137281,42,4,6,4,2
2019,137281,42,6,55,24,31
2019,137281,50,0,2,2,0
2019,137315,0,0,66,20,46
2019,137315,10,0,66,20,46
2019,137315,10,4,66,20,46
2019,137315,20,0,43,18,25
2019,137315,20,4,43,18,25
2019,137315,30,0,22,1,21
2019,137315,30,4,22,1,21
2019,137315,40,0,1,1,0
2019,137315,40,4,1,1,0
2019,137315,42,0,1,1,0
2019,137315,42,4,1,1,0
2019,137351,0,0,1862,1008,854
2019,137351,10,0,1862,1008,854
2019,137351,10,1,445,327,118
2019,137351,10,2,480,266,214
2019,137351,10,3,476,224,252
2019,137351,10,4,399,161,238
2019,137351,10,6,62,30,32
2019,137351,20,0,702,458,244
2019,137351,20,1,379,278,101
2019,137351,20,2,321,179,142
2019,137351,20,3,1,1,0
2019,137351,20,4,1,0,1
2019,137351,30,0,258,145,113
2019,137351,30,1,18,15,3
2019,137351,30,2,55,33,22
2019,137351,30,3,181,94,87
2019,137351,30,4,4,3,1
2019,137351,40,0,902,405,497
2019,137351,40,1,48,34,14
2019,137351,40,2,104,54,50
2019,137351,40,3,294,129,165
2019,137351,40,4,394,158,236
2019,137351,40,6,62,30,32
2019,137351,42,0,880,394,486
2019,137351,42,1,48,34,14
2019,137351,42,2,104,54,50
2019,137351,42,3,294,129,165
2019,137351,42,4,394,158,236
2019,137351,42,6,40,19,21
2019,137351,43,0,22,11,11
2019,137351,43,6,22,11,11
2019,137476,0,0,90,44,46
2019,137476,10,0,90,44,46
2019,137476,10,1,41,26,15
2019,137476,10,2,24,9,15
2019,137476,10,3,14,4,10
2019,137476,10,4,1,1,0
2019,137476,10,5,1,1,0
2019,137476,10,6,9,3,6
2019,137476,20,0,19,13,6
2019,137476,20,1,19,13,6
2019,137476,30,0,1,0,1
2019,137476,30,1,1,0,1
2019,137476,40,0,70,31,39
2019,137476,40,1,21,13,8
2019,137476,40,2,24,9,15
2019,137476,40,3,14,4,10
2019,137476,40,4,1,1,0
2019,137476,40,5,1,1,0
2019,137476,40,6,9,3,6
2019,137476,42,0,70,31,39
2019,137476,42,1,21,13,8
2019,137476,42,2,24,9,15
2019,137476,42,3,14,4,10
2019,137476,42,4,1,1,0
2019,137476,42,5,1,1,0
2019,137476,42,6,9,3,6
2019,137546,0,0,270,133,137
2019,137546,10,0,270,133,137
2019,137546,10,1,106,59,47
2019,137546,10,2,59,32,27
2019,137546,10,3,58,27,31
2019,137546,10,6,47,15,32
2019,137546,20,0,160,88,72
2019,137546,20,1,103,57,46
2019,137546,20,2,57,31,26
2019,137546,30,0,54,25,29
2019,137546,30,2,2,1,1
2019,137546,30,3,52,24,28
2019,137546,40,0,56,20,36
2019,137546,40,1,3,2,1
2019,137546,40,3,6,3,3
2019,137546,40,6,47,15,32
2019,137546,43,0,56,20,36
2019,137546,43,1,3,2,1
2019,137546,43,3,6,3,3
2019,137546,43,6,47,15,32
2019,137564,0,0,142,79,63
2019,137564,10,0,142,79,63
2019,137564,10,1,45,32,13
2019,137564,10,2,47,24,23
2019,137564,10,3,38,20,18
2019,137564,10,4,6,0,6
2019,137564,10,5,6,3,3
2019,137564,40,0,142,79,63
2019,137564,40,1,45,32,13
2019,137564,40,2,47,24,23
2019,137564,40,3,38,20,18
2019,137564,40,4,6,0,6
2019,137564,40,5,6,3,3
2019,137564,41,0,70,46,24
2019,137564,41,1,41,29,12
2019,137564,41,2,29,17,12
2019,137564,42,0,72,33,39
2019,137564,42,1,4,3,1
2019,137564,42,2,18,7,11
2019,137564,42,3,38,20,18
2019,137564,42,4,6,0,6
2019,137564,42,5,6,3,3
2019,137564,44,0,70,46,24
2019,137564,44,1,41,29,12
2019,137564,44,2,29,17,12
2019,137759,0,0,181,74,107
2019,137759,10,0,181,74,107
2019,137759,10,1,82,34,48
2019,137759,10,2,51,20,31
2019,137759,10,3,29,9,20
2019,137759,10,6,19,11,8
2019,137759,20,0,124,53,71
2019,137759,20,1,82,34,48
2019,137759,20,2,42,19,23
2019,137759,30,0,5,1,4
2019,137759,30,2,1,0,1
2019,137759,30,6,4,1,3
2019,137759,40,0,52,20,32
2019,137759,40,2,8,1,7
2019,137759,40,3,29,9,20
2019,137759,40,6,15,10,5
2019,137759,42,0,52,20,32
2019,137759,42,2,8,1,7
2019,137759,42,3,29,9,20
2019,137759,42,6,15,10,5
2019,137777,0,0,9,9,0
2019,137777,10,0,7,7,0
2019,137777,10,1,6,6,0
2019,137777,10,2,1,1,0
2019,137777,40,0,7,7,0
2019,137777,40,1,6,6,0
2019,137777,40,2,1,1,0
2019,137777,41,0,7,7,0
2019,137777,41,1,6,6,0
2019,137777,41,2,1,1,0
2019,137777,45,0,7,7,0
2019,137777,45,1,6,6,0
2019,137777,45,2,1,1,0
2019,137777,50,0,2,2,0
2019,137801,0,0,11,8,3
2019,137801,10,0,11,8,3
2019,137801,10,4,11,8,3
2019,137801,40,0,11,8,3
2019,137801,40,4,11,8,3
2019,137801,41,0,11,8,3
2019,137801,41,4,11,8,3
2019,137801,45,0,11,8,3
2019,137801,45,4,11,8,3
2019,137847,0,0,368,193,175
2019,137847,10,0,368,193,175
2019,137847,10,1,52,31,21
2019,137847,10,2,135,80,55
2019,137847,10,3,158,72,86
2019,137847,10,4,6,4,2
2019,137847,10,5,17,6,11
2019,137847,20,0,156,99,57
2019,137847,20,1,43,29,14
2019,137847,20,2,111,69,42
2019,137847,20,3,2,1,1
2019,137847,30,0,131,73,58
2019,137847,30,2,22,10,12
2019,137847,30,3,109,63,46
2019,137847,40,0,81,21,60
2019,137847,40,1,9,2,7
2019,137847,40,2,2,1,1
2019,137847,40,3,47,8,39
2019,137847,40,4,6,4,2
2019,137847,40,5,17,6,11
2019,137847,42,0,81,21,60
2019,137847,42,1,9,2,7
2019,137847,42,2,2,1,1
2019,137847,42,3,47,8,39
2019,137847,42,4,6,4,2
2019,137847,42,5,17,6,11
2019,137953,0,0,14,10,4
2019,137953,10,0,14,10,4
2019,137953,10,1,6,5,1
2019,137953,10,2,5,3,2
2019,137953,10,3,3,2,1
2019,137953,40,0,14,10,4
2019,137953,40,1,6,5,1
2019,137953,40,2,5,3,2
2019,137953,40,3,3,2,1
2019,137953,42,0,14,10,4
2019,137953,42,1,6,5,1
2019,137953,42,2,5,3,2
2019,137953,42,3,3,2,1
2019,137962,0,0,9,4,5
2019,137962,10,0,9,4,5
2019,137962,10,1,9,4,5
2019,137962,40,0,9,4,5
2019,137962,40,1,9,4,5
2019,137962,42,0,9,4,5
2019,137962,42,1,9,4,5
2019,138187,0,0,619,267,352
2019,138187,10,0,619,267,352
2019,138187,10,6,619,267,352
2019,138187,20,0,316,142,174
2019,138187,20,6,316,142,174
2019,138187,30,0,151,53,98
2019,138187,30,6,151,53,98
2019,138187,40,0,152,72,80
2019,138187,40,6,152,72,80
2019,138187,42,0,98,52,46
2019,138187,42,6,98,52,46
2019,138187,43,0,54,20,34
2019,138187,43,6,54,20,34
2019,138275,0,0,38,24,14
2019,138275,10,0,38,24,14
2019,138275,10,1,7,4,3
2019,138275,10,2,15,7,8
2019,138275,10,3,11,10,1
2019,138275,10,4,5,3,2
2019,138275,40,0,38,24,14
2019,138275,40,1,7,4,3
2019,138275,40,2,15,7,8
2019,138275,40,3,11,10,1
2019,138275,40,4,5,3,2
2019,138275,42,0,38,24,14
2019,138275,42,1,7,4,3
2019,138275,42,2,15,7,8
2019,138275,42,3,11,10,1
2019,138275,42,4,5,3,2
2019,138293,0,0,23,10,13
2019,138293,10,0,23,10,13
2019,138293,10,1,4,2,2
2019,138293,10,2,5,4,1
2019,138293,10,3,9,2,7
2019,138293,10,4,5,2,3
2019,138293,40,0,23,10,13
2019,138293,40,1,4,2,2
2019,138293,40,2,5,4,1
2019,138293,40,3,9,2,7
2019,138293,40,4,5,2,3
2019,138293,42,0,23,10,13
2019,138293,42,1,4,2,2
2019,138293,42,2,5,4,1
2019,138293,42,3,9,2,7
2019,138293,42,4,5,2,3
2019,138309,0,0,129,24,105
2019,138309,10,0,129,24,105
2019,138309,10,4,129,24,105
2019,138309,40,0,129,24,105
2019,138309,40,4,129,24,105
2019,138309,41,0,129,24,105
2019,138309,41,4,129,24,105
2019,138309,45,0,129,24,105
2019,138309,45,4,129,24,105
2019,138354,0,0,352,189,163
2019,138354,10,0,352,189,163
2019,138354,10,1,84,58,26
2019,138354,10,2,67,37,30
2019,138354,10,3,110,57,53
2019,138354,10,4,57,22,35
2019,138354,10,5,34,15,19
2019,138354,20,0,151,93,58
2019,138354,20,1,82,56,26
2019,138354,20,2,65,35,30
2019,138354,20,3,4,2,2
2019,138354,30,0,75,46,29
2019,138354,30,2,2,2,0
2019,138354,30,3,73,44,29
2019,138354,40,0,126,50,76
2019,138354,40,1,2,2,0
2019,138354,40,3,33,11,22
2019,138354,40,4,57,22,35
2019,138354,40,5,34,15,19
2019,138354,41,0,41,15,26
2019,138354,41,1,1,1,0
2019,138354,41,3,2,1,1
2019,138354,41,4,27,7,20
2019,138354,41,5,11,6,5
2019,138354,42,0,12,4,8
2019,138354,42,3,4,1,3
2019,138354,42,4,5,2,3
2019,138354,42,5,3,1,2
2019,138354,43,0,73,31,42
2019,138354,43,1,1,1,0
2019,138354,43,3,27,9,18
2019,138354,43,4,25,13,12
2019,138354,43,5,20,8,12
2019,138354,44,0,41,15,26
2019,138354,44,1,1,1,0
2019,138354,44,3,2,1,1
2019,138354,44,4,27,7,20
2019,138354,44,5,11,6,5
2019,138558,0,0,149,77,72
2019,138558,10,0,149,77,72
2019,138558,10,1,28,16,12
2019,138558,10,2,34,17,17
2019,138558,10,3,59,32,27
2019,138558,10,4,6,3,3
2019,138558,10,5,21,9,12
2019,138558,10,6,1,0,1
2019,138558,20,0,76,40,36
2019,138558,20,1,28,16,12
2019,138558,20,2,31,16,15
2019,138558,20,3,17,8,9
2019,138558,30,0,46,25,21
2019,138558,30,2,3,1,2
2019,138558,30,3,42,24,18
2019,138558,30,4,1,0,1
2019,138558,40,0,27,12,15
2019,138558,40,4,5,3,2
2019,138558,40,5,21,9,12
2019,138558,40,6,1,0,1
2019,138558,41,0,2,2,0
2019,138558,41,5,2,2,0
2019,138558,42,0,25,10,15
2019,138558,42,4,5,3,2
2019,138558,42,5,19,7,12
2019,138558,42,6,1,0,1
2019,138558,45,0,2,2,0
2019,138558,45,5,2,2,0
2019,138600,0,0,95,28,67
2019,138600,10,0,95,28,67
2019,138600,10,1,39,16,23
2019,138600,10,2,23,6,17
2019,138600,10,3,15,2,13
2019,138600,10,4,17,4,13
2019,138600,10,6,1,0,1
2019,138600,20,0,60,21,39
2019,138600,20,1,39,16,23
2019,138600,20,2,21,5,16
2019,138600,30,0,17,3,14
2019,138600,30,2,2,1,1
2019,138600,30,3,15,2,13
2019,138600,40,0,18,4,14
2019,138600,40,4,17,4,13
2019,138600,40,6,1,0,1
2019,138600,42,0,18,4,14
2019,138600,42,4,17,4,13
2019,138600,42,6,1,0,1
2019,138655,0,0,5,4,1
2019,138655,10,0,5,4,1
2019,138655,10,4,5,4,1
2019,138655,40,0,5,4,1
2019,138655,40,4,5,4,1
2019,138655,41,0,5,4,1
2019,138655,41,4,5,4,1
2019,138655,45,0,5,4,1
2019,138655,45,4,5,4,1
2019,138682,0,0,92,34,58
2019,138682,10,0,79,30,49
2019,138682,10,4,79,30,49
2019,138682,40,0,79,30,49
2019,138682,40,4,79,30,49
2019,138682,42,0,65,24,41
2019,138682,42,4,65,24,41
2019,138682,43,0,14,6,8
2019,138682,43,4,14,6,8
2019,138682,50,0,13,4,9
2019,138716,0,0,196,94,102
2019,138716,10,0,196,94,102
2019,138716,10,1,44,29,15
2019,138716,10,2,57,32,25
2019,138716,10,3,60,21,39
2019,138716,10,4,34,11,23
2019,138716,10,5,1,1,0
2019,138716,20,0,94,58,36
2019,138716,20,1,44,29,15
2019,138716,20,2,44,24,20
2019,138716,20,3,6,5,1
2019,138716,30,0,40,19,21
2019,138716,30,2,11,7,4
2019,138716,30,3,29,12,17
2019,138716,40,0,62,17,45
2019,138716,40,2,2,1,1
2019,138716,40,3,25,4,21
2019,138716,40,4,34,11,23
2019,138716,40,5,1,1,0
2019,138716,42,0,62,17,45
2019,138716,42,2,2,1,1
2019,138716,42,3,25,4,21
2019,138716,42,4,34,11,23
2019,138716,42,5,1,1,0
2019,138761,0,0,26,12,14
2019,138761,10,0,26,12,14
2019,138761,10,1,1,0,1
2019,138761,10,2,3,3,0
2019,138761,10,3,21,9,12
2019,138761,10,6,1,0,1
2019,138761,20,0,2,0,2
2019,138761,20,1,1,0,1
2019,138761,20,3,1,0,1
2019,138761,30,0,13,7,6
2019,138761,30,2,3,3,0
2019,138761,30,3,10,4,6
2019,138761,40,0,11,5,6
2019,138761,40,3,10,5,5
2019,138761,40,6,1,0,1
2019,138761,42,0,4,1,3
2019,138761,42,3,3,1,2
2019,138761,42,6,1,0,1
2019,138761,43,0,7,4,3
2019,138761,43,3,7,4,3
2019,138813,0,0,11,7,4
2019,138813,10,0,11,7,4
2019,138813,10,4,11,7,4
2019,138813,40,0,11,7,4
2019,138813,40,4,11,7,4
2019,138813,41,0,11,7,4
2019,138813,41,4,11,7,4
2019,138813,45,0,11,7,4
2019,138813,45,4,11,7,4
2019,138840,0,0,107,45,62
2019,138840,10,0,107,45,62
2019,138840,10,4,107,45,62
2019,138840,40,0,107,45,62
2019,138840,40,4,107,45,62
2019,138840,41,0,104,43,61
2019,138840,41,4,104,43,61
2019,138840,42,0,3,2,1
2019,138840,42,4,3,2,1
2019,138840,45,0,104,43,61
2019,138840,45,4,104,43,61
2019,138868,0,0,47,20,27
2019,138868,10,0,47,20,27
2019,138868,10,1,19,10,9
2019,138868,10,2,7,1,6
2019,138868,10,3,3,2,1
2019,138868,10,4,18,7,11
2019,138868,40,0,47,20,27
2019,138868,40,1,19,10,9
2019,138868,40,2,7,1,6
2019,138868,40,3,3,2,1
2019,138868,40,4,18,7,11
2019,138868,42,0,47,20,27
2019,138868,42,1,19,10,9
2019,138868,42,2,7,1,6
2019,138868,42,3,3,2,1
2019,138868,42,4,18,7,11
2019,138901,0,0,54,29,25
2019,138901,10,0,54,29,25
2019,138901,10,1,6,3,3
2019,138901,10,2,13,9,4
2019,138901,10,3,13,7,6
2019,138901,10,4,12,6,6
2019,138901,10,5,6,2,4
2019,138901,10,6,4,2,2
2019,138901,20,0,19,11,8
2019,138901,20,1,6,3,3
2019,138901,20,2,12,8,4
2019,138901,20,3,1,0,1
2019,138901,30,0,8,5,3
2019,138901,30,2,1,1,0
2019,138901,30,3,7,4,3
2019,138901,40,0,27,13,14
2019,138901,40,3,5,3,2
2019,138901,40,4,12,6,6
2019,138901,40,5,6,2,4
2019,138901,40,6,4,2,2
2019,138901,42,0,27,13,14
2019,138901,42,3,5,3,2
2019,138901,42,4,12,6,6
2019,138901,42,5,6,2,4
2019,138901,42,6,4,2,2
2019,138929,0,0,18,10,8
2019,138929,10,0,16,9,7
2019,138929,10,1,6,5,1
2019,138929,10,2,10,4,6
2019,138929,20,0,15,8,7
2019,138929,20,1,6,5,1
2019,138929,20,2,9,3,6
2019,138929,40,0,1,1,0
2019,138929,40,2,1,1,0
2019,138929,42,0,1,1,0
2019,138929,42,2,1,1,0
2019,138929,50,0,2,1,1
2019,138947,0,0,181,98,83
2019,138947,10,0,181,98,83
2019,138947,10,1,46,38,8
2019,138947,10,2,78,44,34
2019,138947,10,3,29,7,22
2019,138947,10,4,10,4,6
2019,138947,10,5,12,4,8
2019,138947,10,6,6,1,5
2019,138947,20,0,117,77,40
2019,138947,20,1,46,38,8
2019,138947,20,2,66,38,28
2019,138947,20,3,5,1,4
2019,138947,30,0,34,11,23
2019,138947,30,2,11,5,6
2019,138947,30,3,22,6,16
2019,138947,30,5,1,0,1
2019,138947,40,0,30,10,20
2019,138947,40,2,1,1,0
2019,138947,40,3,2,0,2
2019,138947,40,4,10,4,6
2019,138947,40,5,11,4,7
2019,138947,40,6,6,1,5
2019,138947,42,0,1,0,1
2019,138947,42,5,1,0,1
2019,138947,43,0,29,10,19
2019,138947,43,2,1,1,0
2019,138947,43,3,2,0,2
2019,138947,43,4,10,4,6
2019,138947,43,5,10,4,6
2019,138947,43,6,6,1,5
2019,138956,0,0,126,57,69
2019,138956,10,0,126,57,69
2019,138956,10,6,126,57,69
2019,138956,40,0,126,57,69
2019,138956,40,6,126,57,69
2019,138956,42,0,126,57,69
2019,138956,42,6,126,57,69
2019,139144,0,0,163,87,76
2019,139144,10,0,163,87,76
2019,139144,10,1,41,28,13
2019,139144,10,2,47,28,19
2019,139144,10,3,55,25,30
2019,139144,10,4,9,4,5
2019,139144,10,5,11,2,9
2019,139144,20,0,87,55,32
2019,139144,20,1,41,28,13
2019,139144,20,2,45,26,19
2019,139144,20,3,1,1,0
2019,139144,30,0,36,15,21
2019,139144,30,3,36,15,21
2019,139144,40,0,40,17,23
2019,139144,40,2,2,2,0
2019,139144,40,3,18,9,9
2019,139144,40,4,9,4,5
2019,139144,40,5,11,2,9
2019,139144,43,0,40,17,23
2019,139144,43,2,2,2,0
2019,139144,43,3,18,9,9
2019,139144,43,4,9,4,5
2019,139144,43,5,11,2,9
2019,139153,0,0,8,5,3
2019,139153,10,0,8,5,3
2019,139153,10,2,1,1,0
2019,139153,10,3,7,4,3
2019,139153,40,0,8,5,3
2019,139153,40,2,1,1,0
2019,139153,40,3,7,4,3
2019,139153,41,0,8,5,3
2019,139153,41,2,1,1,0
2019,139153,41,3,7,4,3
2019,139153,45,0,8,5,3
2019,139153,45,2,1,1,0
2019,139153,45,3,7,4,3
2019,139199,0,0,144,39,105
2019,139199,10,0,144,39,105
2019,139199,10,1,22,7,15
2019,139199,10,2,43,12,31
2019,139199,10,3,67,19,48
2019,139199,10,4,12,1,11
2019,139199,40,0,144,39,105
2019,139199,40,1,22,7,15
2019,139199,40,2,43,12,31
2019,139199,40,3,67,19,48
2019,139199,40,4,12,1,11
2019,139199,41,0,80,23,57
2019,139199,41,1,22,7,15
2019,139199,41,2,33,9,24
2019,139199,41,3,24,7,17
2019,139199,41,4,1,0,1
2019,139199,42,0,54,14,40
2019,139199,42,2,9,3,6
2019,139199,42,3,42,11,31
2019,139199,42,4,3,0,3
2019,139199,43,0,10,2,8
2019,139199,43,2,1,0,1
2019,139199,43,3,1,1,0
2019,139199,43,4,8,1,7
2019,139199,44,0,80,23,57
2019,139199,44,1,22,7,15
2019,139199,44,2,33,9,24
2019,139199,44,3,24,7,17
2019,139199,44,4,1,0,1
2019,139205,0,0,20,13,7
2019,139205,10,0,20,13,7
2019,139205,10,1,2,1,1
2019,139205,10,2,7,4,3
2019,139205,10,3,11,8,3
2019,139205,40,0,20,13,7
2019,139205,40,1,2,1,1
2019,139205,40,2,7,4,3
2019,139205,40,3,11,8,3
2019,139205,41,0,1,1,0
2019,139205,41,1,1,1,0
2019,139205,42,0,19,12,7
2019,139205,42,1,1,0,1
2019,139205,42,2,7,4,3
2019,139205,42,3,11,8,3
2019,139205,44,0,1,1,0
2019,139205,44,1,1,1,0
2019,139214,0,0,5,3,2
2019,139214,10,0,5,3,2
2019,139214,10,4,5,3,2
2019,139214,40,0,5,3,2
2019,139214,40,4,5,3,2
2019,139214,41,0,5,3,2
2019,139214,41,4,5,3,2
2019,139214,44,0,5,3,2
2019,139214,44,4,5,3,2
2019,139250,0,0,110,47,63
2019,139250,10,0,110,47,63
2019,139250,10,1,8,5,3
2019,139250,10,2,33,14,19
2019,139250,10,3,45,18,27
2019,139250,10,4,7,3,4
2019,139250,10,5,16,6,10
2019,139250,10,6,1,1,0
2019,139250,20,0,32,15,17
2019,139250,20,1,6,4,2
2019,139250,20,2,25,10,15
2019,139250,20,3,1,1,0
2019,139250,30,0,46,18,28
2019,139250,30,1,1,0,1
2019,139250,30,2,5,3,2
2019,139250,30,3,40,15,25
2019,139250,40,0,32,14,18
2019,139250,40,1,1,1,0
2019,139250,40,2,3,1,2
2019,139250,40,3,4,2,2
2019,139250,40,4,7,3,4
2019,139250,40,5,16,6,10
2019,139250,40,6,1,1,0
2019,139250,42,0,32,14,18
2019,139250,42,1,1,1,0
2019,139250,42,2,3,1,2
2019,139250,42,3,4,2,2
2019,139250,42,4,7,3,4
2019,139250,42,5,16,6,10
2019,139250,42,6,1,1,0
2019,139278,0,0,144,52,92
2019,139278,10,0,144,52,92
2019,139278,10,4,144,52,92
2019,139278,40,0,144,52,92
2019,139278,40,4,144,52,92
2019,139278,42,0,129,50,79
2019,139278,42,4,129,50,79
2019,139278,43,0,15,2,13
2019,139278,43,4,15,2,13
2019,139311,0,0,208,102,106
2019,139311,10,0,208,102,106
2019,139311,10,1,59,34,25
2019,139311,10,2,61,31,30
2019,139311,10,3,36,15,21
2019,139311,10,4,8,0,8
2019,139311,10,5,44,22,22
2019,139311,20,0,113,61,52
2019,139311,20,1,57,32,25
2019,139311,20,2,56,29,27
2019,139311,30,0,37,17,20
2019,139311,30,2,5,2,3
2019,139311,30,3,32,15,17
2019,139311,40,0,58,24,34
2019,139311,40,1,2,2,0
2019,139311,40,3,4,0,4
2019,139311,40,4,8,0,8
2019,139311,40,5,44,22,22
2019,139311,42,0,58,24,34
2019,139311,42,1,2,2,0
2019,139311,42,3,4,0,4
2019,139311,42,4,8,0,8
2019,139311,42,5,44,22,22
2019,139348,0,0,23,12,11
2019,139348,10,0,23,12,11
2019,139348,10,1,8,2,6
2019,139348,10,2,7,5,2
2019,139348,10,3,7,4,3
2019,139348,10,5,1,1,0
2019,139348,20,0,15,7,8
2019,139348,20,1,8,2,6
2019,139348,20,2,7,5,2
2019,139348,30,0,6,4,2
2019,139348,30,3,6,4,2
2019,139348,40,0,2,1,1
2019,139348,40,3,1,0,1
2019,139348,40,5,1,1,0
2019,139348,41,0,2,1,1
2019,139348,41,3,1,0,1
2019,139348,41,5,1,1,0
2019,139348,44,0,2,1,1
2019,139348,44,3,1,0,1
2019,139348,44,5,1,1,0
2019,139357,0,0,87,30,57
2019,139357,10,0,87,30,57
2019,139357,10,4,87,30,57
2019,139357,40,0,87,30,57
2019,139357,40,4,87,30,57
2019,139357,41,0,87,30,57
2019,139357,41,4,87,30,57
2019,139357,45,0,87,30,57
2019,139357,45,4,87,30,57
2019,139366,0,0,324,171,153
2019,139366,10,0,323,170,153
2019,139366,10,1,96,62,34
2019,139366,10,2,73,42,31
2019,139366,10,3,92,44,48
2019,139366,10,4,28,7,21
2019,139366,10,5,34,15,19
2019,139366,20,0,162,100,62
2019,139366,20,1,95,61,34
2019,139366,20,2,65,38,27
2019,139366,20,3,2,1,1
2019,139366,30,0,83,40,43
2019,139366,30,1,1,1,0
2019,139366,30,2,5,3,2
2019,139366,30,3,77,36,41
2019,139366,40,0,78,30,48
2019,139366,40,2,3,1,2
2019,139366,40,3,13,7,6
2019,139366,40,4,28,7,21
2019,139366,40,5,34,15,19
2019,139366,41,0,3,1,2
2019,139366,41,2,1,1,0
2019,139366,41,4,1,0,1
2019,139366,41,5,1,0,1
2019,139366,42,0,75,29,46
2019,139366,42,2,2,0,2
2019,139366,42,3,13,7,6
2019,139366,42,4,27,7,20
2019,139366,42,5,33,15,18
2019,139366,45,0,3,1,2
2019,139366,45,2,1,1,0
2019,139366,45,4,1,0,1
2019,139366,45,5,1,0,1
2019,139366,50,0,1,1,0
2019,139384,0,0,114,49,65
2019,139384,50,0,114,49,65
2019,139393,0,0,62,47,15
2019,139393,10,0,62,47,15
2019,139393,10,1,35,31,4
2019,139393,10,2,12,8,4
2019,139393,10,3,14,7,7
2019,139393,10,4,1,1,0
2019,139393,20,0,34,28,6
2019,139393,20,1,29,25,4
2019,139393,20,2,5,3,2
2019,139393,30,0,27,18,9
2019,139393,30,1,6,6,0
2019,139393,30,2,7,5,2
2019,139393,30,3,14,7,7
2019,139393,40,0,1,1,0
2019,139393,40,4,1,1,0
2019,139393,42,0,1,1,0
2019,139393,42,4,1,1,0
2019,139463,0,0,166,76,90
2019,139463,10,0,166,76,90
2019,139463,10,1,27,16,11
2019,139463,10,2,61,26,35
2019,139463,10,3,48,22,26
2019,139463,10,4,7,2,5
2019,139463,10,5,21,9,12
2019,139463,10,6,2,1,1
2019,139463,20,0,87,40,47
2019,139463,20,1,26,16,10
2019,139463,20,2,57,24,33
2019,139463,20,3,4,0,4
2019,139463,30,0,48,24,24
2019,139463,30,1,1,0,1
2019,139463,30,2,4,2,2
2019,139463,30,3,42,21,21
2019,139463,30,5,1,1,0
2019,139463,40,0,31,12,19
2019,139463,40,3,2,1,1
2019,139463,40,4,7,2,5
2019,139463,40,5,20,8,12
2019,139463,40,6,2,1,1
2019,139463,41,0,2,0,2
2019,139463,41,4,1,0,1
2019,139463,41,5,1,0,1
2019,139463,42,0,29,12,17
2019,139463,42,3,2,1,1
2019,139463,42,4,6,2,4
2019,139463,42,5,19,8,11
2019,139463,42,6,2,1,1
2019,139463,45,0,2,0,2
2019,139463,45,4,1,0,1
2019,139463,45,5,1,0,1
2019,139579,0,0,31,13,18
2019,139579,10,0,31,13,18
2019,139579,10,1,3,3,0
2019,139579,10,2,4,1,3
2019,139579,10,3,19,8,11
2019,139579,10,4,5,1,4
2019,139579,40,0,31,13,18
2019,139579,40,1,3,3,0
2019,139579,40,2,4,1,3
2019,139579,40,3,19,8,11
2019,139579,40,4,5,1,4
2019,139579,41,0,31,13,18
2019,139579,41,1,3,3,0
2019,139579,41,2,4,1,3
2019,139579,41,3,19,8,11
2019,139579,41,4,5,1,4
2019,139579,45,0,31,13,18
2019,139579,45,1,3,3,0
2019,139579,45,2,4,1,3
2019,139579,45,3,19,8,11
2019,139579,45,4,5,1,4
2019,139621,0,0,77,43,34
2019,139621,10,0,77,43,34
2019,139621,10,1,12,8,4
2019,139621,10,2,29,13,16
2019,139621,10,3,27,17,10
2019,139621,10,4,9,5,4
2019,139621,20,0,44,24,20
2019,139621,20,1,12,8,4
2019,139621,20,2,28,12,16
2019,139621,20,3,4,4,0
2019,139621,30,0,23,14,9
2019,139621,30,2,1,1,0
2019,139621,30,3,21,12,9
2019,139621,30,4,1,1,0
2019,139621,40,0,10,5,5
2019,139621,40,3,2,1,1
2019,139621,40,4,8,4,4
2019,139621,42,0,10,5,5
2019,139621,42,3,2,1,1
2019,139621,42,4,8,4,4
2019,139630,0,0,48,29,19
2019,139630,10,0,48,29,19
2019,139630,10,1,16,9,7
2019,139630,10,2,12,6,6
2019,139630,10,3,18,12,6
2019,139630,10,4,2,2,0
2019,139630,40,0,48,29,19
2019,139630,40,1,16,9,7
2019,139630,40,2,12,6,6
2019,139630,40,3,18,12,6
2019,139630,40,4,2,2,0
2019,139630,42,0,48,29,19
2019,139630,42,1,16,9,7
2019,139630,42,2,12,6,6
2019,139630,42,3,18,12,6
2019,139630,42,4,2,2,0
2019,139658,0,0,2191,1295,896
2019,139658,10,0,2180,1292,888
2019,139658,10,1,711,501,210
2019,139658,10,2,532,318,214
2019,139658,10,3,665,353,312
2019,139658,10,4,148,68,80
2019,139658,10,5,124,52,72
2019,139658,20,0,745,504,241
2019,139658,20,1,498,360,138
2019,139658,20,2,247,144,103
2019,139658,30,0,243,126,117
2019,139658,30,1,6,3,3
2019,139658,30,2,15,6,9
2019,139658,30,3,222,117,105
2019,139658,40,0,1192,662,530
2019,139658,40,1,207,138,69
2019,139658,40,2,270,168,102
2019,139658,40,3,443,236,207
2019,139658,40,4,148,68,80
2019,139658,40,5,124,52,72
2019,139658,41,0,196,92,104
2019,139658,41,1,48,26,22
2019,139658,41,2,19,12,7
2019,139658,41,3,8,4,4
2019,139658,41,4,3,2,1
2019,139658,41,5,118,48,70
2019,139658,42,0,987,565,422
2019,139658,42,1,157,110,47
2019,139658,42,2,251,156,95
2019,139658,42,3,431,230,201
2019,139658,42,4,143,66,77
2019,139658,42,5,5,3,2
2019,139658,43,0,9,5,4
2019,139658,43,1,2,2,0
2019,139658,43,3,4,2,2
2019,139658,43,4,2,0,2
2019,139658,43,5,1,1,0
2019,139658,44,0,196,92,104
2019,139658,44,1,48,26,22
2019,139658,44,2,19,12,7
2019,139658,44,3,8,4,4
2019,139658,44,4,3,2,1
2019,139658,44,5,118,48,70
2019,139658,50,0,11,3,8
2019,139700,0,0,140,61,79
2019,139700,10,0,140,61,79
2019,139700,10,1,28,14,14
2019,139700,10,2,37,20,17
2019,139700,10,3,41,13,28
2019,139700,10,4,34,14,20
2019,139700,20,0,73,38,35
2019,139700,20,1,28,14,14
2019,139700,20,2,37,20,17
2019,139700,20,3,8,4,4
2019,139700,30,0,29,7,22
2019,139700,30,3,29,7,22
2019,139700,40,0,38,16,22
2019,139700,40,3,4,2,2
2019,139700,40,4,34,14,20
2019,139700,41,0,1,0,1
2019,139700,41,4,1,0,1
2019,139700,42,0,37,16,21
2019,139700,42,3,4,2,2
2019,139700,42,4,33,14,19
2019,139700,45,0,1,0,1
2019,139700,45,4,1,0,1
2019,139719,0,0,102,59,43
2019,139719,10,0,102,59,43
2019,139719,10,1,28,25,3
2019,139719,10,2,25,12,13
2019,139719,10,3,36,17,19
2019,139719,10,4,2,0,2
2019,139719,10,5,8,3,5
2019,139719,10,6,3,2,1
2019,139719,20,0,54,37,17
2019,139719,20,1,27,24,3
2019,139719,20,2,23,10,13
2019,139719,20,3,4,3,1
2019,139719,30,0,23,11,12
2019,139719,30,3,23,11,12
2019,139719,40,0,25,11,14
2019,139719,40,1,1,1,0
2019,139719,40,2,2,2,0
2019,139719,40,3,9,3,6
2019,139719,40,4,2,0,2
2019,139719,40,5,8,3,5
2019,139719,40,6,3,2,1
2019,139719,41,0,2,1,1
2019,139719,41,6,2,1,1
2019,139719,42,0,23,10,13
2019,139719,42,1,1,1,0
2019,139719,42,2,2,2,0
2019,139719,42,3,9,3,6
2019,139719,42,4,2,0,2
2019,139719,42,5,8,3,5
2019,139719,42,6,1,1,0
2019,139719,45,0,2,1,1
2019,139719,45,6,2,1,1
2019,139755,0,0,1053,752,301
2019,139755,10,0,1048,748,300
2019,139755,10,1,420,346,74
2019,139755,10,2,257,189,68
2019,139755,10,3,190,119,71
2019,139755,10,4,3,0,3
2019,139755,10,5,112,56,56
2019,139755,10,6,66,38,28
2019,139755,20,0,665,524,141
2019,139755,20,1,418,344,74
2019,139755,20,2,246,180,66
2019,139755,20,6,1,0,1
2019,139755,30,0,187,123,64
2019,139755,30,1,2,2,0
2019,139755,30,2,11,9,2
2019,139755,30,3,173,111,62
2019,139755,30,5,1,1,0
2019,139755,40,0,196,101,95
2019,139755,40,3,17,8,9
2019,139755,40,4,3,0,3
2019,139755,40,5,111,55,56
2019,139755,40,6,65,38,27
2019,139755,41,0,2,2,0
2019,139755,41,5,2,2,0
2019,139755,42,0,194,99,95
2019,139755,42,3,17,8,9
2019,139755,42,4,3,0,3
2019,139755,42,5,109,53,56
2019,139755,42,6,65,38,27
2019,139755,45,0,2,2,0
2019,139755,45,5,2,2,0
2019,139755,50,0,5,4,1
2019,139764,0,0,116,54,62
2019,139764,10,0,116,54,62
2019,139764,10,1,30,19,11
2019,139764,10,2,29,14,15
2019,139764,10,3,24,11,13
2019,139764,10,4,3,1,2
2019,139764,10,5,30,9,21
2019,139764,20,0,57,33,24
2019,139764,20,1,30,19,11
2019,139764,20,2,27,14,13
2019,139764,30,0,26,11,15
2019,139764,30,2,2,0,2
2019,139764,30,3,24,11,13
2019,139764,40,0,33,10,23
2019,139764,40,4,3,1,2
2019,139764,40,5,30,9,21
2019,139764,42,0,33,10,23
2019,139764,42,4,3,1,2
2019,139764,42,5,30,9,21
2019,139861,0,0,334,146,188
2019,139861,10,0,334,146,188
2019,139861,10,1,103,59,44
2019,139861,10,2,69,24,45
2019,139861,10,3,79,35,44
2019,139861,10,4,6,1,5
2019,139861,10,5,77,27,50
2019,139861,20,0,170,82,88
2019,139861,20,1,103,59,44
2019,139861,20,2,67,23,44
2019,139861,30,0,80,36,44
2019,139861,30,2,2,1,1
2019,139861,30,3,78,35,43
2019,139861,40,0,84,28,56
2019,139861,40,3,1,0,1
2019,139861,40,4,6,1,5
2019,139861,40,5,77,27,50
2019,139861,41,0,2,0,2
2019,139861,41,4,1,0,1
2019,139861,41,5,1,0,1
2019,139861,42,0,82,28,54
2019,139861,42,3,1,0,1
2019,139861,42,4,5,1,4
2019,139861,42,5,76,27,49
2019,139861,45,0,2,0,2
2019,139861,45,4,1,0,1
2019,139861,45,5,1,0,1
2019,139931,0,0,1055,520,535
2019,139931,10,0,1055,520,535
2019,139931,10,1,205,130,75
2019,139931,10,2,279,159,120
2019,139931,10,3,303,152,151
2019,139931,10,4,95,28,67
2019,139931,10,5,173,51,122
2019,139931,20,0,489,290,199
2019,139931,20,1,205,130,75
2019,139931,20,2,274,154,120
2019,139931,20,3,10,6,4
2019,139931,30,0,240,124,116
2019,139931,30,2,4,4,0
2019,139931,30,3,236,120,116
2019,139931,40,0,326,106,220
2019,139931,40,2,1,1,0
2019,139931,40,3,57,26,31
2019,139931,40,4,95,28,67
2019,139931,40,5,173,51,122
2019,139931,42,0,326,106,220
2019,139931,42,2,1,1,0
2019,139931,42,3,57,26,31
2019,139931,42,4,95,28,67
2019,139931,42,5,173,51,122
2019,139940,0,0,1262,646,616
2019,139940,10,0,1170,608,562
2019,139940,10,1,294,197,97
2019,139940,10,2,334,173,161
2019,139940,10,3,235,110,125
2019,139940,10,4,71,24,47
2019,139940,10,5,181,76,105
2019,139940,10,6,55,28,27
2019,139940,20,0,547,329,218
2019,139940,20,1,276,188,88
2019,139940,20,2,271,141,130
2019,139940,30,0,163,82,81
2019,139940,30,1,1,1,0
2019,139940,30,2,15,10,5
2019,139940,30,3,147,71,76
2019,139940,40,0,460,197,263
2019,139940,40,1,17,8,9
2019,139940,40,2,48,22,26
2019,139940,40,3,88,39,49
2019,139940,40,4,71,24,47
2019,139940,40,5,181,76,105
2019,139940,40,6,55,28,27
2019,139940,41,0,4,1,3
2019,139940,41,4,4,1,3
2019,139940,42,0,456,196,260
2019,139940,42,1,17,8,9
2019,139940,42,2,48,22,26
2019,139940,42,3,88,39,49
2019,139940,42,4,67,23,44
2019,139940,42,5,181,76,105
2019,139940,42,6,55,28,27
2019,139940,45,0,4,1,3
2019,139940,45,4,4,1,3
2019,139940,50,0,92,38,54
2019,139959,0,0,2144,1265,879
2019,139959,10,0,2144,1265,879
2019,139959,10,1,722,520,202
2019,139959,10,2,539,312,227
2019,139959,10,3,411,215,196
2019,139959,10,4,72,37,35
2019,139959,10,5,257,125,132
2019,139959,10,6,143,56,87
2019,139959,20,0,1236,820,416
2019,139959,20,1,715,516,199
2019,139959,20,2,520,303,217
2019,139959,20,3,1,1,0
2019,139959,30,0,411,212,199
2019,139959,30,1,2,1,1
2019,139959,30,2,19,9,10
2019,139959,30,3,389,202,187
2019,139959,30,6,1,0,1
2019,139959,40,0,497,233,264
2019,139959,40,1,5,3,2
2019,139959,40,3,21,12,9
2019,139959,40,4,72,37,35
2019,139959,40,5,257,125,132
2019,139959,40,6,142,56,86
2019,139959,41,0,4,3,1
2019,139959,41,1,1,1,0
2019,139959,41,5,1,1,0
2019,139959,41,6,2,1,1
2019,139959,42,0,493,230,263
2019,139959,42,1,4,2,2
2019,139959,42,3,21,12,9
2019,139959,42,4,72,37,35
2019,139959,42,5,256,124,132
2019,139959,42,6,140,55,85
2019,139959,45,0,4,3,1
2019,139959,45,1,1,1,0
2019,139959,45,5,1,1,0
2019,139959,45,6,2,1,1
2019,139968,0,0,112,60,52
2019,139968,10,0,112,60,52
2019,139968,10,1,38,25,13
2019,139968,10,2,22,13,9
2019,139968,10,3,30,8,22
2019,139968,10,4,1,1,0
2019,139968,10,5,21,13,8
2019,139968,20,0,56,33,23
2019,139968,20,1,37,24,13
2019,139968,20,2,16,9,7
2019,139968,20,3,3,0,3
2019,139968,30,0,23,6,17
2019,139968,30,2,2,2,0
2019,139968,30,3,21,4,17
2019,139968,40,0,33,21,12
2019,139968,40,1,1,1,0
2019,139968,40,2,4,2,2
2019,139968,40,3,6,4,2
2019,139968,40,4,1,1,0
2019,139968,40,5,21,13,8
2019,139968,41,0,1,1,0
2019,139968,41,4,1,1,0
2019,139968,42,0,32,20,12
2019,139968,42,1,1,1,0
2019,139968,42,2,4,2,2
2019,139968,42,3,6,4,2
2019,139968,42,5,21,13,8
2019,139968,45,0,1,1,0
2019,139968,45,4,1,1,0
2019,139986,0,0,105,50,55
2019,139986,50,0,105,50,55
2019,140003,0,0,5,3,2
2019,140003,10,0,5,3,2
2019,140003,10,4,5,3,2
2019,140003,40,0,5,3,2
2019,140003,40,4,5,3,2
2019,140003,43,0,5,3,2
2019,140003,43,4,5,3,2
2019,140012,0,0,122,56,66
2019,140012,10,0,122,56,66
2019,140012,10,3,2,1,1
2019,140012,10,4,120,55,65
2019,140012,40,0,122,56,66
2019,140012,40,3,2,1,1
2019,140012,40,4,120,55,65
2019,140012,41,0,116,54,62
2019,140012,41,3,2,1,1
2019,140012,41,4,114,53,61
2019,140012,43,0,6,2,4
2019,140012,43,4,6,2,4
2019,140012,45,0,116,54,62
2019,140012,45,3,2,1,1
2019,140012,45,4,114,53,61
2019,140146,0,0,11,7,4
2019,140146,10,0,11,7,4
2019,140146,10,1,5,3,2
2019,140146,10,2,3,2,1
2019,140146,10,3,3,2,1
2019,140146,20,0,8,5,3
2019,140146,20,1,5,3,2
2019,140146,20,2,3,2,1
2019,140146,30,0,2,1,1
2019,140146,30,3,2,1,1
2019,140146,40,0,1,1,0
2019,140146,40,3,1,1,0
2019,140146,42,0,1,1,0
2019,140146,42,3,1,1,0
2019,140234,0,0,75,37,38
2019,140234,10,0,75,37,38
2019,140234,10,1,24,15,9
2019,140234,10,2,17,5,12
2019,140234,10,3,30,17,13
2019,140234,10,4,3,0,3
2019,140234,10,6,1,0,1
2019,140234,20,0,37,20,17
2019,140234,20,1,24,15,9
2019,140234,20,2,13,5,8
2019,140234,30,0,22,12,10
2019,140234,30,3,21,12,9
2019,140234,30,4,1,0,1
2019,140234,40,0,16,5,11
2019,140234,40,2,4,0,4
2019,140234,40,3,9,5,4
2019,140234,40,4,2,0,2
2019,140234,40,6,1,0,1
2019,140234,41,0,10,3,7
2019,140234,41,2,3,0,3
2019,140234,41,3,4,3,1
2019,140234,41,4,2,0,2
2019,140234,41,6,1,0,1
2019,140234,42,0,6,2,4
2019,140234,42,2,1,0,1
2019,140234,42,3,5,2,3
2019,140234,44,0,10,3,7
2019,140234,44,2,3,0,3
2019,140234,44,3,4,3,1
2019,140234,44,4,2,0,2
2019,140234,44,6,1,0,1
2019,140243,0,0,116,62,54
2019,140243,10,0,116,62,54
2019,140243,10,4,116,62,54
2019,140243,40,0,116,62,54
2019,140243,40,4,116,62,54
2019,140243,42,0,116,62,54
2019,140243,42,4,116,62,54
2019,140252,0,0,125,74,51
2019,140252,10,0,125,74,51
2019,140252,10,1,20,15,5
2019,140252,10,2,32,19,13
2019,140252,10,3,72,39,33
2019,140252,10,4,1,1,0
2019,140252,40,0,125,74,51
2019,140252,40,1,20,15,5
2019,140252,40,2,32,19,13
2019,140252,40,3,72,39,33
2019,140252,40,4,1,1,0
2019,140252,42,0,94,57,37
2019,140252,42,1,19,14,5
2019,140252,42,2,25,15,10
2019,140252,42,3,50,28,22
2019,140252,43,0,31,17,14
2019,140252,43,1,1,1,0
2019,140252,43,2,7,4,3
2019,140252,43,3,22,11,11
2019,140252,43,4,1,1,0
2019,140331,0,0,188,89,99
2019,140331,10,0,188,89,99
2019,140331,10,6,188,89,99
2019,140331,40,0,188,89,99
2019,140331,40,6,188,89,99
2019,140331,42,0,179,87,92
2019,140331,42,6,179,87,92
2019,140331,43,0,9,2,7
2019,140331,43,6,9,2,7
2019,140340,0,0,15,2,13
2019,140340,10,0,15,2,13
2019,140340,10,1,3,1,2
2019,140340,10,2,4,1,3
2019,140340,10,3,8,0,8
2019,140340,40,0,15,2,13
2019,140340,40,1,3,1,2
2019,140340,40,2,4,1,3
2019,140340,40,3,8,0,8
2019,140340,41,0,15,2,13
2019,140340,41,1,3,1,2
2019,140340,41,2,4,1,3
2019,140340,41,3,8,0,8
2019,140340,45,0,15,2,13
2019,140340,45,1,3,1,2
2019,140340,45,2,4,1,3
2019,140340,45,3,8,0,8
2019,140447,0,0,453,229,224
2019,140447,10,0,453,229,224
2019,140447,10,1,129,88,41
2019,140447,10,2,137,68,69
2019,140447,10,3,148,58,90
2019,140447,10,4,21,4,17
2019,140447,10,5,18,11,7
2019,140447,20,0,217,133,84
2019,140447,20,1,118,80,38
2019,140447,20,2,97,51,46
2019,140447,20,3,2,2,0
2019,140447,30,0,94,42,52
2019,140447,30,2,8,4,4
2019,140447,30,3,86,38,48
2019,140447,40,0,142,54,88
2019,140447,40,1,11,8,3
2019,140447,40,2,32,13,19
2019,140447,40,3,60,18,42
2019,140447,40,4,21,4,17
2019,140447,40,5,18,11,7
2019,140447,41,0,9,6,3
2019,140447,41,1,1,1,0
2019,140447,41,2,6,4,2
2019,140447,41,3,1,0,1
2019,140447,41,5,1,1,0
2019,140447,42,0,133,48,85
2019,140447,42,1,10,7,3
2019,140447,42,2,26,9,17
2019,140447,42,3,59,18,41
2019,140447,42,4,21,4,17
2019,140447,42,5,17,10,7
2019,140447,44,0,9,6,3
2019,140447,44,1,1,1,0
2019,140447,44,2,6,4,2
2019,140447,44,3,1,0,1
2019,140447,44,5,1,1,0
2019,140553,0,0,149,93,56
2019,140553,10,0,149,93,56
2019,140553,10,1,34,20,14
2019,140553,10,2,59,40,19
2019,140553,10,3,46,29,17
2019,140553,10,4,7,4,3
2019,140553,10,5,1,0,1
2019,140553,10,6,2,0,2
2019,140553,20,0,91,60,31
2019,140553,20,1,33,20,13
2019,140553,20,2,57,39,18
2019,140553,20,4,1,1,0
2019,140553,30,0,9,6,3
2019,140553,30,2,1,1,0
2019,140553,30,3,8,5,3
2019,140553,40,0,49,27,22
2019,140553,40,1,1,0,1
2019,140553,40,2,1,0,1
2019,140553,40,3,38,24,14
2019,140553,40,4,6,3,3
2019,140553,40,5,1,0,1
2019,140553,40,6,2,0,2
2019,140553,42,0,49,27,22
2019,140553,42,1,1,0,1
2019,140553,42,2,1,0,1
2019,140553,42,3,38,24,14
2019,140553,42,4,6,3,3
2019,140553,42,5,1,0,1
2019,140553,42,6,2,0,2
2019,140562,0,0,255,118,137
2019,140562,10,0,255,118,137
2019,140562,10,1,87,56,31
2019,140562,10,2,66,32,34
2019,140562,10,3,76,23,53
2019,140562,10,4,26,7,19
2019,140562,40,0,255,118,137
2019,140562,40,1,87,56,31
2019,140562,40,2,66,32,34
2019,140562,40,3,76,23,53
2019,140562,40,4,26,7,19
2019,140562,41,0,79,46,33
2019,140562,41,1,58,36,22
2019,140562,41,2,16,9,7
2019,140562,41,3,5,1,4
2019,140562,42,0,175,72,103
2019,140562,42,1,28,20,8
2019,140562,42,2,50,23,27
2019,140562,42,3,71,22,49
2019,140562,42,4,26,7,19
2019,140562,43,0,1,0,1
2019,140562,43,1,1,0,1
2019,140562,44,0,79,46,33
2019,140562,44,1,58,36,22
2019,140562,44,2,16,9,7
2019,140562,44,3,5,1,4
2019,140678,0,0,75,35,40
2019,140678,10,0,75,35,40
2019,140678,10,6,75,35,40
2019,140678,40,0,75,35,40
2019,140678,40,6,75,35,40
2019,140678,42,0,75,35,40
2019,140678,42,6,75,35,40
2019,140696,0,0,74,38,36
2019,140696,10,0,74,38,36
2019,140696,10,1,18,12,6
2019,140696,10,2,14,7,7
2019,140696,10,3,21,8,13
2019,140696,10,4,2,1,1
2019,140696,10,5,17,9,8
2019,140696,10,6,2,1,1
2019,140696,20,0,32,19,13
2019,140696,20,1,18,12,6
2019,140696,20,2,14,7,7
2019,140696,30,0,13,5,8
2019,140696,30,3,13,5,8
2019,140696,40,0,29,14,15
2019,140696,40,3,8,3,5
2019,140696,40,4,2,1,1
2019,140696,40,5,17,9,8
2019,140696,40,6,2,1,1
2019,140696,41,0,12,7,5
2019,140696,41,5,10,6,4
2019,140696,41,6,2,1,1
2019,140696,42,0,17,7,10
2019,140696,42,3,8,3,5
2019,140696,42,4,2,1,1
2019,140696,42,5,7,3,4
2019,140696,44,0,10,6,4
2019,140696,44,5,10,6,4
2019,140696,45,0,2,1,1
2019,140696,45,6,2,1,1
2019,140720,0,0,33,23,10
2019,140720,10,0,33,23,10
2019,140720,10,1,3,3,0
2019,140720,10,2,4,4,0
2019,140720,10,3,20,13,7
2019,140720,10,4,6,3,3
2019,140720,20,0,3,3,0
2019,140720,20,1,3,3,0
2019,140720,30,0,22,15,7
2019,140720,30,2,4,4,0
2019,140720,30,3,18,11,7
2019,140720,40,0,8,5,3
2019,140720,40,3,2,2,0
2019,140720,40,4,6,3,3
2019,140720,42,0,8,5,3
2019,140720,42,3,2,2,0
2019,140720,42,4,6,3,3
2019,140818,0,0,115,54,61
2019,140818,10,0,115,54,61
2019,140818,10,1,37,21,16
2019,140818,10,2,45,16,29
2019,140818,10,3,30,16,14
2019,140818,10,4,3,1,2
2019,140818,20,0,15,9,6
2019,140818,20,1,15,9,6
2019,140818,30,0,2,1,1
2019,140818,30,1,2,1,1
2019,140818,40,0,98,44,54
2019,140818,40,1,20,11,9
2019,140818,40,2,45,16,29
2019,140818,40,3,30,16,14
2019,140818,40,4,3,1,2
2019,140818,42,0,98,44,54
2019,140818,42,1,20,11,9
2019,140818,42,2,45,16,29
2019,140818,42,3,30,16,14
2019,140818,42,4,3,1,2
2019,140872,0,0,78,32,46
2019,140872,10,0,78,32,46
2019,140872,10,1,16,8,8
2019,140872,10,2,21,9,12
2019,140872,10,3,35,13,22
2019,140872,10,4,6,2,4
2019,140872,20,0,28,13,15
2019,140872,20,1,13,5,8
2019,140872,20,2,15,8,7
2019,140872,30,0,17,10,7
2019,140872,30,1,2,2,0
2019,140872,30,2,3,1,2
2019,140872,30,3,12,7,5
2019,140872,40,0,33,9,24
2019,140872,40,1,1,1,0
2019,140872,40,2,3,0,3
2019,140872,40,3,23,6,17
2019,140872,40,4,6,2,4
2019,140872,42,0,33,9,24
2019,140872,42,1,1,1,0
2019,140872,42,2,3,0,3
2019,140872,42,3,23,6,17
2019,140872,42,4,6,2,4
2019,140942,0,0,102,54,48
2019,140942,10,0,102,54,48
2019,140942,10,6,102,54,48
2019,140942,40,0,102,54,48
2019,140942,40,6,102,54,48
2019,140942,41,0,22,7,15
2019,140942,41,6,22,7,15
2019,140942,42,0,75,44,31
2019,140942,42,6,75,44,31
2019,140942,43,0,5,3,2
2019,140942,43,6,5,3,2
2019,140942,45,0,22,7,15
2019,140942,45,6,22,7,15
2019,140951,0,0,619,370,249
2019,140951,10,0,619,370,249
2019,140951,10,1,619,370,249
2019,140951,40,0,619,370,249
2019,140951,40,1,619,370,249
2019,140951,42,0,619,370,249
2019,140951,42,1,619,370,249
2019,140960,0,0,171,97,74
2019,140960,10,0,169,95,74
2019,140960,10,1,29,23,6
2019,140960,10,2,41,21,20
2019,140960,10,3,60,29,31
2019,140960,10,4,23,13,10
2019,140960,10,5,10,5,5
2019,140960,10,6,6,4,2
2019,140960,20,0,71,45,26
2019,140960,20,1,29,23,6
2019,140960,20,2,37,20,17
2019,140960,20,3,5,2,3
2019,140960,30,0,55,27,28
2019,140960,30,2,4,1,3
2019,140960,30,3,50,26,24
2019,140960,30,4,1,0,1
2019,140960,40,0,43,23,20
2019,140960,40,3,5,1,4
2019,140960,40,4,22,13,9
2019,140960,40,5,10,5,5
2019,140960,40,6,6,4,2
2019,140960,41,0,2,1,1
2019,140960,41,4,1,0,1
2019,140960,41,5,1,1,0
2019,140960,42,0,41,22,19
2019,140960,42,3,5,1,4
2019,140960,42,4,21,13,8
2019,140960,42,5,9,4,5
2019,140960,42,6,6,4,2
2019,140960,45,0,2,1,1
2019,140960,45,4,1,0,1
2019,140960,45,5,1,1,0
2019,140960,50,0,2,2,0
2019,140988,0,0,77,43,34
2019,140988,10,0,77,43,34
2019,140988,10,1,8,7,1
2019,140988,10,2,22,14,8
2019,140988,10,3,43,21,22
2019,140988,10,4,4,1,3
2019,140988,20,0,10,8,2
2019,140988,20,1,6,5,1
2019,140988,20,2,4,3,1
2019,140988,30,0,63,34,29
2019,140988,30,1,2,2,0
2019,140988,30,2,18,11,7
2019,140988,30,3,43,21,22
2019,140988,40,0,4,1,3
2019,140988,40,4,4,1,3
2019,140988,42,0,4,1,3
2019,140988,42,4,4,1,3
2019,141006,0,0,56,30,26
2019,141006,10,0,56,30,26
2019,141006,10,4,56,30,26
2019,141006,40,0,56,30,26
2019,141006,40,4,56,30,26
2019,141006,42,0,56,30,26
2019,141006,42,4,56,30,26
2019,141060,0,0,183,42,141
2019,141060,10,0,183,42,141
2019,141060,10,1,20,7,13
2019,141060,10,2,68,17,51
2019,141060,10,3,43,8,35
2019,141060,10,4,17,3,14
2019,141060,10,5,35,7,28
2019,141060,20,0,88,24,64
2019,141060,20,1,20,7,13
2019,141060,20,2,68,17,51
2019,141060,30,0,43,8,35
2019,141060,30,3,43,8,35
2019,141060,40,0,52,10,42
2019,141060,40,4,17,3,14
2019,141060,40,5,35,7,28
2019,141060,41,0,37,9,28
2019,141060,41,4,12,3,9
2019,141060,41,5,25,6,19
2019,141060,42,0,15,1,14
2019,141060,42,4,5,0,5
2019,141060,42,5,10,1,9
2019,141060,44,0,37,9,28
2019,141060,44,4,12,3,9
2019,141060,44,5,25,6,19
2019,141167,0,0,54,17,37
2019,141167,10,0,54,17,37
2019,141167,10,1,4,1,3
2019,141167,10,2,13,3,10
2019,141167,10,3,30,10,20
2019,141167,10,4,7,3,4
2019,141167,40,0,54,17,37
2019,141167,40,1,4,1,3
2019,141167,40,2,13,3,10
2019,141167,40,3,30,10,20
2019,141167,40,4,7,3,4
2019,141167,43,0,54,17,37
2019,141167,43,1,4,1,3
2019,141167,43,2,13,3,10
2019,141167,43,3,30,10,20
2019,141167,43,4,7,3,4
2019,141185,0,0,46,29,17
2019,141185,10,0,46,29,17
2019,141185,10,1,14,11,3
2019,141185,10,2,7,5,2
2019,141185,10,3,25,13,12
2019,141185,20,0,12,10,2
2019,141185,20,1,10,8,2
2019,141185,20,2,2,2,0
2019,141185,30,0,15,11,4
2019,141185,30,1,3,3,0
2019,141185,30,2,5,3,2
2019,141185,30,3,7,5,2
2019,141185,40,0,19,8,11
2019,141185,40,1,1,0,1
2019,141185,40,3,18,8,10
2019,141185,42,0,19,8,11
2019,141185,42,1,1,0,1
2019,141185,42,3,18,8,10
2019,141237,0,0,54,29,25
2019,141237,10,0,54,29,25
2019,141237,10,1,10,6,4
2019,141237,10,2,18,12,6
2019,141237,10,3,22,8,14
2019,141237,10,4,3,3,0
2019,141237,10,6,1,0,1
2019,141237,40,0,54,29,25
2019,141237,40,1,10,6,4
2019,141237,40,2,18,12,6
2019,141237,40,3,22,8,14
2019,141237,40,4,3,3,0
2019,141237,40,6,1,0,1
2019,141237,42,0,54,29,25
2019,141237,42,1,10,6,4
2019,141237,42,2,18,12,6
2019,141237,42,3,22,8,14
2019,141237,42,4,3,3,0
2019,141237,42,6,1,0,1
2019,141255,0,0,141,51,90
2019,141255,10,0,141,51,90
2019,141255,10,4,141,51,90
2019,141255,40,0,141,51,90
2019,141255,40,4,141,51,90
2019,141255,41,0,141,51,90
2019,141255,41,4,141,51,90
2019,141255,45,0,141,51,90
2019,141255,45,4,141,51,90
2019,141264,0,0,418,206,212
2019,141264,10,0,417,206,211
2019,141264,10,1,128,80,48
2019,141264,10,2,109,57,52
2019,141264,10,3,85,39,46
2019,141264,10,4,41,9,32
2019,141264,10,5,53,21,32
2019,141264,10,6,1,0,1
2019,141264,20,0,239,139,100
2019,141264,20,1,128,80,48
2019,141264,20,2,106,56,50
2019,141264,20,3,4,2,2
2019,141264,20,4,1,1,0
2019,141264,30,0,64,29,35
2019,141264,30,2,1,0,1
2019,141264,30,3,62,29,33
2019,141264,30,4,1,0,1
2019,141264,40,0,114,38,76
2019,141264,40,2,2,1,1
2019,141264,40,3,19,8,11
2019,141264,40,4,39,8,31
2019,141264,40,5,53,21,32
2019,141264,40,6,1,0,1
2019,141264,41,0,2,0,2
2019,141264,41,4,1,0,1
2019,141264,41,6,1,0,1
2019,141264,42,0,112,38,74
2019,141264,42,2,2,1,1
2019,141264,42,3,19,8,11
2019,141264,42,4,38,8,30
2019,141264,42,5,53,21,32
2019,141264,45,0,2,0,2
2019,141264,45,4,1,0,1
2019,141264,45,6,1,0,1
2019,141264,50,0,1,0,1
2019,141325,0,0,51,17,34
2019,141325,10,0,51,17,34
2019,141325,10,1,20,5,15
2019,141325,10,2,13,7,6
2019,141325,10,3,13,3,10
2019,141325,10,4,5,2,3
2019,141325,20,0,33,12,21
2019,141325,20,1,20,5,15
2019,141325,20,2,11,6,5
2019,141325,20,3,2,1,1
2019,141325,30,0,13,3,10
2019,141325,30,2,2,1,1
2019,141325,30,3,11,2,9
2019,141325,40,0,5,2,3
2019,141325,40,4,5,2,3
2019,141325,42,0,5,2,3
2019,141325,42,4,5,2,3
2019,141334,0,0,529,227,302
2019,141334,10,0,529,227,302
2019,141334,10,1,126,82,44
2019,141334,10,2,122,53,69
2019,141334,10,3,132,48,84
2019,141334,10,4,72,20,52
2019,141334,10,5,77,24,53
2019,141334,20,0,241,134,107
2019,141334,20,1,126,82,44
2019,141334,20,2,113,50,63
2019,141334,20,3,2,2,0
2019,141334,30,0,109,42,67
2019,141334,30,2,8,3,5
2019,141334,30,3,101,39,62
2019,141334,40,0,179,51,128
2019,141334,40,2,1,0,1
2019,141334,40,3,29,7,22
2019,141334,40,4,72,20,52
2019,141334,40,5,77,24,53
2019,141334,41,0,1,0,1
2019,141334,41,4,1,0,1
2019,141334,42,0,178,51,127
2019,141334,42,2,1,0,1
2019,141334,42,3,29,7,22
2019,141334,42,4,71,20,51
2019,141334,42,5,77,24,53
2019,141334,45,0,1,0,1
2019,141334,45,4,1,0,1
2019,141361,0,0,67,36,31
2019,141361,10,0,67,36,31
2019,141361,10,1,12,8,4
2019,141361,10,2,24,15,9
2019,141361,10,3,24,12,12
2019,141361,10,4,7,1,6
2019,141361,20,0,36,23,13
2019,141361,20,1,12,8,4
2019,141361,20,2,24,15,9
2019,141361,30,0,20,9,11
2019,141361,30,3,20,9,11
2019,141361,40,0,11,4,7
2019,141361,40,3,4,3,1
2019,141361,40,4,7,1,6
2019,141361,42,0,11,4,7
2019,141361,42,3,4,3,1
2019,141361,42,4,7,1,6
2019,141486,0,0,90,50,40
2019,141486,10,0,90,50,40
2019,141486,10,1,21,17,4
2019,141486,10,2,27,15,12
2019,141486,10,3,32,13,19
2019,141486,10,5,10,5,5
2019,141486,20,0,35,26,9
2019,141486,20,1,21,17,4
2019,141486,20,2,11,7,4
2019,141486,20,3,3,2,1
2019,141486,30,0,10,5,5
2019,141486,30,3,10,5,5
2019,141486,40,0,45,19,26
2019,141486,40,2,16,8,8
2019,141486,40,3,19,6,13
2019,141486,40,5,10,5,5
2019,141486,42,0,45,19,26
2019,141486,42,2,16,8,8
2019,141486,42,3,19,6,13
2019,141486,42,5,10,5,5
2019,141565,0,0,203,105,98
2019,141565,10,0,203,105,98
2019,141565,10,1,70,35,35
2019,141565,10,2,59,38,21
2019,141565,10,3,44,25,19
2019,141565,10,4,30,7,23
2019,141565,20,0,130,74,56
2019,141565,20,1,70,35,35
2019,141565,20,2,58,37,21
2019,141565,20,3,2,2,0
2019,141565,30,0,42,24,18
2019,141565,30,2,1,1,0
2019,141565,30,3,41,23,18
2019,141565,40,0,31,7,24
2019,141565,40,3,1,0,1
2019,141565,40,4,30,7,23
2019,141565,41,0,10,0,10
2019,141565,41,4,10,0,10
2019,141565,42,0,21,7,14
2019,141565,42,3,1,0,1
2019,141565,42,4,20,7,13
2019,141565,44,0,10,0,10
2019,141565,44,4,10,0,10
2019,141574,0,0,1153,620,533
2019,141574,10,0,1153,620,533
2019,141574,10,1,438,290,148
2019,141574,10,2,331,160,171
2019,141574,10,3,259,130,129
2019,141574,10,4,125,40,85
2019,141574,20,0,733,433,300
2019,141574,20,1,428,283,145
2019,141574,20,2,304,150,154
2019,141574,20,3,1,0,1
2019,141574,30,0,194,103,91
2019,141574,30,2,4,1,3
2019,141574,30,3,190,102,88
2019,141574,40,0,226,84,142
2019,141574,40,1,10,7,3
2019,141574,40,2,23,9,14
2019,141574,40,3,68,28,40
2019,141574,40,4,125,40,85
2019,141574,41,0,67,24,43
2019,141574,41,2,2,0,2
2019,141574,41,3,19,10,9
2019,141574,41,4,46,14,32
2019,141574,42,0,159,60,99
2019,141574,42,1,10,7,3
2019,141574,42,2,21,9,12
2019,141574,42,3,49,18,31
2019,141574,42,4,79,26,53
2019,141574,44,0,67,24,43
2019,141574,44,2,2,0,2
2019,141574,44,3,19,10,9
2019,141574,44,4,46,14,32
2019,141644,0,0,145,77,68
2019,141644,10,0,145,77,68
2019,141644,10,1,25,14,11
2019,141644,10,2,44,24,20
2019,141644,10,3,47,25,22
2019,141644,10,4,14,7,7
2019,141644,10,5,15,7,8
2019,141644,20,0,1,1,0
2019,141644,20,1,1,1,0
2019,141644,40,0,144,76,68
2019,141644,40,1,24,13,11
2019,141644,40,2,44,24,20
2019,141644,40,3,47,25,22
2019,141644,40,4,14,7,7
2019,141644,40,5,15,7,8
2019,141644,41,0,129,69,60
2019,141644,41,1,24,13,11
2019,141644,41,2,44,24,20
2019,141644,41,3,47,25,22
2019,141644,41,4,14,7,7
2019,141644,42,0,15,7,8
2019,141644,42,5,15,7,8
2019,141644,44,0,129,69,60
2019,141644,44,1,24,13,11
2019,141644,44,2,44,24,20
2019,141644,44,3,47,25,22
2019,141644,44,4,14,7,7
2019,141680,0,0,99,59,40
2019,141680,10,0,99,59,40
2019,141680,10,1,22,11,11
2019,141680,10,2,17,11,6
2019,141680,10,3,22,16,6
2019,141680,10,4,38,21,17
2019,141680,20,0,57,35,22
2019,141680,20,1,22,11,11
2019,141680,20,2,17,11,6
2019,141680,20,3,18,13,5
2019,141680,30,0,38,22,16
2019,141680,30,3,2,2,0
2019,141680,30,4,36,20,16
2019,141680,40,0,4,2,2
2019,141680,40,3,2,1,1
2019,141680,40,4,2,1,1
2019,141680,41,0,1,1,0
2019,141680,41,3,1,1,0
2019,141680,42,0,3,1,2
2019,141680,42,3,1,0,1
2019,141680,42,4,2,1,1
2019,141680,44,0,1,1,0
2019,141680,44,3,1,1,0
2019,141796,0,0,172,87,85
2019,141796,10,0,172,87,85
2019,141796,10,1,46,27,19
2019,141796,10,2,25,10,15
2019,141796,10,3,47,27,20
2019,141796,10,4,54,23,31
2019,141796,20,0,111,61,50
2019,141796,20,1,44,26,18
2019,141796,20,2,25,10,15
2019,141796,20,3,41,25,16
2019,141796,20,4,1,0,1
2019,141796,30,0,47,22,25
2019,141796,30,3,3,1,2
2019,141796,30,4,44,21,23
2019,141796,40,0,14,4,10
2019,141796,40,1,2,1,1
2019,141796,40,3,3,1,2
2019,141796,40,4,9,2,7
2019,141796,42,0,14,4,10
2019,141796,42,1,2,1,1
2019,141796,42,3,3,1,2
2019,141796,42,4,9,2,7
2019,141802,0,0,54,27,27
2019,141802,10,0,54,27,27
2019,141802,10,1,9,5,4
2019,141802,10,2,10,5,5
2019,141802,10,3,17,8,9
2019,141802,10,4,18,9,9
2019,141802,20,0,36,18,18
2019,141802,20,1,9,5,4
2019,141802,20,2,10,5,5
2019,141802,20,3,17,8,9
2019,141802,30,0,12,7,5
2019,141802,30,4,12,7,5
2019,141802,40,0,6,2,4
2019,141802,40,4,6,2,4
2019,141802,42,0,6,2,4
2019,141802,42,4,6,2,4
2019,141811,0,0,146,69,77
2019,141811,10,0,146,69,77
2019,141811,10,1,38,21,17
2019,141811,10,2,19,10,9
2019,141811,10,3,46,21,25
2019,141811,10,4,43,17,26
2019,141811,20,0,103,52,51
2019,141811,20,1,38,21,17
2019,141811,20,2,19,10,9
2019,141811,20,3,46,21,25
2019,141811,30,0,40,16,24
2019,141811,30,4,40,16,24
2019,141811,40,0,3,1,2
2019,141811,40,4,3,1,2
2019,141811,42,0,3,1,2
2019,141811,42,4,3,1,2
2019,141839,0,0,73,36,37
2019,141839,10,0,73,36,37
2019,141839,10,1,12,4,8
2019,141839,10,2,16,7,9
2019,141839,10,3,18,13,5
2019,141839,10,4,27,12,15
2019,141839,20,0,46,24,22
2019,141839,20,1,12,4,8
2019,141839,20,2,16,7,9
2019,141839,20,3,18,13,5
2019,141839,30,0,25,11,14
2019,141839,30,4,25,11,14
2019,141839,40,0,2,1,1
2019,141839,40,4,2,1,1
2019,141839,42,0,2,1,1
2019,141839,42,4,2,1,1
2019,141981,0,0,85,43,42
2019,141981,10,0,85,43,42
2019,141981,10,1,27,16,11
2019,141981,10,2,11,8,3
2019,141981,10,3,37,14,23
2019,141981,10,4,10,5,5
2019,141981,20,0,37,23,14
2019,141981,20,1,27,16,11
2019,141981,20,2,10,7,3
2019,141981,30,0,36,14,22
2019,141981,30,2,1,1,0
2019,141981,30,3,35,13,22
2019,141981,40,0,12,6,6
2019,141981,40,3,2,1,1
2019,141981,40,4,10,5,5
2019,141981,41,0,6,2,4
2019,141981,41,3,2,1,1
2019,141981,41,4,4,1,3
2019,141981,42,0,6,4,2
2019,141981,42,4,6,4,2
2019,141981,44,0,6,2,4
2019,141981,44,3,2,1,1
2019,141981,44,4,4,1,3
2019,141990,0,0,58,28,30
2019,141990,10,0,58,28,30
2019,141990,10,1,13,9,4
2019,141990,10,2,5,3,2
2019,141990,10,3,12,5,7
2019,141990,10,4,28,11,17
2019,141990,20,0,29,17,12
2019,141990,20,1,13,9,4
2019,141990,20,2,5,3,2
2019,141990,20,3,11,5,6
2019,141990,30,0,24,10,14
2019,141990,30,3,1,0,1
2019,141990,30,4,23,10,13
2019,141990,40,0,5,1,4
2019,141990,40,4,5,1,4
2019,141990,42,0,5,1,4
2019,141990,42,4,5,1,4
2019,142054,0,0,20,2,18
2019,142054,10,0,20,2,18
2019,142054,10,4,20,2,18
2019,142054,40,0,20,2,18
2019,142054,40,4,20,2,18
2019,142054,41,0,20,2,18
2019,142054,41,4,20,2,18
2019,142054,45,0,20,2,18
2019,142054,45,4,20,2,18
2019,142090,0,0,6,4,2
2019,142090,10,0,6,4,2
2019,142090,10,1,6,4,2
2019,142090,40,0,6,4,2
2019,142090,40,1,6,4,2
2019,142090,41,0,6,4,2
2019,142090,41,1,6,4,2
2019,142090,44,0,6,4,2
2019,142090,44,1,6,4,2
2019,142115,0,0,790,400,390
2019,142115,10,0,790,400,390
2019,142115,10,1,176,107,69
2019,142115,10,2,226,117,109
2019,142115,10,3,204,96,108
2019,142115,10,4,13,9,4
2019,142115,10,5,148,64,84
2019,142115,10,6,23,7,16
2019,142115,20,0,356,201,155
2019,142115,20,1,175,106,69
2019,142115,20,2,177,93,84
2019,142115,20,3,4,2,2
2019,142115,30,0,174,94,80
2019,142115,30,2,29,17,12
2019,142115,30,3,145,77,68
2019,142115,40,0,260,105,155
2019,142115,40,1,1,1,0
2019,142115,40,2,20,7,13
2019,142115,40,3,55,17,38
2019,142115,40,4,13,9,4
2019,142115,40,5,148,64,84
2019,142115,40,6,23,7,16
2019,142115,42,0,260,105,155
2019,142115,42,1,1,1,0
2019,142115,42,2,20,7,13
2019,142115,42,3,55,17,38
2019,142115,42,4,13,9,4
2019,142115,42,5,148,64,84
2019,142115,42,6,23,7,16
2019,142179,0,0,57,28,29
2019,142179,10,0,57,28,29
2019,142179,10,4,54,28,26
2019,142179,10,6,3,0,3
2019,142179,40,0,57,28,29
2019,142179,40,4,54,28,26
2019,142179,40,6,3,0,3
2019,142179,42,0,57,28,29
2019,142179,42,4,54,28,26
2019,142179,42,6,3,0,3
2019,142276,0,0,614,322,292
2019,142276,10,0,614,322,292
2019,142276,10,1,131,90,41
2019,142276,10,2,124,58,66
2019,142276,10,3,203,93,110
2019,142276,10,4,84,53,31
2019,142276,10,5,71,27,44
2019,142276,10,6,1,1,0
2019,142276,20,0,220,138,82
2019,142276,20,1,126,89,37
2019,142276,20,2,94,49,45
2019,142276,30,0,110,51,59
2019,142276,30,2,5,3,2
2019,142276,30,3,105,48,57
2019,142276,40,0,284,133,151
2019,142276,40,1,5,1,4
2019,142276,40,2,25,6,19
2019,142276,40,3,98,45,53
2019,142276,40,4,84,53,31
2019,142276,40,5,71,27,44
2019,142276,40,6,1,1,0
2019,142276,42,0,284,133,151
2019,142276,42,1,5,1,4
2019,142276,42,2,25,6,19
2019,142276,42,3,98,45,53
2019,142276,42,4,84,53,31
2019,142276,42,5,71,27,44
2019,142276,42,6,1,1,0
2019,142285,0,0,585,371,214
2019,142285,10,0,585,371,214
2019,142285,10,1,179,134,45
2019,142285,10,2,174,107,67
2019,142285,10,3,167,99,68
2019,142285,10,4,49,21,28
2019,142285,10,6,16,10,6
2019,142285,20,0,324,225,99
2019,142285,20,1,175,131,44
2019,142285,20,2,145,92,53
2019,142285,20,3,1,0,1
2019,142285,20,4,3,2,1
2019,142285,30,0,132,79,53
2019,142285,30,2,4,4,0
2019,142285,30,3,128,75,53
2019,142285,40,0,129,67,62
2019,142285,40,1,4,3,1
2019,142285,40,2,25,11,14
2019,142285,40,3,38,24,14
2019,142285,40,4,46,19,27
2019,142285,40,6,16,10,6
2019,142285,41,0,2,2,0
2019,142285,41,3,2,2,0
2019,142285,42,0,127,65,62
2019,142285,42,1,4,3,1
2019,142285,42,2,25,11,14
2019,142285,42,3,36,22,14
2019,142285,42,4,46,19,27
2019,142285,42,6,16,10,6
2019,142285,44,0,2,2,0
2019,142285,44,3,2,2,0
2019,142294,0,0,72,41,31
2019,142294,10,0,72,41,31
2019,142294,10,1,24,16,8
2019,142294,10,2,18,9,9
2019,142294,10,3,15,6,9
2019,142294,10,4,13,8,5
2019,142294,10,6,2,2,0
2019,142294,20,0,42,25,17
2019,142294,20,1,24,16,8
2019,142294,20,2,18,9,9
2019,142294,30,0,12,5,7
2019,142294,30,3,12,5,7
2019,142294,40,0,18,11,7
2019,142294,40,3,3,1,2
2019,142294,40,4,13,8,5
2019,142294,40,6,2,2,0
2019,142294,42,0,14,9,5
2019,142294,42,4,12,7,5
2019,142294,42,6,2,2,0
2019,142294,43,0,4,2,2
2019,142294,43,3,3,1,2
2019,142294,43,4,1,1,0
2019,142328,0,0,181,85,96
2019,142328,10,0,181,85,96
2019,142328,10,1,49,30,19
2019,142328,10,2,49,18,31
2019,142328,10,3,54,23,31
2019,142328,10,4,29,14,15
2019,142328,20,0,88,36,52
2019,142328,20,1,40,23,17
2019,142328,20,2,41,13,28
2019,142328,20,3,6,0,6
2019,142328,20,4,1,0,1
2019,142328,30,0,42,19,23
2019,142328,30,1,1,1,0
2019,142328,30,2,2,2,0
2019,142328,30,3,28,11,17
2019,142328,30,4,11,5,6
2019,142328,40,0,51,30,21
2019,142328,40,1,8,6,2
2019,142328,40,2,6,3,3
2019,142328,40,3,20,12,8
2019,142328,40,4,17,9,8
2019,142328,42,0,51,30,21
2019,142328,42,1,8,6,2
2019,142328,42,2,6,3,3
2019,142328,42,3,20,12,8
2019,142328,42,4,17,9,8
2019,142443,0,0,158,86,72
2019,142443,10,0,158,86,72
2019,142443,10,3,9,1,8
2019,142443,10,4,149,85,64
2019,142443,20,0,101,56,45
2019,142443,20,4,101,56,45
2019,142443,30,0,40,19,21
2019,142443,30,3,9,1,8
2019,142443,30,4,31,18,13
2019,142443,40,0,17,11,6
2019,142443,40,4,17,11,6
2019,142443,42,0,17,11,6
2019,142443,42,4,17,11,6
2019,142461,0,0,97,50,47
2019,142461,10,0,96,50,46
2019,142461,10,1,31,22,9
2019,142461,10,2,30,15,15
2019,142461,10,3,35,13,22
2019,142461,20,0,43,28,15
2019,142461,20,1,28,21,7
2019,142461,20,2,14,7,7
2019,142461,20,3,1,0,1
2019,142461,30,0,39,17,22
2019,142461,30,1,2,1,1
2019,142461,30,2,10,6,4
2019,142461,30,3,27,10,17
2019,142461,40,0,14,5,9
2019,142461,40,1,1,0,1
2019,142461,40,2,6,2,4
2019,142461,40,3,7,3,4
2019,142461,42,0,14,5,9
2019,142461,42,1,1,0,1
2019,142461,42,2,6,2,4
2019,142461,42,3,7,3,4
2019,142461,50,0,1,0,1
2019,142522,0,0,596,491,105
2019,142522,50,0,596,491,105
2019,142559,0,0,143,68,75
2019,142559,10,0,143,68,75
2019,142559,10,1,50,23,27
2019,142559,10,2,23,10,13
2019,142559,10,3,22,11,11
2019,142559,10,4,48,24,24
2019,142559,40,0,143,68,75
2019,142559,40,1,50,23,27
2019,142559,40,2,23,10,13
2019,142559,40,3,22,11,11
2019,142559,40,4,48,24,24
2019,142559,42,0,143,68,75
2019,142559,42,1,50,23,27
2019,142559,42,2,23,10,13
2019,142559,42,3,22,11,11
2019,142559,42,4,48,24,24
2019,142832,0,0,65,20,45
2019,142832,10,0,65,20,45
2019,142832,10,1,15,3,12
2019,142832,10,2,20,8,12
2019,142832,10,3,29,9,20
2019,142832,10,6,1,0,1
2019,142832,40,0,65,20,45
2019,142832,40,1,15,3,12
2019,142832,40,2,20,8,12
2019,142832,40,3,29,9,20
2019,142832,40,6,1,0,1
2019,142832,41,0,57,17,40
2019,142832,41,1,15,3,12
2019,142832,41,2,18,6,12
2019,142832,41,3,24,8,16
2019,142832,42,0,8,3,5
2019,142832,42,2,2,2,0
2019,142832,42,3,5,1,4
2019,142832,42,6,1,0,1
2019,142832,44,0,55,16,39
2019,142832,44,1,15,3,12
2019,142832,44,2,17,5,12
2019,142832,44,3,23,8,15
2019,142832,45,0,2,1,1
2019,142832,45,2,1,1,0
2019,142832,45,3,1,0,1
2019,142887,0,0,20,12,8
2019,142887,10,0,20,12,8
2019,142887,10,4,20,12,8
2019,142887,40,0,20,12,8
2019,142887,40,4,20,12,8
2019,142887,42,0,10,6,4
2019,142887,42,4,10,6,4
2019,142887,43,0,10,6,4
2019,142887,43,4,10,6,4
2019,143048,0,0,176,98,78
2019,143048,10,0,176,98,78
2019,143048,10,1,50,26,24
2019,143048,10,2,73,47,26
2019,143048,10,3,42,19,23
2019,143048,10,6,11,6,5
2019,143048,20,0,122,72,50
2019,143048,20,1,50,26,24
2019,143048,20,2,72,46,26
2019,143048,30,0,43,20,23
2019,143048,30,2,1,1,0
2019,143048,30,3,42,19,23
2019,143048,40,0,11,6,5
2019,143048,40,6,11,6,5
2019,143048,41,0,5,4,1
2019,143048,41,6,5,4,1
2019,143048,42,0,6,2,4
2019,143048,42,6,6,2,4
2019,143048,44,0,5,4,1
2019,143048,44,6,5,4,1
2019,143084,0,0,196,102,94
2019,143084,10,0,196,102,94
2019,143084,10,1,63,39,24
2019,143084,10,2,45,25,20
2019,143084,10,3,77,32,45
2019,143084,10,4,11,6,5
2019,143084,20,0,106,62,44
2019,143084,20,1,63,39,24
2019,143084,20,2,43,23,20
2019,143084,30,0,40,13,27
2019,143084,30,3,40,13,27
2019,143084,40,0,50,27,23
2019,143084,40,2,2,2,0
2019,143084,40,3,37,19,18
2019,143084,40,4,11,6,5
2019,143084,42,0,50,27,23
2019,143084,42,2,2,2,0
2019,143084,42,3,37,19,18
2019,143084,42,4,11,6,5
2019,143118,0,0,139,63,76
2019,143118,10,0,139,63,76
2019,143118,10,1,24,12,12
2019,143118,10,2,43,19,24
2019,143118,10,3,72,32,40
2019,143118,20,0,54,23,31
2019,143118,20,1,20,10,10
2019,143118,20,2,34,13,21
2019,143118,30,0,35,22,13
2019,143118,30,1,1,0,1
2019,143118,30,2,2,1,1
2019,143118,30,3,32,21,11
2019,143118,40,0,50,18,32
2019,143118,40,1,3,2,1
2019,143118,40,2,7,5,2
2019,143118,40,3,40,11,29
2019,143118,41,0,17,9,8
2019,143118,41,1,2,2,0
2019,143118,41,2,7,5,2
2019,143118,41,3,8,2,6
2019,143118,42,0,33,9,24
2019,143118,42,1,1,0,1
2019,143118,42,3,32,9,23
2019,143118,44,0,17,9,8
2019,143118,44,1,2,2,0
2019,143118,44,2,7,5,2
2019,143118,44,3,8,2,6
2019,143215,0,0,137,61,76
2019,143215,10,0,137,61,76
2019,143215,10,1,15,5,10
2019,143215,10,2,40,18,22
2019,143215,10,3,65,25,40
2019,143215,10,4,15,11,4
2019,143215,10,6,2,2,0
2019,143215,20,0,98,46,52
2019,143215,20,1,12,5,7
2019,143215,20,2,29,14,15
2019,143215,20,3,51,21,30
2019,143215,20,4,4,4,0
2019,143215,20,6,2,2,0
2019,143215,30,0,39,15,24
2019,143215,30,1,3,0,3
2019,143215,30,2,11,4,7
2019,143215,30,3,14,4,10
2019,143215,30,4,11,7,4
2019,143233,0,0,7,5,2
2019,143233,10,0,7,5,2
2019,143233,10,1,5,4,1
2019,143233,10,2,1,0,1
2019,143233,10,3,1,1,0
2019,143233,20,0,6,4,2
2019,143233,20,1,5,4,1
2019,143233,20,2,1,0,1
2019,143233,30,0,1,1,0
2019,143233,30,3,1,1,0
2019,143279,0,0,96,38,58
2019,143279,10,0,96,38,58
2019,143279,10,1,43,19,24
2019,143279,10,2,15,3,12
2019,143279,10,3,20,9,11
2019,143279,10,4,18,7,11
2019,143279,20,0,78,31,47
2019,143279,20,1,43,19,24
2019,143279,20,2,15,3,12
2019,143279,20,3,20,9,11
2019,143279,30,0,15,4,11
2019,143279,30,4,15,4,11
2019,143279,40,0,3,3,0
2019,143279,40,4,3,3,0
2019,143279,42,0,3,3,0
2019,143279,42,4,3,3,0
2019,143288,0,0,32,16,16
2019,143288,10,0,32,16,16
2019,143288,10,1,32,16,16
2019,143288,20,0,22,12,10
2019,143288,20,1,22,12,10
2019,143288,30,0,9,3,6
2019,143288,30,1,9,3,6
2019,143288,40,0,1,1,0
2019,143288,40,1,1,1,0
2019,143288,42,0,1,1,0
2019,143288,42,1,1,1,0
2019,143297,0,0,29,2,27
2019,143297,10,0,29,2,27
2019,143297,10,1,2,0,2
2019,143297,10,2,3,0,3
2019,143297,10,3,17,2,15
2019,143297,10,4,6,0,6
2019,143297,10,6,1,0,1
2019,143297,40,0,29,2,27
2019,143297,40,1,2,0,2
2019,143297,40,2,3,0,3
2019,143297,40,3,17,2,15
2019,143297,40,4,6,0,6
2019,143297,40,6,1,0,1
2019,143297,42,0,29,2,27
2019,143297,42,1,2,0,2
2019,143297,42,2,3,0,3
2019,143297,42,3,17,2,15
2019,143297,42,4,6,0,6
2019,143297,42,6,1,0,1
2019,143358,0,0,351,200,151
2019,143358,10,0,351,200,151
2019,143358,10,1,86,68,18
2019,143358,10,2,103,58,45
2019,143358,10,3,111,53,58
2019,143358,10,4,34,17,17
2019,143358,10,5,16,4,12
2019,143358,10,6,1,0,1
2019,143358,20,0,196,127,69
2019,143358,20,1,85,67,18
2019,143358,20,2,101,57,44
2019,143358,20,3,4,2,2
2019,143358,20,5,6,1,5
2019,143358,30,0,85,47,38
2019,143358,30,1,1,1,0
2019,143358,30,2,2,1,1
2019,143358,30,3,76,42,34
2019,143358,30,5,6,3,3
2019,143358,40,0,70,26,44
2019,143358,40,3,31,9,22
2019,143358,40,4,34,17,17
2019,143358,40,5,4,0,4
2019,143358,40,6,1,0,1
2019,143358,42,0,70,26,44
2019,143358,42,3,31,9,22
2019,143358,42,4,34,17,17
2019,143358,42,5,4,0,4
2019,143358,42,6,1,0,1
2019,143613,0,0,39,17,22
2019,143613,10,0,39,17,22
2019,143613,10,6,39,17,22
2019,143613,20,0,29,12,17
2019,143613,20,6,29,12,17
2019,143613,30,0,10,5,5
2019,143613,30,6,10,5,5
2019,143659,0,0,30,18,12
2019,143659,10,0,30,18,12
2019,143659,10,1,14,8,6
2019,143659,10,2,9,7,2
2019,143659,10,3,7,3,4
2019,143659,20,0,21,13,8
2019,143659,20,1,13,7,6
2019,143659,20,2,8,6,2
2019,143659,30,0,9,5,4
2019,143659,30,1,1,1,0
2019,143659,30,2,1,1,0
2019,143659,30,3,7,3,4
2019,143853,0,0,216,91,125
2019,143853,10,0,210,88,122
2019,143853,10,1,37,18,19
2019,143853,10,2,52,16,36
2019,143853,10,3,115,51,64
2019,143853,10,4,6,3,3
2019,143853,20,0,69,27,42
2019,143853,20,1,31,13,18
2019,143853,20,2,36,14,22
2019,143853,20,3,2,0,2
2019,143853,30,0,36,16,20
2019,143853,30,2,5,1,4
2019,143853,30,3,31,15,16
2019,143853,40,0,105,45,60
2019,143853,40,1,6,5,1
2019,143853,40,2,11,1,10
2019,143853,40,3,82,36,46
2019,143853,40,4,6,3,3
2019,143853,41,0,105,45,60
2019,143853,41,1,6,5,1
2019,143853,41,2,11,1,10
2019,143853,41,3,82,36,46
2019,143853,41,4,6,3,3
2019,143853,44,0,105,45,60
2019,143853,44,1,6,5,1
2019,143853,44,2,11,1,10
2019,143853,44,3,82,36,46
2019,143853,44,4,6,3,3
2019,143853,50,0,6,3,3
2019,143978,0,0,87,41,46
2019,143978,10,0,87,41,46
2019,143978,10,1,10,4,6
2019,143978,10,2,32,10,22
2019,143978,10,3,43,25,18
2019,143978,10,4,2,2,0
2019,143978,40,0,87,41,46
2019,143978,40,1,10,4,6
2019,143978,40,2,32,10,22
2019,143978,40,3,43,25,18
2019,143978,40,4,2,2,0
2019,143978,41,0,69,31,38
2019,143978,41,1,10,4,6
2019,143978,41,2,32,10,22
2019,143978,41,3,25,15,10
2019,143978,41,4,2,2,0
2019,143978,42,0,18,10,8
2019,143978,42,3,18,10,8
2019,143978,44,0,69,31,38
2019,143978,44,1,10,4,6
2019,143978,44,2,32,10,22
2019,143978,44,3,25,15,10
2019,143978,44,4,2,2,0
2019,144005,0,0,192,94,98
2019,144005,10,0,192,94,98
2019,144005,10,1,42,29,13
2019,144005,10,2,53,27,26
2019,144005,10,3,56,21,35
2019,144005,10,5,41,17,24
2019,144005,20,0,90,51,39
2019,144005,20,1,41,29,12
2019,144005,20,2,45,22,23
2019,144005,20,3,4,0,4
2019,144005,30,0,51,23,28
2019,144005,30,1,1,0,1
2019,144005,30,2,6,5,1
2019,144005,30,3,44,18,26
2019,144005,40,0,51,20,31
2019,144005,40,2,2,0,2
2019,144005,40,3,8,3,5
2019,144005,40,5,41,17,24
2019,144005,42,0,51,20,31
2019,144005,42,2,2,0,2
2019,144005,42,3,8,3,5
2019,144005,42,5,41,17,24
2019,144014,0,0,10,6,4
2019,144014,10,0,10,6,4
2019,144014,10,1,3,3,0
2019,144014,10,2,4,1,3
2019,144014,10,3,2,2,0
2019,144014,10,6,1,0,1
2019,144014,20,0,7,4,3
2019,144014,20,1,3,3,0
2019,144014,20,2,4,1,3
2019,144014,30,0,2,2,0
2019,144014,30,3,2,2,0
2019,144014,40,0,1,0,1
2019,144014,40,6,1,0,1
2019,144014,41,0,1,0,1
2019,144014,41,6,1,0,1
2019,144014,44,0,1,0,1
2019,144014,44,6,1,0,1
2019,144050,0,0,2371,1473,898
2019,144050,10,0,2371,1473,898
2019,144050,10,1,869,658,211
2019,144050,10,2,455,273,182
2019,144050,10,3,622,337,285
2019,144050,10,4,104,49,55
2019,144050,10,5,229,105,124
2019,144050,10,6,92,51,41
2019,144050,20,0,862,631,231
2019,144050,20,1,655,501,154
2019,144050,20,2,207,130,77
2019,144050,30,0,297,192,105
2019,144050,30,1,3,3,0
2019,144050,30,2,29,21,8
2019,144050,30,3,265,168,97
2019,144050,40,0,1212,650,562
2019,144050,40,1,211,154,57
2019,144050,40,2,219,122,97
2019,144050,40,3,357,169,188
2019,144050,40,4,104,49,55
2019,144050,40,5,229,105,124
2019,144050,40,6,92,51,41
2019,144050,41,0,1078,575,503
2019,144050,41,1,196,142,54
2019,144050,41,2,213,119,94
2019,144050,41,3,350,164,186
2019,144050,41,4,72,35,37
2019,144050,41,5,167,72,95
2019,144050,41,6,80,43,37
2019,144050,42,0,100,54,46
2019,144050,42,1,1,1,0
2019,144050,42,2,2,2,0
2019,144050,42,4,30,13,17
2019,144050,42,5,55,30,25
2019,144050,42,6,12,8,4
2019,144050,43,0,34,21,13
2019,144050,43,1,14,11,3
2019,144050,43,2,4,1,3
2019,144050,43,3,7,5,2
2019,144050,43,4,2,1,1
2019,144050,43,5,7,3,4
2019,144050,44,0,1045,559,486
2019,144050,44,1,193,139,54
2019,144050,44,2,213,119,94
2019,144050,44,3,350,164,186
2019,144050,44,4,72,35,37
2019,144050,44,5,137,59,78
2019,144050,44,6,80,43,37
2019,144050,45,0,33,16,17
2019,144050,45,1,3,3,0
2019,144050,45,5,30,13,17
2019,144157,0,0,66,33,33
2019,144157,10,0,66,33,33
2019,144157,10,1,4,2,2
2019,144157,10,2,11,4,7
2019,144157,10,3,19,7,12
2019,144157,10,4,22,13,9
2019,144157,10,6,10,7,3
2019,144157,20,0,53,24,29
2019,144157,20,1,4,2,2
2019,144157,20,2,11,4,7
2019,144157,20,3,19,7,12
2019,144157,20,4,19,11,8
2019,144157,30,0,3,2,1
2019,144157,30,4,3,2,1
2019,144157,40,0,10,7,3
2019,144157,40,6,10,7,3
2019,144157,42,0,10,7,3
2019,144157,42,6,10,7,3
2019,144166,0,0,108,36,72
2019,144166,10,0,108,36,72
2019,144166,10,1,3,2,1
2019,144166,10,2,12,2,10
2019,144166,10,3,30,7,23
2019,144166,10,4,63,25,38
2019,144166,20,0,93,30,63
2019,144166,20,1,3,2,1
2019,144166,20,2,12,2,10
2019,144166,20,3,30,7,23
2019,144166,20,4,48,19,29
2019,144166,30,0,15,6,9
2019,144166,30,4,15,6,9
2019,144175,0,0,44,19,25
2019,144175,10,0,44,19,25
2019,144175,10,1,3,1,2
2019,144175,10,2,10,3,7
2019,144175,10,3,20,6,14
2019,144175,10,4,11,9,2
2019,144175,20,0,43,18,25
2019,144175,20,1,3,1,2
2019,144175,20,2,10,3,7
2019,144175,20,3,20,6,14
2019,144175,20,4,10,8,2
2019,144175,30,0,1,1,0
2019,144175,30,4,1,1,0
2019,144184,0,0,64,32,32
2019,144184,10,0,64,32,32
2019,144184,10,1,5,4,1
2019,144184,10,2,12,6,6
2019,144184,10,3,12,7,5
2019,144184,10,4,32,14,18
2019,144184,10,6,3,1,2
2019,144184,20,0,55,28,27
2019,144184,20,1,5,4,1
2019,144184,20,2,12,6,6
2019,144184,20,3,12,7,5
2019,144184,20,4,26,11,15
2019,144184,30,0,6,3,3
2019,144184,30,4,6,3,3
2019,144184,40,0,3,1,2
2019,144184,40,6,3,1,2
2019,144184,42,0,3,1,2
2019,144184,42,6,3,1,2
2019,144193,0,0,53,26,27
2019,144193,10,0,53,26,27
2019,144193,10,1,4,1,3
2019,144193,10,2,10,5,5
2019,144193,10,3,14,5,9
2019,144193,10,4,25,15,10
2019,144193,20,0,48,22,26
2019,144193,20,1,4,1,3
2019,144193,20,2,10,5,5
2019,144193,20,3,14,5,9
2019,144193,20,4,20,11,9
2019,144193,30,0,5,4,1
2019,144193,30,4,5,4,1
2019,144209,0,0,102,42,60
2019,144209,10,0,102,42,60
2019,144209,10,1,10,6,4
2019,144209,10,2,29,9,20
2019,144209,10,3,40,19,21
2019,144209,10,4,23,8,15
2019,144209,20,0,99,42,57
2019,144209,20,1,10,6,4
2019,144209,20,2,29,9,20
2019,144209,20,3,40,19,21
2019,144209,20,4,20,8,12
2019,144209,30,0,3,0,3
2019,144209,30,4,3,0,3
2019,144218,0,0,88,38,50
2019,144218,10,0,88,38,50
2019,144218,10,1,20,5,15
2019,144218,10,2,23,10,13
2019,144218,10,3,28,14,14
2019,144218,10,4,17,9,8
2019,144218,20,0,84,37,47
2019,144218,20,1,20,5,15
2019,144218,20,2,23,10,13
2019,144218,20,3,28,14,14
2019,144218,20,4,13,8,5
2019,144218,30,0,4,1,3
2019,144218,30,4,4,1,3
2019,144281,0,0,259,143,116
2019,144281,10,0,259,143,116
2019,144281,10,1,34,21,13
2019,144281,10,2,141,76,65
2019,144281,10,3,27,14,13
2019,144281,10,5,57,32,25
2019,144281,20,0,175,97,78
2019,144281,20,1,34,21,13
2019,144281,20,2,141,76,65
2019,144281,30,0,27,14,13
2019,144281,30,3,27,14,13
2019,144281,40,0,57,32,25
2019,144281,40,5,57,32,25
2019,144281,41,0,57,32,25
2019,144281,41,5,57,32,25
2019,144281,44,0,57,32,25
2019,144281,44,5,57,32,25
2019,144351,0,0,301,133,168
2019,144351,10,0,301,133,168
2019,144351,10,1,56,25,31
2019,144351,10,2,60,26,34
2019,144351,10,3,51,22,29
2019,144351,10,4,134,60,74
2019,144351,20,0,58,26,32
2019,144351,20,1,47,20,27
2019,144351,20,2,11,6,5
2019,144351,30,0,83,34,49
2019,144351,30,1,7,3,4
2019,144351,30,2,42,17,25
2019,144351,30,3,34,14,20
2019,144351,40,0,160,73,87
2019,144351,40,1,2,2,0
2019,144351,40,2,7,3,4
2019,144351,40,3,17,8,9
2019,144351,40,4,134,60,74
2019,144351,41,0,2,1,1
2019,144351,41,3,2,1,1
2019,144351,42,0,25,12,13
2019,144351,42,1,2,2,0
2019,144351,42,2,7,3,4
2019,144351,42,3,14,6,8
2019,144351,42,4,2,1,1
2019,144351,43,0,133,60,73
2019,144351,43,3,1,1,0
2019,144351,43,4,132,59,73
2019,144351,44,0,2,1,1
2019,144351,44,3,2,1,1
2019,144485,0,0,13,9,4
2019,144485,10,0,13,9,4
2019,144485,10,4,13,9,4
2019,144485,40,0,13,9,4
2019,144485,40,4,13,9,4
2019,144485,41,0,13,9,4
2019,144485,41,4,13,9,4
2019,144485,45,0,13,9,4
2019,144485,45,4,13,9,4
2019,144564,0,0,61,27,34
2019,144564,10,0,61,27,34
2019,144564,10,1,29,13,16
2019,144564,10,4,31,13,18
2019,144564,10,6,1,1,0
2019,144564,20,0,43,21,22
2019,144564,20,1,25,12,13
2019,144564,20,4,18,9,9
2019,144564,30,0,18,6,12
2019,144564,30,1,4,1,3
2019,144564,30,4,13,4,9
2019,144564,30,6,1,1,0
2019,144740,0,0,870,467,403
2019,144740,10,0,870,467,403
2019,144740,10,1,190,119,71
2019,144740,10,2,336,172,164
2019,144740,10,3,116,55,61
2019,144740,10,4,228,121,107
2019,144740,20,0,522,292,230
2019,144740,20,1,190,119,71
2019,144740,20,2,331,172,159
2019,144740,20,3,1,1,0
2019,144740,30,0,117,53,64
2019,144740,30,2,4,0,4
2019,144740,30,3,113,53,60
2019,144740,40,0,231,122,109
2019,144740,40,2,1,0,1
2019,144740,40,3,2,1,1
2019,144740,40,4,228,121,107
2019,144740,41,0,40,17,23
2019,144740,41,4,40,17,23
2019,144740,42,0,191,105,86
2019,144740,42,2,1,0,1
2019,144740,42,3,2,1,1
2019,144740,42,4,188,104,84
2019,144740,44,0,40,17,23
2019,144740,44,4,40,17,23
2019,144865,0,0,276,135,141
2019,144865,10,0,276,135,141
2019,144865,10,1,112,63,49
2019,144865,10,2,68,37,31
2019,144865,10,3,74,29,45
2019,144865,10,4,22,6,16
2019,144865,20,0,271,132,139
2019,144865,20,1,112,63,49
2019,144865,20,2,68,37,31
2019,144865,20,3,71,27,44
2019,144865,20,4,20,5,15
2019,144865,40,0,5,3,2
2019,144865,40,3,3,2,1
2019,144865,40,4,2,1,1
2019,144865,42,0,5,3,2
2019,144865,42,3,3,2,1
2019,144865,42,4,2,1,1
2019,144883,0,0,10,6,4
2019,144883,10,0,10,6,4
2019,144883,10,2,3,0,3
2019,144883,10,3,7,6,1
2019,144883,40,0,10,6,4
2019,144883,40,2,3,0,3
2019,144883,40,3,7,6,1
2019,144883,42,0,10,6,4
2019,144883,42,2,3,0,3
2019,144883,42,3,7,6,1
2019,144892,0,0,370,197,173
2019,144892,10,0,370,197,173
2019,144892,10,1,132,74,58
2019,144892,10,2,80,47,33
2019,144892,10,3,46,19,27
2019,144892,10,4,112,57,55
2019,144892,20,0,211,121,90
2019,144892,20,1,132,74,58
2019,144892,20,2,76,45,31
2019,144892,20,3,3,2,1
2019,144892,30,0,42,17,25
2019,144892,30,2,4,2,2
2019,144892,30,3,36,14,22
2019,144892,30,4,2,1,1
2019,144892,40,0,117,59,58
2019,144892,40,3,7,3,4
2019,144892,40,4,110,56,54
2019,144892,41,0,43,18,25
2019,144892,41,3,2,1,1
2019,144892,41,4,41,17,24
2019,144892,42,0,59,32,27
2019,144892,42,3,5,2,3
2019,144892,42,4,54,30,24
2019,144892,43,0,15,9,6
2019,144892,43,4,15,9,6
2019,144892,44,0,43,18,25
2019,144892,44,3,2,1,1
2019,144892,44,4,41,17,24
2019,144944,0,0,129,61,68
2019,144944,10,0,129,61,68
2019,144944,10,1,59,26,33
2019,144944,10,2,24,13,11
2019,144944,10,3,28,17,11
2019,144944,10,4,18,5,13
2019,144944,20,0,105,51,54
2019,144944,20,1,59,26,33
2019,144944,20,2,23,12,11
2019,144944,20,3,21,13,8
2019,144944,20,4,2,0,2
2019,144944,30,0,23,10,13
2019,144944,30,2,1,1,0
2019,144944,30,3,7,4,3
2019,144944,30,4,15,5,10
2019,144944,40,0,1,0,1
2019,144944,40,4,1,0,1
2019,144944,42,0,1,0,1
2019,144944,42,4,1,0,1
2019,144962,0,0,159,60,99
2019,144962,10,0,158,59,99
2019,144962,10,1,54,24,30
2019,144962,10,2,37,14,23
2019,144962,10,3,44,15,29
2019,144962,10,4,1,0,1
2019,144962,10,5,17,5,12
2019,144962,10,6,5,1,4
2019,144962,20,0,86,36,50
2019,144962,20,1,54,24,30
2019,144962,20,2,31,12,19
2019,144962,20,3,1,0,1
2019,144962,30,0,27,10,17
2019,144962,30,3,25,10,15
2019,144962,30,4,1,0,1
2019,144962,30,6,1,0,1
2019,144962,40,0,45,13,32
2019,144962,40,2,6,2,4
2019,144962,40,3,18,5,13
2019,144962,40,5,17,5,12
2019,144962,40,6,4,1,3
2019,144962,42,0,45,13,32
2019,144962,42,2,6,2,4
2019,144962,42,3,18,5,13
2019,144962,42,5,17,5,12
2019,144962,42,6,4,1,3
2019,144962,50,0,1,1,0
2019,144971,0,0,33,15,18
2019,144971,10,0,33,15,18
2019,144971,10,1,6,2,4
2019,144971,10,2,12,6,6
2019,144971,10,3,15,7,8
2019,144971,20,0,15,7,8
2019,144971,20,1,6,2,4
2019,144971,20,2,9,5,4
2019,144971,30,0,8,4,4
2019,144971,30,3,8,4,4
2019,144971,40,0,10,4,6
2019,144971,40,2,3,1,2
2019,144971,40,3,7,3,4
2019,144971,42,0,10,4,6
2019,144971,42,2,3,1,2
2019,144971,42,3,7,3,4
2019,145239,0,0,35,2,33
2019,145239,10,0,35,2,33
2019,145239,10,4,35,2,33
2019,145239,40,0,35,2,33
2019,145239,40,4,35,2,33
2019,145239,41,0,35,2,33
2019,145239,41,4,35,2,33
2019,145239,45,0,35,2,33
2019,145239,45,4,35,2,33
2019,145275,0,0,26,17,9
2019,145275,10,0,26,17,9
2019,145275,10,1,12,8,4
2019,145275,10,2,8,5,3
2019,145275,10,3,5,3,2
2019,145275,10,4,1,1,0
2019,145275,20,0,11,6,5
2019,145275,20,1,9,5,4
2019,145275,20,2,2,1,1
2019,145275,30,0,2,1,1
2019,145275,30,1,1,1,0
2019,145275,30,3,1,0,1
2019,145275,40,0,13,10,3
2019,145275,40,1,2,2,0
2019,145275,40,2,6,4,2
2019,145275,40,3,4,3,1
2019,145275,40,4,1,1,0
2019,145275,41,0,13,10,3
2019,145275,41,1,2,2,0
2019,145275,41,2,6,4,2
2019,145275,41,3,4,3,1
2019,145275,41,4,1,1,0
2019,145275,44,0,13,10,3
2019,145275,44,1,2,2,0
2019,145275,44,2,6,4,2
2019,145275,44,3,4,3,1
2019,145275,44,4,1,1,0
2019,145336,0,0,227,94,133
2019,145336,10,0,227,94,133
2019,145336,10,1,29,16,13
2019,145336,10,2,66,33,33
2019,145336,10,3,62,17,45
2019,145336,10,4,2,0,2
2019,145336,10,5,60,24,36
2019,145336,10,6,8,4,4
2019,145336,20,0,80,42,38
2019,145336,20,1,29,16,13
2019,145336,20,2,51,26,25
2019,145336,30,0,79,24,55
2019,145336,30,2,15,7,8
2019,145336,30,3,62,17,45
2019,145336,30,4,2,0,2
2019,145336,40,0,68,28,40
2019,145336,40,5,60,24,36
2019,145336,40,6,8,4,4
2019,145336,41,0,8,5,3
2019,145336,41,5,8,5,3
2019,145336,42,0,60,23,37
2019,145336,42,5,52,19,33
2019,145336,42,6,8,4,4
2019,145336,44,0,8,5,3
2019,145336,44,5,8,5,3
2019,145372,0,0,63,41,22
2019,145372,10,0,63,41,22
2019,145372,10,1,10,9,1
2019,145372,10,2,14,8,6
2019,145372,10,3,29,18,11
2019,145372,10,4,8,5,3
2019,145372,10,6,2,1,1
2019,145372,20,0,27,18,9
2019,145372,20,1,10,9,1
2019,145372,20,2,12,6,6
2019,145372,20,3,5,3,2
2019,145372,30,0,19,13,6
2019,145372,30,2,1,1,0
2019,145372,30,3,18,12,6
2019,145372,40,0,17,10,7
2019,145372,40,2,1,1,0
2019,145372,40,3,6,3,3
2019,145372,40,4,8,5,3
2019,145372,40,6,2,1,1
2019,145372,42,0,2,1,1
2019,145372,42,3,1,1,0
2019,145372,42,6,1,0,1
2019,145372,43,0,15,9,6
2019,145372,43,2,1,1,0
2019,145372,43,3,5,2,3
2019,145372,43,4,8,5,3
2019,145372,43,6,1,1,0
2019,145497,0,0,14,9,5
2019,145497,10,0,14,9,5
2019,145497,10,1,1,1,0
2019,145497,10,2,3,0,3
2019,145497,10,3,10,8,2
2019,145497,40,0,14,9,5
2019,145497,40,1,1,1,0
2019,145497,40,2,3,0,3
2019,145497,40,3,10,8,2
2019,145497,42,0,14,9,5
2019,145497,42,1,1,1,0
2019,145497,42,2,3,0,3
2019,145497,42,3,10,8,2
2019,145521,0,0,49,24,25
2019,145521,10,0,49,24,25
2019,145521,10,6,49,24,25
2019,145521,20,0,37,19,18
2019,145521,20,6,37,19,18
2019,145521,30,0,12,5,7
2019,145521,30,6,12,5,7
2019,145558,0,0,166,93,73
2019,145558,10,0,164,92,72
2019,145558,10,1,36,25,11
2019,145558,10,2,45,28,17
2019,145558,10,3,68,31,37
2019,145558,10,4,14,8,6
2019,145558,10,5,1,0,1
2019,145558,20,0,35,24,11
2019,145558,20,1,29,21,8
2019,145558,20,2,6,3,3
2019,145558,30,0,62,38,24
2019,145558,30,1,2,1,1
2019,145558,30,2,22,18,4
2019,145558,30,3,32,17,15
2019,145558,30,4,6,2,4
2019,145558,40,0,67,30,37
2019,145558,40,1,5,3,2
2019,145558,40,2,17,7,10
2019,145558,40,3,36,14,22
2019,145558,40,4,8,6,2
2019,145558,40,5,1,0,1
2019,145558,41,0,23,10,13
2019,145558,41,2,12,5,7
2019,145558,41,3,10,5,5
2019,145558,41,4,1,0,1
2019,145558,42,0,44,20,24
2019,145558,42,1,5,3,2
2019,145558,42,2,5,2,3
2019,145558,42,3,26,9,17
2019,145558,42,4,7,6,1
2019,145558,42,5,1,0,1
2019,145558,44,0,23,10,13
2019,145558,44,2,12,5,7
2019,145558,44,3,10,5,5
2019,145558,44,4,1,0,1
2019,145558,50,0,2,1,1
2019,145600,0,0,2185,1131,1054
2019,145600,10,0,2185,1131,1054
2019,145600,10,1,522,342,180
2019,145600,10,2,567,292,275
2019,145600,10,3,749,354,395
2019,145600,10,4,138,48,90
2019,145600,10,5,198,93,105
2019,145600,10,6,11,2,9
2019,145600,20,0,887,538,349
2019,145600,20,1,466,313,153
2019,145600,20,2,401,215,186
2019,145600,20,3,19,9,10
2019,145600,20,6,1,1,0
2019,145600,30,0,398,220,178
2019,145600,30,1,15,11,4
2019,145600,30,2,49,28,21
2019,145600,30,3,334,181,153
2019,145600,40,0,900,373,527
2019,145600,40,1,41,18,23
2019,145600,40,2,117,49,68
2019,145600,40,3,396,164,232
2019,145600,40,4,138,48,90
2019,145600,40,5,198,93,105
2019,145600,40,6,10,1,9
2019,145600,41,0,230,97,133
2019,145600,41,1,16,7,9
2019,145600,41,2,70,32,38
2019,145600,41,3,82,34,48
2019,145600,41,4,4,0,4
2019,145600,41,5,58,24,34
2019,145600,42,0,668,276,392
2019,145600,42,1,25,11,14
2019,145600,42,2,47,17,30
2019,145600,42,3,314,130,184
2019,145600,42,4,134,48,86
2019,145600,42,5,138,69,69
2019,145600,42,6,10,1,9
2019,145600,43,0,2,0,2
2019,145600,43,5,2,0,2
2019,145600,44,0,230,97,133
2019,145600,44,1,16,7,9
2019,145600,44,2,70,32,38
2019,145600,44,3,82,34,48
2019,145600,44,4,4,0,4
2019,145600,44,5,58,24,34
2019,145619,0,0,140,67,73
2019,145619,10,0,140,67,73
2019,145619,10,1,49,26,23
2019,145619,10,2,33,14,19
2019,145619,10,3,46,20,26
2019,145619,10,4,12,7,5
2019,145619,20,0,73,37,36
2019,145619,20,1,48,26,22
2019,145619,20,2,25,11,14
2019,145619,30,0,35,13,22
2019,145619,30,2,5,1,4
2019,145619,30,3,30,12,18
2019,145619,40,0,32,17,15
2019,145619,40,1,1,0,1
2019,145619,40,2,3,2,1
2019,145619,40,3,16,8,8
2019,145619,40,4,12,7,5
2019,145619,41,0,6,3,3
2019,145619,41,1,1,0,1
2019,145619,41,2,2,2,0
2019,145619,41,3,3,1,2
2019,145619,42,0,26,14,12
2019,145619,42,2,1,0,1
2019,145619,42,3,13,7,6
2019,145619,42,4,12,7,5
2019,145619,44,0,6,3,3
2019,145619,44,1,1,0,1
2019,145619,44,2,2,2,0
2019,145619,44,3,3,1,2
2019,145628,0,0,51,12,39
2019,145628,10,0,50,12,38
2019,145628,10,1,7,2,5
2019,145628,10,2,26,9,17
2019,145628,10,3,15,1,14
2019,145628,10,4,2,0,2
2019,145628,20,0,35,11,24
2019,145628,20,1,7,2,5
2019,145628,20,2,22,8,14
2019,145628,20,3,4,1,3
2019,145628,20,4,2,0,2
2019,145628,30,0,15,1,14
2019,145628,30,2,4,1,3
2019,145628,30,3,11,0,11
2019,145628,50,0,1,0,1
2019,145637,0,0,2361,1436,925
2019,145637,10,0,2361,1436,925
2019,145637,10,1,847,615,232
2019,145637,10,2,515,299,216
2019,145637,10,3,692,367,325
2019,145637,10,4,97,46,51
2019,145637,10,5,179,91,88
2019,145637,10,6,31,18,13
2019,145637,20,0,1266,863,403
2019,145637,20,1,819,602,217
2019,145637,20,2,446,261,185
2019,145637,20,3,1,0,1
2019,145637,30,0,511,287,224
2019,145637,30,1,1,1,0
2019,145637,30,2,5,3,2
2019,145637,30,3,505,283,222
2019,145637,40,0,584,286,298
2019,145637,40,1,27,12,15
2019,145637,40,2,64,35,29
2019,145637,40,3,186,84,102
2019,145637,40,4,97,46,51
2019,145637,40,5,179,91,88
2019,145637,40,6,31,18,13
2019,145637,41,0,45,25,20
2019,145637,41,1,14,6,8
2019,145637,41,2,19,11,8
2019,145637,41,3,10,7,3
2019,145637,41,5,2,1,1
2019,145637,42,0,539,261,278
2019,145637,42,1,13,6,7
2019,145637,42,2,45,24,21
2019,145637,42,3,176,77,99
2019,145637,42,4,97,46,51
2019,145637,42,5,177,90,87
2019,145637,42,6,31,18,13
2019,145637,44,0,45,25,20
2019,145637,44,1,14,6,8
2019,145637,44,2,19,11,8
2019,145637,44,3,10,7,3
2019,145637,44,5,2,1,1
2019,145646,0,0,128,72,56
2019,145646,10,0,128,72,56
2019,145646,10,1,48,34,14
2019,145646,10,2,49,23,26
2019,145646,10,3,31,15,16
2019,145646,20,0,95,54,41
2019,145646,20,1,46,32,14
2019,145646,20,2,46,21,25
2019,145646,20,3,3,1,2
2019,145646,30,0,23,11,12
2019,145646,30,1,1,1,0
2019,145646,30,2,1,1,0
2019,145646,30,3,21,9,12
2019,145646,40,0,10,7,3
2019,145646,40,1,1,1,0
2019,145646,40,2,2,1,1
2019,145646,40,3,7,5,2
2019,145646,42,0,10,7,3
2019,145646,42,1,1,1,0
2019,145646,42,2,2,1,1
2019,145646,42,3,7,5,2
2019,145682,0,0,170,82,88
2019,145682,10,0,170,82,88
2019,145682,10,1,101,44,57
2019,145682,10,2,26,15,11
2019,145682,10,3,17,9,8
2019,145682,10,4,26,14,12
2019,145682,20,0,140,66,74
2019,145682,20,1,101,44,57
2019,145682,20,2,26,15,11
2019,145682,20,3,13,7,6
2019,145682,30,0,20,11,9
2019,145682,30,3,4,2,2
2019,145682,30,4,16,9,7
2019,145682,40,0,10,5,5
2019,145682,40,4,10,5,5
2019,145682,42,0,10,5,5
2019,145682,42,4,10,5,5
2019,145691,0,0,72,37,35
2019,145691,10,0,72,37,35
2019,145691,10,1,20,12,8
2019,145691,10,2,19,12,7
2019,145691,10,3,23,8,15
2019,145691,10,4,10,5,5
2019,145691,20,0,39,24,15
2019,145691,20,1,20,12,8
2019,145691,20,2,19,12,7
2019,145691,30,0,16,7,9
2019,145691,30,3,13,6,7
2019,145691,30,4,3,1,2
2019,145691,40,0,17,6,11
2019,145691,40,3,10,2,8
2019,145691,40,4,7,4,3
2019,145691,41,0,14,5,9
2019,145691,41,3,8,1,7
2019,145691,41,4,6,4,2
2019,145691,42,0,3,1,2
2019,145691,42,3,2,1,1
2019,145691,42,4,1,0,1
2019,145691,44,0,14,5,9
2019,145691,44,3,8,1,7
2019,145691,44,4,6,4,2
2019,145707,0,0,39,14,25
2019,145707,10,0,39,14,25
2019,145707,10,1,6,3,3
2019,145707,10,2,7,1,6
2019,145707,10,3,12,5,7
2019,145707,10,4,14,5,9
2019,145707,20,0,29,12,17
2019,145707,20,1,6,3,3
2019,145707,20,2,7,1,6
2019,145707,20,3,12,5,7
2019,145707,20,4,4,3,1
2019,145707,30,0,10,2,8
2019,145707,30,4,10,2,8
2019,145725,0,0,402,287,115
2019,145725,10,0,402,287,115
2019,145725,10,1,137,109,28
2019,145725,10,2,93,74,19
2019,145725,10,3,67,37,30
2019,145725,10,4,8,4,4
2019,145725,10,5,31,22,9
2019,145725,10,6,66,41,25
2019,145725,20,0,215,168,47
2019,145725,20,1,114,94,20
2019,145725,20,2,78,63,15
2019,145725,20,3,23,11,12
2019,145725,30,0,49,35,14
2019,145725,30,3,28,20,8
2019,145725,30,5,1,1,0
2019,145725,30,6,20,14,6
2019,145725,40,0,138,84,54
2019,145725,40,1,23,15,8
2019,145725,40,2,15,11,4
2019,145725,40,3,16,6,10
2019,145725,40,4,8,4,4
2019,145725,40,5,30,21,9
2019,145725,40,6,46,27,19
2019,145725,42,0,138,84,54
2019,145725,42,1,23,15,8
2019,145725,42,2,15,11,4
2019,145725,42,3,16,6,10
2019,145725,42,4,8,4,4
2019,145725,42,5,30,21,9
2019,145725,42,6,46,27,19
2019,145813,0,0,905,419,486
2019,145813,10,0,905,419,486
2019,145813,10,1,234,143,91
2019,145813,10,2,252,120,132
2019,145813,10,3,194,87,107
2019,145813,10,5,225,69,156
2019,145813,20,0,481,261,220
2019,145813,20,1,234,143,91
2019,145813,20,2,244,116,128
2019,145813,20,3,3,2,1
2019,145813,30,0,199,89,110
2019,145813,30,2,8,4,4
2019,145813,30,3,191,85,106
2019,145813,40,0,225,69,156
2019,145813,40,5,225,69,156
2019,145813,42,0,210,66,144
2019,145813,42,5,210,66,144
2019,145813,43,0,15,3,12
2019,145813,43,5,15,3,12
2019,145831,0,0,75,38,37
2019,145831,10,0,75,38,37
2019,145831,10,4,75,38,37
2019,145831,20,0,61,31,30
2019,145831,20,4,61,31,30
2019,145831,30,0,14,7,7
2019,145831,30,4,14,7,7
2019,146205,0,0,69,30,39
2019,146205,10,0,69,30,39
2019,146205,10,1,11,4,7
2019,146205,10,2,10,3,7
2019,146205,10,3,26,11,15
2019,146205,10,4,22,12,10
2019,146205,20,0,47,18,29
2019,146205,20,1,11,4,7
2019,146205,20,2,10,3,7
2019,146205,20,3,26,11,15
2019,146205,30,0,22,12,10
2019,146205,30,4,22,12,10
2019,146241,0,0,62,34,28
2019,146241,10,0,57,33,24
2019,146241,10,1,42,27,15
2019,146241,10,2,4,2,2
2019,146241,10,3,6,1,5
2019,146241,10,5,5,3,2
2019,146241,20,0,31,20,11
2019,146241,20,1,27,18,9
2019,146241,20,2,4,2,2
2019,146241,30,0,6,1,5
2019,146241,30,3,6,1,5
2019,146241,40,0,20,12,8
2019,146241,40,1,15,9,6
2019,146241,40,5,5,3,2
2019,146241,41,0,7,4,3
2019,146241,41,1,7,4,3
2019,146241,42,0,11,7,4
2019,146241,42,1,6,4,2
2019,146241,42,5,5,3,2
2019,146241,43,0,2,1,1
2019,146241,43,1,2,1,1
2019,146241,44,0,7,4,3
2019,146241,44,1,7,4,3
2019,146241,50,0,5,1,4
2019,146278,0,0,48,27,21
2019,146278,10,0,48,27,21
2019,146278,10,1,7,5,2
2019,146278,10,2,2,2,0
2019,146278,10,3,26,12,14
2019,146278,10,4,11,8,3
2019,146278,10,6,2,0,2
2019,146278,20,0,30,18,12
2019,146278,20,1,7,5,2
2019,146278,20,2,2,2,0
2019,146278,20,3,21,11,10
2019,146278,30,0,15,7,8
2019,146278,30,3,5,1,4
2019,146278,30,4,8,6,2
2019,146278,30,6,2,0,2
2019,146278,40,0,3,2,1
2019,146278,40,4,3,2,1
2019,146278,42,0,3,2,1
2019,146278,42,4,3,2,1
2019,146296,0,0,211,101,110
2019,146296,10,0,211,101,110
2019,146296,10,6,211,101,110
2019,146296,20,0,183,88,95
2019,146296,20,6,183,88,95
2019,146296,30,0,28,13,15
2019,146296,30,6,28,13,15
2019,146339,0,0,43,24,19
2019,146339,10,0,43,24,19
2019,146339,10,1,20,13,7
2019,146339,10,2,8,4,4
2019,146339,10,3,15,7,8
2019,146339,20,0,18,11,7
2019,146339,20,1,16,11,5
2019,146339,20,2,2,0,2
2019,146339,30,0,5,3,2
2019,146339,30,2,2,2,0
2019,146339,30,3,3,1,2
2019,146339,40,0,20,10,10
2019,146339,40,1,4,2,2
2019,146339,40,2,4,2,2
2019,146339,40,3,12,6,6
2019,146339,41,0,1,0,1
2019,146339,41,1,1,0,1
2019,146339,42,0,19,10,9
2019,146339,42,1,3,2,1
2019,146339,42,2,4,2,2
2019,146339,42,3,12,6,6
2019,146339,44,0,1,0,1
2019,146339,44,1,1,0,1
2019,146348,0,0,66,24,42
2019,146348,10,0,66,24,42
2019,146348,10,1,57,21,36
2019,146348,10,3,8,3,5
2019,146348,10,6,1,0,1
2019,146348,20,0,56,20,36
2019,146348,20,1,56,20,36
2019,146348,30,0,10,4,6
2019,146348,30,1,1,1,0
2019,146348,30,3,8,3,5
2019,146348,30,6,1,0,1
2019,146366,0,0,69,34,35
2019,146366,10,0,69,34,35
2019,146366,10,1,24,13,11
2019,146366,10,2,12,5,7
2019,146366,10,3,33,16,17
2019,146366,20,0,52,26,26
2019,146366,20,1,24,13,11
2019,146366,20,2,12,5,7
2019,146366,20,3,16,8,8
2019,146366,30,0,17,8,9
2019,146366,30,3,17,8,9
2019,146418,0,0,60,31,29
2019,146418,10,0,60,31,29
2019,146418,10,6,60,31,29
2019,146418,20,0,56,29,27
2019,146418,20,6,56,29,27
2019,146418,30,0,4,2,2
2019,146418,30,6,4,2,2
2019,146427,0,0,109,67,42
2019,146427,10,0,109,67,42
2019,146427,10,1,32,18,14
2019,146427,10,2,38,22,16
2019,146427,10,3,33,22,11
2019,146427,10,4,6,5,1
2019,146427,20,0,66,39,27
2019,146427,20,1,31,17,14
2019,146427,20,2,34,21,13
2019,146427,20,3,1,1,0
2019,146427,30,0,26,15,11
2019,146427,30,2,4,1,3
2019,146427,30,3,22,14,8
2019,146427,40,0,17,13,4
2019,146427,40,1,1,1,0
2019,146427,40,3,10,7,3
2019,146427,40,4,6,5,1
2019,146427,41,0,13,10,3
2019,146427,41,1,1,1,0
2019,146427,41,3,6,4,2
2019,146427,41,4,6,5,1
2019,146427,42,0,4,3,1
2019,146427,42,3,4,3,1
2019,146427,44,0,13,10,3
2019,146427,44,1,1,1,0
2019,146427,44,3,6,4,2
2019,146427,44,4,6,5,1
2019,146472,0,0,203,94,109
2019,146472,10,0,203,94,109
2019,146472,10,4,203,94,109
2019,146472,20,0,176,79,97
2019,146472,20,4,176,79,97
2019,146472,30,0,26,15,11
2019,146472,30,4,26,15,11
2019,146472,40,0,1,0,1
2019,146472,40,4,1,0,1
2019,146472,41,0,1,0,1
2019,146472,41,4,1,0,1
2019,146472,44,0,1,0,1
2019,146472,44,4,1,0,1
2019,146481,0,0,101,53,48
2019,146481,10,0,101,53,48
2019,146481,10,1,26,18,8
2019,146481,10,2,30,15,15
2019,146481,10,3,34,14,20
2019,146481,10,4,4,2,2
2019,146481,10,5,6,3,3
2019,146481,10,6,1,1,0
2019,146481,20,0,56,33,23
2019,146481,20,1,26,18,8
2019,146481,20,2,30,15,15
2019,146481,30,0,29,12,17
2019,146481,30,3,29,12,17
2019,146481,40,0,16,8,8
2019,146481,40,3,5,2,3
2019,146481,40,4,4,2,2
2019,146481,40,5,6,3,3
2019,146481,40,6,1,1,0
2019,146481,41,0,16,8,8
2019,146481,41,3,5,2,3
2019,146481,41,4,4,2,2
2019,146481,41,5,6,3,3
2019,146481,41,6,1,1,0
2019,146481,44,0,4,2,2
2019,146481,44,4,4,2,2
2019,146481,45,0,12,6,6
2019,146481,45,3,5,2,3
2019,146481,45,5,6,3,3
2019,146481,45,6,1,1,0
2019,146506,0,0,104,46,58
2019,146506,10,0,104,46,58
2019,146506,10,6,104,46,58
2019,146506,20,0,56,28,28
2019,146506,20,6,56,28,28
2019,146506,30,0,39,14,25
2019,146506,30,6,39,14,25
2019,146506,40,0,9,4,5
2019,146506,40,6,9,4,5
2019,146506,42,0,9,4,5
2019,146506,42,6,9,4,5
2019,146533,0,0,17,3,14
2019,146533,10,0,17,3,14
2019,146533,10,2,2,0,2
2019,146533,10,3,1,0,1
2019,146533,10,4,14,3,11
2019,146533,40,0,17,3,14
2019,146533,40,2,2,0,2
2019,146533,40,3,1,0,1
2019,146533,40,4,14,3,11
2019,146533,42,0,16,2,14
2019,146533,42,2,2,0,2
2019,146533,42,3,1,0,1
2019,146533,42,4,13,2,11
2019,146533,43,0,1,1,0
2019,146533,43,4,1,1,0
2019,146603,0,0,101,43,58
2019,146603,10,0,101,43,58
2019,146603,10,1,51,21,30
2019,146603,10,2,30,10,20
2019,146603,10,3,10,7,3
2019,146603,10,4,10,5,5
2019,146603,20,0,95,42,53
2019,146603,20,1,50,21,29
2019,146603,20,2,27,9,18
2019,146603,20,3,10,7,3
2019,146603,20,4,8,5,3
2019,146603,30,0,6,1,5
2019,146603,30,1,1,0,1
2019,146603,30,2,3,1,2
2019,146603,30,4,2,0,2
2019,146612,0,0,228,113,115
2019,146612,10,0,228,113,115
2019,146612,10,1,54,33,21
2019,146612,10,2,62,29,33
2019,146612,10,3,95,43,52
2019,146612,10,4,17,8,9
2019,146612,20,0,74,39,35
2019,146612,20,1,49,29,20
2019,146612,20,2,25,10,15
2019,146612,30,0,54,26,28
2019,146612,30,1,3,2,1
2019,146612,30,2,19,9,10
2019,146612,30,3,32,15,17
2019,146612,40,0,100,48,52
2019,146612,40,1,2,2,0
2019,146612,40,2,18,10,8
2019,146612,40,3,63,28,35
2019,146612,40,4,17,8,9
2019,146612,42,0,100,48,52
2019,146612,42,1,2,2,0
2019,146612,42,2,18,10,8
2019,146612,42,3,63,28,35
2019,146612,42,4,17,8,9
2019,146667,0,0,25,20,5
2019,146667,10,0,25,20,5
2019,146667,10,1,16,15,1
2019,146667,10,2,5,2,3
2019,146667,10,3,4,3,1
2019,146667,40,0,25,20,5
2019,146667,40,1,16,15,1
2019,146667,40,2,5,2,3
2019,146667,40,3,4,3,1
2019,146667,42,0,25,20,5
2019,146667,42,1,16,15,1
2019,146667,42,2,5,2,3
2019,146667,42,3,4,3,1
2019,146676,0,0,32,14,18
2019,146676,10,0,32,14,18
2019,146676,10,2,14,7,7
2019,146676,10,3,18,7,11
2019,146676,20,0,12,5,7
2019,146676,20,2,9,4,5
2019,146676,20,3,3,1,2
2019,146676,30,0,20,9,11
2019,146676,30,2,5,3,2
2019,146676,30,3,15,6,9
2019,146685,0,0,113,49,64
2019,146685,10,0,113,49,64
2019,146685,10,1,74,37,37
2019,146685,10,2,4,1,3
2019,146685,10,3,20,5,15
2019,146685,10,4,15,6,9
2019,146685,20,0,91,43,48
2019,146685,20,1,74,37,37
2019,146685,20,2,4,1,3
2019,146685,20,3,6,1,5
2019,146685,20,4,7,4,3
2019,146685,30,0,22,6,16
2019,146685,30,3,14,4,10
2019,146685,30,4,8,2,6
2019,146700,0,0,33,26,7
2019,146700,10,0,33,26,7
2019,146700,10,4,33,26,7
2019,146700,40,0,33,26,7
2019,146700,40,4,33,26,7
2019,146700,41,0,33,26,7
2019,146700,41,4,33,26,7
2019,146700,45,0,33,26,7
2019,146700,45,4,33,26,7
2019,146719,0,0,943,491,452
2019,146719,10,0,943,491,452
2019,146719,10,1,221,147,74
2019,146719,10,2,216,115,101
2019,146719,10,3,138,69,69
2019,146719,10,4,368,160,208
2019,146719,20,0,433,260,173
2019,146719,20,1,220,147,73
2019,146719,20,2,206,108,98
2019,146719,20,3,7,5,2
2019,146719,30,0,142,71,71
2019,146719,30,1,1,0,1
2019,146719,30,2,10,7,3
2019,146719,30,3,131,64,67
2019,146719,40,0,368,160,208
2019,146719,40,4,368,160,208
2019,146719,41,0,309,129,180
2019,146719,41,4,309,129,180
2019,146719,42,0,59,31,28
2019,146719,42,4,59,31,28
2019,146719,44,0,309,129,180
2019,146719,44,4,309,129,180
2019,146728,0,0,12,6,6
2019,146728,10,0,12,6,6
2019,146728,10,1,5,1,4
2019,146728,10,2,4,4,0
2019,146728,10,3,3,1,2
2019,146728,20,0,8,4,4
2019,146728,20,1,5,1,4
2019,146728,20,2,3,3,0
2019,146728,30,0,3,1,2
2019,146728,30,3,3,1,2
2019,146728,40,0,1,1,0
2019,146728,40,2,1,1,0
2019,146728,41,0,1,1,0
2019,146728,41,2,1,1,0
2019,146728,44,0,1,1,0
2019,146728,44,2,1,1,0
2019,146755,0,0,12,0,12
2019,146755,10,0,12,0,12
2019,146755,10,1,2,0,2
2019,146755,10,2,1,0,1
2019,146755,10,3,4,0,4
2019,146755,10,4,5,0,5
2019,146755,40,0,12,0,12
2019,146755,40,1,2,0,2
2019,146755,40,2,1,0,1
2019,146755,40,3,4,0,4
2019,146755,40,4,5,0,5
2019,146755,42,0,12,0,12
2019,146755,42,1,2,0,2
2019,146755,42,2,1,0,1
2019,146755,42,3,4,0,4
2019,146755,42,4,5,0,5
2019,146816,0,0,8,3,5
2019,146816,10,0,8,3,5
2019,146816,10,2,2,1,1
2019,146816,10,3,6,2,4
2019,146816,40,0,8,3,5
2019,146816,40,2,2,1,1
2019,146816,40,3,6,2,4
2019,146816,42,0,8,3,5
2019,146816,42,2,2,1,1
2019,146816,42,3,6,2,4
2019,146825,0,0,37,15,22
2019,146825,10,0,37,15,22
2019,146825,10,1,5,1,4
2019,146825,10,2,9,5,4
2019,146825,10,3,22,9,13
2019,146825,10,4,1,0,1
2019,146825,20,0,14,6,8
2019,146825,20,1,5,1,4
2019,146825,20,2,9,5,4
2019,146825,30,0,11,3,8
2019,146825,30,3,11,3,8
2019,146825,40,0,12,6,6
2019,146825,40,3,11,6,5
2019,146825,40,4,1,0,1
2019,146825,42,0,12,6,6
2019,146825,42,3,11,6,5
2019,146825,42,4,1,0,1
2019,146977,0,0,13,6,7
2019,146977,10,0,13,6,7
2019,146977,10,1,6,4,2
2019,146977,10,2,3,1,2
2019,146977,10,3,3,0,3
2019,146977,10,6,1,1,0
2019,146977,20,0,8,5,3
2019,146977,20,1,6,4,2
2019,146977,20,2,2,1,1
2019,146977,30,0,2,0,2
2019,146977,30,3,2,0,2
2019,146977,40,0,3,1,2
2019,146977,40,2,1,0,1
2019,146977,40,3,1,0,1
2019,146977,40,6,1,1,0
2019,146977,41,0,3,1,2
2019,146977,41,2,1,0,1
2019,146977,41,3,1,0,1
2019,146977,41,6,1,1,0
2019,146977,44,0,2,0,2
2019,146977,44,2,1,0,1
2019,146977,44,3,1,0,1
2019,146977,45,0,1,1,0
2019,146977,45,6,1,1,0
2019,147004,0,0,92,41,51
2019,147004,10,0,92,41,51
2019,147004,10,6,92,41,51
2019,147004,20,0,84,38,46
2019,147004,20,6,84,38,46
2019,147004,30,0,7,3,4
2019,147004,30,6,7,3,4
2019,147004,40,0,1,0,1
2019,147004,40,6,1,0,1
2019,147004,42,0,1,0,1
2019,147004,42,6,1,0,1
2019,147013,0,0,92,37,55
2019,147013,10,0,92,37,55
2019,147013,10,1,27,10,17
2019,147013,10,2,28,12,16
2019,147013,10,3,27,11,16
2019,147013,10,4,10,4,6
2019,147013,20,0,58,22,36
2019,147013,20,1,27,10,17
2019,147013,20,2,27,11,16
2019,147013,20,3,4,1,3
2019,147013,30,0,21,10,11
2019,147013,30,2,1,1,0
2019,147013,30,3,20,9,11
2019,147013,40,0,13,5,8
2019,147013,40,3,3,1,2
2019,147013,40,4,10,4,6
2019,147013,42,0,4,1,3
2019,147013,42,3,2,0,2
2019,147013,42,4,2,1,1
2019,147013,43,0,9,4,5
2019,147013,43,3,1,1,0
2019,147013,43,4,8,3,5
2019,147031,0,0,3,2,1
2019,147031,10,0,3,2,1
2019,147031,10,1,1,1,0
2019,147031,10,2,1,1,0
2019,147031,10,3,1,0,1
2019,147031,40,0,3,2,1
2019,147031,40,1,1,1,0
2019,147031,40,2,1,1,0
2019,147031,40,3,1,0,1
2019,147031,41,0,3,2,1
2019,147031,41,1,1,1,0
2019,147031,41,2,1,1,0
2019,147031,41,3,1,0,1
2019,147031,44,0,3,2,1
2019,147031,44,1,1,1,0
2019,147031,44,2,1,1,0
2019,147031,44,3,1,0,1
2019,147129,0,0,43,2,41
2019,147129,10,0,43,2,41
2019,147129,10,1,3,1,2
2019,147129,10,2,1,0,1
2019,147129,10,3,16,0,16
2019,147129,10,4,23,1,22
2019,147129,40,0,43,2,41
2019,147129,40,1,3,1,2
2019,147129,40,2,1,0,1
2019,147129,40,3,16,0,16
2019,147129,40,4,23,1,22
2019,147129,41,0,28,2,26
2019,147129,41,1,3,1,2
2019,147129,41,3,12,0,12
2019,147129,41,4,13,1,12
2019,147129,42,0,15,0,15
2019,147129,42,2,1,0,1
2019,147129,42,3,4,0,4
2019,147129,42,4,10,0,10
2019,147129,44,0,28,2,26
2019,147129,44,1,3,1,2
2019,147129,44,3,12,0,12
2019,147129,44,4,13,1,12
2019,147244,0,0,153,74,79
2019,147244,10,0,153,74,79
2019,147244,10,1,30,20,10
2019,147244,10,2,46,23,23
2019,147244,10,3,43,18,25
2019,147244,10,4,27,11,16
2019,147244,10,5,7,2,5
2019,147244,20,0,74,43,31
2019,147244,20,1,30,20,10
2019,147244,20,2,44,23,21
2019,147244,30,0,42,16,26
2019,147244,30,2,2,0,2
2019,147244,30,3,39,16,23
2019,147244,30,4,1,0,1
2019,147244,40,0,37,15,22
2019,147244,40,3,4,2,2
2019,147244,40,4,26,11,15
2019,147244,40,5,7,2,5
2019,147244,42,0,37,15,22
2019,147244,42,3,4,2,2
2019,147244,42,4,26,11,15
2019,147244,42,5,7,2,5
2019,147341,0,0,85,43,42
2019,147341,10,0,85,43,42
2019,147341,10,1,29,14,15
2019,147341,10,2,16,11,5
2019,147341,10,3,31,15,16
2019,147341,10,5,9,3,6
2019,147341,20,0,39,22,17
2019,147341,20,1,29,14,15
2019,147341,20,2,10,8,2
2019,147341,30,0,32,15,17
2019,147341,30,2,5,3,2
2019,147341,30,3,27,12,15
2019,147341,40,0,14,6,8
2019,147341,40,2,1,0,1
2019,147341,40,3,4,3,1
2019,147341,40,5,9,3,6
2019,147341,41,0,1,0,1
2019,147341,41,2,1,0,1
2019,147341,42,0,13,6,7
2019,147341,42,3,4,3,1
2019,147341,42,5,9,3,6
2019,147341,44,0,1,0,1
2019,147341,44,2,1,0,1
2019,147369,0,0,66,49,17
2019,147369,10,0,66,49,17
2019,147369,10,1,35,26,9
2019,147369,10,2,12,9,3
2019,147369,10,3,8,6,2
2019,147369,10,4,11,8,3
2019,147369,40,0,66,49,17
2019,147369,40,1,35,26,9
2019,147369,40,2,12,9,3
2019,147369,40,3,8,6,2
2019,147369,40,4,11,8,3
2019,147369,42,0,66,49,17
2019,147369,42,1,35,26,9
2019,147369,42,2,12,9,3
2019,147369,42,3,8,6,2
2019,147369,42,4,11,8,3
2019,147378,0,0,191,79,112
2019,147378,10,0,191,79,112
2019,147378,10,1,66,28,38
2019,147378,10,2,48,19,29
2019,147378,10,3,41,22,19
2019,147378,10,4,36,10,26
2019,147378,20,0,169,73,96
2019,147378,20,1,66,28,38
2019,147378,20,2,48,19,29
2019,147378,20,3,39,21,18
2019,147378,20,4,16,5,11
2019,147378,30,0,22,6,16
2019,147378,30,3,2,1,1
2019,147378,30,4,20,5,15
2019,147396,0,0,12,9,3
2019,147396,10,0,12,9,3
2019,147396,10,6,12,9,3
2019,147396,40,0,12,9,3
2019,147396,40,6,12,9,3
2019,147396,42,0,2,2,0
2019,147396,42,6,2,2,0
2019,147396,43,0,10,7,3
2019,147396,43,6,10,7,3
2019,147411,0,0,68,37,31
2019,147411,10,0,68,37,31
2019,147411,10,4,68,37,31
2019,147411,20,0,41,24,17
2019,147411,20,4,41,24,17
2019,147411,30,0,27,13,14
2019,147411,30,4,27,13,14
2019,147536,0,0,182,62,120
2019,147536,10,0,182,62,120
2019,147536,10,1,18,5,13
2019,147536,10,2,50,16,34
2019,147536,10,3,107,35,72
2019,147536,10,5,7,6,1
2019,147536,20,0,48,20,28
2019,147536,20,1,10,3,7
2019,147536,20,2,34,14,20
2019,147536,20,3,4,3,1
2019,147536,30,0,5,1,4
2019,147536,30,2,1,0,1
2019,147536,30,3,4,1,3
2019,147536,40,0,129,41,88
2019,147536,40,1,8,2,6
2019,147536,40,2,15,2,13
2019,147536,40,3,99,31,68
2019,147536,40,5,7,6,1
2019,147536,41,0,15,3,12
2019,147536,41,2,2,0,2
2019,147536,41,3,13,3,10
2019,147536,42,0,114,38,76
2019,147536,42,1,8,2,6
2019,147536,42,2,13,2,11
2019,147536,42,3,86,28,58
2019,147536,42,5,7,6,1
2019,147536,44,0,15,3,12
2019,147536,44,2,2,0,2
2019,147536,44,3,13,3,10
2019,147590,0,0,60,35,25
2019,147590,10,0,58,33,25
2019,147590,10,1,14,8,6
2019,147590,10,2,10,4,6
2019,147590,10,3,13,8,5
2019,147590,10,4,21,13,8
2019,147590,20,0,12,7,5
2019,147590,20,1,9,6,3
2019,147590,20,2,3,1,2
2019,147590,30,0,16,11,5
2019,147590,30,1,1,1,0
2019,147590,30,2,4,3,1
2019,147590,30,3,2,1,1
2019,147590,30,4,9,6,3
2019,147590,40,0,30,15,15
2019,147590,40,1,4,1,3
2019,147590,40,2,3,0,3
2019,147590,40,3,11,7,4
2019,147590,40,4,12,7,5
2019,147590,42,0,30,15,15
2019,147590,42,1,4,1,3
2019,147590,42,2,3,0,3
2019,147590,42,3,11,7,4
2019,147590,42,4,12,7,5
2019,147590,50,0,2,2,0
2019,147660,0,0,158,70,88
2019,147660,10,0,158,70,88
2019,147660,10,1,46,31,15
2019,147660,10,2,48,20,28
2019,147660,10,3,60,18,42
2019,147660,10,4,1,1,0
2019,147660,10,5,3,0,3
2019,147660,20,0,74,43,31
2019,147660,20,1,39,27,12
2019,147660,20,2,35,16,19
2019,147660,30,0,39,13,26
2019,147660,30,1,1,1,0
2019,147660,30,2,3,1,2
2019,147660,30,3,35,11,24
2019,147660,40,0,45,14,31
2019,147660,40,1,6,3,3
2019,147660,40,2,10,3,7
2019,147660,40,3,25,7,18
2019,147660,40,4,1,1,0
2019,147660,40,5,3,0,3
2019,147660,41,0,24,5,19
2019,147660,41,1,3,2,1
2019,147660,41,2,7,1,6
2019,147660,41,3,13,1,12
2019,147660,41,4,1,1,0
2019,147660,42,0,21,9,12
2019,147660,42,1,3,1,2
2019,147660,42,2,3,2,1
2019,147660,42,3,12,6,6
2019,147660,42,5,3,0,3
2019,147660,44,0,24,5,19
2019,147660,44,1,3,2,1
2019,147660,44,2,7,1,6
2019,147660,44,3,13,1,12
2019,147660,44,4,1,1,0
2019,147679,0,0,124,60,64
2019,147679,10,0,124,60,64
2019,147679,10,1,61,34,27
2019,147679,10,2,38,19,19
2019,147679,10,3,22,4,18
2019,147679,10,4,3,3,0
2019,147679,20,0,68,36,32
2019,147679,20,1,51,27,24
2019,147679,20,2,16,9,7
2019,147679,20,3,1,0,1
2019,147679,30,0,22,11,11
2019,147679,30,1,7,5,2
2019,147679,30,2,8,3,5
2019,147679,30,3,7,3,4
2019,147679,40,0,34,13,21
2019,147679,40,1,3,2,1
2019,147679,40,2,14,7,7
2019,147679,40,3,14,1,13
2019,147679,40,4,3,3,0
2019,147679,41,0,29,10,19
2019,147679,41,1,3,2,1
2019,147679,41,2,14,7,7
2019,147679,41,3,12,1,11
2019,147679,42,0,5,3,2
2019,147679,42,3,2,0,2
2019,147679,42,4,3,3,0
2019,147679,44,0,29,10,19
2019,147679,44,1,3,2,1
2019,147679,44,2,14,7,7
2019,147679,44,3,12,1,11
2019,147697,0,0,4,3,1
2019,147697,10,0,4,3,1
2019,147697,10,1,2,2,0
2019,147697,10,2,2,1,1
2019,147697,40,0,4,3,1
2019,147697,40,1,2,2,0
2019,147697,40,2,2,1,1
2019,147697,41,0,4,3,1
2019,147697,41,1,2,2,0
2019,147697,41,2,2,1,1
2019,147697,45,0,4,3,1
2019,147697,45,1,2,2,0
2019,147697,45,2,2,1,1
2019,147703,0,0,800,395,405
2019,147703,10,0,800,395,405
2019,147703,10,1,217,146,71
2019,147703,10,2,240,115,125
2019,147703,10,3,160,69,91
2019,147703,10,4,175,64,111
2019,147703,10,6,8,1,7
2019,147703,20,0,446,253,193
2019,147703,20,1,213,143,70
2019,147703,20,2,231,109,122
2019,147703,20,3,2,1,1
2019,147703,30,0,137,65,72
2019,147703,30,2,5,3,2
2019,147703,30,3,132,62,70
2019,147703,40,0,217,77,140
2019,147703,40,1,4,3,1
2019,147703,40,2,4,3,1
2019,147703,40,3,26,6,20
2019,147703,40,4,175,64,111
2019,147703,40,6,8,1,7
2019,147703,41,0,42,13,29
2019,147703,41,1,4,3,1
2019,147703,41,2,4,3,1
2019,147703,41,3,26,6,20
2019,147703,41,6,8,1,7
2019,147703,42,0,175,64,111
2019,147703,42,4,175,64,111
2019,147703,44,0,42,13,29
2019,147703,44,1,4,3,1
2019,147703,44,2,4,3,1
2019,147703,44,3,26,6,20
2019,147703,44,6,8,1,7
2019,147767,0,0,2296,1366,930
2019,147767,10,0,2296,1366,930
2019,147767,10,1,980,706,274
2019,147767,10,2,596,329,267
2019,147767,10,3,532,246,286
2019,147767,10,4,16,8,8
2019,147767,10,5,172,77,95
2019,147767,20,0,1061,763,298
2019,147767,20,1,750,568,182
2019,147767,20,2,311,195,116
2019,147767,30,0,306,166,140
2019,147767,30,2,45,30,15
2019,147767,30,3,261,136,125
2019,147767,40,0,929,437,492
2019,147767,40,1,230,138,92
2019,147767,40,2,240,104,136
2019,147767,40,3,271,110,161
2019,147767,40,4,16,8,8
2019,147767,40,5,172,77,95
2019,147767,41,0,917,434,483
2019,147767,41,1,230,138,92
2019,147767,41,2,240,104,136
2019,147767,41,3,271,110,161
2019,147767,41,4,16,8,8
2019,147767,41,5,160,74,86
2019,147767,42,0,12,3,9
2019,147767,42,5,12,3,9
2019,147767,44,0,917,434,483
2019,147767,44,1,230,138,92
2019,147767,44,2,240,104,136
2019,147767,44,3,271,110,161
2019,147767,44,4,16,8,8
2019,147767,44,5,160,74,86
2019,147776,0,0,297,131,166
2019,147776,10,0,297,131,166
2019,147776,10,1,65,33,32
2019,147776,10,2,96,41,55
2019,147776,10,3,57,23,34
2019,147776,10,4,79,34,45
2019,147776,20,0,145,67,78
2019,147776,20,1,64,33,31
2019,147776,20,2,80,34,46
2019,147776,20,3,1,0,1
2019,147776,30,0,73,30,43
2019,147776,30,1,1,0,1
2019,147776,30,2,16,7,9
2019,147776,30,3,56,23,33
2019,147776,40,0,79,34,45
2019,147776,40,4,79,34,45
2019,147776,42,0,79,34,45
2019,147776,42,4,79,34,45
2019,147800,0,0,152,56,96
2019,147800,10,0,152,56,96
2019,147800,10,1,96,39,57
2019,147800,10,2,32,10,22
2019,147800,10,3,21,6,15
2019,147800,10,4,3,1,2
2019,147800,20,0,131,52,79
2019,147800,20,1,93,39,54
2019,147800,20,2,26,9,17
2019,147800,20,3,12,4,8
2019,147800,30,0,21,4,17
2019,147800,30,1,3,0,3
2019,147800,30,2,6,1,5
2019,147800,30,3,9,2,7
2019,147800,30,4,3,1,2
2019,147828,0,0,128,79,49
2019,147828,10,0,128,79,49
2019,147828,10,1,52,35,17
2019,147828,10,2,41,30,11
2019,147828,10,3,34,13,21
2019,147828,10,4,1,1,0
2019,147828,20,0,13,13,0
2019,147828,20,1,12,12,0
2019,147828,20,2,1,1,0
2019,147828,40,0,115,66,49
2019,147828,40,1,40,23,17
2019,147828,40,2,40,29,11
2019,147828,40,3,34,13,21
2019,147828,40,4,1,1,0
2019,147828,41,0,47,27,20
2019,147828,41,1,26,15,11
2019,147828,41,2,19,11,8
2019,147828,41,3,2,1,1
2019,147828,42,0,68,39,29
2019,147828,42,1,14,8,6
2019,147828,42,2,21,18,3
2019,147828,42,3,32,12,20
2019,147828,42,4,1,1,0
2019,147828,44,0,47,27,20
2019,147828,44,1,26,15,11
2019,147828,44,2,19,11,8
2019,147828,44,3,2,1,1
2019,147916,0,0,157,78,79
2019,147916,10,0,157,78,79
2019,147916,10,1,54,33,21
2019,147916,10,2,69,24,45
2019,147916,10,3,9,7,2
2019,147916,10,4,25,14,11
2019,147916,20,0,132,64,68
2019,147916,20,1,54,33,21
2019,147916,20,2,69,24,45
2019,147916,20,3,9,7,2
2019,147916,30,0,9,2,7
2019,147916,30,4,9,2,7
2019,147916,40,0,16,12,4
2019,147916,40,4,16,12,4
2019,147916,42,0,14,11,3
2019,147916,42,4,14,11,3
2019,147916,43,0,2,1,1
2019,147916,43,4,2,1,1
2019,148007,0,0,78,32,46
2019,148007,10,0,78,32,46
2019,148007,10,1,28,17,11
2019,148007,10,2,36,11,25
2019,148007,10,3,14,4,10
2019,148007,20,0,63,28,35
2019,148007,20,1,27,17,10
2019,148007,20,2,36,11,25
2019,148007,30,0,9,1,8
2019,148007,30,1,1,0,1
2019,148007,30,3,8,1,7
2019,148007,40,0,6,3,3
2019,148007,40,3,6,3,3
2019,148007,42,0,6,3,3
2019,148007,42,3,6,3,3
2019,148016,0,0,65,33,32
2019,148016,10,0,65,33,32
2019,148016,10,1,25,15,10
2019,148016,10,2,9,5,4
2019,148016,10,3,24,10,14
2019,148016,10,4,5,3,2
2019,148016,10,6,2,0,2
2019,148016,40,0,65,33,32
2019,148016,40,1,25,15,10
2019,148016,40,2,9,5,4
2019,148016,40,3,24,10,14
2019,148016,40,4,5,3,2
2019,148016,40,6,2,0,2
2019,148016,42,0,63,33,30
2019,148016,42,1,25,15,10
2019,148016,42,2,9,5,4
2019,148016,42,3,24,10,14
2019,148016,42,4,5,3,2
2019,148016,43,0,2,0,2
2019,148016,43,6,2,0,2
2019,148131,0,0,53,30,23
2019,148131,10,0,53,30,23
2019,148131,10,1,9,8,1
2019,148131,10,2,15,8,7
2019,148131,10,3,25,12,13
2019,148131,10,4,4,2,2
2019,148131,20,0,22,15,7
2019,148131,20,1,9,8,1
2019,148131,20,2,13,7,6
2019,148131,30,0,15,6,9
2019,148131,30,3,15,6,9
2019,148131,40,0,16,9,7
2019,148131,40,2,2,1,1
2019,148131,40,3,10,6,4
2019,148131,40,4,4,2,2
2019,148131,42,0,16,9,7
2019,148131,42,2,2,1,1
2019,148131,42,3,10,6,4
2019,148131,42,4,4,2,2
2019,148256,0,0,54,24,30
2019,148256,10,0,54,24,30
2019,148256,10,1,26,12,14
2019,148256,10,2,16,7,9
2019,148256,10,4,11,4,7
2019,148256,10,6,1,1,0
2019,148256,20,0,41,19,22
2019,148256,20,1,26,12,14
2019,148256,20,2,15,7,8
2019,148256,30,0,13,5,8
2019,148256,30,2,1,0,1
2019,148256,30,4,11,4,7
2019,148256,30,6,1,1,0
2019,148292,0,0,63,27,36
2019,148292,10,0,63,27,36
2019,148292,10,1,25,7,18
2019,148292,10,2,11,5,6
2019,148292,10,3,10,3,7
2019,148292,10,4,17,12,5
2019,148292,20,0,54,21,33
2019,148292,20,1,25,7,18
2019,148292,20,2,9,3,6
2019,148292,20,3,10,3,7
2019,148292,20,4,10,8,2
2019,148292,30,0,7,5,2
2019,148292,30,2,2,2,0
2019,148292,30,4,5,3,2
2019,148292,40,0,2,1,1
2019,148292,40,4,2,1,1
2019,148292,42,0,2,1,1
2019,148292,42,4,2,1,1
2019,148335,0,0,41,26,15
2019,148335,10,0,41,26,15
2019,148335,10,1,41,26,15
2019,148335,40,0,41,26,15
2019,148335,40,1,41,26,15
2019,148335,43,0,41,26,15
2019,148335,43,1,41,26,15
2019,148380,0,0,127,55,72
2019,148380,10,0,127,55,72
2019,148380,10,1,48,22,26
2019,148380,10,2,61,27,34
2019,148380,10,3,16,6,10
2019,148380,10,4,2,0,2
2019,148380,20,0,113,50,63
2019,148380,20,1,45,20,25
2019,148380,20,2,57,25,32
2019,148380,20,3,10,5,5
2019,148380,20,4,1,0,1
2019,148380,30,0,10,5,5
2019,148380,30,1,2,2,0
2019,148380,30,2,4,2,2
2019,148380,30,3,4,1,3
2019,148380,40,0,4,0,4
2019,148380,40,1,1,0,1
2019,148380,40,3,2,0,2
2019,148380,40,4,1,0,1
2019,148380,41,0,4,0,4
2019,148380,41,1,1,0,1
2019,148380,41,3,2,0,2
2019,148380,41,4,1,0,1
2019,148380,44,0,4,0,4
2019,148380,44,1,1,0,1
2019,148380,44,3,2,0,2
2019,148380,44,4,1,0,1
2019,148405,0,0,71,27,44
2019,148405,10,0,71,27,44
2019,148405,10,1,10,4,6
2019,148405,10,2,22,14,8
2019,148405,10,3,39,9,30
2019,148405,20,0,36,17,19
2019,148405,20,1,10,4,6
2019,148405,20,2,16,10,6
2019,148405,20,3,10,3,7
2019,148405,30,0,30,10,20
2019,148405,30,2,5,4,1
2019,148405,30,3,25,6,19
2019,148405,40,0,5,0,5
2019,148405,40,2,1,0,1
2019,148405,40,3,4,0,4
2019,148405,41,0,2,0,2
2019,148405,41,2,1,0,1
2019,148405,41,3,1,0,1
2019,148405,42,0,3,0,3
2019,148405,42,3,3,0,3
2019,148405,44,0,2,0,2
2019,148405,44,2,1,0,1
2019,148405,44,3,1,0,1
2019,148487,0,0,197,106,91
2019,148487,10,0,197,106,91
2019,148487,10,1,38,24,14
2019,148487,10,2,82,40,42
2019,148487,10,3,52,30,22
2019,148487,10,5,20,10,10
2019,148487,10,6,5,2,3
2019,148487,20,0,118,63,55
2019,148487,20,1,37,23,14
2019,148487,20,2,78,38,40
2019,148487,20,3,2,1,1
2019,148487,20,6,1,1,0
2019,148487,30,0,21,14,7
2019,148487,30,3,21,14,7
2019,148487,40,0,58,29,29
2019,148487,40,1,1,1,0
2019,148487,40,2,4,2,2
2019,148487,40,3,29,15,14
2019,148487,40,5,20,10,10
2019,148487,40,6,4,1,3
2019,148487,41,0,21,13,8
2019,148487,41,1,1,1,0
2019,148487,41,2,2,1,1
2019,148487,41,3,5,3,2
2019,148487,41,5,12,7,5
2019,148487,41,6,1,1,0
2019,148487,42,0,32,13,19
2019,148487,42,2,2,1,1
2019,148487,42,3,20,9,11
2019,148487,42,5,8,3,5
2019,148487,42,6,2,0,2
2019,148487,43,0,5,3,2
2019,148487,43,3,4,3,1
2019,148487,43,6,1,0,1
2019,148487,44,0,21,13,8
2019,148487,44,1,1,1,0
2019,148487,44,2,2,1,1
2019,148487,44,3,5,3,2
2019,148487,44,5,12,7,5
2019,148487,44,6,1,1,0
2019,148496,0,0,155,63,92
2019,148496,10,0,155,63,92
2019,148496,10,1,54,22,32
2019,148496,10,2,39,18,21
2019,148496,10,3,41,17,24
2019,148496,10,5,21,6,15
2019,148496,20,0,90,38,52
2019,148496,20,1,50,20,30
2019,148496,20,2,35,15,20
2019,148496,20,3,5,3,2
2019,148496,30,0,28,14,14
2019,148496,30,2,3,2,1
2019,148496,30,3,25,12,13
2019,148496,40,0,37,11,26
2019,148496,40,1,4,2,2
2019,148496,40,2,1,1,0
2019,148496,40,3,11,2,9
2019,148496,40,5,21,6,15
2019,148496,42,0,37,11,26
2019,148496,42,1,4,2,2
2019,148496,42,2,1,1,0
2019,148496,42,3,11,2,9
2019,148496,42,5,21,6,15
2019,148511,0,0,1068,449,619
2019,148511,10,0,1068,449,619
2019,148511,10,1,115,70,45
2019,148511,10,2,157,77,80
2019,148511,10,3,571,227,344
2019,148511,10,4,130,44,86
2019,148511,10,5,16,3,13
2019,148511,10,6,79,28,51
2019,148511,20,0,272,147,125
2019,148511,20,1,115,70,45
2019,148511,20,2,157,77,80
2019,148511,30,0,701,271,430
2019,148511,30,3,571,227,344
2019,148511,30,4,130,44,86
2019,148511,40,0,95,31,64
2019,148511,40,5,16,3,13
2019,148511,40,6,79,28,51
2019,148511,41,0,3,1,2
2019,148511,41,6,3,1,2
2019,148511,42,0,49,11,38
2019,148511,42,5,16,3,13
2019,148511,42,6,33,8,25
2019,148511,43,0,43,19,24
2019,148511,43,6,43,19,24
2019,148511,44,0,3,1,2
2019,148511,44,6,3,1,2
2019,148575,0,0,40,3,37
2019,148575,10,0,40,3,37
2019,148575,10,1,4,0,4
2019,148575,10,2,6,0,6
2019,148575,10,3,24,2,22
2019,148575,10,4,6,1,5
2019,148575,40,0,40,3,37
2019,148575,40,1,4,0,4
2019,148575,40,2,6,0,6
2019,148575,40,3,24,2,22
2019,148575,40,4,6,1,5
2019,148575,43,0,40,3,37
2019,148575,43,1,4,0,4
2019,148575,43,2,6,0,6
2019,148575,43,3,24,2,22
2019,148575,43,4,6,1,5
2019,148584,0,0,99,37,62
2019,148584,10,0,99,37,62
2019,148584,10,1,25,16,9
2019,148584,10,2,23,8,15
2019,148584,10,3,31,6,25
2019,148584,10,4,20,7,13
2019,148584,20,0,44,20,24
2019,148584,20,1,20,12,8
2019,148584,20,2,23,8,15
2019,148584,20,3,1,0,1
2019,148584,30,0,20,4,16
2019,148584,30,3,20,4,16
2019,148584,40,0,35,13,22
2019,148584,40,1,5,4,1
2019,148584,40,3,10,2,8
2019,148584,40,4,20,7,13
2019,148584,42,0,35,13,22
2019,148584,42,1,5,4,1
2019,148584,42,3,10,2,8
2019,148584,42,4,20,7,13
2019,148593,0,0,17,1,16
2019,148593,10,0,17,1,16
2019,148593,10,2,1,0,1
2019,148593,10,3,14,1,13
2019,148593,10,4,2,0,2
2019,148593,40,0,17,1,16
2019,148593,40,2,1,0,1
2019,148593,40,3,14,1,13
2019,148593,40,4,2,0,2
2019,148593,42,0,17,1,16
2019,148593,42,2,1,0,1
2019,148593,42,3,14,1,13
2019,148593,42,4,2,0,2
2019,148627,0,0,133,55,78
2019,148627,10,0,122,53,69
2019,148627,10,1,25,10,15
2019,148627,10,2,45,21,24
2019,148627,10,3,23,10,13
2019,148627,10,5,29,12,17
2019,148627,20,0,68,31,37
2019,148627,20,1,24,10,14
2019,148627,20,2,44,21,23
2019,148627,30,0,24,10,14
2019,148627,30,2,1,0,1
2019,148627,30,3,23,10,13
2019,148627,40,0,30,12,18
2019,148627,40,1,1,0,1
2019,148627,40,5,29,12,17
2019,148627,42,0,30,12,18
2019,148627,42,1,1,0,1
2019,148627,42,5,29,12,17
2019,148627,50,0,11,2,9
2019,148654,0,0,201,111,90
2019,148654,10,0,201,111,90
2019,148654,10,1,19,15,4
2019,148654,10,2,87,44,43
2019,148654,10,3,62,32,30
2019,148654,10,4,30,18,12
2019,148654,10,5,3,2,1
2019,148654,20,0,110,62,48
2019,148654,20,1,19,15,4
2019,148654,20,2,82,42,40
2019,148654,20,3,9,5,4
2019,148654,30,0,50,25,25
2019,148654,30,2,3,1,2
2019,148654,30,3,47,24,23
2019,148654,40,0,41,24,17
2019,148654,40,2,2,1,1
2019,148654,40,3,6,3,3
2019,148654,40,4,30,18,12
2019,148654,40,5,3,2,1
2019,148654,42,0,41,24,17
2019,148654,42,2,2,1,1
2019,148654,42,3,6,3,3
2019,148654,42,4,30,18,12
2019,148654,42,5,3,2,1
2019,148672,0,0,45,23,22
2019,148672,10,0,45,23,22
2019,148672,10,1,11,8,3
2019,148672,10,2,10,5,5
2019,148672,10,3,20,7,13
2019,148672,10,4,4,3,1
2019,148672,20,0,31,17,14
2019,148672,20,1,10,7,3
2019,148672,20,2,10,5,5
2019,148672,20,3,10,4,6
2019,148672,20,4,1,1,0
2019,148672,30,0,14,6,8
2019,148672,30,1,1,1,0
2019,148672,30,3,10,3,7
2019,148672,30,4,3,2,1
2019,148821,0,0,33,13,20
2019,148821,10,0,33,13,20
2019,148821,10,6,33,13,20
2019,148821,20,0,25,10,15
2019,148821,20,6,25,10,15
2019,148821,30,0,8,3,5
2019,148821,30,6,8,3,5
2019,148876,0,0,15,7,8
2019,148876,10,0,15,7,8
2019,148876,10,2,7,5,2
2019,148876,10,3,4,2,2
2019,148876,10,4,4,0,4
2019,148876,40,0,15,7,8
2019,148876,40,2,7,5,2
2019,148876,40,3,4,2,2
2019,148876,40,4,4,0,4
2019,148876,42,0,15,7,8
2019,148876,42,2,7,5,2
2019,148876,42,3,4,2,2
2019,148876,42,4,4,0,4
2019,148885,0,0,32,26,6
2019,148885,10,0,32,26,6
2019,148885,10,1,9,7,2
2019,148885,10,2,6,6,0
2019,148885,10,3,12,8,4
2019,148885,10,4,5,5,0
2019,148885,40,0,32,26,6
2019,148885,40,1,9,7,2
2019,148885,40,2,6,6,0
2019,148885,40,3,12,8,4
2019,148885,40,4,5,5,0
2019,148885,41,0,32,26,6
2019,148885,41,1,9,7,2
2019,148885,41,2,6,6,0
2019,148885,41,3,12,8,4
2019,148885,41,4,5,5,0
2019,148885,44,0,32,26,6
2019,148885,44,1,9,7,2
2019,148885,44,2,6,6,0
2019,148885,44,3,12,8,4
2019,148885,44,4,5,5,0
2019,148937,0,0,37,18,19
2019,148937,10,0,37,18,19
2019,148937,10,4,37,18,19
2019,148937,20,0,23,14,9
2019,148937,20,4,23,14,9
2019,148937,30,0,10,3,7
2019,148937,30,4,10,3,7
2019,148937,40,0,4,1,3
2019,148937,40,4,4,1,3
2019,148937,42,0,4,1,3
2019,148937,42,4,4,1,3
2019,148982,0,0,3,2,1
2019,148982,10,0,3,2,1
2019,148982,10,1,2,2,0
2019,148982,10,2,1,0,1
2019,148982,40,0,3,2,1
2019,148982,40,1,2,2,0
2019,148982,40,2,1,0,1
2019,148982,41,0,2,1,1
2019,148982,41,1,1,1,0
2019,148982,41,2,1,0,1
2019,148982,42,0,1,1,0
2019,148982,42,1,1,1,0
2019,148982,44,0,1,1,0
2019,148982,44,1,1,1,0
2019,148982,45,0,1,0,1
2019,148982,45,2,1,0,1
2019,148991,0,0,32,13,19
2019,148991,10,0,32,13,19
2019,148991,10,6,32,13,19
2019,148991,20,0,28,13,15
2019,148991,20,6,28,13,15
2019,148991,30,0,4,0,4
2019,148991,30,6,4,0,4
2019,149028,0,0,21,2,19
2019,149028,10,0,21,2,19
2019,149028,10,1,1,1,0
2019,149028,10,2,1,0,1
2019,149028,10,3,14,1,13
2019,149028,10,4,5,0,5
2019,149028,40,0,21,2,19
2019,149028,40,1,1,1,0
2019,149028,40,2,1,0,1
2019,149028,40,3,14,1,13
2019,149028,40,4,5,0,5
2019,149028,41,0,21,2,19
2019,149028,41,1,1,1,0
2019,149028,41,2,1,0,1
2019,149028,41,3,14,1,13
2019,149028,41,4,5,0,5
2019,149028,45,0,21,2,19
2019,149028,45,1,1,1,0
2019,149028,45,2,1,0,1
2019,149028,45,3,14,1,13
2019,149028,45,4,5,0,5
2019,149222,0,0,946,562,384
2019,149222,10,0,946,562,384
2019,149222,10,1,217,160,57
2019,149222,10,2,304,175,129
2019,149222,10,3,293,166,127
2019,149222,10,4,69,32,37
2019,149222,10,5,63,29,34
2019,149222,20,0,368,258,110
2019,149222,20,1,181,138,43
2019,149222,20,2,183,117,66
2019,149222,20,3,4,3,1
2019,149222,30,0,162,99,63
2019,149222,30,2,32,14,18
2019,149222,30,3,129,84,45
2019,149222,30,5,1,1,0
2019,149222,40,0,416,205,211
2019,149222,40,1,36,22,14
2019,149222,40,2,89,44,45
2019,149222,40,3,160,79,81
2019,149222,40,4,69,32,37
2019,149222,40,5,62,28,34
2019,149222,41,0,285,143,142
2019,149222,41,1,31,19,12
2019,149222,41,2,88,43,45
2019,149222,41,3,111,58,53
2019,149222,41,4,14,2,12
2019,149222,41,5,41,21,20
2019,149222,42,0,19,9,10
2019,149222,42,1,4,2,2
2019,149222,42,2,1,1,0
2019,149222,42,3,9,3,6
2019,149222,42,4,5,3,2
2019,149222,43,0,112,53,59
2019,149222,43,1,1,1,0
2019,149222,43,3,40,18,22
2019,149222,43,4,50,27,23
2019,149222,43,5,21,7,14
2019,149222,44,0,285,143,142
2019,149222,44,1,31,19,12
2019,149222,44,2,88,43,45
2019,149222,44,3,111,58,53
2019,149222,44,4,14,2,12
2019,149222,44,5,41,21,20
2019,149231,0,0,614,304,310
2019,149231,10,0,614,304,310
2019,149231,10,1,172,105,67
2019,149231,10,2,182,97,85
2019,149231,10,3,126,57,69
2019,149231,10,4,132,43,89
2019,149231,10,5,2,2,0
2019,149231,20,0,331,190,141
2019,149231,20,1,168,103,65
2019,149231,20,2,162,87,75
2019,149231,20,3,1,0,1
2019,149231,30,0,113,50,63
2019,149231,30,2,4,3,1
2019,149231,30,3,109,47,62
2019,149231,40,0,170,64,106
2019,149231,40,1,4,2,2
2019,149231,40,2,16,7,9
2019,149231,40,3,16,10,6
2019,149231,40,4,132,43,89
2019,149231,40,5,2,2,0
2019,149231,41,0,26,10,16
2019,149231,41,1,3,1,2
2019,149231,41,2,10,1,9
2019,149231,41,3,8,4,4
2019,149231,41,4,5,4,1
2019,149231,42,0,140,53,87
2019,149231,42,1,1,1,0
2019,149231,42,2,6,6,0
2019,149231,42,3,8,6,2
2019,149231,42,4,124,39,85
2019,149231,42,5,1,1,0
2019,149231,43,0,4,1,3
2019,149231,43,4,3,0,3
2019,149231,43,5,1,1,0
2019,149231,44,0,26,10,16
2019,149231,44,1,3,1,2
2019,149231,44,2,10,1,9
2019,149231,44,3,8,4,4
2019,149231,44,4,5,4,1
2019,149329,0,0,6,6,0
2019,149329,10,0,6,6,0
2019,149329,10,4,6,6,0
2019,149329,40,0,6,6,0
2019,149329,40,4,6,6,0
2019,149329,42,0,6,6,0
2019,149329,42,4,6,6,0
2019,149365,0,0,78,38,40
2019,149365,10,0,78,38,40
2019,149365,10,6,78,38,40
2019,149365,20,0,62,34,28
2019,149365,20,6,62,34,28
2019,149365,30,0,7,1,6
2019,149365,30,6,7,1,6
2019,149365,40,0,9,3,6
2019,149365,40,6,9,3,6
2019,149365,41,0,9,3,6
2019,149365,41,6,9,3,6
2019,149365,44,0,9,3,6
2019,149365,44,6,9,3,6
2019,149505,0,0,68,30,38
2019,149505,10,0,68,30,38
2019,149505,10,1,20,16,4
2019,149505,10,2,18,5,13
2019,149505,10,3,30,9,21
2019,149505,20,0,22,16,6
2019,149505,20,1,18,14,4
2019,149505,20,2,4,2,2
2019,149505,30,0,24,12,12
2019,149505,30,1,2,2,0
2019,149505,30,2,12,3,9
2019,149505,30,3,10,7,3
2019,149505,40,0,22,2,20
2019,149505,40,2,2,0,2
2019,149505,40,3,20,2,18
2019,149505,41,0,1,0,1
2019,149505,41,3,1,0,1
2019,149505,42,0,21,2,19
2019,149505,42,2,2,0,2
2019,149505,42,3,19,2,17
2019,149505,44,0,1,0,1
2019,149505,44,3,1,0,1
2019,149514,0,0,64,48,16
2019,149514,10,0,64,48,16
2019,149514,10,1,25,22,3
2019,149514,10,2,30,19,11
2019,149514,10,3,9,7,2
2019,149514,20,0,36,25,11
2019,149514,20,1,25,22,3
2019,149514,20,2,11,3,8
2019,149514,30,0,19,15,4
2019,149514,30,2,16,13,3
2019,149514,30,3,3,2,1
2019,149514,40,0,9,8,1
2019,149514,40,2,3,3,0
2019,149514,40,3,6,5,1
2019,149514,42,0,9,8,1
2019,149514,42,2,3,3,0
2019,149514,42,3,6,5,1
2019,149532,0,0,99,45,54
2019,149532,10,0,99,45,54
2019,149532,10,6,99,45,54
2019,149532,20,0,80,38,42
2019,149532,20,6,80,38,42
2019,149532,30,0,4,1,3
2019,149532,30,6,4,1,3
2019,149532,40,0,15,6,9
2019,149532,40,6,15,6,9
2019,149532,41,0,15,6,9
2019,149532,41,6,15,6,9
2019,149532,44,0,15,6,9
2019,149532,44,6,15,6,9
2019,149639,0,0,10,5,5
2019,149639,10,0,10,5,5
2019,149639,10,1,4,1,3
2019,149639,10,2,4,2,2
2019,149639,10,3,2,2,0
2019,149639,40,0,10,5,5
2019,149639,40,1,4,1,3
2019,149639,40,2,4,2,2
2019,149639,40,3,2,2,0
2019,149639,42,0,10,5,5
2019,149639,42,1,4,1,3
2019,149639,42,2,4,2,2
2019,149639,42,3,2,2,0
2019,149727,0,0,98,46,52
2019,149727,10,0,98,46,52
2019,149727,10,1,27,14,13
2019,149727,10,2,21,8,13
2019,149727,10,3,38,15,23
2019,149727,10,4,12,9,3
2019,149727,20,0,86,37,49
2019,149727,20,1,27,14,13
2019,149727,20,2,21,8,13
2019,149727,20,3,38,15,23
2019,149727,30,0,12,9,3
2019,149727,30,4,12,9,3
2019,149763,0,0,49,10,39
2019,149763,10,0,49,10,39
2019,149763,10,2,10,1,9
2019,149763,10,3,18,1,17
2019,149763,10,4,21,8,13
2019,149763,40,0,49,10,39
2019,149763,40,2,10,1,9
2019,149763,40,3,18,1,17
2019,149763,40,4,21,8,13
2019,149763,41,0,29,3,26
2019,149763,41,2,5,0,5
2019,149763,41,3,15,1,14
2019,149763,41,4,9,2,7
2019,149763,42,0,20,7,13
2019,149763,42,2,5,1,4
2019,149763,42,3,3,0,3
2019,149763,42,4,12,6,6
2019,149763,44,0,21,3,18
2019,149763,44,2,2,0,2
2019,149763,44,3,10,1,9
2019,149763,44,4,9,2,7
2019,149763,45,0,8,0,8
2019,149763,45,2,3,0,3
2019,149763,45,3,5,0,5
2019,149772,0,0,470,259,211
2019,149772,10,0,470,259,211
2019,149772,10,1,192,129,63
2019,149772,10,2,119,67,52
2019,149772,10,3,74,37,37
2019,149772,10,4,85,26,59
2019,149772,20,0,307,193,114
2019,149772,20,1,192,129,63
2019,149772,20,2,115,64,51
2019,149772,30,0,77,40,37
2019,149772,30,2,3,3,0
2019,149772,30,3,74,37,37
2019,149772,40,0,86,26,60
2019,149772,40,2,1,0,1
2019,149772,40,4,85,26,59
2019,149772,41,0,86,26,60
2019,149772,41,2,1,0,1
2019,149772,41,4,85,26,59
2019,149772,45,0,86,26,60
2019,149772,45,2,1,0,1
2019,149772,45,4,85,26,59
2019,149781,0,0,218,139,79
2019,149781,10,0,218,139,79
2019,149781,10,1,62,44,18
2019,149781,10,2,89,59,30
2019,149781,10,3,61,35,26
2019,149781,10,4,6,1,5
2019,149781,20,0,130,92,38
2019,149781,20,1,57,40,17
2019,149781,20,2,73,52,21
2019,149781,30,0,57,32,25
2019,149781,30,1,4,3,1
2019,149781,30,2,12,5,7
2019,149781,30,3,41,24,17
2019,149781,40,0,31,15,16
2019,149781,40,1,1,1,0
2019,149781,40,2,4,2,2
2019,149781,40,3,20,11,9
2019,149781,40,4,6,1,5
2019,149781,42,0,31,15,16
2019,149781,42,1,1,1,0
2019,149781,42,2,4,2,2
2019,149781,42,3,20,11,9
2019,149781,42,4,6,1,5
2019,149842,0,0,201,81,120
2019,149842,10,0,201,81,120
2019,149842,10,1,69,33,36
2019,149842,10,2,65,26,39
2019,149842,10,3,38,13,25
2019,149842,10,4,24,8,16
2019,149842,10,6,5,1,4
2019,149842,20,0,168,72,96
2019,149842,20,1,69,33,36
2019,149842,20,2,65,26,39
2019,149842,20,3,28,9,19
2019,149842,20,4,5,4,1
2019,149842,20,6,1,0,1
2019,149842,30,0,33,9,24
2019,149842,30,3,10,4,6
2019,149842,30,4,19,4,15
2019,149842,30,6,4,1,3
2019,150048,0,0,20,7,13
2019,150048,10,0,20,7,13
2019,150048,10,1,1,1,0
2019,150048,10,2,1,0,1
2019,150048,10,3,6,3,3
2019,150048,10,4,12,3,9
2019,150048,40,0,20,7,13
2019,150048,40,1,1,1,0
2019,150048,40,2,1,0,1
2019,150048,40,3,6,3,3
2019,150048,40,4,12,3,9
2019,150048,42,0,20,7,13
2019,150048,42,1,1,1,0
2019,150048,42,2,1,0,1
2019,150048,42,3,6,3,3
2019,150048,42,4,12,3,9
2019,150066,0,0,112,61,51
2019,150066,10,0,112,61,51
2019,150066,10,1,42,29,13
2019,150066,10,2,22,14,8
2019,150066,10,3,42,16,26
2019,150066,10,4,6,2,4
2019,150066,20,0,57,36,21
2019,150066,20,1,41,28,13
2019,150066,20,2,16,8,8
2019,150066,30,0,29,16,13
2019,150066,30,1,1,1,0
2019,150066,30,2,5,5,0
2019,150066,30,3,23,10,13
2019,150066,40,0,26,9,17
2019,150066,40,2,1,1,0
2019,150066,40,3,19,6,13
2019,150066,40,4,6,2,4
2019,150066,42,0,26,9,17
2019,150066,42,2,1,1,0
2019,150066,42,3,19,6,13
2019,150066,42,4,6,2,4
2019,150136,0,0,1063,515,548
2019,150136,10,0,1060,512,548
2019,150136,10,1,181,113,68
2019,150136,10,2,211,108,103
2019,150136,10,3,252,134,118
2019,150136,10,4,73,24,49
2019,150136,10,5,178,59,119
2019,150136,10,6,165,74,91
2019,150136,20,0,392,222,170
2019,150136,20,1,180,112,68
2019,150136,20,2,195,101,94
2019,150136,20,3,17,9,8
2019,150136,30,0,228,118,110
2019,150136,30,2,16,7,9
2019,150136,30,3,211,111,100
2019,150136,30,6,1,0,1
2019,150136,40,0,440,172,268
2019,150136,40,1,1,1,0
2019,150136,40,3,24,14,10
2019,150136,40,4,73,24,49
2019,150136,40,5,178,59,119
2019,150136,40,6,164,74,90
2019,150136,41,0,3,0,3
2019,150136,41,6,3,0,3
2019,150136,42,0,434,172,262
2019,150136,42,1,1,1,0
2019,150136,42,3,24,14,10
2019,150136,42,4,70,24,46
2019,150136,42,5,178,59,119
2019,150136,42,6,161,74,87
2019,150136,43,0,3,0,3
2019,150136,43,4,3,0,3
2019,150136,44,0,3,0,3
2019,150136,44,6,3,0,3
2019,150136,50,0,3,3,0
2019,150145,0,0,61,29,32
2019,150145,10,0,61,29,32
2019,150145,10,1,9,5,4
2019,150145,10,2,24,14,10
2019,150145,10,3,27,9,18
2019,150145,10,4,1,1,0
2019,150145,20,0,33,20,13
2019,150145,20,1,8,5,3
2019,150145,20,2,24,14,10
2019,150145,20,3,1,1,0
2019,150145,30,0,19,6,13
2019,150145,30,1,1,0,1
2019,150145,30,3,18,6,12
2019,150145,40,0,9,3,6
2019,150145,40,3,8,2,6
2019,150145,40,4,1,1,0
2019,150145,42,0,9,3,6
2019,150145,42,3,8,2,6
2019,150145,42,4,1,1,0
2019,150163,0,0,394,197,197
2019,150163,10,0,394,197,197
2019,150163,10,1,108,66,42
2019,150163,10,2,120,55,65
2019,150163,10,3,79,37,42
2019,150163,10,4,87,39,48
2019,150163,20,0,202,113,89
2019,150163,20,1,103,63,40
2019,150163,20,2,99,50,49
2019,150163,30,0,54,31,23
2019,150163,30,1,1,1,0
2019,150163,30,2,1,1,0
2019,150163,30,3,52,29,23
2019,150163,40,0,138,53,85
2019,150163,40,1,4,2,2
2019,150163,40,2,20,4,16
2019,150163,40,3,27,8,19
2019,150163,40,4,87,39,48
2019,150163,41,0,138,53,85
2019,150163,41,1,4,2,2
2019,150163,41,2,20,4,16
2019,150163,41,3,27,8,19
2019,150163,41,4,87,39,48
2019,150163,44,0,138,53,85
2019,150163,44,1,4,2,2
2019,150163,44,2,20,4,16
2019,150163,44,3,27,8,19
2019,150163,44,4,87,39,48
2019,150172,0,0,21,11,10
2019,150172,10,0,21,11,10
2019,150172,10,1,1,1,0
2019,150172,10,2,5,2,3
2019,150172,10,3,9,5,4
2019,150172,10,4,6,3,3
2019,150172,20,0,7,4,3
2019,150172,20,1,1,1,0
2019,150172,20,2,5,2,3
2019,150172,20,3,1,1,0
2019,150172,30,0,8,4,4
2019,150172,30,3,8,4,4
2019,150172,40,0,6,3,3
2019,150172,40,4,6,3,3
2019,150172,41,0,1,1,0
2019,150172,41,4,1,1,0
2019,150172,42,0,5,2,3
2019,150172,42,4,5,2,3
2019,150172,44,0,1,1,0
2019,150172,44,4,1,1,0
2019,150215,0,0,9,5,4
2019,150215,10,0,9,5,4
2019,150215,10,1,3,3,0
2019,150215,10,2,4,2,2
2019,150215,10,3,2,0,2
2019,150215,20,0,9,5,4
2019,150215,20,1,3,3,0
2019,150215,20,2,4,2,2
2019,150215,20,3,2,0,2
2019,150288,0,0,23,22,1
2019,150288,10,0,20,20,0
2019,150288,10,1,9,9,0
2019,150288,10,2,5,5,0
2019,150288,10,3,6,6,0
2019,150288,20,0,15,15,0
2019,150288,20,1,9,9,0
2019,150288,20,2,5,5,0
2019,150288,20,3,1,1,0
2019,150288,30,0,5,5,0
2019,150288,30,3,5,5,0
2019,150288,50,0,3,2,1
2019,150400,0,0,220,123,97
2019,150400,10,0,220,123,97
2019,150400,10,1,111,66,45
2019,150400,10,2,50,24,26
2019,150400,10,3,57,32,25
2019,150400,10,4,2,1,1
2019,150400,20,0,158,89,69
2019,150400,20,1,109,65,44
2019,150400,20,2,47,23,24
2019,150400,20,3,2,1,1
2019,150400,30,0,23,12,11
2019,150400,30,2,1,1,0
2019,150400,30,3,22,11,11
2019,150400,40,0,39,22,17
2019,150400,40,1,2,1,1
2019,150400,40,2,2,0,2
2019,150400,40,3,33,20,13
2019,150400,40,4,2,1,1
2019,150400,41,0,36,19,17
2019,150400,41,1,2,1,1
2019,150400,41,2,2,0,2
2019,150400,41,3,31,18,13
2019,150400,41,4,1,0,1
2019,150400,42,0,3,3,0
2019,150400,42,3,2,2,0
2019,150400,42,4,1,1,0
2019,150400,44,0,36,19,17
2019,150400,44,1,2,1,1
2019,150400,44,2,2,0,2
2019,150400,44,3,31,18,13
2019,150400,44,4,1,0,1
2019,150455,0,0,127,67,60
2019,150455,10,0,125,66,59
2019,150455,10,1,31,20,11
2019,150455,10,2,28,14,14
2019,150455,10,3,45,26,19
2019,150455,10,4,21,6,15
2019,150455,20,0,59,34,25
2019,150455,20,1,31,20,11
2019,150455,20,2,28,14,14
2019,150455,30,0,27,12,15
2019,150455,30,3,27,12,15
2019,150455,40,0,39,20,19
2019,150455,40,3,18,14,4
2019,150455,40,4,21,6,15
2019,150455,41,0,20,11,9
2019,150455,41,3,7,7,0
2019,150455,41,4,13,4,9
2019,150455,42,0,19,9,10
2019,150455,42,3,11,7,4
2019,150455,42,4,8,2,6
2019,150455,44,0,20,11,9
2019,150455,44,3,7,7,0
2019,150455,44,4,13,4,9
2019,150455,50,0,2,1,1
2019,150534,0,0,171,91,80
2019,150534,10,0,171,91,80
2019,150534,10,1,41,33,8
2019,150534,10,2,59,32,27
2019,150534,10,3,68,25,43
2019,150534,10,4,2,1,1
2019,150534,10,5,1,0,1
2019,150534,20,0,102,67,35
2019,150534,20,1,41,33,8
2019,150534,20,2,54,28,26
2019,150534,20,3,7,6,1
2019,150534,30,0,37,14,23
2019,150534,30,2,2,2,0
2019,150534,30,3,35,12,23
2019,150534,40,0,32,10,22
2019,150534,40,2,3,2,1
2019,150534,40,3,26,7,19
2019,150534,40,4,2,1,1
2019,150534,40,5,1,0,1
2019,150534,42,0,32,10,22
2019,150534,42,2,3,2,1
2019,150534,42,3,26,7,19
2019,150534,42,4,2,1,1
2019,150534,42,5,1,0,1
2019,150604,0,0,79,44,35
2019,150604,10,0,78,44,34
2019,150604,10,1,16,13,3
2019,150604,10,2,22,10,12
2019,150604,10,3,28,15,13
2019,150604,10,4,8,4,4
2019,150604,10,5,4,2,2
2019,150604,20,0,38,23,15
2019,150604,20,1,16,13,3
2019,150604,20,2,22,10,12
2019,150604,30,0,24,15,9
2019,150604,30,3,21,12,9
2019,150604,30,4,3,3,0
2019,150604,40,0,16,6,10
2019,150604,40,3,7,3,4
2019,150604,40,4,5,1,4
2019,150604,40,5,4,2,2
2019,150604,42,0,16,6,10
2019,150604,42,3,7,3,4
2019,150604,42,4,5,1,4
2019,150604,42,5,4,2,2
2019,150604,50,0,1,0,1
2019,150668,0,0,61,30,31
2019,150668,10,0,60,30,30
2019,150668,10,1,31,18,13
2019,150668,10,2,18,6,12
2019,150668,10,3,11,6,5
2019,150668,20,0,29,17,12
2019,150668,20,1,25,15,10
2019,150668,20,2,4,2,2
2019,150668,30,0,8,6,2
2019,150668,30,1,2,2,0
2019,150668,30,2,3,2,1
2019,150668,30,3,3,2,1
2019,150668,40,0,23,7,16
2019,150668,40,1,4,1,3
2019,150668,40,2,11,2,9
2019,150668,40,3,8,4,4
2019,150668,42,0,23,7,16
2019,150668,42,1,4,1,3
2019,150668,42,2,11,2,9
2019,150668,42,3,8,4,4
2019,150668,50,0,1,0,1
2019,150677,0,0,48,29,19
2019,150677,10,0,48,29,19
2019,150677,10,1,17,13,4
2019,150677,10,2,4,1,3
2019,150677,10,3,22,12,10
2019,150677,10,4,4,3,1
2019,150677,10,5,1,0,1
2019,150677,40,0,48,29,19
2019,150677,40,1,17,13,4
2019,150677,40,2,4,1,3
2019,150677,40,3,22,12,10
2019,150677,40,4,4,3,1
2019,150677,40,5,1,0,1
2019,150677,42,0,48,29,19
2019,150677,42,1,17,13,4
2019,150677,42,2,4,1,3
2019,150677,42,3,22,12,10
2019,150677,42,4,4,3,1
2019,150677,42,5,1,0,1
2019,150756,0,0,89,54,35
2019,150756,10,0,89,54,35
2019,150756,10,1,48,29,19
2019,150756,10,2,15,10,5
2019,150756,10,3,23,14,9
2019,150756,10,4,3,1,2
2019,150756,20,0,57,37,20
2019,150756,20,1,46,29,17
2019,150756,20,2,11,8,3
2019,150756,30,0,18,8,10
2019,150756,30,2,2,1,1
2019,150756,30,3,15,7,8
2019,150756,30,4,1,0,1
2019,150756,40,0,14,9,5
2019,150756,40,1,2,0,2
2019,150756,40,2,2,1,1
2019,150756,40,3,8,7,1
2019,150756,40,4,2,1,1
2019,150756,41,0,5,4,1
2019,150756,41,1,1,0,1
2019,150756,41,2,1,1,0
2019,150756,41,3,3,3,0
2019,150756,42,0,9,5,4
2019,150756,42,1,1,0,1
2019,150756,42,2,1,0,1
2019,150756,42,3,5,4,1
2019,150756,42,4,2,1,1
2019,150756,44,0,1,1,0
2019,150756,44,3,1,1,0
2019,150756,45,0,4,3,1
2019,150756,45,1,1,0,1
2019,150756,45,2,1,1,0
2019,150756,45,3,2,2,0
2019,150774,0,0,20,11,9
2019,150774,10,0,20,11,9
2019,150774,10,1,2,1,1
2019,150774,10,2,6,4,2
2019,150774,10,3,8,5,3
2019,150774,10,4,3,0,3
2019,150774,10,5,1,1,0
2019,150774,20,0,5,3,2
2019,150774,20,1,2,1,1
2019,150774,20,2,3,2,1
2019,150774,30,0,8,5,3
2019,150774,30,2,3,2,1
2019,150774,30,3,5,3,2
2019,150774,40,0,7,3,4
2019,150774,40,3,3,2,1
2019,150774,40,4,3,0,3
2019,150774,40,5,1,1,0
2019,150774,41,0,3,1,2
2019,150774,41,3,1,0,1
2019,150774,41,4,1,0,1
2019,150774,41,5,1,1,0
2019,150774,42,0,4,2,2
2019,150774,42,3,2,2,0
2019,150774,42,4,2,0,2
2019,150774,44,0,3,1,2
2019,150774,44,3,1,0,1
2019,150774,44,4,1,0,1
2019,150774,44,5,1,1,0
2019,150941,0,0,70,38,32
2019,150941,10,0,70,38,32
2019,150941,10,1,19,14,5
2019,150941,10,2,17,8,9
2019,150941,10,3,26,13,13
2019,150941,10,4,7,3,4
2019,150941,10,6,1,0,1
2019,150941,20,0,23,17,6
2019,150941,20,1,16,12,4
2019,150941,20,2,7,5,2
2019,150941,30,0,36,17,19
2019,150941,30,1,2,2,0
2019,150941,30,2,9,3,6
2019,150941,30,3,25,12,13
2019,150941,40,0,11,4,7
2019,150941,40,1,1,0,1
2019,150941,40,2,1,0,1
2019,150941,40,3,1,1,0
2019,150941,40,4,7,3,4
2019,150941,40,6,1,0,1
2019,150941,42,0,11,4,7
2019,150941,42,1,1,0,1
2019,150941,42,2,1,0,1
2019,150941,42,3,1,1,0
2019,150941,42,4,7,3,4
2019,150941,42,6,1,0,1
2019,150987,0,0,1230,501,729
2019,150987,10,0,1230,501,729
2019,150987,10,1,86,35,51
2019,150987,10,2,305,99,206
2019,150987,10,3,571,256,315
2019,150987,10,4,265,108,157
2019,150987,10,5,3,3,0
2019,150987,40,0,1230,501,729
2019,150987,40,1,86,35,51
2019,150987,40,2,305,99,206
2019,150987,40,3,571,256,315
2019,150987,40,4,265,108,157
2019,150987,40,5,3,3,0
2019,150987,42,0,1219,496,723
2019,150987,42,1,86,35,51
2019,150987,42,2,305,99,206
2019,150987,42,3,570,255,315
2019,150987,42,4,256,105,151
2019,150987,42,5,2,2,0
2019,150987,43,0,11,5,6
2019,150987,43,3,1,1,0
2019,150987,43,4,9,3,6
2019,150987,43,5,1,1,0
2019,151102,0,0,310,185,125
2019,151102,10,0,246,148,98
2019,151102,10,1,57,42,15
2019,151102,10,2,109,61,48
2019,151102,10,3,70,43,27
2019,151102,10,4,10,2,8
2019,151102,20,0,162,101,61
2019,151102,20,1,57,42,15
2019,151102,20,2,103,58,45
2019,151102,20,4,2,1,1
2019,151102,30,0,50,31,19
2019,151102,30,2,6,3,3
2019,151102,30,3,44,28,16
2019,151102,40,0,34,16,18
2019,151102,40,3,26,15,11
2019,151102,40,4,8,1,7
2019,151102,41,0,20,7,13
2019,151102,41,3,14,6,8
2019,151102,41,4,6,1,5
2019,151102,42,0,2,2,0
2019,151102,42,3,2,2,0
2019,151102,43,0,12,7,5
2019,151102,43,3,10,7,3
2019,151102,43,4,2,0,2
2019,151102,44,0,2,0,2
2019,151102,44,3,2,0,2
2019,151102,45,0,18,7,11
2019,151102,45,3,12,6,6
2019,151102,45,4,6,1,5
2019,151102,50,0,64,37,27
2019,151111,0,0,2542,1404,1138
2019,151111,10,0,2527,1400,1127
2019,151111,10,1,545,388,157
2019,151111,10,2,621,364,257
2019,151111,10,3,1042,512,530
2019,151111,10,5,319,136,183
2019,151111,20,0,854,573,281
2019,151111,20,1,456,337,119
2019,151111,20,2,396,234,162
2019,151111,20,3,2,2,0
2019,151111,30,0,334,178,156
2019,151111,30,1,4,3,1
2019,151111,30,2,34,21,13
2019,151111,30,3,296,154,142
2019,151111,40,0,1339,649,690
2019,151111,40,1,85,48,37
2019,151111,40,2,191,109,82
2019,151111,40,3,744,356,388
2019,151111,40,5,319,136,183
2019,151111,41,0,1242,617,625
2019,151111,41,1,81,47,34
2019,151111,41,2,188,108,80
2019,151111,41,3,711,344,367
2019,151111,41,5,262,118,144
2019,151111,42,0,97,32,65
2019,151111,42,1,4,1,3
2019,151111,42,2,3,1,2
2019,151111,42,3,33,12,21
2019,151111,42,5,57,18,39
2019,151111,44,0,122,70,52
2019,151111,44,1,12,8,4
2019,151111,44,2,39,19,20
2019,151111,44,3,62,38,24
2019,151111,44,5,9,5,4
2019,151111,45,0,1120,547,573
2019,151111,45,1,69,39,30
2019,151111,45,2,149,89,60
2019,151111,45,3,649,306,343
2019,151111,45,5,253,113,140
2019,151111,50,0,15,4,11
2019,151263,0,0,302,126,176
2019,151263,10,0,302,126,176
2019,151263,10,1,40,18,22
2019,151263,10,2,76,36,40
2019,151263,10,3,157,61,96
2019,151263,10,4,29,11,18
2019,151263,20,0,102,48,54
2019,151263,20,1,38,18,20
2019,151263,20,2,64,30,34
2019,151263,30,0,108,42,66
2019,151263,30,1,1,0,1
2019,151263,30,2,5,3,2
2019,151263,30,3,102,39,63
2019,151263,40,0,92,36,56
2019,151263,40,1,1,0,1
2019,151263,40,2,7,3,4
2019,151263,40,3,55,22,33
2019,151263,40,4,29,11,18
2019,151263,42,0,92,36,56
2019,151263,42,1,1,0,1
2019,151263,42,2,7,3,4
2019,151263,42,3,55,22,33
2019,151263,42,4,29,11,18
2019,151290,0,0,63,34,29
2019,151290,10,0,63,34,29
2019,151290,10,1,6,5,1
2019,151290,10,2,29,15,14
2019,151290,10,3,25,13,12
2019,151290,10,5,3,1,2
2019,151290,20,0,29,18,11
2019,151290,20,1,6,5,1
2019,151290,20,2,23,13,10
2019,151290,30,0,27,14,13
2019,151290,30,2,4,2,2
2019,151290,30,3,23,12,11
2019,151290,40,0,7,2,5
2019,151290,40,2,2,0,2
2019,151290,40,3,2,1,1
2019,151290,40,5,3,1,2
2019,151290,42,0,7,2,5
2019,151290,42,2,2,0,2
2019,151290,42,3,2,1,1
2019,151290,42,5,3,1,2
2019,151306,0,0,360,159,201
2019,151306,10,0,360,159,201
2019,151306,10,1,44,27,17
2019,151306,10,2,117,58,59
2019,151306,10,3,119,47,72
2019,151306,10,4,80,27,53
2019,151306,20,0,151,85,66
2019,151306,20,1,42,26,16
2019,151306,20,2,104,55,49
2019,151306,20,3,5,4,1
2019,151306,30,0,96,39,57
2019,151306,30,1,1,0,1
2019,151306,30,2,9,3,6
2019,151306,30,3,85,36,49
2019,151306,30,4,1,0,1
2019,151306,40,0,113,35,78
2019,151306,40,1,1,1,0
2019,151306,40,2,4,0,4
2019,151306,40,3,29,7,22
2019,151306,40,4,79,27,52
2019,151306,41,0,105,32,73
2019,151306,41,1,1,1,0
2019,151306,41,2,4,0,4
2019,151306,41,3,28,7,21
2019,151306,41,4,72,24,48
2019,151306,42,0,8,3,5
2019,151306,42,3,1,0,1
2019,151306,42,4,7,3,4
2019,151306,44,0,17,6,11
2019,151306,44,3,4,0,4
2019,151306,44,4,13,6,7
2019,151306,45,0,88,26,62
2019,151306,45,1,1,1,0
2019,151306,45,2,4,0,4
2019,151306,45,3,24,7,17
2019,151306,45,4,59,18,41
2019,151324,0,0,474,253,221
2019,151324,10,0,474,253,221
2019,151324,10,1,129,83,46
2019,151324,10,2,105,51,54
2019,151324,10,3,118,59,59
2019,151324,10,4,111,53,58
2019,151324,10,5,11,7,4
2019,151324,20,0,234,134,100
2019,151324,20,1,129,83,46
2019,151324,20,2,104,50,54
2019,151324,20,3,1,1,0
2019,151324,30,0,118,59,59
2019,151324,30,2,1,1,0
2019,151324,30,3,117,58,59
2019,151324,40,0,122,60,62
2019,151324,40,4,111,53,58
2019,151324,40,5,11,7,4
2019,151324,41,0,111,53,58
2019,151324,41,4,111,53,58
2019,151324,42,0,11,7,4
2019,151324,42,5,11,7,4
2019,151324,44,0,111,53,58
2019,151324,44,4,111,53,58
2019,151333,0,0,125,45,80
2019,151333,10,0,125,45,80
2019,151333,10,1,12,8,4
2019,151333,10,2,23,13,10
2019,151333,10,3,46,16,30
2019,151333,10,5,44,8,36
2019,151333,20,0,27,17,10
2019,151333,20,1,11,8,3
2019,151333,20,2,16,9,7
2019,151333,30,0,41,18,23
2019,151333,30,2,6,4,2
2019,151333,30,3,35,14,21
2019,151333,40,0,57,10,47
2019,151333,40,1,1,0,1
2019,151333,40,2,1,0,1
2019,151333,40,3,11,2,9
2019,151333,40,5,44,8,36
2019,151333,41,0,48,8,40
2019,151333,41,1,1,0,1
2019,151333,41,2,1,0,1
2019,151333,41,3,11,2,9
2019,151333,41,5,35,6,29
2019,151333,42,0,9,2,7
2019,151333,42,5,9,2,7
2019,151333,44,0,12,1,11
2019,151333,44,1,1,0,1
2019,151333,44,2,1,0,1
2019,151333,44,3,3,0,3
2019,151333,44,5,7,1,6
2019,151333,45,0,36,7,29
2019,151333,45,3,8,2,6
2019,151333,45,5,28,5,23
2019,151342,0,0,245,123,122
2019,151342,10,0,245,123,122
2019,151342,10,1,54,32,22
2019,151342,10,2,79,48,31
2019,151342,10,3,54,24,30
2019,151342,10,5,58,19,39
2019,151342,20,0,128,76,52
2019,151342,20,1,54,32,22
2019,151342,20,2,74,44,30
2019,151342,30,0,28,19,9
2019,151342,30,2,5,4,1
2019,151342,30,3,23,15,8
2019,151342,40,0,89,28,61
2019,151342,40,3,31,9,22
2019,151342,40,5,58,19,39
2019,151342,41,0,73,18,55
2019,151342,41,3,24,4,20
2019,151342,41,5,49,14,35
2019,151342,42,0,16,10,6
2019,151342,42,3,7,5,2
2019,151342,42,5,9,5,4
2019,151342,44,0,11,2,9
2019,151342,44,3,1,1,0
2019,151342,44,5,10,1,9
2019,151342,45,0,62,16,46
2019,151342,45,3,23,3,20
2019,151342,45,5,39,13,26
2019,151351,0,0,2153,1281,872
2019,151351,10,0,2142,1277,865
2019,151351,10,1,714,506,208
2019,151351,10,2,538,307,231
2019,151351,10,3,424,242,182
2019,151351,10,5,466,222,244
2019,151351,20,0,1022,684,338
2019,151351,20,1,639,460,179
2019,151351,20,2,383,224,159
2019,151351,30,0,396,237,159
2019,151351,30,1,2,1,1
2019,151351,30,2,94,55,39
2019,151351,30,3,300,181,119
2019,151351,40,0,724,356,368
2019,151351,40,1,73,45,28
2019,151351,40,2,61,28,33
2019,151351,40,3,124,61,63
2019,151351,40,5,466,222,244
2019,151351,41,0,579,276,303
2019,151351,41,1,68,43,25
2019,151351,41,2,56,26,30
2019,151351,41,3,52,17,35
2019,151351,41,5,403,190,213
2019,151351,42,0,145,80,65
2019,151351,42,1,5,2,3
2019,151351,42,2,5,2,3
2019,151351,42,3,72,44,28
2019,151351,42,5,63,32,31
2019,151351,44,0,11,4,7
2019,151351,44,1,4,4,0
2019,151351,44,2,4,0,4
2019,151351,44,5,3,0,3
2019,151351,45,0,568,272,296
2019,151351,45,1,64,39,25
2019,151351,45,2,52,26,26
2019,151351,45,3,52,17,35
2019,151351,45,5,400,190,210
2019,151351,50,0,11,4,7
2019,151360,0,0,153,71,82
2019,151360,10,0,152,70,82
2019,151360,10,1,31,19,12
2019,151360,10,2,47,26,21
2019,151360,10,3,54,17,37
2019,151360,10,5,20,8,12
2019,151360,20,0,69,42,27
2019,151360,20,1,31,19,12
2019,151360,20,2,38,23,15
2019,151360,30,0,26,11,15
2019,151360,30,2,5,2,3
2019,151360,30,3,21,9,12
2019,151360,40,0,57,17,40
2019,151360,40,2,4,1,3
2019,151360,40,3,33,8,25
2019,151360,40,5,20,8,12
2019,151360,41,0,52,14,38
2019,151360,41,2,4,1,3
2019,151360,41,3,33,8,25
2019,151360,41,5,15,5,10
2019,151360,42,0,5,3,2
2019,151360,42,5,5,3,2
2019,151360,44,0,4,2,2
2019,151360,44,3,1,1,0
2019,151360,44,5,3,1,2
2019,151360,45,0,48,12,36
2019,151360,45,2,4,1,3
2019,151360,45,3,32,7,25
2019,151360,45,5,12,4,8
2019,151360,50,0,1,1,0
2019,151379,0,0,199,89,110
2019,151379,10,0,199,89,110
2019,151379,10,1,43,22,21
2019,151379,10,2,58,29,29
2019,151379,10,3,50,21,29
2019,151379,10,5,48,17,31
2019,151379,20,0,91,48,43
2019,151379,20,1,39,21,18
2019,151379,20,2,52,27,25
2019,151379,30,0,36,15,21
2019,151379,30,1,2,1,1
2019,151379,30,2,5,2,3
2019,151379,30,3,29,12,17
2019,151379,40,0,72,26,46
2019,151379,40,1,2,0,2
2019,151379,40,2,1,0,1
2019,151379,40,3,21,9,12
2019,151379,40,5,48,17,31
2019,151379,41,0,57,18,39
2019,151379,41,1,2,0,2
2019,151379,41,2,1,0,1
2019,151379,41,3,8,2,6
2019,151379,41,5,46,16,30
2019,151379,42,0,15,8,7
2019,151379,42,3,13,7,6
2019,151379,42,5,2,1,1
2019,151379,45,0,57,18,39
2019,151379,45,1,2,0,2
2019,151379,45,2,1,0,1
2019,151379,45,3,8,2,6
2019,151379,45,5,46,16,30
2019,151388,0,0,103,36,67
2019,151388,10,0,103,36,67
2019,151388,10,1,8,5,3
2019,151388,10,2,28,11,17
2019,151388,10,3,42,13,29
2019,151388,10,5,25,7,18
2019,151388,20,0,31,13,18
2019,151388,20,1,8,5,3
2019,151388,20,2,23,8,15
2019,151388,30,0,37,13,24
2019,151388,30,2,4,2,2
2019,151388,30,3,33,11,22
2019,151388,40,0,35,10,25
2019,151388,40,2,1,1,0
2019,151388,40,3,9,2,7
2019,151388,40,5,25,7,18
2019,151388,41,0,26,6,20
2019,151388,41,3,5,0,5
2019,151388,41,5,21,6,15
2019,151388,42,0,9,4,5
2019,151388,42,2,1,1,0
2019,151388,42,3,4,2,2
2019,151388,42,5,4,1,3
2019,151388,44,0,4,0,4
2019,151388,44,3,2,0,2
2019,151388,44,5,2,0,2
2019,151388,45,0,22,6,16
2019,151388,45,3,3,0,3
2019,151388,45,5,19,6,13
2019,151458,0,0,7,2,5
2019,151458,50,0,7,2,5
2019,151467,0,0,15,1,14
2019,151467,10,0,15,1,14
2019,151467,10,4,15,1,14
2019,151467,40,0,15,1,14
2019,151467,40,4,15,1,14
2019,151467,41,0,15,1,14
2019,151467,41,4,15,1,14
2019,151467,45,0,15,1,14
2019,151467,45,4,15,1,14
2019,151661,0,0,33,33,0
2019,151661,10,0,33,33,0
2019,151661,10,4,33,33,0
2019,151661,40,0,33,33,0
2019,151661,40,4,33,33,0
2019,151661,41,0,33,33,0
2019,151661,41,4,33,33,0
2019,151661,45,0,33,33,0
2019,151661,45,4,33,33,0
2019,151777,0,0,115,58,57
2019,151777,10,0,115,58,57
2019,151777,10,1,32,17,15
2019,151777,10,2,39,21,18
2019,151777,10,3,41,19,22
2019,151777,10,4,3,1,2
2019,151777,20,0,62,34,28
2019,151777,20,1,30,16,14
2019,151777,20,2,31,18,13
2019,151777,20,3,1,0,1
2019,151777,30,0,24,11,13
2019,151777,30,2,4,1,3
2019,151777,30,3,20,10,10
2019,151777,40,0,29,13,16
2019,151777,40,1,2,1,1
2019,151777,40,2,4,2,2
2019,151777,40,3,20,9,11
2019,151777,40,4,3,1,2
2019,151777,42,0,29,13,16
2019,151777,42,1,2,1,1
2019,151777,42,2,4,2,2
2019,151777,42,3,20,9,11
2019,151777,42,4,3,1,2
2019,151786,0,0,176,77,99
2019,151786,10,0,176,77,99
2019,151786,10,1,13,11,2
2019,151786,10,2,35,21,14
2019,151786,10,3,118,41,77
2019,151786,10,4,8,3,5
2019,151786,10,5,1,1,0
2019,151786,10,6,1,0,1
2019,151786,20,0,30,22,8
2019,151786,20,1,11,9,2
2019,151786,20,2,17,12,5
2019,151786,20,3,2,1,1
2019,151786,30,0,40,18,22
2019,151786,30,2,9,5,4
2019,151786,30,3,31,13,18
2019,151786,40,0,106,37,69
2019,151786,40,1,2,2,0
2019,151786,40,2,9,4,5
2019,151786,40,3,85,27,58
2019,151786,40,4,8,3,5
2019,151786,40,5,1,1,0
2019,151786,40,6,1,0,1
2019,151786,41,0,105,37,68
2019,151786,41,1,2,2,0
2019,151786,41,2,9,4,5
2019,151786,41,3,84,27,57
2019,151786,41,4,8,3,5
2019,151786,41,5,1,1,0
2019,151786,41,6,1,0,1
2019,151786,42,0,1,0,1
2019,151786,42,3,1,0,1
2019,151786,45,0,105,37,68
2019,151786,45,1,2,2,0
2019,151786,45,2,9,4,5
2019,151786,45,3,84,27,57
2019,151786,45,4,8,3,5
2019,151786,45,5,1,1,0
2019,151786,45,6,1,0,1
2019,151801,0,0,287,146,141
2019,151801,10,0,287,146,141
2019,151801,10,1,80,52,28
2019,151801,10,2,88,47,41
2019,151801,10,3,111,43,68
2019,151801,10,4,4,2,2
2019,151801,10,6,4,2,2
2019,151801,40,0,287,146,141
2019,151801,40,1,80,52,28
2019,151801,40,2,88,47,41
2019,151801,40,3,111,43,68
2019,151801,40,4,4,2,2
2019,151801,40,6,4,2,2
2019,151801,41,0,256,135,121
2019,151801,41,1,76,49,27
2019,151801,41,2,81,43,38
2019,151801,41,3,93,39,54
2019,151801,41,4,4,2,2
2019,151801,41,6,2,2,0
2019,151801,42,0,31,11,20
2019,151801,42,1,4,3,1
2019,151801,42,2,7,4,3
2019,151801,42,3,18,4,14
2019,151801,42,6,2,0,2
2019,151801,44,0,256,135,121
2019,151801,44,1,76,49,27
2019,151801,44,2,81,43,38
2019,151801,44,3,93,39,54
2019,151801,44,4,4,2,2
2019,151801,44,6,2,2,0
2019,151810,0,0,5,4,1
2019,151810,10,0,5,4,1
2019,151810,10,1,2,2,0
2019,151810,10,2,2,1,1
2019,151810,10,3,1,1,0
2019,151810,40,0,5,4,1
2019,151810,40,1,2,2,0
2019,151810,40,2,2,1,1
2019,151810,40,3,1,1,0
2019,151810,41,0,5,4,1
2019,151810,41,1,2,2,0
2019,151810,41,2,2,1,1
2019,151810,41,3,1,1,0
2019,151810,45,0,5,4,1
2019,151810,45,1,2,2,0
2019,151810,45,2,2,1,1
2019,151810,45,3,1,1,0
2019,151865,0,0,7,5,2
2019,151865,10,0,7,5,2
2019,151865,10,2,5,4,1
2019,151865,10,3,2,1,1
2019,151865,20,0,5,4,1
2019,151865,20,2,5,4,1
2019,151865,30,0,2,1,1
2019,151865,30,3,2,1,1
2019,152080,0,0,1224,847,377
2019,152080,10,0,1196,829,367
2019,152080,10,1,419,347,72
2019,152080,10,2,281,182,99
2019,152080,10,3,196,127,69
2019,152080,10,4,2,1,1
2019,152080,10,6,298,172,126
2019,152080,20,0,685,519,166
2019,152080,20,1,419,347,72
2019,152080,20,2,266,172,94
2019,152080,30,0,207,132,75
2019,152080,30,2,15,10,5
2019,152080,30,3,190,121,69
2019,152080,30,4,2,1,1
2019,152080,40,0,304,178,126
2019,152080,40,3,6,6,0
2019,152080,40,6,298,172,126
2019,152080,41,0,159,94,65
2019,152080,41,6,159,94,65
2019,152080,42,0,138,77,61
2019,152080,42,3,6,6,0
2019,152080,42,6,132,71,61
2019,152080,43,0,7,7,0
2019,152080,43,6,7,7,0
2019,152080,44,0,159,94,65
2019,152080,44,6,159,94,65
2019,152080,50,0,28,18,10
2019,152099,0,0,34,18,16
2019,152099,10,0,34,18,16
2019,152099,10,1,8,5,3
2019,152099,10,2,10,6,4
2019,152099,10,3,6,3,3
2019,152099,10,5,10,4,6
2019,152099,40,0,34,18,16
2019,152099,40,1,8,5,3
2019,152099,40,2,10,6,4
2019,152099,40,3,6,3,3
2019,152099,40,5,10,4,6
2019,152099,42,0,34,18,16
2019,152099,42,1,8,5,3
2019,152099,42,2,10,6,4
2019,152099,42,3,6,3,3
2019,152099,42,5,10,4,6
2019,152318,0,0,186,138,48
2019,152318,10,0,186,138,48
2019,152318,10,1,72,59,13
2019,152318,10,2,59,46,13
2019,152318,10,3,53,33,20
2019,152318,10,4,1,0,1
2019,152318,10,5,1,0,1
2019,152318,20,0,125,100,25
2019,152318,20,1,71,58,13
2019,152318,20,2,54,42,12
2019,152318,30,0,46,32,14
2019,152318,30,1,1,1,0
2019,152318,30,2,4,3,1
2019,152318,30,3,41,28,13
2019,152318,40,0,15,6,9
2019,152318,40,2,1,1,0
2019,152318,40,3,12,5,7
2019,152318,40,4,1,0,1
2019,152318,40,5,1,0,1
2019,152318,42,0,15,6,9
2019,152318,42,2,1,1,0
2019,152318,42,3,12,5,7
2019,152318,42,4,1,0,1
2019,152318,42,5,1,0,1
2019,152336,0,0,129,51,78
2019,152336,10,0,129,51,78
2019,152336,10,1,13,9,4
2019,152336,10,2,32,15,17
2019,152336,10,3,66,23,43
2019,152336,10,4,18,4,14
2019,152336,20,0,43,24,19
2019,152336,20,1,13,9,4
2019,152336,20,2,25,12,13
2019,152336,20,3,5,3,2
2019,152336,30,0,41,20,21
2019,152336,30,2,5,3,2
2019,152336,30,3,33,16,17
2019,152336,30,4,3,1,2
2019,152336,40,0,45,7,38
2019,152336,40,2,2,0,2
2019,152336,40,3,28,4,24
2019,152336,40,4,15,3,12
2019,152336,42,0,45,7,38
2019,152336,42,2,2,0,2
2019,152336,42,3,28,4,24
2019,152336,42,4,15,3,12
2019,152381,0,0,53,15,38
2019,152381,10,0,53,15,38
2019,152381,10,1,8,4,4
2019,152381,10,2,18,4,14
2019,152381,10,3,19,5,14
2019,152381,10,4,7,2,5
2019,152381,10,5,1,0,1
2019,152381,20,0,23,8,15
2019,152381,20,1,8,4,4
2019,152381,20,2,15,4,11
2019,152381,30,0,16,3,13
2019,152381,30,2,3,0,3
2019,152381,30,3,13,3,10
2019,152381,40,0,14,4,10
2019,152381,40,3,6,2,4
2019,152381,40,4,7,2,5
2019,152381,40,5,1,0,1
2019,152381,41,0,1,0,1
2019,152381,41,4,1,0,1
2019,152381,42,0,13,4,9
2019,152381,42,3,6,2,4
2019,152381,42,4,6,2,4
2019,152381,42,5,1,0,1
2019,152381,44,0,1,0,1
2019,152381,44,4,1,0,1
2019,152390,0,0,146,46,100
2019,152390,10,0,146,46,100
2019,152390,10,1,26,9,17
2019,152390,10,2,44,13,31
2019,152390,10,3,52,18,34
2019,152390,10,5,7,2,5
2019,152390,10,6,17,4,13
2019,152390,20,0,72,23,49
2019,152390,20,1,26,9,17
2019,152390,20,2,43,13,30
2019,152390,20,3,3,1,2
2019,152390,30,0,40,12,28
2019,152390,30,2,1,0,1
2019,152390,30,3,38,12,26
2019,152390,30,6,1,0,1
2019,152390,40,0,34,11,23
2019,152390,40,3,11,5,6
2019,152390,40,5,7,2,5
2019,152390,40,6,16,4,12
2019,152390,41,0,11,2,9
2019,152390,41,5,4,1,3
2019,152390,41,6,7,1,6
2019,152390,42,0,16,7,9
2019,152390,42,3,10,5,5
2019,152390,42,5,1,0,1
2019,152390,42,6,5,2,3
2019,152390,43,0,7,2,5
2019,152390,43,3,1,0,1
2019,152390,43,5,2,1,1
2019,152390,43,6,4,1,3
2019,152390,44,0,11,2,9
2019,152390,44,5,4,1,3
2019,152390,44,6,7,1,6
2019,152451,0,0,11,9,2
2019,152451,10,0,10,9,1
2019,152451,10,1,4,4,0
2019,152451,10,2,3,2,1
2019,152451,10,3,3,3,0
2019,152451,20,0,7,6,1
2019,152451,20,1,4,4,0
2019,152451,20,2,3,2,1
2019,152451,30,0,3,3,0
2019,152451,30,3,3,3,0
2019,152451,50,0,1,0,1
2019,152530,0,0,134,88,46
2019,152530,10,0,134,88,46
2019,152530,10,1,49,38,11
2019,152530,10,2,34,23,11
2019,152530,10,3,47,24,23
2019,152530,10,4,4,3,1
2019,152530,20,0,67,51,16
2019,152530,20,1,44,35,9
2019,152530,20,2,23,16,7
2019,152530,30,0,48,28,20
2019,152530,30,1,5,3,2
2019,152530,30,2,8,6,2
2019,152530,30,3,35,19,16
2019,152530,40,0,19,9,10
2019,152530,40,2,3,1,2
2019,152530,40,3,12,5,7
2019,152530,40,4,4,3,1
2019,152530,41,0,1,0,1
2019,152530,41,3,1,0,1
2019,152530,42,0,18,9,9
2019,152530,42,2,3,1,2
2019,152530,42,3,11,5,6
2019,152530,42,4,4,3,1
2019,152530,45,0,1,0,1
2019,152530,45,3,1,0,1
2019,152567,0,0,124,73,51
2019,152567,10,0,124,73,51
2019,152567,10,1,11,10,1
2019,152567,10,2,35,23,12
2019,152567,10,3,56,29,27
2019,152567,10,4,10,5,5
2019,152567,10,5,12,6,6
2019,152567,40,0,124,73,51
2019,152567,40,1,11,10,1
2019,152567,40,2,35,23,12
2019,152567,40,3,56,29,27
2019,152567,40,4,10,5,5
2019,152567,40,5,12,6,6
2019,152567,42,0,124,73,51
2019,152567,42,1,11,10,1
2019,152567,42,2,35,23,12
2019,152567,42,3,56,29,27
2019,152567,42,4,10,5,5
2019,152567,42,5,12,6,6
2019,152600,0,0,293,160,133
2019,152600,10,0,293,160,133
2019,152600,10,1,64,47,17
2019,152600,10,2,94,45,49
2019,152600,10,3,78,42,36
2019,152600,10,4,7,4,3
2019,152600,10,5,50,22,28
2019,152600,20,0,143,80,63
2019,152600,20,1,60,43,17
2019,152600,20,2,82,36,46
2019,152600,20,3,1,1,0
2019,152600,30,0,83,46,37
2019,152600,30,2,11,8,3
2019,152600,30,3,68,37,31
2019,152600,30,4,4,1,3
2019,152600,40,0,67,34,33
2019,152600,40,1,4,4,0
2019,152600,40,2,1,1,0
2019,152600,40,3,9,4,5
2019,152600,40,4,3,3,0
2019,152600,40,5,50,22,28
2019,152600,41,0,4,1,3
2019,152600,41,5,4,1,3
2019,152600,42,0,63,33,30
2019,152600,42,1,4,4,0
2019,152600,42,2,1,1,0
2019,152600,42,3,9,4,5
2019,152600,42,4,3,3,0
2019,152600,42,5,46,21,25
2019,152600,44,0,4,1,3
2019,152600,44,5,4,1,3
2019,152637,0,0,188,92,96
2019,152637,10,0,188,92,96
2019,152637,10,1,30,9,21
2019,152637,10,2,44,23,21
2019,152637,10,3,78,29,49
2019,152637,10,4,36,31,5
2019,152637,20,0,46,19,27
2019,152637,20,1,25,7,18
2019,152637,20,2,20,11,9
2019,152637,20,4,1,1,0
2019,152637,30,0,13,8,5
2019,152637,30,1,1,1,0
2019,152637,30,2,6,4,2
2019,152637,30,3,6,3,3
2019,152637,40,0,129,65,64
2019,152637,40,1,4,1,3
2019,152637,40,2,18,8,10
2019,152637,40,3,72,26,46
2019,152637,40,4,35,30,5
2019,152637,42,0,129,65,64
2019,152637,42,1,4,1,3
2019,152637,42,2,18,8,10
2019,152637,42,3,72,26,46
2019,152637,42,4,35,30,5
2019,152673,0,0,96,59,37
2019,152673,10,0,96,59,37
2019,152673,10,1,24,18,6
2019,152673,10,2,35,21,14
2019,152673,10,3,34,20,14
2019,152673,10,4,3,0,3
2019,152673,20,0,57,37,20
2019,152673,20,1,24,18,6
2019,152673,20,2,33,19,14
2019,152673,30,0,21,11,10
2019,152673,30,3,21,11,10
2019,152673,40,0,18,11,7
2019,152673,40,2,2,2,0
2019,152673,40,3,13,9,4
2019,152673,40,4,3,0,3
2019,152673,41,0,10,7,3
2019,152673,41,2,2,2,0
2019,152673,41,3,7,5,2
2019,152673,41,4,1,0,1
2019,152673,42,0,8,4,4
2019,152673,42,3,6,4,2
2019,152673,42,4,2,0,2
2019,152673,44,0,9,6,3
2019,152673,44,2,1,1,0
2019,152673,44,3,7,5,2
2019,152673,44,4,1,0,1
2019,152673,45,0,1,1,0
2019,152673,45,2,1,1,0
2019,152798,0,0,45,5,40
2019,152798,10,0,45,5,40
2019,152798,10,1,11,0,11
2019,152798,10,2,17,2,15
2019,152798,10,3,15,3,12
2019,152798,10,4,2,0,2
2019,152798,40,0,45,5,40
2019,152798,40,1,11,0,11
2019,152798,40,2,17,2,15
2019,152798,40,3,15,3,12
2019,152798,40,4,2,0,2
2019,152798,41,0,7,3,4
2019,152798,41,1,2,0,2
2019,152798,41,2,2,2,0
2019,152798,41,3,3,1,2
2019,152798,42,0,38,2,36
2019,152798,42,1,9,0,9
2019,152798,42,2,15,0,15
2019,152798,42,3,12,2,10
2019,152798,42,4,2,0,2
2019,152798,44,0,7,3,4
2019,152798,44,1,2,0,2
2019,152798,44,2,2,2,0
2019,152798,44,3,3,1,2
2019,152992,0,0,66,33,33
2019,152992,10,0,66,33,33
2019,152992,10,1,14,10,4
2019,152992,10,2,18,11,7
2019,152992,10,3,30,12,18
2019,152992,10,4,3,0,3
2019,152992,10,6,1,0,1
2019,152992,20,0,32,21,11
2019,152992,20,1,13,9,4
2019,152992,20,2,13,7,6
2019,152992,20,3,6,5,1
2019,152992,30,0,29,12,17
2019,152992,30,1,1,1,0
2019,152992,30,2,5,4,1
2019,152992,30,3,23,7,16
2019,152992,40,0,5,0,5
2019,152992,40,3,1,0,1
2019,152992,40,4,3,0,3
2019,152992,40,6,1,0,1
2019,152992,42,0,3,0,3
2019,152992,42,3,1,0,1
2019,152992,42,4,2,0,2
2019,152992,43,0,2,0,2
2019,152992,43,4,1,0,1
2019,152992,43,6,1,0,1
2019,153001,0,0,84,37,47
2019,153001,10,0,84,37,47
2019,153001,10,1,20,9,11
2019,153001,10,2,20,8,12
2019,153001,10,3,29,13,16
2019,153001,10,4,15,7,8
2019,153001,20,0,38,18,20
2019,153001,20,1,19,9,10
2019,153001,20,2,16,6,10
2019,153001,20,3,3,3,0
2019,153001,30,0,23,9,14
2019,153001,30,2,4,2,2
2019,153001,30,3,19,7,12
2019,153001,40,0,23,10,13
2019,153001,40,1,1,0,1
2019,153001,40,3,7,3,4
2019,153001,40,4,15,7,8
2019,153001,42,0,23,10,13
2019,153001,42,1,1,0,1
2019,153001,42,3,7,3,4
2019,153001,42,4,15,7,8
2019,153108,0,0,97,50,47
2019,153108,10,0,97,50,47
2019,153108,10,1,32,20,12
2019,153108,10,2,31,14,17
2019,153108,10,3,18,10,8
2019,153108,10,5,16,6,10
2019,153108,20,0,62,33,29
2019,153108,20,1,31,19,12
2019,153108,20,2,31,14,17
2019,153108,30,0,19,11,8
2019,153108,30,1,1,1,0
2019,153108,30,3,18,10,8
2019,153108,40,0,16,6,10
2019,153108,40,5,16,6,10
2019,153108,41,0,16,6,10
2019,153108,41,5,16,6,10
2019,153108,45,0,16,6,10
2019,153108,45,5,16,6,10
2019,153126,0,0,80,24,56
2019,153126,10,0,80,24,56
2019,153126,10,1,21,7,14
2019,153126,10,2,18,8,10
2019,153126,10,3,33,8,25
2019,153126,10,4,8,1,7
2019,153126,20,0,39,15,24
2019,153126,20,1,21,7,14
2019,153126,20,2,17,7,10
2019,153126,20,3,1,1,0
2019,153126,30,0,22,6,16
2019,153126,30,2,1,1,0
2019,153126,30,3,21,5,16
2019,153126,40,0,19,3,16
2019,153126,40,3,11,2,9
2019,153126,40,4,8,1,7
2019,153126,41,0,7,0,7
2019,153126,41,3,6,0,6
2019,153126,41,4,1,0,1
2019,153126,42,0,12,3,9
2019,153126,42,3,5,2,3
2019,153126,42,4,7,1,6
2019,153126,44,0,7,0,7
2019,153126,44,3,6,0,6
2019,153126,44,4,1,0,1
2019,153144,0,0,114,55,59
2019,153144,10,0,109,54,55
2019,153144,10,1,27,18,9
2019,153144,10,2,28,13,15
2019,153144,10,3,54,23,31
2019,153144,20,0,60,34,26
2019,153144,20,1,27,18,9
2019,153144,20,2,28,13,15
2019,153144,20,3,5,3,2
2019,153144,30,0,33,14,19
2019,153144,30,3,33,14,19
2019,153144,40,0,16,6,10
2019,153144,40,3,16,6,10
2019,153144,41,0,9,4,5
2019,153144,41,3,9,4,5
2019,153144,42,0,7,2,5
2019,153144,42,3,7,2,5
2019,153144,44,0,9,4,5
2019,153144,44,3,9,4,5
2019,153144,50,0,5,1,4
2019,153162,0,0,78,35,43
2019,153162,10,0,75,34,41
2019,153162,10,1,43,22,21
2019,153162,10,2,12,3,9
2019,153162,10,3,20,9,11
2019,153162,20,0,55,25,30
2019,153162,20,1,43,22,21
2019,153162,20,2,12,3,9
2019,153162,30,0,20,9,11
2019,153162,30,3,20,9,11
2019,153162,50,0,3,1,2
2019,153214,0,0,355,171,184
2019,153214,10,0,355,171,184
2019,153214,10,1,220,112,108
2019,153214,10,2,45,20,25
2019,153214,10,4,90,39,51
2019,153214,40,0,355,171,184
2019,153214,40,1,220,112,108
2019,153214,40,2,45,20,25
2019,153214,40,4,90,39,51
2019,153214,42,0,355,171,184
2019,153214,42,1,220,112,108
2019,153214,42,2,45,20,25
2019,153214,42,4,90,39,51
2019,153241,0,0,17,7,10
2019,153241,10,0,17,7,10
2019,153241,10,1,1,1,0
2019,153241,10,2,1,1,0
2019,153241,10,3,9,4,5
2019,153241,10,4,5,0,5
2019,153241,10,5,1,1,0
2019,153241,40,0,17,7,10
2019,153241,40,1,1,1,0
2019,153241,40,2,1,1,0
2019,153241,40,3,9,4,5
2019,153241,40,4,5,0,5
2019,153241,40,5,1,1,0
2019,153241,41,0,17,7,10
2019,153241,41,1,1,1,0
2019,153241,41,2,1,1,0
2019,153241,41,3,9,4,5
2019,153241,41,4,5,0,5
2019,153241,41,5,1,1,0
2019,153241,44,0,17,7,10
2019,153241,44,1,1,1,0
2019,153241,44,2,1,1,0
2019,153241,44,3,9,4,5
2019,153241,44,4,5,0,5
2019,153241,44,5,1,1,0
2019,153250,0,0,88,63,25
2019,153250,10,0,88,63,25
2019,153250,10,1,38,31,7
2019,153250,10,2,27,20,7
2019,153250,10,3,10,6,4
2019,153250,10,4,13,6,7
2019,153250,40,0,88,63,25
2019,153250,40,1,38,31,7
2019,153250,40,2,27,20,7
2019,153250,40,3,10,6,4
2019,153250,40,4,13,6,7
2019,153250,41,0,88,63,25
2019,153250,41,1,38,31,7
2019,153250,41,2,27,20,7
2019,153250,41,3,10,6,4
2019,153250,41,4,13,6,7
2019,153250,44,0,88,63,25
2019,153250,44,1,38,31,7
2019,153250,44,2,27,20,7
2019,153250,44,3,10,6,4
2019,153250,44,4,13,6,7
2019,153269,0,0,305,159,146
2019,153269,10,0,305,159,146
2019,153269,10,1,98,60,38
2019,153269,10,2,130,63,67
2019,153269,10,3,74,34,40
2019,153269,10,4,3,2,1
2019,153269,20,0,183,105,78
2019,153269,20,1,92,57,35
2019,153269,20,2,91,48,43
2019,153269,30,0,64,31,33
2019,153269,30,1,1,1,0
2019,153269,30,2,11,5,6
2019,153269,30,3,52,25,27
2019,153269,40,0,58,23,35
2019,153269,40,1,5,2,3
2019,153269,40,2,28,10,18
2019,153269,40,3,22,9,13
2019,153269,40,4,3,2,1
2019,153269,41,0,58,23,35
2019,153269,41,1,5,2,3
2019,153269,41,2,28,10,18
2019,153269,41,3,22,9,13
2019,153269,41,4,3,2,1
2019,153269,45,0,58,23,35
2019,153269,45,1,5,2,3
2019,153269,45,2,28,10,18
2019,153269,45,3,22,9,13
2019,153269,45,4,3,2,1
2019,153278,0,0,108,56,52
2019,153278,10,0,108,56,52
2019,153278,10,1,22,17,5
2019,153278,10,2,27,14,13
2019,153278,10,3,52,23,29
2019,153278,10,4,7,2,5
2019,153278,20,0,22,18,4
2019,153278,20,1,18,15,3
2019,153278,20,2,4,3,1
2019,153278,30,0,14,7,7
2019,153278,30,2,4,2,2
2019,153278,30,3,10,5,5
2019,153278,40,0,72,31,41
2019,153278,40,1,4,2,2
2019,153278,40,2,19,9,10
2019,153278,40,3,42,18,24
2019,153278,40,4,7,2,5
2019,153278,41,0,69,30,39
2019,153278,41,1,4,2,2
2019,153278,41,2,19,9,10
2019,153278,41,3,42,18,24
2019,153278,41,4,4,1,3
2019,153278,42,0,3,1,2
2019,153278,42,4,3,1,2
2019,153278,44,0,69,30,39
2019,153278,44,1,4,2,2
2019,153278,44,2,19,9,10
2019,153278,44,3,42,18,24
2019,153278,44,4,4,1,3
2019,153296,0,0,27,16,11
2019,153296,10,0,27,16,11
2019,153296,10,1,11,7,4
2019,153296,10,2,12,7,5
2019,153296,10,3,2,1,1
2019,153296,10,4,2,1,1
2019,153296,40,0,27,16,11
2019,153296,40,1,11,7,4
2019,153296,40,2,12,7,5
2019,153296,40,3,2,1,1
2019,153296,40,4,2,1,1
2019,153296,41,0,27,16,11
2019,153296,41,1,11,7,4
2019,153296,41,2,12,7,5
2019,153296,41,3,2,1,1
2019,153296,41,4,2,1,1
2019,153296,45,0,27,16,11
2019,153296,45,1,11,7,4
2019,153296,45,2,12,7,5
2019,153296,45,3,2,1,1
2019,153296,45,4,2,1,1
2019,153302,0,0,21,17,4
2019,153302,10,0,20,16,4
2019,153302,10,6,20,16,4
2019,153302,40,0,20,16,4
2019,153302,40,6,20,16,4
2019,153302,41,0,20,16,4
2019,153302,41,6,20,16,4
2019,153302,45,0,20,16,4
2019,153302,45,6,20,16,4
2019,153302,50,0,1,1,0
2019,153311,0,0,132,57,75
2019,153311,10,0,132,57,75
2019,153311,10,4,132,57,75
2019,153311,40,0,132,57,75
2019,153311,40,4,132,57,75
2019,153311,42,0,132,57,75
2019,153311,42,4,132,57,75
2019,153320,0,0,19,15,4
2019,153320,10,0,19,15,4
2019,153320,10,1,7,7,0
2019,153320,10,2,4,3,1
2019,153320,10,3,7,5,2
2019,153320,10,4,1,0,1
2019,153320,40,0,19,15,4
2019,153320,40,1,7,7,0
2019,153320,40,2,4,3,1
2019,153320,40,3,7,5,2
2019,153320,40,4,1,0,1
2019,153320,42,0,19,15,4
2019,153320,42,1,7,7,0
2019,153320,42,2,4,3,1
2019,153320,42,3,7,5,2
2019,153320,42,4,1,0,1
2019,153366,0,0,74,35,39
2019,153366,10,0,74,35,39
2019,153366,10,1,17,11,6
2019,153366,10,2,17,8,9
2019,153366,10,3,33,16,17
2019,153366,10,4,2,0,2
2019,153366,10,6,5,0,5
2019,153366,20,0,32,19,13
2019,153366,20,1,17,11,6
2019,153366,20,2,15,8,7
2019,153366,30,0,35,16,19
2019,153366,30,2,2,0,2
2019,153366,30,3,33,16,17
2019,153366,40,0,7,0,7
2019,153366,40,4,2,0,2
2019,153366,40,6,5,0,5
2019,153366,41,0,7,0,7
2019,153366,41,4,2,0,2
2019,153366,41,6,5,0,5
2019,153366,44,0,7,0,7
2019,153366,44,4,2,0,2
2019,153366,44,6,5,0,5
2019,153375,0,0,91,43,48
2019,153375,10,0,91,43,48
2019,153375,10,1,29,20,9
2019,153375,10,2,17,3,14
2019,153375,10,3,36,16,20
2019,153375,10,4,7,4,3
2019,153375,10,6,2,0,2
2019,153375,20,0,38,21,17
2019,153375,20,1,24,17,7
2019,153375,20,2,13,3,10
2019,153375,20,3,1,1,0
2019,153375,30,0,27,9,18
2019,153375,30,1,5,3,2
2019,153375,30,2,4,0,4
2019,153375,30,3,18,6,12
2019,153375,40,0,26,13,13
2019,153375,40,3,17,9,8
2019,153375,40,4,7,4,3
2019,153375,40,6,2,0,2
2019,153375,41,0,7,5,2
2019,153375,41,3,5,4,1
2019,153375,41,4,2,1,1
2019,153375,42,0,19,8,11
2019,153375,42,3,12,5,7
2019,153375,42,4,5,3,2
2019,153375,42,6,2,0,2
2019,153375,44,0,7,5,2
2019,153375,44,3,5,4,1
2019,153375,44,4,2,1,1
2019,153384,0,0,204,101,103
2019,153384,10,0,204,101,103
2019,153384,10,1,51,25,26
2019,153384,10,2,65,38,27
2019,153384,10,3,72,35,37
2019,153384,10,4,2,0,2
2019,153384,10,5,14,3,11
2019,153384,20,0,110,59,51
2019,153384,20,1,51,25,26
2019,153384,20,2,59,34,25
2019,153384,30,0,40,20,20
2019,153384,30,2,2,1,1
2019,153384,30,3,38,19,19
2019,153384,40,0,54,22,32
2019,153384,40,2,4,3,1
2019,153384,40,3,34,16,18
2019,153384,40,4,2,0,2
2019,153384,40,5,14,3,11
2019,153384,41,0,40,17,23
2019,153384,41,2,4,3,1
2019,153384,41,3,24,11,13
2019,153384,41,5,12,3,9
2019,153384,42,0,14,5,9
2019,153384,42,3,10,5,5
2019,153384,42,4,2,0,2
2019,153384,42,5,2,0,2
2019,153384,44,0,33,15,18
2019,153384,44,2,4,3,1
2019,153384,44,3,24,11,13
2019,153384,44,5,5,1,4
2019,153384,45,0,7,2,5
2019,153384,45,5,7,2,5
2019,153445,0,0,110,52,58
2019,153445,10,0,110,52,58
2019,153445,10,6,110,52,58
2019,153445,40,0,110,52,58
2019,153445,40,6,110,52,58
2019,153445,42,0,110,52,58
2019,153445,42,6,110,52,58
2019,153472,0,0,136,67,69
2019,153472,10,0,133,67,66
2019,153472,10,1,46,23,23
2019,153472,10,2,30,15,15
2019,153472,10,4,57,29,28
2019,153472,40,0,133,67,66
2019,153472,40,1,46,23,23
2019,153472,40,2,30,15,15
2019,153472,40,4,57,29,28
2019,153472,41,0,1,1,0
2019,153472,41,4,1,1,0
2019,153472,42,0,132,66,66
2019,153472,42,1,46,23,23
2019,153472,42,2,30,15,15
2019,153472,42,4,56,28,28
2019,153472,45,0,1,1,0
2019,153472,45,4,1,1,0
2019,153472,50,0,3,0,3
2019,153524,0,0,95,55,40
2019,153524,10,0,95,55,40
2019,153524,10,1,12,5,7
2019,153524,10,2,7,4,3
2019,153524,10,3,6,2,4
2019,153524,10,4,70,44,26
2019,153524,40,0,95,55,40
2019,153524,40,1,12,5,7
2019,153524,40,2,7,4,3
2019,153524,40,3,6,2,4
2019,153524,40,4,70,44,26
2019,153524,42,0,95,55,40
2019,153524,42,1,12,5,7
2019,153524,42,2,7,4,3
2019,153524,42,3,6,2,4
2019,153524,42,4,70,44,26
2019,153533,0,0,70,34,36
2019,153533,10,0,70,34,36
2019,153533,10,1,27,9,18
2019,153533,10,2,11,4,7
2019,153533,10,3,23,14,9
2019,153533,10,4,9,7,2
2019,153533,40,0,70,34,36
2019,153533,40,1,27,9,18
2019,153533,40,2,11,4,7
2019,153533,40,3,23,14,9
2019,153533,40,4,9,7,2
2019,153533,42,0,70,34,36
2019,153533,42,1,27,9,18
2019,153533,42,2,11,4,7
2019,153533,42,3,23,14,9
2019,153533,42,4,9,7,2
2019,153603,0,0,1538,966,572
2019,153603,10,0,1538,966,572
2019,153603,10,1,536,415,121
2019,153603,10,2,491,277,214
2019,153603,10,3,488,262,226
2019,153603,10,5,23,12,11
2019,153603,20,0,881,624,257
2019,153603,20,1,507,396,111
2019,153603,20,2,373,228,145
2019,153603,20,3,1,0,1
2019,153603,30,0,343,199,144
2019,153603,30,2,10,9,1
2019,153603,30,3,332,190,142
2019,153603,30,5,1,0,1
2019,153603,40,0,314,143,171
2019,153603,40,1,29,19,10
2019,153603,40,2,108,40,68
2019,153603,40,3,155,72,83
2019,153603,40,5,22,12,10
2019,153603,41,0,223,105,118
2019,153603,41,1,19,14,5
2019,153603,41,2,81,33,48
2019,153603,41,3,112,52,60
2019,153603,41,5,11,6,5
2019,153603,42,0,80,33,47
2019,153603,42,1,8,3,5
2019,153603,42,2,26,6,20
2019,153603,42,3,38,19,19
2019,153603,42,5,8,5,3
2019,153603,43,0,11,5,6
2019,153603,43,1,2,2,0
2019,153603,43,2,1,1,0
2019,153603,43,3,5,1,4
2019,153603,43,5,3,1,2
2019,153603,44,0,223,105,118
2019,153603,44,1,19,14,5
2019,153603,44,2,81,33,48
2019,153603,44,3,112,52,60
2019,153603,44,5,11,6,5
2019,153621,0,0,34,14,20
2019,153621,10,0,34,14,20
2019,153621,10,1,7,3,4
2019,153621,10,2,10,4,6
2019,153621,10,3,16,6,10
2019,153621,10,4,1,1,0
2019,153621,20,0,14,4,10
2019,153621,20,1,7,3,4
2019,153621,20,2,6,1,5
2019,153621,20,3,1,0,1
2019,153621,30,0,9,2,7
2019,153621,30,2,2,1,1
2019,153621,30,3,7,1,6
2019,153621,40,0,11,8,3
2019,153621,40,2,2,2,0
2019,153621,40,3,8,5,3
2019,153621,40,4,1,1,0
2019,153621,42,0,11,8,3
2019,153621,42,2,2,2,0
2019,153621,42,3,8,5,3
2019,153621,42,4,1,1,0
2019,153630,0,0,108,55,53
2019,153630,10,0,108,55,53
2019,153630,10,1,8,3,5
2019,153630,10,2,8,3,5
2019,153630,10,3,12,5,7
2019,153630,10,4,80,44,36
2019,153630,40,0,108,55,53
2019,153630,40,1,8,3,5
2019,153630,40,2,8,3,5
2019,153630,40,3,12,5,7
2019,153630,40,4,80,44,36
2019,153630,42,0,108,55,53
2019,153630,42,1,8,3,5
2019,153630,42,2,8,3,5
2019,153630,42,3,12,5,7
2019,153630,42,4,80,44,36
2019,153658,0,0,2486,1461,1025
2019,153658,10,0,2486,1461,1025
2019,153658,10,1,761,561,200
2019,153658,10,2,713,410,303
2019,153658,10,3,731,369,362
2019,153658,10,4,2,1,1
2019,153658,10,5,195,75,120
2019,153658,10,6,84,45,39
2019,153658,20,0,999,695,304
2019,153658,20,1,594,449,145
2019,153658,20,2,405,246,159
2019,153658,30,0,327,181,146
2019,153658,30,1,2,1,1
2019,153658,30,2,23,17,6
2019,153658,30,3,302,163,139
2019,153658,40,0,1160,585,575
2019,153658,40,1,165,111,54
2019,153658,40,2,285,147,138
2019,153658,40,3,429,206,223
2019,153658,40,4,2,1,1
2019,153658,40,5,195,75,120
2019,153658,40,6,84,45,39
2019,153658,41,0,1026,503,523
2019,153658,41,1,156,103,53
2019,153658,41,2,282,144,138
2019,153658,41,3,382,178,204
2019,153658,41,4,2,1,1
2019,153658,41,5,192,74,118
2019,153658,41,6,12,3,9
2019,153658,42,0,132,81,51
2019,153658,42,1,9,8,1
2019,153658,42,2,3,3,0
2019,153658,42,3,47,28,19
2019,153658,42,5,2,0,2
2019,153658,42,6,71,42,29
2019,153658,43,0,2,1,1
2019,153658,43,5,1,1,0
2019,153658,43,6,1,0,1
2019,153658,44,0,1026,503,523
2019,153658,44,1,156,103,53
2019,153658,44,2,282,144,138
2019,153658,44,3,382,178,204
2019,153658,44,4,2,1,1
2019,153658,44,5,192,74,118
2019,153658,44,6,12,3,9
2019,153737,0,0,263,143,120
2019,153737,10,0,255,140,115
2019,153737,10,1,110,65,45
2019,153737,10,2,45,21,24
2019,153737,10,3,52,29,23
2019,153737,10,4,46,24,22
2019,153737,10,6,2,1,1
2019,153737,40,0,255,140,115
2019,153737,40,1,110,65,45
2019,153737,40,2,45,21,24
2019,153737,40,3,52,29,23
2019,153737,40,4,46,24,22
2019,153737,40,6,2,1,1
2019,153737,42,0,255,140,115
2019,153737,42,1,110,65,45
2019,153737,42,2,45,21,24
2019,153737,42,3,52,29,23
2019,153737,42,4,46,24,22
2019,153737,42,6,2,1,1
2019,153737,50,0,8,3,5
2019,153825,0,0,99,59,40
2019,153825,10,0,99,59,40
2019,153825,10,1,26,22,4
2019,153825,10,2,45,22,23
2019,153825,10,3,26,15,11
2019,153825,10,4,2,0,2
2019,153825,20,0,68,42,26
2019,153825,20,1,23,20,3
2019,153825,20,2,45,22,23
2019,153825,30,0,23,13,10
2019,153825,30,3,23,13,10
2019,153825,40,0,8,4,4
2019,153825,40,1,3,2,1
2019,153825,40,3,3,2,1
2019,153825,40,4,2,0,2
2019,153825,41,0,4,3,1
2019,153825,41,1,1,1,0
2019,153825,41,3,3,2,1
2019,153825,42,0,4,1,3
2019,153825,42,1,2,1,1
2019,153825,42,4,2,0,2
2019,153825,44,0,4,3,1
2019,153825,44,1,1,1,0
2019,153825,44,3,3,2,1
2019,153834,0,0,161,86,75
2019,153834,10,0,161,86,75
2019,153834,10,1,62,40,22
2019,153834,10,2,58,25,33
2019,153834,10,3,20,9,11
2019,153834,10,4,21,12,9
2019,153834,20,0,117,63,54
2019,153834,20,1,61,39,22
2019,153834,20,2,56,24,32
2019,153834,30,0,16,6,10
2019,153834,30,2,1,0,1
2019,153834,30,3,15,6,9
2019,153834,40,0,28,17,11
2019,153834,40,1,1,1,0
2019,153834,40,2,1,1,0
2019,153834,40,3,5,3,2
2019,153834,40,4,21,12,9
2019,153834,42,0,28,17,11
2019,153834,42,1,1,1,0
2019,153834,42,2,1,1,0
2019,153834,42,3,5,3,2
2019,153834,42,4,21,12,9
2019,153861,0,0,114,80,34
2019,153861,10,0,114,80,34
2019,153861,10,1,23,18,5
2019,153861,10,2,17,11,6
2019,153861,10,3,33,23,10
2019,153861,10,4,28,21,7
2019,153861,10,5,3,2,1
2019,153861,10,6,10,5,5
2019,153861,40,0,114,80,34
2019,153861,40,1,23,18,5
2019,153861,40,2,17,11,6
2019,153861,40,3,33,23,10
2019,153861,40,4,28,21,7
2019,153861,40,5,3,2,1
2019,153861,40,6,10,5,5
2019,153861,41,0,114,80,34
2019,153861,41,1,23,18,5
2019,153861,41,2,17,11,6
2019,153861,41,3,33,23,10
2019,153861,41,4,28,21,7
2019,153861,41,5,3,2,1
2019,153861,41,6,10,5,5
2019,153861,45,0,114,80,34
2019,153861,45,1,23,18,5
2019,153861,45,2,17,11,6
2019,153861,45,3,33,23,10
2019,153861,45,4,28,21,7
2019,153861,45,5,3,2,1
2019,153861,45,6,10,5,5
2019,153922,0,0,42,23,19
2019,153922,10,0,42,23,19
2019,153922,10,1,23,11,12
2019,153922,10,2,16,11,5
2019,153922,10,3,2,1,1
2019,153922,10,4,1,0,1
2019,153922,40,0,42,23,19
2019,153922,40,1,23,11,12
2019,153922,40,2,16,11,5
2019,153922,40,3,2,1,1
2019,153922,40,4,1,0,1
2019,153922,41,0,42,23,19
2019,153922,41,1,23,11,12
2019,153922,41,2,16,11,5
2019,153922,41,3,2,1,1
2019,153922,41,4,1,0,1
2019,153922,45,0,42,23,19
2019,153922,45,1,23,11,12
2019,153922,45,2,16,11,5
2019,153922,45,3,2,1,1
2019,153922,45,4,1,0,1
2019,153977,0,0,56,8,48
2019,153977,10,0,56,8,48
2019,153977,10,1,7,2,5
2019,153977,10,2,3,0,3
2019,153977,10,3,39,4,35
2019,153977,10,4,7,2,5
2019,153977,40,0,56,8,48
2019,153977,40,1,7,2,5
2019,153977,40,2,3,0,3
2019,153977,40,3,39,4,35
2019,153977,40,4,7,2,5
2019,153977,41,0,56,8,48
2019,153977,41,1,7,2,5
2019,153977,41,2,3,0,3
2019,153977,41,3,39,4,35
2019,153977,41,4,7,2,5
2019,153977,44,0,56,8,48
2019,153977,44,1,7,2,5
2019,153977,44,2,3,0,3
2019,153977,44,3,39,4,35
2019,153977,44,4,7,2,5
2019,154004,0,0,76,40,36
2019,154004,10,0,76,40,36
2019,154004,10,1,18,12,6
2019,154004,10,2,29,13,16
2019,154004,10,3,26,14,12
2019,154004,10,4,3,1,2
2019,154004,20,0,38,22,16
2019,154004,20,1,15,10,5
2019,154004,20,2,23,12,11
2019,154004,30,0,19,8,11
2019,154004,30,1,1,0,1
2019,154004,30,2,4,1,3
2019,154004,30,3,14,7,7
2019,154004,40,0,19,10,9
2019,154004,40,1,2,2,0
2019,154004,40,2,2,0,2
2019,154004,40,3,12,7,5
2019,154004,40,4,3,1,2
2019,154004,41,0,19,10,9
2019,154004,41,1,2,2,0
2019,154004,41,2,2,0,2
2019,154004,41,3,12,7,5
2019,154004,41,4,3,1,2
2019,154004,44,0,2,1,1
2019,154004,44,3,1,1,0
2019,154004,44,4,1,0,1
2019,154004,45,0,17,9,8
2019,154004,45,1,2,2,0
2019,154004,45,2,2,0,2
2019,154004,45,3,11,6,5
2019,154004,45,4,2,1,1
2019,154013,0,0,77,30,47
2019,154013,10,0,77,30,47
2019,154013,10,1,15,3,12
2019,154013,10,2,26,14,12
2019,154013,10,3,33,12,21
2019,154013,10,5,3,1,2
2019,154013,20,0,41,16,25
2019,154013,20,1,15,3,12
2019,154013,20,2,25,13,12
2019,154013,20,3,1,0,1
2019,154013,30,0,12,6,6
2019,154013,30,2,1,1,0
2019,154013,30,3,11,5,6
2019,154013,40,0,24,8,16
2019,154013,40,3,21,7,14
2019,154013,40,5,3,1,2
2019,154013,41,0,24,8,16
2019,154013,41,3,21,7,14
2019,154013,41,5,3,1,2
2019,154013,44,0,24,8,16
2019,154013,44,3,21,7,14
2019,154013,44,5,3,1,2
2019,154022,0,0,187,67,120
2019,154022,10,0,187,67,120
2019,154022,10,1,29,14,15
2019,154022,10,2,49,13,36
2019,154022,10,3,94,36,58
2019,154022,10,4,15,4,11
2019,154022,40,0,187,67,120
2019,154022,40,1,29,14,15
2019,154022,40,2,49,13,36
2019,154022,40,3,94,36,58
2019,154022,40,4,15,4,11
2019,154022,41,0,187,67,120
2019,154022,41,1,29,14,15
2019,154022,41,2,49,13,36
2019,154022,41,3,94,36,58
2019,154022,41,4,15,4,11
2019,154022,45,0,187,67,120
2019,154022,45,1,29,14,15
2019,154022,45,2,49,13,36
2019,154022,45,3,94,36,58
2019,154022,45,4,15,4,11
2019,154059,0,0,68,38,30
2019,154059,10,0,68,38,30
2019,154059,10,5,68,38,30
2019,154059,40,0,68,38,30
2019,154059,40,5,68,38,30
2019,154059,42,0,68,38,30
2019,154059,42,5,68,38,30
2019,154095,0,0,483,248,235
2019,154095,10,0,483,248,235
2019,154095,10,1,130,85,45
2019,154095,10,2,161,89,72
2019,154095,10,3,105,45,60
2019,154095,10,4,87,29,58
2019,154095,20,0,306,176,130
2019,154095,20,1,130,85,45
2019,154095,20,2,157,87,70
2019,154095,20,3,5,3,2
2019,154095,20,4,14,1,13
2019,154095,30,0,110,48,62
2019,154095,30,2,4,2,2
2019,154095,30,3,100,42,58
2019,154095,30,4,6,4,2
2019,154095,40,0,67,24,43
2019,154095,40,4,67,24,43
2019,154095,41,0,58,23,35
2019,154095,41,4,58,23,35
2019,154095,43,0,9,1,8
2019,154095,43,4,9,1,8
2019,154095,44,0,58,23,35
2019,154095,44,4,58,23,35
2019,154101,0,0,83,45,38
2019,154101,10,0,83,45,38
2019,154101,10,1,31,22,9
2019,154101,10,2,19,10,9
2019,154101,10,3,18,7,11
2019,154101,10,4,7,1,6
2019,154101,10,6,8,5,3
2019,154101,20,0,49,30,19
2019,154101,20,1,31,22,9
2019,154101,20,2,16,8,8
2019,154101,20,3,2,0,2
2019,154101,30,0,24,10,14
2019,154101,30,2,3,2,1
2019,154101,30,3,16,7,9
2019,154101,30,4,5,1,4
2019,154101,40,0,10,5,5
2019,154101,40,4,2,0,2
2019,154101,40,6,8,5,3
2019,154101,42,0,10,5,5
2019,154101,42,4,2,0,2
2019,154101,42,6,8,5,3
2019,154110,0,0,95,44,51
2019,154110,10,0,95,44,51
2019,154110,10,6,95,44,51
2019,154110,40,0,95,44,51
2019,154110,40,6,95,44,51
2019,154110,42,0,95,44,51
2019,154110,42,6,95,44,51
2019,154129,0,0,33,22,11
2019,154129,10,0,33,22,11
2019,154129,10,6,33,22,11
2019,154129,40,0,33,22,11
2019,154129,40,6,33,22,11
2019,154129,42,0,33,22,11
2019,154129,42,6,33,22,11
2019,154156,0,0,78,35,43
2019,154156,10,0,78,35,43
2019,154156,10,1,14,9,5
2019,154156,10,2,25,9,16
2019,154156,10,3,37,17,20
2019,154156,10,4,2,0,2
2019,154156,20,0,23,12,11
2019,154156,20,1,10,7,3
2019,154156,20,2,13,5,8
2019,154156,30,0,18,7,11
2019,154156,30,2,3,1,2
2019,154156,30,3,14,6,8
2019,154156,30,4,1,0,1
2019,154156,40,0,37,16,21
2019,154156,40,1,4,2,2
2019,154156,40,2,9,3,6
2019,154156,40,3,23,11,12
2019,154156,40,4,1,0,1
2019,154156,42,0,37,16,21
2019,154156,42,1,4,2,2
2019,154156,42,2,9,3,6
2019,154156,42,3,23,11,12
2019,154156,42,4,1,0,1
2019,154174,0,0,132,73,59
2019,154174,10,0,131,73,58
2019,154174,10,1,33,21,12
2019,154174,10,2,58,33,25
2019,154174,10,3,27,14,13
2019,154174,10,4,13,5,8
2019,154174,40,0,131,73,58
2019,154174,40,1,33,21,12
2019,154174,40,2,58,33,25
2019,154174,40,3,27,14,13
2019,154174,40,4,13,5,8
2019,154174,41,0,131,73,58
2019,154174,41,1,33,21,12
2019,154174,41,2,58,33,25
2019,154174,41,3,27,14,13
2019,154174,41,4,13,5,8
2019,154174,45,0,131,73,58
2019,154174,45,1,33,21,12
2019,154174,45,2,58,33,25
2019,154174,45,3,27,14,13
2019,154174,45,4,13,5,8
2019,154174,50,0,1,0,1
2019,154235,0,0,201,93,108
2019,154235,10,0,201,93,108
2019,154235,10,1,80,46,34
2019,154235,10,2,54,24,30
2019,154235,10,3,54,19,35
2019,154235,10,4,13,4,9
2019,154235,20,0,123,66,57
2019,154235,20,1,79,46,33
2019,154235,20,2,40,20,20
2019,154235,20,3,4,0,4
2019,154235,30,0,45,18,27
2019,154235,30,2,7,3,4
2019,154235,30,3,38,15,23
2019,154235,40,0,33,9,24
2019,154235,40,1,1,0,1
2019,154235,40,2,7,1,6
2019,154235,40,3,12,4,8
2019,154235,40,4,13,4,9
2019,154235,42,0,33,9,24
2019,154235,42,1,1,0,1
2019,154235,42,2,7,1,6
2019,154235,42,3,12,4,8
2019,154235,42,4,13,4,9
2019,154262,0,0,23,2,21
2019,154262,10,0,23,2,21
2019,154262,10,1,1,1,0
2019,154262,10,2,7,1,6
2019,154262,10,3,9,0,9
2019,154262,10,4,6,0,6
2019,154262,40,0,23,2,21
2019,154262,40,1,1,1,0
2019,154262,40,2,7,1,6
2019,154262,40,3,9,0,9
2019,154262,40,4,6,0,6
2019,154262,41,0,3,2,1
2019,154262,41,1,1,1,0
2019,154262,41,2,2,1,1
2019,154262,42,0,20,0,20
2019,154262,42,2,5,0,5
2019,154262,42,3,9,0,9
2019,154262,42,4,6,0,6
2019,154262,45,0,3,2,1
2019,154262,45,1,1,1,0
2019,154262,45,2,2,1,1
2019,154350,0,0,82,42,40
2019,154350,10,0,80,40,40
2019,154350,10,1,32,17,15
2019,154350,10,2,19,11,8
2019,154350,10,3,25,10,15
2019,154350,10,4,4,2,2
2019,154350,20,0,36,18,18
2019,154350,20,1,32,17,15
2019,154350,20,3,4,1,3
2019,154350,30,0,34,17,17
2019,154350,30,2,19,11,8
2019,154350,30,3,14,6,8
2019,154350,30,4,1,0,1
2019,154350,40,0,10,5,5
2019,154350,40,3,7,3,4
2019,154350,40,4,3,2,1
2019,154350,42,0,10,5,5
2019,154350,42,3,7,3,4
2019,154350,42,4,3,2,1
2019,154350,50,0,2,2,0
2019,154378,0,0,75,34,41
2019,154378,10,0,67,32,35
2019,154378,10,4,67,32,35
2019,154378,40,0,67,32,35
2019,154378,40,4,67,32,35
2019,154378,41,0,67,32,35
2019,154378,41,4,67,32,35
2019,154378,45,0,67,32,35
2019,154378,45,4,67,32,35
2019,154378,50,0,8,2,6
2019,154396,0,0,40,22,18
2019,154396,10,0,40,22,18
2019,154396,10,4,40,22,18
2019,154396,40,0,40,22,18
2019,154396,40,4,40,22,18
2019,154396,42,0,40,22,18
2019,154396,42,4,40,22,18
2019,154493,0,0,74,28,46
2019,154493,10,0,73,28,45
2019,154493,10,1,11,9,2
2019,154493,10,2,26,8,18
2019,154493,10,3,23,7,16
2019,154493,10,4,1,1,0
2019,154493,10,5,12,3,9
2019,154493,20,0,37,17,20
2019,154493,20,1,11,9,2
2019,154493,20,2,26,8,18
2019,154493,30,0,23,7,16
2019,154493,30,3,23,7,16
2019,154493,40,0,13,4,9
2019,154493,40,4,1,1,0
2019,154493,40,5,12,3,9
2019,154493,42,0,9,2,7
2019,154493,42,5,9,2,7
2019,154493,43,0,4,2,2
2019,154493,43,4,1,1,0
2019,154493,43,5,3,1,2
2019,154493,50,0,1,0,1
2019,154518,0,0,48,25,23
2019,154518,10,0,45,25,20
2019,154518,10,1,10,6,4
2019,154518,10,2,8,5,3
2019,154518,10,3,23,12,11
2019,154518,10,4,4,2,2
2019,154518,20,0,16,10,6
2019,154518,20,1,9,5,4
2019,154518,20,2,7,5,2
2019,154518,30,0,18,10,8
2019,154518,30,1,1,1,0
2019,154518,30,2,1,0,1
2019,154518,30,3,16,9,7
2019,154518,40,0,11,5,6
2019,154518,40,3,7,3,4
2019,154518,40,4,4,2,2
2019,154518,42,0,11,5,6
2019,154518,42,3,7,3,4
2019,154518,42,4,4,2,2
2019,154518,50,0,3,0,3
2019,154527,0,0,91,47,44
2019,154527,10,0,91,47,44
2019,154527,10,1,30,17,13
2019,154527,10,2,27,14,13
2019,154527,10,3,18,8,10
2019,154527,10,5,9,4,5
2019,154527,10,6,7,4,3
2019,154527,20,0,56,30,26
2019,154527,20,1,29,17,12
2019,154527,20,2,26,13,13
2019,154527,20,3,1,0,1
2019,154527,30,0,19,9,10
2019,154527,30,1,1,0,1
2019,154527,30,2,1,1,0
2019,154527,30,3,17,8,9
2019,154527,40,0,16,8,8
2019,154527,40,5,9,4,5
2019,154527,40,6,7,4,3
2019,154527,42,0,16,8,8
2019,154527,42,5,9,4,5
2019,154527,42,6,7,4,3
2019,154536,0,0,8,7,1
2019,154536,10,0,8,7,1
2019,154536,10,1,6,5,1
2019,154536,10,2,2,2,0
2019,154536,20,0,8,7,1
2019,154536,20,1,6,5,1
2019,154536,20,2,2,2,0
2019,154572,0,0,66,33,33
2019,154572,10,0,66,33,33
2019,154572,10,4,1,0,1
2019,154572,10,6,65,33,32
2019,154572,40,0,66,33,33
2019,154572,40,4,1,0,1
2019,154572,40,6,65,33,32
2019,154572,42,0,66,33,33
2019,154572,42,4,1,0,1
2019,154572,42,6,65,33,32
2019,154590,0,0,47,26,21
2019,154590,10,0,45,26,19
2019,154590,10,1,5,4,1
2019,154590,10,2,7,6,1
2019,154590,10,3,16,9,7
2019,154590,10,4,15,7,8
2019,154590,10,6,2,0,2
2019,154590,20,0,11,7,4
2019,154590,20,1,4,3,1
2019,154590,20,2,4,3,1
2019,154590,20,3,3,1,2
2019,154590,30,0,8,5,3
2019,154590,30,2,2,2,0
2019,154590,30,3,6,3,3
2019,154590,40,0,26,14,12
2019,154590,40,1,1,1,0
2019,154590,40,2,1,1,0
2019,154590,40,3,7,5,2
2019,154590,40,4,15,7,8
2019,154590,40,6,2,0,2
2019,154590,42,0,26,14,12
2019,154590,42,1,1,1,0
2019,154590,42,2,1,1,0
2019,154590,42,3,7,5,2
2019,154590,42,4,15,7,8
2019,154590,42,6,2,0,2
2019,154590,50,0,2,0,2
2019,154642,0,0,30,15,15
2019,154642,10,0,30,15,15
2019,154642,10,4,30,15,15
2019,154642,20,0,23,11,12
2019,154642,20,4,23,11,12
2019,154642,30,0,7,4,3
2019,154642,30,4,7,4,3
2019,154688,0,0,73,33,40
2019,154688,10,0,73,33,40
2019,154688,10,1,19,11,8
2019,154688,10,2,28,14,14
2019,154688,10,3,23,7,16
2019,154688,10,4,3,1,2
2019,154688,20,0,41,22,19
2019,154688,20,1,18,11,7
2019,154688,20,2,22,11,11
2019,154688,20,3,1,0,1
2019,154688,30,0,17,7,10
2019,154688,30,2,1,0,1
2019,154688,30,3,16,7,9
2019,154688,40,0,15,4,11
2019,154688,40,1,1,0,1
2019,154688,40,2,5,3,2
2019,154688,40,3,6,0,6
2019,154688,40,4,3,1,2
2019,154688,41,0,12,3,9
2019,154688,41,1,1,0,1
2019,154688,41,2,4,2,2
2019,154688,41,3,4,0,4
2019,154688,41,4,3,1,2
2019,154688,42,0,3,1,2
2019,154688,42,2,1,1,0
2019,154688,42,3,2,0,2
2019,154688,45,0,12,3,9
2019,154688,45,1,1,0,1
2019,154688,45,2,4,2,2
2019,154688,45,3,4,0,4
2019,154688,45,4,3,1,2
2019,154697,0,0,70,33,37
2019,154697,10,0,70,33,37
2019,154697,10,6,70,33,37
2019,154697,20,0,51,24,27
2019,154697,20,6,51,24,27
2019,154697,30,0,19,9,10
2019,154697,30,6,19,9,10
2019,154712,0,0,122,81,41
2019,154712,10,0,122,81,41
2019,154712,10,1,23,20,3
2019,154712,10,2,27,19,8
2019,154712,10,3,57,35,22
2019,154712,10,4,9,4,5
2019,154712,10,5,5,2,3
2019,154712,10,6,1,1,0
2019,154712,20,0,55,40,15
2019,154712,20,1,21,18,3
2019,154712,20,2,18,12,6
2019,154712,20,3,16,10,6
2019,154712,30,0,30,22,8
2019,154712,30,1,2,2,0
2019,154712,30,2,3,3,0
2019,154712,30,3,24,16,8
2019,154712,30,4,1,1,0
2019,154712,40,0,37,19,18
2019,154712,40,2,6,4,2
2019,154712,40,3,17,9,8
2019,154712,40,4,8,3,5
2019,154712,40,5,5,2,3
2019,154712,40,6,1,1,0
2019,154712,42,0,37,19,18
2019,154712,42,2,6,4,2
2019,154712,42,3,17,9,8
2019,154712,42,4,8,3,5
2019,154712,42,5,5,2,3
2019,154712,42,6,1,1,0
2019,154721,0,0,42,26,16
2019,154721,10,0,42,26,16
2019,154721,10,1,11,7,4
2019,154721,10,2,12,8,4
2019,154721,10,3,19,11,8
2019,154721,20,0,17,13,4
2019,154721,20,1,5,4,1
2019,154721,20,2,9,6,3
2019,154721,20,3,3,3,0
2019,154721,30,0,25,13,12
2019,154721,30,1,6,3,3
2019,154721,30,2,3,2,1
2019,154721,30,3,16,8,8
2019,154749,0,0,41,16,25
2019,154749,10,0,41,16,25
2019,154749,10,1,12,8,4
2019,154749,10,2,12,3,9
2019,154749,10,3,12,3,9
2019,154749,10,4,5,2,3
2019,154749,20,0,18,9,9
2019,154749,20,1,11,7,4
2019,154749,20,2,7,2,5
2019,154749,30,0,10,3,7
2019,154749,30,2,4,1,3
2019,154749,30,3,6,2,4
2019,154749,40,0,13,4,9
2019,154749,40,1,1,1,0
2019,154749,40,2,1,0,1
2019,154749,40,3,6,1,5
2019,154749,40,4,5,2,3
2019,154749,42,0,13,4,9
2019,154749,42,1,1,1,0
2019,154749,42,2,1,0,1
2019,154749,42,3,6,1,5
2019,154749,42,4,5,2,3
2019,154800,0,0,152,67,85
2019,154800,10,0,152,67,85
2019,154800,10,1,77,33,44
2019,154800,10,2,44,24,20
2019,154800,10,3,28,10,18
2019,154800,10,5,3,0,3
2019,154800,40,0,152,67,85
2019,154800,40,1,77,33,44
2019,154800,40,2,44,24,20
2019,154800,40,3,28,10,18
2019,154800,40,5,3,0,3
2019,154800,42,0,150,67,83
2019,154800,42,1,77,33,44
2019,154800,42,2,44,24,20
2019,154800,42,3,28,10,18
2019,154800,42,5,1,0,1
2019,154800,43,0,2,0,2
2019,154800,43,5,2,0,2
2019,154855,0,0,21,12,9
2019,154855,10,0,21,12,9
2019,154855,10,6,21,12,9
2019,154855,40,0,21,12,9
2019,154855,40,6,21,12,9
2019,154855,42,0,21,12,9
2019,154855,42,6,21,12,9
2019,154907,0,0,41,24,17
2019,154907,10,0,41,24,17
2019,154907,10,4,41,24,17
2019,154907,20,0,22,12,10
2019,154907,20,4,22,12,10
2019,154907,30,0,19,12,7
2019,154907,30,4,19,12,7
2019,154925,0,0,47,28,19
2019,154925,10,0,44,26,18
2019,154925,10,4,44,26,18
2019,154925,20,0,42,25,17
2019,154925,20,4,42,25,17
2019,154925,30,0,2,1,1
2019,154925,30,4,2,1,1
2019,154925,50,0,3,2,1
2019,154934,0,0,48,14,34
2019,154934,10,0,48,14,34
2019,154934,10,4,48,14,34
2019,154934,20,0,29,10,19
2019,154934,20,4,29,10,19
2019,154934,30,0,19,4,15
2019,154934,30,4,19,4,15
2019,154952,0,0,62,34,28
2019,154952,10,0,56,32,24
2019,154952,10,4,56,32,24
2019,154952,20,0,35,19,16
2019,154952,20,4,35,19,16
2019,154952,30,0,21,13,8
2019,154952,30,4,21,13,8
2019,154952,50,0,6,2,4
2019,154998,0,0,45,24,21
2019,154998,10,0,45,24,21
2019,154998,10,1,27,14,13
2019,154998,10,2,10,4,6
2019,154998,10,3,3,1,2
2019,154998,10,4,5,5,0
2019,154998,20,0,27,15,12
2019,154998,20,1,20,11,9
2019,154998,20,2,5,3,2
2019,154998,20,3,1,0,1
2019,154998,20,4,1,1,0
2019,154998,30,0,18,9,9
2019,154998,30,1,7,3,4
2019,154998,30,2,5,1,4
2019,154998,30,3,2,1,1
2019,154998,30,4,4,4,0
2019,155007,0,0,14,4,10
2019,155007,10,0,14,4,10
2019,155007,10,2,1,0,1
2019,155007,10,3,11,4,7
2019,155007,10,4,2,0,2
2019,155007,40,0,14,4,10
2019,155007,40,2,1,0,1
2019,155007,40,3,11,4,7
2019,155007,40,4,2,0,2
2019,155007,42,0,14,4,10
2019,155007,42,2,1,0,1
2019,155007,42,3,11,4,7
2019,155007,42,4,2,0,2
2019,155025,0,0,249,120,129
2019,155025,10,0,249,120,129
2019,155025,10,1,68,43,25
2019,155025,10,2,57,27,30
2019,155025,10,3,78,36,42
2019,155025,10,4,46,14,32
2019,155025,20,0,120,67,53
2019,155025,20,1,68,43,25
2019,155025,20,2,52,24,28
2019,155025,30,0,81,37,44
2019,155025,30,2,5,3,2
2019,155025,30,3,76,34,42
2019,155025,40,0,48,16,32
2019,155025,40,3,2,2,0
2019,155025,40,4,46,14,32
2019,155025,42,0,48,16,32
2019,155025,42,3,2,2,0
2019,155025,42,4,46,14,32
2019,155052,0,0,34,18,16
2019,155052,10,0,34,18,16
2019,155052,10,4,34,18,16
2019,155052,40,0,34,18,16
2019,155052,40,4,34,18,16
2019,155052,42,0,34,18,16
2019,155052,42,4,34,18,16
2019,155061,0,0,367,196,171
2019,155061,10,0,367,196,171
2019,155061,10,1,50,33,17
2019,155061,10,2,80,46,34
2019,155061,10,3,119,68,51
2019,155061,10,4,103,44,59
2019,155061,10,5,15,5,10
2019,155061,20,0,131,79,52
2019,155061,20,1,48,31,17
2019,155061,20,2,72,40,32
2019,155061,20,3,11,8,3
2019,155061,30,0,87,46,41
2019,155061,30,1,1,1,0
2019,155061,30,2,5,3,2
2019,155061,30,3,80,42,38
2019,155061,30,4,1,0,1
2019,155061,40,0,149,71,78
2019,155061,40,1,1,1,0
2019,155061,40,2,3,3,0
2019,155061,40,3,28,18,10
2019,155061,40,4,102,44,58
2019,155061,40,5,15,5,10
2019,155061,42,0,149,71,78
2019,155061,42,1,1,1,0
2019,155061,42,2,3,3,0
2019,155061,42,3,28,18,10
2019,155061,42,4,102,44,58
2019,155061,42,5,15,5,10
2019,155070,0,0,11,8,3
2019,155070,10,0,11,8,3
2019,155070,10,6,11,8,3
2019,155070,40,0,11,8,3
2019,155070,40,6,11,8,3
2019,155070,42,0,2,2,0
2019,155070,42,6,2,2,0
2019,155070,43,0,9,6,3
2019,155070,43,6,9,6,3
2019,155089,0,0,60,33,27
2019,155089,10,0,60,33,27
2019,155089,10,1,15,10,5
2019,155089,10,2,11,7,4
2019,155089,10,3,33,15,18
2019,155089,10,5,1,1,0
2019,155089,20,0,10,5,5
2019,155089,20,1,10,5,5
2019,155089,30,0,45,24,21
2019,155089,30,1,5,5,0
2019,155089,30,2,11,7,4
2019,155089,30,3,29,12,17
2019,155089,40,0,5,4,1
2019,155089,40,3,4,3,1
2019,155089,40,5,1,1,0
2019,155089,43,0,5,4,1
2019,155089,43,3,4,3,1
2019,155089,43,5,1,1,0
2019,155098,0,0,39,20,19
2019,155098,10,0,39,20,19
2019,155098,10,4,39,20,19
2019,155098,20,0,27,13,14
2019,155098,20,4,27,13,14
2019,155098,30,0,12,7,5
2019,155098,30,4,12,7,5
2019,155104,0,0,68,32,36
2019,155104,10,0,63,29,34
2019,155104,10,4,63,29,34
2019,155104,20,0,37,16,21
2019,155104,20,4,37,16,21
2019,155104,30,0,26,13,13
2019,155104,30,4,26,13,13
2019,155104,50,0,5,3,2
2019,155140,0,0,32,16,16
2019,155140,50,0,32,16,16
2019,155177,0,0,30,19,11
2019,155177,10,0,30,19,11
2019,155177,10,4,30,19,11
2019,155177,40,0,30,19,11
2019,155177,40,4,30,19,11
2019,155177,42,0,30,19,11
2019,155177,42,4,30,19,11
2019,155186,0,0,55,31,24
2019,155186,10,0,55,31,24
2019,155186,10,6,55,31,24
2019,155186,40,0,55,31,24
2019,155186,40,6,55,31,24
2019,155186,42,0,55,31,24
2019,155186,42,6,55,31,24
2019,155195,0,0,139,69,70
2019,155195,10,0,107,53,54
2019,155195,10,4,107,53,54
2019,155195,20,0,79,38,41
2019,155195,20,4,79,38,41
2019,155195,30,0,28,15,13
2019,155195,30,4,28,15,13
2019,155195,50,0,32,16,16
2019,155201,0,0,30,12,18
2019,155201,10,0,30,12,18
2019,155201,10,1,14,4,10
2019,155201,10,2,12,6,6
2019,155201,10,3,4,2,2
2019,155201,20,0,14,4,10
2019,155201,20,1,14,4,10
2019,155201,30,0,12,6,6
2019,155201,30,2,12,6,6
2019,155201,40,0,4,2,2
2019,155201,40,3,4,2,2
2019,155201,41,0,4,2,2
2019,155201,41,3,4,2,2
2019,155201,44,0,4,2,2
2019,155201,44,3,4,2,2
2019,155210,0,0,318,157,161
2019,155210,10,0,318,157,161
2019,155210,10,1,172,91,81
2019,155210,10,2,78,37,41
2019,155210,10,3,62,25,37
2019,155210,10,6,6,4,2
2019,155210,40,0,318,157,161
2019,155210,40,1,172,91,81
2019,155210,40,2,78,37,41
2019,155210,40,3,62,25,37
2019,155210,40,6,6,4,2
2019,155210,42,0,318,157,161
2019,155210,42,1,172,91,81
2019,155210,42,2,78,37,41
2019,155210,42,3,62,25,37
2019,155210,42,6,6,4,2
2019,155283,0,0,12,0,12
2019,155283,10,0,12,0,12
2019,155283,10,4,12,0,12
2019,155283,40,0,12,0,12
2019,155283,40,4,12,0,12
2019,155283,41,0,12,0,12
2019,155283,41,4,12,0,12
2019,155283,45,0,12,0,12
2019,155283,45,4,12,0,12
2019,155292,0,0,152,82,70
2019,155292,10,0,152,82,70
2019,155292,10,1,29,19,10
2019,155292,10,2,18,11,7
2019,155292,10,3,18,8,10
2019,155292,10,4,87,44,43
2019,155292,20,0,133,73,60
2019,155292,20,1,29,19,10
2019,155292,20,2,18,11,7
2019,155292,20,3,14,6,8
2019,155292,20,4,72,37,35
2019,155292,30,0,19,9,10
2019,155292,30,3,4,2,2
2019,155292,30,4,15,7,8
2019,155308,0,0,6,4,2
2019,155308,10,0,6,4,2
2019,155308,10,1,1,0,1
2019,155308,10,2,5,4,1
2019,155308,40,0,6,4,2
2019,155308,40,1,1,0,1
2019,155308,40,2,5,4,1
2019,155308,42,0,6,4,2
2019,155308,42,1,1,0,1
2019,155308,42,2,5,4,1
2019,155317,0,0,2392,1402,990
2019,155317,10,0,2392,1402,990
2019,155317,10,1,615,451,164
2019,155317,10,2,648,366,282
2019,155317,10,3,908,493,415
2019,155317,10,4,63,28,35
2019,155317,10,5,158,64,94
2019,155317,20,0,922,627,295
2019,155317,20,1,539,405,134
2019,155317,20,2,383,222,161
2019,155317,30,0,258,156,102
2019,155317,30,1,1,0,1
2019,155317,30,2,8,4,4
2019,155317,30,3,249,152,97
2019,155317,40,0,1212,619,593
2019,155317,40,1,75,46,29
2019,155317,40,2,257,140,117
2019,155317,40,3,659,341,318
2019,155317,40,4,63,28,35
2019,155317,40,5,158,64,94
2019,155317,41,0,694,408,286
2019,155317,41,1,54,39,15
2019,155317,41,2,187,115,72
2019,155317,41,3,350,210,140
2019,155317,41,4,13,7,6
2019,155317,41,5,90,37,53
2019,155317,42,0,516,211,305
2019,155317,42,1,21,7,14
2019,155317,42,2,70,25,45
2019,155317,42,3,309,131,178
2019,155317,42,4,50,21,29
2019,155317,42,5,66,27,39
2019,155317,43,0,2,0,2
2019,155317,43,5,2,0,2
2019,155317,44,0,627,382,245
2019,155317,44,1,54,39,15
2019,155317,44,2,187,115,72
2019,155317,44,3,350,210,140
2019,155317,44,4,13,7,6
2019,155317,44,5,23,11,12
2019,155317,45,0,67,26,41
2019,155317,45,5,67,26,41
2019,155335,0,0,89,34,55
2019,155335,10,0,89,34,55
2019,155335,10,1,10,5,5
2019,155335,10,2,27,12,15
2019,155335,10,3,43,16,27
2019,155335,10,4,9,1,8
2019,155335,20,0,29,12,17
2019,155335,20,1,9,5,4
2019,155335,20,2,19,7,12
2019,155335,20,3,1,0,1
2019,155335,30,0,60,22,38
2019,155335,30,1,1,0,1
2019,155335,30,2,8,5,3
2019,155335,30,3,42,16,26
2019,155335,30,4,9,1,8
2019,155399,0,0,1001,576,425
2019,155399,10,0,1001,576,425
2019,155399,10,1,262,189,73
2019,155399,10,2,269,151,118
2019,155399,10,3,236,134,102
2019,155399,10,4,180,77,103
2019,155399,10,5,54,25,29
2019,155399,20,0,504,325,179
2019,155399,20,1,244,179,65
2019,155399,20,2,260,146,114
2019,155399,30,0,193,115,78
2019,155399,30,3,193,115,78
2019,155399,40,0,304,136,168
2019,155399,40,1,18,10,8
2019,155399,40,2,9,5,4
2019,155399,40,3,43,19,24
2019,155399,40,4,180,77,103
2019,155399,40,5,54,25,29
2019,155399,41,0,146,59,87
2019,155399,41,1,7,3,4
2019,155399,41,3,20,7,13
2019,155399,41,4,95,39,56
2019,155399,41,5,24,10,14
2019,155399,42,0,158,77,81
2019,155399,42,1,11,7,4
2019,155399,42,2,9,5,4
2019,155399,42,3,23,12,11
2019,155399,42,4,85,38,47
2019,155399,42,5,30,15,15
2019,155399,45,0,146,59,87
2019,155399,45,1,7,3,4
2019,155399,45,3,20,7,13
2019,155399,45,4,95,39,56
2019,155399,45,5,24,10,14
2019,155414,0,0,47,21,26
2019,155414,10,0,47,21,26
2019,155414,10,1,7,5,2
2019,155414,10,2,12,6,6
2019,155414,10,3,24,8,16
2019,155414,10,4,1,0,1
2019,155414,10,5,3,2,1
2019,155414,20,0,20,12,8
2019,155414,20,1,7,5,2
2019,155414,20,2,10,5,5
2019,155414,20,3,3,2,1
2019,155414,30,0,20,6,14
2019,155414,30,2,1,0,1
2019,155414,30,3,19,6,13
2019,155414,40,0,7,3,4
2019,155414,40,2,1,1,0
2019,155414,40,3,2,0,2
2019,155414,40,4,1,0,1
2019,155414,40,5,3,2,1
2019,155414,42,0,7,3,4
2019,155414,42,2,1,1,0
2019,155414,42,3,2,0,2
2019,155414,42,4,1,0,1
2019,155414,42,5,3,2,1
2019,155450,0,0,34,15,19
2019,155450,10,0,34,15,19
2019,155450,10,1,18,9,9
2019,155450,10,2,4,2,2
2019,155450,10,3,6,3,3
2019,155450,10,4,6,1,5
2019,155450,20,0,22,10,12
2019,155450,20,1,18,9,9
2019,155450,20,2,2,1,1
2019,155450,20,4,2,0,2
2019,155450,30,0,12,5,7
2019,155450,30,2,2,1,1
2019,155450,30,3,6,3,3
2019,155450,30,4,4,1,3
2019,155487,0,0,25,15,10
2019,155487,10,0,25,15,10
2019,155487,10,4,25,15,10
2019,155487,40,0,25,15,10
2019,155487,40,4,25,15,10
2019,155487,42,0,25,15,10
2019,155487,42,4,25,15,10
2019,155496,0,0,9,7,2
2019,155496,10,0,9,7,2
2019,155496,10,1,5,4,1
2019,155496,10,2,2,2,0
2019,155496,10,3,2,1,1
2019,155496,40,0,9,7,2
2019,155496,40,1,5,4,1
2019,155496,40,2,2,2,0
2019,155496,40,3,2,1,1
2019,155496,42,0,9,7,2
2019,155496,42,1,5,4,1
2019,155496,42,2,2,2,0
2019,155496,42,3,2,1,1
2019,155511,0,0,45,26,19
2019,155511,10,0,45,26,19
2019,155511,10,1,14,10,4
2019,155511,10,2,13,9,4
2019,155511,10,3,18,7,11
2019,155511,20,0,24,17,7
2019,155511,20,1,14,10,4
2019,155511,20,2,10,7,3
2019,155511,30,0,17,7,10
2019,155511,30,2,3,2,1
2019,155511,30,3,14,5,9
2019,155511,40,0,4,2,2
2019,155511,40,3,4,2,2
2019,155511,43,0,4,2,2
2019,155511,43,3,4,2,2
2019,155520,0,0,70,37,33
2019,155520,10,0,70,37,33
2019,155520,10,1,31,18,13
2019,155520,10,2,14,7,7
2019,155520,10,3,25,12,13
2019,155520,40,0,70,37,33
2019,155520,40,1,31,18,13
2019,155520,40,2,14,7,7
2019,155520,40,3,25,12,13
2019,155520,42,0,70,37,33
2019,155520,42,1,31,18,13
2019,155520,42,2,14,7,7
2019,155520,42,3,25,12,13
2019,155566,0,0,58,28,30
2019,155566,10,0,58,28,30
2019,155566,10,1,21,11,10
2019,155566,10,2,8,2,6
2019,155566,10,3,15,7,8
2019,155566,10,4,14,8,6
2019,155566,20,0,29,15,14
2019,155566,20,1,17,9,8
2019,155566,20,2,6,2,4
2019,155566,20,3,1,0,1
2019,155566,20,4,5,4,1
2019,155566,30,0,17,6,11
2019,155566,30,3,10,3,7
2019,155566,30,4,7,3,4
2019,155566,40,0,12,7,5
2019,155566,40,1,4,2,2
2019,155566,40,2,2,0,2
2019,155566,40,3,4,4,0
2019,155566,40,4,2,1,1
2019,155566,42,0,12,7,5
2019,155566,42,1,4,2,2
2019,155566,42,2,2,0,2
2019,155566,42,3,4,4,0
2019,155566,42,4,2,1,1
2019,155593,0,0,52,31,21
2019,155593,10,0,50,29,21
2019,155593,10,4,50,29,21
2019,155593,20,0,37,24,13
2019,155593,20,4,37,24,13
2019,155593,30,0,13,5,8
2019,155593,30,4,13,5,8
2019,155593,50,0,2,2,0
2019,155618,0,0,31,20,11
2019,155618,10,0,31,20,11
2019,155618,10,4,31,20,11
2019,155618,20,0,19,14,5
2019,155618,20,4,19,14,5
2019,155618,30,0,12,6,6
2019,155618,30,4,12,6,6
2019,155627,0,0,26,16,10
2019,155627,10,0,26,16,10
2019,155627,10,1,6,4,2
2019,155627,10,2,13,7,6
2019,155627,10,3,6,5,1
2019,155627,10,4,1,0,1
2019,155627,20,0,9,5,4
2019,155627,20,1,5,3,2
2019,155627,20,2,4,2,2
2019,155627,30,0,6,3,3
2019,155627,30,2,4,2,2
2019,155627,30,3,2,1,1
2019,155627,40,0,11,8,3
2019,155627,40,1,1,1,0
2019,155627,40,2,5,3,2
2019,155627,40,3,4,4,0
2019,155627,40,4,1,0,1
2019,155627,42,0,11,8,3
2019,155627,42,1,1,1,0
2019,155627,42,2,5,3,2
2019,155627,42,3,4,4,0
2019,155627,42,4,1,0,1
2019,155636,0,0,4,1,3
2019,155636,10,0,4,1,3
2019,155636,10,2,1,0,1
2019,155636,10,3,3,1,2
2019,155636,40,0,4,1,3
2019,155636,40,2,1,0,1
2019,155636,40,3,3,1,2
2019,155636,42,0,4,1,3
2019,155636,42,2,1,0,1
2019,155636,42,3,3,1,2
2019,155681,0,0,291,163,128
2019,155681,10,0,291,163,128
2019,155681,10,1,107,69,38
2019,155681,10,2,69,43,26
2019,155681,10,3,60,34,26
2019,155681,10,4,55,17,38
2019,155681,20,0,183,115,68
2019,155681,20,1,107,69,38
2019,155681,20,2,69,43,26
2019,155681,20,3,7,3,4
2019,155681,30,0,53,31,22
2019,155681,30,3,53,31,22
2019,155681,40,0,55,17,38
2019,155681,40,4,55,17,38
2019,155681,42,0,55,17,38
2019,155681,42,4,55,17,38
2019,155715,0,0,36,21,15
2019,155715,10,0,36,21,15
2019,155715,10,4,36,21,15
2019,155715,20,0,22,10,12
2019,155715,20,4,22,10,12
2019,155715,30,0,14,11,3
2019,155715,30,4,14,11,3
2019,155812,0,0,74,26,48
2019,155812,10,0,74,26,48
2019,155812,10,1,8,4,4
2019,155812,10,2,23,10,13
2019,155812,10,3,22,5,17
2019,155812,10,4,21,7,14
2019,155812,20,0,28,14,14
2019,155812,20,1,8,4,4
2019,155812,20,2,20,10,10
2019,155812,30,0,21,5,16
2019,155812,30,2,3,0,3
2019,155812,30,3,15,4,11
2019,155812,30,4,3,1,2
2019,155812,40,0,25,7,18
2019,155812,40,3,7,1,6
2019,155812,40,4,18,6,12
2019,155812,42,0,25,7,18
2019,155812,42,3,7,1,6
2019,155812,42,4,18,6,12
2019,155830,0,0,25,15,10
2019,155830,10,0,25,15,10
2019,155830,10,4,25,15,10
2019,155830,20,0,16,13,3
2019,155830,20,4,16,13,3
2019,155830,30,0,9,2,7
2019,155830,30,4,9,2,7
2019,155858,0,0,54,26,28
2019,155858,10,0,54,26,28
2019,155858,10,4,54,26,28
2019,155858,40,0,54,26,28
2019,155858,40,4,54,26,28
2019,155858,42,0,54,26,28
2019,155858,42,4,54,26,28
2019,155900,0,0,42,24,18
2019,155900,10,0,42,24,18
2019,155900,10,1,12,9,3
2019,155900,10,2,14,4,10
2019,155900,10,3,12,7,5
2019,155900,10,4,4,4,0
2019,155900,20,0,25,12,13
2019,155900,20,1,12,9,3
2019,155900,20,2,13,3,10
2019,155900,30,0,8,5,3
2019,155900,30,3,8,5,3
2019,155900,40,0,9,7,2
2019,155900,40,2,1,1,0
2019,155900,40,3,4,2,2
2019,155900,40,4,4,4,0
2019,155900,42,0,9,7,2
2019,155900,42,2,1,1,0
2019,155900,42,3,4,2,2
2019,155900,42,4,4,4,0
2019,155937,0,0,45,23,22
2019,155937,10,0,45,23,22
2019,155937,10,1,5,4,1
2019,155937,10,2,6,4,2
2019,155937,10,3,32,14,18
2019,155937,10,4,2,1,1
2019,155937,20,0,21,13,8
2019,155937,20,1,5,4,1
2019,155937,20,2,3,2,1
2019,155937,20,3,13,7,6
2019,155937,30,0,24,10,14
2019,155937,30,2,3,2,1
2019,155937,30,3,19,7,12
2019,155937,30,4,2,1,1
2019,155973,0,0,36,21,15
2019,155973,10,0,36,21,15
2019,155973,10,1,9,6,3
2019,155973,10,2,7,4,3
2019,155973,10,3,20,11,9
2019,155973,20,0,12,8,4
2019,155973,20,1,8,5,3
2019,155973,20,2,4,3,1
2019,155973,30,0,18,7,11
2019,155973,30,2,2,0,2
2019,155973,30,3,16,7,9
2019,155973,40,0,6,6,0
2019,155973,40,1,1,1,0
2019,155973,40,2,1,1,0
2019,155973,40,3,4,4,0
2019,155973,41,0,3,3,0
2019,155973,41,1,1,1,0
2019,155973,41,2,1,1,0
2019,155973,41,3,1,1,0
2019,155973,42,0,3,3,0
2019,155973,42,3,3,3,0
2019,155973,44,0,3,3,0
2019,155973,44,1,1,1,0
2019,155973,44,2,1,1,0
2019,155973,44,3,1,1,0
2019,156082,0,0,285,125,160
2019,156082,10,0,285,125,160
2019,156082,10,1,77,39,38
2019,156082,10,2,48,23,25
2019,156082,10,3,71,28,43
2019,156082,10,5,85,33,52
2019,156082,10,6,4,2,2
2019,156082,20,0,134,65,69
2019,156082,20,1,74,37,37
2019,156082,20,2,43,22,21
2019,156082,20,3,17,6,11
2019,156082,30,0,57,23,34
2019,156082,30,2,4,1,3
2019,156082,30,3,53,22,31
2019,156082,40,0,94,37,57
2019,156082,40,1,3,2,1
2019,156082,40,2,1,0,1
2019,156082,40,3,1,0,1
2019,156082,40,5,85,33,52
2019,156082,40,6,4,2,2
2019,156082,42,0,91,36,55
2019,156082,42,1,3,2,1
2019,156082,42,2,1,0,1
2019,156082,42,3,1,0,1
2019,156082,42,5,85,33,52
2019,156082,42,6,1,1,0
2019,156082,43,0,3,1,2
2019,156082,43,6,3,1,2
2019,156107,0,0,88,49,39
2019,156107,10,0,78,41,37
2019,156107,10,4,78,41,37
2019,156107,20,0,44,25,19
2019,156107,20,4,44,25,19
2019,156107,30,0,34,16,18
2019,156107,30,4,34,16,18
2019,156107,50,0,10,8,2
2019,156125,0,0,564,294,270
2019,156125,10,0,564,294,270
2019,156125,10,1,153,99,54
2019,156125,10,2,184,93,91
2019,156125,10,3,203,91,112
2019,156125,10,4,2,1,1
2019,156125,10,6,22,10,12
2019,156125,20,0,260,174,86
2019,156125,20,1,118,87,31
2019,156125,20,2,136,83,53
2019,156125,20,3,4,2,2
2019,156125,20,6,2,2,0
2019,156125,30,0,122,63,59
2019,156125,30,2,1,0,1
2019,156125,30,3,115,60,55
2019,156125,30,4,1,1,0
2019,156125,30,6,5,2,3
2019,156125,40,0,182,57,125
2019,156125,40,1,35,12,23
2019,156125,40,2,47,10,37
2019,156125,40,3,84,29,55
2019,156125,40,4,1,0,1
2019,156125,40,6,15,6,9
2019,156125,42,0,176,57,119
2019,156125,42,1,35,12,23
2019,156125,42,2,44,10,34
2019,156125,42,3,81,29,52
2019,156125,42,4,1,0,1
2019,156125,42,6,15,6,9
2019,156125,43,0,6,0,6
2019,156125,43,2,3,0,3
2019,156125,43,3,3,0,3
2019,156134,0,0,37,23,14
2019,156134,10,0,36,22,14
2019,156134,10,4,36,22,14
2019,156134,40,0,36,22,14
2019,156134,40,4,36,22,14
2019,156134,41,0,36,22,14
2019,156134,41,4,36,22,14
2019,156134,44,0,36,22,14
2019,156134,44,4,36,22,14
2019,156134,50,0,1,1,0
2019,156189,0,0,26,13,13
2019,156189,10,0,26,13,13
2019,156189,10,1,9,6,3
2019,156189,10,2,3,1,2
2019,156189,10,3,11,6,5
2019,156189,10,4,3,0,3
2019,156189,40,0,26,13,13
2019,156189,40,1,9,6,3
2019,156189,40,2,3,1,2
2019,156189,40,3,11,6,5
2019,156189,40,4,3,0,3
2019,156189,43,0,26,13,13
2019,156189,43,1,9,6,3
2019,156189,43,2,3,1,2
2019,156189,43,3,11,6,5
2019,156189,43,4,3,0,3
2019,156213,0,0,90,56,34
2019,156213,10,0,90,56,34
2019,156213,10,1,31,27,4
2019,156213,10,2,27,17,10
2019,156213,10,3,32,12,20
2019,156213,20,0,51,40,11
2019,156213,20,1,30,26,4
2019,156213,20,2,21,14,7
2019,156213,30,0,28,11,17
2019,156213,30,1,1,1,0
2019,156213,30,2,5,2,3
2019,156213,30,3,22,8,14
2019,156213,40,0,11,5,6
2019,156213,40,2,1,1,0
2019,156213,40,3,10,4,6
2019,156213,41,0,4,3,1
2019,156213,41,2,1,1,0
2019,156213,41,3,3,2,1
2019,156213,42,0,7,2,5
2019,156213,42,3,7,2,5
2019,156213,44,0,4,3,1
2019,156213,44,2,1,1,0
2019,156213,44,3,3,2,1
2019,156222,0,0,47,38,9
2019,156222,10,0,47,38,9
2019,156222,10,1,36,30,6
2019,156222,10,2,8,7,1
2019,156222,10,3,3,1,2
2019,156222,20,0,41,34,7
2019,156222,20,1,36,30,6
2019,156222,20,2,5,4,1
2019,156222,30,0,6,4,2
2019,156222,30,2,3,3,0
2019,156222,30,3,3,1,2
2019,156231,0,0,69,35,34
2019,156231,10,0,69,35,34
2019,156231,10,1,29,18,11
2019,156231,10,2,12,6,6
2019,156231,10,3,8,5,3
2019,156231,10,4,20,6,14
2019,156231,20,0,19,12,7
2019,156231,20,1,19,12,7
2019,156231,40,0,50,23,27
2019,156231,40,1,10,6,4
2019,156231,40,2,12,6,6
2019,156231,40,3,8,5,3
2019,156231,40,4,20,6,14
2019,156231,42,0,4,2,2
2019,156231,42,1,1,1,0
2019,156231,42,2,3,1,2
2019,156231,43,0,46,21,25
2019,156231,43,1,9,5,4
2019,156231,43,2,9,5,4
2019,156231,43,3,8,5,3
2019,156231,43,4,20,6,14
2019,156286,0,0,176,74,102
2019,156286,10,0,176,74,102
2019,156286,10,1,42,28,14
2019,156286,10,2,57,22,35
2019,156286,10,3,56,17,39
2019,156286,10,4,21,7,14
2019,156286,20,0,87,46,41
2019,156286,20,1,39,25,14
2019,156286,20,2,47,21,26
2019,156286,20,3,1,0,1
2019,156286,30,0,43,15,28
2019,156286,30,1,2,2,0
2019,156286,30,2,5,0,5
2019,156286,30,3,36,13,23
2019,156286,40,0,46,13,33
2019,156286,40,1,1,1,0
2019,156286,40,2,5,1,4
2019,156286,40,3,19,4,15
2019,156286,40,4,21,7,14
2019,156286,42,0,46,13,33
2019,156286,42,1,1,1,0
2019,156286,42,2,5,1,4
2019,156286,42,3,19,4,15
2019,156286,42,4,21,7,14
2019,156295,0,0,147,70,77
2019,156295,10,0,147,70,77
2019,156295,10,1,33,16,17
2019,156295,10,2,60,33,27
2019,156295,10,3,48,18,30
2019,156295,10,4,6,3,3
2019,156295,20,0,76,43,33
2019,156295,20,1,29,14,15
2019,156295,20,2,47,29,18
2019,156295,30,0,37,13,24
2019,156295,30,1,2,0,2
2019,156295,30,2,4,0,4
2019,156295,30,3,31,13,18
2019,156295,40,0,34,14,20
2019,156295,40,1,2,2,0
2019,156295,40,2,9,4,5
2019,156295,40,3,17,5,12
2019,156295,40,4,6,3,3
2019,156295,41,0,29,13,16
2019,156295,41,1,2,2,0
2019,156295,41,2,9,4,5
2019,156295,41,3,13,4,9
2019,156295,41,4,5,3,2
2019,156295,42,0,5,1,4
2019,156295,42,3,4,1,3
2019,156295,42,4,1,0,1
2019,156295,44,0,28,12,16
2019,156295,44,1,2,2,0
2019,156295,44,2,9,4,5
2019,156295,44,3,13,4,9
2019,156295,44,4,4,2,2
2019,156295,45,0,1,1,0
2019,156295,45,4,1,1,0
2019,156338,0,0,96,45,51
2019,156338,10,0,96,45,51
2019,156338,10,1,15,10,5
2019,156338,10,2,30,13,17
2019,156338,10,3,21,9,12
2019,156338,10,4,29,13,16
2019,156338,10,5,1,0,1
2019,156338,40,0,96,45,51
2019,156338,40,1,15,10,5
2019,156338,40,2,30,13,17
2019,156338,40,3,21,9,12
2019,156338,40,4,29,13,16
2019,156338,40,5,1,0,1
2019,156338,42,0,28,12,16
2019,156338,42,1,4,1,3
2019,156338,42,2,7,3,4
2019,156338,42,3,7,2,5
2019,156338,42,4,10,6,4
2019,156338,43,0,68,33,35
2019,156338,43,1,11,9,2
2019,156338,43,2,23,10,13
2019,156338,43,3,14,7,7
2019,156338,43,4,19,7,12
2019,156338,43,5,1,0,1
2019,156356,0,0,44,21,23
2019,156356,10,0,44,21,23
2019,156356,10,1,4,2,2
2019,156356,10,2,12,5,7
2019,156356,10,3,24,11,13
2019,156356,10,4,4,3,1
2019,156356,20,0,15,6,9
2019,156356,20,1,4,2,2
2019,156356,20,2,10,4,6
2019,156356,20,3,1,0,1
2019,156356,30,0,17,9,8
2019,156356,30,2,1,0,1
2019,156356,30,3,16,9,7
2019,156356,40,0,12,6,6
2019,156356,40,2,1,1,0
2019,156356,40,3,7,2,5
2019,156356,40,4,4,3,1
2019,156356,42,0,12,6,6
2019,156356,42,2,1,1,0
2019,156356,42,3,7,2,5
2019,156356,42,4,4,3,1
2019,156365,0,0,244,114,130
2019,156365,10,0,215,106,109
2019,156365,10,1,41,27,14
2019,156365,10,2,53,25,28
2019,156365,10,3,73,36,37
2019,156365,10,4,48,18,30
2019,156365,20,0,54,29,25
2019,156365,20,1,27,18,9
2019,156365,20,2,25,11,14
2019,156365,20,3,2,0,2
2019,156365,30,0,113,59,54
2019,156365,30,1,14,9,5
2019,156365,30,2,28,14,14
2019,156365,30,3,71,36,35
2019,156365,40,0,48,18,30
2019,156365,40,4,48,18,30
2019,156365,42,0,48,18,30
2019,156365,42,4,48,18,30
2019,156365,50,0,29,8,21
2019,156392,0,0,193,84,109
2019,156392,10,0,193,84,109
2019,156392,10,1,61,23,38
2019,156392,10,2,62,34,28
2019,156392,10,3,28,8,20
2019,156392,10,4,39,16,23
2019,156392,10,5,3,3,0
2019,156392,20,0,88,43,45
2019,156392,20,1,52,20,32
2019,156392,20,2,36,23,13
2019,156392,30,0,22,7,15
2019,156392,30,1,3,1,2
2019,156392,30,2,9,2,7
2019,156392,30,3,2,0,2
2019,156392,30,4,8,4,4
2019,156392,40,0,83,34,49
2019,156392,40,1,6,2,4
2019,156392,40,2,17,9,8
2019,156392,40,3,26,8,18
2019,156392,40,4,31,12,19
2019,156392,40,5,3,3,0
2019,156392,42,0,10,2,8
2019,156392,42,1,1,0,1
2019,156392,42,2,1,0,1
2019,156392,42,3,6,2,4
2019,156392,42,4,2,0,2
2019,156392,43,0,73,32,41
2019,156392,43,1,5,2,3
2019,156392,43,2,16,9,7
2019,156392,43,3,20,6,14
2019,156392,43,4,29,12,17
2019,156392,43,5,3,3,0
2019,156408,0,0,133,77,56
2019,156408,10,0,133,77,56
2019,156408,10,1,30,21,9
2019,156408,10,2,40,23,17
2019,156408,10,3,57,28,29
2019,156408,10,4,5,4,1
2019,156408,10,6,1,1,0
2019,156408,20,0,70,44,26
2019,156408,20,1,30,21,9
2019,156408,20,2,40,23,17
2019,156408,30,0,39,16,23
2019,156408,30,3,39,16,23
2019,156408,40,0,24,17,7
2019,156408,40,3,18,12,6
2019,156408,40,4,5,4,1
2019,156408,40,6,1,1,0
2019,156408,41,0,9,7,2
2019,156408,41,3,5,3,2
2019,156408,41,4,3,3,0
2019,156408,41,6,1,1,0
2019,156408,42,0,15,10,5
2019,156408,42,3,13,9,4
2019,156408,42,4,2,1,1
2019,156408,44,0,9,7,2
2019,156408,44,3,5,3,2
2019,156408,44,4,3,3,0
2019,156408,44,6,1,1,0
2019,156417,0,0,6,6,0
2019,156417,10,0,6,6,0
2019,156417,10,1,3,3,0
2019,156417,10,2,1,1,0
2019,156417,10,3,2,2,0
2019,156417,40,0,6,6,0
2019,156417,40,1,3,3,0
2019,156417,40,2,1,1,0
2019,156417,40,3,2,2,0
2019,156417,41,0,2,2,0
2019,156417,41,1,2,2,0
2019,156417,42,0,4,4,0
2019,156417,42,1,1,1,0
2019,156417,42,2,1,1,0
2019,156417,42,3,2,2,0
2019,156417,44,0,2,2,0
2019,156417,44,1,2,2,0
2019,156471,0,0,64,6,58
2019,156471,10,0,64,6,58
2019,156471,10,2,2,0,2
2019,156471,10,3,10,1,9
2019,156471,10,4,52,5,47
2019,156471,40,0,64,6,58
2019,156471,40,2,2,0,2
2019,156471,40,3,10,1,9
2019,156471,40,4,52,5,47
2019,156471,41,0,64,6,58
2019,156471,41,2,2,0,2
2019,156471,41,3,10,1,9
2019,156471,41,4,52,5,47
2019,156471,45,0,64,6,58
2019,156471,45,2,2,0,2
2019,156471,45,3,10,1,9
2019,156471,45,4,52,5,47
2019,156541,0,0,227,113,114
2019,156541,10,0,227,113,114
2019,156541,10,1,56,36,20
2019,156541,10,2,98,50,48
2019,156541,10,3,72,27,45
2019,156541,10,4,1,0,1
2019,156541,20,0,37,22,15
2019,156541,20,1,26,17,9
2019,156541,20,2,11,5,6
2019,156541,30,0,121,45,76
2019,156541,30,1,14,9,5
2019,156541,30,2,50,17,33
2019,156541,30,3,56,19,37
2019,156541,30,4,1,0,1
2019,156541,40,0,69,46,23
2019,156541,40,1,16,10,6
2019,156541,40,2,37,28,9
2019,156541,40,3,16,8,8
2019,156541,42,0,69,46,23
2019,156541,42,1,16,10,6
2019,156541,42,2,37,28,9
2019,156541,42,3,16,8,8
2019,156620,0,0,580,283,297
2019,156620,10,0,580,283,297
2019,156620,10,1,150,92,58
2019,156620,10,2,155,70,85
2019,156620,10,3,158,71,87
2019,156620,10,4,18,5,13
2019,156620,10,5,64,37,27
2019,156620,10,6,35,8,27
2019,156620,20,0,317,160,157
2019,156620,20,1,148,91,57
2019,156620,20,2,134,59,75
2019,156620,20,3,34,9,25
2019,156620,20,6,1,1,0
2019,156620,30,0,161,78,83
2019,156620,30,1,1,1,0
2019,156620,30,2,21,11,10
2019,156620,30,3,117,58,59
2019,156620,30,4,14,4,10
2019,156620,30,6,8,4,4
2019,156620,40,0,102,45,57
2019,156620,40,1,1,0,1
2019,156620,40,3,7,4,3
2019,156620,40,4,4,1,3
2019,156620,40,5,64,37,27
2019,156620,40,6,26,3,23
2019,156620,42,0,101,45,56
2019,156620,42,1,1,0,1
2019,156620,42,3,7,4,3
2019,156620,42,4,4,1,3
2019,156620,42,5,64,37,27
2019,156620,42,6,25,3,22
2019,156620,43,0,1,0,1
2019,156620,43,6,1,0,1
2019,156648,0,0,115,65,50
2019,156648,10,0,115,65,50
2019,156648,10,1,45,22,23
2019,156648,10,2,41,28,13
2019,156648,10,3,10,5,5
2019,156648,10,4,19,10,9
2019,156648,20,0,54,27,27
2019,156648,20,1,26,11,15
2019,156648,20,2,28,16,12
2019,156648,30,0,2,1,1
2019,156648,30,3,2,1,1
2019,156648,40,0,59,37,22
2019,156648,40,1,19,11,8
2019,156648,40,2,13,12,1
2019,156648,40,3,8,4,4
2019,156648,40,4,19,10,9
2019,156648,42,0,2,2,0
2019,156648,42,1,1,1,0
2019,156648,42,2,1,1,0
2019,156648,43,0,57,35,22
2019,156648,43,1,18,10,8
2019,156648,43,2,12,11,1
2019,156648,43,3,8,4,4
2019,156648,43,4,19,10,9
2019,156727,0,0,126,4,122
2019,156727,10,0,126,4,122
2019,156727,10,1,3,0,3
2019,156727,10,2,15,1,14
2019,156727,10,3,33,0,33
2019,156727,10,4,61,1,60
2019,156727,10,6,14,2,12
2019,156727,40,0,126,4,122
2019,156727,40,1,3,0,3
2019,156727,40,2,15,1,14
2019,156727,40,3,33,0,33
2019,156727,40,4,61,1,60
2019,156727,40,6,14,2,12
2019,156727,42,0,126,4,122
2019,156727,42,1,3,0,3
2019,156727,42,2,15,1,14
2019,156727,42,3,33,0,33
2019,156727,42,4,61,1,60
2019,156727,42,6,14,2,12
2019,156745,0,0,82,40,42
2019,156745,10,0,82,40,42
2019,156745,10,1,38,21,17
2019,156745,10,2,23,11,12
2019,156745,10,3,6,2,4
2019,156745,10,4,10,6,4
2019,156745,10,5,5,0,5
2019,156745,20,0,61,32,29
2019,156745,20,1,38,21,17
2019,156745,20,2,22,11,11
2019,156745,20,3,1,0,1
2019,156745,30,0,6,2,4
2019,156745,30,2,1,0,1
2019,156745,30,3,5,2,3
2019,156745,40,0,15,6,9
2019,156745,40,4,10,6,4
2019,156745,40,5,5,0,5
2019,156745,42,0,15,6,9
2019,156745,42,4,10,6,4
2019,156745,42,5,5,0,5
2019,156790,0,0,80,39,41
2019,156790,10,0,80,39,41
2019,156790,10,1,45,24,21
2019,156790,10,2,11,4,7
2019,156790,10,3,13,5,8
2019,156790,10,4,9,5,4
2019,156790,10,5,2,1,1
2019,156790,20,0,32,18,14
2019,156790,20,1,32,18,14
2019,156790,40,0,48,21,27
2019,156790,40,1,13,6,7
2019,156790,40,2,11,4,7
2019,156790,40,3,13,5,8
2019,156790,40,4,9,5,4
2019,156790,40,5,2,1,1
2019,156790,42,0,8,5,3
2019,156790,42,1,4,2,2
2019,156790,42,2,2,1,1
2019,156790,42,3,1,1,0
2019,156790,42,4,1,1,0
2019,156790,43,0,40,16,24
2019,156790,43,1,9,4,5
2019,156790,43,2,9,3,6
2019,156790,43,3,12,4,8
2019,156790,43,4,8,4,4
2019,156790,43,5,2,1,1
2019,156851,0,0,39,14,25
2019,156851,10,0,39,14,25
2019,156851,10,1,16,6,10
2019,156851,10,2,8,3,5
2019,156851,10,3,1,0,1
2019,156851,10,4,14,5,9
2019,156851,20,0,18,7,11
2019,156851,20,1,16,6,10
2019,156851,20,2,1,1,0
2019,156851,20,4,1,0,1
2019,156851,30,0,2,0,2
2019,156851,30,2,2,0,2
2019,156851,40,0,19,7,12
2019,156851,40,2,5,2,3
2019,156851,40,3,1,0,1
2019,156851,40,4,13,5,8
2019,156851,42,0,2,1,1
2019,156851,42,2,1,0,1
2019,156851,42,4,1,1,0
2019,156851,43,0,17,6,11
2019,156851,43,2,4,2,2
2019,156851,43,3,1,0,1
2019,156851,43,4,12,4,8
2019,156860,0,0,54,24,30
2019,156860,10,0,54,24,30
2019,156860,10,1,13,8,5
2019,156860,10,2,10,5,5
2019,156860,10,3,7,4,3
2019,156860,10,4,23,6,17
2019,156860,10,5,1,1,0
2019,156860,20,0,16,7,9
2019,156860,20,1,12,7,5
2019,156860,20,2,4,0,4
2019,156860,30,0,1,1,0
2019,156860,30,3,1,1,0
2019,156860,40,0,37,16,21
2019,156860,40,1,1,1,0
2019,156860,40,2,6,5,1
2019,156860,40,3,6,3,3
2019,156860,40,4,23,6,17
2019,156860,40,5,1,1,0
2019,156860,43,0,37,16,21
2019,156860,43,1,1,1,0
2019,156860,43,2,6,5,1
2019,156860,43,3,6,3,3
2019,156860,43,4,23,6,17
2019,156860,43,5,1,1,0
2019,156921,0,0,181,84,97
2019,156921,10,0,181,84,97
2019,156921,10,1,53,20,33
2019,156921,10,2,54,25,29
2019,156921,10,3,16,10,6
2019,156921,10,4,58,29,29
2019,156921,20,0,80,35,45
2019,156921,20,1,47,19,28
2019,156921,20,2,33,16,17
2019,156921,30,0,8,2,6
2019,156921,30,2,8,2,6
2019,156921,40,0,93,47,46
2019,156921,40,1,6,1,5
2019,156921,40,2,13,7,6
2019,156921,40,3,16,10,6
2019,156921,40,4,58,29,29
2019,156921,42,0,19,8,11
2019,156921,42,1,2,0,2
2019,156921,42,2,4,2,2
2019,156921,42,3,4,2,2
2019,156921,42,4,9,4,5
2019,156921,43,0,74,39,35
2019,156921,43,1,4,1,3
2019,156921,43,2,9,5,4
2019,156921,43,3,12,8,4
2019,156921,43,4,49,25,24
2019,157021,0,0,7,3,4
2019,157021,50,0,7,3,4
2019,157058,0,0,119,67,52
2019,157058,10,0,119,67,52
2019,157058,10,1,25,17,8
2019,157058,10,2,32,17,15
2019,157058,10,3,57,32,25
2019,157058,10,4,4,1,3
2019,157058,10,6,1,0,1
2019,157058,20,0,65,39,26
2019,157058,20,1,23,15,8
2019,157058,20,2,24,13,11
2019,157058,20,3,18,11,7
2019,157058,30,0,22,14,8
2019,157058,30,1,2,2,0
2019,157058,30,2,4,3,1
2019,157058,30,3,16,9,7
2019,157058,40,0,32,14,18
2019,157058,40,2,4,1,3
2019,157058,40,3,23,12,11
2019,157058,40,4,4,1,3
2019,157058,40,6,1,0,1
2019,157058,42,0,32,14,18
2019,157058,42,2,4,1,3
2019,157058,42,3,23,12,11
2019,157058,42,4,4,1,3
2019,157058,42,6,1,0,1
2019,157076,0,0,45,18,27
2019,157076,10,0,45,18,27
2019,157076,10,1,2,1,1
2019,157076,10,2,11,4,7
2019,157076,10,3,31,13,18
2019,157076,10,4,1,0,1
2019,157076,20,0,12,5,7
2019,157076,20,1,2,1,1
2019,157076,20,2,10,4,6
2019,157076,30,0,19,10,9
2019,157076,30,2,1,0,1
2019,157076,30,3,18,10,8
2019,157076,40,0,14,3,11
2019,157076,40,3,13,3,10
2019,157076,40,4,1,0,1
2019,157076,42,0,14,3,11
2019,157076,42,3,13,3,10
2019,157076,42,4,1,0,1
2019,157085,0,0,1751,1015,736
2019,157085,10,0,1751,1015,736
2019,157085,10,1,616,455,161
2019,157085,10,2,505,302,203
2019,157085,10,3,400,168,232
2019,157085,10,4,15,4,11
2019,157085,10,5,215,86,129
2019,157085,20,0,1086,734,352
2019,157085,20,1,613,452,161
2019,157085,20,2,473,282,191
2019,157085,30,0,419,184,235
2019,157085,30,2,31,19,12
2019,157085,30,3,388,165,223
2019,157085,40,0,246,97,149
2019,157085,40,1,3,3,0
2019,157085,40,2,1,1,0
2019,157085,40,3,12,3,9
2019,157085,40,4,15,4,11
2019,157085,40,5,215,86,129
2019,157085,41,0,131,53,78
2019,157085,41,5,131,53,78
2019,157085,42,0,97,39,58
2019,157085,42,1,3,3,0
2019,157085,42,2,1,1,0
2019,157085,42,3,11,2,9
2019,157085,42,4,9,4,5
2019,157085,42,5,73,29,44
2019,157085,43,0,18,5,13
2019,157085,43,3,1,1,0
2019,157085,43,4,6,0,6
2019,157085,43,5,11,4,7
2019,157085,44,0,131,53,78
2019,157085,44,5,131,53,78
2019,157100,0,0,29,13,16
2019,157100,10,0,29,13,16
2019,157100,10,1,3,2,1
2019,157100,10,2,6,5,1
2019,157100,10,3,19,6,13
2019,157100,10,4,1,0,1
2019,157100,40,0,29,13,16
2019,157100,40,1,3,2,1
2019,157100,40,2,6,5,1
2019,157100,40,3,19,6,13
2019,157100,40,4,1,0,1
2019,157100,42,0,29,13,16
2019,157100,42,1,3,2,1
2019,157100,42,2,6,5,1
2019,157100,42,3,19,6,13
2019,157100,42,4,1,0,1
2019,157207,0,0,3,1,2
2019,157207,10,0,3,1,2
2019,157207,10,1,1,1,0
2019,157207,10,2,1,0,1
2019,157207,10,3,1,0,1
2019,157207,40,0,3,1,2
2019,157207,40,1,1,1,0
2019,157207,40,2,1,0,1
2019,157207,40,3,1,0,1
2019,157207,41,0,3,1,2
2019,157207,41,1,1,1,0
2019,157207,41,2,1,0,1
2019,157207,41,3,1,0,1
2019,157207,44,0,3,1,2
2019,157207,44,1,1,1,0
2019,157207,44,2,1,0,1
2019,157207,44,3,1,0,1
2019,157216,0,0,111,53,58
2019,157216,10,0,111,53,58
2019,157216,10,1,13,10,3
2019,157216,10,2,27,13,14
2019,157216,10,3,56,24,32
2019,157216,10,4,15,6,9
2019,157216,40,0,111,53,58
2019,157216,40,1,13,10,3
2019,157216,40,2,27,13,14
2019,157216,40,3,56,24,32
2019,157216,40,4,15,6,9
2019,157216,41,0,84,43,41
2019,157216,41,1,13,10,3
2019,157216,41,2,24,11,13
2019,157216,41,3,37,19,18
2019,157216,41,4,10,3,7
2019,157216,42,0,27,10,17
2019,157216,42,2,3,2,1
2019,157216,42,3,19,5,14
2019,157216,42,4,5,3,2
2019,157216,44,0,84,43,41
2019,157216,44,1,13,10,3
2019,157216,44,2,24,11,13
2019,157216,44,3,37,19,18
2019,157216,44,4,10,3,7
2019,157289,0,0,1728,1002,726
2019,157289,10,0,1728,1002,726
2019,157289,10,1,492,360,132
2019,157289,10,2,490,280,210
2019,157289,10,3,614,311,303
2019,157289,10,4,116,43,73
2019,157289,10,6,16,8,8
2019,157289,20,0,726,504,222
2019,157289,20,1,417,315,102
2019,157289,20,2,303,186,117
2019,157289,20,3,5,3,2
2019,157289,20,4,1,0,1
2019,157289,30,0,217,123,94
2019,157289,30,1,3,3,0
2019,157289,30,2,13,10,3
2019,157289,30,3,197,109,88
2019,157289,30,4,4,1,3
2019,157289,40,0,785,375,410
2019,157289,40,1,72,42,30
2019,157289,40,2,174,84,90
2019,157289,40,3,412,199,213
2019,157289,40,4,111,42,69
2019,157289,40,6,16,8,8
2019,157289,41,0,23,14,9
2019,157289,41,1,5,1,4
2019,157289,41,2,3,3,0
2019,157289,41,3,5,4,1
2019,157289,41,4,10,6,4
2019,157289,42,0,762,361,401
2019,157289,42,1,67,41,26
2019,157289,42,2,171,81,90
2019,157289,42,3,407,195,212
2019,157289,42,4,101,36,65
2019,157289,42,6,16,8,8
2019,157289,44,0,23,14,9
2019,157289,44,1,5,1,4
2019,157289,44,2,3,3,0
2019,157289,44,3,5,4,1
2019,157289,44,4,10,6,4
2019,157298,0,0,15,9,6
2019,157298,10,0,15,9,6
2019,157298,10,1,11,6,5
2019,157298,10,3,3,2,1
2019,157298,10,4,1,1,0
2019,157298,20,0,11,6,5
2019,157298,20,1,11,6,5
2019,157298,30,0,3,2,1
2019,157298,30,3,3,2,1
2019,157298,40,0,1,1,0
2019,157298,40,4,1,1,0
2019,157298,42,0,1,1,0
2019,157298,42,4,1,1,0
2019,157304,0,0,81,27,54
2019,157304,10,0,81,27,54
2019,157304,10,1,36,11,25
2019,157304,10,2,29,7,22
2019,157304,10,3,7,4,3
2019,157304,10,4,9,5,4
2019,157304,20,0,29,9,20
2019,157304,20,1,21,7,14
2019,157304,20,2,8,2,6
2019,157304,30,0,4,1,3
2019,157304,30,2,4,1,3
2019,157304,40,0,48,17,31
2019,157304,40,1,15,4,11
2019,157304,40,2,17,4,13
2019,157304,40,3,7,4,3
2019,157304,40,4,9,5,4
2019,157304,42,0,7,5,2
2019,157304,42,1,2,1,1
2019,157304,42,2,1,0,1
2019,157304,42,3,2,2,0
2019,157304,42,4,2,2,0
2019,157304,43,0,41,12,29
2019,157304,43,1,13,3,10
2019,157304,43,2,16,4,12
2019,157304,43,3,5,2,3
2019,157304,43,4,7,3,4
2019,157331,0,0,82,33,49
2019,157331,10,0,82,33,49
2019,157331,10,1,26,11,15
2019,157331,10,2,22,9,13
2019,157331,10,3,14,4,10
2019,157331,10,4,20,9,11
2019,157331,20,0,19,7,12
2019,157331,20,1,15,6,9
2019,157331,20,2,4,1,3
2019,157331,30,0,7,2,5
2019,157331,30,1,1,0,1
2019,157331,30,2,6,2,4
2019,157331,40,0,56,24,32
2019,157331,40,1,10,5,5
2019,157331,40,2,12,6,6
2019,157331,40,3,14,4,10
2019,157331,40,4,20,9,11
2019,157331,42,0,3,2,1
2019,157331,42,1,2,1,1
2019,157331,42,4,1,1,0
2019,157331,43,0,53,22,31
2019,157331,43,1,8,4,4
2019,157331,43,2,12,6,6
2019,157331,43,3,14,4,10
2019,157331,43,4,19,8,11
2019,157377,0,0,28,11,17
2019,157377,10,0,28,11,17
2019,157377,10,1,5,4,1
2019,157377,10,2,5,1,4
2019,157377,10,3,12,5,7
2019,157377,10,4,6,1,5
2019,157377,40,0,28,11,17
2019,157377,40,1,5,4,1
2019,157377,40,2,5,1,4
2019,157377,40,3,12,5,7
2019,157377,40,4,6,1,5
2019,157377,41,0,21,7,14
2019,157377,41,1,4,4,0
2019,157377,41,2,3,0,3
2019,157377,41,3,9,2,7
2019,157377,41,4,5,1,4
2019,157377,42,0,7,4,3
2019,157377,42,1,1,0,1
2019,157377,42,2,2,1,1
2019,157377,42,3,3,3,0
2019,157377,42,4,1,0,1
2019,157377,44,0,21,7,14
2019,157377,44,1,4,4,0
2019,157377,44,2,3,0,3
2019,157377,44,3,9,2,7
2019,157377,44,4,5,1,4
2019,157386,0,0,311,161,150
2019,157386,10,0,308,161,147
2019,157386,10,1,76,42,34
2019,157386,10,2,93,51,42
2019,157386,10,3,55,29,26
2019,157386,10,4,84,39,45
2019,157386,20,0,163,91,72
2019,157386,20,1,76,42,34
2019,157386,20,2,87,49,38
2019,157386,30,0,45,24,21
2019,157386,30,2,6,2,4
2019,157386,30,3,39,22,17
2019,157386,40,0,100,46,54
2019,157386,40,3,16,7,9
2019,157386,40,4,84,39,45
2019,157386,42,0,100,46,54
2019,157386,42,3,16,7,9
2019,157386,42,4,84,39,45
2019,157386,50,0,3,0,3
2019,157401,0,0,453,236,217
2019,157401,10,0,453,236,217
2019,157401,10,1,93,60,33
2019,157401,10,2,103,62,41
2019,157401,10,3,146,67,79
2019,157401,10,4,106,45,61
2019,157401,10,5,4,1,3
2019,157401,10,6,1,1,0
2019,157401,20,0,197,126,71
2019,157401,20,1,89,58,31
2019,157401,20,2,98,60,38
2019,157401,20,3,10,8,2
2019,157401,30,0,128,56,72
2019,157401,30,1,1,0,1
2019,157401,30,2,4,2,2
2019,157401,30,3,122,53,69
2019,157401,30,4,1,1,0
2019,157401,40,0,128,54,74
2019,157401,40,1,3,2,1
2019,157401,40,2,1,0,1
2019,157401,40,3,14,6,8
2019,157401,40,4,105,44,61
2019,157401,40,5,4,1,3
2019,157401,40,6,1,1,0
2019,157401,41,0,5,2,3
2019,157401,41,1,3,2,1
2019,157401,41,2,1,0,1
2019,157401,41,3,1,0,1
2019,157401,42,0,123,52,71
2019,157401,42,3,13,6,7
2019,157401,42,4,105,44,61
2019,157401,42,5,4,1,3
2019,157401,42,6,1,1,0
2019,157401,44,0,5,2,3
2019,157401,44,1,3,2,1
2019,157401,44,2,1,0,1
2019,157401,44,3,1,0,1
2019,157438,0,0,75,42,33
2019,157438,10,0,75,42,33
2019,157438,10,1,5,4,1
2019,157438,10,2,21,10,11
2019,157438,10,3,16,10,6
2019,157438,10,4,31,17,14
2019,157438,10,5,2,1,1
2019,157438,40,0,75,42,33
2019,157438,40,1,5,4,1
2019,157438,40,2,21,10,11
2019,157438,40,3,16,10,6
2019,157438,40,4,31,17,14
2019,157438,40,5,2,1,1
2019,157438,42,0,17,8,9
2019,157438,42,2,6,3,3
2019,157438,42,3,3,1,2
2019,157438,42,4,8,4,4
2019,157438,43,0,58,34,24
2019,157438,43,1,5,4,1
2019,157438,43,2,15,7,8
2019,157438,43,3,13,9,4
2019,157438,43,4,23,13,10
2019,157438,43,5,2,1,1
2019,157447,0,0,602,275,327
2019,157447,10,0,602,275,327
2019,157447,10,1,123,77,46
2019,157447,10,2,141,65,76
2019,157447,10,3,96,37,59
2019,157447,10,5,242,96,146
2019,157447,20,0,264,142,122
2019,157447,20,1,123,77,46
2019,157447,20,2,141,65,76
2019,157447,30,0,91,33,58
2019,157447,30,3,91,33,58
2019,157447,40,0,247,100,147
2019,157447,40,3,5,4,1
2019,157447,40,5,242,96,146
2019,157447,42,0,244,97,147
2019,157447,42,3,5,4,1
2019,157447,42,5,239,93,146
2019,157447,43,0,3,3,0
2019,157447,43,5,3,3,0
2019,157483,0,0,115,42,73
2019,157483,10,0,115,42,73
2019,157483,10,1,41,11,30
2019,157483,10,2,23,15,8
2019,157483,10,3,13,6,7
2019,157483,10,4,38,10,28
2019,157483,20,0,26,8,18
2019,157483,20,1,25,8,17
2019,157483,20,2,1,0,1
2019,157483,40,0,89,34,55
2019,157483,40,1,16,3,13
2019,157483,40,2,22,15,7
2019,157483,40,3,13,6,7
2019,157483,40,4,38,10,28
2019,157483,42,0,25,16,9
2019,157483,42,2,12,8,4
2019,157483,42,3,6,3,3
2019,157483,42,4,7,5,2
2019,157483,43,0,64,18,46
2019,157483,43,1,16,3,13
2019,157483,43,2,10,7,3
2019,157483,43,3,7,3,4
2019,157483,43,4,31,5,26
2019,157535,0,0,98,49,49
2019,157535,10,0,98,49,49
2019,157535,10,1,28,17,11
2019,157535,10,2,34,17,17
2019,157535,10,3,31,13,18
2019,157535,10,4,5,2,3
2019,157535,40,0,98,49,49
2019,157535,40,1,28,17,11
2019,157535,40,2,34,17,17
2019,157535,40,3,31,13,18
2019,157535,40,4,5,2,3
2019,157535,41,0,39,21,18
2019,157535,41,1,20,12,8
2019,157535,41,2,19,9,10
2019,157535,42,0,59,28,31
2019,157535,42,1,8,5,3
2019,157535,42,2,15,8,7
2019,157535,42,3,31,13,18
2019,157535,42,4,5,2,3
2019,157535,44,0,39,21,18
2019,157535,44,1,20,12,8
2019,157535,44,2,19,9,10
2019,157553,0,0,83,36,47
2019,157553,10,0,83,36,47
2019,157553,10,1,40,15,25
2019,157553,10,2,25,12,13
2019,157553,10,3,3,3,0
2019,157553,10,4,13,4,9
2019,157553,10,5,2,2,0
2019,157553,20,0,21,10,11
2019,157553,20,1,19,8,11
2019,157553,20,2,2,2,0
2019,157553,30,0,1,1,0
2019,157553,30,3,1,1,0
2019,157553,40,0,61,25,36
2019,157553,40,1,21,7,14
2019,157553,40,2,23,10,13
2019,157553,40,3,2,2,0
2019,157553,40,4,13,4,9
2019,157553,40,5,2,2,0
2019,157553,42,0,7,1,6
2019,157553,42,1,3,1,2
2019,157553,42,2,3,0,3
2019,157553,42,4,1,0,1
2019,157553,43,0,54,24,30
2019,157553,43,1,18,6,12
2019,157553,43,2,20,10,10
2019,157553,43,3,2,2,0
2019,157553,43,4,12,4,8
2019,157553,43,5,2,2,0
2019,157711,0,0,134,56,78
2019,157711,10,0,134,56,78
2019,157711,10,1,40,17,23
2019,157711,10,2,51,23,28
2019,157711,10,3,13,5,8
2019,157711,10,4,30,11,19
2019,157711,20,0,39,17,22
2019,157711,20,1,29,11,18
2019,157711,20,2,10,6,4
2019,157711,40,0,95,39,56
2019,157711,40,1,11,6,5
2019,157711,40,2,41,17,24
2019,157711,40,3,13,5,8
2019,157711,40,4,30,11,19
2019,157711,42,0,7,2,5
2019,157711,42,2,2,0,2
2019,157711,42,3,3,1,2
2019,157711,42,4,2,1,1
2019,157711,43,0,88,37,51
2019,157711,43,1,11,6,5
2019,157711,43,2,39,17,22
2019,157711,43,3,10,4,6
2019,157711,43,4,28,10,18
2019,157739,0,0,71,31,40
2019,157739,10,0,71,31,40
2019,157739,10,1,36,23,13
2019,157739,10,2,19,6,13
2019,157739,10,3,7,2,5
2019,157739,10,4,9,0,9
2019,157739,20,0,30,19,11
2019,157739,20,1,21,15,6
2019,157739,20,2,9,4,5
2019,157739,30,0,3,1,2
2019,157739,30,2,1,0,1
2019,157739,30,3,2,1,1
2019,157739,40,0,38,11,27
2019,157739,40,1,15,8,7
2019,157739,40,2,9,2,7
2019,157739,40,3,5,1,4
2019,157739,40,4,9,0,9
2019,157739,42,0,6,3,3
2019,157739,42,1,5,3,2
2019,157739,42,4,1,0,1
2019,157739,43,0,32,8,24
2019,157739,43,1,10,5,5
2019,157739,43,2,9,2,7
2019,157739,43,3,5,1,4
2019,157739,43,4,8,0,8
2019,157748,0,0,53,51,2
2019,157748,10,0,53,51,2
2019,157748,10,1,27,26,1
2019,157748,10,2,16,15,1
2019,157748,10,3,10,10,0
2019,157748,40,0,53,51,2
2019,157748,40,1,27,26,1
2019,157748,40,2,16,15,1
2019,157748,40,3,10,10,0
2019,157748,41,0,53,51,2
2019,157748,41,1,27,26,1
2019,157748,41,2,16,15,1
2019,157748,41,3,10,10,0
2019,157748,44,0,53,51,2
2019,157748,44,1,27,26,1
2019,157748,44,2,16,15,1
2019,157748,44,3,10,10,0
2019,157757,0,0,93,37,56
2019,157757,10,0,93,37,56
2019,157757,10,1,32,14,18
2019,157757,10,2,18,5,13
2019,157757,10,3,39,16,23
2019,157757,10,4,1,1,0
2019,157757,10,5,3,1,2
2019,157757,20,0,39,18,21
2019,157757,20,1,25,13,12
2019,157757,20,2,10,3,7
2019,157757,20,3,3,2,1
2019,157757,20,5,1,0,1
2019,157757,30,0,23,7,16
2019,157757,30,1,4,0,4
2019,157757,30,2,7,2,5
2019,157757,30,3,11,4,7
2019,157757,30,5,1,1,0
2019,157757,40,0,31,12,19
2019,157757,40,1,3,1,2
2019,157757,40,2,1,0,1
2019,157757,40,3,25,10,15
2019,157757,40,4,1,1,0
2019,157757,40,5,1,0,1
2019,157757,42,0,8,1,7
2019,157757,42,2,1,0,1
2019,157757,42,3,7,1,6
2019,157757,43,0,23,11,12
2019,157757,43,1,3,1,2
2019,157757,43,3,18,9,9
2019,157757,43,4,1,1,0
2019,157757,43,5,1,0,1
2019,157793,0,0,159,62,97
2019,157793,10,0,159,62,97
2019,157793,10,1,42,28,14
2019,157793,10,2,29,11,18
2019,157793,10,3,34,9,25
2019,157793,10,4,54,14,40
2019,157793,40,0,159,62,97
2019,157793,40,1,42,28,14
2019,157793,40,2,29,11,18
2019,157793,40,3,34,9,25
2019,157793,40,4,54,14,40
2019,157793,42,0,159,62,97
2019,157793,42,1,42,28,14
2019,157793,42,2,29,11,18
2019,157793,42,3,34,9,25
2019,157793,42,4,54,14,40
2019,157809,0,0,87,44,43
2019,157809,10,0,87,44,43
2019,157809,10,1,32,20,12
2019,157809,10,2,23,9,14
2019,157809,10,3,27,12,15
2019,157809,10,4,5,3,2
2019,157809,20,0,49,27,22
2019,157809,20,1,31,19,12
2019,157809,20,2,18,8,10
2019,157809,30,0,11,3,8
2019,157809,30,2,4,0,4
2019,157809,30,3,7,3,4
2019,157809,40,0,27,14,13
2019,157809,40,1,1,1,0
2019,157809,40,2,1,1,0
2019,157809,40,3,20,9,11
2019,157809,40,4,5,3,2
2019,157809,41,0,2,2,0
2019,157809,41,1,1,1,0
2019,157809,41,2,1,1,0
2019,157809,42,0,25,12,13
2019,157809,42,3,20,9,11
2019,157809,42,4,5,3,2
2019,157809,44,0,2,2,0
2019,157809,44,1,1,1,0
2019,157809,44,2,1,1,0
2019,157818,0,0,83,43,40
2019,157818,10,0,83,43,40
2019,157818,10,1,31,22,9
2019,157818,10,2,32,12,20
2019,157818,10,3,14,5,9
2019,157818,10,4,6,4,2
2019,157818,20,0,62,34,28
2019,157818,20,1,31,22,9
2019,157818,20,2,31,12,19
2019,157818,30,0,11,4,7
2019,157818,30,2,1,0,1
2019,157818,30,3,10,4,6
2019,157818,40,0,10,5,5
2019,157818,40,3,4,1,3
2019,157818,40,4,6,4,2
2019,157818,41,0,8,3,5
2019,157818,41,3,4,1,3
2019,157818,41,4,4,2,2
2019,157818,42,0,2,2,0
2019,157818,42,4,2,2,0
2019,157818,44,0,8,3,5
2019,157818,44,3,4,1,3
2019,157818,44,4,4,2,2
2019,157863,0,0,51,30,21
2019,157863,10,0,51,30,21
2019,157863,10,1,14,10,4
2019,157863,10,2,15,11,4
2019,157863,10,3,15,6,9
2019,157863,10,4,7,3,4
2019,157863,20,0,18,14,4
2019,157863,20,1,13,10,3
2019,157863,20,2,5,4,1
2019,157863,30,0,17,7,10
2019,157863,30,2,5,3,2
2019,157863,30,3,5,1,4
2019,157863,30,4,7,3,4
2019,157863,40,0,16,9,7
2019,157863,40,1,1,0,1
2019,157863,40,2,5,4,1
2019,157863,40,3,10,5,5
2019,157863,42,0,2,1,1
2019,157863,42,2,1,1,0
2019,157863,42,3,1,0,1
2019,157863,43,0,14,8,6
2019,157863,43,1,1,0,1
2019,157863,43,2,4,3,1
2019,157863,43,3,9,5,4
2019,157951,0,0,681,332,349
2019,157951,10,0,681,332,349
2019,157951,10,1,193,121,72
2019,157951,10,2,216,99,117
2019,157951,10,3,134,62,72
2019,157951,10,4,121,40,81
2019,157951,10,5,1,1,0
2019,157951,10,6,16,9,7
2019,157951,20,0,405,222,183
2019,157951,20,1,193,121,72
2019,157951,20,2,205,98,107
2019,157951,20,3,7,3,4
2019,157951,30,0,126,55,71
2019,157951,30,2,4,0,4
2019,157951,30,3,122,55,67
2019,157951,40,0,150,55,95
2019,157951,40,2,7,1,6
2019,157951,40,3,5,4,1
2019,157951,40,4,121,40,81
2019,157951,40,5,1,1,0
2019,157951,40,6,16,9,7
2019,157951,41,0,109,36,73
2019,157951,41,2,6,1,5
2019,157951,41,3,3,3,0
2019,157951,41,4,96,30,66
2019,157951,41,5,1,1,0
2019,157951,41,6,3,1,2
2019,157951,42,0,41,19,22
2019,157951,42,2,1,0,1
2019,157951,42,3,2,1,1
2019,157951,42,4,25,10,15
2019,157951,42,6,13,8,5
2019,157951,44,0,109,36,73
2019,157951,44,2,6,1,5
2019,157951,44,3,3,3,0
2019,157951,44,4,96,30,66
2019,157951,44,5,1,1,0
2019,157951,44,6,3,1,2
2019,158088,0,0,77,28,49
2019,158088,10,0,77,28,49
2019,158088,10,1,2,1,1
2019,158088,10,4,16,6,10
2019,158088,10,6,59,21,38
2019,158088,20,0,4,3,1
2019,158088,20,1,1,0,1
2019,158088,20,6,3,3,0
2019,158088,40,0,73,25,48
2019,158088,40,1,1,1,0
2019,158088,40,4,16,6,10
2019,158088,40,6,56,18,38
2019,158088,42,0,67,23,44
2019,158088,42,1,1,1,0
2019,158088,42,4,16,6,10
2019,158088,42,6,50,16,34
2019,158088,43,0,6,2,4
2019,158088,43,6,6,2,4
2019,158431,0,0,130,44,86
2019,158431,10,0,130,44,86
2019,158431,10,1,33,9,24
2019,158431,10,2,12,4,8
2019,158431,10,3,32,10,22
2019,158431,10,4,47,20,27
2019,158431,10,6,6,1,5
2019,158431,20,0,18,7,11
2019,158431,20,1,17,6,11
2019,158431,20,2,1,1,0
2019,158431,30,0,1,0,1
2019,158431,30,2,1,0,1
2019,158431,40,0,111,37,74
2019,158431,40,1,16,3,13
2019,158431,40,2,10,3,7
2019,158431,40,3,32,10,22
2019,158431,40,4,47,20,27
2019,158431,40,6,6,1,5
2019,158431,42,0,111,37,74
2019,158431,42,1,16,3,13
2019,158431,42,2,10,3,7
2019,158431,42,3,32,10,22
2019,158431,42,4,47,20,27
2019,158431,42,6,6,1,5
2019,158477,0,0,56,35,21
2019,158477,10,0,56,35,21
2019,158477,10,1,20,13,7
2019,158477,10,2,10,5,5
2019,158477,10,3,25,16,9
2019,158477,10,4,1,1,0
2019,158477,20,0,31,19,12
2019,158477,20,1,20,13,7
2019,158477,20,2,10,5,5
2019,158477,20,3,1,1,0
2019,158477,30,0,19,12,7
2019,158477,30,3,19,12,7
2019,158477,40,0,6,4,2
2019,158477,40,3,5,3,2
2019,158477,40,4,1,1,0
2019,158477,41,0,1,1,0
2019,158477,41,3,1,1,0
2019,158477,42,0,5,3,2
2019,158477,42,3,4,2,2
2019,158477,42,4,1,1,0
2019,158477,44,0,1,1,0
2019,158477,44,3,1,1,0
2019,158662,0,0,332,116,216
2019,158662,10,0,332,116,216
2019,158662,10,1,87,24,63
2019,158662,10,2,68,25,43
2019,158662,10,3,79,32,47
2019,158662,10,4,93,35,58
2019,158662,10,6,5,0,5
2019,158662,20,0,18,4,14
2019,158662,20,1,13,2,11
2019,158662,20,2,3,2,1
2019,158662,20,3,1,0,1
2019,158662,20,6,1,0,1
2019,158662,30,0,11,3,8
2019,158662,30,1,10,3,7
2019,158662,30,2,1,0,1
2019,158662,40,0,303,109,194
2019,158662,40,1,64,19,45
2019,158662,40,2,64,23,41
2019,158662,40,3,78,32,46
2019,158662,40,4,93,35,58
2019,158662,40,6,4,0,4
2019,158662,42,0,303,109,194
2019,158662,42,1,64,19,45
2019,158662,42,2,64,23,41
2019,158662,42,3,78,32,46
2019,158662,42,4,93,35,58
2019,158662,42,6,4,0,4
2019,158802,0,0,71,33,38
2019,158802,10,0,71,33,38
2019,158802,10,1,11,7,4
2019,158802,10,2,18,12,6
2019,158802,10,3,27,10,17
2019,158802,10,4,15,4,11
2019,158802,20,0,26,17,9
2019,158802,20,1,10,6,4
2019,158802,20,2,16,11,5
2019,158802,30,0,11,5,6
2019,158802,30,1,1,1,0
2019,158802,30,2,1,0,1
2019,158802,30,3,9,4,5
2019,158802,40,0,34,11,23
2019,158802,40,2,1,1,0
2019,158802,40,3,18,6,12
2019,158802,40,4,15,4,11
2019,158802,42,0,34,11,23
2019,158802,42,2,1,1,0
2019,158802,42,3,18,6,12
2019,158802,42,4,15,4,11
2019,158884,0,0,38,21,17
2019,158884,10,0,38,21,17
2019,158884,10,1,8,4,4
2019,158884,10,2,2,1,1
2019,158884,10,3,9,6,3
2019,158884,10,4,17,8,9
2019,158884,10,6,2,2,0
2019,158884,40,0,38,21,17
2019,158884,40,1,8,4,4
2019,158884,40,2,2,1,1
2019,158884,40,3,9,6,3
2019,158884,40,4,17,8,9
2019,158884,40,6,2,2,0
2019,158884,42,0,36,19,17
2019,158884,42,1,8,4,4
2019,158884,42,2,2,1,1
2019,158884,42,3,9,6,3
2019,158884,42,4,17,8,9
2019,158884,43,0,2,2,0
2019,158884,43,6,2,2,0
2019,159009,0,0,193,98,95
2019,159009,10,0,156,80,76
2019,159009,10,1,41,29,12
2019,159009,10,2,47,24,23
2019,159009,10,3,50,19,31
2019,159009,10,4,8,3,5
2019,159009,10,5,10,5,5
2019,159009,20,0,105,60,45
2019,159009,20,1,41,29,12
2019,159009,20,2,39,21,18
2019,159009,20,3,24,10,14
2019,159009,20,4,1,0,1
2019,159009,30,0,32,12,20
2019,159009,30,2,8,3,5
2019,159009,30,3,22,7,15
2019,159009,30,4,1,1,0
2019,159009,30,5,1,1,0
2019,159009,40,0,19,8,11
2019,159009,40,3,4,2,2
2019,159009,40,4,6,2,4
2019,159009,40,5,9,4,5
2019,159009,42,0,19,8,11
2019,159009,42,3,4,2,2
2019,159009,42,4,6,2,4
2019,159009,42,5,9,4,5
2019,159009,50,0,37,18,19
2019,159197,0,0,23,18,5
2019,159197,10,0,23,18,5
2019,159197,10,4,23,18,5
2019,159197,40,0,23,18,5
2019,159197,40,4,23,18,5
2019,159197,41,0,23,18,5
2019,159197,41,4,23,18,5
2019,159197,45,0,23,18,5
2019,159197,45,4,23,18,5
2019,159373,0,0,752,395,357
2019,159373,10,0,752,395,357
2019,159373,10,1,106,78,28
2019,159373,10,2,234,141,93
2019,159373,10,3,335,156,179
2019,159373,10,4,77,20,57
2019,159373,20,0,100,70,30
2019,159373,20,1,58,43,15
2019,159373,20,2,42,27,15
2019,159373,30,0,37,22,15
2019,159373,30,1,9,8,1
2019,159373,30,2,8,4,4
2019,159373,30,3,20,10,10
2019,159373,40,0,615,303,312
2019,159373,40,1,39,27,12
2019,159373,40,2,184,110,74
2019,159373,40,3,315,146,169
2019,159373,40,4,77,20,57
2019,159373,42,0,615,303,312
2019,159373,42,1,39,27,12
2019,159373,42,2,184,110,74
2019,159373,42,3,315,146,169
2019,159373,42,4,77,20,57
2019,159382,0,0,85,40,45
2019,159382,10,0,85,40,45
2019,159382,10,1,21,14,7
2019,159382,10,2,21,8,13
2019,159382,10,3,28,9,19
2019,159382,10,4,15,9,6
2019,159382,20,0,44,22,22
2019,159382,20,1,21,14,7
2019,159382,20,2,20,7,13
2019,159382,20,3,2,0,2
2019,159382,20,4,1,1,0
2019,159382,30,0,27,10,17
2019,159382,30,2,1,1,0
2019,159382,30,3,26,9,17
2019,159382,40,0,14,8,6
2019,159382,40,4,14,8,6
2019,159382,42,0,14,8,6
2019,159382,42,4,14,8,6
2019,159391,0,0,1344,826,518
2019,159391,10,0,1344,826,518
2019,159391,10,1,434,335,99
2019,159391,10,2,290,180,110
2019,159391,10,3,317,172,145
2019,159391,10,4,269,113,156
2019,159391,10,5,34,26,8
2019,159391,20,0,698,501,197
2019,159391,20,1,426,328,98
2019,159391,20,2,271,173,98
2019,159391,20,3,1,0,1
2019,159391,30,0,277,162,115
2019,159391,30,2,3,2,1
2019,159391,30,3,274,160,114
2019,159391,40,0,369,163,206
2019,159391,40,1,8,7,1
2019,159391,40,2,16,5,11
2019,159391,40,3,42,12,30
2019,159391,40,4,269,113,156
2019,159391,40,5,34,26,8
2019,159391,42,0,369,163,206
2019,159391,42,1,8,7,1
2019,159391,42,2,16,5,11
2019,159391,42,3,42,12,30
2019,159391,42,4,269,113,156
2019,159391,42,5,34,26,8
2019,159407,0,0,72,28,44
2019,159407,10,0,72,28,44
2019,159407,10,1,12,8,4
2019,159407,10,2,9,5,4
2019,159407,10,3,11,4,7
2019,159407,10,4,40,11,29
2019,159407,20,0,21,13,8
2019,159407,20,1,12,8,4
2019,159407,20,2,8,5,3
2019,159407,20,3,1,0,1
2019,159407,30,0,11,4,7
2019,159407,30,2,1,0,1
2019,159407,30,3,10,4,6
2019,159407,40,0,40,11,29
2019,159407,40,4,40,11,29
2019,159407,42,0,40,11,29
2019,159407,42,4,40,11,29
2019,159416,0,0,134,76,58
2019,159416,10,0,134,76,58
2019,159416,10,1,37,24,13
2019,159416,10,2,32,15,17
2019,159416,10,3,36,23,13
2019,159416,10,4,15,5,10
2019,159416,10,5,14,9,5
2019,159416,20,0,60,37,23
2019,159416,20,1,35,23,12
2019,159416,20,2,24,13,11
2019,159416,20,3,1,1,0
2019,159416,30,0,37,21,16
2019,159416,30,2,5,1,4
2019,159416,30,3,32,20,12
2019,159416,40,0,37,18,19
2019,159416,40,1,2,1,1
2019,159416,40,2,3,1,2
2019,159416,40,3,3,2,1
2019,159416,40,4,15,5,10
2019,159416,40,5,14,9,5
2019,159416,41,0,5,2,3
2019,159416,41,1,1,0,1
2019,159416,41,2,3,1,2
2019,159416,41,5,1,1,0
2019,159416,42,0,32,16,16
2019,159416,42,1,1,1,0
2019,159416,42,3,3,2,1
2019,159416,42,4,15,5,10
2019,159416,42,5,13,8,5
2019,159416,44,0,5,2,3
2019,159416,44,1,1,0,1
2019,159416,44,2,3,1,2
2019,159416,44,5,1,1,0
2019,159568,0,0,73,30,43
2019,159568,10,0,73,30,43
2019,159568,10,1,16,9,7
2019,159568,10,2,25,7,18
2019,159568,10,3,31,14,17
2019,159568,10,4,1,0,1
2019,159568,20,0,37,13,24
2019,159568,20,1,14,7,7
2019,159568,20,2,19,4,15
2019,159568,20,3,4,2,2
2019,159568,30,0,32,16,16
2019,159568,30,1,1,1,0
2019,159568,30,2,5,3,2
2019,159568,30,3,26,12,14
2019,159568,40,0,4,1,3
2019,159568,40,1,1,1,0
2019,159568,40,2,1,0,1
2019,159568,40,3,1,0,1
2019,159568,40,4,1,0,1
2019,159568,42,0,4,1,3
2019,159568,42,1,1,1,0
2019,159568,42,2,1,0,1
2019,159568,42,3,1,0,1
2019,159568,42,4,1,0,1
2019,159647,0,0,396,236,160
2019,159647,10,0,387,231,156
2019,159647,10,1,66,43,23
2019,159647,10,2,110,74,36
2019,159647,10,3,101,53,48
2019,159647,10,4,69,28,41
2019,159647,10,5,41,33,8
2019,159647,20,0,173,114,59
2019,159647,20,1,63,41,22
2019,159647,20,2,105,69,36
2019,159647,20,3,5,4,1
2019,159647,30,0,98,52,46
2019,159647,30,1,2,1,1
2019,159647,30,2,5,5,0
2019,159647,30,3,91,46,45
2019,159647,40,0,116,65,51
2019,159647,40,1,1,1,0
2019,159647,40,3,5,3,2
2019,159647,40,4,69,28,41
2019,159647,40,5,41,33,8
2019,159647,42,0,113,64,49
2019,159647,42,1,1,1,0
2019,159647,42,3,5,3,2
2019,159647,42,4,66,27,39
2019,159647,42,5,41,33,8
2019,159647,43,0,3,1,2
2019,159647,43,4,3,1,2
2019,159647,50,0,9,5,4
2019,159656,0,0,233,127,106
2019,159656,10,0,233,127,106
2019,159656,10,1,68,42,26
2019,159656,10,2,62,42,20
2019,159656,10,3,27,10,17
2019,159656,10,5,76,33,43
2019,159656,20,0,130,83,47
2019,159656,20,1,68,42,26
2019,159656,20,2,60,41,19
2019,159656,20,3,2,0,2
2019,159656,30,0,27,11,16
2019,159656,30,2,2,1,1
2019,159656,30,3,25,10,15
2019,159656,40,0,76,33,43
2019,159656,40,5,76,33,43
2019,159656,41,0,5,1,4
2019,159656,41,5,5,1,4
2019,159656,42,0,71,32,39
2019,159656,42,5,71,32,39
2019,159656,44,0,5,1,4
2019,159656,44,5,5,1,4
2019,159717,0,0,261,126,135
2019,159717,10,0,261,126,135
2019,159717,10,1,54,36,18
2019,159717,10,2,43,23,20
2019,159717,10,3,112,49,63
2019,159717,10,4,52,18,34
2019,159717,20,0,123,72,51
2019,159717,20,1,54,36,18
2019,159717,20,2,37,20,17
2019,159717,20,3,32,16,16
2019,159717,30,0,74,31,43
2019,159717,30,2,6,3,3
2019,159717,30,3,68,28,40
2019,159717,40,0,64,23,41
2019,159717,40,3,12,5,7
2019,159717,40,4,52,18,34
2019,159717,42,0,64,23,41
2019,159717,42,3,12,5,7
2019,159717,42,4,52,18,34
2019,159939,0,0,281,173,108
2019,159939,10,0,281,173,108
2019,159939,10,1,85,62,23
2019,159939,10,2,69,46,23
2019,159939,10,3,65,43,22
2019,159939,10,4,62,22,40
2019,159939,20,0,150,104,46
2019,159939,20,1,81,58,23
2019,159939,20,2,68,45,23
2019,159939,20,3,1,1,0
2019,159939,30,0,64,44,20
2019,159939,30,1,2,2,0
2019,159939,30,3,62,42,20
2019,159939,40,0,67,25,42
2019,159939,40,1,2,2,0
2019,159939,40,2,1,1,0
2019,159939,40,3,2,0,2
2019,159939,40,4,62,22,40
2019,159939,42,0,64,24,40
2019,159939,42,1,2,2,0
2019,159939,42,2,1,1,0
2019,159939,42,3,2,0,2
2019,159939,42,4,59,21,38
2019,159939,43,0,3,1,2
2019,159939,43,4,3,1,2
2019,159948,0,0,52,44,8
2019,159948,10,0,52,44,8
2019,159948,10,1,38,32,6
2019,159948,10,2,10,10,0
2019,159948,10,3,4,2,2
2019,159948,20,0,43,37,6
2019,159948,20,1,36,30,6
2019,159948,20,2,7,7,0
2019,159948,30,0,9,7,2
2019,159948,30,1,2,2,0
2019,159948,30,2,3,3,0
2019,159948,30,3,4,2,2
2019,159966,0,0,257,112,145
2019,159966,10,0,256,111,145
2019,159966,10,1,34,22,12
2019,159966,10,2,56,28,28
2019,159966,10,3,83,39,44
2019,159966,10,4,83,22,61
2019,159966,20,0,103,55,48
2019,159966,20,1,34,22,12
2019,159966,20,2,56,28,28
2019,159966,20,3,13,5,8
2019,159966,30,0,70,34,36
2019,159966,30,3,70,34,36
2019,159966,40,0,83,22,61
2019,159966,40,4,83,22,61
2019,159966,42,0,83,22,61
2019,159966,42,4,83,22,61
2019,159966,50,0,1,1,0
2019,159993,0,0,321,133,188
2019,159993,10,0,321,133,188
2019,159993,10,1,66,40,26
2019,159993,10,2,77,34,43
2019,159993,10,3,113,38,75
2019,159993,10,4,65,21,44
2019,159993,20,0,144,72,72
2019,159993,20,1,59,38,21
2019,159993,20,2,71,33,38
2019,159993,20,3,14,1,13
2019,159993,30,0,86,33,53
2019,159993,30,2,2,1,1
2019,159993,30,3,84,32,52
2019,159993,40,0,91,28,63
2019,159993,40,1,7,2,5
2019,159993,40,2,4,0,4
2019,159993,40,3,15,5,10
2019,159993,40,4,65,21,44
2019,159993,42,0,23,8,15
2019,159993,42,1,7,2,5
2019,159993,42,2,3,0,3
2019,159993,42,3,10,3,7
2019,159993,42,4,3,3,0
2019,159993,43,0,68,20,48
2019,159993,43,2,1,0,1
2019,159993,43,3,5,2,3
2019,159993,43,4,62,18,44
2019,160010,0,0,34,19,15
2019,160010,10,0,34,19,15
2019,160010,10,1,2,1,1
2019,160010,10,2,1,1,0
2019,160010,10,4,31,17,14
2019,160010,20,0,1,1,0
2019,160010,20,1,1,1,0
2019,160010,40,0,33,18,15
2019,160010,40,1,1,0,1
2019,160010,40,2,1,1,0
2019,160010,40,4,31,17,14
2019,160010,42,0,33,18,15
2019,160010,42,1,1,0,1
2019,160010,42,2,1,1,0
2019,160010,42,4,31,17,14
2019,160038,0,0,322,128,194
2019,160038,10,0,322,128,194
2019,160038,10,1,59,28,31
2019,160038,10,2,73,41,32
2019,160038,10,3,139,48,91
2019,160038,10,4,51,11,40
2019,160038,20,0,145,68,77
2019,160038,20,1,58,28,30
2019,160038,20,2,61,34,27
2019,160038,20,3,26,6,20
2019,160038,30,0,110,47,63
2019,160038,30,1,1,0,1
2019,160038,30,2,11,7,4
2019,160038,30,3,97,40,57
2019,160038,30,4,1,0,1
2019,160038,40,0,67,13,54
2019,160038,40,2,1,0,1
2019,160038,40,3,16,2,14
2019,160038,40,4,50,11,39
2019,160038,42,0,15,2,13
2019,160038,42,3,6,1,5
2019,160038,42,4,9,1,8
2019,160038,43,0,52,11,41
2019,160038,43,2,1,0,1
2019,160038,43,3,10,1,9
2019,160038,43,4,41,10,31
2019,160065,0,0,69,26,43
2019,160065,10,0,69,26,43
2019,160065,10,1,19,9,10
2019,160065,10,2,18,7,11
2019,160065,10,3,31,9,22
2019,160065,10,4,1,1,0
2019,160065,40,0,69,26,43
2019,160065,40,1,19,9,10
2019,160065,40,2,18,7,11
2019,160065,40,3,31,9,22
2019,160065,40,4,1,1,0
2019,160065,41,0,61,22,39
2019,160065,41,1,18,8,10
2019,160065,41,2,18,7,11
2019,160065,41,3,25,7,18
2019,160065,42,0,8,4,4
2019,160065,42,1,1,1,0
2019,160065,42,3,6,2,4
2019,160065,42,4,1,1,0
2019,160065,44,0,61,22,39
2019,160065,44,1,18,8,10
2019,160065,44,2,18,7,11
2019,160065,44,3,25,7,18
2019,160074,0,0,90,27,63
2019,160074,10,0,90,27,63
2019,160074,10,1,7,3,4
2019,160074,10,2,24,9,15
2019,160074,10,3,49,14,35
2019,160074,10,4,10,1,9
2019,160074,40,0,90,27,63
2019,160074,40,1,7,3,4
2019,160074,40,2,24,9,15
2019,160074,40,3,49,14,35
2019,160074,40,4,10,1,9
2019,160074,42,0,90,27,63
2019,160074,42,1,7,3,4
2019,160074,42,2,24,9,15
2019,160074,42,3,49,14,35
2019,160074,42,4,10,1,9
2019,160409,0,0,28,22,6
2019,160409,10,0,26,20,6
2019,160409,10,1,26,20,6
2019,160409,40,0,26,20,6
2019,160409,40,1,26,20,6
2019,160409,42,0,21,18,3
2019,160409,42,1,21,18,3
2019,160409,43,0,5,2,3
2019,160409,43,1,5,2,3
2019,160409,50,0,2,2,0
2019,160481,0,0,56,21,35
2019,160481,10,0,56,21,35
2019,160481,10,1,1,0,1
2019,160481,10,2,2,0,2
2019,160481,10,3,8,4,4
2019,160481,10,4,43,17,26
2019,160481,10,5,2,0,2
2019,160481,20,0,2,2,0
2019,160481,20,4,2,2,0
2019,160481,40,0,54,19,35
2019,160481,40,1,1,0,1
2019,160481,40,2,2,0,2
2019,160481,40,3,8,4,4
2019,160481,40,4,41,15,26
2019,160481,40,5,2,0,2
2019,160481,41,0,1,0,1
2019,160481,41,4,1,0,1
2019,160481,42,0,53,19,34
2019,160481,42,1,1,0,1
2019,160481,42,2,2,0,2
2019,160481,42,3,8,4,4
2019,160481,42,4,40,15,25
2019,160481,42,5,2,0,2
2019,160481,44,0,1,0,1
2019,160481,44,4,1,0,1
2019,160524,0,0,22,5,17
2019,160524,50,0,22,5,17
2019,160579,0,0,98,48,50
2019,160579,10,0,98,48,50
2019,160579,10,1,6,2,4
2019,160579,10,2,4,3,1
2019,160579,10,3,21,7,14
2019,160579,10,4,67,36,31
2019,160579,20,0,5,3,2
2019,160579,20,1,1,0,1
2019,160579,20,2,2,2,0
2019,160579,20,4,2,1,1
2019,160579,40,0,93,45,48
2019,160579,40,1,5,2,3
2019,160579,40,2,2,1,1
2019,160579,40,3,21,7,14
2019,160579,40,4,65,35,30
2019,160579,42,0,93,45,48
2019,160579,42,1,5,2,3
2019,160579,42,2,2,1,1
2019,160579,42,3,21,7,14
2019,160579,42,4,65,35,30
2019,160612,0,0,507,222,285
2019,160612,10,0,507,222,285
2019,160612,10,1,97,71,26
2019,160612,10,2,91,43,48
2019,160612,10,3,69,30,39
2019,160612,10,4,250,78,172
2019,160612,20,0,191,115,76
2019,160612,20,1,97,71,26
2019,160612,20,2,89,42,47
2019,160612,20,3,5,2,3
2019,160612,30,0,62,26,36
2019,160612,30,2,2,1,1
2019,160612,30,3,60,25,35
2019,160612,40,0,254,81,173
2019,160612,40,3,4,3,1
2019,160612,40,4,250,78,172
2019,160612,42,0,251,80,171
2019,160612,42,3,4,3,1
2019,160612,42,4,247,77,170
2019,160612,43,0,3,1,2
2019,160612,43,4,3,1,2
2019,160621,0,0,309,152,157
2019,160621,10,0,220,113,107
2019,160621,10,1,76,52,24
2019,160621,10,2,52,29,23
2019,160621,10,3,88,31,57
2019,160621,10,4,4,1,3
2019,160621,20,0,105,68,37
2019,160621,20,1,70,49,21
2019,160621,20,2,26,17,9
2019,160621,20,3,8,2,6
2019,160621,20,4,1,0,1
2019,160621,30,0,72,25,47
2019,160621,30,1,4,1,3
2019,160621,30,2,16,5,11
2019,160621,30,3,51,19,32
2019,160621,30,4,1,0,1
2019,160621,40,0,43,20,23
2019,160621,40,1,2,2,0
2019,160621,40,2,10,7,3
2019,160621,40,3,29,10,19
2019,160621,40,4,2,1,1
2019,160621,42,0,42,19,23
2019,160621,42,1,2,2,0
2019,160621,42,2,10,7,3
2019,160621,42,3,29,10,19
2019,160621,42,4,1,0,1
2019,160621,43,0,1,1,0
2019,160621,43,4,1,1,0
2019,160621,50,0,89,39,50
2019,160630,0,0,73,46,27
2019,160630,10,0,73,46,27
2019,160630,10,1,14,10,4
2019,160630,10,2,19,15,4
2019,160630,10,3,40,21,19
2019,160630,20,0,41,31,10
2019,160630,20,1,14,10,4
2019,160630,20,2,19,15,4
2019,160630,20,3,8,6,2
2019,160630,30,0,31,15,16
2019,160630,30,3,31,15,16
2019,160630,40,0,1,0,1
2019,160630,40,3,1,0,1
2019,160630,41,0,1,0,1
2019,160630,41,3,1,0,1
2019,160630,44,0,1,0,1
2019,160630,44,3,1,0,1
2019,160649,0,0,75,23,52
2019,160649,10,0,69,21,48
2019,160649,10,1,3,2,1
2019,160649,10,2,17,4,13
2019,160649,10,3,20,5,15
2019,160649,10,4,29,10,19
2019,160649,20,0,16,6,10
2019,160649,20,1,3,2,1
2019,160649,20,2,11,4,7
2019,160649,20,3,2,0,2
2019,160649,30,0,23,5,18
2019,160649,30,2,3,0,3
2019,160649,30,3,7,1,6
2019,160649,30,4,13,4,9
2019,160649,40,0,30,10,20
2019,160649,40,2,3,0,3
2019,160649,40,3,11,4,7
2019,160649,40,4,16,6,10
2019,160649,42,0,7,1,6
2019,160649,42,2,1,0,1
2019,160649,42,3,3,0,3
2019,160649,42,4,3,1,2
2019,160649,43,0,23,9,14
2019,160649,43,2,2,0,2
2019,160649,43,3,8,4,4
2019,160649,43,4,13,5,8
2019,160649,50,0,6,2,4
2019,160658,0,0,647,361,286
2019,160658,10,0,647,361,286
2019,160658,10,1,139,111,28
2019,160658,10,2,127,72,55
2019,160658,10,3,171,96,75
2019,160658,10,4,172,68,104
2019,160658,10,5,1,1,0
2019,160658,10,6,37,13,24
2019,160658,20,0,238,171,67
2019,160658,20,1,133,105,28
2019,160658,20,2,94,59,35
2019,160658,20,3,10,6,4
2019,160658,20,6,1,1,0
2019,160658,30,0,167,93,74
2019,160658,30,1,4,4,0
2019,160658,30,2,32,13,19
2019,160658,30,3,130,76,54
2019,160658,30,4,1,0,1
2019,160658,40,0,242,97,145
2019,160658,40,1,2,2,0
2019,160658,40,2,1,0,1
2019,160658,40,3,31,14,17
2019,160658,40,4,171,68,103
2019,160658,40,5,1,1,0
2019,160658,40,6,36,12,24
2019,160658,41,0,242,97,145
2019,160658,41,1,2,2,0
2019,160658,41,2,1,0,1
2019,160658,41,3,31,14,17
2019,160658,41,4,171,68,103
2019,160658,41,5,1,1,0
2019,160658,41,6,36,12,24
2019,160658,44,0,242,97,145
2019,160658,44,1,2,2,0
2019,160658,44,2,1,0,1
2019,160658,44,3,31,14,17
2019,160658,44,4,171,68,103
2019,160658,44,5,1,1,0
2019,160658,44,6,36,12,24
2019,160667,0,0,87,34,53
2019,160667,10,0,87,34,53
2019,160667,10,2,4,1,3
2019,160667,10,3,7,1,6
2019,160667,10,4,75,32,43
2019,160667,10,6,1,0,1
2019,160667,40,0,87,34,53
2019,160667,40,2,4,1,3
2019,160667,40,3,7,1,6
2019,160667,40,4,75,32,43
2019,160667,40,6,1,0,1
2019,160667,42,0,87,34,53
2019,160667,42,2,4,1,3
2019,160667,42,3,7,1,6
2019,160667,42,4,75,32,43
2019,160667,42,6,1,0,1
2019,160755,0,0,1323,739,584
2019,160755,10,0,1323,739,584
2019,160755,10,1,312,239,73
2019,160755,10,2,284,158,126
2019,160755,10,3,466,238,228
2019,160755,10,4,65,18,47
2019,160755,10,5,196,86,110
2019,160755,20,0,467,318,149
2019,160755,20,1,273,205,68
2019,160755,20,2,194,113,81
2019,160755,30,0,168,93,75
2019,160755,30,1,6,5,1
2019,160755,30,2,8,4,4
2019,160755,30,3,154,84,70
2019,160755,40,0,688,328,360
2019,160755,40,1,33,29,4
2019,160755,40,2,82,41,41
2019,160755,40,3,312,154,158
2019,160755,40,4,65,18,47
2019,160755,40,5,196,86,110
2019,160755,42,0,688,328,360
2019,160755,42,1,33,29,4
2019,160755,42,2,82,41,41
2019,160755,42,3,312,154,158
2019,160755,42,4,65,18,47
2019,160755,42,5,196,86,110
2019,160904,0,0,233,124,109
2019,160904,10,0,233,124,109
2019,160904,10,1,48,30,18
2019,160904,10,2,72,41,31
2019,160904,10,3,100,47,53
2019,160904,10,4,6,2,4
2019,160904,10,5,7,4,3
2019,160904,20,0,122,76,46
2019,160904,20,1,42,27,15
2019,160904,20,2,59,36,23
2019,160904,20,3,21,13,8
2019,160904,30,0,46,23,23
2019,160904,30,1,2,0,2
2019,160904,30,2,5,3,2
2019,160904,30,3,38,20,18
2019,160904,30,5,1,0,1
2019,160904,40,0,65,25,40
2019,160904,40,1,4,3,1
2019,160904,40,2,8,2,6
2019,160904,40,3,41,14,27
2019,160904,40,4,6,2,4
2019,160904,40,5,6,4,2
2019,160904,42,0,65,25,40
2019,160904,42,1,4,3,1
2019,160904,42,2,8,2,6
2019,160904,42,3,41,14,27
2019,160904,42,4,6,2,4
2019,160904,42,5,6,4,2
2019,160959,0,0,26,15,11
2019,160959,10,0,26,15,11
2019,160959,10,1,26,15,11
2019,160959,40,0,26,15,11
2019,160959,40,1,26,15,11
2019,160959,41,0,26,15,11
2019,160959,41,1,26,15,11
2019,160959,44,0,26,15,11
2019,160959,44,1,26,15,11
2019,160977,0,0,185,91,94
2019,160977,10,0,185,91,94
2019,160977,10,1,54,27,27
2019,160977,10,2,51,22,29
2019,160977,10,3,60,29,31
2019,160977,10,4,1,0,1
2019,160977,10,5,19,13,6
2019,160977,20,0,95,44,51
2019,160977,20,1,48,23,25
2019,160977,20,2,47,21,26
2019,160977,30,0,34,16,18
2019,160977,30,2,1,0,1
2019,160977,30,3,33,16,17
2019,160977,40,0,56,31,25
2019,160977,40,1,6,4,2
2019,160977,40,2,3,1,2
2019,160977,40,3,27,13,14
2019,160977,40,4,1,0,1
2019,160977,40,5,19,13,6
2019,160977,41,0,34,22,12
2019,160977,41,1,6,4,2
2019,160977,41,2,2,1,1
2019,160977,41,3,11,6,5
2019,160977,41,5,15,11,4
2019,160977,42,0,22,9,13
2019,160977,42,2,1,0,1
2019,160977,42,3,16,7,9
2019,160977,42,4,1,0,1
2019,160977,42,5,4,2,2
2019,160977,44,0,34,22,12
2019,160977,44,1,6,4,2
2019,160977,44,2,2,1,1
2019,160977,44,3,11,6,5
2019,160977,44,5,15,11,4
2019,160995,0,0,43,11,32
2019,160995,50,0,43,11,32
2019,161004,0,0,222,99,123
2019,161004,10,0,222,99,123
2019,161004,10,1,69,35,34
2019,161004,10,2,53,21,32
2019,161004,10,3,74,30,44
2019,161004,10,4,1,0,1
2019,161004,10,5,25,13,12
2019,161004,20,0,122,56,66
2019,161004,20,1,69,35,34
2019,161004,20,2,53,21,32
2019,161004,30,0,43,16,27
2019,161004,30,3,43,16,27
2019,161004,40,0,57,27,30
2019,161004,40,3,31,14,17
2019,161004,40,4,1,0,1
2019,161004,40,5,25,13,12
2019,161004,41,0,30,15,15
2019,161004,41,3,11,4,7
2019,161004,41,5,19,11,8
2019,161004,42,0,27,12,15
2019,161004,42,3,20,10,10
2019,161004,42,4,1,0,1
2019,161004,42,5,6,2,4
2019,161004,44,0,30,15,15
2019,161004,44,3,11,4,7
2019,161004,44,5,19,11,8
2019,161022,0,0,10,0,10
2019,161022,10,0,10,0,10
2019,161022,10,4,10,0,10
2019,161022,40,0,10,0,10
2019,161022,40,4,10,0,10
2019,161022,42,0,2,0,2
2019,161022,42,4,2,0,2
2019,161022,43,0,8,0,8
2019,161022,43,4,8,0,8
2019,161077,0,0,53,32,21
2019,161077,10,0,53,32,21
2019,161077,10,4,53,32,21
2019,161077,40,0,53,32,21
2019,161077,40,4,53,32,21
2019,161077,42,0,53,32,21
2019,161077,42,4,53,32,21
2019,161086,0,0,234,117,117
2019,161086,10,0,226,114,112
2019,161086,10,1,61,38,23
2019,161086,10,2,57,29,28
2019,161086,10,3,67,26,41
2019,161086,10,4,41,21,20
2019,161086,20,0,111,61,50
2019,161086,20,1,58,35,23
2019,161086,20,2,53,26,27
2019,161086,30,0,58,25,33
2019,161086,30,3,58,25,33
2019,161086,40,0,57,28,29
2019,161086,40,1,3,3,0
2019,161086,40,2,4,3,1
2019,161086,40,3,9,1,8
2019,161086,40,4,41,21,20
2019,161086,41,0,17,6,11
2019,161086,41,1,2,2,0
2019,161086,41,2,4,3,1
2019,161086,41,3,9,1,8
2019,161086,41,4,2,0,2
2019,161086,42,0,40,22,18
2019,161086,42,1,1,1,0
2019,161086,42,4,39,21,18
2019,161086,44,0,17,6,11
2019,161086,44,1,2,2,0
2019,161086,44,2,4,3,1
2019,161086,44,3,9,1,8
2019,161086,44,4,2,0,2
2019,161086,50,0,8,3,5
2019,161138,0,0,61,34,27
2019,161138,10,0,61,34,27
2019,161138,10,4,61,34,27
2019,161138,40,0,61,34,27
2019,161138,40,4,61,34,27
2019,161138,42,0,61,34,27
2019,161138,42,4,61,34,27
2019,161192,0,0,42,16,26
2019,161192,10,0,42,16,26
2019,161192,10,4,42,16,26
2019,161192,40,0,42,16,26
2019,161192,40,4,42,16,26
2019,161192,42,0,42,16,26
2019,161192,42,4,42,16,26
2019,161217,0,0,94,40,54
2019,161217,10,0,94,40,54
2019,161217,10,1,28,16,12
2019,161217,10,2,21,8,13
2019,161217,10,3,26,10,16
2019,161217,10,4,3,1,2
2019,161217,10,5,16,5,11
2019,161217,20,0,49,24,25
2019,161217,20,1,28,16,12
2019,161217,20,2,21,8,13
2019,161217,30,0,26,10,16
2019,161217,30,3,26,10,16
2019,161217,40,0,19,6,13
2019,161217,40,4,3,1,2
2019,161217,40,5,16,5,11
2019,161217,41,0,8,2,6
2019,161217,41,4,3,1,2
2019,161217,41,5,5,1,4
2019,161217,42,0,11,4,7
2019,161217,42,5,11,4,7
2019,161217,44,0,7,2,5
2019,161217,44,4,3,1,2
2019,161217,44,5,4,1,3
2019,161217,45,0,1,0,1
2019,161217,45,5,1,0,1
2019,161226,0,0,117,47,70
2019,161226,10,0,117,47,70
2019,161226,10,1,37,21,16
2019,161226,10,2,34,13,21
2019,161226,10,3,34,13,21
2019,161226,10,4,3,0,3
2019,161226,10,5,9,0,9
2019,161226,20,0,71,34,37
2019,161226,20,1,37,21,16
2019,161226,20,2,34,13,21
2019,161226,30,0,25,8,17
2019,161226,30,3,24,8,16
2019,161226,30,4,1,0,1
2019,161226,40,0,21,5,16
2019,161226,40,3,10,5,5
2019,161226,40,4,2,0,2
2019,161226,40,5,9,0,9
2019,161226,41,0,10,3,7
2019,161226,41,3,3,3,0
2019,161226,41,4,1,0,1
2019,161226,41,5,6,0,6
2019,161226,42,0,7,1,6
2019,161226,42,3,3,1,2
2019,161226,42,4,1,0,1
2019,161226,42,5,3,0,3
2019,161226,43,0,4,1,3
2019,161226,43,3,4,1,3
2019,161226,44,0,10,3,7
2019,161226,44,3,3,3,0
2019,161226,44,4,1,0,1
2019,161226,44,5,6,0,6
2019,161235,0,0,32,18,14
2019,161235,10,0,32,18,14
2019,161235,10,1,8,4,4
2019,161235,10,2,7,6,1
2019,161235,10,3,13,6,7
2019,161235,10,4,2,0,2
2019,161235,10,5,2,2,0
2019,161235,20,0,15,10,5
2019,161235,20,1,8,4,4
2019,161235,20,2,7,6,1
2019,161235,30,0,7,4,3
2019,161235,30,3,7,4,3
2019,161235,40,0,10,4,6
2019,161235,40,3,6,2,4
2019,161235,40,4,2,0,2
2019,161235,40,5,2,2,0
2019,161235,41,0,5,4,1
2019,161235,41,3,3,2,1
2019,161235,41,5,2,2,0
2019,161235,42,0,5,0,5
2019,161235,42,3,3,0,3
2019,161235,42,4,2,0,2
2019,161235,44,0,5,4,1
2019,161235,44,3,3,2,1
2019,161235,44,5,2,2,0
2019,161244,0,0,27,14,13
2019,161244,10,0,27,14,13
2019,161244,10,1,10,6,4
2019,161244,10,2,8,4,4
2019,161244,10,3,7,2,5
2019,161244,10,4,1,1,0
2019,161244,10,5,1,1,0
2019,161244,20,0,19,10,9
2019,161244,20,1,10,6,4
2019,161244,20,2,8,4,4
2019,161244,20,3,1,0,1
2019,161244,30,0,4,3,1
2019,161244,30,3,3,2,1
2019,161244,30,4,1,1,0
2019,161244,40,0,4,1,3
2019,161244,40,3,3,0,3
2019,161244,40,5,1,1,0
2019,161244,42,0,4,1,3
2019,161244,42,3,3,0,3
2019,161244,42,5,1,1,0
2019,161253,0,0,541,321,220
2019,161253,10,0,541,321,220
2019,161253,10,1,183,131,52
2019,161253,10,2,127,78,49
2019,161253,10,3,142,75,67
2019,161253,10,4,8,2,6
2019,161253,10,5,81,35,46
2019,161253,20,0,298,200,98
2019,161253,20,1,178,127,51
2019,161253,20,2,120,73,47
2019,161253,30,0,128,62,66
2019,161253,30,1,1,1,0
2019,161253,30,2,5,3,2
2019,161253,30,3,122,58,64
2019,161253,40,0,115,59,56
2019,161253,40,1,4,3,1
2019,161253,40,2,2,2,0
2019,161253,40,3,20,17,3
2019,161253,40,4,8,2,6
2019,161253,40,5,81,35,46
2019,161253,41,0,51,22,29
2019,161253,41,1,3,2,1
2019,161253,41,3,5,5,0
2019,161253,41,4,6,2,4
2019,161253,41,5,37,13,24
2019,161253,42,0,64,37,27
2019,161253,42,1,1,1,0
2019,161253,42,2,2,2,0
2019,161253,42,3,15,12,3
2019,161253,42,4,2,0,2
2019,161253,42,5,44,22,22
2019,161253,44,0,50,21,29
2019,161253,44,1,2,1,1
2019,161253,44,3,5,5,0
2019,161253,44,4,6,2,4
2019,161253,44,5,37,13,24
2019,161253,45,0,1,1,0
2019,161253,45,1,1,1,0
2019,161299,0,0,78,62,16
2019,161299,10,0,78,62,16
2019,161299,10,1,24,18,6
2019,161299,10,2,18,16,2
2019,161299,10,3,29,22,7
2019,161299,10,4,6,5,1
2019,161299,10,5,1,1,0
2019,161299,40,0,78,62,16
2019,161299,40,1,24,18,6
2019,161299,40,2,18,16,2
2019,161299,40,3,29,22,7
2019,161299,40,4,6,5,1
2019,161299,40,5,1,1,0
2019,161299,41,0,77,61,16
2019,161299,41,1,23,17,6
2019,161299,41,2,18,16,2
2019,161299,41,3,29,22,7
2019,161299,41,4,6,5,1
2019,161299,41,5,1,1,0
2019,161299,43,0,1,1,0
2019,161299,43,1,1,1,0
2019,161299,45,0,77,61,16
2019,161299,45,1,23,17,6
2019,161299,45,2,18,16,2
2019,161299,45,3,29,22,7
2019,161299,45,4,6,5,1
2019,161299,45,5,1,1,0
2019,161341,0,0,33,18,15
2019,161341,10,0,33,18,15
2019,161341,10,1,13,9,4
2019,161341,10,2,10,6,4
2019,161341,10,3,9,3,6
2019,161341,10,4,1,0,1
2019,161341,20,0,21,13,8
2019,161341,20,1,12,8,4
2019,161341,20,2,9,5,4
2019,161341,30,0,9,3,6
2019,161341,30,2,1,1,0
2019,161341,30,3,7,2,5
2019,161341,30,4,1,0,1
2019,161341,40,0,3,2,1
2019,161341,40,1,1,1,0
2019,161341,40,3,2,1,1
2019,161341,41,0,1,1,0
2019,161341,41,1,1,1,0
2019,161341,42,0,2,1,1
2019,161341,42,3,2,1,1
2019,161341,45,0,1,1,0
2019,161341,45,1,1,1,0
2019,161457,0,0,298,126,172
2019,161457,10,0,298,126,172
2019,161457,10,1,59,35,24
2019,161457,10,2,92,40,52
2019,161457,10,3,86,25,61
2019,161457,10,4,2,1,1
2019,161457,10,5,59,25,34
2019,161457,20,0,97,55,42
2019,161457,20,1,44,29,15
2019,161457,20,2,53,26,27
2019,161457,30,0,21,7,14
2019,161457,30,1,1,1,0
2019,161457,30,2,5,2,3
2019,161457,30,3,15,4,11
2019,161457,40,0,180,64,116
2019,161457,40,1,14,5,9
2019,161457,40,2,34,12,22
2019,161457,40,3,71,21,50
2019,161457,40,4,2,1,1
2019,161457,40,5,59,25,34
2019,161457,42,0,180,64,116
2019,161457,42,1,14,5,9
2019,161457,42,2,34,12,22
2019,161457,42,3,71,21,50
2019,161457,42,4,2,1,1
2019,161457,42,5,59,25,34
2019,161484,0,0,37,22,15
2019,161484,10,0,36,21,15
2019,161484,10,4,36,21,15
2019,161484,40,0,36,21,15
2019,161484,40,4,36,21,15
2019,161484,42,0,36,21,15
2019,161484,42,4,36,21,15
2019,161484,50,0,1,1,0
2019,161509,0,0,24,12,12
2019,161509,10,0,24,12,12
2019,161509,10,1,9,4,5
2019,161509,10,2,2,1,1
2019,161509,10,3,13,7,6
2019,161509,40,0,24,12,12
2019,161509,40,1,9,4,5
2019,161509,40,2,2,1,1
2019,161509,40,3,13,7,6
2019,161509,41,0,20,10,10
2019,161509,41,1,9,4,5
2019,161509,41,2,2,1,1
2019,161509,41,3,9,5,4
2019,161509,42,0,4,2,2
2019,161509,42,3,4,2,2
2019,161509,44,0,20,10,10
2019,161509,44,1,9,4,5
2019,161509,44,2,2,1,1
2019,161509,44,3,9,5,4
2019,161518,0,0,78,35,43
2019,161518,10,0,78,35,43
2019,161518,10,1,9,5,4
2019,161518,10,2,23,12,11
2019,161518,10,3,39,16,23
2019,161518,10,4,7,2,5
2019,161518,20,0,29,18,11
2019,161518,20,1,9,5,4
2019,161518,20,2,17,11,6
2019,161518,20,3,3,2,1
2019,161518,30,0,19,10,9
2019,161518,30,2,2,1,1
2019,161518,30,3,17,9,8
2019,161518,40,0,30,7,23
2019,161518,40,2,4,0,4
2019,161518,40,3,19,5,14
2019,161518,40,4,7,2,5
2019,161518,42,0,11,2,9
2019,161518,42,2,4,0,4
2019,161518,42,3,5,1,4
2019,161518,42,4,2,1,1
2019,161518,43,0,19,5,14
2019,161518,43,3,14,4,10
2019,161518,43,4,5,1,4
2019,161545,0,0,97,49,48
2019,161545,10,0,97,49,48
2019,161545,10,1,36,21,15
2019,161545,10,2,26,14,12
2019,161545,10,3,17,7,10
2019,161545,10,4,18,7,11
2019,161545,40,0,97,49,48
2019,161545,40,1,36,21,15
2019,161545,40,2,26,14,12
2019,161545,40,3,17,7,10
2019,161545,40,4,18,7,11
2019,161545,42,0,97,49,48
2019,161545,42,1,36,21,15
2019,161545,42,2,26,14,12
2019,161545,42,3,17,7,10
2019,161545,42,4,18,7,11
2019,161554,0,0,289,129,160
2019,161554,10,0,289,129,160
2019,161554,10,1,85,53,32
2019,161554,10,2,65,28,37
2019,161554,10,3,75,27,48
2019,161554,10,4,2,0,2
2019,161554,10,5,62,21,41
2019,161554,20,0,143,79,64
2019,161554,20,1,79,50,29
2019,161554,20,2,63,28,35
2019,161554,20,3,1,1,0
2019,161554,30,0,69,23,46
2019,161554,30,2,1,0,1
2019,161554,30,3,68,23,45
2019,161554,40,0,77,27,50
2019,161554,40,1,6,3,3
2019,161554,40,2,1,0,1
2019,161554,40,3,6,3,3
2019,161554,40,4,2,0,2
2019,161554,40,5,62,21,41
2019,161554,41,0,29,11,18
2019,161554,41,1,6,3,3
2019,161554,41,2,1,0,1
2019,161554,41,3,3,1,2
2019,161554,41,4,2,0,2
2019,161554,41,5,17,7,10
2019,161554,42,0,48,16,32
2019,161554,42,3,3,2,1
2019,161554,42,5,45,14,31
2019,161554,44,0,28,10,18
2019,161554,44,1,5,2,3
2019,161554,44,2,1,0,1
2019,161554,44,3,3,1,2
2019,161554,44,4,2,0,2
2019,161554,44,5,17,7,10
2019,161554,45,0,1,1,0
2019,161554,45,1,1,1,0
2019,161563,0,0,35,24,11
2019,161563,10,0,35,24,11
2019,161563,10,1,12,10,2
2019,161563,10,2,10,6,4
2019,161563,10,3,12,7,5
2019,161563,10,4,1,1,0
2019,161563,40,0,35,24,11
2019,161563,40,1,12,10,2
2019,161563,40,2,10,6,4
2019,161563,40,3,12,7,5
2019,161563,40,4,1,1,0
2019,161563,41,0,32,24,8
2019,161563,41,1,12,10,2
2019,161563,41,2,9,6,3
2019,161563,41,3,10,7,3
2019,161563,41,4,1,1,0
2019,161563,42,0,3,0,3
2019,161563,42,2,1,0,1
2019,161563,42,3,2,0,2
2019,161563,44,0,32,24,8
2019,161563,44,1,12,10,2
2019,161563,44,2,9,6,3
2019,161563,44,3,10,7,3
2019,161563,44,4,1,1,0
2019,161572,0,0,45,24,21
2019,161572,10,0,45,24,21
2019,161572,10,1,12,6,6
2019,161572,10,2,10,8,2
2019,161572,10,3,11,4,7
2019,161572,10,4,12,6,6
2019,161572,40,0,45,24,21
2019,161572,40,1,12,6,6
2019,161572,40,2,10,8,2
2019,161572,40,3,11,4,7
2019,161572,40,4,12,6,6
2019,161572,41,0,36,19,17
2019,161572,41,1,12,6,6
2019,161572,41,2,10,8,2
2019,161572,41,3,9,4,5
2019,161572,41,4,5,1,4
2019,161572,42,0,6,4,2
2019,161572,42,3,2,0,2
2019,161572,42,4,4,4,0
2019,161572,43,0,3,1,2
2019,161572,43,4,3,1,2
2019,161572,44,0,36,19,17
2019,161572,44,1,12,6,6
2019,161572,44,2,10,8,2
2019,161572,44,3,9,4,5
2019,161572,44,4,5,1,4
2019,161581,0,0,23,15,8
2019,161581,10,0,23,15,8
2019,161581,10,4,23,15,8
2019,161581,40,0,23,15,8
2019,161581,40,4,23,15,8
2019,161581,42,0,23,15,8
2019,161581,42,4,23,15,8
2019,161688,0,0,95,36,59
2019,161688,10,0,95,36,59
2019,161688,10,1,22,7,15
2019,161688,10,2,33,15,18
2019,161688,10,3,26,9,17
2019,161688,10,4,14,5,9
2019,161688,20,0,60,26,34
2019,161688,20,1,22,7,15
2019,161688,20,2,24,12,12
2019,161688,20,3,12,5,7
2019,161688,20,4,2,2,0
2019,161688,30,0,33,9,24
2019,161688,30,2,9,3,6
2019,161688,30,3,14,4,10
2019,161688,30,4,10,2,8
2019,161688,40,0,2,1,1
2019,161688,40,4,2,1,1
2019,161688,42,0,2,1,1
2019,161688,42,4,2,1,1
2019,161767,0,0,264,98,166
2019,161767,10,0,264,98,166
2019,161767,10,1,68,25,43
2019,161767,10,2,84,34,50
2019,161767,10,3,78,26,52
2019,161767,10,4,15,5,10
2019,161767,10,6,19,8,11
2019,161767,20,0,112,33,79
2019,161767,20,1,59,21,38
2019,161767,20,2,43,12,31
2019,161767,20,3,8,0,8
2019,161767,20,4,2,0,2
2019,161767,30,0,27,12,15
2019,161767,30,1,5,3,2
2019,161767,30,2,11,5,6
2019,161767,30,3,9,3,6
2019,161767,30,4,2,1,1
2019,161767,40,0,125,53,72
2019,161767,40,1,4,1,3
2019,161767,40,2,30,17,13
2019,161767,40,3,61,23,38
2019,161767,40,4,11,4,7
2019,161767,40,6,19,8,11
2019,161767,41,0,49,25,24
2019,161767,41,1,4,1,3
2019,161767,41,2,27,15,12
2019,161767,41,3,14,7,7
2019,161767,41,4,4,2,2
2019,161767,43,0,76,28,48
2019,161767,43,2,3,2,1
2019,161767,43,3,47,16,31
2019,161767,43,4,7,2,5
2019,161767,43,6,19,8,11
2019,161767,44,0,49,25,24
2019,161767,44,1,4,1,3
2019,161767,44,2,27,15,12
2019,161767,44,3,14,7,7
2019,161767,44,4,4,2,2
2019,161864,0,0,106,47,59
2019,161864,10,0,106,47,59
2019,161864,10,1,27,13,14
2019,161864,10,2,29,15,14
2019,161864,10,3,50,19,31
2019,161864,40,0,106,47,59
2019,161864,40,1,27,13,14
2019,161864,40,2,29,15,14
2019,161864,40,3,50,19,31
2019,161864,43,0,106,47,59
2019,161864,43,1,27,13,14
2019,161864,43,2,29,15,14
2019,161864,43,3,50,19,31
2019,161873,0,0,183,97,86
2019,161873,10,0,183,97,86
2019,161873,10,1,40,28,12
2019,161873,10,2,59,30,29
2019,161873,10,3,48,22,26
2019,161873,10,5,36,17,19
2019,161873,20,0,98,57,41
2019,161873,20,1,39,28,11
2019,161873,20,2,58,29,29
2019,161873,20,3,1,0,1
2019,161873,30,0,49,23,26
2019,161873,30,1,1,0,1
2019,161873,30,2,1,1,0
2019,161873,30,3,47,22,25
2019,161873,40,0,36,17,19
2019,161873,40,5,36,17,19
2019,161873,41,0,23,9,14
2019,161873,41,5,23,9,14
2019,161873,42,0,13,8,5
2019,161873,42,5,13,8,5
2019,161873,44,0,23,9,14
2019,161873,44,5,23,9,14
2019,162007,0,0,221,99,122
2019,162007,10,0,221,99,122
2019,162007,10,1,42,29,13
2019,162007,10,2,53,23,30
2019,162007,10,3,84,31,53
2019,162007,10,4,8,0,8
2019,162007,10,5,34,16,18
2019,162007,20,0,79,48,31
2019,162007,20,1,39,28,11
2019,162007,20,2,26,10,16
2019,162007,20,3,14,10,4
2019,162007,30,0,34,11,23
2019,162007,30,1,1,0,1
2019,162007,30,2,14,7,7
2019,162007,30,3,19,4,15
2019,162007,40,0,108,40,68
2019,162007,40,1,2,1,1
2019,162007,40,2,13,6,7
2019,162007,40,3,51,17,34
2019,162007,40,4,8,0,8
2019,162007,40,5,34,16,18
2019,162007,41,0,79,26,53
2019,162007,41,1,2,1,1
2019,162007,41,2,13,6,7
2019,162007,41,3,51,17,34
2019,162007,41,4,8,0,8
2019,162007,41,5,5,2,3
2019,162007,42,0,29,14,15
2019,162007,42,5,29,14,15
2019,162007,44,0,79,26,53
2019,162007,44,1,2,1,1
2019,162007,44,2,13,6,7
2019,162007,44,3,51,17,34
2019,162007,44,4,8,0,8
2019,162007,44,5,5,2,3
2019,162061,0,0,14,11,3
2019,162061,10,0,14,11,3
2019,162061,10,1,4,4,0
2019,162061,10,2,3,2,1
2019,162061,10,3,7,5,2
2019,162061,40,0,14,11,3
2019,162061,40,1,4,4,0
2019,162061,40,2,3,2,1
2019,162061,40,3,7,5,2
2019,162061,41,0,14,11,3
2019,162061,41,1,4,4,0
2019,162061,41,2,3,2,1
2019,162061,41,3,7,5,2
2019,162061,44,0,14,11,3
2019,162061,44,1,4,4,0
2019,162061,44,2,3,2,1
2019,162061,44,3,7,5,2
2019,162104,0,0,54,22,32
2019,162104,10,0,54,22,32
2019,162104,10,1,17,3,14
2019,162104,10,2,13,8,5
2019,162104,10,3,22,9,13
2019,162104,10,4,2,2,0
2019,162104,20,0,1,1,0
2019,162104,20,1,1,1,0
2019,162104,40,0,53,21,32
2019,162104,40,1,16,2,14
2019,162104,40,2,13,8,5
2019,162104,40,3,22,9,13
2019,162104,40,4,2,2,0
2019,162104,42,0,4,0,4
2019,162104,42,1,1,0,1
2019,162104,42,3,3,0,3
2019,162104,43,0,49,21,28
2019,162104,43,1,15,2,13
2019,162104,43,2,13,8,5
2019,162104,43,3,19,9,10
2019,162104,43,4,2,2,0
2019,162122,0,0,120,46,74
2019,162122,10,0,120,46,74
2019,162122,10,1,74,25,49
2019,162122,10,2,16,7,9
2019,162122,10,3,24,10,14
2019,162122,10,4,6,4,2
2019,162122,20,0,57,21,36
2019,162122,20,1,56,21,35
2019,162122,20,2,1,0,1
2019,162122,30,0,5,0,5
2019,162122,30,1,4,0,4
2019,162122,30,3,1,0,1
2019,162122,40,0,58,25,33
2019,162122,40,1,14,4,10
2019,162122,40,2,15,7,8
2019,162122,40,3,23,10,13
2019,162122,40,4,6,4,2
2019,162122,42,0,58,25,33
2019,162122,42,1,14,4,10
2019,162122,42,2,15,7,8
2019,162122,42,3,23,10,13
2019,162122,42,4,6,4,2
2019,162168,0,0,54,15,39
2019,162168,10,0,54,15,39
2019,162168,10,1,11,3,8
2019,162168,10,2,12,5,7
2019,162168,10,3,16,4,12
2019,162168,10,4,15,3,12
2019,162168,40,0,54,15,39
2019,162168,40,1,11,3,8
2019,162168,40,2,12,5,7
2019,162168,40,3,16,4,12
2019,162168,40,4,15,3,12
2019,162168,41,0,34,10,24
2019,162168,41,1,9,2,7
2019,162168,41,2,9,4,5
2019,162168,41,3,11,2,9
2019,162168,41,4,5,2,3
2019,162168,42,0,7,2,5
2019,162168,42,2,3,1,2
2019,162168,42,3,2,1,1
2019,162168,42,4,2,0,2
2019,162168,43,0,13,3,10
2019,162168,43,1,2,1,1
2019,162168,43,3,3,1,2
2019,162168,43,4,8,1,7
2019,162168,44,0,34,10,24
2019,162168,44,1,9,2,7
2019,162168,44,2,9,4,5
2019,162168,44,3,11,2,9
2019,162168,44,4,5,2,3
2019,162210,0,0,43,23,20
2019,162210,10,0,43,23,20
2019,162210,10,1,15,8,7
2019,162210,10,2,13,7,6
2019,162210,10,3,15,8,7
2019,162210,40,0,43,23,20
2019,162210,40,1,15,8,7
2019,162210,40,2,13,7,6
2019,162210,40,3,15,8,7
2019,162210,42,0,43,23,20
2019,162210,42,1,15,8,7
2019,162210,42,2,13,7,6
2019,162210,42,3,15,8,7
2019,162283,0,0,123,53,70
2019,162283,10,0,123,53,70
2019,162283,10,1,23,12,11
2019,162283,10,2,38,19,19
2019,162283,10,3,55,18,37
2019,162283,10,4,7,4,3
2019,162283,20,0,85,41,44
2019,162283,20,1,23,12,11
2019,162283,20,2,35,18,17
2019,162283,20,3,27,11,16
2019,162283,30,0,31,8,23
2019,162283,30,2,3,1,2
2019,162283,30,3,28,7,21
2019,162283,40,0,7,4,3
2019,162283,40,4,7,4,3
2019,162283,42,0,7,4,3
2019,162283,42,4,7,4,3
2019,162557,0,0,102,41,61
2019,162557,10,0,102,41,61
2019,162557,10,1,31,17,14
2019,162557,10,2,29,9,20
2019,162557,10,3,41,14,27
2019,162557,10,6,1,1,0
2019,162557,40,0,102,41,61
2019,162557,40,1,31,17,14
2019,162557,40,2,29,9,20
2019,162557,40,3,41,14,27
2019,162557,40,6,1,1,0
2019,162557,43,0,102,41,61
2019,162557,43,1,31,17,14
2019,162557,43,2,29,9,20
2019,162557,43,3,41,14,27
2019,162557,43,6,1,1,0
2019,162584,0,0,238,134,104
2019,162584,10,0,238,134,104
2019,162584,10,1,67,49,18
2019,162584,10,2,79,45,34
2019,162584,10,3,53,22,31
2019,162584,10,4,1,1,0
2019,162584,10,5,38,17,21
2019,162584,20,0,139,91,48
2019,162584,20,1,66,48,18
2019,162584,20,2,67,39,28
2019,162584,20,3,6,4,2
2019,162584,30,0,60,25,35
2019,162584,30,1,1,1,0
2019,162584,30,2,12,6,6
2019,162584,30,3,47,18,29
2019,162584,40,0,39,18,21
2019,162584,40,4,1,1,0
2019,162584,40,5,38,17,21
2019,162584,42,0,37,17,20
2019,162584,42,5,37,17,20
2019,162584,43,0,2,1,1
2019,162584,43,4,1,1,0
2019,162584,43,5,1,0,1
2019,162609,0,0,21,12,9
2019,162609,10,0,21,12,9
2019,162609,10,1,11,8,3
2019,162609,10,2,5,1,4
2019,162609,10,3,5,3,2
2019,162609,40,0,21,12,9
2019,162609,40,1,11,8,3
2019,162609,40,2,5,1,4
2019,162609,40,3,5,3,2
2019,162609,41,0,8,6,2
2019,162609,41,1,8,6,2
2019,162609,42,0,10,5,5
2019,162609,42,1,3,2,1
2019,162609,42,2,4,1,3
2019,162609,42,3,3,2,1
2019,162609,43,0,3,1,2
2019,162609,43,2,1,0,1
2019,162609,43,3,2,1,1
2019,162609,44,0,8,6,2
2019,162609,44,1,8,6,2
2019,162654,0,0,114,44,70
2019,162654,10,0,114,44,70
2019,162654,10,1,25,8,17
2019,162654,10,2,37,14,23
2019,162654,10,3,41,19,22
2019,162654,10,4,11,3,8
2019,162654,20,0,57,20,37
2019,162654,20,1,25,8,17
2019,162654,20,2,32,12,20
2019,162654,30,0,24,12,12
2019,162654,30,2,4,2,2
2019,162654,30,3,20,10,10
2019,162654,40,0,33,12,21
2019,162654,40,2,1,0,1
2019,162654,40,3,21,9,12
2019,162654,40,4,11,3,8
2019,162654,42,0,33,12,21
2019,162654,42,2,1,0,1
2019,162654,42,3,21,9,12
2019,162654,42,4,11,3,8
2019,162690,0,0,78,29,49
2019,162690,10,0,78,29,49
2019,162690,10,1,15,6,9
2019,162690,10,2,8,4,4
2019,162690,10,3,39,11,28
2019,162690,10,4,16,8,8
2019,162690,20,0,43,15,28
2019,162690,20,1,15,6,9
2019,162690,20,2,8,4,4
2019,162690,20,3,20,5,15
2019,162690,30,0,33,13,20
2019,162690,30,3,19,6,13
2019,162690,30,4,14,7,7
2019,162690,40,0,2,1,1
2019,162690,40,4,2,1,1
2019,162690,41,0,2,1,1
2019,162690,41,4,2,1,1
2019,162690,44,0,2,1,1
2019,162690,44,4,2,1,1
2019,162706,0,0,103,39,64
2019,162706,10,0,103,39,64
2019,162706,10,1,16,5,11
2019,162706,10,2,17,5,12
2019,162706,10,3,70,29,41
2019,162706,20,0,40,12,28
2019,162706,20,1,14,4,10
2019,162706,20,2,15,3,12
2019,162706,20,3,11,5,6
2019,162706,30,0,17,7,10
2019,162706,30,2,1,1,0
2019,162706,30,3,16,6,10
2019,162706,40,0,46,20,26
2019,162706,40,1,2,1,1
2019,162706,40,2,1,1,0
2019,162706,40,3,43,18,25
2019,162706,41,0,43,19,24
2019,162706,41,1,2,1,1
2019,162706,41,2,1,1,0
2019,162706,41,3,40,17,23
2019,162706,42,0,2,0,2
2019,162706,42,3,2,0,2
2019,162706,43,0,1,1,0
2019,162706,43,3,1,1,0
2019,162706,44,0,43,19,24
2019,162706,44,1,2,1,1
2019,162706,44,2,1,1,0
2019,162706,44,3,40,17,23
2019,162760,0,0,101,41,60
2019,162760,10,0,101,41,60
2019,162760,10,1,26,11,15
2019,162760,10,2,35,14,21
2019,162760,10,3,31,11,20
2019,162760,10,4,1,1,0
2019,162760,10,6,8,4,4
2019,162760,20,0,55,23,32
2019,162760,20,1,26,11,15
2019,162760,20,2,29,12,17
2019,162760,30,0,32,10,22
2019,162760,30,2,6,2,4
2019,162760,30,3,26,8,18
2019,162760,40,0,14,8,6
2019,162760,40,3,5,3,2
2019,162760,40,4,1,1,0
2019,162760,40,6,8,4,4
2019,162760,42,0,14,8,6
2019,162760,42,3,5,3,2
2019,162760,42,4,1,1,0
2019,162760,42,6,8,4,4
2019,162779,0,0,201,76,125
2019,162779,10,0,201,76,125
2019,162779,10,1,71,27,44
2019,162779,10,2,62,21,41
2019,162779,10,3,55,21,34
2019,162779,10,4,13,7,6
2019,162779,40,0,201,76,125
2019,162779,40,1,71,27,44
2019,162779,40,2,62,21,41
2019,162779,40,3,55,21,34
2019,162779,40,4,13,7,6
2019,162779,41,0,201,76,125
2019,162779,41,1,71,27,44
2019,162779,41,2,62,21,41
2019,162779,41,3,55,21,34
2019,162779,41,4,13,7,6
2019,162779,44,0,159,56,103
2019,162779,44,1,71,27,44
2019,162779,44,2,54,17,37
2019,162779,44,3,34,12,22
2019,162779,45,0,42,20,22
2019,162779,45,2,8,4,4
2019,162779,45,3,21,9,12
2019,162779,45,4,13,7,6
2019,162928,0,0,3906,2219,1687
2019,162928,10,0,3906,2219,1687
2019,162928,10,1,1115,824,291
2019,162928,10,2,858,503,355
2019,162928,10,3,1384,650,734
2019,162928,10,4,224,111,113
2019,162928,10,5,255,94,161
2019,162928,10,6,70,37,33
2019,162928,20,0,1146,843,303
2019,162928,20,1,1041,777,264
2019,162928,20,2,105,66,39
2019,162928,30,0,1990,1030,960
2019,162928,30,1,4,2,2
2019,162928,30,2,689,408,281
2019,162928,30,3,1297,620,677
2019,162928,40,0,770,346,424
2019,162928,40,1,70,45,25
2019,162928,40,2,64,29,35
2019,162928,40,3,87,30,57
2019,162928,40,4,224,111,113
2019,162928,40,5,255,94,161
2019,162928,40,6,70,37,33
2019,162928,41,0,189,91,98
2019,162928,41,1,22,13,9
2019,162928,41,2,31,13,18
2019,162928,41,3,34,12,22
2019,162928,41,4,9,6,3
2019,162928,41,5,56,21,35
2019,162928,41,6,37,26,11
2019,162928,42,0,552,239,313
2019,162928,42,1,42,28,14
2019,162928,42,2,25,12,13
2019,162928,42,3,48,16,32
2019,162928,42,4,212,103,109
2019,162928,42,5,196,72,124
2019,162928,42,6,29,8,21
2019,162928,43,0,29,16,13
2019,162928,43,1,6,4,2
2019,162928,43,2,8,4,4
2019,162928,43,3,5,2,3
2019,162928,43,4,3,2,1
2019,162928,43,5,3,1,2
2019,162928,43,6,4,3,1
2019,162928,44,0,189,91,98
2019,162928,44,1,22,13,9
2019,162928,44,2,31,13,18
2019,162928,44,3,34,12,22
2019,162928,44,4,9,6,3
2019,162928,44,5,56,21,35
2019,162928,44,6,37,26,11
2019,163028,0,0,32,30,2
2019,163028,10,0,32,30,2
2019,163028,10,4,32,30,2
2019,163028,40,0,32,30,2
2019,163028,40,4,32,30,2
2019,163028,41,0,32,30,2
2019,163028,41,4,32,30,2
2019,163028,45,0,32,30,2
2019,163028,45,4,32,30,2
2019,163046,0,0,353,169,184
2019,163046,10,0,353,169,184
2019,163046,10,1,74,50,24
2019,163046,10,2,123,56,67
2019,163046,10,3,43,19,24
2019,163046,10,4,23,6,17
2019,163046,10,5,90,38,52
2019,163046,20,0,199,108,91
2019,163046,20,1,74,50,24
2019,163046,20,2,123,56,67
2019,163046,20,3,2,2,0
2019,163046,30,0,35,16,19
2019,163046,30,3,35,16,19
2019,163046,40,0,119,45,74
2019,163046,40,3,6,1,5
2019,163046,40,4,23,6,17
2019,163046,40,5,90,38,52
2019,163046,42,0,119,45,74
2019,163046,42,3,6,1,5
2019,163046,42,4,23,6,17
2019,163046,42,5,90,38,52
2019,163204,0,0,209,118,91
2019,163204,10,0,209,118,91
2019,163204,10,1,131,74,57
2019,163204,10,2,67,37,30
2019,163204,10,3,11,7,4
2019,163204,40,0,209,118,91
2019,163204,40,1,131,74,57
2019,163204,40,2,67,37,30
2019,163204,40,3,11,7,4
2019,163204,42,0,209,118,91
2019,163204,42,1,131,74,57
2019,163204,42,2,67,37,30
2019,163204,42,3,11,7,4
2019,163259,0,0,1785,943,842
2019,163259,10,0,1785,943,842
2019,163259,10,1,405,301,104
2019,163259,10,2,365,204,161
2019,163259,10,3,843,388,455
2019,163259,10,4,153,48,105
2019,163259,10,5,14,1,13
2019,163259,10,6,5,1,4
2019,163259,20,0,361,248,113
2019,163259,20,1,270,200,70
2019,163259,20,2,89,47,42
2019,163259,20,3,1,1,0
2019,163259,20,6,1,0,1
2019,163259,30,0,111,65,46
2019,163259,30,1,6,6,0
2019,163259,30,2,37,24,13
2019,163259,30,3,68,35,33
2019,163259,40,0,1313,630,683
2019,163259,40,1,129,95,34
2019,163259,40,2,239,133,106
2019,163259,40,3,774,352,422
2019,163259,40,4,153,48,105
2019,163259,40,5,14,1,13
2019,163259,40,6,4,1,3
2019,163259,42,0,1313,630,683
2019,163259,42,1,129,95,34
2019,163259,42,2,239,133,106
2019,163259,42,3,774,352,422
2019,163259,42,4,153,48,105
2019,163259,42,5,14,1,13
2019,163259,42,6,4,1,3
2019,163268,0,0,556,287,269
2019,163268,10,0,556,287,269
2019,163268,10,1,157,112,45
2019,163268,10,2,159,75,84
2019,163268,10,3,122,54,68
2019,163268,10,4,10,2,8
2019,163268,10,5,108,44,64
2019,163268,20,0,284,171,113
2019,163268,20,1,142,101,41
2019,163268,20,2,141,69,72
2019,163268,20,3,1,1,0
2019,163268,30,0,122,56,66
2019,163268,30,1,1,1,0
2019,163268,30,2,11,5,6
2019,163268,30,3,110,50,60
2019,163268,40,0,150,60,90
2019,163268,40,1,14,10,4
2019,163268,40,2,7,1,6
2019,163268,40,3,11,3,8
2019,163268,40,4,10,2,8
2019,163268,40,5,108,44,64
2019,163268,42,0,150,60,90
2019,163268,42,1,14,10,4
2019,163268,42,2,7,1,6
2019,163268,42,3,11,3,8
2019,163268,42,4,10,2,8
2019,163268,42,5,108,44,64
2019,163286,0,0,1870,1128,742
2019,163286,10,0,1870,1128,742
2019,163286,10,1,719,538,181
2019,163286,10,2,455,258,197
2019,163286,10,3,315,140,175
2019,163286,10,4,8,2,6
2019,163286,10,5,373,190,183
2019,163286,20,0,1104,765,339
2019,163286,20,1,690,518,172
2019,163286,20,2,414,247,167
2019,163286,30,0,268,132,136
2019,163286,30,2,1,0,1
2019,163286,30,3,267,132,135
2019,163286,40,0,498,231,267
2019,163286,40,1,29,20,9
2019,163286,40,2,40,11,29
2019,163286,40,3,48,8,40
2019,163286,40,4,8,2,6
2019,163286,40,5,373,190,183
2019,163286,42,0,498,231,267
2019,163286,42,1,29,20,9
2019,163286,42,2,40,11,29
2019,163286,42,3,48,8,40
2019,163286,42,4,8,2,6
2019,163286,42,5,373,190,183
2019,163295,0,0,151,67,84
2019,163295,10,0,151,67,84
2019,163295,10,1,151,67,84
2019,163295,40,0,151,67,84
2019,163295,40,1,151,67,84
2019,163295,41,0,143,63,80
2019,163295,41,1,143,63,80
2019,163295,42,0,8,4,4
2019,163295,42,1,8,4,4
2019,163295,44,0,143,63,80
2019,163295,44,1,143,63,80
2019,163338,0,0,205,113,92
2019,163338,10,0,205,113,92
2019,163338,10,1,43,26,17
2019,163338,10,2,73,47,26
2019,163338,10,3,49,23,26
2019,163338,10,4,1,1,0
2019,163338,10,5,39,16,23
2019,163338,20,0,111,73,38
2019,163338,20,1,43,26,17
2019,163338,20,2,62,42,20
2019,163338,20,3,6,5,1
2019,163338,30,0,40,19,21
2019,163338,30,2,7,3,4
2019,163338,30,3,33,16,17
2019,163338,40,0,54,21,33
2019,163338,40,2,4,2,2
2019,163338,40,3,10,2,8
2019,163338,40,4,1,1,0
2019,163338,40,5,39,16,23
2019,163338,42,0,21,6,15
2019,163338,42,2,2,1,1
2019,163338,42,3,8,1,7
2019,163338,42,4,1,1,0
2019,163338,42,5,10,3,7
2019,163338,43,0,33,15,18
2019,163338,43,2,2,1,1
2019,163338,43,3,2,1,1
2019,163338,43,5,29,13,16
2019,163426,0,0,467,187,280
2019,163426,10,0,466,187,279
2019,163426,10,1,353,164,189
2019,163426,10,2,83,19,64
2019,163426,10,3,29,4,25
2019,163426,10,4,1,0,1
2019,163426,20,0,2,2,0
2019,163426,20,1,2,2,0
2019,163426,40,0,464,185,279
2019,163426,40,1,351,162,189
2019,163426,40,2,83,19,64
2019,163426,40,3,29,4,25
2019,163426,40,4,1,0,1
2019,163426,42,0,464,185,279
2019,163426,42,1,351,162,189
2019,163426,42,2,83,19,64
2019,163426,42,3,29,4,25
2019,163426,42,4,1,0,1
2019,163426,50,0,1,0,1
2019,163453,0,0,467,257,210
2019,163453,10,0,467,257,210
2019,163453,10,1,73,54,19
2019,163453,10,2,173,92,81
2019,163453,10,3,87,42,45
2019,163453,10,4,2,1,1
2019,163453,10,5,132,68,64
2019,163453,20,0,240,141,99
2019,163453,20,1,71,52,19
2019,163453,20,2,163,85,78
2019,163453,20,3,5,3,2
2019,163453,20,4,1,1,0
2019,163453,30,0,93,48,45
2019,163453,30,1,1,1,0
2019,163453,30,2,10,7,3
2019,163453,30,3,81,39,42
2019,163453,30,5,1,1,0
2019,163453,40,0,134,68,66
2019,163453,40,1,1,1,0
2019,163453,40,3,1,0,1
2019,163453,40,4,1,0,1
2019,163453,40,5,131,67,64
2019,163453,41,0,26,8,18
2019,163453,41,1,1,1,0
2019,163453,41,3,1,0,1
2019,163453,41,4,1,0,1
2019,163453,41,5,23,7,16
2019,163453,42,0,106,58,48
2019,163453,42,5,106,58,48
2019,163453,43,0,2,2,0
2019,163453,43,5,2,2,0
2019,163453,44,0,26,8,18
2019,163453,44,1,1,1,0
2019,163453,44,3,1,0,1
2019,163453,44,4,1,0,1
2019,163453,44,5,23,7,16
2019,163462,0,0,131,79,52
2019,163462,10,0,131,79,52
2019,163462,10,1,28,13,15
2019,163462,10,2,43,31,12
2019,163462,10,3,39,25,14
2019,163462,10,4,1,0,1
2019,163462,10,5,20,10,10
2019,163462,20,0,62,35,27
2019,163462,20,1,25,10,15
2019,163462,20,2,37,25,12
2019,163462,30,0,29,19,10
2019,163462,30,2,1,1,0
2019,163462,30,3,28,18,10
2019,163462,40,0,40,25,15
2019,163462,40,1,3,3,0
2019,163462,40,2,5,5,0
2019,163462,40,3,11,7,4
2019,163462,40,4,1,0,1
2019,163462,40,5,20,10,10
2019,163462,41,0,19,12,7
2019,163462,41,1,1,1,0
2019,163462,41,2,4,4,0
2019,163462,41,3,9,5,4
2019,163462,41,5,5,2,3
2019,163462,42,0,21,13,8
2019,163462,42,1,2,2,0
2019,163462,42,2,1,1,0
2019,163462,42,3,2,2,0
2019,163462,42,4,1,0,1
2019,163462,42,5,15,8,7
2019,163462,44,0,19,12,7
2019,163462,44,1,1,1,0
2019,163462,44,2,4,4,0
2019,163462,44,3,9,5,4
2019,163462,44,5,5,2,3
2019,163532,0,0,12,12,0
2019,163532,10,0,12,12,0
2019,163532,10,1,12,12,0
2019,163532,20,0,12,12,0
2019,163532,20,1,12,12,0
2019,163578,0,0,106,31,75
2019,163578,10,0,106,31,75
2019,163578,10,1,18,8,10
2019,163578,10,2,40,12,28
2019,163578,10,3,48,11,37
2019,163578,20,0,34,12,22
2019,163578,20,1,15,7,8
2019,163578,20,2,19,5,14
2019,163578,30,0,57,17,40
2019,163578,30,1,2,1,1
2019,163578,30,2,19,7,12
2019,163578,30,3,36,9,27
2019,163578,40,0,15,2,13
2019,163578,40,1,1,0,1
2019,163578,40,2,2,0,2
2019,163578,40,3,12,2,10
2019,163578,42,0,15,2,13
2019,163578,42,1,1,0,1
2019,163578,42,2,2,0,2
2019,163578,42,3,12,2,10
2019,163657,0,0,233,89,144
2019,163657,10,0,233,89,144
2019,163657,10,1,89,36,53
2019,163657,10,2,113,38,75
2019,163657,10,3,30,14,16
2019,163657,10,4,1,1,0
2019,163657,20,0,92,32,60
2019,163657,20,1,63,23,40
2019,163657,20,2,28,9,19
2019,163657,20,3,1,0,1
2019,163657,30,0,112,44,68
2019,163657,30,1,22,11,11
2019,163657,30,2,67,21,46
2019,163657,30,3,23,12,11
2019,163657,40,0,29,13,16
2019,163657,40,1,4,2,2
2019,163657,40,2,18,8,10
2019,163657,40,3,6,2,4
2019,163657,40,4,1,1,0
2019,163657,42,0,29,13,16
2019,163657,42,1,4,2,2
2019,163657,42,2,18,8,10
2019,163657,42,3,6,2,4
2019,163657,42,4,1,1,0
2019,163851,0,0,446,216,230
2019,163851,10,0,446,216,230
2019,163851,10,1,110,74,36
2019,163851,10,2,123,61,62
2019,163851,10,3,112,55,57
2019,163851,10,4,6,2,4
2019,163851,10,5,95,24,71
2019,163851,20,0,239,139,100
2019,163851,20,1,109,73,36
2019,163851,20,2,121,61,60
2019,163851,20,3,9,5,4
2019,163851,30,0,112,53,59
2019,163851,30,1,1,1,0
2019,163851,30,2,2,0,2
2019,163851,30,3,103,50,53
2019,163851,30,4,6,2,4
2019,163851,40,0,95,24,71
2019,163851,40,5,95,24,71
2019,163851,41,0,40,11,29
2019,163851,41,5,40,11,29
2019,163851,43,0,55,13,42
2019,163851,43,5,55,13,42
2019,163851,44,0,40,11,29
2019,163851,44,5,40,11,29
2019,163912,0,0,134,67,67
2019,163912,10,0,134,67,67
2019,163912,10,1,50,27,23
2019,163912,10,2,34,18,16
2019,163912,10,3,46,20,26
2019,163912,10,4,2,1,1
2019,163912,10,5,2,1,1
2019,163912,20,0,83,44,39
2019,163912,20,1,50,27,23
2019,163912,20,2,33,17,16
2019,163912,30,0,35,13,22
2019,163912,30,3,35,13,22
2019,163912,40,0,16,10,6
2019,163912,40,2,1,1,0
2019,163912,40,3,11,7,4
2019,163912,40,4,2,1,1
2019,163912,40,5,2,1,1
2019,163912,41,0,16,10,6
2019,163912,41,2,1,1,0
2019,163912,41,3,11,7,4
2019,163912,41,4,2,1,1
2019,163912,41,5,2,1,1
2019,163912,44,0,16,10,6
2019,163912,44,2,1,1,0
2019,163912,44,3,11,7,4
2019,163912,44,4,2,1,1
2019,163912,44,5,2,1,1
2019,163976,0,0,57,42,15
2019,163976,10,0,57,42,15
2019,163976,10,1,57,42,15
2019,163976,20,0,46,35,11
2019,163976,20,1,46,35,11
2019,163976,30,0,11,7,4
2019,163976,30,1,11,7,4
2019,164076,0,0,930,390,540
2019,164076,10,0,930,390,540
2019,164076,10,1,232,124,108
2019,164076,10,2,224,102,122
2019,164076,10,3,224,78,146
2019,164076,10,4,19,3,16
2019,164076,10,5,231,83,148
2019,164076,20,0,433,225,208
2019,164076,20,1,226,123,103
2019,164076,20,2,204,100,104
2019,164076,20,3,3,2,1
2019,164076,30,0,175,60,115
2019,164076,30,1,1,0,1
2019,164076,30,3,171,60,111
2019,164076,30,4,3,0,3
2019,164076,40,0,322,105,217
2019,164076,40,1,5,1,4
2019,164076,40,2,20,2,18
2019,164076,40,3,50,16,34
2019,164076,40,4,16,3,13
2019,164076,40,5,231,83,148
2019,164076,42,0,312,102,210
2019,164076,42,1,5,1,4
2019,164076,42,2,20,2,18
2019,164076,42,3,50,16,34
2019,164076,42,4,16,3,13
2019,164076,42,5,221,80,141
2019,164076,43,0,10,3,7
2019,164076,43,5,10,3,7
2019,164085,0,0,11,4,7
2019,164085,10,0,11,4,7
2019,164085,10,1,2,0,2
2019,164085,10,2,1,0,1
2019,164085,10,3,4,1,3
2019,164085,10,4,4,3,1
2019,164085,40,0,11,4,7
2019,164085,40,1,2,0,2
2019,164085,40,2,1,0,1
2019,164085,40,3,4,1,3
2019,164085,40,4,4,3,1
2019,164085,41,0,7,1,6
2019,164085,41,1,2,0,2
2019,164085,41,2,1,0,1
2019,164085,41,3,4,1,3
2019,164085,42,0,4,3,1
2019,164085,42,4,4,3,1
2019,164085,44,0,7,1,6
2019,164085,44,1,2,0,2
2019,164085,44,2,1,0,1
2019,164085,44,3,4,1,3
2019,164155,0,0,324,224,100
2019,164155,10,0,324,224,100
2019,164155,10,1,122,87,35
2019,164155,10,2,95,69,26
2019,164155,10,3,70,36,34
2019,164155,10,6,37,32,5
2019,164155,20,0,217,156,61
2019,164155,20,1,122,87,35
2019,164155,20,2,95,69,26
2019,164155,30,0,70,36,34
2019,164155,30,3,70,36,34
2019,164155,40,0,37,32,5
2019,164155,40,6,37,32,5
2019,164155,41,0,35,30,5
2019,164155,41,6,35,30,5
2019,164155,42,0,2,2,0
2019,164155,42,6,2,2,0
2019,164155,44,0,24,21,3
2019,164155,44,6,24,21,3
2019,164155,45,0,11,9,2
2019,164155,45,6,11,9,2
2019,164173,0,0,127,52,75
2019,164173,10,0,127,52,75
2019,164173,10,1,39,16,23
2019,164173,10,2,30,16,14
2019,164173,10,3,35,14,21
2019,164173,10,4,2,1,1
2019,164173,10,5,21,5,16
2019,164173,40,0,127,52,75
2019,164173,40,1,39,16,23
2019,164173,40,2,30,16,14
2019,164173,40,3,35,14,21
2019,164173,40,4,2,1,1
2019,164173,40,5,21,5,16
2019,164173,41,0,103,45,58
2019,164173,41,1,39,16,23
2019,164173,41,2,27,14,13
2019,164173,41,3,25,12,13
2019,164173,41,4,2,1,1
2019,164173,41,5,10,2,8
2019,164173,42,0,24,7,17
2019,164173,42,2,3,2,1
2019,164173,42,3,10,2,8
2019,164173,42,5,11,3,8
2019,164173,44,0,103,45,58
2019,164173,44,1,39,16,23
2019,164173,44,2,27,14,13
2019,164173,44,3,25,12,13
2019,164173,44,4,2,1,1
2019,164173,44,5,10,2,8
2019,164216,0,0,111,49,62
2019,164216,10,0,111,49,62
2019,164216,10,1,14,6,8
2019,164216,10,2,46,23,23
2019,164216,10,3,47,18,29
2019,164216,10,4,4,2,2
2019,164216,20,0,61,29,32
2019,164216,20,1,14,6,8
2019,164216,20,2,46,23,23
2019,164216,20,3,1,0,1
2019,164216,30,0,32,13,19
2019,164216,30,3,32,13,19
2019,164216,40,0,18,7,11
2019,164216,40,3,14,5,9
2019,164216,40,4,4,2,2
2019,164216,41,0,8,3,5
2019,164216,41,3,6,3,3
2019,164216,41,4,2,0,2
2019,164216,42,0,9,3,6
2019,164216,42,3,8,2,6
2019,164216,42,4,1,1,0
2019,164216,43,0,1,1,0
2019,164216,43,4,1,1,0
2019,164216,44,0,8,3,5
2019,164216,44,3,6,3,3
2019,164216,44,4,2,0,2
2019,164270,0,0,128,61,67
2019,164270,10,0,128,61,67
2019,164270,10,1,34,19,15
2019,164270,10,2,39,20,19
2019,164270,10,3,21,8,13
2019,164270,10,4,2,2,0
2019,164270,10,5,32,12,20
2019,164270,20,0,73,39,34
2019,164270,20,1,34,19,15
2019,164270,20,2,39,20,19
2019,164270,30,0,21,8,13
2019,164270,30,3,21,8,13
2019,164270,40,0,34,14,20
2019,164270,40,4,2,2,0
2019,164270,40,5,32,12,20
2019,164270,41,0,10,5,5
2019,164270,41,5,10,5,5
2019,164270,42,0,24,9,15
2019,164270,42,4,2,2,0
2019,164270,42,5,22,7,15
2019,164270,44,0,10,5,5
2019,164270,44,5,10,5,5
2019,164313,0,0,71,24,47
2019,164313,10,0,71,24,47
2019,164313,10,1,13,3,10
2019,164313,10,2,15,6,9
2019,164313,10,3,30,10,20
2019,164313,10,4,13,5,8
2019,164313,40,0,71,24,47
2019,164313,40,1,13,3,10
2019,164313,40,2,15,6,9
2019,164313,40,3,30,10,20
2019,164313,40,4,13,5,8
2019,164313,41,0,55,17,38
2019,164313,41,1,13,3,10
2019,164313,41,2,13,5,8
2019,164313,41,3,24,7,17
2019,164313,41,4,5,2,3
2019,164313,42,0,16,7,9
2019,164313,42,2,2,1,1
2019,164313,42,3,6,3,3
2019,164313,42,4,8,3,5
2019,164313,44,0,55,17,38
2019,164313,44,1,13,3,10
2019,164313,44,2,13,5,8
2019,164313,44,3,24,7,17
2019,164313,44,4,5,2,3
2019,164368,0,0,32,24,8
2019,164368,10,0,32,24,8
2019,164368,10,1,32,24,8
2019,164368,40,0,32,24,8
2019,164368,40,1,32,24,8
2019,164368,41,0,30,22,8
2019,164368,41,1,30,22,8
2019,164368,42,0,2,2,0
2019,164368,42,1,2,2,0
2019,164368,44,0,30,22,8
2019,164368,44,1,30,22,8
2019,164447,0,0,65,25,40
2019,164447,10,0,65,25,40
2019,164447,10,1,13,4,9
2019,164447,10,2,25,14,11
2019,164447,10,3,22,5,17
2019,164447,10,4,5,2,3
2019,164447,20,0,39,19,20
2019,164447,20,1,13,4,9
2019,164447,20,2,25,14,11
2019,164447,20,3,1,1,0
2019,164447,30,0,12,2,10
2019,164447,30,3,12,2,10
2019,164447,40,0,14,4,10
2019,164447,40,3,9,2,7
2019,164447,40,4,5,2,3
2019,164447,42,0,14,4,10
2019,164447,42,3,9,2,7
2019,164447,42,4,5,2,3
2019,164465,0,0,260,132,128
2019,164465,10,0,260,132,128
2019,164465,10,1,102,58,44
2019,164465,10,2,36,20,16
2019,164465,10,3,85,42,43
2019,164465,10,4,1,0,1
2019,164465,10,5,35,12,23
2019,164465,10,6,1,0,1
2019,164465,20,0,127,72,55
2019,164465,20,1,94,54,40
2019,164465,20,2,33,18,15
2019,164465,30,0,63,32,31
2019,164465,30,3,63,32,31
2019,164465,40,0,70,28,42
2019,164465,40,1,8,4,4
2019,164465,40,2,3,2,1
2019,164465,40,3,22,10,12
2019,164465,40,4,1,0,1
2019,164465,40,5,35,12,23
2019,164465,40,6,1,0,1
2019,164465,41,0,48,20,28
2019,164465,41,1,4,1,3
2019,164465,41,2,3,2,1
2019,164465,41,3,9,6,3
2019,164465,41,4,1,0,1
2019,164465,41,5,31,11,20
2019,164465,42,0,21,7,14
2019,164465,42,1,3,2,1
2019,164465,42,3,13,4,9
2019,164465,42,5,4,1,3
2019,164465,42,6,1,0,1
2019,164465,43,0,1,1,0
2019,164465,43,1,1,1,0
2019,164465,44,0,48,20,28
2019,164465,44,1,4,1,3
2019,164465,44,2,3,2,1
2019,164465,44,3,9,6,3
2019,164465,44,4,1,0,1
2019,164465,44,5,31,11,20
2019,164492,0,0,42,18,24
2019,164492,10,0,42,18,24
2019,164492,10,1,3,1,2
2019,164492,10,2,10,5,5
2019,164492,10,3,24,9,15
2019,164492,10,4,5,3,2
2019,164492,20,0,10,3,7
2019,164492,20,1,3,1,2
2019,164492,20,2,6,2,4
2019,164492,20,3,1,0,1
2019,164492,30,0,12,8,4
2019,164492,30,2,3,3,0
2019,164492,30,3,9,5,4
2019,164492,40,0,20,7,13
2019,164492,40,2,1,0,1
2019,164492,40,3,14,4,10
2019,164492,40,4,5,3,2
2019,164492,41,0,3,0,3
2019,164492,41,2,1,0,1
2019,164492,41,3,1,0,1
2019,164492,41,4,1,0,1
2019,164492,42,0,17,7,10
2019,164492,42,3,13,4,9
2019,164492,42,4,4,3,1
2019,164492,44,0,3,0,3
2019,164492,44,2,1,0,1
2019,164492,44,3,1,0,1
2019,164492,44,4,1,0,1
2019,164562,0,0,143,81,62
2019,164562,10,0,143,81,62
2019,164562,10,1,28,20,8
2019,164562,10,2,49,25,24
2019,164562,10,3,43,24,19
2019,164562,10,4,8,4,4
2019,164562,10,6,15,8,7
2019,164562,20,0,86,50,36
2019,164562,20,1,28,20,8
2019,164562,20,2,49,25,24
2019,164562,20,3,9,5,4
2019,164562,30,0,25,14,11
2019,164562,30,3,25,14,11
2019,164562,40,0,32,17,15
2019,164562,40,3,9,5,4
2019,164562,40,4,8,4,4
2019,164562,40,6,15,8,7
2019,164562,41,0,15,8,7
2019,164562,41,6,15,8,7
2019,164562,42,0,17,9,8
2019,164562,42,3,9,5,4
2019,164562,42,4,8,4,4
2019,164562,44,0,15,8,7
2019,164562,44,6,15,8,7
2019,164580,0,0,191,115,76
2019,164580,10,0,191,115,76
2019,164580,10,1,57,36,21
2019,164580,10,2,50,34,16
2019,164580,10,3,34,15,19
2019,164580,10,5,50,30,20
2019,164580,20,0,105,69,36
2019,164580,20,1,56,35,21
2019,164580,20,2,49,34,15
2019,164580,30,0,33,14,19
2019,164580,30,2,1,0,1
2019,164580,30,3,32,14,18
2019,164580,40,0,53,32,21
2019,164580,40,1,1,1,0
2019,164580,40,3,2,1,1
2019,164580,40,5,50,30,20
2019,164580,41,0,31,18,13
2019,164580,41,1,1,1,0
2019,164580,41,5,30,17,13
2019,164580,42,0,22,14,8
2019,164580,42,3,2,1,1
2019,164580,42,5,20,13,7
2019,164580,44,0,31,18,13
2019,164580,44,1,1,1,0
2019,164580,44,5,30,17,13
2019,164632,0,0,72,13,59
2019,164632,10,0,72,13,59
2019,164632,10,1,12,3,9
2019,164632,10,2,13,4,9
2019,164632,10,3,40,5,35
2019,164632,10,4,4,1,3
2019,164632,10,6,3,0,3
2019,164632,40,0,72,13,59
2019,164632,40,1,12,3,9
2019,164632,40,2,13,4,9
2019,164632,40,3,40,5,35
2019,164632,40,4,4,1,3
2019,164632,40,6,3,0,3
2019,164632,41,0,50,11,39
2019,164632,41,1,10,3,7
2019,164632,41,2,10,4,6
2019,164632,41,3,28,3,25
2019,164632,41,4,2,1,1
2019,164632,42,0,22,2,20
2019,164632,42,1,2,0,2
2019,164632,42,2,3,0,3
2019,164632,42,3,12,2,10
2019,164632,42,4,2,0,2
2019,164632,42,6,3,0,3
2019,164632,44,0,50,11,39
2019,164632,44,1,10,3,7
2019,164632,44,2,10,4,6
2019,164632,44,3,28,3,25
2019,164632,44,4,2,1,1
2019,164641,0,0,12,2,10
2019,164641,10,0,12,2,10
2019,164641,10,1,1,1,0
2019,164641,10,3,10,1,9
2019,164641,10,4,1,0,1
2019,164641,40,0,12,2,10
2019,164641,40,1,1,1,0
2019,164641,40,3,10,1,9
2019,164641,40,4,1,0,1
2019,164641,43,0,12,2,10
2019,164641,43,1,1,1,0
2019,164641,43,3,10,1,9
2019,164641,43,4,1,0,1
2019,164720,0,0,50,23,27
2019,164720,10,0,50,23,27
2019,164720,10,1,18,8,10
2019,164720,10,2,13,6,7
2019,164720,10,3,8,5,3
2019,164720,10,4,11,4,7
2019,164720,40,0,50,23,27
2019,164720,40,1,18,8,10
2019,164720,40,2,13,6,7
2019,164720,40,3,8,5,3
2019,164720,40,4,11,4,7
2019,164720,41,0,45,20,25
2019,164720,41,1,17,7,10
2019,164720,41,2,12,6,6
2019,164720,41,3,6,4,2
2019,164720,41,4,10,3,7
2019,164720,42,0,5,3,2
2019,164720,42,1,1,1,0
2019,164720,42,2,1,0,1
2019,164720,42,3,2,1,1
2019,164720,42,4,1,1,0
2019,164720,44,0,45,20,25
2019,164720,44,1,17,7,10
2019,164720,44,2,12,6,6
2019,164720,44,3,6,4,2
2019,164720,44,4,10,3,7
2019,164739,0,0,292,164,128
2019,164739,10,0,292,164,128
2019,164739,10,1,90,53,37
2019,164739,10,2,56,31,25
2019,164739,10,3,50,24,26
2019,164739,10,5,95,56,39
2019,164739,10,6,1,0,1
2019,164739,20,0,140,81,59
2019,164739,20,1,89,52,37
2019,164739,20,2,51,29,22
2019,164739,30,0,51,25,26
2019,164739,30,2,4,2,2
2019,164739,30,3,47,23,24
2019,164739,40,0,101,58,43
2019,164739,40,1,1,1,0
2019,164739,40,2,1,0,1
2019,164739,40,3,3,1,2
2019,164739,40,5,95,56,39
2019,164739,40,6,1,0,1
2019,164739,42,0,101,58,43
2019,164739,42,1,1,1,0
2019,164739,42,2,1,0,1
2019,164739,42,3,3,1,2
2019,164739,42,5,95,56,39
2019,164739,42,6,1,0,1
2019,164748,0,0,349,231,118
2019,164748,10,0,349,231,118
2019,164748,10,1,187,127,60
2019,164748,10,2,115,74,41
2019,164748,10,3,47,30,17
2019,164748,40,0,349,231,118
2019,164748,40,1,187,127,60
2019,164748,40,2,115,74,41
2019,164748,40,3,47,30,17
2019,164748,41,0,349,231,118
2019,164748,41,1,187,127,60
2019,164748,41,2,115,74,41
2019,164748,41,3,47,30,17
2019,164748,44,0,349,231,118
2019,164748,44,1,187,127,60
2019,164748,44,2,115,74,41
2019,164748,44,3,47,30,17
2019,164775,0,0,47,14,33
2019,164775,10,0,47,14,33
2019,164775,10,1,24,10,14
2019,164775,10,2,3,0,3
2019,164775,10,3,20,4,16
2019,164775,20,0,28,11,17
2019,164775,20,1,24,10,14
2019,164775,20,2,1,0,1
2019,164775,20,3,3,1,2
2019,164775,30,0,19,3,16
2019,164775,30,2,2,0,2
2019,164775,30,3,17,3,14
2019,164872,0,0,17,11,6
2019,164872,10,0,16,11,5
2019,164872,10,6,16,11,5
2019,164872,40,0,16,11,5
2019,164872,40,6,16,11,5
2019,164872,42,0,16,11,5
2019,164872,42,6,16,11,5
2019,164872,50,0,1,0,1
2019,164924,0,0,878,509,369
2019,164924,10,0,878,509,369
2019,164924,10,1,288,192,96
2019,164924,10,2,307,161,146
2019,164924,10,3,198,112,86
2019,164924,10,4,62,30,32
2019,164924,10,5,23,14,9
2019,164924,20,0,482,295,187
2019,164924,20,1,256,173,83
2019,164924,20,2,226,122,104
2019,164924,30,0,137,80,57
2019,164924,30,2,2,1,1
2019,164924,30,3,132,78,54
2019,164924,30,4,3,1,2
2019,164924,40,0,259,134,125
2019,164924,40,1,32,19,13
2019,164924,40,2,79,38,41
2019,164924,40,3,66,34,32
2019,164924,40,4,59,29,30
2019,164924,40,5,23,14,9
2019,164924,41,0,246,132,114
2019,164924,41,1,27,19,8
2019,164924,41,2,79,38,41
2019,164924,41,3,66,34,32
2019,164924,41,4,51,27,24
2019,164924,41,5,23,14,9
2019,164924,42,0,13,2,11
2019,164924,42,1,5,0,5
2019,164924,42,4,8,2,6
2019,164924,44,0,246,132,114
2019,164924,44,1,27,19,8
2019,164924,44,2,79,38,41
2019,164924,44,3,66,34,32
2019,164924,44,4,51,27,24
2019,164924,44,5,23,14,9
2019,164988,0,0,3051,1552,1499
2019,164988,10,0,3030,1550,1480
2019,164988,10,1,642,472,170
2019,164988,10,2,531,296,235
2019,164988,10,3,781,345,436
2019,164988,10,4,239,59,180
2019,164988,10,5,371,175,196
2019,164988,10,6,466,203,263
2019,164988,20,0,700,485,215
2019,164988,20,1,421,324,97
2019,164988,20,2,279,161,118
2019,164988,30,0,203,110,93
2019,164988,30,2,5,3,2
2019,164988,30,3,198,107,91
2019,164988,40,0,2127,955,1172
2019,164988,40,1,221,148,73
2019,164988,40,2,247,132,115
2019,164988,40,3,583,238,345
2019,164988,40,4,239,59,180
2019,164988,40,5,371,175,196
2019,164988,40,6,466,203,263
2019,164988,41,0,1978,873,1105
2019,164988,41,1,215,142,73
2019,164988,41,2,231,122,109
2019,164988,41,3,548,220,328
2019,164988,41,4,227,54,173
2019,164988,41,5,323,147,176
2019,164988,41,6,434,188,246
2019,164988,42,0,145,80,65
2019,164988,42,1,6,6,0
2019,164988,42,2,16,10,6
2019,164988,42,3,34,18,16
2019,164988,42,4,12,5,7
2019,164988,42,5,48,28,20
2019,164988,42,6,29,13,16
2019,164988,43,0,4,2,2
2019,164988,43,3,1,0,1
2019,164988,43,6,3,2,1
2019,164988,44,0,930,444,486
2019,164988,44,1,101,65,36
2019,164988,44,2,113,60,53
2019,164988,44,3,132,61,71
2019,164988,44,4,6,2,4
2019,164988,44,5,323,147,176
2019,164988,44,6,255,109,146
2019,164988,45,0,1048,429,619
2019,164988,45,1,114,77,37
2019,164988,45,2,118,62,56
2019,164988,45,3,416,159,257
2019,164988,45,4,221,52,169
2019,164988,45,6,179,79,100
2019,164988,50,0,21,2,19
2019,165015,0,0,379,207,172
2019,165015,10,0,379,207,172
2019,165015,10,1,147,94,53
2019,165015,10,2,97,55,42
2019,165015,10,3,83,35,48
2019,165015,10,4,3,3,0
2019,165015,10,5,49,20,29
2019,165015,20,0,190,124,66
2019,165015,20,1,120,79,41
2019,165015,20,2,70,45,25
2019,165015,30,0,70,32,38
2019,165015,30,2,6,2,4
2019,165015,30,3,64,30,34
2019,165015,40,0,119,51,68
2019,165015,40,1,27,15,12
2019,165015,40,2,21,8,13
2019,165015,40,3,19,5,14
2019,165015,40,4,3,3,0
2019,165015,40,5,49,20,29
2019,165015,41,0,103,44,59
2019,165015,41,1,25,13,12
2019,165015,41,2,21,8,13
2019,165015,41,3,14,2,12
2019,165015,41,4,3,3,0
2019,165015,41,5,40,18,22
2019,165015,42,0,16,7,9
2019,165015,42,1,2,2,0
2019,165015,42,3,5,3,2
2019,165015,42,5,9,2,7
2019,165015,44,0,103,44,59
2019,165015,44,1,25,13,12
2019,165015,44,2,21,8,13
2019,165015,44,3,14,2,12
2019,165015,44,4,3,3,0
2019,165015,44,5,40,18,22
2019,165024,0,0,361,166,195
2019,165024,10,0,361,166,195
2019,165024,10,1,139,73,66
2019,165024,10,2,95,47,48
2019,165024,10,3,111,38,73
2019,165024,10,4,16,8,8
2019,165024,20,0,234,119,115
2019,165024,20,1,139,73,66
2019,165024,20,2,90,45,45
2019,165024,20,3,5,1,4
2019,165024,30,0,98,37,61
2019,165024,30,2,5,2,3
2019,165024,30,3,92,34,58
2019,165024,30,4,1,1,0
2019,165024,40,0,29,10,19
2019,165024,40,3,14,3,11
2019,165024,40,4,15,7,8
2019,165024,42,0,29,10,19
2019,165024,42,3,14,3,11
2019,165024,42,4,15,7,8
2019,165033,0,0,125,42,83
2019,165033,10,0,125,42,83
2019,165033,10,1,50,15,35
2019,165033,10,2,52,18,34
2019,165033,10,3,19,9,10
2019,165033,10,4,4,0,4
2019,165033,20,0,81,25,56
2019,165033,20,1,47,14,33
2019,165033,20,2,33,10,23
2019,165033,20,3,1,1,0
2019,165033,30,0,44,17,27
2019,165033,30,1,3,1,2
2019,165033,30,2,19,8,11
2019,165033,30,3,18,8,10
2019,165033,30,4,4,0,4
2019,165112,0,0,147,58,89
2019,165112,10,0,147,58,89
2019,165112,10,1,90,34,56
2019,165112,10,2,30,14,16
2019,165112,10,3,27,10,17
2019,165112,20,0,100,42,58
2019,165112,20,1,88,33,55
2019,165112,20,2,9,8,1
2019,165112,20,3,3,1,2
2019,165112,30,0,47,16,31
2019,165112,30,1,2,1,1
2019,165112,30,2,21,6,15
2019,165112,30,3,24,9,15
2019,165167,0,0,16,7,9
2019,165167,10,0,16,7,9
2019,165167,10,1,11,5,6
2019,165167,10,2,2,1,1
2019,165167,10,3,2,1,1
2019,165167,10,5,1,0,1
2019,165167,40,0,16,7,9
2019,165167,40,1,11,5,6
2019,165167,40,2,2,1,1
2019,165167,40,3,2,1,1
2019,165167,40,5,1,0,1
2019,165167,41,0,15,7,8
2019,165167,41,1,11,5,6
2019,165167,41,2,2,1,1
2019,165167,41,3,2,1,1
2019,165167,42,0,1,0,1
2019,165167,42,5,1,0,1
2019,165167,45,0,15,7,8
2019,165167,45,1,11,5,6
2019,165167,45,2,2,1,1
2019,165167,45,3,2,1,1
2019,165194,0,0,71,32,39
2019,165194,10,0,71,32,39
2019,165194,10,1,33,16,17
2019,165194,10,2,20,8,12
2019,165194,10,3,15,6,9
2019,165194,10,4,3,2,1
2019,165194,20,0,43,19,24
2019,165194,20,1,28,12,16
2019,165194,20,2,14,7,7
2019,165194,20,3,1,0,1
2019,165194,30,0,28,13,15
2019,165194,30,1,5,4,1
2019,165194,30,2,6,1,5
2019,165194,30,3,14,6,8
2019,165194,30,4,3,2,1
2019,165264,0,0,57,6,51
2019,165264,10,0,50,5,45
2019,165264,10,1,1,1,0
2019,165264,10,2,8,2,6
2019,165264,10,3,17,2,15
2019,165264,10,4,24,0,24
2019,165264,40,0,50,5,45
2019,165264,40,1,1,1,0
2019,165264,40,2,8,2,6
2019,165264,40,3,17,2,15
2019,165264,40,4,24,0,24
2019,165264,41,0,26,5,21
2019,165264,41,1,1,1,0
2019,165264,41,2,8,2,6
2019,165264,41,3,17,2,15
2019,165264,42,0,24,0,24
2019,165264,42,4,24,0,24
2019,165264,44,0,26,5,21
2019,165264,44,1,1,1,0
2019,165264,44,2,8,2,6
2019,165264,44,3,17,2,15
2019,165264,50,0,7,1,6
2019,165334,0,0,206,112,94
2019,165334,10,0,206,112,94
2019,165334,10,1,69,42,27
2019,165334,10,2,55,31,24
2019,165334,10,3,37,18,19
2019,165334,10,4,24,7,17
2019,165334,10,5,21,14,7
2019,165334,20,0,121,72,49
2019,165334,20,1,68,41,27
2019,165334,20,2,53,31,22
2019,165334,30,0,38,18,20
2019,165334,30,2,2,0,2
2019,165334,30,3,36,18,18
2019,165334,40,0,47,22,25
2019,165334,40,1,1,1,0
2019,165334,40,3,1,0,1
2019,165334,40,4,24,7,17
2019,165334,40,5,21,14,7
2019,165334,41,0,23,15,8
2019,165334,41,1,1,1,0
2019,165334,41,3,1,0,1
2019,165334,41,5,21,14,7
2019,165334,42,0,24,7,17
2019,165334,42,4,24,7,17
2019,165334,44,0,23,15,8
2019,165334,44,1,1,1,0
2019,165334,44,3,1,0,1
2019,165334,44,5,21,14,7
2019,165529,0,0,116,31,85
2019,165529,10,0,116,31,85
2019,165529,10,1,53,15,38
2019,165529,10,2,23,6,17
2019,165529,10,3,37,10,27
2019,165529,10,4,3,0,3
2019,165529,20,0,1,1,0
2019,165529,20,1,1,1,0
2019,165529,40,0,115,30,85
2019,165529,40,1,52,14,38
2019,165529,40,2,23,6,17
2019,165529,40,3,37,10,27
2019,165529,40,4,3,0,3
2019,165529,41,0,83,21,62
2019,165529,41,1,51,14,37
2019,165529,41,2,20,5,15
2019,165529,41,3,12,2,10
2019,165529,42,0,32,9,23
2019,165529,42,1,1,0,1
2019,165529,42,2,3,1,2
2019,165529,42,3,25,8,17
2019,165529,42,4,3,0,3
2019,165529,44,0,83,21,62
2019,165529,44,1,51,14,37
2019,165529,44,2,20,5,15
2019,165529,44,3,12,2,10
2019,165574,0,0,31,17,14
2019,165574,10,0,31,17,14
2019,165574,10,1,4,2,2
2019,165574,10,2,10,6,4
2019,165574,10,3,16,8,8
2019,165574,10,6,1,1,0
2019,165574,40,0,31,17,14
2019,165574,40,1,4,2,2
2019,165574,40,2,10,6,4
2019,165574,40,3,16,8,8
2019,165574,40,6,1,1,0
2019,165574,42,0,31,17,14
2019,165574,42,1,4,2,2
2019,165574,42,2,10,6,4
2019,165574,42,3,16,8,8
2019,165574,42,6,1,1,0
2019,165644,0,0,32,21,11
2019,165644,10,0,32,21,11
2019,165644,10,1,6,6,0
2019,165644,10,2,5,4,1
2019,165644,10,3,16,9,7
2019,165644,10,4,5,2,3
2019,165644,20,0,9,9,0
2019,165644,20,1,6,6,0
2019,165644,20,2,3,3,0
2019,165644,30,0,10,4,6
2019,165644,30,3,10,4,6
2019,165644,40,0,13,8,5
2019,165644,40,2,2,1,1
2019,165644,40,3,6,5,1
2019,165644,40,4,5,2,3
2019,165644,41,0,2,2,0
2019,165644,41,3,2,2,0
2019,165644,42,0,11,6,5
2019,165644,42,2,2,1,1
2019,165644,42,3,4,3,1
2019,165644,42,4,5,2,3
2019,165644,44,0,2,2,0
2019,165644,44,3,2,2,0
2019,165662,0,0,212,113,99
2019,165662,10,0,212,113,99
2019,165662,10,1,41,23,18
2019,165662,10,2,54,34,20
2019,165662,10,3,55,26,29
2019,165662,10,5,62,30,32
2019,165662,20,0,95,57,38
2019,165662,20,1,41,23,18
2019,165662,20,2,54,34,20
2019,165662,30,0,55,26,29
2019,165662,30,3,55,26,29
2019,165662,40,0,62,30,32
2019,165662,40,5,62,30,32
2019,165662,42,0,62,30,32
2019,165662,42,5,62,30,32
2019,165671,0,0,99,39,60
2019,165671,10,0,99,39,60
2019,165671,10,1,16,2,14
2019,165671,10,2,35,20,15
2019,165671,10,3,28,9,19
2019,165671,10,5,20,8,12
2019,165671,20,0,45,20,25
2019,165671,20,1,15,2,13
2019,165671,20,2,30,18,12
2019,165671,30,0,11,3,8
2019,165671,30,2,1,0,1
2019,165671,30,3,10,3,7
2019,165671,40,0,43,16,27
2019,165671,40,1,1,0,1
2019,165671,40,2,4,2,2
2019,165671,40,3,18,6,12
2019,165671,40,5,20,8,12
2019,165671,42,0,43,16,27
2019,165671,42,1,1,0,1
2019,165671,42,2,4,2,2
2019,165671,42,3,18,6,12
2019,165671,42,5,20,8,12
2019,165699,0,0,112,44,68
2019,165699,10,0,112,44,68
2019,165699,10,1,39,21,18
2019,165699,10,2,35,11,24
2019,165699,10,3,37,12,25
2019,165699,10,4,1,0,1
2019,165699,40,0,112,44,68
2019,165699,40,1,39,21,18
2019,165699,40,2,35,11,24
2019,165699,40,3,37,12,25
2019,165699,40,4,1,0,1
2019,165699,41,0,112,44,68
2019,165699,41,1,39,21,18
2019,165699,41,2,35,11,24
2019,165699,41,3,37,12,25
2019,165699,41,4,1,0,1
2019,165699,45,0,112,44,68
2019,165699,45,1,39,21,18
2019,165699,45,2,35,11,24
2019,165699,45,3,37,12,25
2019,165699,45,4,1,0,1
2019,165802,0,0,36,14,22
2019,165802,10,0,36,14,22
2019,165802,10,1,2,2,0
2019,165802,10,2,11,4,7
2019,165802,10,3,23,8,15
2019,165802,40,0,36,14,22
2019,165802,40,1,2,2,0
2019,165802,40,2,11,4,7
2019,165802,40,3,23,8,15
2019,165802,42,0,36,14,22
2019,165802,42,1,2,2,0
2019,165802,42,2,11,4,7
2019,165802,42,3,23,8,15
2019,165820,0,0,206,98,108
2019,165820,10,0,206,98,108
2019,165820,10,1,70,42,28
2019,165820,10,2,66,32,34
2019,165820,10,3,60,23,37
2019,165820,10,4,10,1,9
2019,165820,20,0,129,72,57
2019,165820,20,1,70,42,28
2019,165820,20,2,59,30,29
2019,165820,30,0,65,24,41
2019,165820,30,2,7,2,5
2019,165820,30,3,58,22,36
2019,165820,40,0,12,2,10
2019,165820,40,3,2,1,1
2019,165820,40,4,10,1,9
2019,165820,42,0,12,2,10
2019,165820,42,3,2,1,1
2019,165820,42,4,10,1,9
2019,165866,0,0,198,85,113
2019,165866,10,0,198,85,113
2019,165866,10,1,60,24,36
2019,165866,10,2,64,30,34
2019,165866,10,3,65,28,37
2019,165866,10,4,9,3,6
2019,165866,20,0,121,53,68
2019,165866,20,1,60,24,36
2019,165866,20,2,58,28,30
2019,165866,20,3,3,1,2
2019,165866,30,0,57,23,34
2019,165866,30,2,6,2,4
2019,165866,30,3,51,21,30
2019,165866,40,0,20,9,11
2019,165866,40,3,11,6,5
2019,165866,40,4,9,3,6
2019,165866,41,0,11,6,5
2019,165866,41,3,11,6,5
2019,165866,42,0,9,3,6
2019,165866,42,4,9,3,6
2019,165866,44,0,11,6,5
2019,165866,44,3,11,6,5
2019,165884,0,0,43,32,11
2019,165884,10,0,43,32,11
2019,165884,10,1,7,4,3
2019,165884,10,2,12,12,0
2019,165884,10,3,14,9,5
2019,165884,10,4,10,7,3
2019,165884,40,0,43,32,11
2019,165884,40,1,7,4,3
2019,165884,40,2,12,12,0
2019,165884,40,3,14,9,5
2019,165884,40,4,10,7,3
2019,165884,42,0,43,32,11
2019,165884,42,1,7,4,3
2019,165884,42,2,12,12,0
2019,165884,42,3,14,9,5
2019,165884,42,4,10,7,3
2019,165936,0,0,86,51,35
2019,165936,10,0,85,51,34
2019,165936,10,1,48,36,12
2019,165936,10,2,18,8,10
2019,165936,10,3,19,7,12
2019,165936,20,0,52,35,17
2019,165936,20,1,44,32,12
2019,165936,20,2,8,3,5
2019,165936,30,0,17,8,9
2019,165936,30,1,2,2,0
2019,165936,30,2,6,3,3
2019,165936,30,3,9,3,6
2019,165936,40,0,16,8,8
2019,165936,40,1,2,2,0
2019,165936,40,2,4,2,2
2019,165936,40,3,10,4,6
2019,165936,42,0,16,8,8
2019,165936,42,1,2,2,0
2019,165936,42,2,4,2,2
2019,165936,42,3,10,4,6
2019,165936,50,0,1,0,1
2019,165945,0,0,32,20,12
2019,165945,10,0,32,20,12
2019,165945,10,1,14,12,2
2019,165945,10,2,10,6,4
2019,165945,10,3,7,2,5
2019,165945,10,4,1,0,1
2019,165945,20,0,21,16,5
2019,165945,20,1,14,12,2
2019,165945,20,2,6,3,3
2019,165945,20,3,1,1,0
2019,165945,30,0,8,4,4
2019,165945,30,2,4,3,1
2019,165945,30,3,4,1,3
2019,165945,40,0,3,0,3
2019,165945,40,3,2,0,2
2019,165945,40,4,1,0,1
2019,165945,42,0,3,0,3
2019,165945,42,3,2,0,2
2019,165945,42,4,1,0,1
2019,165981,0,0,49,15,34
2019,165981,10,0,49,15,34
2019,165981,10,1,25,8,17
2019,165981,10,2,11,2,9
2019,165981,10,3,10,3,7
2019,165981,10,4,3,2,1
2019,165981,20,0,37,10,27
2019,165981,20,1,25,8,17
2019,165981,20,2,11,2,9
2019,165981,20,3,1,0,1
2019,165981,30,0,11,4,7
2019,165981,30,3,8,2,6
2019,165981,30,4,3,2,1
2019,165981,40,0,1,1,0
2019,165981,40,3,1,1,0
2019,165981,42,0,1,1,0
2019,165981,42,3,1,1,0
2019,166018,0,0,57,28,29
2019,166018,10,0,57,28,29
2019,166018,10,1,16,8,8
2019,166018,10,2,15,6,9
2019,166018,10,3,18,8,10
2019,166018,10,5,7,6,1
2019,166018,10,6,1,0,1
2019,166018,40,0,57,28,29
2019,166018,40,1,16,8,8
2019,166018,40,2,15,6,9
2019,166018,40,3,18,8,10
2019,166018,40,5,7,6,1
2019,166018,40,6,1,0,1
2019,166018,41,0,54,27,27
2019,166018,41,1,16,8,8
2019,166018,41,2,15,6,9
2019,166018,41,3,15,7,8
2019,166018,41,5,7,6,1
2019,166018,41,6,1,0,1
2019,166018,42,0,3,1,2
2019,166018,42,3,3,1,2
2019,166018,44,0,54,27,27
2019,166018,44,1,16,8,8
2019,166018,44,2,15,6,9
2019,166018,44,3,15,7,8
2019,166018,44,5,7,6,1
2019,166018,44,6,1,0,1
2019,166027,0,0,2155,1384,771
2019,166027,10,0,2155,1384,771
2019,166027,10,1,1194,880,314
2019,166027,10,2,183,105,78
2019,166027,10,3,266,142,124
2019,166027,10,4,197,93,104
2019,166027,10,5,315,164,151
2019,166027,20,0,1082,804,278
2019,166027,20,1,1082,804,278
2019,166027,30,0,403,229,174
2019,166027,30,2,172,100,72
2019,166027,30,3,231,129,102
2019,166027,40,0,670,351,319
2019,166027,40,1,112,76,36
2019,166027,40,2,11,5,6
2019,166027,40,3,35,13,22
2019,166027,40,4,197,93,104
2019,166027,40,5,315,164,151
2019,166027,41,0,302,181,121
2019,166027,41,1,96,63,33
2019,166027,41,2,7,2,5
2019,166027,41,3,27,13,14
2019,166027,41,4,73,40,33
2019,166027,41,5,99,63,36
2019,166027,42,0,368,170,198
2019,166027,42,1,16,13,3
2019,166027,42,2,4,3,1
2019,166027,42,3,8,0,8
2019,166027,42,4,124,53,71
2019,166027,42,5,216,101,115
2019,166027,44,0,295,176,119
2019,166027,44,1,89,58,31
2019,166027,44,2,7,2,5
2019,166027,44,3,27,13,14
2019,166027,44,4,73,40,33
2019,166027,44,5,99,63,36
2019,166027,45,0,7,5,2
2019,166027,45,1,7,5,2
2019,166045,0,0,9,6,3
2019,166045,10,0,9,6,3
2019,166045,10,1,2,2,0
2019,166045,10,2,1,0,1
2019,166045,10,3,2,1,1
2019,166045,10,4,4,3,1
2019,166045,20,0,4,2,2
2019,166045,20,1,1,1,0
2019,166045,20,2,1,0,1
2019,166045,20,3,2,1,1
2019,166045,40,0,5,4,1
2019,166045,40,1,1,1,0
2019,166045,40,4,4,3,1
2019,166045,41,0,5,4,1
2019,166045,41,1,1,1,0
2019,166045,41,4,4,3,1
2019,166045,45,0,5,4,1
2019,166045,45,1,1,1,0
2019,166045,45,4,4,3,1
2019,166054,0,0,22,14,8
2019,166054,10,0,22,14,8
2019,166054,10,1,10,6,4
2019,166054,10,3,12,8,4
2019,166054,20,0,10,6,4
2019,166054,20,1,10,6,4
2019,166054,30,0,5,4,1
2019,166054,30,3,5,4,1
2019,166054,40,0,7,4,3
2019,166054,40,3,7,4,3
2019,166054,41,0,1,0,1
2019,166054,41,3,1,0,1
2019,166054,42,0,6,4,2
2019,166054,42,3,6,4,2
2019,166054,44,0,1,0,1
2019,166054,44,3,1,0,1
2019,166124,0,0,296,151,145
2019,166124,10,0,296,151,145
2019,166124,10,1,102,58,44
2019,166124,10,2,91,49,42
2019,166124,10,3,76,36,40
2019,166124,10,4,6,2,4
2019,166124,10,5,21,6,15
2019,166124,20,0,189,104,85
2019,166124,20,1,98,55,43
2019,166124,20,2,91,49,42
2019,166124,30,0,35,19,16
2019,166124,30,3,35,19,16
2019,166124,40,0,72,28,44
2019,166124,40,1,4,3,1
2019,166124,40,3,41,17,24
2019,166124,40,4,6,2,4
2019,166124,40,5,21,6,15
2019,166124,41,0,26,8,18
2019,166124,41,3,5,2,3
2019,166124,41,5,21,6,15
2019,166124,42,0,46,20,26
2019,166124,42,1,4,3,1
2019,166124,42,3,36,15,21
2019,166124,42,4,6,2,4
2019,166124,44,0,5,2,3
2019,166124,44,3,5,2,3
2019,166124,45,0,21,6,15
2019,166124,45,5,21,6,15
2019,166133,0,0,118,39,79
2019,166133,10,0,118,39,79
2019,166133,10,1,73,28,45
2019,166133,10,2,15,4,11
2019,166133,10,3,18,4,14
2019,166133,10,4,12,3,9
2019,166133,20,0,84,31,53
2019,166133,20,1,73,28,45
2019,166133,20,2,10,3,7
2019,166133,20,3,1,0,1
2019,166133,30,0,33,8,25
2019,166133,30,2,5,1,4
2019,166133,30,3,17,4,13
2019,166133,30,4,11,3,8
2019,166133,40,0,1,0,1
2019,166133,40,4,1,0,1
2019,166133,42,0,1,0,1
2019,166133,42,4,1,0,1
2019,166391,0,0,82,30,52
2019,166391,10,0,82,30,52
2019,166391,10,1,8,1,7
2019,166391,10,2,43,18,25
2019,166391,10,3,27,9,18
2019,166391,10,4,4,2,2
2019,166391,40,0,82,30,52
2019,166391,40,1,8,1,7
2019,166391,40,2,43,18,25
2019,166391,40,3,27,9,18
2019,166391,40,4,4,2,2
2019,166391,41,0,76,28,48
2019,166391,41,1,8,1,7
2019,166391,41,2,42,18,24
2019,166391,41,3,25,9,16
2019,166391,41,4,1,0,1
2019,166391,42,0,6,2,4
2019,166391,42,2,1,0,1
2019,166391,42,3,2,0,2
2019,166391,42,4,3,2,1
2019,166391,44,0,76,28,48
2019,166391,44,1,8,1,7
2019,166391,44,2,42,18,24
2019,166391,44,3,25,9,16
2019,166391,44,4,1,0,1
2019,166407,0,0,36,3,33
2019,166407,10,0,36,3,33
2019,166407,10,2,2,0,2
2019,166407,10,3,31,2,29
2019,166407,10,4,3,1,2
2019,166407,40,0,36,3,33
2019,166407,40,2,2,0,2
2019,166407,40,3,31,2,29
2019,166407,40,4,3,1,2
2019,166407,41,0,36,3,33
2019,166407,41,2,2,0,2
2019,166407,41,3,31,2,29
2019,166407,41,4,3,1,2
2019,166407,44,0,36,3,33
2019,166407,44,2,2,0,2
2019,166407,44,3,31,2,29
2019,166407,44,4,3,1,2
2019,166452,0,0,149,51,98
2019,166452,10,0,149,51,98
2019,166452,10,1,42,17,25
2019,166452,10,2,55,20,35
2019,166452,10,3,43,11,32
2019,166452,10,4,9,3,6
2019,166452,40,0,149,51,98
2019,166452,40,1,42,17,25
2019,166452,40,2,55,20,35
2019,166452,40,3,43,11,32
2019,166452,40,4,9,3,6
2019,166452,41,0,144,49,95
2019,166452,41,1,42,17,25
2019,166452,41,2,55,20,35
2019,166452,41,3,42,11,31
2019,166452,41,4,5,1,4
2019,166452,42,0,5,2,3
2019,166452,42,3,1,0,1
2019,166452,42,4,4,2,2
2019,166452,44,0,144,49,95
2019,166452,44,1,42,17,25
2019,166452,44,2,55,20,35
2019,166452,44,3,42,11,31
2019,166452,44,4,5,1,4
2019,166489,0,0,23,16,7
2019,166489,10,0,23,16,7
2019,166489,10,1,23,16,7
2019,166489,40,0,23,16,7
2019,166489,40,1,23,16,7
2019,166489,41,0,23,16,7
2019,166489,41,1,23,16,7
2019,166489,44,0,23,16,7
2019,166489,44,1,23,16,7
2019,166513,0,0,647,355,292
2019,166513,10,0,643,355,288
2019,166513,10,1,152,111,41
2019,166513,10,2,154,76,78
2019,166513,10,3,154,88,66
2019,166513,10,4,7,0,7
2019,166513,10,5,119,54,65
2019,166513,10,6,57,26,31
2019,166513,20,0,288,177,111
2019,166513,20,1,148,109,39
2019,166513,20,2,140,68,72
2019,166513,30,0,157,95,62
2019,166513,30,1,1,1,0
2019,166513,30,2,9,6,3
2019,166513,30,3,147,88,59
2019,166513,40,0,198,83,115
2019,166513,40,1,3,1,2
2019,166513,40,2,5,2,3
2019,166513,40,3,7,0,7
2019,166513,40,4,7,0,7
2019,166513,40,5,119,54,65
2019,166513,40,6,57,26,31
2019,166513,41,0,8,3,5
2019,166513,41,1,3,1,2
2019,166513,41,2,5,2,3
2019,166513,42,0,190,80,110
2019,166513,42,3,7,0,7
2019,166513,42,4,7,0,7
2019,166513,42,5,119,54,65
2019,166513,42,6,57,26,31
2019,166513,45,0,8,3,5
2019,166513,45,1,3,1,2
2019,166513,45,2,5,2,3
2019,166513,50,0,4,0,4
2019,166629,0,0,1461,797,664
2019,166629,10,0,1461,797,664
2019,166629,10,1,451,320,131
2019,166629,10,2,352,176,176
2019,166629,10,3,306,148,158
2019,166629,10,4,3,0,3
2019,166629,10,5,349,153,196
2019,166629,20,0,783,489,294
2019,166629,20,1,449,319,130
2019,166629,20,2,333,169,164
2019,166629,20,3,1,1,0
2019,166629,30,0,300,150,150
2019,166629,30,2,11,4,7
2019,166629,30,3,289,146,143
2019,166629,40,0,378,158,220
2019,166629,40,1,2,1,1
2019,166629,40,2,8,3,5
2019,166629,40,3,16,1,15
2019,166629,40,4,3,0,3
2019,166629,40,5,349,153,196
2019,166629,41,0,335,137,198
2019,166629,41,1,2,1,1
2019,166629,41,2,7,3,4
2019,166629,41,3,14,1,13
2019,166629,41,5,312,132,180
2019,166629,42,0,43,21,22
2019,166629,42,2,1,0,1
2019,166629,42,3,2,0,2
2019,166629,42,4,3,0,3
2019,166629,42,5,37,21,16
2019,166629,44,0,335,137,198
2019,166629,44,1,2,1,1
2019,166629,44,2,7,3,4
2019,166629,44,3,14,1,13
2019,166629,44,5,312,132,180
2019,166638,0,0,689,346,343
2019,166638,10,0,689,346,343
2019,166638,10,1,124,77,47
2019,166638,10,2,227,113,114
2019,166638,10,3,124,57,67
2019,166638,10,5,199,93,106
2019,166638,10,6,15,6,9
2019,166638,20,0,349,189,160
2019,166638,20,1,124,77,47
2019,166638,20,2,224,112,112
2019,166638,20,3,1,0,1
2019,166638,30,0,125,57,68
2019,166638,30,2,3,1,2
2019,166638,30,3,122,56,66
2019,166638,40,0,215,100,115
2019,166638,40,3,1,1,0
2019,166638,40,5,199,93,106
2019,166638,40,6,15,6,9
2019,166638,41,0,2,1,1
2019,166638,41,5,2,1,1
2019,166638,42,0,109,49,60
2019,166638,42,5,103,45,58
2019,166638,42,6,6,4,2
2019,166638,43,0,104,50,54
2019,166638,43,3,1,1,0
2019,166638,43,5,94,47,47
2019,166638,43,6,9,2,7
2019,166638,44,0,2,1,1
2019,166638,44,5,2,1,1
2019,166647,0,0,67,31,36
2019,166647,10,0,67,31,36
2019,166647,10,1,27,9,18
2019,166647,10,2,18,10,8
2019,166647,10,3,22,12,10
2019,166647,20,0,45,19,26
2019,166647,20,1,27,9,18
2019,166647,20,2,15,9,6
2019,166647,20,3,3,1,2
2019,166647,30,0,22,12,10
2019,166647,30,2,3,1,2
2019,166647,30,3,19,11,8
2019,166656,0,0,296,103,193
2019,166656,10,0,296,103,193
2019,166656,10,1,50,18,32
2019,166656,10,2,99,41,58
2019,166656,10,3,118,29,89
2019,166656,10,4,16,9,7
2019,166656,10,6,13,6,7
2019,166656,40,0,296,103,193
2019,166656,40,1,50,18,32
2019,166656,40,2,99,41,58
2019,166656,40,3,118,29,89
2019,166656,40,4,16,9,7
2019,166656,40,6,13,6,7
2019,166656,41,0,247,83,164
2019,166656,41,1,49,17,32
2019,166656,41,2,96,40,56
2019,166656,41,3,102,26,76
2019,166656,42,0,49,20,29
2019,166656,42,1,1,1,0
2019,166656,42,2,3,1,2
2019,166656,42,3,16,3,13
2019,166656,42,4,16,9,7
2019,166656,42,6,13,6,7
2019,166656,44,0,247,83,164
2019,166656,44,1,49,17,32
2019,166656,44,2,96,40,56
2019,166656,44,3,102,26,76
2019,166674,0,0,121,66,55
2019,166674,10,0,121,66,55
2019,166674,10,1,64,35,29
2019,166674,10,2,20,11,9
2019,166674,10,3,37,20,17
2019,166674,20,0,73,39,34
2019,166674,20,1,64,35,29
2019,166674,20,2,9,4,5
2019,166674,30,0,21,10,11
2019,166674,30,2,9,5,4
2019,166674,30,3,12,5,7
2019,166674,40,0,27,17,10
2019,166674,40,2,2,2,0
2019,166674,40,3,25,15,10
2019,166674,42,0,25,15,10
2019,166674,42,2,2,2,0
2019,166674,42,3,23,13,10
2019,166674,43,0,2,2,0
2019,166674,43,3,2,2,0
2019,166683,0,0,1372,986,386
2019,166683,10,0,1028,775,253
2019,166683,10,1,650,524,126
2019,166683,10,2,224,156,68
2019,166683,10,3,153,95,58
2019,166683,10,6,1,0,1
2019,166683,20,0,790,622,168
2019,166683,20,1,650,524,126
2019,166683,20,2,140,98,42
2019,166683,30,0,227,146,81
2019,166683,30,2,77,53,24
2019,166683,30,3,150,93,57
2019,166683,40,0,11,7,4
2019,166683,40,2,7,5,2
2019,166683,40,3,3,2,1
2019,166683,40,6,1,0,1
2019,166683,41,0,11,7,4
2019,166683,41,2,7,5,2
2019,166683,41,3,3,2,1
2019,166683,41,6,1,0,1
2019,166683,44,0,11,7,4
2019,166683,44,2,7,5,2
2019,166683,44,3,3,2,1
2019,166683,44,6,1,0,1
2019,166683,50,0,344,211,133
2019,166692,0,0,88,59,29
2019,166692,10,0,88,59,29
2019,166692,10,1,37,26,11
2019,166692,10,2,19,14,5
2019,166692,10,3,27,17,10
2019,166692,10,4,5,2,3
2019,166692,20,0,51,35,16
2019,166692,20,1,36,26,10
2019,166692,20,2,13,8,5
2019,166692,20,3,2,1,1
2019,166692,30,0,37,24,13
2019,166692,30,1,1,0,1
2019,166692,30,2,6,6,0
2019,166692,30,3,25,16,9
2019,166692,30,4,5,2,3
2019,166708,0,0,1268,724,544
2019,166708,10,0,980,574,406
2019,166708,10,1,203,138,65
2019,166708,10,2,222,144,78
2019,166708,10,3,512,273,239
2019,166708,10,4,43,19,24
2019,166708,20,0,127,91,36
2019,166708,20,1,106,77,29
2019,166708,20,2,21,14,7
2019,166708,30,0,55,35,20
2019,166708,30,1,6,2,4
2019,166708,30,2,24,19,5
2019,166708,30,3,25,14,11
2019,166708,40,0,798,448,350
2019,166708,40,1,91,59,32
2019,166708,40,2,177,111,66
2019,166708,40,3,487,259,228
2019,166708,40,4,43,19,24
2019,166708,41,0,793,443,350
2019,166708,41,1,87,55,32
2019,166708,41,2,177,111,66
2019,166708,41,3,486,258,228
2019,166708,41,4,43,19,24
2019,166708,43,0,5,5,0
2019,166708,43,1,4,4,0
2019,166708,43,3,1,1,0
2019,166708,44,0,25,2,23
2019,166708,44,1,5,0,5
2019,166708,44,2,6,1,5
2019,166708,44,3,10,1,9
2019,166708,44,4,4,0,4
2019,166708,45,0,768,441,327
2019,166708,45,1,82,55,27
2019,166708,45,2,171,110,61
2019,166708,45,3,476,257,219
2019,166708,45,4,39,19,20
2019,166708,50,0,288,150,138
2019,166717,0,0,71,27,44
2019,166717,10,0,71,27,44
2019,166717,10,1,7,3,4
2019,166717,10,2,24,13,11
2019,166717,10,3,28,9,19
2019,166717,10,4,12,2,10
2019,166717,40,0,71,27,44
2019,166717,40,1,7,3,4
2019,166717,40,2,24,13,11
2019,166717,40,3,28,9,19
2019,166717,40,4,12,2,10
2019,166717,41,0,71,27,44
2019,166717,41,1,7,3,4
2019,166717,41,2,24,13,11
2019,166717,41,3,28,9,19
2019,166717,41,4,12,2,10
2019,166717,44,0,71,27,44
2019,166717,44,1,7,3,4
2019,166717,44,2,24,13,11
2019,166717,44,3,28,9,19
2019,166717,44,4,12,2,10
2019,166823,0,0,113,49,64
2019,166823,10,0,113,49,64
2019,166823,10,1,42,23,19
2019,166823,10,2,40,17,23
2019,166823,10,3,23,7,16
2019,166823,10,4,8,2,6
2019,166823,20,0,84,41,43
2019,166823,20,1,42,23,19
2019,166823,20,2,35,15,20
2019,166823,20,3,7,3,4
2019,166823,30,0,29,8,21
2019,166823,30,2,5,2,3
2019,166823,30,3,16,4,12
2019,166823,30,4,8,2,6
2019,166850,0,0,200,90,110
2019,166850,10,0,200,90,110
2019,166850,10,1,32,20,12
2019,166850,10,2,77,35,42
2019,166850,10,3,77,31,46
2019,166850,10,5,14,4,10
2019,166850,20,0,86,46,40
2019,166850,20,1,30,19,11
2019,166850,20,2,56,27,29
2019,166850,30,0,64,28,36
2019,166850,30,2,2,2,0
2019,166850,30,3,62,26,36
2019,166850,40,0,50,16,34
2019,166850,40,1,2,1,1
2019,166850,40,2,19,6,13
2019,166850,40,3,15,5,10
2019,166850,40,5,14,4,10
2019,166850,42,0,50,16,34
2019,166850,42,1,2,1,1
2019,166850,42,2,19,6,13
2019,166850,42,3,15,5,10
2019,166850,42,5,14,4,10
2019,166869,0,0,99,15,84
2019,166869,10,0,99,15,84
2019,166869,10,1,10,1,9
2019,166869,10,2,17,4,13
2019,166869,10,3,52,8,44
2019,166869,10,4,20,2,18
2019,166869,40,0,99,15,84
2019,166869,40,1,10,1,9
2019,166869,40,2,17,4,13
2019,166869,40,3,52,8,44
2019,166869,40,4,20,2,18
2019,166869,41,0,99,15,84
2019,166869,41,1,10,1,9
2019,166869,41,2,17,4,13
2019,166869,41,3,52,8,44
2019,166869,41,4,20,2,18
2019,166869,44,0,99,15,84
2019,166869,44,1,10,1,9
2019,166869,44,2,17,4,13
2019,166869,44,3,52,8,44
2019,166869,44,4,20,2,18
2019,166887,0,0,120,39,81
2019,166887,10,0,120,39,81
2019,166887,10,1,70,25,45
2019,166887,10,2,20,6,14
2019,166887,10,3,30,8,22
2019,166887,20,0,78,28,50
2019,166887,20,1,69,25,44
2019,166887,20,2,8,3,5
2019,166887,20,3,1,0,1
2019,166887,30,0,42,11,31
2019,166887,30,1,1,0,1
2019,166887,30,2,12,3,9
2019,166887,30,3,29,8,21
2019,166911,0,0,17,9,8
2019,166911,10,0,17,9,8
2019,166911,10,1,12,6,6
2019,166911,10,2,4,3,1
2019,166911,10,3,1,0,1
2019,166911,40,0,17,9,8
2019,166911,40,1,12,6,6
2019,166911,40,2,4,3,1
2019,166911,40,3,1,0,1
2019,166911,41,0,16,8,8
2019,166911,41,1,11,5,6
2019,166911,41,2,4,3,1
2019,166911,41,3,1,0,1
2019,166911,42,0,1,1,0
2019,166911,42,1,1,1,0
2019,166911,44,0,16,8,8
2019,166911,44,1,11,5,6
2019,166911,44,2,4,3,1
2019,166911,44,3,1,0,1
2019,166939,0,0,227,94,133
2019,166939,10,0,227,94,133
2019,166939,10,1,71,33,38
2019,166939,10,2,45,17,28
2019,166939,10,3,54,24,30
2019,166939,10,4,8,2,6
2019,166939,10,5,44,16,28
2019,166939,10,6,5,2,3
2019,166939,20,0,108,49,59
2019,166939,20,1,71,33,38
2019,166939,20,2,37,16,21
2019,166939,30,0,54,21,33
2019,166939,30,2,4,1,3
2019,166939,30,3,50,20,30
2019,166939,40,0,65,24,41
2019,166939,40,2,4,0,4
2019,166939,40,3,4,4,0
2019,166939,40,4,8,2,6
2019,166939,40,5,44,16,28
2019,166939,40,6,5,2,3
2019,166939,41,0,35,11,24
2019,166939,41,2,2,0,2
2019,166939,41,3,3,3,0
2019,166939,41,4,3,1,2
2019,166939,41,5,24,5,19
2019,166939,41,6,3,2,1
2019,166939,42,0,30,13,17
2019,166939,42,2,2,0,2
2019,166939,42,3,1,1,0
2019,166939,42,4,5,1,4
2019,166939,42,5,20,11,9
2019,166939,42,6,2,0,2
2019,166939,44,0,23,7,16
2019,166939,44,2,2,0,2
2019,166939,44,3,3,3,0
2019,166939,44,5,16,3,13
2019,166939,44,6,2,1,1
2019,166939,45,0,12,4,8
2019,166939,45,4,3,1,2
2019,166939,45,5,8,2,6
2019,166939,45,6,1,1,0
2019,166957,0,0,64,24,40
2019,166957,10,0,64,24,40
2019,166957,10,1,24,6,18
2019,166957,10,2,24,9,15
2019,166957,10,3,14,9,5
2019,166957,10,4,2,0,2
2019,166957,20,0,41,12,29
2019,166957,20,1,24,6,18
2019,166957,20,2,16,5,11
2019,166957,20,3,1,1,0
2019,166957,30,0,22,11,11
2019,166957,30,2,7,3,4
2019,166957,30,3,13,8,5
2019,166957,30,4,2,0,2
2019,166957,40,0,1,1,0
2019,166957,40,2,1,1,0
2019,166957,42,0,1,1,0
2019,166957,42,2,1,1,0
2019,167057,0,0,126,83,43
2019,167057,10,0,126,83,43
2019,167057,10,6,126,83,43
2019,167057,40,0,126,83,43
2019,167057,40,6,126,83,43
2019,167057,41,0,99,67,32
2019,167057,41,6,99,67,32
2019,167057,42,0,27,16,11
2019,167057,42,6,27,16,11
2019,167057,44,0,99,67,32
2019,167057,44,6,99,67,32
2019,167093,0,0,47,17,30
2019,167093,10,0,47,17,30
2019,167093,10,1,8,3,5
2019,167093,10,2,14,4,10
2019,167093,10,3,25,10,15
2019,167093,20,0,9,3,6
2019,167093,20,1,7,3,4
2019,167093,20,2,2,0,2
2019,167093,30,0,11,3,8
2019,167093,30,2,6,1,5
2019,167093,30,3,5,2,3
2019,167093,40,0,27,11,16
2019,167093,40,1,1,0,1
2019,167093,40,2,6,3,3
2019,167093,40,3,20,8,12
2019,167093,42,0,27,11,16
2019,167093,42,1,1,0,1
2019,167093,42,2,6,3,3
2019,167093,42,3,20,8,12
2019,167215,0,0,25,16,9
2019,167215,10,0,25,16,9
2019,167215,10,1,22,15,7
2019,167215,10,2,1,0,1
2019,167215,10,3,1,0,1
2019,167215,10,4,1,1,0
2019,167215,20,0,18,15,3
2019,167215,20,1,18,15,3
2019,167215,30,0,1,0,1
2019,167215,30,2,1,0,1
2019,167215,40,0,6,1,5
2019,167215,40,1,4,0,4
2019,167215,40,3,1,0,1
2019,167215,40,4,1,1,0
2019,167215,42,0,6,1,5
2019,167215,42,1,4,0,4
2019,167215,42,3,1,0,1
2019,167215,42,4,1,1,0
2019,167260,0,0,46,22,24
2019,167260,10,0,46,22,24
2019,167260,10,1,6,6,0
2019,167260,10,2,22,10,12
2019,167260,10,3,18,6,12
2019,167260,20,0,10,9,1
2019,167260,20,1,6,6,0
2019,167260,20,2,4,3,1
2019,167260,30,0,10,5,5
2019,167260,30,2,3,2,1
2019,167260,30,3,7,3,4
2019,167260,40,0,26,8,18
2019,167260,40,2,15,5,10
2019,167260,40,3,11,3,8
2019,167260,41,0,26,8,18
2019,167260,41,2,15,5,10
2019,167260,41,3,11,3,8
2019,167260,44,0,26,8,18
2019,167260,44,2,15,5,10
2019,167260,44,3,11,3,8
2019,167288,0,0,89,43,46
2019,167288,10,0,89,43,46
2019,167288,10,1,39,22,17
2019,167288,10,2,17,8,9
2019,167288,10,3,32,13,19
2019,167288,10,4,1,0,1
2019,167288,20,0,56,30,26
2019,167288,20,1,39,22,17
2019,167288,20,2,17,8,9
2019,167288,30,0,26,10,16
2019,167288,30,3,26,10,16
2019,167288,40,0,7,3,4
2019,167288,40,3,6,3,3
2019,167288,40,4,1,0,1
2019,167288,42,0,7,3,4
2019,167288,42,3,6,3,3
2019,167288,42,4,1,0,1
2019,167312,0,0,121,42,79
2019,167312,10,0,121,42,79
2019,167312,10,1,59,18,41
2019,167312,10,2,33,13,20
2019,167312,10,3,14,3,11
2019,167312,10,4,15,8,7
2019,167312,20,0,84,25,59
2019,167312,20,1,59,18,41
2019,167312,20,2,23,7,16
2019,167312,20,3,2,0,2
2019,167312,30,0,37,17,20
2019,167312,30,2,10,6,4
2019,167312,30,3,12,3,9
2019,167312,30,4,15,8,7
2019,167358,0,0,1352,774,578
2019,167358,10,0,1352,774,578
2019,167358,10,1,399,277,122
2019,167358,10,2,400,235,165
2019,167358,10,3,315,162,153
2019,167358,10,4,81,43,38
2019,167358,10,5,22,17,5
2019,167358,10,6,135,40,95
2019,167358,20,0,578,395,183
2019,167358,20,1,343,250,93
2019,167358,20,2,235,145,90
2019,167358,30,0,195,109,86
2019,167358,30,1,3,2,1
2019,167358,30,2,19,12,7
2019,167358,30,3,173,95,78
2019,167358,40,0,579,270,309
2019,167358,40,1,53,25,28
2019,167358,40,2,146,78,68
2019,167358,40,3,142,67,75
2019,167358,40,4,81,43,38
2019,167358,40,5,22,17,5
2019,167358,40,6,135,40,95
2019,167358,41,0,90,37,53
2019,167358,41,1,38,15,23
2019,167358,41,2,15,6,9
2019,167358,41,4,13,8,5
2019,167358,41,6,24,8,16
2019,167358,42,0,489,233,256
2019,167358,42,1,15,10,5
2019,167358,42,2,131,72,59
2019,167358,42,3,142,67,75
2019,167358,42,4,68,35,33
2019,167358,42,5,22,17,5
2019,167358,42,6,111,32,79
2019,167358,44,0,90,37,53
2019,167358,44,1,38,15,23
2019,167358,44,2,15,6,9
2019,167358,44,4,13,8,5
2019,167358,44,6,24,8,16
2019,167376,0,0,92,31,61
2019,167376,10,0,92,31,61
2019,167376,10,1,53,19,34
2019,167376,10,2,20,5,15
2019,167376,10,3,13,5,8
2019,167376,10,4,6,2,4
2019,167376,20,0,60,20,40
2019,167376,20,1,51,18,33
2019,167376,20,2,8,1,7
2019,167376,20,3,1,1,0
2019,167376,30,0,27,8,19
2019,167376,30,1,1,0,1
2019,167376,30,2,11,3,8
2019,167376,30,3,11,4,7
2019,167376,30,4,4,1,3
2019,167376,40,0,5,3,2
2019,167376,40,1,1,1,0
2019,167376,40,2,1,1,0
2019,167376,40,3,1,0,1
2019,167376,40,4,2,1,1
2019,167376,42,0,5,3,2
2019,167376,42,1,1,1,0
2019,167376,42,2,1,1,0
2019,167376,42,3,1,0,1
2019,167376,42,4,2,1,1
2019,167394,0,0,62,20,42
2019,167394,10,0,62,20,42
2019,167394,10,1,8,4,4
2019,167394,10,2,22,9,13
2019,167394,10,3,25,5,20
2019,167394,10,4,1,0,1
2019,167394,10,5,6,2,4
2019,167394,20,0,25,11,14
2019,167394,20,1,8,4,4
2019,167394,20,2,17,7,10
2019,167394,30,0,22,7,15
2019,167394,30,2,5,2,3
2019,167394,30,3,16,5,11
2019,167394,30,5,1,0,1
2019,167394,40,0,15,2,13
2019,167394,40,3,9,0,9
2019,167394,40,4,1,0,1
2019,167394,40,5,5,2,3
2019,167394,42,0,15,2,13
2019,167394,42,3,9,0,9
2019,167394,42,4,1,0,1
2019,167394,42,5,5,2,3
2019,167455,0,0,36,7,29
2019,167455,10,0,21,4,17
2019,167455,10,1,5,1,4
2019,167455,10,2,3,0,3
2019,167455,10,3,13,3,10
2019,167455,20,0,7,1,6
2019,167455,20,1,5,1,4
2019,167455,20,2,2,0,2
2019,167455,30,0,10,3,7
2019,167455,30,3,10,3,7
2019,167455,40,0,4,0,4
2019,167455,40,2,1,0,1
2019,167455,40,3,3,0,3
2019,167455,42,0,4,0,4
2019,167455,42,2,1,0,1
2019,167455,42,3,3,0,3
2019,167455,50,0,15,3,12
2019,167464,0,0,12,12,0
2019,167464,10,0,7,7,0
2019,167464,10,1,7,7,0
2019,167464,40,0,7,7,0
2019,167464,40,1,7,7,0
2019,167464,41,0,7,7,0
2019,167464,41,1,7,7,0
2019,167464,45,0,7,7,0
2019,167464,45,1,7,7,0
2019,167464,50,0,5,5,0
2019,167525,0,0,57,27,30
2019,167525,10,0,57,27,30
2019,167525,10,1,27,15,12
2019,167525,10,2,5,2,3
2019,167525,10,3,20,9,11
2019,167525,10,4,5,1,4
2019,167525,20,0,27,15,12
2019,167525,20,1,27,15,12
2019,167525,30,0,30,12,18
2019,167525,30,2,5,2,3
2019,167525,30,3,20,9,11
2019,167525,30,4,5,1,4
2019,167534,0,0,136,44,92
2019,167534,10,0,136,44,92
2019,167534,10,1,83,27,56
2019,167534,10,2,28,9,19
2019,167534,10,3,22,6,16
2019,167534,10,4,3,2,1
2019,167534,20,0,91,29,62
2019,167534,20,1,83,27,56
2019,167534,20,2,5,2,3
2019,167534,20,3,3,0,3
2019,167534,30,0,45,15,30
2019,167534,30,2,23,7,16
2019,167534,30,3,19,6,13
2019,167534,30,4,3,2,1
2019,167598,0,0,125,31,94
2019,167598,10,0,124,30,94
2019,167598,10,1,6,2,4
2019,167598,10,2,48,15,33
2019,167598,10,3,61,12,49
2019,167598,10,4,1,0,1
2019,167598,10,5,7,1,6
2019,167598,10,6,1,0,1
2019,167598,20,0,14,6,8
2019,167598,20,1,5,1,4
2019,167598,20,2,9,5,4
2019,167598,30,0,8,3,5
2019,167598,30,2,5,3,2
2019,167598,30,3,3,0,3
2019,167598,40,0,102,21,81
2019,167598,40,1,1,1,0
2019,167598,40,2,34,7,27
2019,167598,40,3,58,12,46
2019,167598,40,4,1,0,1
2019,167598,40,5,7,1,6
2019,167598,40,6,1,0,1
2019,167598,41,0,52,12,40
2019,167598,41,1,1,1,0
2019,167598,41,2,22,3,19
2019,167598,41,3,29,8,21
2019,167598,42,0,50,9,41
2019,167598,42,2,12,4,8
2019,167598,42,3,29,4,25
2019,167598,42,4,1,0,1
2019,167598,42,5,7,1,6
2019,167598,42,6,1,0,1
2019,167598,44,0,52,12,40
2019,167598,44,1,1,1,0
2019,167598,44,2,22,3,19
2019,167598,44,3,29,8,21
2019,167598,50,0,1,1,0
2019,167631,0,0,43,21,22
2019,167631,10,0,43,21,22
2019,167631,10,1,14,7,7
2019,167631,10,2,5,3,2
2019,167631,10,3,18,10,8
2019,167631,10,4,6,1,5
2019,167631,20,0,19,9,10
2019,167631,20,1,14,7,7
2019,167631,20,2,4,2,2
2019,167631,20,3,1,0,1
2019,167631,30,0,24,12,12
2019,167631,30,2,1,1,0
2019,167631,30,3,17,10,7
2019,167631,30,4,6,1,5
2019,167677,0,0,14,11,3
2019,167677,10,0,14,11,3
2019,167677,10,6,14,11,3
2019,167677,40,0,14,11,3
2019,167677,40,6,14,11,3
2019,167677,41,0,10,10,0
2019,167677,41,6,10,10,0
2019,167677,42,0,4,1,3
2019,167677,42,6,4,1,3
2019,167677,44,0,1,1,0
2019,167677,44,6,1,1,0
2019,167677,45,0,9,9,0
2019,167677,45,6,9,9,0
2019,167729,0,0,318,148,170
2019,167729,10,0,318,148,170
2019,167729,10,1,146,74,72
2019,167729,10,2,94,40,54
2019,167729,10,3,68,30,38
2019,167729,10,4,10,4,6
2019,167729,20,0,232,110,122
2019,167729,20,1,144,72,72
2019,167729,20,2,87,37,50
2019,167729,20,3,1,1,0
2019,167729,30,0,67,30,37
2019,167729,30,2,6,3,3
2019,167729,30,3,57,25,32
2019,167729,30,4,4,2,2
2019,167729,40,0,19,8,11
2019,167729,40,1,2,2,0
2019,167729,40,2,1,0,1
2019,167729,40,3,10,4,6
2019,167729,40,4,6,2,4
2019,167729,42,0,19,8,11
2019,167729,42,1,2,2,0
2019,167729,42,2,1,0,1
2019,167729,42,3,10,4,6
2019,167729,42,4,6,2,4
2019,167783,0,0,231,63,168
2019,167783,10,0,231,63,168
2019,167783,10,1,52,15,37
2019,167783,10,2,109,27,82
2019,167783,10,3,59,17,42
2019,167783,10,5,11,4,7
2019,167783,20,0,94,32,62
2019,167783,20,1,37,13,24
2019,167783,20,2,56,19,37
2019,167783,20,3,1,0,1
2019,167783,30,0,43,15,28
2019,167783,30,2,2,1,1
2019,167783,30,3,41,14,27
2019,167783,40,0,94,16,78
2019,167783,40,1,15,2,13
2019,167783,40,2,51,7,44
2019,167783,40,3,17,3,14
2019,167783,40,5,11,4,7
2019,167783,41,0,44,10,34
2019,167783,41,1,9,2,7
2019,167783,41,2,23,5,18
2019,167783,41,3,6,2,4
2019,167783,41,5,6,1,5
2019,167783,42,0,50,6,44
2019,167783,42,1,6,0,6
2019,167783,42,2,28,2,26
2019,167783,42,3,11,1,10
2019,167783,42,5,5,3,2
2019,167783,44,0,44,10,34
2019,167783,44,1,9,2,7
2019,167783,44,2,23,5,18
2019,167783,44,3,6,2,4
2019,167783,44,5,6,1,5
2019,167792,0,0,56,32,24
2019,167792,10,0,56,32,24
2019,167792,10,6,56,32,24
2019,167792,40,0,56,32,24
2019,167792,40,6,56,32,24
2019,167792,41,0,52,28,24
2019,167792,41,6,52,28,24
2019,167792,42,0,4,4,0
2019,167792,42,6,4,4,0
2019,167792,44,0,52,28,24
2019,167792,44,6,52,28,24
2019,167835,0,0,332,135,197
2019,167835,10,0,328,134,194
2019,167835,10,1,136,62,74
2019,167835,10,2,54,22,32
2019,167835,10,3,52,18,34
2019,167835,10,4,14,5,9
2019,167835,10,5,72,27,45
2019,167835,20,0,189,84,105
2019,167835,20,1,136,62,74
2019,167835,20,2,53,22,31
2019,167835,30,0,53,18,35
2019,167835,30,2,1,0,1
2019,167835,30,3,52,18,34
2019,167835,40,0,86,32,54
2019,167835,40,4,14,5,9
2019,167835,40,5,72,27,45
2019,167835,41,0,68,23,45
2019,167835,41,4,12,3,9
2019,167835,41,5,56,20,36
2019,167835,42,0,16,9,7
2019,167835,42,4,2,2,0
2019,167835,42,5,14,7,7
2019,167835,43,0,2,0,2
2019,167835,43,5,2,0,2
2019,167835,44,0,67,22,45
2019,167835,44,4,12,3,9
2019,167835,44,5,55,19,36
2019,167835,45,0,1,1,0
2019,167835,45,5,1,1,0
2019,167835,50,0,4,1,3
2019,167899,0,0,193,80,113
2019,167899,10,0,193,80,113
2019,167899,10,1,50,25,25
2019,167899,10,2,52,21,31
2019,167899,10,3,79,29,50
2019,167899,10,4,12,5,7
2019,167899,20,0,84,40,44
2019,167899,20,1,48,23,25
2019,167899,20,2,35,16,19
2019,167899,20,3,1,1,0
2019,167899,30,0,46,15,31
2019,167899,30,2,3,2,1
2019,167899,30,3,43,13,30
2019,167899,40,0,63,25,38
2019,167899,40,1,2,2,0
2019,167899,40,2,14,3,11
2019,167899,40,3,35,15,20
2019,167899,40,4,12,5,7
2019,167899,41,0,52,21,31
2019,167899,41,1,2,2,0
2019,167899,41,2,14,3,11
2019,167899,41,3,29,13,16
2019,167899,41,4,7,3,4
2019,167899,42,0,11,4,7
2019,167899,42,3,6,2,4
2019,167899,42,4,5,2,3
2019,167899,44,0,52,21,31
2019,167899,44,1,2,2,0
2019,167899,44,2,14,3,11
2019,167899,44,3,29,13,16
2019,167899,44,4,7,3,4
2019,167905,0,0,128,47,81
2019,167905,10,0,128,47,81
2019,167905,10,1,70,28,42
2019,167905,10,2,30,10,20
2019,167905,10,3,25,8,17
2019,167905,10,4,3,1,2
2019,167905,20,0,82,34,48
2019,167905,20,1,70,28,42
2019,167905,20,2,10,4,6
2019,167905,20,3,2,2,0
2019,167905,30,0,46,13,33
2019,167905,30,2,20,6,14
2019,167905,30,3,23,6,17
2019,167905,30,4,3,1,2
2019,167987,0,0,395,208,187
2019,167987,10,0,395,208,187
2019,167987,10,1,124,78,46
2019,167987,10,2,100,57,43
2019,167987,10,3,73,28,45
2019,167987,10,5,98,45,53
2019,167987,20,0,218,134,84
2019,167987,20,1,122,77,45
2019,167987,20,2,95,57,38
2019,167987,20,3,1,0,1
2019,167987,30,0,71,28,43
2019,167987,30,1,1,0,1
2019,167987,30,2,4,0,4
2019,167987,30,3,66,28,38
2019,167987,40,0,106,46,60
2019,167987,40,1,1,1,0
2019,167987,40,2,1,0,1
2019,167987,40,3,6,0,6
2019,167987,40,5,98,45,53
2019,167987,41,0,8,1,7
2019,167987,41,1,1,1,0
2019,167987,41,2,1,0,1
2019,167987,41,3,6,0,6
2019,167987,42,0,98,45,53
2019,167987,42,5,98,45,53
2019,167987,44,0,7,0,7
2019,167987,44,2,1,0,1
2019,167987,44,3,6,0,6
2019,167987,45,0,1,1,0
2019,167987,45,1,1,1,0
2019,167996,0,0,184,96,88
2019,167996,10,0,184,96,88
2019,167996,10,1,52,37,15
2019,167996,10,2,63,32,31
2019,167996,10,3,51,22,29
2019,167996,10,4,7,1,6
2019,167996,10,5,10,4,6
2019,167996,10,6,1,0,1
2019,167996,20,0,98,60,38
2019,167996,20,1,51,36,15
2019,167996,20,2,46,24,22
2019,167996,20,3,1,0,1
2019,167996,30,0,31,12,19
2019,167996,30,2,7,3,4
2019,167996,30,3,24,9,15
2019,167996,40,0,55,24,31
2019,167996,40,1,1,1,0
2019,167996,40,2,10,5,5
2019,167996,40,3,26,13,13
2019,167996,40,4,7,1,6
2019,167996,40,5,10,4,6
2019,167996,40,6,1,0,1
2019,167996,41,0,38,17,21
2019,167996,41,1,1,1,0
2019,167996,41,2,9,4,5
2019,167996,41,3,24,11,13
2019,167996,41,4,2,0,2
2019,167996,41,5,2,1,1
2019,167996,42,0,17,7,10
2019,167996,42,2,1,1,0
2019,167996,42,3,2,2,0
2019,167996,42,4,5,1,4
2019,167996,42,5,8,3,5
2019,167996,42,6,1,0,1
2019,167996,44,0,38,17,21
2019,167996,44,1,1,1,0
2019,167996,44,2,9,4,5
2019,167996,44,3,24,11,13
2019,167996,44,4,2,0,2
2019,167996,44,5,2,1,1
2019,168005,0,0,355,178,177
2019,168005,10,0,355,178,177
2019,168005,10,1,96,54,42
2019,168005,10,2,111,55,56
2019,168005,10,3,80,34,46
2019,168005,10,4,68,35,33
2019,168005,20,0,202,107,95
2019,168005,20,1,96,54,42
2019,168005,20,2,106,53,53
2019,168005,30,0,71,31,40
2019,168005,30,2,3,1,2
2019,168005,30,3,68,30,38
2019,168005,40,0,82,40,42
2019,168005,40,2,2,1,1
2019,168005,40,3,12,4,8
2019,168005,40,4,68,35,33
2019,168005,41,0,28,13,15
2019,168005,41,2,2,1,1
2019,168005,41,3,5,1,4
2019,168005,41,4,21,11,10
2019,168005,42,0,54,27,27
2019,168005,42,3,7,3,4
2019,168005,42,4,47,24,23
2019,168005,44,0,28,13,15
2019,168005,44,2,2,1,1
2019,168005,44,3,5,1,4
2019,168005,44,4,21,11,10
2019,168148,0,0,934,490,444
2019,168148,10,0,934,490,444
2019,168148,10,1,288,195,93
2019,168148,10,2,224,129,95
2019,168148,10,3,259,111,148
2019,168148,10,4,1,0,1
2019,168148,10,5,162,55,107
2019,168148,20,0,374,248,126
2019,168148,20,1,229,158,71
2019,168148,20,2,145,90,55
2019,168148,30,0,96,47,49
2019,168148,30,1,1,0,1
2019,168148,30,2,1,0,1
2019,168148,30,3,94,47,47
2019,168148,40,0,464,195,269
2019,168148,40,1,58,37,21
2019,168148,40,2,78,39,39
2019,168148,40,3,165,64,101
2019,168148,40,4,1,0,1
2019,168148,40,5,162,55,107
2019,168148,41,0,396,167,229
2019,168148,41,1,52,32,20
2019,168148,41,2,69,35,34
2019,168148,41,3,123,49,74
2019,168148,41,5,152,51,101
2019,168148,42,0,65,26,39
2019,168148,42,1,6,5,1
2019,168148,42,2,8,4,4
2019,168148,42,3,42,15,27
2019,168148,42,4,1,0,1
2019,168148,42,5,8,2,6
2019,168148,43,0,3,2,1
2019,168148,43,2,1,0,1
2019,168148,43,5,2,2,0
2019,168148,44,0,362,148,214
2019,168148,44,1,34,20,14
2019,168148,44,2,53,28,25
2019,168148,44,3,123,49,74
2019,168148,44,5,152,51,101
2019,168148,45,0,34,19,15
2019,168148,45,1,18,12,6
2019,168148,45,2,16,7,9
2019,168218,0,0,328,122,206
2019,168218,10,0,328,122,206
2019,168218,10,1,95,48,47
2019,168218,10,2,73,29,44
2019,168218,10,3,42,13,29
2019,168218,10,5,70,18,52
2019,168218,10,6,48,14,34
2019,168218,20,0,168,77,91
2019,168218,20,1,95,48,47
2019,168218,20,2,73,29,44
2019,168218,30,0,42,13,29
2019,168218,30,3,42,13,29
2019,168218,40,0,118,32,86
2019,168218,40,5,70,18,52
2019,168218,40,6,48,14,34
2019,168218,41,0,89,20,69
2019,168218,41,5,63,15,48
2019,168218,41,6,26,5,21
2019,168218,42,0,29,12,17
2019,168218,42,5,7,3,4
2019,168218,42,6,22,9,13
2019,168218,44,0,88,20,68
2019,168218,44,5,63,15,48
2019,168218,44,6,25,5,20
2019,168218,45,0,1,0,1
2019,168218,45,6,1,0,1
2019,168227,0,0,161,107,54
2019,168227,10,0,161,107,54
2019,168227,10,1,28,21,7
2019,168227,10,2,53,32,21
2019,168227,10,3,80,54,26
2019,168227,40,0,161,107,54
2019,168227,40,1,28,21,7
2019,168227,40,2,53,32,21
2019,168227,40,3,80,54,26
2019,168227,41,0,140,93,47
2019,168227,41,1,28,21,7
2019,168227,41,2,53,32,21
2019,168227,41,3,59,40,19
2019,168227,43,0,21,14,7
2019,168227,43,3,21,14,7
2019,168227,44,0,1,1,0
2019,168227,44,3,1,1,0
2019,168227,45,0,139,92,47
2019,168227,45,1,28,21,7
2019,168227,45,2,53,32,21
2019,168227,45,3,58,39,19
2019,168254,0,0,225,127,98
2019,168254,10,0,225,127,98
2019,168254,10,1,79,45,34
2019,168254,10,2,65,37,28
2019,168254,10,3,54,31,23
2019,168254,10,4,27,14,13
2019,168254,20,0,114,68,46
2019,168254,20,1,70,41,29
2019,168254,20,2,43,26,17
2019,168254,20,3,1,1,0
2019,168254,30,0,54,33,21
2019,168254,30,2,13,8,5
2019,168254,30,3,41,25,16
2019,168254,40,0,57,26,31
2019,168254,40,1,9,4,5
2019,168254,40,2,9,3,6
2019,168254,40,3,12,5,7
2019,168254,40,4,27,14,13
2019,168254,41,0,37,17,20
2019,168254,41,1,2,1,1
2019,168254,41,2,9,3,6
2019,168254,41,3,1,1,0
2019,168254,41,4,25,12,13
2019,168254,42,0,20,9,11
2019,168254,42,1,7,3,4
2019,168254,42,3,11,4,7
2019,168254,42,4,2,2,0
2019,168254,44,0,37,17,20
2019,168254,44,1,2,1,1
2019,168254,44,2,9,3,6
2019,168254,44,3,1,1,0
2019,168254,44,4,25,12,13
2019,168263,0,0,233,114,119
2019,168263,10,0,233,114,119
2019,168263,10,1,89,49,40
2019,168263,10,2,68,33,35
2019,168263,10,3,66,30,36
2019,168263,10,4,10,2,8
2019,168263,20,0,159,84,75
2019,168263,20,1,89,49,40
2019,168263,20,2,65,33,32
2019,168263,20,3,5,2,3
2019,168263,30,0,54,25,29
2019,168263,30,2,3,0,3
2019,168263,30,3,49,25,24
2019,168263,30,4,2,0,2
2019,168263,40,0,20,5,15
2019,168263,40,3,12,3,9
2019,168263,40,4,8,2,6
2019,168263,41,0,2,1,1
2019,168263,41,3,1,0,1
2019,168263,41,4,1,1,0
2019,168263,42,0,15,1,14
2019,168263,42,3,9,1,8
2019,168263,42,4,6,0,6
2019,168263,43,0,3,3,0
2019,168263,43,3,2,2,0
2019,168263,43,4,1,1,0
2019,168263,44,0,2,1,1
2019,168263,44,3,1,0,1
2019,168263,44,4,1,1,0
2019,168281,0,0,135,65,70
2019,168281,10,0,135,65,70
2019,168281,10,1,51,27,24
2019,168281,10,2,45,23,22
2019,168281,10,3,29,11,18
2019,168281,10,4,8,3,5
2019,168281,10,6,2,1,1
2019,168281,20,0,94,50,44
2019,168281,20,1,49,27,22
2019,168281,20,2,45,23,22
2019,168281,30,0,21,8,13
2019,168281,30,3,21,8,13
2019,168281,40,0,20,7,13
2019,168281,40,1,2,0,2
2019,168281,40,3,8,3,5
2019,168281,40,4,8,3,5
2019,168281,40,6,2,1,1
2019,168281,41,0,12,1,11
2019,168281,41,1,2,0,2
2019,168281,41,3,4,0,4
2019,168281,41,4,6,1,5
2019,168281,42,0,8,6,2
2019,168281,42,3,4,3,1
2019,168281,42,4,2,2,0
2019,168281,42,6,2,1,1
2019,168281,44,0,12,1,11
2019,168281,44,1,2,0,2
2019,168281,44,3,4,0,4
2019,168281,44,4,6,1,5
2019,168342,0,0,312,164,148
2019,168342,10,0,310,162,148
2019,168342,10,1,150,90,60
2019,168342,10,2,31,14,17
2019,168342,10,3,82,37,45
2019,168342,10,4,4,3,1
2019,168342,10,5,8,3,5
2019,168342,10,6,35,15,20
2019,168342,20,0,180,104,76
2019,168342,20,1,150,90,60
2019,168342,20,2,30,14,16
2019,168342,30,0,81,36,45
2019,168342,30,3,81,36,45
2019,168342,40,0,49,22,27
2019,168342,40,2,1,0,1
2019,168342,40,3,1,1,0
2019,168342,40,4,4,3,1
2019,168342,40,5,8,3,5
2019,168342,40,6,35,15,20
2019,168342,41,0,33,12,21
2019,168342,41,2,1,0,1
2019,168342,41,3,1,1,0
2019,168342,41,4,4,3,1
2019,168342,41,5,7,2,5
2019,168342,41,6,20,6,14
2019,168342,42,0,16,10,6
2019,168342,42,5,1,1,0
2019,168342,42,6,15,9,6
2019,168342,44,0,33,12,21
2019,168342,44,2,1,0,1
2019,168342,44,3,1,1,0
2019,168342,44,4,4,3,1
2019,168342,44,5,7,2,5
2019,168342,44,6,20,6,14
2019,168342,50,0,2,2,0
2019,168421,0,0,419,294,125
2019,168421,10,0,418,293,125
2019,168421,10,1,110,83,27
2019,168421,10,2,91,64,27
2019,168421,10,3,66,40,26
2019,168421,10,4,151,106,45
2019,168421,20,0,192,140,52
2019,168421,20,1,107,81,26
2019,168421,20,2,85,59,26
2019,168421,30,0,69,42,27
2019,168421,30,2,6,5,1
2019,168421,30,3,63,37,26
2019,168421,40,0,157,111,46
2019,168421,40,1,3,2,1
2019,168421,40,3,3,3,0
2019,168421,40,4,151,106,45
2019,168421,42,0,12,9,3
2019,168421,42,4,12,9,3
2019,168421,43,0,145,102,43
2019,168421,43,1,3,2,1
2019,168421,43,3,3,3,0
2019,168421,43,4,139,97,42
2019,168421,50,0,1,1,0
2019,168430,0,0,208,87,121
2019,168430,10,0,208,87,121
2019,168430,10,1,76,30,46
2019,168430,10,2,54,26,28
2019,168430,10,3,65,29,36
2019,168430,10,4,13,2,11
2019,168430,20,0,126,54,72
2019,168430,20,1,76,30,46
2019,168430,20,2,50,24,26
2019,168430,30,0,55,24,31
2019,168430,30,2,4,2,2
2019,168430,30,3,45,21,24
2019,168430,30,4,6,1,5
2019,168430,40,0,27,9,18
2019,168430,40,3,20,8,12
2019,168430,40,4,7,1,6
2019,168430,42,0,27,9,18
2019,168430,42,3,20,8,12
2019,168430,42,4,7,1,6
2019,168528,0,0,97,52,45
2019,168528,10,0,97,52,45
2019,168528,10,1,38,22,16
2019,168528,10,2,23,13,10
2019,168528,10,3,34,16,18
2019,168528,10,4,2,1,1
2019,168528,20,0,59,35,24
2019,168528,20,1,38,22,16
2019,168528,20,2,21,13,8
2019,168528,30,0,10,7,3
2019,168528,30,3,10,7,3
2019,168528,40,0,28,10,18
2019,168528,40,2,2,0,2
2019,168528,40,3,24,9,15
2019,168528,40,4,2,1,1
2019,168528,41,0,1,0,1
2019,168528,41,3,1,0,1
2019,168528,42,0,27,10,17
2019,168528,42,2,2,0,2
2019,168528,42,3,23,9,14
2019,168528,42,4,2,1,1
2019,168528,44,0,1,0,1
2019,168528,44,3,1,0,1
2019,168546,0,0,115,59,56
2019,168546,10,0,115,59,56
2019,168546,10,1,56,31,25
2019,168546,10,2,21,13,8
2019,168546,10,3,35,14,21
2019,168546,10,4,1,0,1
2019,168546,10,5,2,1,1
2019,168546,20,0,77,44,33
2019,168546,20,1,56,31,25
2019,168546,20,2,21,13,8
2019,168546,30,0,26,9,17
2019,168546,30,3,26,9,17
2019,168546,40,0,12,6,6
2019,168546,40,3,9,5,4
2019,168546,40,4,1,0,1
2019,168546,40,5,2,1,1
2019,168546,41,0,1,0,1
2019,168546,41,3,1,0,1
2019,168546,42,0,11,6,5
2019,168546,42,3,8,5,3
2019,168546,42,4,1,0,1
2019,168546,42,5,2,1,1
2019,168546,44,0,1,0,1
2019,168546,44,3,1,0,1
2019,168591,0,0,101,52,49
2019,168591,10,0,101,52,49
2019,168591,10,1,33,21,12
2019,168591,10,2,23,12,11
2019,168591,10,3,33,13,20
2019,168591,10,4,11,5,6
2019,168591,10,5,1,1,0
2019,168591,20,0,53,32,21
2019,168591,20,1,32,20,12
2019,168591,20,2,20,11,9
2019,168591,20,3,1,1,0
2019,168591,30,0,29,11,18
2019,168591,30,1,1,1,0
2019,168591,30,2,2,1,1
2019,168591,30,3,26,9,17
2019,168591,40,0,19,9,10
2019,168591,40,2,1,0,1
2019,168591,40,3,6,3,3
2019,168591,40,4,11,5,6
2019,168591,40,5,1,1,0
2019,168591,42,0,19,9,10
2019,168591,42,2,1,0,1
2019,168591,42,3,6,3,3
2019,168591,42,4,11,5,6
2019,168591,42,5,1,1,0
2019,168607,0,0,46,29,17
2019,168607,10,0,46,29,17
2019,168607,10,6,46,29,17
2019,168607,40,0,46,29,17
2019,168607,40,6,46,29,17
2019,168607,41,0,46,29,17
2019,168607,41,6,46,29,17
2019,168607,44,0,46,29,17
2019,168607,44,6,46,29,17
2019,168740,0,0,218,128,90
2019,168740,10,0,218,128,90
2019,168740,10,1,73,54,19
2019,168740,10,2,66,31,35
2019,168740,10,3,76,41,35
2019,168740,10,4,3,2,1
2019,168740,20,0,67,45,22
2019,168740,20,1,45,32,13
2019,168740,20,2,16,8,8
2019,168740,20,3,6,5,1
2019,168740,30,0,130,75,55
2019,168740,30,1,26,22,4
2019,168740,30,2,44,19,25
2019,168740,30,3,60,34,26
2019,168740,40,0,21,8,13
2019,168740,40,1,2,0,2
2019,168740,40,2,6,4,2
2019,168740,40,3,10,2,8
2019,168740,40,4,3,2,1
2019,168740,42,0,21,8,13
2019,168740,42,1,2,0,2
2019,168740,42,2,6,4,2
2019,168740,42,3,10,2,8
2019,168740,42,4,3,2,1
2019,168786,0,0,89,50,39
2019,168786,10,0,89,50,39
2019,168786,10,1,27,17,10
2019,168786,10,2,31,17,14
2019,168786,10,3,29,16,13
2019,168786,10,4,2,0,2
2019,168786,20,0,58,35,23
2019,168786,20,1,27,17,10
2019,168786,20,2,25,15,10
2019,168786,20,3,6,3,3
2019,168786,30,0,20,10,10
2019,168786,30,2,4,1,3
2019,168786,30,3,16,9,7
2019,168786,40,0,11,5,6
2019,168786,40,2,2,1,1
2019,168786,40,3,7,4,3
2019,168786,40,4,2,0,2
2019,168786,41,0,11,5,6
2019,168786,41,2,2,1,1
2019,168786,41,3,7,4,3
2019,168786,41,4,2,0,2
2019,168786,45,0,11,5,6
2019,168786,45,2,2,1,1
2019,168786,45,3,7,4,3
2019,168786,45,4,2,0,2
2019,168847,0,0,174,47,127
2019,168847,10,0,174,47,127
2019,168847,10,1,15,3,12
2019,168847,10,2,29,5,24
2019,168847,10,3,19,2,17
2019,168847,10,4,111,37,74
2019,168847,40,0,174,47,127
2019,168847,40,1,15,3,12
2019,168847,40,2,29,5,24
2019,168847,40,3,19,2,17
2019,168847,40,4,111,37,74
2019,168847,42,0,174,47,127
2019,168847,42,1,15,3,12
2019,168847,42,2,29,5,24
2019,168847,42,3,19,2,17
2019,168847,42,4,111,37,74
2019,168883,0,0,41,18,23
2019,168883,10,0,41,18,23
2019,168883,10,6,41,18,23
2019,168883,20,0,34,17,17
2019,168883,20,6,34,17,17
2019,168883,30,0,7,1,6
2019,168883,30,6,7,1,6
2019,169080,0,0,236,143,93
2019,169080,10,0,223,141,82
2019,169080,10,1,126,87,39
2019,169080,10,2,56,33,23
2019,169080,10,3,40,20,20
2019,169080,10,4,1,1,0
2019,169080,20,0,165,109,56
2019,169080,20,1,119,83,36
2019,169080,20,2,46,26,20
2019,169080,30,0,43,21,22
2019,169080,30,1,6,4,2
2019,169080,30,2,6,4,2
2019,169080,30,3,30,12,18
2019,169080,30,4,1,1,0
2019,169080,40,0,15,11,4
2019,169080,40,1,1,0,1
2019,169080,40,2,4,3,1
2019,169080,40,3,10,8,2
2019,169080,41,0,15,11,4
2019,169080,41,1,1,0,1
2019,169080,41,2,4,3,1
2019,169080,41,3,10,8,2
2019,169080,44,0,15,11,4
2019,169080,44,1,1,0,1
2019,169080,44,2,4,3,1
2019,169080,44,3,10,8,2
2019,169080,50,0,13,2,11
2019,169099,0,0,13,10,3
2019,169099,10,0,13,10,3
2019,169099,10,1,10,8,2
2019,169099,10,2,3,2,1
2019,169099,20,0,7,6,1
2019,169099,20,1,7,6,1
2019,169099,30,0,6,4,2
2019,169099,30,1,3,2,1
2019,169099,30,2,3,2,1
2019,169220,0,0,14,7,7
2019,169220,10,0,14,7,7
2019,169220,10,1,12,6,6
2019,169220,10,6,2,1,1
2019,169220,40,0,14,7,7
2019,169220,40,1,12,6,6
2019,169220,40,6,2,1,1
2019,169220,41,0,12,6,6
2019,169220,41,1,11,6,5
2019,169220,41,6,1,0,1
2019,169220,42,0,2,1,1
2019,169220,42,1,1,0,1
2019,169220,42,6,1,1,0
2019,169220,44,0,12,6,6
2019,169220,44,1,11,6,5
2019,169220,44,6,1,0,1
2019,169248,0,0,792,443,349
2019,169248,10,0,792,443,349
2019,169248,10,1,318,197,121
2019,169248,10,2,169,85,84
2019,169248,10,3,94,48,46
2019,169248,10,4,1,1,0
2019,169248,10,5,200,107,93
2019,169248,10,6,10,5,5
2019,169248,20,0,460,265,195
2019,169248,20,1,311,192,119
2019,169248,20,2,145,71,74
2019,169248,20,3,4,2,2
2019,169248,30,0,108,58,50
2019,169248,30,1,1,1,0
2019,169248,30,2,22,13,9
2019,169248,30,3,85,44,41
2019,169248,40,0,224,120,104
2019,169248,40,1,6,4,2
2019,169248,40,2,2,1,1
2019,169248,40,3,5,2,3
2019,169248,40,4,1,1,0
2019,169248,40,5,200,107,93
2019,169248,40,6,10,5,5
2019,169248,41,0,166,88,78
2019,169248,41,1,6,4,2
2019,169248,41,2,2,1,1
2019,169248,41,3,5,2,3
2019,169248,41,4,1,1,0
2019,169248,41,5,152,80,72
2019,169248,42,0,58,32,26
2019,169248,42,5,48,27,21
2019,169248,42,6,10,5,5
2019,169248,44,0,166,88,78
2019,169248,44,1,6,4,2
2019,169248,44,2,2,1,1
2019,169248,44,3,5,2,3
2019,169248,44,4,1,1,0
2019,169248,44,5,152,80,72
2019,169275,0,0,138,55,83
2019,169275,10,0,138,55,83
2019,169275,10,6,138,55,83
2019,169275,40,0,138,55,83
2019,169275,40,6,138,55,83
2019,169275,42,0,133,53,80
2019,169275,42,6,133,53,80
2019,169275,43,0,5,2,3
2019,169275,43,6,5,2,3
2019,169327,0,0,6,3,3
2019,169327,10,0,6,3,3
2019,169327,10,1,4,2,2
2019,169327,10,2,2,1,1
2019,169327,40,0,6,3,3
2019,169327,40,1,4,2,2
2019,169327,40,2,2,1,1
2019,169327,42,0,6,3,3
2019,169327,42,1,4,2,2
2019,169327,42,2,2,1,1
2019,169363,0,0,56,31,25
2019,169363,10,0,53,29,24
2019,169363,10,1,9,6,3
2019,169363,10,2,10,3,7
2019,169363,10,3,34,20,14
2019,169363,40,0,53,29,24
2019,169363,40,1,9,6,3
2019,169363,40,2,10,3,7
2019,169363,40,3,34,20,14
2019,169363,41,0,42,22,20
2019,169363,41,1,9,6,3
2019,169363,41,2,10,3,7
2019,169363,41,3,23,13,10
2019,169363,42,0,11,7,4
2019,169363,42,3,11,7,4
2019,169363,44,0,33,16,17
2019,169363,44,2,10,3,7
2019,169363,44,3,23,13,10
2019,169363,45,0,9,6,3
2019,169363,45,1,9,6,3
2019,169363,50,0,3,2,1
2019,169424,0,0,10,4,6
2019,169424,10,0,10,4,6
2019,169424,10,4,10,4,6
2019,169424,40,0,10,4,6
2019,169424,40,4,10,4,6
2019,169424,42,0,10,4,6
2019,169424,42,4,10,4,6
2019,169442,0,0,56,39,17
2019,169442,10,0,56,39,17
2019,169442,10,1,14,10,4
2019,169442,10,2,23,20,3
2019,169442,10,3,18,9,9
2019,169442,10,4,1,0,1
2019,169442,40,0,56,39,17
2019,169442,40,1,14,10,4
2019,169442,40,2,23,20,3
2019,169442,40,3,18,9,9
2019,169442,40,4,1,0,1
2019,169442,41,0,56,39,17
2019,169442,41,1,14,10,4
2019,169442,41,2,23,20,3
2019,169442,41,3,18,9,9
2019,169442,41,4,1,0,1
2019,169442,44,0,56,39,17
2019,169442,44,1,14,10,4
2019,169442,44,2,23,20,3
2019,169442,44,3,18,9,9
2019,169442,44,4,1,0,1
2019,169479,0,0,109,37,72
2019,169479,10,0,109,37,72
2019,169479,10,1,5,4,1
2019,169479,10,2,22,12,10
2019,169479,10,3,37,13,24
2019,169479,10,4,45,8,37
2019,169479,40,0,109,37,72
2019,169479,40,1,5,4,1
2019,169479,40,2,22,12,10
2019,169479,40,3,37,13,24
2019,169479,40,4,45,8,37
2019,169479,41,0,109,37,72
2019,169479,41,1,5,4,1
2019,169479,41,2,22,12,10
2019,169479,41,3,37,13,24
2019,169479,41,4,45,8,37
2019,169479,45,0,109,37,72
2019,169479,45,1,5,4,1
2019,169479,45,2,22,12,10
2019,169479,45,3,37,13,24
2019,169479,45,4,45,8,37
2019,169521,0,0,174,82,92
2019,169521,10,0,174,82,92
2019,169521,10,1,56,26,30
2019,169521,10,2,74,40,34
2019,169521,10,3,26,7,19
2019,169521,10,4,18,9,9
2019,169521,20,0,141,68,73
2019,169521,20,1,56,26,30
2019,169521,20,2,74,40,34
2019,169521,20,3,11,2,9
2019,169521,30,0,32,13,19
2019,169521,30,3,14,4,10
2019,169521,30,4,18,9,9
2019,169521,40,0,1,1,0
2019,169521,40,3,1,1,0
2019,169521,42,0,1,1,0
2019,169521,42,3,1,1,0
2019,169628,0,0,45,25,20
2019,169628,10,0,45,25,20
2019,169628,10,1,26,17,9
2019,169628,10,2,11,4,7
2019,169628,10,3,3,0,3
2019,169628,10,4,5,4,1
2019,169628,20,0,24,15,9
2019,169628,20,1,23,15,8
2019,169628,20,2,1,0,1
2019,169628,30,0,3,1,2
2019,169628,30,2,1,1,0
2019,169628,30,3,2,0,2
2019,169628,40,0,18,9,9
2019,169628,40,1,3,2,1
2019,169628,40,2,9,3,6
2019,169628,40,3,1,0,1
2019,169628,40,4,5,4,1
2019,169628,41,0,18,9,9
2019,169628,41,1,3,2,1
2019,169628,41,2,9,3,6
2019,169628,41,3,1,0,1
2019,169628,41,4,5,4,1
2019,169628,44,0,18,9,9
2019,169628,44,1,3,2,1
2019,169628,44,2,9,3,6
2019,169628,44,3,1,0,1
2019,169628,44,4,5,4,1
2019,169655,0,0,63,54,9
2019,169655,10,0,63,54,9
2019,169655,10,4,63,54,9
2019,169655,40,0,63,54,9
2019,169655,40,4,63,54,9
2019,169655,41,0,63,54,9
2019,169655,41,4,63,54,9
2019,169655,45,0,63,54,9
2019,169655,45,4,63,54,9
2019,169716,0,0,322,154,168
2019,169716,10,0,322,154,168
2019,169716,10,1,65,42,23
2019,169716,10,2,127,56,71
2019,169716,10,3,103,44,59
2019,169716,10,4,19,5,14
2019,169716,10,5,8,7,1
2019,169716,20,0,157,83,74
2019,169716,20,1,63,42,21
2019,169716,20,2,90,39,51
2019,169716,20,3,3,1,2
2019,169716,20,5,1,1,0
2019,169716,30,0,77,30,47
2019,169716,30,1,1,0,1
2019,169716,30,2,13,5,8
2019,169716,30,3,60,23,37
2019,169716,30,4,2,1,1
2019,169716,30,5,1,1,0
2019,169716,40,0,88,41,47
2019,169716,40,1,1,0,1
2019,169716,40,2,24,12,12
2019,169716,40,3,40,20,20
2019,169716,40,4,17,4,13
2019,169716,40,5,6,5,1
2019,169716,41,0,11,5,6
2019,169716,41,3,2,0,2
2019,169716,41,4,3,0,3
2019,169716,41,5,6,5,1
2019,169716,42,0,77,36,41
2019,169716,42,1,1,0,1
2019,169716,42,2,24,12,12
2019,169716,42,3,38,20,18
2019,169716,42,4,14,4,10
2019,169716,44,0,11,5,6
2019,169716,44,3,2,0,2
2019,169716,44,4,3,0,3
2019,169716,44,5,6,5,1
2019,169798,0,0,688,343,345
2019,169798,10,0,688,343,345
2019,169798,10,1,327,177,150
2019,169798,10,2,161,72,89
2019,169798,10,3,113,56,57
2019,169798,10,4,3,1,2
2019,169798,10,5,84,37,47
2019,169798,20,0,431,224,207
2019,169798,20,1,283,157,126
2019,169798,20,2,140,62,78
2019,169798,20,3,6,4,2
2019,169798,20,4,2,1,1
2019,169798,30,0,173,82,91
2019,169798,30,1,44,20,24
2019,169798,30,2,21,10,11
2019,169798,30,3,107,52,55
2019,169798,30,4,1,0,1
2019,169798,40,0,84,37,47
2019,169798,40,5,84,37,47
2019,169798,41,0,84,37,47
2019,169798,41,5,84,37,47
2019,169798,44,0,84,37,47
2019,169798,44,5,84,37,47
2019,169910,0,0,493,280,213
2019,169910,10,0,493,280,213
2019,169910,10,1,161,100,61
2019,169910,10,2,144,88,56
2019,169910,10,3,99,55,44
2019,169910,10,4,2,1,1
2019,169910,10,6,87,36,51
2019,169910,20,0,318,196,122
2019,169910,20,1,158,99,59
2019,169910,20,2,128,78,50
2019,169910,20,3,31,18,13
2019,169910,20,4,1,1,0
2019,169910,30,0,88,48,40
2019,169910,30,1,3,1,2
2019,169910,30,2,16,10,6
2019,169910,30,3,68,37,31
2019,169910,30,4,1,0,1
2019,169910,40,0,87,36,51
2019,169910,40,6,87,36,51
2019,169910,41,0,1,0,1
2019,169910,41,6,1,0,1
2019,169910,42,0,65,29,36
2019,169910,42,6,65,29,36
2019,169910,43,0,21,7,14
2019,169910,43,6,21,7,14
2019,169910,44,0,1,0,1
2019,169910,44,6,1,0,1
2019,169974,0,0,25,14,11
2019,169974,10,0,25,14,11
2019,169974,10,1,17,11,6
2019,169974,10,4,8,3,5
2019,169974,20,0,17,11,6
2019,169974,20,1,17,11,6
2019,169974,30,0,3,0,3
2019,169974,30,4,3,0,3
2019,169974,40,0,5,3,2
2019,169974,40,4,5,3,2
2019,169974,42,0,5,3,2
2019,169974,42,4,5,3,2
2019,169983,0,0,113,78,35
2019,169983,10,0,113,78,35
2019,169983,10,1,33,29,4
2019,169983,10,2,36,23,13
2019,169983,10,3,19,10,9
2019,169983,10,4,1,0,1
2019,169983,10,5,24,16,8
2019,169983,20,0,70,53,17
2019,169983,20,1,33,29,4
2019,169983,20,2,36,23,13
2019,169983,20,3,1,1,0
2019,169983,30,0,18,9,9
2019,169983,30,3,18,9,9
2019,169983,40,0,25,16,9
2019,169983,40,4,1,0,1
2019,169983,40,5,24,16,8
2019,169983,41,0,1,1,0
2019,169983,41,5,1,1,0
2019,169983,42,0,24,15,9
2019,169983,42,4,1,0,1
2019,169983,42,5,23,15,8
2019,169983,44,0,1,1,0
2019,169983,44,5,1,1,0
2019,169992,0,0,33,14,19
2019,169992,10,0,33,14,19
2019,169992,10,6,33,14,19
2019,169992,40,0,33,14,19
2019,169992,40,6,33,14,19
2019,169992,42,0,33,14,19
2019,169992,42,6,33,14,19
2019,170000,0,0,21,15,6
2019,170000,10,0,20,14,6
2019,170000,10,1,7,6,1
2019,170000,10,2,6,2,4
2019,170000,10,3,7,6,1
2019,170000,40,0,20,14,6
2019,170000,40,1,7,6,1
2019,170000,40,2,6,2,4
2019,170000,40,3,7,6,1
2019,170000,41,0,20,14,6
2019,170000,41,1,7,6,1
2019,170000,41,2,6,2,4
2019,170000,41,3,7,6,1
2019,170000,44,0,20,14,6
2019,170000,44,1,7,6,1
2019,170000,44,2,6,2,4
2019,170000,44,3,7,6,1
2019,170000,50,0,1,1,0
2019,170037,0,0,66,41,25
2019,170037,10,0,66,41,25
2019,170037,10,1,21,18,3
2019,170037,10,2,17,9,8
2019,170037,10,3,27,13,14
2019,170037,10,4,1,1,0
2019,170037,20,0,37,27,10
2019,170037,20,1,21,18,3
2019,170037,20,2,16,9,7
2019,170037,30,0,25,12,13
2019,170037,30,3,25,12,13
2019,170037,40,0,4,2,2
2019,170037,40,2,1,0,1
2019,170037,40,3,2,1,1
2019,170037,40,4,1,1,0
2019,170037,42,0,4,2,2
2019,170037,42,2,1,0,1
2019,170037,42,3,2,1,1
2019,170037,42,4,1,1,0
2019,170055,0,0,216,107,109
2019,170055,10,0,216,107,109
2019,170055,10,1,100,54,46
2019,170055,10,2,24,14,10
2019,170055,10,3,74,34,40
2019,170055,10,4,18,5,13
2019,170055,20,0,176,88,88
2019,170055,20,1,100,54,46
2019,170055,20,2,24,14,10
2019,170055,20,3,44,19,25
2019,170055,20,4,8,1,7
2019,170055,30,0,36,16,20
2019,170055,30,3,28,13,15
2019,170055,30,4,8,3,5
2019,170055,40,0,4,3,1
2019,170055,40,3,2,2,0
2019,170055,40,4,2,1,1
2019,170055,43,0,4,3,1
2019,170055,43,3,2,2,0
2019,170055,43,4,2,1,1
2019,170082,0,0,1141,572,569
2019,170082,10,0,1141,572,569
2019,170082,10,1,302,192,110
2019,170082,10,2,337,170,167
2019,170082,10,3,217,87,130
2019,170082,10,4,6,2,4
2019,170082,10,6,279,121,158
2019,170082,20,0,630,358,272
2019,170082,20,1,299,189,110
2019,170082,20,2,305,158,147
2019,170082,20,3,24,10,14
2019,170082,20,4,2,1,1
2019,170082,30,0,232,93,139
2019,170082,30,1,3,3,0
2019,170082,30,2,32,12,20
2019,170082,30,3,193,77,116
2019,170082,30,4,4,1,3
2019,170082,40,0,279,121,158
2019,170082,40,6,279,121,158
2019,170082,41,0,131,46,85
2019,170082,41,6,131,46,85
2019,170082,42,0,148,75,73
2019,170082,42,6,148,75,73
2019,170082,44,0,131,46,85
2019,170082,44,6,131,46,85
2019,170091,0,0,9,7,2
2019,170091,10,0,9,7,2
2019,170091,10,6,9,7,2
2019,170091,40,0,9,7,2
2019,170091,40,6,9,7,2
2019,170091,42,0,9,7,2
2019,170091,42,6,9,7,2
2019,170240,0,0,165,78,87
2019,170240,10,0,165,78,87
2019,170240,10,4,165,78,87
2019,170240,20,0,139,68,71
2019,170240,20,4,139,68,71
2019,170240,30,0,26,10,16
2019,170240,30,4,26,10,16
2019,170286,0,0,145,108,37
2019,170286,10,0,123,99,24
2019,170286,10,1,51,43,8
2019,170286,10,2,34,28,6
2019,170286,10,3,35,27,8
2019,170286,10,4,2,0,2
2019,170286,10,5,1,1,0
2019,170286,20,0,84,68,16
2019,170286,20,1,51,43,8
2019,170286,20,2,28,22,6
2019,170286,20,3,5,3,2
2019,170286,30,0,23,20,3
2019,170286,30,2,3,3,0
2019,170286,30,3,20,17,3
2019,170286,40,0,16,11,5
2019,170286,40,2,3,3,0
2019,170286,40,3,10,7,3
2019,170286,40,4,2,0,2
2019,170286,40,5,1,1,0
2019,170286,41,0,12,8,4
2019,170286,41,2,3,3,0
2019,170286,41,3,8,5,3
2019,170286,41,4,1,0,1
2019,170286,42,0,4,3,1
2019,170286,42,3,2,2,0
2019,170286,42,4,1,0,1
2019,170286,42,5,1,1,0
2019,170286,44,0,12,8,4
2019,170286,44,2,3,3,0
2019,170286,44,3,8,5,3
2019,170286,44,4,1,0,1
2019,170286,50,0,22,9,13
2019,170301,0,0,231,119,112
2019,170301,10,0,231,119,112
2019,170301,10,1,80,52,28
2019,170301,10,2,68,33,35
2019,170301,10,3,72,31,41
2019,170301,10,4,11,3,8
2019,170301,20,0,138,80,58
2019,170301,20,1,79,52,27
2019,170301,20,2,59,28,31
2019,170301,30,0,41,19,22
2019,170301,30,2,2,0,2
2019,170301,30,3,39,19,20
2019,170301,40,0,52,20,32
2019,170301,40,1,1,0,1
2019,170301,40,2,7,5,2
2019,170301,40,3,33,12,21
2019,170301,40,4,11,3,8
2019,170301,42,0,52,20,32
2019,170301,42,1,1,0,1
2019,170301,42,2,7,5,2
2019,170301,42,3,33,12,21
2019,170301,42,4,11,3,8
2019,170444,0,0,70,31,39
2019,170444,10,0,70,31,39
2019,170444,10,1,22,12,10
2019,170444,10,2,15,4,11
2019,170444,10,3,12,6,6
2019,170444,10,4,17,8,9
2019,170444,10,6,4,1,3
2019,170444,20,0,49,22,27
2019,170444,20,1,22,12,10
2019,170444,20,2,15,4,11
2019,170444,20,3,12,6,6
2019,170444,30,0,14,6,8
2019,170444,30,4,13,6,7
2019,170444,30,6,1,0,1
2019,170444,40,0,7,3,4
2019,170444,40,4,4,2,2
2019,170444,40,6,3,1,2
2019,170444,42,0,7,3,4
2019,170444,42,4,4,2,2
2019,170444,42,6,3,1,2
2019,170532,0,0,115,56,59
2019,170532,10,0,115,56,59
2019,170532,10,1,36,20,16
2019,170532,10,2,28,11,17
2019,170532,10,3,24,13,11
2019,170532,10,4,27,12,15
2019,170532,20,0,63,30,33
2019,170532,20,1,36,20,16
2019,170532,20,2,27,10,17
2019,170532,30,0,22,13,9
2019,170532,30,2,1,1,0
2019,170532,30,3,21,12,9
2019,170532,40,0,30,13,17
2019,170532,40,3,3,1,2
2019,170532,40,4,27,12,15
2019,170532,41,0,12,6,6
2019,170532,41,3,2,1,1
2019,170532,41,4,10,5,5
2019,170532,42,0,18,7,11
2019,170532,42,3,1,0,1
2019,170532,42,4,17,7,10
2019,170532,44,0,11,6,5
2019,170532,44,3,2,1,1
2019,170532,44,4,9,5,4
2019,170532,45,0,1,0,1
2019,170532,45,4,1,0,1
2019,170541,0,0,122,70,52
2019,170541,10,0,121,69,52
2019,170541,10,4,121,69,52
2019,170541,20,0,84,51,33
2019,170541,20,4,84,51,33
2019,170541,30,0,37,18,19
2019,170541,30,4,37,18,19
2019,170541,50,0,1,1,0
2019,170550,0,0,85,38,47
2019,170550,10,0,85,38,47
2019,170550,10,1,71,33,38
2019,170550,10,4,14,5,9
2019,170550,20,0,71,33,38
2019,170550,20,1,71,33,38
2019,170550,30,0,12,4,8
2019,170550,30,4,12,4,8
2019,170550,40,0,2,1,1
2019,170550,40,4,2,1,1
2019,170550,43,0,2,1,1
2019,170550,43,4,2,1,1
2019,170587,0,0,26,14,12
2019,170587,10,0,26,14,12
2019,170587,10,4,26,14,12
2019,170587,40,0,26,14,12
2019,170587,40,4,26,14,12
2019,170587,42,0,26,14,12
2019,170587,42,4,26,14,12
2019,170620,0,0,60,32,28
2019,170620,10,0,60,32,28
2019,170620,10,4,51,26,25
2019,170620,10,5,6,4,2
2019,170620,10,6,3,2,1
2019,170620,40,0,60,32,28
2019,170620,40,4,51,26,25
2019,170620,40,5,6,4,2
2019,170620,40,6,3,2,1
2019,170620,41,0,51,26,25
2019,170620,41,4,48,24,24
2019,170620,41,6,3,2,1
2019,170620,42,0,9,6,3
2019,170620,42,4,3,2,1
2019,170620,42,5,6,4,2
2019,170620,44,0,51,26,25
2019,170620,44,4,48,24,24
2019,170620,44,6,3,2,1
2019,170639,0,0,98,60,38
2019,170639,10,0,95,57,38
2019,170639,10,1,21,16,5
2019,170639,10,2,24,17,7
2019,170639,10,3,39,16,23
2019,170639,10,4,7,5,2
2019,170639,10,6,4,3,1
2019,170639,20,0,61,36,25
2019,170639,20,1,21,16,5
2019,170639,20,2,23,16,7
2019,170639,20,3,17,4,13
2019,170639,30,0,20,13,7
2019,170639,30,2,1,1,0
2019,170639,30,3,16,10,6
2019,170639,30,6,3,2,1
2019,170639,40,0,14,8,6
2019,170639,40,3,6,2,4
2019,170639,40,4,7,5,2
2019,170639,40,6,1,1,0
2019,170639,41,0,2,1,1
2019,170639,41,3,1,1,0
2019,170639,41,4,1,0,1
2019,170639,42,0,5,4,1
2019,170639,42,3,1,0,1
2019,170639,42,4,3,3,0
2019,170639,42,6,1,1,0
2019,170639,43,0,7,3,4
2019,170639,43,3,4,1,3
2019,170639,43,4,3,2,1
2019,170639,44,0,2,1,1
2019,170639,44,3,1,1,0
2019,170639,44,4,1,0,1
2019,170639,50,0,3,3,0
2019,170657,0,0,202,108,94
2019,170657,10,0,202,108,94
2019,170657,10,1,202,108,94
2019,170657,40,0,202,108,94
2019,170657,40,1,202,108,94
2019,170657,42,0,202,108,94
2019,170657,42,1,202,108,94
2019,170675,0,0,104,78,26
2019,170675,10,0,104,78,26
2019,170675,10,1,10,7,3
2019,170675,10,2,26,22,4
2019,170675,10,3,38,29,9
2019,170675,10,5,30,20,10
2019,170675,20,0,41,35,6
2019,170675,20,1,9,7,2
2019,170675,20,2,25,21,4
2019,170675,20,3,7,7,0
2019,170675,30,0,25,18,7
2019,170675,30,3,23,16,7
2019,170675,30,5,2,2,0
2019,170675,40,0,38,25,13
2019,170675,40,1,1,0,1
2019,170675,40,2,1,1,0
2019,170675,40,3,8,6,2
2019,170675,40,5,28,18,10
2019,170675,42,0,38,25,13
2019,170675,42,1,1,0,1
2019,170675,42,2,1,1,0
2019,170675,42,3,8,6,2
2019,170675,42,5,28,18,10
2019,170790,0,0,204,103,101
2019,170790,10,0,204,103,101
2019,170790,10,6,204,103,101
2019,170790,40,0,204,103,101
2019,170790,40,6,204,103,101
2019,170790,41,0,201,101,100
2019,170790,41,6,201,101,100
2019,170790,42,0,3,2,1
2019,170790,42,6,3,2,1
2019,170790,44,0,201,101,100
2019,170790,44,6,201,101,100
2019,170806,0,0,90,21,69
2019,170806,10,0,90,21,69
2019,170806,10,1,17,8,9
2019,170806,10,2,17,3,14
2019,170806,10,3,50,9,41
2019,170806,10,4,6,1,5
2019,170806,40,0,90,21,69
2019,170806,40,1,17,8,9
2019,170806,40,2,17,3,14
2019,170806,40,3,50,9,41
2019,170806,40,4,6,1,5
2019,170806,42,0,90,21,69
2019,170806,42,1,17,8,9
2019,170806,42,2,17,3,14
2019,170806,42,3,50,9,41
2019,170806,42,4,6,1,5
2019,170967,0,0,35,17,18
2019,170967,10,0,35,17,18
2019,170967,10,1,11,8,3
2019,170967,10,2,13,5,8
2019,170967,10,3,11,4,7
2019,170967,20,0,12,8,4
2019,170967,20,1,10,7,3
2019,170967,20,2,1,0,1
2019,170967,20,3,1,1,0
2019,170967,30,0,23,9,14
2019,170967,30,1,1,1,0
2019,170967,30,2,12,5,7
2019,170967,30,3,10,3,7
2019,170976,0,0,6787,3983,2804
2019,170976,10,0,6787,3983,2804
2019,170976,10,1,1740,1247,493
2019,170976,10,2,1060,604,456
2019,170976,10,3,1452,754,698
2019,170976,10,4,174,73,101
2019,170976,10,5,738,326,412
2019,170976,10,6,1623,979,644
2019,170976,20,0,2186,1480,706
2019,170976,20,1,1480,1074,406
2019,170976,20,2,706,406,300
2019,170976,30,0,641,349,292
2019,170976,30,1,1,1,0
2019,170976,30,2,19,12,7
2019,170976,30,3,621,336,285
2019,170976,40,0,3960,2154,1806
2019,170976,40,1,259,172,87
2019,170976,40,2,335,186,149
2019,170976,40,3,831,418,413
2019,170976,40,4,174,73,101
2019,170976,40,5,738,326,412
2019,170976,40,6,1623,979,644
2019,170976,41,0,3881,2123,1758
2019,170976,41,1,254,170,84
2019,170976,41,2,334,185,149
2019,170976,41,3,829,418,411
2019,170976,41,4,174,73,101
2019,170976,41,5,667,298,369
2019,170976,41,6,1623,979,644
2019,170976,43,0,79,31,48
2019,170976,43,1,5,2,3
2019,170976,43,2,1,1,0
2019,170976,43,3,2,0,2
2019,170976,43,5,71,28,43
2019,170976,45,0,3881,2123,1758
2019,170976,45,1,254,170,84
2019,170976,45,2,334,185,149
2019,170976,45,3,829,418,411
2019,170976,45,4,174,73,101
2019,170976,45,5,667,298,369
2019,170976,45,6,1623,979,644
2019,171100,0,0,2971,1702,1269
2019,171100,10,0,2747,1603,1144
2019,171100,10,1,873,629,244
2019,171100,10,2,708,414,294
2019,171100,10,3,946,472,474
2019,171100,10,4,212,83,129
2019,171100,10,5,8,5,3
2019,171100,20,0,1385,914,471
2019,171100,20,1,813,587,226
2019,171100,20,2,572,327,245
2019,171100,30,0,466,244,222
2019,171100,30,2,15,9,6
2019,171100,30,3,451,235,216
2019,171100,40,0,896,445,451
2019,171100,40,1,60,42,18
2019,171100,40,2,121,78,43
2019,171100,40,3,495,237,258
2019,171100,40,4,212,83,129
2019,171100,40,5,8,5,3
2019,171100,41,0,279,156,123
2019,171100,41,1,34,24,10
2019,171100,41,2,67,45,22
2019,171100,41,3,159,78,81
2019,171100,41,4,17,7,10
2019,171100,41,5,2,2,0
2019,171100,42,0,565,254,311
2019,171100,42,1,23,15,8
2019,171100,42,2,44,25,19
2019,171100,42,3,310,142,168
2019,171100,42,4,185,71,114
2019,171100,42,5,3,1,2
2019,171100,43,0,52,35,17
2019,171100,43,1,3,3,0
2019,171100,43,2,10,8,2
2019,171100,43,3,26,17,9
2019,171100,43,4,10,5,5
2019,171100,43,5,3,2,1
2019,171100,44,0,279,156,123
2019,171100,44,1,34,24,10
2019,171100,44,2,67,45,22
2019,171100,44,3,159,78,81
2019,171100,44,4,17,7,10
2019,171100,44,5,2,2,0
2019,171100,50,0,224,99,125
2019,171128,0,0,409,284,125
2019,171128,10,0,409,284,125
2019,171128,10,1,121,94,27
2019,171128,10,2,124,91,33
2019,171128,10,3,76,46,30
2019,171128,10,4,26,19,7
2019,171128,10,5,62,34,28
2019,171128,20,0,239,181,58
2019,171128,20,1,121,94,27
2019,171128,20,2,118,87,31
2019,171128,30,0,82,50,32
2019,171128,30,2,6,4,2
2019,171128,30,3,76,46,30
2019,171128,40,0,88,53,35
2019,171128,40,4,26,19,7
2019,171128,40,5,62,34,28
2019,171128,41,0,81,47,34
2019,171128,41,4,19,13,6
2019,171128,41,5,62,34,28
2019,171128,42,0,7,6,1
2019,171128,42,4,7,6,1
2019,171128,44,0,22,14,8
2019,171128,44,4,1,0,1
2019,171128,44,5,21,14,7
2019,171128,45,0,59,33,26
2019,171128,45,4,18,13,5
2019,171128,45,5,41,20,21
2019,171137,0,0,371,216,155
2019,171137,10,0,371,216,155
2019,171137,10,1,87,59,28
2019,171137,10,2,113,63,50
2019,171137,10,3,71,48,23
2019,171137,10,5,100,46,54
2019,171137,20,0,194,119,75
2019,171137,20,1,86,58,28
2019,171137,20,2,108,61,47
2019,171137,30,0,74,49,25
2019,171137,30,2,3,1,2
2019,171137,30,3,71,48,23
2019,171137,40,0,103,48,55
2019,171137,40,1,1,1,0
2019,171137,40,2,2,1,1
2019,171137,40,5,100,46,54
2019,171137,41,0,90,41,49
2019,171137,41,1,1,1,0
2019,171137,41,2,2,1,1
2019,171137,41,5,87,39,48
2019,171137,43,0,13,7,6
2019,171137,43,5,13,7,6
2019,171137,45,0,90,41,49
2019,171137,45,1,1,1,0
2019,171137,45,2,2,1,1
2019,171137,45,5,87,39,48
2019,171146,0,0,302,141,161
2019,171146,10,0,302,141,161
2019,171146,10,1,46,30,16
2019,171146,10,2,96,40,56
2019,171146,10,3,70,31,39
2019,171146,10,5,89,39,50
2019,171146,10,6,1,1,0
2019,171146,20,0,135,69,66
2019,171146,20,1,45,30,15
2019,171146,20,2,90,39,51
2019,171146,30,0,56,28,28
2019,171146,30,2,1,0,1
2019,171146,30,3,55,28,27
2019,171146,40,0,111,44,67
2019,171146,40,1,1,0,1
2019,171146,40,2,5,1,4
2019,171146,40,3,15,3,12
2019,171146,40,5,89,39,50
2019,171146,40,6,1,1,0
2019,171146,41,0,101,41,60
2019,171146,41,1,1,0,1
2019,171146,41,2,5,1,4
2019,171146,41,3,15,3,12
2019,171146,41,5,79,36,43
2019,171146,41,6,1,1,0
2019,171146,43,0,10,3,7
2019,171146,43,5,10,3,7
2019,171146,45,0,101,41,60
2019,171146,45,1,1,0,1
2019,171146,45,2,5,1,4
2019,171146,45,3,15,3,12
2019,171146,45,5,79,36,43
2019,171146,45,6,1,1,0
2019,171155,0,0,52,22,30
2019,171155,10,0,51,22,29
2019,171155,10,1,20,10,10
2019,171155,10,2,8,3,5
2019,171155,10,3,7,3,4
2019,171155,10,4,16,6,10
2019,171155,40,0,51,22,29
2019,171155,40,1,20,10,10
2019,171155,40,2,8,3,5
2019,171155,40,3,7,3,4
2019,171155,40,4,16,6,10
2019,171155,42,0,51,22,29
2019,171155,42,1,20,10,10
2019,171155,42,2,8,3,5
2019,171155,42,3,7,3,4
2019,171155,42,4,16,6,10
2019,171155,50,0,1,0,1
2019,171225,0,0,51,25,26
2019,171225,10,0,51,25,26
2019,171225,10,1,8,6,2
2019,171225,10,2,10,7,3
2019,171225,10,3,21,5,16
2019,171225,10,4,12,7,5
2019,171225,20,0,35,16,19
2019,171225,20,1,7,5,2
2019,171225,20,2,7,5,2
2019,171225,20,3,15,3,12
2019,171225,20,4,6,3,3
2019,171225,30,0,16,9,7
2019,171225,30,1,1,1,0
2019,171225,30,2,3,2,1
2019,171225,30,3,6,2,4
2019,171225,30,4,6,4,2
2019,171234,0,0,31,12,19
2019,171234,10,0,31,12,19
2019,171234,10,4,31,12,19
2019,171234,20,0,20,8,12
2019,171234,20,4,20,8,12
2019,171234,30,0,11,4,7
2019,171234,30,4,11,4,7
2019,171304,0,0,83,47,36
2019,171304,10,0,83,47,36
2019,171304,10,6,83,47,36
2019,171304,40,0,83,47,36
2019,171304,40,6,83,47,36
2019,171304,42,0,83,47,36
2019,171304,42,6,83,47,36
2019,171395,0,0,33,19,14
2019,171395,10,0,31,17,14
2019,171395,10,1,28,17,11
2019,171395,10,4,3,0,3
2019,171395,40,0,31,17,14
2019,171395,40,1,28,17,11
2019,171395,40,4,3,0,3
2019,171395,43,0,31,17,14
2019,171395,43,1,28,17,11
2019,171395,43,4,3,0,3
2019,171395,50,0,2,2,0
2019,171456,0,0,304,168,136
2019,171456,10,0,304,168,136
2019,171456,10,1,112,67,45
2019,171456,10,2,64,40,24
2019,171456,10,3,72,38,34
2019,171456,10,4,37,11,26
2019,171456,10,6,19,12,7
2019,171456,20,0,165,102,63
2019,171456,20,1,110,67,43
2019,171456,20,2,55,35,20
2019,171456,30,0,50,27,23
2019,171456,30,2,1,0,1
2019,171456,30,3,48,27,21
2019,171456,30,4,1,0,1
2019,171456,40,0,89,39,50
2019,171456,40,1,2,0,2
2019,171456,40,2,8,5,3
2019,171456,40,3,24,11,13
2019,171456,40,4,36,11,25
2019,171456,40,6,19,12,7
2019,171456,41,0,50,26,24
2019,171456,41,1,2,0,2
2019,171456,41,2,8,5,3
2019,171456,41,3,14,8,6
2019,171456,41,4,19,8,11
2019,171456,41,6,7,5,2
2019,171456,42,0,23,6,17
2019,171456,42,3,9,3,6
2019,171456,42,4,12,2,10
2019,171456,42,6,2,1,1
2019,171456,43,0,16,7,9
2019,171456,43,3,1,0,1
2019,171456,43,4,5,1,4
2019,171456,43,6,10,6,4
2019,171456,44,0,26,16,10
2019,171456,44,3,9,7,2
2019,171456,44,4,14,6,8
2019,171456,44,6,3,3,0
2019,171456,45,0,24,10,14
2019,171456,45,1,2,0,2
2019,171456,45,2,8,5,3
2019,171456,45,3,5,1,4
2019,171456,45,4,5,2,3
2019,171456,45,6,4,2,2
2019,171483,0,0,79,45,34
2019,171483,10,0,79,45,34
2019,171483,10,6,79,45,34
2019,171483,40,0,79,45,34
2019,171483,40,6,79,45,34
2019,171483,42,0,78,44,34
2019,171483,42,6,78,44,34
2019,171483,43,0,1,1,0
2019,171483,43,6,1,1,0
2019,171492,0,0,52,27,25
2019,171492,10,0,52,27,25
2019,171492,10,1,9,5,4
2019,171492,10,2,16,9,7
2019,171492,10,3,27,13,14
2019,171492,40,0,52,27,25
2019,171492,40,1,9,5,4
2019,171492,40,2,16,9,7
2019,171492,40,3,27,13,14
2019,171492,42,0,52,27,25
2019,171492,42,1,9,5,4
2019,171492,42,2,16,9,7
2019,171492,42,3,27,13,14
2019,171535,0,0,204,97,107
2019,171535,10,0,204,97,107
2019,171535,10,6,204,97,107
2019,171535,40,0,204,97,107
2019,171535,40,6,204,97,107
2019,171535,41,0,199,96,103
2019,171535,41,6,199,96,103
2019,171535,42,0,3,1,2
2019,171535,42,6,3,1,2
2019,171535,43,0,2,0,2
2019,171535,43,6,2,0,2
2019,171535,44,0,5,1,4
2019,171535,44,6,5,1,4
2019,171535,45,0,194,95,99
2019,171535,45,6,194,95,99
2019,171571,0,0,640,324,316
2019,171571,10,0,640,324,316
2019,171571,10,1,146,102,44
2019,171571,10,2,243,119,124
2019,171571,10,3,187,87,100
2019,171571,10,4,64,16,48
2019,171571,20,0,394,215,179
2019,171571,20,1,141,98,43
2019,171571,20,2,232,114,118
2019,171571,20,4,21,3,18
2019,171571,30,0,186,85,101
2019,171571,30,2,8,4,4
2019,171571,30,3,155,72,83
2019,171571,30,4,23,9,14
2019,171571,40,0,60,24,36
2019,171571,40,1,5,4,1
2019,171571,40,2,3,1,2
2019,171571,40,3,32,15,17
2019,171571,40,4,20,4,16
2019,171571,41,0,25,9,16
2019,171571,41,1,1,1,0
2019,171571,41,2,3,1,2
2019,171571,41,3,7,4,3
2019,171571,41,4,14,3,11
2019,171571,42,0,35,15,20
2019,171571,42,1,4,3,1
2019,171571,42,3,25,11,14
2019,171571,42,4,6,1,5
2019,171571,44,0,25,9,16
2019,171571,44,1,1,1,0
2019,171571,44,2,3,1,2
2019,171571,44,3,7,4,3
2019,171571,44,4,14,3,11
2019,171599,0,0,45,26,19
2019,171599,10,0,45,26,19
2019,171599,10,1,9,6,3
2019,171599,10,2,16,8,8
2019,171599,10,3,20,12,8
2019,171599,20,0,29,16,13
2019,171599,20,1,9,6,3
2019,171599,20,2,16,8,8
2019,171599,20,3,4,2,2
2019,171599,30,0,11,8,3
2019,171599,30,3,11,8,3
2019,171599,40,0,5,2,3
2019,171599,40,3,5,2,3
2019,171599,42,0,5,2,3
2019,171599,42,3,5,2,3
2019,171881,0,0,9,6,3
2019,171881,10,0,9,6,3
2019,171881,10,1,6,4,2
2019,171881,10,2,2,2,0
2019,171881,10,3,1,0,1
2019,171881,20,0,6,4,2
2019,171881,20,1,6,4,2
2019,171881,30,0,3,2,1
2019,171881,30,2,2,2,0
2019,171881,30,3,1,0,1
2019,172033,0,0,15,13,2
2019,172033,10,0,15,13,2
2019,172033,10,1,10,8,2
2019,172033,10,2,2,2,0
2019,172033,10,3,2,2,0
2019,172033,10,4,1,1,0
2019,172033,40,0,15,13,2
2019,172033,40,1,10,8,2
2019,172033,40,2,2,2,0
2019,172033,40,3,2,2,0
2019,172033,40,4,1,1,0
2019,172033,41,0,15,13,2
2019,172033,41,1,10,8,2
2019,172033,41,2,2,2,0
2019,172033,41,3,2,2,0
2019,172033,41,4,1,1,0
2019,172033,44,0,15,13,2
2019,172033,44,1,10,8,2
2019,172033,44,2,2,2,0
2019,172033,44,3,2,2,0
2019,172033,44,4,1,1,0
2019,172051,0,0,285,149,136
2019,172051,10,0,285,149,136
2019,172051,10,1,104,69,35
2019,172051,10,2,96,42,54
2019,172051,10,3,67,28,39
2019,172051,10,4,1,1,0
2019,172051,10,5,17,9,8
2019,172051,20,0,211,117,94
2019,172051,20,1,104,69,35
2019,172051,20,2,96,42,54
2019,172051,20,3,11,6,5
2019,172051,30,0,46,20,26
2019,172051,30,3,46,20,26
2019,172051,40,0,28,12,16
2019,172051,40,3,10,2,8
2019,172051,40,4,1,1,0
2019,172051,40,5,17,9,8
2019,172051,42,0,28,12,16
2019,172051,42,3,10,2,8
2019,172051,42,4,1,1,0
2019,172051,42,5,17,9,8
2019,172200,0,0,88,43,45
2019,172200,10,0,88,43,45
2019,172200,10,6,88,43,45
2019,172200,40,0,88,43,45
2019,172200,40,6,88,43,45
2019,172200,42,0,88,43,45
2019,172200,42,6,88,43,45
2019,172264,0,0,89,46,43
2019,172264,10,0,89,46,43
2019,172264,10,1,21,14,7
2019,172264,10,2,27,11,16
2019,172264,10,3,36,19,17
2019,172264,10,4,5,2,3
2019,172264,40,0,89,46,43
2019,172264,40,1,21,14,7
2019,172264,40,2,27,11,16
2019,172264,40,3,36,19,17
2019,172264,40,4,5,2,3
2019,172264,42,0,89,46,43
2019,172264,42,1,21,14,7
2019,172264,42,2,27,11,16
2019,172264,42,3,36,19,17
2019,172264,42,4,5,2,3
2019,172291,0,0,62,27,35
2019,172291,10,0,62,27,35
2019,172291,10,1,54,26,28
2019,172291,10,4,8,1,7
2019,172291,20,0,54,26,28
2019,172291,20,1,54,26,28
2019,172291,30,0,8,1,7
2019,172291,30,4,8,1,7
2019,172307,0,0,58,29,29
2019,172307,10,0,58,29,29
2019,172307,10,1,20,8,12
2019,172307,10,2,13,7,6
2019,172307,10,3,25,14,11
2019,172307,40,0,58,29,29
2019,172307,40,1,20,8,12
2019,172307,40,2,13,7,6
2019,172307,40,3,25,14,11
2019,172307,41,0,49,22,27
2019,172307,41,1,20,8,12
2019,172307,41,2,13,7,6
2019,172307,41,3,16,7,9
2019,172307,42,0,9,7,2
2019,172307,42,3,9,7,2
2019,172307,44,0,49,22,27
2019,172307,44,1,20,8,12
2019,172307,44,2,13,7,6
2019,172307,44,3,16,7,9
2019,172334,0,0,89,52,37
2019,172334,10,0,89,52,37
2019,172334,10,1,32,23,9
2019,172334,10,2,29,19,10
2019,172334,10,3,28,10,18
2019,172334,20,0,47,36,11
2019,172334,20,1,31,23,8
2019,172334,20,2,16,13,3
2019,172334,30,0,40,15,25
2019,172334,30,1,1,0,1
2019,172334,30,2,13,6,7
2019,172334,30,3,26,9,17
2019,172334,40,0,2,1,1
2019,172334,40,3,2,1,1
2019,172334,42,0,2,1,1
2019,172334,42,3,2,1,1
2019,172440,0,0,29,15,14
2019,172440,10,0,29,15,14
2019,172440,10,1,2,0,2
2019,172440,10,2,4,2,2
2019,172440,10,3,21,11,10
2019,172440,10,6,2,2,0
2019,172440,20,0,9,5,4
2019,172440,20,1,2,0,2
2019,172440,20,2,4,2,2
2019,172440,20,3,3,3,0
2019,172440,30,0,14,7,7
2019,172440,30,3,14,7,7
2019,172440,40,0,6,3,3
2019,172440,40,3,4,1,3
2019,172440,40,6,2,2,0
2019,172440,42,0,6,3,3
2019,172440,42,3,4,1,3
2019,172440,42,6,2,2,0
2019,172477,0,0,48,25,23
2019,172477,10,0,46,23,23
2019,172477,10,1,34,20,14
2019,172477,10,2,6,2,4
2019,172477,10,3,6,1,5
2019,172477,20,0,34,20,14
2019,172477,20,1,34,20,14
2019,172477,30,0,7,2,5
2019,172477,30,2,6,2,4
2019,172477,30,3,1,0,1
2019,172477,40,0,5,1,4
2019,172477,40,3,5,1,4
2019,172477,41,0,3,1,2
2019,172477,41,3,3,1,2
2019,172477,42,0,1,0,1
2019,172477,42,3,1,0,1
2019,172477,43,0,1,0,1
2019,172477,43,3,1,0,1
2019,172477,44,0,3,1,2
2019,172477,44,3,3,1,2
2019,172477,50,0,2,2,0
2019,172608,0,0,24,16,8
2019,172608,10,0,24,16,8
2019,172608,10,1,13,6,7
2019,172608,10,2,8,8,0
2019,172608,10,3,3,2,1
2019,172608,40,0,24,16,8
2019,172608,40,1,13,6,7
2019,172608,40,2,8,8,0
2019,172608,40,3,3,2,1
2019,172608,41,0,24,16,8
2019,172608,41,1,13,6,7
2019,172608,41,2,8,8,0
2019,172608,41,3,3,2,1
2019,172608,44,0,24,16,8
2019,172608,44,1,13,6,7
2019,172608,44,2,8,8,0
2019,172608,44,3,3,2,1
2019,172617,0,0,161,79,82
2019,172617,10,0,161,79,82
2019,172617,10,6,161,79,82
2019,172617,40,0,161,79,82
2019,172617,40,6,161,79,82
2019,172617,41,0,161,79,82
2019,172617,41,6,161,79,82
2019,172617,44,0,161,79,82
2019,172617,44,6,161,79,82
2019,172635,0,0,69,31,38
2019,172635,10,0,69,31,38
2019,172635,10,4,69,31,38
2019,172635,40,0,69,31,38
2019,172635,40,4,69,31,38
2019,172635,41,0,69,31,38
2019,172635,41,4,69,31,38
2019,172635,45,0,69,31,38
2019,172635,45,4,69,31,38
2019,172644,0,0,1630,921,709
2019,172644,10,0,1630,921,709
2019,172644,10,1,488,360,128
2019,172644,10,2,477,264,213
2019,172644,10,3,439,207,232
2019,172644,10,4,30,6,24
2019,172644,10,5,196,84,112
2019,172644,20,0,749,500,249
2019,172644,20,1,390,295,95
2019,172644,20,2,345,193,152
2019,172644,20,3,12,10,2
2019,172644,20,5,2,2,0
2019,172644,30,0,164,91,73
2019,172644,30,1,1,1,0
2019,172644,30,2,9,6,3
2019,172644,30,3,154,84,70
2019,172644,40,0,717,330,387
2019,172644,40,1,97,64,33
2019,172644,40,2,123,65,58
2019,172644,40,3,273,113,160
2019,172644,40,4,30,6,24
2019,172644,40,5,194,82,112
2019,172644,41,0,685,325,360
2019,172644,41,1,96,63,33
2019,172644,41,2,123,65,58
2019,172644,41,3,271,113,158
2019,172644,41,4,3,2,1
2019,172644,41,5,192,82,110
2019,172644,42,0,32,5,27
2019,172644,42,1,1,1,0
2019,172644,42,3,2,0,2
2019,172644,42,4,27,4,23
2019,172644,42,5,2,0,2
2019,172644,44,0,685,325,360
2019,172644,44,1,96,63,33
2019,172644,44,2,123,65,58
2019,172644,44,3,271,113,158
2019,172644,44,4,3,2,1
2019,172644,44,5,192,82,110
2019,172671,0,0,25,16,9
2019,172671,10,0,25,16,9
2019,172671,10,1,17,12,5
2019,172671,10,2,8,4,4
2019,172671,20,0,17,12,5
2019,172671,20,1,17,12,5
2019,172671,30,0,8,4,4
2019,172671,30,2,8,4,4
2019,172699,0,0,851,458,393
2019,172699,10,0,851,458,393
2019,172699,10,1,340,228,112
2019,172699,10,2,244,124,120
2019,172699,10,3,195,76,119
2019,172699,10,4,72,30,42
2019,172699,20,0,582,343,239
2019,172699,20,1,337,226,111
2019,172699,20,2,229,114,115
2019,172699,20,3,16,3,13
2019,172699,30,0,192,83,109
2019,172699,30,1,3,2,1
2019,172699,30,2,13,9,4
2019,172699,30,3,159,66,93
2019,172699,30,4,17,6,11
2019,172699,40,0,77,32,45
2019,172699,40,2,2,1,1
2019,172699,40,3,20,7,13
2019,172699,40,4,55,24,31
2019,172699,42,0,77,32,45
2019,172699,42,2,2,1,1
2019,172699,42,3,20,7,13
2019,172699,42,4,55,24,31
2019,172705,0,0,11,9,2
2019,172705,10,0,11,9,2
2019,172705,10,1,8,7,1
2019,172705,10,3,3,2,1
2019,172705,20,0,8,7,1
2019,172705,20,1,8,7,1
2019,172705,30,0,3,2,1
2019,172705,30,3,3,2,1
2019,172918,0,0,63,34,29
2019,172918,10,0,63,34,29
2019,172918,10,4,63,34,29
2019,172918,20,0,52,30,22
2019,172918,20,4,52,30,22
2019,172918,30,0,11,4,7
2019,172918,30,4,11,4,7
2019,172954,0,0,55,22,33
2019,172954,10,0,55,22,33
2019,172954,10,4,55,22,33
2019,172954,20,0,45,17,28
2019,172954,20,4,45,17,28
2019,172954,30,0,8,3,5
2019,172954,30,4,8,3,5
2019,172954,40,0,2,2,0
2019,172954,40,4,2,2,0
2019,172954,42,0,2,2,0
2019,172954,42,4,2,2,0
2019,172963,0,0,124,52,72
2019,172963,10,0,124,52,72
2019,172963,10,4,124,52,72
2019,172963,20,0,113,47,66
2019,172963,20,4,113,47,66
2019,172963,30,0,8,2,6
2019,172963,30,4,8,2,6
2019,172963,40,0,3,3,0
2019,172963,40,4,3,3,0
2019,172963,42,0,3,3,0
2019,172963,42,4,3,3,0
2019,173045,0,0,179,83,96
2019,173045,10,0,179,83,96
2019,173045,10,1,42,21,21
2019,173045,10,2,56,33,23
2019,173045,10,3,59,23,36
2019,173045,10,4,22,6,16
2019,173045,20,0,93,52,41
2019,173045,20,1,41,20,21
2019,173045,20,2,51,31,20
2019,173045,20,3,1,1,0
2019,173045,30,0,44,16,28
2019,173045,30,2,2,1,1
2019,173045,30,3,42,15,27
2019,173045,40,0,42,15,27
2019,173045,40,1,1,1,0
2019,173045,40,2,3,1,2
2019,173045,40,3,16,7,9
2019,173045,40,4,22,6,16
2019,173045,42,0,42,15,27
2019,173045,42,1,1,1,0
2019,173045,42,2,3,1,2
2019,173045,42,3,16,7,9
2019,173045,42,4,22,6,16
2019,173063,0,0,68,31,37
2019,173063,10,0,68,31,37
2019,173063,10,4,68,31,37
2019,173063,20,0,48,24,24
2019,173063,20,4,48,24,24
2019,173063,30,0,17,6,11
2019,173063,30,4,17,6,11
2019,173063,40,0,3,1,2
2019,173063,40,4,3,1,2
2019,173063,43,0,3,1,2
2019,173063,43,4,3,1,2
2019,173115,0,0,19,5,14
2019,173115,10,0,19,5,14
2019,173115,10,4,19,5,14
2019,173115,20,0,11,2,9
2019,173115,20,4,11,2,9
2019,173115,30,0,8,3,5
2019,173115,30,4,8,3,5
2019,173124,0,0,156,79,77
2019,173124,10,0,156,79,77
2019,173124,10,1,45,28,17
2019,173124,10,2,42,23,19
2019,173124,10,3,69,28,41
2019,173124,20,0,80,47,33
2019,173124,20,1,44,27,17
2019,173124,20,2,33,19,14
2019,173124,20,3,3,1,2
2019,173124,30,0,57,25,32
2019,173124,30,1,1,1,0
2019,173124,30,2,7,3,4
2019,173124,30,3,49,21,28
2019,173124,40,0,19,7,12
2019,173124,40,2,2,1,1
2019,173124,40,3,17,6,11
2019,173124,42,0,19,7,12
2019,173124,42,2,2,1,1
2019,173124,42,3,17,6,11
2019,173142,0,0,42,26,16
2019,173142,10,0,42,26,16
2019,173142,10,1,15,12,3
2019,173142,10,2,16,10,6
2019,173142,10,3,10,4,6
2019,173142,10,4,1,0,1
2019,173142,40,0,42,26,16
2019,173142,40,1,15,12,3
2019,173142,40,2,16,10,6
2019,173142,40,3,10,4,6
2019,173142,40,4,1,0,1
2019,173142,42,0,4,1,3
2019,173142,42,2,2,1,1
2019,173142,42,3,2,0,2
2019,173142,43,0,38,25,13
2019,173142,43,1,15,12,3
2019,173142,43,2,14,9,5
2019,173142,43,3,8,4,4
2019,173142,43,4,1,0,1
2019,173160,0,0,197,89,108
2019,173160,10,0,197,89,108
2019,173160,10,1,73,45,28
2019,173160,10,2,86,35,51
2019,173160,10,3,31,8,23
2019,173160,10,4,7,1,6
2019,173160,20,0,119,70,49
2019,173160,20,1,69,43,26
2019,173160,20,2,48,26,22
2019,173160,20,3,1,1,0
2019,173160,20,4,1,0,1
2019,173160,30,0,56,14,42
2019,173160,30,1,2,0,2
2019,173160,30,2,30,6,24
2019,173160,30,3,22,7,15
2019,173160,30,4,2,1,1
2019,173160,40,0,22,5,17
2019,173160,40,1,2,2,0
2019,173160,40,2,8,3,5
2019,173160,40,3,8,0,8
2019,173160,40,4,4,0,4
2019,173160,41,0,8,1,7
2019,173160,41,2,5,1,4
2019,173160,41,3,3,0,3
2019,173160,42,0,14,4,10
2019,173160,42,1,2,2,0
2019,173160,42,2,3,2,1
2019,173160,42,3,5,0,5
2019,173160,42,4,4,0,4
2019,173160,44,0,8,1,7
2019,173160,44,2,5,1,4
2019,173160,44,3,3,0,3
2019,173203,0,0,81,47,34
2019,173203,10,0,81,47,34
2019,173203,10,4,81,47,34
2019,173203,20,0,70,40,30
2019,173203,20,4,70,40,30
2019,173203,30,0,6,4,2
2019,173203,30,4,6,4,2
2019,173203,40,0,5,3,2
2019,173203,40,4,5,3,2
2019,173203,42,0,4,3,1
2019,173203,42,4,4,3,1
2019,173203,43,0,1,0,1
2019,173203,43,4,1,0,1
2019,173258,0,0,249,128,121
2019,173258,10,0,243,124,119
2019,173258,10,1,104,54,50
2019,173258,10,2,51,30,21
2019,173258,10,3,61,30,31
2019,173258,10,4,5,1,4
2019,173258,10,5,15,6,9
2019,173258,10,6,7,3,4
2019,173258,20,0,142,76,66
2019,173258,20,1,95,48,47
2019,173258,20,2,47,28,19
2019,173258,30,0,42,18,24
2019,173258,30,3,42,18,24
2019,173258,40,0,59,30,29
2019,173258,40,1,9,6,3
2019,173258,40,2,4,2,2
2019,173258,40,3,19,12,7
2019,173258,40,4,5,1,4
2019,173258,40,5,15,6,9
2019,173258,40,6,7,3,4
2019,173258,41,0,37,18,19
2019,173258,41,1,9,6,3
2019,173258,41,2,2,2,0
2019,173258,41,3,1,0,1
2019,173258,41,4,3,1,2
2019,173258,41,5,15,6,9
2019,173258,41,6,7,3,4
2019,173258,42,0,19,11,8
2019,173258,42,2,2,0,2
2019,173258,42,3,16,11,5
2019,173258,42,4,1,0,1
2019,173258,43,0,3,1,2
2019,173258,43,3,2,1,1
2019,173258,43,4,1,0,1
2019,173258,44,0,37,18,19
2019,173258,44,1,9,6,3
2019,173258,44,2,2,2,0
2019,173258,44,3,1,0,1
2019,173258,44,4,3,1,2
2019,173258,44,5,15,6,9
2019,173258,44,6,7,3,4
2019,173258,50,0,6,4,2
2019,173300,0,0,162,86,76
2019,173300,10,0,162,86,76
2019,173300,10,1,51,33,18
2019,173300,10,2,56,29,27
2019,173300,10,3,47,22,25
2019,173300,10,4,7,2,5
2019,173300,10,6,1,0,1
2019,173300,20,0,106,63,43
2019,173300,20,1,50,33,17
2019,173300,20,2,52,28,24
2019,173300,20,3,4,2,2
2019,173300,30,0,34,16,18
2019,173300,30,1,1,0,1
2019,173300,30,3,33,16,17
2019,173300,40,0,22,7,15
2019,173300,40,2,4,1,3
2019,173300,40,3,10,4,6
2019,173300,40,4,7,2,5
2019,173300,40,6,1,0,1
2019,173300,41,0,11,4,7
2019,173300,41,2,4,1,3
2019,173300,41,3,5,2,3
2019,173300,41,4,2,1,1
2019,173300,42,0,11,3,8
2019,173300,42,3,5,2,3
2019,173300,42,4,5,1,4
2019,173300,42,6,1,0,1
2019,173300,44,0,6,3,3
2019,173300,44,3,4,2,2
2019,173300,44,4,2,1,1
2019,173300,45,0,5,1,4
2019,173300,45,2,4,1,3
2019,173300,45,3,1,0,1
2019,173328,0,0,86,34,52
2019,173328,10,0,86,34,52
2019,173328,10,1,24,12,12
2019,173328,10,2,17,6,11
2019,173328,10,3,22,9,13
2019,173328,10,4,10,3,7
2019,173328,10,6,13,4,9
2019,173328,20,0,21,11,10
2019,173328,20,1,19,11,8
2019,173328,20,2,2,0,2
2019,173328,30,0,37,13,24
2019,173328,30,1,5,1,4
2019,173328,30,2,11,5,6
2019,173328,30,3,14,5,9
2019,173328,30,4,7,2,5
2019,173328,40,0,28,10,18
2019,173328,40,2,4,1,3
2019,173328,40,3,8,4,4
2019,173328,40,4,3,1,2
2019,173328,40,6,13,4,9
2019,173328,41,0,14,6,8
2019,173328,41,2,3,1,2
2019,173328,41,3,7,4,3
2019,173328,41,4,3,1,2
2019,173328,41,6,1,0,1
2019,173328,42,0,14,4,10
2019,173328,42,2,1,0,1
2019,173328,42,3,1,0,1
2019,173328,42,6,12,4,8
2019,173328,44,0,14,6,8
2019,173328,44,2,3,1,2
2019,173328,44,3,7,4,3
2019,173328,44,4,3,1,2
2019,173328,44,6,1,0,1
2019,173416,0,0,60,37,23
2019,173416,10,0,60,37,23
2019,173416,10,4,60,37,23
2019,173416,20,0,50,31,19
2019,173416,20,4,50,31,19
2019,173416,30,0,10,6,4
2019,173416,30,4,10,6,4
2019,173452,0,0,79,60,19
2019,173452,10,0,78,60,18
2019,173452,10,1,78,60,18
2019,173452,40,0,78,60,18
2019,173452,40,1,78,60,18
2019,173452,41,0,78,60,18
2019,173452,41,1,78,60,18
2019,173452,45,0,78,60,18
2019,173452,45,1,78,60,18
2019,173452,50,0,1,0,1
2019,173461,0,0,88,44,44
2019,173461,10,0,88,44,44
2019,173461,10,4,88,44,44
2019,173461,20,0,69,34,35
2019,173461,20,4,69,34,35
2019,173461,30,0,19,10,9
2019,173461,30,4,19,10,9
2019,173559,0,0,124,61,63
2019,173559,10,0,124,61,63
2019,173559,10,4,124,61,63
2019,173559,20,0,105,51,54
2019,173559,20,4,105,51,54
2019,173559,30,0,17,9,8
2019,173559,30,4,17,9,8
2019,173559,40,0,2,1,1
2019,173559,40,4,2,1,1
2019,173559,42,0,2,1,1
2019,173559,42,4,2,1,1
2019,173638,0,0,73,39,34
2019,173638,10,0,73,39,34
2019,173638,10,4,73,39,34
2019,173638,20,0,55,28,27
2019,173638,20,4,55,28,27
2019,173638,30,0,18,11,7
2019,173638,30,4,18,11,7
2019,173647,0,0,208,85,123
2019,173647,10,0,208,85,123
2019,173647,10,1,49,26,23
2019,173647,10,2,71,30,41
2019,173647,10,3,66,20,46
2019,173647,10,4,15,5,10
2019,173647,10,5,7,4,3
2019,173647,20,0,118,56,62
2019,173647,20,1,49,26,23
2019,173647,20,2,69,30,39
2019,173647,30,0,27,4,23
2019,173647,30,2,1,0,1
2019,173647,30,3,26,4,22
2019,173647,40,0,63,25,38
2019,173647,40,2,1,0,1
2019,173647,40,3,40,16,24
2019,173647,40,4,15,5,10
2019,173647,40,5,7,4,3
2019,173647,41,0,9,4,5
2019,173647,41,3,3,1,2
2019,173647,41,4,3,1,2
2019,173647,41,5,3,2,1
2019,173647,42,0,54,21,33
2019,173647,42,2,1,0,1
2019,173647,42,3,37,15,22
2019,173647,42,4,12,4,8
2019,173647,42,5,4,2,2
2019,173647,44,0,9,4,5
2019,173647,44,3,3,1,2
2019,173647,44,4,3,1,2
2019,173647,44,5,3,2,1
2019,173665,0,0,152,68,84
2019,173665,10,0,152,68,84
2019,173665,10,1,59,24,35
2019,173665,10,2,30,15,15
2019,173665,10,3,31,11,20
2019,173665,10,4,3,1,2
2019,173665,10,5,11,7,4
2019,173665,10,6,18,10,8
2019,173665,20,0,88,38,50
2019,173665,20,1,59,24,35
2019,173665,20,2,28,14,14
2019,173665,20,3,1,0,1
2019,173665,30,0,28,9,19
2019,173665,30,3,27,8,19
2019,173665,30,5,1,1,0
2019,173665,40,0,36,21,15
2019,173665,40,2,2,1,1
2019,173665,40,3,3,3,0
2019,173665,40,4,3,1,2
2019,173665,40,5,10,6,4
2019,173665,40,6,18,10,8
2019,173665,41,0,6,3,3
2019,173665,41,5,6,3,3
2019,173665,42,0,30,18,12
2019,173665,42,2,2,1,1
2019,173665,42,3,3,3,0
2019,173665,42,4,3,1,2
2019,173665,42,5,4,3,1
2019,173665,42,6,18,10,8
2019,173665,44,0,6,3,3
2019,173665,44,5,6,3,3
2019,173708,0,0,103,61,42
2019,173708,10,0,103,61,42
2019,173708,10,4,103,61,42
2019,173708,20,0,95,54,41
2019,173708,20,4,95,54,41
2019,173708,30,0,7,6,1
2019,173708,30,4,7,6,1
2019,173708,40,0,1,1,0
2019,173708,40,4,1,1,0
2019,173708,42,0,1,1,0
2019,173708,42,4,1,1,0
2019,173735,0,0,35,24,11
2019,173735,10,0,35,24,11
2019,173735,10,4,35,24,11
2019,173735,20,0,26,19,7
2019,173735,20,4,26,19,7
2019,173735,30,0,9,5,4
2019,173735,30,4,9,5,4
2019,173799,0,0,77,35,42
2019,173799,10,0,77,35,42
2019,173799,10,4,77,35,42
2019,173799,20,0,71,33,38
2019,173799,20,4,71,33,38
2019,173799,30,0,5,2,3
2019,173799,30,4,5,2,3
2019,173799,40,0,1,0,1
2019,173799,40,4,1,0,1
2019,173799,42,0,1,0,1
2019,173799,42,4,1,0,1
2019,173805,0,0,25,14,11
2019,173805,10,0,25,14,11
2019,173805,10,4,25,14,11
2019,173805,20,0,20,11,9
2019,173805,20,4,20,11,9
2019,173805,30,0,5,3,2
2019,173805,30,4,5,3,2
2019,173896,0,0,24,12,12
2019,173896,10,0,22,11,11
2019,173896,10,1,14,9,5
2019,173896,10,2,7,1,6
2019,173896,10,3,1,1,0
2019,173896,20,0,18,10,8
2019,173896,20,1,14,9,5
2019,173896,20,2,4,1,3
2019,173896,40,0,4,1,3
2019,173896,40,2,3,0,3
2019,173896,40,3,1,1,0
2019,173896,41,0,4,1,3
2019,173896,41,2,3,0,3
2019,173896,41,3,1,1,0
2019,173896,44,0,3,1,2
2019,173896,44,2,2,0,2
2019,173896,44,3,1,1,0
2019,173896,45,0,1,0,1
2019,173896,45,2,1,0,1
2019,173896,50,0,2,1,1
2019,173902,0,0,211,94,117
2019,173902,10,0,211,94,117
2019,173902,10,1,79,42,37
2019,173902,10,2,50,23,27
2019,173902,10,3,59,24,35
2019,173902,10,4,13,4,9
2019,173902,10,5,4,0,4
2019,173902,10,6,6,1,5
2019,173902,20,0,121,62,59
2019,173902,20,1,77,41,36
2019,173902,20,2,44,21,23
2019,173902,30,0,36,16,20
2019,173902,30,3,36,16,20
2019,173902,40,0,54,16,38
2019,173902,40,1,2,1,1
2019,173902,40,2,6,2,4
2019,173902,40,3,23,8,15
2019,173902,40,4,13,4,9
2019,173902,40,5,4,0,4
2019,173902,40,6,6,1,5
2019,173902,42,0,54,16,38
2019,173902,42,1,2,1,1
2019,173902,42,2,6,2,4
2019,173902,42,3,23,8,15
2019,173902,42,4,13,4,9
2019,173902,42,5,4,0,4
2019,173902,42,6,6,1,5
2019,173911,0,0,85,46,39
2019,173911,10,0,85,46,39
2019,173911,10,4,85,46,39
2019,173911,20,0,71,39,32
2019,173911,20,4,71,39,32
2019,173911,30,0,14,7,7
2019,173911,30,4,14,7,7
2019,173920,0,0,491,261,230
2019,173920,10,0,491,261,230
2019,173920,10,1,177,107,70
2019,173920,10,2,137,64,73
2019,173920,10,3,162,80,82
2019,173920,10,4,15,10,5
2019,173920,20,0,322,172,150
2019,173920,20,1,176,106,70
2019,173920,20,2,135,63,72
2019,173920,20,3,11,3,8
2019,173920,30,0,128,64,64
2019,173920,30,1,1,1,0
2019,173920,30,2,2,1,1
2019,173920,30,3,123,61,62
2019,173920,30,4,2,1,1
2019,173920,40,0,41,25,16
2019,173920,40,3,28,16,12
2019,173920,40,4,13,9,4
2019,173920,42,0,41,25,16
2019,173920,42,3,28,16,12
2019,173920,42,4,13,9,4
2019,173993,0,0,27,15,12
2019,173993,10,0,27,15,12
2019,173993,10,4,27,15,12
2019,173993,20,0,24,13,11
2019,173993,20,4,24,13,11
2019,173993,30,0,3,2,1
2019,173993,30,4,3,2,1
2019,174020,0,0,132,58,74
2019,174020,10,0,132,58,74
2019,174020,10,1,39,15,24
2019,174020,10,2,52,24,28
2019,174020,10,3,41,19,22
2019,174020,20,0,81,36,45
2019,174020,20,1,39,15,24
2019,174020,20,2,41,20,21
2019,174020,20,3,1,1,0
2019,174020,30,0,43,19,24
2019,174020,30,2,9,3,6
2019,174020,30,3,34,16,18
2019,174020,40,0,8,3,5
2019,174020,40,2,2,1,1
2019,174020,40,3,6,2,4
2019,174020,42,0,8,3,5
2019,174020,42,2,2,1,1
2019,174020,42,3,6,2,4
2019,174066,0,0,3629,2104,1525
2019,174066,10,0,3275,1966,1309
2019,174066,10,1,1200,852,348
2019,174066,10,2,827,470,357
2019,174066,10,3,1205,619,586
2019,174066,10,4,37,21,16
2019,174066,10,6,6,4,2
2019,174066,20,0,1652,1111,541
2019,174066,20,1,1085,774,311
2019,174066,20,2,565,335,230
2019,174066,20,3,1,1,0
2019,174066,20,4,1,1,0
2019,174066,30,0,519,281,238
2019,174066,30,1,1,1,0
2019,174066,30,2,32,15,17
2019,174066,30,3,486,265,221
2019,174066,40,0,1104,574,530
2019,174066,40,1,114,77,37
2019,174066,40,2,230,120,110
2019,174066,40,3,718,353,365
2019,174066,40,4,36,20,16
2019,174066,40,6,6,4,2
2019,174066,41,0,43,17,26
2019,174066,41,1,5,4,1
2019,174066,41,2,18,8,10
2019,174066,41,3,20,5,15
2019,174066,42,0,1053,552,501
2019,174066,42,1,109,73,36
2019,174066,42,2,212,112,100
2019,174066,42,3,695,346,349
2019,174066,42,4,32,18,14
2019,174066,42,6,5,3,2
2019,174066,43,0,8,5,3
2019,174066,43,3,3,2,1
2019,174066,43,4,4,2,2
2019,174066,43,6,1,1,0
2019,174066,44,0,42,17,25
2019,174066,44,1,5,4,1
2019,174066,44,2,17,8,9
2019,174066,44,3,20,5,15
2019,174066,45,0,1,0,1
2019,174066,45,2,1,0,1
2019,174066,50,0,354,138,216
2019,174075,0,0,71,39,32
2019,174075,10,0,42,26,16
2019,174075,10,1,8,5,3
2019,174075,10,2,15,12,3
2019,174075,10,3,16,8,8
2019,174075,10,4,3,1,2
2019,174075,20,0,22,15,7
2019,174075,20,1,8,5,3
2019,174075,20,2,13,10,3
2019,174075,20,3,1,0,1
2019,174075,30,0,17,10,7
2019,174075,30,2,2,2,0
2019,174075,30,3,15,8,7
2019,174075,40,0,3,1,2
2019,174075,40,4,3,1,2
2019,174075,42,0,3,1,2
2019,174075,42,4,3,1,2
2019,174075,50,0,29,13,16
2019,174127,0,0,39,21,18
2019,174127,10,0,39,21,18
2019,174127,10,1,23,14,9
2019,174127,10,2,8,4,4
2019,174127,10,3,4,1,3
2019,174127,10,6,4,2,2
2019,174127,40,0,39,21,18
2019,174127,40,1,23,14,9
2019,174127,40,2,8,4,4
2019,174127,40,3,4,1,3
2019,174127,40,6,4,2,2
2019,174127,41,0,35,19,16
2019,174127,41,1,23,14,9
2019,174127,41,2,8,4,4
2019,174127,41,3,4,1,3
2019,174127,42,0,4,2,2
2019,174127,42,6,4,2,2
2019,174127,44,0,35,19,16
2019,174127,44,1,23,14,9
2019,174127,44,2,8,4,4
2019,174127,44,3,4,1,3
2019,174136,0,0,117,49,68
2019,174136,10,0,117,49,68
2019,174136,10,4,117,49,68
2019,174136,20,0,95,38,57
2019,174136,20,4,95,38,57
2019,174136,30,0,22,11,11
2019,174136,30,4,22,11,11
2019,174154,0,0,19,1,18
2019,174154,10,0,19,1,18
2019,174154,10,2,2,1,1
2019,174154,10,3,15,0,15
2019,174154,10,4,2,0,2
2019,174154,40,0,19,1,18
2019,174154,40,2,2,1,1
2019,174154,40,3,15,0,15
2019,174154,40,4,2,0,2
2019,174154,41,0,19,1,18
2019,174154,41,2,2,1,1
2019,174154,41,3,15,0,15
2019,174154,41,4,2,0,2
2019,174154,45,0,19,1,18
2019,174154,45,2,2,1,1
2019,174154,45,3,15,0,15
2019,174154,45,4,2,0,2
2019,174233,0,0,486,269,217
2019,174233,10,0,486,269,217
2019,174233,10,1,97,70,27
2019,174233,10,2,144,82,62
2019,174233,10,3,159,77,82
2019,174233,10,4,86,40,46
2019,174233,20,0,241,152,89
2019,174233,20,1,97,70,27
2019,174233,20,2,143,81,62
2019,174233,20,3,1,1,0
2019,174233,30,0,92,48,44
2019,174233,30,2,1,1,0
2019,174233,30,3,89,45,44
2019,174233,30,4,2,2,0
2019,174233,40,0,153,69,84
2019,174233,40,3,69,31,38
2019,174233,40,4,84,38,46
2019,174233,41,0,44,25,19
2019,174233,41,3,23,12,11
2019,174233,41,4,21,13,8
2019,174233,42,0,109,44,65
2019,174233,42,3,46,19,27
2019,174233,42,4,63,25,38
2019,174233,44,0,44,25,19
2019,174233,44,3,23,12,11
2019,174233,44,4,21,13,8
2019,174251,0,0,118,67,51
2019,174251,10,0,94,53,41
2019,174251,10,1,26,17,9
2019,174251,10,2,38,19,19
2019,174251,10,3,30,17,13
2019,174251,20,0,61,33,28
2019,174251,20,1,26,17,9
2019,174251,20,2,35,16,19
2019,174251,30,0,29,18,11
2019,174251,30,2,2,2,0
2019,174251,30,3,27,16,11
2019,174251,40,0,4,2,2
2019,174251,40,2,1,1,0
2019,174251,40,3,3,1,2
2019,174251,42,0,4,2,2
2019,174251,42,2,1,1,0
2019,174251,42,3,3,1,2
2019,174251,50,0,24,14,10
2019,174358,0,0,208,107,101
2019,174358,10,0,208,107,101
2019,174358,10,1,97,60,37
2019,174358,10,2,46,18,28
2019,174358,10,3,60,28,32
2019,174358,10,4,5,1,4
2019,174358,20,0,142,76,66
2019,174358,20,1,96,59,37
2019,174358,20,2,42,17,25
2019,174358,20,3,4,0,4
2019,174358,30,0,45,24,21
2019,174358,30,1,1,1,0
2019,174358,30,2,4,1,3
2019,174358,30,3,40,22,18
2019,174358,40,0,21,7,14
2019,174358,40,3,16,6,10
2019,174358,40,4,5,1,4
2019,174358,42,0,21,7,14
2019,174358,42,3,16,6,10
2019,174358,42,4,5,1,4
2019,174376,0,0,98,36,62
2019,174376,10,0,98,36,62
2019,174376,10,4,98,36,62
2019,174376,20,0,87,32,55
2019,174376,20,4,87,32,55
2019,174376,30,0,11,4,7
2019,174376,30,4,11,4,7
2019,174428,0,0,160,77,83
2019,174428,10,0,160,77,83
2019,174428,10,4,160,77,83
2019,174428,20,0,141,68,73
2019,174428,20,4,141,68,73
2019,174428,30,0,19,9,10
2019,174428,30,4,19,9,10
2019,174437,0,0,38,25,13
2019,174437,10,0,38,25,13
2019,174437,10,1,4,2,2
2019,174437,10,2,16,12,4
2019,174437,10,3,16,9,7
2019,174437,10,4,1,1,0
2019,174437,10,6,1,1,0
2019,174437,40,0,38,25,13
2019,174437,40,1,4,2,2
2019,174437,40,2,16,12,4
2019,174437,40,3,16,9,7
2019,174437,40,4,1,1,0
2019,174437,40,6,1,1,0
2019,174437,42,0,37,24,13
2019,174437,42,1,4,2,2
2019,174437,42,2,16,12,4
2019,174437,42,3,16,9,7
2019,174437,42,6,1,1,0
2019,174437,43,0,1,1,0
2019,174437,43,4,1,1,0
2019,174473,0,0,88,43,45
2019,174473,10,0,88,43,45
2019,174473,10,4,88,43,45
2019,174473,20,0,75,38,37
2019,174473,20,4,75,38,37
2019,174473,30,0,10,4,6
2019,174473,30,4,10,4,6
2019,174473,40,0,3,1,2
2019,174473,40,4,3,1,2
2019,174473,42,0,3,1,2
2019,174473,42,4,3,1,2
2019,174491,0,0,75,44,31
2019,174491,10,0,75,44,31
2019,174491,10,1,28,20,8
2019,174491,10,2,20,12,8
2019,174491,10,3,26,11,15
2019,174491,10,4,1,1,0
2019,174491,40,0,75,44,31
2019,174491,40,1,28,20,8
2019,174491,40,2,20,12,8
2019,174491,40,3,26,11,15
2019,174491,40,4,1,1,0
2019,174491,42,0,75,44,31
2019,174491,42,1,28,20,8
2019,174491,42,2,20,12,8
2019,174491,42,3,26,11,15
2019,174491,42,4,1,1,0
2019,174507,0,0,62,23,39
2019,174507,10,0,62,23,39
2019,174507,10,1,13,6,7
2019,174507,10,2,19,11,8
2019,174507,10,3,21,5,16
2019,174507,10,4,9,1,8
2019,174507,40,0,62,23,39
2019,174507,40,1,13,6,7
2019,174507,40,2,19,11,8
2019,174507,40,3,21,5,16
2019,174507,40,4,9,1,8
2019,174507,41,0,39,20,19
2019,174507,41,1,12,6,6
2019,174507,41,2,17,10,7
2019,174507,41,3,8,3,5
2019,174507,41,4,2,1,1
2019,174507,42,0,23,3,20
2019,174507,42,1,1,0,1
2019,174507,42,2,2,1,1
2019,174507,42,3,13,2,11
2019,174507,42,4,7,0,7
2019,174507,44,0,39,20,19
2019,174507,44,1,12,6,6
2019,174507,44,2,17,10,7
2019,174507,44,3,8,3,5
2019,174507,44,4,2,1,1
2019,174525,0,0,9,7,2
2019,174525,10,0,9,7,2
2019,174525,10,6,9,7,2
2019,174525,40,0,9,7,2
2019,174525,40,6,9,7,2
2019,174525,41,0,9,7,2
2019,174525,41,6,9,7,2
2019,174525,45,0,9,7,2
2019,174525,45,6,9,7,2
2019,174570,0,0,25,11,14
2019,174570,10,0,25,11,14
2019,174570,10,4,25,11,14
2019,174570,20,0,17,5,12
2019,174570,20,4,17,5,12
2019,174570,30,0,8,6,2
2019,174570,30,4,8,6,2
2019,174738,0,0,106,49,57
2019,174738,10,0,106,49,57
2019,174738,10,4,106,49,57
2019,174738,20,0,100,49,51
2019,174738,20,4,100,49,51
2019,174738,30,0,6,0,6
2019,174738,30,4,6,0,6
2019,174747,0,0,142,69,73
2019,174747,10,0,142,69,73
2019,174747,10,1,45,27,18
2019,174747,10,2,44,20,24
2019,174747,10,3,40,19,21
2019,174747,10,4,13,3,10
2019,174747,20,0,87,45,42
2019,174747,20,1,44,26,18
2019,174747,20,2,43,19,24
2019,174747,30,0,16,7,9
2019,174747,30,2,1,1,0
2019,174747,30,3,15,6,9
2019,174747,40,0,39,17,22
2019,174747,40,1,1,1,0
2019,174747,40,3,25,13,12
2019,174747,40,4,13,3,10
2019,174747,42,0,39,17,22
2019,174747,42,1,1,1,0
2019,174747,42,3,25,13,12
2019,174747,42,4,13,3,10
2019,174756,0,0,92,50,42
2019,174756,10,0,92,50,42
2019,174756,10,4,92,50,42
2019,174756,20,0,69,43,26
2019,174756,20,4,69,43,26
2019,174756,30,0,22,6,16
2019,174756,30,4,22,6,16
2019,174756,40,0,1,1,0
2019,174756,40,4,1,1,0
2019,174756,43,0,1,1,0
2019,174756,43,4,1,1,0
2019,174783,0,0,407,223,184
2019,174783,10,0,407,223,184
2019,174783,10,1,212,128,84
2019,174783,10,2,85,52,33
2019,174783,10,3,95,36,59
2019,174783,10,4,15,7,8
2019,174783,20,0,295,180,115
2019,174783,20,1,212,128,84
2019,174783,20,2,77,49,28
2019,174783,20,3,6,3,3
2019,174783,30,0,59,20,39
2019,174783,30,2,5,3,2
2019,174783,30,3,54,17,37
2019,174783,40,0,53,23,30
2019,174783,40,2,3,0,3
2019,174783,40,3,35,16,19
2019,174783,40,4,15,7,8
2019,174783,42,0,50,22,28
2019,174783,42,2,1,0,1
2019,174783,42,3,34,15,19
2019,174783,42,4,15,7,8
2019,174783,43,0,3,1,2
2019,174783,43,2,2,0,2
2019,174783,43,3,1,1,0
2019,174792,0,0,138,68,70
2019,174792,10,0,138,68,70
2019,174792,10,1,44,26,18
2019,174792,10,2,43,20,23
2019,174792,10,3,38,18,20
2019,174792,10,4,13,4,9
2019,174792,20,0,87,45,42
2019,174792,20,1,44,26,18
2019,174792,20,2,42,19,23
2019,174792,20,3,1,0,1
2019,174792,30,0,13,6,7
2019,174792,30,3,13,6,7
2019,174792,40,0,38,17,21
2019,174792,40,2,1,1,0
2019,174792,40,3,24,12,12
2019,174792,40,4,13,4,9
2019,174792,42,0,38,17,21
2019,174792,42,2,1,1,0
2019,174792,42,3,24,12,12
2019,174792,42,4,13,4,9
2019,174817,0,0,103,65,38
2019,174817,10,0,103,65,38
2019,174817,10,1,27,14,13
2019,174817,10,2,43,29,14
2019,174817,10,3,30,21,9
2019,174817,10,4,3,1,2
2019,174817,20,0,58,37,21
2019,174817,20,1,21,11,10
2019,174817,20,2,30,20,10
2019,174817,20,3,7,6,1
2019,174817,30,0,17,11,6
2019,174817,30,1,1,1,0
2019,174817,30,2,3,2,1
2019,174817,30,3,13,8,5
2019,174817,40,0,28,17,11
2019,174817,40,1,5,2,3
2019,174817,40,2,10,7,3
2019,174817,40,3,10,7,3
2019,174817,40,4,3,1,2
2019,174817,42,0,28,17,11
2019,174817,42,1,5,2,3
2019,174817,42,2,10,7,3
2019,174817,42,3,10,7,3
2019,174817,42,4,3,1,2
2019,174844,0,0,209,107,102
2019,174844,10,0,209,107,102
2019,174844,10,1,58,35,23
2019,174844,10,2,68,36,32
2019,174844,10,3,67,29,38
2019,174844,10,4,11,4,7
2019,174844,10,6,5,3,2
2019,174844,20,0,120,69,51
2019,174844,20,1,58,35,23
2019,174844,20,2,62,34,28
2019,174844,30,0,32,10,22
2019,174844,30,3,32,10,22
2019,174844,40,0,57,28,29
2019,174844,40,2,6,2,4
2019,174844,40,3,35,19,16
2019,174844,40,4,11,4,7
2019,174844,40,6,5,3,2
2019,174844,41,0,23,13,10
2019,174844,41,2,6,2,4
2019,174844,41,3,11,7,4
2019,174844,41,4,1,1,0
2019,174844,41,6,5,3,2
2019,174844,42,0,34,15,19
2019,174844,42,3,24,12,12
2019,174844,42,4,10,3,7
2019,174844,44,0,23,13,10
2019,174844,44,2,6,2,4
2019,174844,44,3,11,7,4
2019,174844,44,4,1,1,0
2019,174844,44,6,5,3,2
2019,174862,0,0,30,18,12
2019,174862,10,0,30,18,12
2019,174862,10,1,8,5,3
2019,174862,10,2,9,3,6
2019,174862,10,3,13,10,3
2019,174862,20,0,5,3,2
2019,174862,20,1,4,3,1
2019,174862,20,2,1,0,1
2019,174862,30,0,22,12,10
2019,174862,30,1,4,2,2
2019,174862,30,2,8,3,5
2019,174862,30,3,10,7,3
2019,174862,40,0,3,3,0
2019,174862,40,3,3,3,0
2019,174862,41,0,3,3,0
2019,174862,41,3,3,3,0
2019,174862,44,0,3,3,0
2019,174862,44,3,3,3,0
2019,174899,0,0,238,78,160
2019,174899,10,0,238,78,160
2019,174899,10,1,20,11,9
2019,174899,10,2,58,25,33
2019,174899,10,3,131,32,99
2019,174899,10,4,18,8,10
2019,174899,10,5,11,2,9
2019,174899,20,0,65,33,32
2019,174899,20,1,19,11,8
2019,174899,20,2,42,20,22
2019,174899,20,3,4,2,2
2019,174899,30,0,54,14,40
2019,174899,30,2,6,1,5
2019,174899,30,3,48,13,35
2019,174899,40,0,119,31,88
2019,174899,40,1,1,0,1
2019,174899,40,2,10,4,6
2019,174899,40,3,79,17,62
2019,174899,40,4,18,8,10
2019,174899,40,5,11,2,9
2019,174899,41,0,20,7,13
2019,174899,41,2,1,1,0
2019,174899,41,3,19,6,13
2019,174899,42,0,99,24,75
2019,174899,42,1,1,0,1
2019,174899,42,2,9,3,6
2019,174899,42,3,60,11,49
2019,174899,42,4,18,8,10
2019,174899,42,5,11,2,9
2019,174899,44,0,20,7,13
2019,174899,44,2,1,1,0
2019,174899,44,3,19,6,13
2019,174914,0,0,416,247,169
2019,174914,10,0,416,247,169
2019,174914,10,1,123,85,38
2019,174914,10,2,167,86,81
2019,174914,10,3,70,44,26
2019,174914,10,4,4,2,2
2019,174914,10,5,51,29,22
2019,174914,10,6,1,1,0
2019,174914,20,0,287,170,117
2019,174914,20,1,120,84,36
2019,174914,20,2,166,85,81
2019,174914,20,3,1,1,0
2019,174914,30,0,60,36,24
2019,174914,30,1,1,0,1
2019,174914,30,2,1,1,0
2019,174914,30,3,55,33,22
2019,174914,30,4,3,2,1
2019,174914,40,0,69,41,28
2019,174914,40,1,2,1,1
2019,174914,40,3,14,10,4
2019,174914,40,4,1,0,1
2019,174914,40,5,51,29,22
2019,174914,40,6,1,1,0
2019,174914,42,0,68,40,28
2019,174914,42,1,2,1,1
2019,174914,42,3,14,10,4
2019,174914,42,4,1,0,1
2019,174914,42,5,51,29,22
2019,174914,43,0,1,1,0
2019,174914,43,6,1,1,0
2019,175005,0,0,244,45,199
2019,175005,10,0,244,45,199
2019,175005,10,1,37,10,27
2019,175005,10,2,74,17,57
2019,175005,10,3,129,16,113
2019,175005,10,4,2,2,0
2019,175005,10,6,2,0,2
2019,175005,20,0,77,20,57
2019,175005,20,1,32,9,23
2019,175005,20,2,45,11,34
2019,175005,30,0,47,6,41
2019,175005,30,2,8,2,6
2019,175005,30,3,39,4,35
2019,175005,40,0,120,19,101
2019,175005,40,1,5,1,4
2019,175005,40,2,21,4,17
2019,175005,40,3,90,12,78
2019,175005,40,4,2,2,0
2019,175005,40,6,2,0,2
2019,175005,41,0,110,19,91
2019,175005,41,1,5,1,4
2019,175005,41,2,21,4,17
2019,175005,41,3,82,12,70
2019,175005,41,4,2,2,0
2019,175005,42,0,10,0,10
2019,175005,42,3,8,0,8
2019,175005,42,6,2,0,2
2019,175005,44,0,110,19,91
2019,175005,44,1,5,1,4
2019,175005,44,2,21,4,17
2019,175005,44,3,82,12,70
2019,175005,44,4,2,2,0
2019,175014,0,0,81,13,68
2019,175014,10,0,81,13,68
2019,175014,10,4,81,13,68
2019,175014,40,0,81,13,68
2019,175014,40,4,81,13,68
2019,175014,41,0,81,13,68
2019,175014,41,4,81,13,68
2019,175014,45,0,81,13,68
2019,175014,45,4,81,13,68
2019,175041,0,0,116,50,66
2019,175041,10,0,116,50,66
2019,175041,10,4,116,50,66
2019,175041,20,0,93,42,51
2019,175041,20,4,93,42,51
2019,175041,30,0,23,8,15
2019,175041,30,4,23,8,15
2019,175078,0,0,98,50,48
2019,175078,10,0,98,50,48
2019,175078,10,1,46,27,19
2019,175078,10,2,21,10,11
2019,175078,10,3,30,12,18
2019,175078,10,4,1,1,0
2019,175078,20,0,68,39,29
2019,175078,20,1,46,27,19
2019,175078,20,2,20,10,10
2019,175078,20,3,2,2,0
2019,175078,30,0,18,8,10
2019,175078,30,2,1,0,1
2019,175078,30,3,17,8,9
2019,175078,40,0,12,3,9
2019,175078,40,3,11,2,9
2019,175078,40,4,1,1,0
2019,175078,42,0,12,3,9
2019,175078,42,3,11,2,9
2019,175078,42,4,1,1,0
2019,175139,0,0,9,7,2
2019,175139,10,0,9,7,2
2019,175139,10,1,2,2,0
2019,175139,10,2,1,1,0
2019,175139,10,3,6,4,2
2019,175139,20,0,2,2,0
2019,175139,20,1,2,2,0
2019,175139,30,0,5,4,1
2019,175139,30,2,1,1,0
2019,175139,30,3,4,3,1
2019,175139,40,0,2,1,1
2019,175139,40,3,2,1,1
2019,175139,41,0,2,1,1
2019,175139,41,3,2,1,1
2019,175139,44,0,2,1,1
2019,175139,44,3,2,1,1
2019,175157,0,0,14,8,6
2019,175157,10,0,14,8,6
2019,175157,10,4,14,8,6
2019,175157,20,0,9,5,4
2019,175157,20,4,9,5,4
2019,175157,30,0,5,3,2
2019,175157,30,4,5,3,2
2019,175227,0,0,89,70,19
2019,175227,10,0,89,70,19
2019,175227,10,1,6,3,3
2019,175227,10,2,13,8,5
2019,175227,10,3,26,20,6
2019,175227,10,4,44,39,5
2019,175227,40,0,89,70,19
2019,175227,40,1,6,3,3
2019,175227,40,2,13,8,5
2019,175227,40,3,26,20,6
2019,175227,40,4,44,39,5
2019,175227,41,0,89,70,19
2019,175227,41,1,6,3,3
2019,175227,41,2,13,8,5
2019,175227,41,3,26,20,6
2019,175227,41,4,44,39,5
2019,175227,45,0,89,70,19
2019,175227,45,1,6,3,3
2019,175227,45,2,13,8,5
2019,175227,45,3,26,20,6
2019,175227,45,4,44,39,5
2019,175236,0,0,98,53,45
2019,175236,10,0,98,53,45
2019,175236,10,4,98,53,45
2019,175236,20,0,85,46,39
2019,175236,20,4,85,46,39
2019,175236,30,0,13,7,6
2019,175236,30,4,13,7,6
2019,175263,0,0,44,25,19
2019,175263,10,0,44,25,19
2019,175263,10,4,44,25,19
2019,175263,20,0,36,18,18
2019,175263,20,4,36,18,18
2019,175263,30,0,7,7,0
2019,175263,30,4,7,7,0
2019,175263,40,0,1,0,1
2019,175263,40,4,1,0,1
2019,175263,42,0,1,0,1
2019,175263,42,4,1,0,1
2019,175272,0,0,304,149,155
2019,175272,10,0,304,149,155
2019,175272,10,1,123,70,53
2019,175272,10,2,83,40,43
2019,175272,10,3,89,36,53
2019,175272,10,4,9,3,6
2019,175272,20,0,199,109,90
2019,175272,20,1,122,70,52
2019,175272,20,2,72,35,37
2019,175272,20,3,5,4,1
2019,175272,30,0,66,27,39
2019,175272,30,1,1,0,1
2019,175272,30,2,10,5,5
2019,175272,30,3,55,22,33
2019,175272,40,0,39,13,26
2019,175272,40,2,1,0,1
2019,175272,40,3,29,10,19
2019,175272,40,4,9,3,6
2019,175272,42,0,39,13,26
2019,175272,42,2,1,0,1
2019,175272,42,3,29,10,19
2019,175272,42,4,9,3,6
2019,175281,0,0,38,21,17
2019,175281,10,0,38,21,17
2019,175281,10,1,30,18,12
2019,175281,10,4,1,0,1
2019,175281,10,6,7,3,4
2019,175281,20,0,30,18,12
2019,175281,20,1,30,18,12
2019,175281,40,0,8,3,5
2019,175281,40,4,1,0,1
2019,175281,40,6,7,3,4
2019,175281,41,0,7,3,4
2019,175281,41,4,1,0,1
2019,175281,41,6,6,3,3
2019,175281,42,0,1,0,1
2019,175281,42,6,1,0,1
2019,175281,44,0,6,3,3
2019,175281,44,6,6,3,3
2019,175281,45,0,1,0,1
2019,175281,45,4,1,0,1
2019,175315,0,0,152,70,82
2019,175315,10,0,152,70,82
2019,175315,10,4,152,70,82
2019,175315,20,0,142,67,75
2019,175315,20,4,142,67,75
2019,175315,30,0,10,3,7
2019,175315,30,4,10,3,7
2019,175342,0,0,158,82,76
2019,175342,10,0,158,82,76
2019,175342,10,1,26,21,5
2019,175342,10,2,34,15,19
2019,175342,10,3,52,27,25
2019,175342,10,4,46,19,27
2019,175342,20,0,52,32,20
2019,175342,20,1,26,21,5
2019,175342,20,2,21,9,12
2019,175342,20,3,5,2,3
2019,175342,30,0,33,20,13
2019,175342,30,2,9,5,4
2019,175342,30,3,23,14,9
2019,175342,30,4,1,1,0
2019,175342,40,0,73,30,43
2019,175342,40,2,4,1,3
2019,175342,40,3,24,11,13
2019,175342,40,4,45,18,27
2019,175342,42,0,9,4,5
2019,175342,42,2,2,1,1
2019,175342,42,3,1,0,1
2019,175342,42,4,6,3,3
2019,175342,43,0,64,26,38
2019,175342,43,2,2,0,2
2019,175342,43,3,23,11,12
2019,175342,43,4,39,15,24
2019,175421,0,0,83,39,44
2019,175421,10,0,82,39,43
2019,175421,10,1,25,13,12
2019,175421,10,2,20,7,13
2019,175421,10,3,28,15,13
2019,175421,10,4,9,4,5
2019,175421,20,0,37,17,20
2019,175421,20,1,24,13,11
2019,175421,20,2,12,4,8
2019,175421,20,3,1,0,1
2019,175421,30,0,32,16,16
2019,175421,30,2,8,3,5
2019,175421,30,3,24,13,11
2019,175421,40,0,13,6,7
2019,175421,40,1,1,0,1
2019,175421,40,3,3,2,1
2019,175421,40,4,9,4,5
2019,175421,42,0,10,4,6
2019,175421,42,1,1,0,1
2019,175421,42,3,2,1,1
2019,175421,42,4,7,3,4
2019,175421,43,0,3,2,1
2019,175421,43,3,1,1,0
2019,175421,43,4,2,1,1
2019,175421,50,0,1,0,1
2019,175430,0,0,37,18,19
2019,175430,10,0,37,18,19
2019,175430,10,1,7,4,3
2019,175430,10,2,12,7,5
2019,175430,10,3,12,5,7
2019,175430,10,4,6,2,4
2019,175430,40,0,37,18,19
2019,175430,40,1,7,4,3
2019,175430,40,2,12,7,5
2019,175430,40,3,12,5,7
2019,175430,40,4,6,2,4
2019,175430,42,0,37,18,19
2019,175430,42,1,7,4,3
2019,175430,42,2,12,7,5
2019,175430,42,3,12,5,7
2019,175430,42,4,6,2,4
2019,175519,0,0,80,36,44
2019,175519,10,0,80,36,44
2019,175519,10,4,80,36,44
2019,175519,40,0,80,36,44
2019,175519,40,4,80,36,44
2019,175519,42,0,80,36,44
2019,175519,42,4,80,36,44
2019,175573,0,0,103,42,61
2019,175573,10,0,103,42,61
2019,175573,10,4,103,42,61
2019,175573,40,0,103,42,61
2019,175573,40,4,103,42,61
2019,175573,42,0,103,42,61
2019,175573,42,4,103,42,61
2019,175616,0,0,155,64,91
2019,175616,10,0,155,64,91
2019,175616,10,1,14,9,5
2019,175616,10,2,49,27,22
2019,175616,10,3,58,20,38
2019,175616,10,4,34,8,26
2019,175616,20,0,59,32,27
2019,175616,20,1,10,5,5
2019,175616,20,2,48,26,22
2019,175616,20,3,1,1,0
2019,175616,30,0,52,16,36
2019,175616,30,3,52,16,36
2019,175616,40,0,44,16,28
2019,175616,40,1,4,4,0
2019,175616,40,2,1,1,0
2019,175616,40,3,5,3,2
2019,175616,40,4,34,8,26
2019,175616,42,0,44,16,28
2019,175616,42,1,4,4,0
2019,175616,42,2,1,1,0
2019,175616,42,3,5,3,2
2019,175616,42,4,34,8,26
2019,175643,0,0,83,35,48
2019,175643,10,0,78,33,45
2019,175643,10,4,78,33,45
2019,175643,40,0,78,33,45
2019,175643,40,4,78,33,45
2019,175643,42,0,7,1,6
2019,175643,42,4,7,1,6
2019,175643,43,0,71,32,39
2019,175643,43,4,71,32,39
2019,175643,50,0,5,2,3
2019,175652,0,0,98,47,51
2019,175652,10,0,98,47,51
2019,175652,10,4,98,47,51
2019,175652,40,0,98,47,51
2019,175652,40,4,98,47,51
2019,175652,42,0,98,47,51
2019,175652,42,4,98,47,51
2019,175786,0,0,426,152,274
2019,175786,10,0,411,149,262
2019,175786,10,4,411,149,262
2019,175786,40,0,411,149,262
2019,175786,40,4,411,149,262
2019,175786,42,0,411,149,262
2019,175786,42,4,411,149,262
2019,175786,50,0,15,3,12
2019,175810,0,0,134,49,85
2019,175810,10,0,134,49,85
2019,175810,10,6,134,49,85
2019,175810,40,0,134,49,85
2019,175810,40,6,134,49,85
2019,175810,42,0,134,49,85
2019,175810,42,6,134,49,85
2019,175829,0,0,147,48,99
2019,175829,10,0,147,48,99
2019,175829,10,4,147,48,99
2019,175829,40,0,147,48,99
2019,175829,40,4,147,48,99
2019,175829,41,0,2,0,2
2019,175829,41,4,2,0,2
2019,175829,42,0,143,48,95
2019,175829,42,4,143,48,95
2019,175829,43,0,2,0,2
2019,175829,43,4,2,0,2
2019,175829,45,0,2,0,2
2019,175829,45,4,2,0,2
2019,175856,0,0,338,167,171
2019,175856,10,0,338,167,171
2019,175856,10,1,87,59,28
2019,175856,10,2,82,44,38
2019,175856,10,3,93,39,54
2019,175856,10,4,65,21,44
2019,175856,10,5,11,4,7
2019,175856,20,0,157,96,61
2019,175856,20,1,84,57,27
2019,175856,20,2,67,35,32
2019,175856,20,3,6,4,2
2019,175856,30,0,54,24,30
2019,175856,30,1,1,1,0
2019,175856,30,2,7,4,3
2019,175856,30,3,46,19,27
2019,175856,40,0,127,47,80
2019,175856,40,1,2,1,1
2019,175856,40,2,8,5,3
2019,175856,40,3,41,16,25
2019,175856,40,4,65,21,44
2019,175856,40,5,11,4,7
2019,175856,42,0,127,47,80
2019,175856,42,1,2,1,1
2019,175856,42,2,8,5,3
2019,175856,42,3,41,16,25
2019,175856,42,4,65,21,44
2019,175856,42,5,11,4,7
2019,175883,0,0,141,56,85
2019,175883,10,0,141,56,85
2019,175883,10,4,141,56,85
2019,175883,40,0,141,56,85
2019,175883,40,4,141,56,85
2019,175883,42,0,127,49,78
2019,175883,42,4,127,49,78
2019,175883,43,0,14,7,7
2019,175883,43,4,14,7,7
2019,175935,0,0,134,39,95
2019,175935,10,0,134,39,95
2019,175935,10,4,134,39,95
2019,175935,40,0,134,39,95
2019,175935,40,4,134,39,95
2019,175935,42,0,134,39,95
2019,175935,42,4,134,39,95
2019,175980,0,0,81,41,40
2019,175980,10,0,80,41,39
2019,175980,10,1,28,18,10
2019,175980,10,2,26,13,13
2019,175980,10,3,20,8,12
2019,175980,10,4,2,0,2
2019,175980,10,6,4,2,2
2019,175980,20,0,52,31,21
2019,175980,20,1,27,18,9
2019,175980,20,2,24,12,12
2019,175980,20,3,1,1,0
2019,175980,30,0,16,8,8
2019,175980,30,2,2,1,1
2019,175980,30,3,14,7,7
2019,175980,40,0,12,2,10
2019,175980,40,1,1,0,1
2019,175980,40,3,5,0,5
2019,175980,40,4,2,0,2
2019,175980,40,6,4,2,2
2019,175980,42,0,10,2,8
2019,175980,42,1,1,0,1
2019,175980,42,3,4,0,4
2019,175980,42,4,1,0,1
2019,175980,42,6,4,2,2
2019,175980,43,0,2,0,2
2019,175980,43,3,1,0,1
2019,175980,43,4,1,0,1
2019,175980,50,0,1,0,1
2019,176008,0,0,99,34,65
2019,176008,10,0,99,34,65
2019,176008,10,4,99,34,65
2019,176008,40,0,99,34,65
2019,176008,40,4,99,34,65
2019,176008,42,0,99,34,65
2019,176008,42,4,99,34,65
2019,176017,0,0,1893,1035,858
2019,176017,10,0,1893,1035,858
2019,176017,10,1,476,326,150
2019,176017,10,2,480,280,200
2019,176017,10,3,632,328,304
2019,176017,10,4,257,82,175
2019,176017,10,5,48,19,29
2019,176017,20,0,632,417,215
2019,176017,20,1,355,245,110
2019,176017,20,2,274,171,103
2019,176017,20,3,3,1,2
2019,176017,30,0,308,185,123
2019,176017,30,1,21,14,7
2019,176017,30,2,48,27,21
2019,176017,30,3,238,143,95
2019,176017,30,4,1,1,0
2019,176017,40,0,953,433,520
2019,176017,40,1,100,67,33
2019,176017,40,2,158,82,76
2019,176017,40,3,391,184,207
2019,176017,40,4,256,81,175
2019,176017,40,5,48,19,29
2019,176017,42,0,943,429,514
2019,176017,42,1,100,67,33
2019,176017,42,2,158,82,76
2019,176017,42,3,386,181,205
2019,176017,42,4,251,80,171
2019,176017,42,5,48,19,29
2019,176017,43,0,10,4,6
2019,176017,43,3,5,3,2
2019,176017,43,4,5,1,4
2019,176035,0,0,140,47,93
2019,176035,10,0,140,47,93
2019,176035,10,1,42,15,27
2019,176035,10,2,26,12,14
2019,176035,10,3,34,12,22
2019,176035,10,4,38,8,30
2019,176035,20,0,56,24,32
2019,176035,20,1,41,14,27
2019,176035,20,2,15,10,5
2019,176035,30,0,43,14,29
2019,176035,30,1,1,1,0
2019,176035,30,2,11,2,9
2019,176035,30,3,31,11,20
2019,176035,40,0,41,9,32
2019,176035,40,3,3,1,2
2019,176035,40,4,38,8,30
2019,176035,42,0,41,9,32
2019,176035,42,3,3,1,2
2019,176035,42,4,38,8,30
2019,176044,0,0,109,50,59
2019,176044,10,0,109,50,59
2019,176044,10,1,21,13,8
2019,176044,10,2,19,10,9
2019,176044,10,3,39,13,26
2019,176044,10,4,30,14,16
2019,176044,20,0,51,26,25
2019,176044,20,1,21,13,8
2019,176044,20,2,16,8,8
2019,176044,20,3,14,5,9
2019,176044,30,0,28,10,18
2019,176044,30,2,3,2,1
2019,176044,30,3,25,8,17
2019,176044,40,0,30,14,16
2019,176044,40,4,30,14,16
2019,176044,42,0,30,14,16
2019,176044,42,4,30,14,16
2019,176053,0,0,218,115,103
2019,176053,10,0,218,115,103
2019,176053,10,1,63,49,14
2019,176053,10,2,54,26,28
2019,176053,10,3,59,28,31
2019,176053,10,4,42,12,30
2019,176053,20,0,101,65,36
2019,176053,20,1,60,46,14
2019,176053,20,2,40,19,21
2019,176053,20,3,1,0,1
2019,176053,30,0,42,26,16
2019,176053,30,2,10,5,5
2019,176053,30,3,32,21,11
2019,176053,40,0,75,24,51
2019,176053,40,1,3,3,0
2019,176053,40,2,4,2,2
2019,176053,40,3,26,7,19
2019,176053,40,4,42,12,30
2019,176053,42,0,75,24,51
2019,176053,42,1,3,3,0
2019,176053,42,2,4,2,2
2019,176053,42,3,26,7,19
2019,176053,42,4,42,12,30
2019,176071,0,0,277,111,166
2019,176071,10,0,277,111,166
2019,176071,10,4,277,111,166
2019,176071,40,0,277,111,166
2019,176071,40,4,277,111,166
2019,176071,42,0,277,111,166
2019,176071,42,4,277,111,166
2019,176080,0,0,951,565,386
2019,176080,10,0,951,565,386
2019,176080,10,1,228,176,52
2019,176080,10,2,245,167,78
2019,176080,10,3,266,157,109
2019,176080,10,4,151,49,102
2019,176080,10,5,61,16,45
2019,176080,20,0,460,335,125
2019,176080,20,1,227,176,51
2019,176080,20,2,233,159,74
2019,176080,30,0,260,155,105
2019,176080,30,2,11,8,3
2019,176080,30,3,249,147,102
2019,176080,40,0,231,75,156
2019,176080,40,1,1,0,1
2019,176080,40,2,1,0,1
2019,176080,40,3,17,10,7
2019,176080,40,4,151,49,102
2019,176080,40,5,61,16,45
2019,176080,42,0,20,5,15
2019,176080,42,3,1,0,1
2019,176080,42,4,19,5,14
2019,176080,43,0,211,70,141
2019,176080,43,1,1,0,1
2019,176080,43,2,1,0,1
2019,176080,43,3,16,10,6
2019,176080,43,4,132,44,88
2019,176080,43,5,61,16,45
2019,176169,0,0,121,39,82
2019,176169,10,0,121,39,82
2019,176169,10,6,121,39,82
2019,176169,40,0,121,39,82
2019,176169,40,6,121,39,82
2019,176169,42,0,121,39,82
2019,176169,42,6,121,39,82
2019,176178,0,0,215,87,128
2019,176178,10,0,206,85,121
2019,176178,10,6,206,85,121
2019,176178,40,0,206,85,121
2019,176178,40,6,206,85,121
2019,176178,42,0,206,85,121
2019,176178,42,6,206,85,121
2019,176178,50,0,9,2,7
2019,176239,0,0,190,63,127
2019,176239,10,0,190,63,127
2019,176239,10,6,190,63,127
2019,176239,40,0,190,63,127
2019,176239,40,6,190,63,127
2019,176239,42,0,190,63,127
2019,176239,42,6,190,63,127
2019,176318,0,0,46,23,23
2019,176318,10,0,46,23,23
2019,176318,10,1,8,7,1
2019,176318,10,2,10,5,5
2019,176318,10,3,17,6,11
2019,176318,10,4,11,5,6
2019,176318,40,0,46,23,23
2019,176318,40,1,8,7,1
2019,176318,40,2,10,5,5
2019,176318,40,3,17,6,11
2019,176318,40,4,11,5,6
2019,176318,42,0,46,23,23
2019,176318,42,1,8,7,1
2019,176318,42,2,10,5,5
2019,176318,42,3,17,6,11
2019,176318,42,4,11,5,6
2019,176354,0,0,69,22,47
2019,176354,10,0,69,22,47
2019,176354,10,4,69,22,47
2019,176354,40,0,69,22,47
2019,176354,40,4,69,22,47
2019,176354,42,0,69,22,47
2019,176354,42,4,69,22,47
2019,176372,0,0,659,327,332
2019,176372,10,0,659,327,332
2019,176372,10,1,152,102,50
2019,176372,10,2,182,103,79
2019,176372,10,3,207,91,116
2019,176372,10,4,96,28,68
2019,176372,10,5,22,3,19
2019,176372,20,0,308,189,119
2019,176372,20,1,144,96,48
2019,176372,20,2,161,93,68
2019,176372,20,3,3,0,3
2019,176372,30,0,147,74,73
2019,176372,30,1,7,5,2
2019,176372,30,2,6,3,3
2019,176372,30,3,134,66,68
2019,176372,40,0,204,64,140
2019,176372,40,1,1,1,0
2019,176372,40,2,15,7,8
2019,176372,40,3,70,25,45
2019,176372,40,4,96,28,68
2019,176372,40,5,22,3,19
2019,176372,42,0,204,64,140
2019,176372,42,1,1,1,0
2019,176372,42,2,15,7,8
2019,176372,42,3,70,25,45
2019,176372,42,4,96,28,68
2019,176372,42,5,22,3,19
2019,176406,0,0,60,28,32
2019,176406,10,0,60,28,32
2019,176406,10,1,10,6,4
2019,176406,10,2,22,14,8
2019,176406,10,3,18,6,12
2019,176406,10,4,10,2,8
2019,176406,20,0,32,19,13
2019,176406,20,1,10,6,4
2019,176406,20,2,21,13,8
2019,176406,20,3,1,0,1
2019,176406,30,0,14,4,10
2019,176406,30,3,14,4,10
2019,176406,40,0,14,5,9
2019,176406,40,2,1,1,0
2019,176406,40,3,3,2,1
2019,176406,40,4,10,2,8
2019,176406,43,0,14,5,9
2019,176406,43,2,1,1,0
2019,176406,43,3,3,2,1
2019,176406,43,4,10,2,8
2019,176479,0,0,220,104,116
2019,176479,10,0,220,104,116
2019,176479,10,1,34,24,10
2019,176479,10,2,58,25,33
2019,176479,10,3,107,45,62
2019,176479,10,4,20,10,10
2019,176479,10,5,1,0,1
2019,176479,20,0,11,5,6
2019,176479,20,1,10,5,5
2019,176479,20,2,1,0,1
2019,176479,30,0,209,99,110
2019,176479,30,1,24,19,5
2019,176479,30,2,57,25,32
2019,176479,30,3,107,45,62
2019,176479,30,4,20,10,10
2019,176479,30,5,1,0,1
2019,176600,0,0,12,6,6
2019,176600,10,0,12,6,6
2019,176600,10,1,4,2,2
2019,176600,10,2,4,1,3
2019,176600,10,3,4,3,1
2019,176600,40,0,12,6,6
2019,176600,40,1,4,2,2
2019,176600,40,2,4,1,3
2019,176600,40,3,4,3,1
2019,176600,41,0,6,1,5
2019,176600,41,1,2,0,2
2019,176600,41,2,3,1,2
2019,176600,41,3,1,0,1
2019,176600,42,0,6,5,1
2019,176600,42,1,2,2,0
2019,176600,42,2,1,0,1
2019,176600,42,3,3,3,0
2019,176600,44,0,6,1,5
2019,176600,44,1,2,0,2
2019,176600,44,2,3,1,2
2019,176600,44,3,1,0,1
2019,176628,0,0,65,26,39
2019,176628,10,0,64,25,39
2019,176628,10,1,8,5,3
2019,176628,10,2,20,9,11
2019,176628,10,3,27,8,19
2019,176628,10,4,8,3,5
2019,176628,10,5,1,0,1
2019,176628,20,0,38,17,21
2019,176628,20,1,8,5,3
2019,176628,20,2,19,8,11
2019,176628,20,3,10,3,7
2019,176628,20,4,1,1,0
2019,176628,30,0,16,5,11
2019,176628,30,3,15,5,10
2019,176628,30,4,1,0,1
2019,176628,40,0,10,3,7
2019,176628,40,2,1,1,0
2019,176628,40,3,2,0,2
2019,176628,40,4,6,2,4
2019,176628,40,5,1,0,1
2019,176628,42,0,10,3,7
2019,176628,42,2,1,1,0
2019,176628,42,3,2,0,2
2019,176628,42,4,6,2,4
2019,176628,42,5,1,0,1
2019,176628,50,0,1,1,0
2019,176664,0,0,9,7,2
2019,176664,10,0,9,7,2
2019,176664,10,6,9,7,2
2019,176664,40,0,9,7,2
2019,176664,40,6,9,7,2
2019,176664,42,0,9,7,2
2019,176664,42,6,9,7,2
2019,176770,0,0,55,7,48
2019,176770,10,0,55,7,48
2019,176770,10,2,8,2,6
2019,176770,10,3,40,5,35
2019,176770,10,4,7,0,7
2019,176770,40,0,55,7,48
2019,176770,40,2,8,2,6
2019,176770,40,3,40,5,35
2019,176770,40,4,7,0,7
2019,176770,42,0,55,7,48
2019,176770,42,2,8,2,6
2019,176770,42,3,40,5,35
2019,176770,42,4,7,0,7
2019,176789,0,0,24,16,8
2019,176789,10,0,22,16,6
2019,176789,10,1,10,8,2
2019,176789,10,2,1,0,1
2019,176789,10,3,9,6,3
2019,176789,10,4,2,2,0
2019,176789,40,0,22,16,6
2019,176789,40,1,10,8,2
2019,176789,40,2,1,0,1
2019,176789,40,3,9,6,3
2019,176789,40,4,2,2,0
2019,176789,41,0,22,16,6
2019,176789,41,1,10,8,2
2019,176789,41,2,1,0,1
2019,176789,41,3,9,6,3
2019,176789,41,4,2,2,0
2019,176789,45,0,22,16,6
2019,176789,45,1,10,8,2
2019,176789,45,2,1,0,1
2019,176789,45,3,9,6,3
2019,176789,45,4,2,2,0
2019,176789,50,0,2,0,2
2019,176910,0,0,11,9,2
2019,176910,10,0,11,9,2
2019,176910,10,1,11,9,2
2019,176910,40,0,11,9,2
2019,176910,40,1,11,9,2
2019,176910,42,0,11,9,2
2019,176910,42,1,11,9,2
2019,176947,0,0,81,38,43
2019,176947,10,0,81,38,43
2019,176947,10,1,14,10,4
2019,176947,10,2,26,13,13
2019,176947,10,3,38,15,23
2019,176947,10,4,3,0,3
2019,176947,20,0,24,17,7
2019,176947,20,1,12,10,2
2019,176947,20,2,10,7,3
2019,176947,20,3,2,0,2
2019,176947,30,0,18,7,11
2019,176947,30,2,6,2,4
2019,176947,30,3,12,5,7
2019,176947,40,0,39,14,25
2019,176947,40,1,2,0,2
2019,176947,40,2,10,4,6
2019,176947,40,3,24,10,14
2019,176947,40,4,3,0,3
2019,176947,42,0,39,14,25
2019,176947,42,1,2,0,2
2019,176947,42,2,10,4,6
2019,176947,42,3,24,10,14
2019,176947,42,4,3,0,3
2019,176965,0,0,436,225,211
2019,176965,10,0,436,225,211
2019,176965,10,1,109,67,42
2019,176965,10,2,48,33,15
2019,176965,10,3,84,44,40
2019,176965,10,4,33,9,24
2019,176965,10,6,162,72,90
2019,176965,20,0,203,126,77
2019,176965,20,1,109,67,42
2019,176965,20,2,47,32,15
2019,176965,20,3,38,20,18
2019,176965,20,4,1,1,0
2019,176965,20,6,8,6,2
2019,176965,30,0,103,51,52
2019,176965,30,3,27,16,11
2019,176965,30,4,1,0,1
2019,176965,30,6,75,35,40
2019,176965,40,0,130,48,82
2019,176965,40,2,1,1,0
2019,176965,40,3,19,8,11
2019,176965,40,4,31,8,23
2019,176965,40,6,79,31,48
2019,176965,41,0,2,1,1
2019,176965,41,3,2,1,1
2019,176965,42,0,128,47,81
2019,176965,42,2,1,1,0
2019,176965,42,3,17,7,10
2019,176965,42,4,31,8,23
2019,176965,42,6,79,31,48
2019,176965,44,0,2,1,1
2019,176965,44,3,2,1,1
2019,177038,0,0,38,21,17
2019,177038,10,0,38,21,17
2019,177038,10,1,6,4,2
2019,177038,10,2,3,1,2
2019,177038,10,3,9,4,5
2019,177038,10,4,20,12,8
2019,177038,40,0,38,21,17
2019,177038,40,1,6,4,2
2019,177038,40,2,3,1,2
2019,177038,40,3,9,4,5
2019,177038,40,4,20,12,8
2019,177038,41,0,8,5,3
2019,177038,41,1,5,4,1
2019,177038,41,2,2,1,1
2019,177038,41,3,1,0,1
2019,177038,42,0,28,15,13
2019,177038,42,1,1,0,1
2019,177038,42,2,1,0,1
2019,177038,42,3,8,4,4
2019,177038,42,4,18,11,7
2019,177038,43,0,2,1,1
2019,177038,43,4,2,1,1
2019,177038,44,0,8,5,3
2019,177038,44,1,5,4,1
2019,177038,44,2,2,1,1
2019,177038,44,3,1,0,1
2019,177065,0,0,72,34,38
2019,177065,10,0,72,34,38
2019,177065,10,1,17,7,10
2019,177065,10,2,25,17,8
2019,177065,10,3,19,9,10
2019,177065,10,4,9,1,8
2019,177065,10,6,2,0,2
2019,177065,20,0,37,23,14
2019,177065,20,1,15,6,9
2019,177065,20,2,20,16,4
2019,177065,20,3,2,1,1
2019,177065,30,0,19,6,13
2019,177065,30,1,1,0,1
2019,177065,30,2,5,1,4
2019,177065,30,3,11,5,6
2019,177065,30,4,1,0,1
2019,177065,30,6,1,0,1
2019,177065,40,0,16,5,11
2019,177065,40,1,1,1,0
2019,177065,40,3,6,3,3
2019,177065,40,4,8,1,7
2019,177065,40,6,1,0,1
2019,177065,41,0,9,4,5
2019,177065,41,1,1,1,0
2019,177065,41,3,2,2,0
2019,177065,41,4,6,1,5
2019,177065,42,0,7,1,6
2019,177065,42,3,4,1,3
2019,177065,42,4,2,0,2
2019,177065,42,6,1,0,1
2019,177065,44,0,9,4,5
2019,177065,44,1,1,1,0
2019,177065,44,3,2,2,0
2019,177065,44,4,6,1,5
2019,177092,0,0,34,34,0
2019,177092,10,0,34,34,0
2019,177092,10,1,18,18,0
2019,177092,10,2,13,13,0
2019,177092,10,3,3,3,0
2019,177092,40,0,34,34,0
2019,177092,40,1,18,18,0
2019,177092,40,2,13,13,0
2019,177092,40,3,3,3,0
2019,177092,41,0,29,29,0
2019,177092,41,1,17,17,0
2019,177092,41,2,10,10,0
2019,177092,41,3,2,2,0
2019,177092,42,0,5,5,0
2019,177092,42,1,1,1,0
2019,177092,42,2,3,3,0
2019,177092,42,3,1,1,0
2019,177092,44,0,29,29,0
2019,177092,44,1,17,17,0
2019,177092,44,2,10,10,0
2019,177092,44,3,2,2,0
2019,177117,0,0,42,10,32
2019,177117,10,0,42,10,32
2019,177117,10,1,14,3,11
2019,177117,10,2,10,2,8
2019,177117,10,3,18,5,13
2019,177117,20,0,23,5,18
2019,177117,20,1,14,3,11
2019,177117,20,2,9,2,7
2019,177117,30,0,16,2,14
2019,177117,30,2,1,0,1
2019,177117,30,3,15,2,13
2019,177117,40,0,3,3,0
2019,177117,40,3,3,3,0
2019,177117,42,0,3,3,0
2019,177117,42,3,3,3,0
2019,177126,0,0,19,17,2
2019,177126,10,0,19,17,2
2019,177126,10,1,12,11,1
2019,177126,10,2,3,3,0
2019,177126,10,3,4,3,1
2019,177126,40,0,19,17,2
2019,177126,40,1,12,11,1
2019,177126,40,2,3,3,0
2019,177126,40,3,4,3,1
2019,177126,41,0,18,16,2
2019,177126,41,1,12,11,1
2019,177126,41,2,3,3,0
2019,177126,41,3,3,2,1
2019,177126,42,0,1,1,0
2019,177126,42,3,1,1,0
2019,177126,44,0,18,16,2
2019,177126,44,1,12,11,1
2019,177126,44,2,3,3,0
2019,177126,44,3,3,2,1
2019,177135,0,0,141,59,82
2019,177135,10,0,141,59,82
2019,177135,10,6,141,59,82
2019,177135,40,0,141,59,82
2019,177135,40,6,141,59,82
2019,177135,42,0,141,59,82
2019,177135,42,6,141,59,82
2019,177144,0,0,49,27,22
2019,177144,10,0,49,27,22
2019,177144,10,1,9,6,3
2019,177144,10,2,8,5,3
2019,177144,10,3,16,8,8
2019,177144,10,5,16,8,8
2019,177144,20,0,17,11,6
2019,177144,20,1,9,6,3
2019,177144,20,2,8,5,3
2019,177144,30,0,13,6,7
2019,177144,30,3,13,6,7
2019,177144,40,0,19,10,9
2019,177144,40,3,3,2,1
2019,177144,40,5,16,8,8
2019,177144,43,0,19,10,9
2019,177144,43,3,3,2,1
2019,177144,43,5,16,8,8
2019,177214,0,0,111,63,48
2019,177214,10,0,111,63,48
2019,177214,10,1,42,23,19
2019,177214,10,2,38,24,14
2019,177214,10,3,23,13,10
2019,177214,10,4,8,3,5
2019,177214,20,0,79,47,32
2019,177214,20,1,42,23,19
2019,177214,20,2,37,24,13
2019,177214,30,0,16,7,9
2019,177214,30,2,1,0,1
2019,177214,30,3,15,7,8
2019,177214,40,0,16,9,7
2019,177214,40,3,8,6,2
2019,177214,40,4,8,3,5
2019,177214,42,0,16,9,7
2019,177214,42,3,8,6,2
2019,177214,42,4,8,3,5
2019,177250,0,0,64,31,33
2019,177250,10,0,64,31,33
2019,177250,10,1,3,1,2
2019,177250,10,2,9,5,4
2019,177250,10,3,14,6,8
2019,177250,10,4,38,19,19
2019,177250,20,0,40,22,18
2019,177250,20,1,3,1,2
2019,177250,20,2,9,5,4
2019,177250,20,3,14,6,8
2019,177250,20,4,14,10,4
2019,177250,30,0,24,9,15
2019,177250,30,4,24,9,15
2019,177278,0,0,9,4,5
2019,177278,10,0,9,4,5
2019,177278,10,1,5,1,4
2019,177278,10,2,2,1,1
2019,177278,10,3,2,2,0
2019,177278,20,0,5,2,3
2019,177278,20,1,4,1,3
2019,177278,20,2,1,1,0
2019,177278,30,0,3,2,1
2019,177278,30,2,1,0,1
2019,177278,30,3,2,2,0
2019,177278,40,0,1,0,1
2019,177278,40,1,1,0,1
2019,177278,41,0,1,0,1
2019,177278,41,1,1,0,1
2019,177278,44,0,1,0,1
2019,177278,44,1,1,0,1
2019,177302,0,0,6,2,4
2019,177302,10,0,6,2,4
2019,177302,10,4,6,2,4
2019,177302,40,0,6,2,4
2019,177302,40,4,6,2,4
2019,177302,41,0,6,2,4
2019,177302,41,4,6,2,4
2019,177302,45,0,6,2,4
2019,177302,45,4,6,2,4
2019,177339,0,0,84,48,36
2019,177339,10,0,84,48,36
2019,177339,10,1,38,27,11
2019,177339,10,2,26,15,11
2019,177339,10,3,20,6,14
2019,177339,20,0,47,33,14
2019,177339,20,1,30,25,5
2019,177339,20,2,15,8,7
2019,177339,20,3,2,0,2
2019,177339,30,0,36,14,22
2019,177339,30,1,8,2,6
2019,177339,30,2,11,7,4
2019,177339,30,3,17,5,12
2019,177339,40,0,1,1,0
2019,177339,40,3,1,1,0
2019,177339,42,0,1,1,0
2019,177339,42,3,1,1,0
2019,177418,0,0,62,25,37
2019,177418,10,0,62,25,37
2019,177418,10,1,15,7,8
2019,177418,10,2,16,7,9
2019,177418,10,3,22,6,16
2019,177418,10,4,9,5,4
2019,177418,20,0,28,12,16
2019,177418,20,1,14,6,8
2019,177418,20,2,14,6,8
2019,177418,30,0,22,7,15
2019,177418,30,2,2,1,1
2019,177418,30,3,20,6,14
2019,177418,40,0,12,6,6
2019,177418,40,1,1,1,0
2019,177418,40,3,2,0,2
2019,177418,40,4,9,5,4
2019,177418,42,0,12,6,6
2019,177418,42,1,1,1,0
2019,177418,42,3,2,0,2
2019,177418,42,4,9,5,4
2019,177472,0,0,224,93,131
2019,177472,10,0,224,93,131
2019,177472,10,6,224,93,131
2019,177472,40,0,224,93,131
2019,177472,40,6,224,93,131
2019,177472,42,0,222,93,129
2019,177472,42,6,222,93,129
2019,177472,43,0,2,0,2
2019,177472,43,6,2,0,2
2019,177542,0,0,43,21,22
2019,177542,10,0,43,21,22
2019,177542,10,1,8,6,2
2019,177542,10,2,5,3,2
2019,177542,10,3,20,8,12
2019,177542,10,4,10,4,6
2019,177542,40,0,43,21,22
2019,177542,40,1,8,6,2
2019,177542,40,2,5,3,2
2019,177542,40,3,20,8,12
2019,177542,40,4,10,4,6
2019,177542,42,0,43,21,22
2019,177542,42,1,8,6,2
2019,177542,42,2,5,3,2
2019,177542,42,3,20,8,12
2019,177542,42,4,10,4,6
2019,177551,0,0,35,20,15
2019,177551,10,0,35,20,15
2019,177551,10,1,4,2,2
2019,177551,10,2,13,7,6
2019,177551,10,3,12,6,6
2019,177551,10,4,6,5,1
2019,177551,20,0,6,4,2
2019,177551,20,1,4,2,2
2019,177551,20,3,1,1,0
2019,177551,20,4,1,1,0
2019,177551,30,0,15,9,6
2019,177551,30,2,10,5,5
2019,177551,30,3,5,4,1
2019,177551,40,0,14,7,7
2019,177551,40,2,3,2,1
2019,177551,40,3,6,1,5
2019,177551,40,4,5,4,1
2019,177551,41,0,13,7,6
2019,177551,41,2,2,2,0
2019,177551,41,3,6,1,5
2019,177551,41,4,5,4,1
2019,177551,42,0,1,0,1
2019,177551,42,2,1,0,1
2019,177551,44,0,13,7,6
2019,177551,44,2,2,2,0
2019,177551,44,3,6,1,5
2019,177551,44,4,5,4,1
2019,177676,0,0,91,40,51
2019,177676,10,0,91,40,51
2019,177676,10,1,29,16,13
2019,177676,10,2,25,10,15
2019,177676,10,3,18,4,14
2019,177676,10,4,16,9,7
2019,177676,10,6,3,1,2
2019,177676,20,0,58,27,31
2019,177676,20,1,29,16,13
2019,177676,20,2,23,9,14
2019,177676,20,3,6,2,4
2019,177676,30,0,30,12,18
2019,177676,30,2,2,1,1
2019,177676,30,3,12,2,10
2019,177676,30,4,16,9,7
2019,177676,40,0,3,1,2
2019,177676,40,6,3,1,2
2019,177676,42,0,3,1,2
2019,177676,42,6,3,1,2
2019,177719,0,0,54,6,48
2019,177719,10,0,54,6,48
2019,177719,10,1,1,0,1
2019,177719,10,2,5,0,5
2019,177719,10,3,36,6,30
2019,177719,10,4,12,0,12
2019,177719,40,0,54,6,48
2019,177719,40,1,1,0,1
2019,177719,40,2,5,0,5
2019,177719,40,3,36,6,30
2019,177719,40,4,12,0,12
2019,177719,41,0,1,0,1
2019,177719,41,1,1,0,1
2019,177719,42,0,53,6,47
2019,177719,42,2,5,0,5
2019,177719,42,3,36,6,30
2019,177719,42,4,12,0,12
2019,177719,44,0,1,0,1
2019,177719,44,1,1,0,1
2019,177746,0,0,56,30,26
2019,177746,10,0,56,30,26
2019,177746,10,1,15,7,8
2019,177746,10,2,18,11,7
2019,177746,10,3,23,12,11
2019,177746,20,0,32,18,14
2019,177746,20,1,15,7,8
2019,177746,20,2,14,10,4
2019,177746,20,3,3,1,2
2019,177746,30,0,10,4,6
2019,177746,30,2,1,0,1
2019,177746,30,3,9,4,5
2019,177746,40,0,14,8,6
2019,177746,40,2,3,1,2
2019,177746,40,3,11,7,4
2019,177746,42,0,14,8,6
2019,177746,42,2,3,1,2
2019,177746,42,3,11,7,4
2019,177816,0,0,12,11,1
2019,177816,10,0,12,11,1
2019,177816,10,1,5,4,1
2019,177816,10,2,3,3,0
2019,177816,10,3,3,3,0
2019,177816,10,5,1,1,0
2019,177816,40,0,12,11,1
2019,177816,40,1,5,4,1
2019,177816,40,2,3,3,0
2019,177816,40,3,3,3,0
2019,177816,40,5,1,1,0
2019,177816,41,0,7,6,1
2019,177816,41,1,4,3,1
2019,177816,41,2,2,2,0
2019,177816,41,3,1,1,0
2019,177816,42,0,5,5,0
2019,177816,42,1,1,1,0
2019,177816,42,2,1,1,0
2019,177816,42,3,2,2,0
2019,177816,42,5,1,1,0
2019,177816,44,0,7,6,1
2019,177816,44,1,4,3,1
2019,177816,44,2,2,2,0
2019,177816,44,3,1,1,0
2019,177834,0,0,246,117,129
2019,177834,10,0,246,117,129
2019,177834,10,1,40,26,14
2019,177834,10,2,69,33,36
2019,177834,10,3,120,57,63
2019,177834,10,4,17,1,16
2019,177834,40,0,246,117,129
2019,177834,40,1,40,26,14
2019,177834,40,2,69,33,36
2019,177834,40,3,120,57,63
2019,177834,40,4,17,1,16
2019,177834,42,0,246,117,129
2019,177834,42,1,40,26,14
2019,177834,42,2,69,33,36
2019,177834,42,3,120,57,63
2019,177834,42,4,17,1,16
2019,177940,0,0,106,57,49
2019,177940,10,0,106,57,49
2019,177940,10,1,30,21,9
2019,177940,10,2,23,12,11
2019,177940,10,3,36,16,20
2019,177940,10,4,17,8,9
2019,177940,20,0,43,29,14
2019,177940,20,1,30,21,9
2019,177940,20,2,12,8,4
2019,177940,20,3,1,0,1
2019,177940,30,0,30,12,18
2019,177940,30,2,7,1,6
2019,177940,30,3,21,11,10
2019,177940,30,4,2,0,2
2019,177940,40,0,33,16,17
2019,177940,40,2,4,3,1
2019,177940,40,3,14,5,9
2019,177940,40,4,15,8,7
2019,177940,42,0,33,16,17
2019,177940,42,2,4,3,1
2019,177940,42,3,14,5,9
2019,177940,42,4,15,8,7
2019,177968,0,0,257,127,130
2019,177968,10,0,257,127,130
2019,177968,10,1,77,35,42
2019,177968,10,2,91,48,43
2019,177968,10,3,72,36,36
2019,177968,10,4,17,8,9
2019,177968,40,0,257,127,130
2019,177968,40,1,77,35,42
2019,177968,40,2,91,48,43
2019,177968,40,3,72,36,36
2019,177968,40,4,17,8,9
2019,177968,42,0,257,127,130
2019,177968,42,1,77,35,42
2019,177968,42,2,91,48,43
2019,177968,42,3,72,36,36
2019,177968,42,4,17,8,9
2019,177977,0,0,94,63,31
2019,177977,10,0,94,63,31
2019,177977,10,4,94,63,31
2019,177977,40,0,94,63,31
2019,177977,40,4,94,63,31
2019,177977,42,0,94,63,31
2019,177977,42,4,94,63,31
2019,177986,0,0,44,25,19
2019,177986,10,0,44,25,19
2019,177986,10,1,11,6,5
2019,177986,10,2,4,3,1
2019,177986,10,3,17,7,10
2019,177986,10,4,12,9,3
2019,177986,40,0,44,25,19
2019,177986,40,1,11,6,5
2019,177986,40,2,4,3,1
2019,177986,40,3,17,7,10
2019,177986,40,4,12,9,3
2019,177986,41,0,26,15,11
2019,177986,41,1,10,5,5
2019,177986,41,2,3,2,1
2019,177986,41,3,7,4,3
2019,177986,41,4,6,4,2
2019,177986,42,0,18,10,8
2019,177986,42,1,1,1,0
2019,177986,42,2,1,1,0
2019,177986,42,3,10,3,7
2019,177986,42,4,6,5,1
2019,177986,44,0,26,15,11
2019,177986,44,1,10,5,5
2019,177986,44,2,3,2,1
2019,177986,44,3,7,4,3
2019,177986,44,4,6,4,2
2019,177995,0,0,243,110,133
2019,177995,10,0,243,110,133
2019,177995,10,6,243,110,133
2019,177995,40,0,243,110,133
2019,177995,40,6,243,110,133
2019,177995,42,0,243,110,133
2019,177995,42,6,243,110,133
2019,178059,0,0,167,65,102
2019,178059,10,0,167,65,102
2019,178059,10,1,26,14,12
2019,178059,10,2,45,18,27
2019,178059,10,3,83,26,57
2019,178059,10,4,12,7,5
2019,178059,10,6,1,0,1
2019,178059,20,0,63,30,33
2019,178059,20,1,25,13,12
2019,178059,20,2,38,17,21
2019,178059,30,0,50,17,33
2019,178059,30,2,6,1,5
2019,178059,30,3,44,16,28
2019,178059,40,0,54,18,36
2019,178059,40,1,1,1,0
2019,178059,40,2,1,0,1
2019,178059,40,3,39,10,29
2019,178059,40,4,12,7,5
2019,178059,40,6,1,0,1
2019,178059,41,0,1,0,1
2019,178059,41,6,1,0,1
2019,178059,42,0,53,18,35
2019,178059,42,1,1,1,0
2019,178059,42,2,1,0,1
2019,178059,42,3,39,10,29
2019,178059,42,4,12,7,5
2019,178059,44,0,1,0,1
2019,178059,44,6,1,0,1
2019,178183,0,0,6,1,5
2019,178183,10,0,6,1,5
2019,178183,10,4,6,1,5
2019,178183,40,0,6,1,5
2019,178183,40,4,6,1,5
2019,178183,41,0,6,1,5
2019,178183,41,4,6,1,5
2019,178183,44,0,6,1,5
2019,178183,44,4,6,1,5
2019,178208,0,0,36,36,0
2019,178208,10,0,36,36,0
2019,178208,10,1,10,10,0
2019,178208,10,2,10,10,0
2019,178208,10,3,16,16,0
2019,178208,40,0,36,36,0
2019,178208,40,1,10,10,0
2019,178208,40,2,10,10,0
2019,178208,40,3,16,16,0
2019,178208,41,0,36,36,0
2019,178208,41,1,10,10,0
2019,178208,41,2,10,10,0
2019,178208,41,3,16,16,0
2019,178208,44,0,36,36,0
2019,178208,44,1,10,10,0
2019,178208,44,2,10,10,0
2019,178208,44,3,16,16,0
2019,178217,0,0,56,27,29
2019,178217,10,0,56,27,29
2019,178217,10,1,14,8,6
2019,178217,10,2,10,7,3
2019,178217,10,3,13,5,8
2019,178217,10,4,19,7,12
2019,178217,40,0,56,27,29
2019,178217,40,1,14,8,6
2019,178217,40,2,10,7,3
2019,178217,40,3,13,5,8
2019,178217,40,4,19,7,12
2019,178217,42,0,55,27,28
2019,178217,42,1,14,8,6
2019,178217,42,2,10,7,3
2019,178217,42,3,13,5,8
2019,178217,42,4,18,7,11
2019,178217,43,0,1,0,1
2019,178217,43,4,1,0,1
2019,178244,0,0,67,33,34
2019,178244,10,0,67,33,34
2019,178244,10,1,16,9,7
2019,178244,10,2,11,5,6
2019,178244,10,3,36,17,19
2019,178244,10,4,2,1,1
2019,178244,10,5,2,1,1
2019,178244,40,0,67,33,34
2019,178244,40,1,16,9,7
2019,178244,40,2,11,5,6
2019,178244,40,3,36,17,19
2019,178244,40,4,2,1,1
2019,178244,40,5,2,1,1
2019,178244,42,0,67,33,34
2019,178244,42,1,16,9,7
2019,178244,42,2,11,5,6
2019,178244,42,3,36,17,19
2019,178244,42,4,2,1,1
2019,178244,42,5,2,1,1
2019,178341,0,0,191,99,92
2019,178341,10,0,191,99,92
2019,178341,10,1,48,34,14
2019,178341,10,2,37,16,21
2019,178341,10,3,68,33,35
2019,178341,10,4,25,8,17
2019,178341,10,5,13,8,5
2019,178341,20,0,84,50,34
2019,178341,20,1,48,34,14
2019,178341,20,2,27,12,15
2019,178341,20,3,9,4,5
2019,178341,30,0,57,28,29
2019,178341,30,2,10,4,6
2019,178341,30,3,47,24,23
2019,178341,40,0,50,21,29
2019,178341,40,3,12,5,7
2019,178341,40,4,25,8,17
2019,178341,40,5,13,8,5
2019,178341,42,0,50,21,29
2019,178341,42,3,12,5,7
2019,178341,42,4,25,8,17
2019,178341,42,5,13,8,5
2019,178369,0,0,89,44,45
2019,178369,10,0,85,41,44
2019,178369,10,1,9,5,4
2019,178369,10,2,21,10,11
2019,178369,10,3,38,13,25
2019,178369,10,4,16,13,3
2019,178369,10,6,1,0,1
2019,178369,40,0,85,41,44
2019,178369,40,1,9,5,4
2019,178369,40,2,21,10,11
2019,178369,40,3,38,13,25
2019,178369,40,4,16,13,3
2019,178369,40,6,1,0,1
2019,178369,41,0,4,2,2
2019,178369,41,1,1,0,1
2019,178369,41,3,3,2,1
2019,178369,42,0,81,39,42
2019,178369,42,1,8,5,3
2019,178369,42,2,21,10,11
2019,178369,42,3,35,11,24
2019,178369,42,4,16,13,3
2019,178369,42,6,1,0,1
2019,178369,44,0,4,2,2
2019,178369,44,1,1,0,1
2019,178369,44,3,3,2,1
2019,178369,50,0,4,3,1
2019,178387,0,0,210,113,97
2019,178387,10,0,210,113,97
2019,178387,10,1,48,34,14
2019,178387,10,2,50,29,21
2019,178387,10,3,81,37,44
2019,178387,10,4,31,13,18
2019,178387,20,0,102,66,36
2019,178387,20,1,48,34,14
2019,178387,20,2,48,27,21
2019,178387,20,3,6,5,1
2019,178387,30,0,75,33,42
2019,178387,30,2,1,1,0
2019,178387,30,3,74,32,42
2019,178387,40,0,33,14,19
2019,178387,40,2,1,1,0
2019,178387,40,3,1,0,1
2019,178387,40,4,31,13,18
2019,178387,42,0,31,13,18
2019,178387,42,2,1,1,0
2019,178387,42,3,1,0,1
2019,178387,42,4,29,12,17
2019,178387,43,0,2,1,1
2019,178387,43,4,2,1,1
2019,178396,0,0,1872,1067,805
2019,178396,10,0,1872,1067,805
2019,178396,10,1,430,307,123
2019,178396,10,2,547,322,225
2019,178396,10,3,654,325,329
2019,178396,10,4,103,41,62
2019,178396,10,5,9,3,6
2019,178396,10,6,129,69,60
2019,178396,20,0,661,457,204
2019,178396,20,1,339,257,82
2019,178396,20,2,322,200,122
2019,178396,30,0,242,117,125
2019,178396,30,1,1,0,1
2019,178396,30,2,7,3,4
2019,178396,30,3,234,114,120
2019,178396,40,0,969,493,476
2019,178396,40,1,90,50,40
2019,178396,40,2,218,119,99
2019,178396,40,3,420,211,209
2019,178396,40,4,103,41,62
2019,178396,40,5,9,3,6
2019,178396,40,6,129,69,60
2019,178396,42,0,968,493,475
2019,178396,42,1,90,50,40
2019,178396,42,2,218,119,99
2019,178396,42,3,420,211,209
2019,178396,42,4,102,41,61
2019,178396,42,5,9,3,6
2019,178396,42,6,129,69,60
2019,178396,43,0,1,0,1
2019,178396,43,4,1,0,1
2019,178402,0,0,616,318,298
2019,178402,10,0,616,318,298
2019,178402,10,1,150,92,58
2019,178402,10,2,237,130,107
2019,178402,10,3,173,73,100
2019,178402,10,4,16,7,9
2019,178402,10,5,19,7,12
2019,178402,10,6,21,9,12
2019,178402,20,0,260,161,99
2019,178402,20,1,125,79,46
2019,178402,20,2,135,82,53
2019,178402,30,0,80,40,40
2019,178402,30,1,1,1,0
2019,178402,30,2,15,9,6
2019,178402,30,3,64,30,34
2019,178402,40,0,276,117,159
2019,178402,40,1,24,12,12
2019,178402,40,2,87,39,48
2019,178402,40,3,109,43,66
2019,178402,40,4,16,7,9
2019,178402,40,5,19,7,12
2019,178402,40,6,21,9,12
2019,178402,42,0,275,116,159
2019,178402,42,1,24,12,12
2019,178402,42,2,87,39,48
2019,178402,42,3,109,43,66
2019,178402,42,4,16,7,9
2019,178402,42,5,19,7,12
2019,178402,42,6,20,8,12
2019,178402,43,0,1,1,0
2019,178402,43,6,1,1,0
2019,178411,0,0,360,253,107
2019,178411,10,0,360,253,107
2019,178411,10,1,119,93,26
2019,178411,10,2,118,81,37
2019,178411,10,3,105,68,37
2019,178411,10,5,6,4,2
2019,178411,10,6,12,7,5
2019,178411,20,0,202,154,48
2019,178411,20,1,111,90,21
2019,178411,20,2,91,64,27
2019,178411,30,0,77,55,22
2019,178411,30,2,2,2,0
2019,178411,30,3,75,53,22
2019,178411,40,0,81,44,37
2019,178411,40,1,8,3,5
2019,178411,40,2,25,15,10
2019,178411,40,3,30,15,15
2019,178411,40,5,6,4,2
2019,178411,40,6,12,7,5
2019,178411,42,0,81,44,37
2019,178411,42,1,8,3,5
2019,178411,42,2,25,15,10
2019,178411,42,3,30,15,15
2019,178411,42,5,6,4,2
2019,178411,42,6,12,7,5
2019,178420,0,0,389,171,218
2019,178420,10,0,389,171,218
2019,178420,10,1,114,66,48
2019,178420,10,2,119,53,66
2019,178420,10,3,151,50,101
2019,178420,10,5,1,0,1
2019,178420,10,6,4,2,2
2019,178420,20,0,161,92,69
2019,178420,20,1,88,58,30
2019,178420,20,2,73,34,39
2019,178420,30,0,63,24,39
2019,178420,30,2,5,3,2
2019,178420,30,3,58,21,37
2019,178420,40,0,165,55,110
2019,178420,40,1,26,8,18
2019,178420,40,2,41,16,25
2019,178420,40,3,93,29,64
2019,178420,40,5,1,0,1
2019,178420,40,6,4,2,2
2019,178420,42,0,165,55,110
2019,178420,42,1,26,8,18
2019,178420,42,2,41,16,25
2019,178420,42,3,93,29,64
2019,178420,42,5,1,0,1
2019,178420,42,6,4,2,2
2019,178448,0,0,67,28,39
2019,178448,10,0,67,28,39
2019,178448,10,1,10,4,6
2019,178448,10,2,20,8,12
2019,178448,10,3,10,3,7
2019,178448,10,4,27,13,14
2019,178448,40,0,67,28,39
2019,178448,40,1,10,4,6
2019,178448,40,2,20,8,12
2019,178448,40,3,10,3,7
2019,178448,40,4,27,13,14
2019,178448,41,0,31,14,17
2019,178448,41,1,8,3,5
2019,178448,41,2,11,5,6
2019,178448,41,3,7,2,5
2019,178448,41,4,5,4,1
2019,178448,42,0,36,14,22
2019,178448,42,1,2,1,1
2019,178448,42,2,9,3,6
2019,178448,42,3,3,1,2
2019,178448,42,4,22,9,13
2019,178448,44,0,31,14,17
2019,178448,44,1,8,3,5
2019,178448,44,2,11,5,6
2019,178448,44,3,7,2,5
2019,178448,44,4,5,4,1
2019,178518,0,0,11,8,3
2019,178518,10,0,11,8,3
2019,178518,10,1,8,7,1
2019,178518,10,2,3,1,2
2019,178518,20,0,1,1,0
2019,178518,20,1,1,1,0
2019,178518,40,0,10,7,3
2019,178518,40,1,7,6,1
2019,178518,40,2,3,1,2
2019,178518,41,0,10,7,3
2019,178518,41,1,7,6,1
2019,178518,41,2,3,1,2
2019,178518,44,0,10,7,3
2019,178518,44,1,7,6,1
2019,178518,44,2,3,1,2
2019,178615,0,0,295,168,127
2019,178615,10,0,295,168,127
2019,178615,10,1,142,95,47
2019,178615,10,2,25,14,11
2019,178615,10,3,101,49,52
2019,178615,10,4,27,10,17
2019,178615,20,0,167,108,59
2019,178615,20,1,142,95,47
2019,178615,20,2,23,12,11
2019,178615,20,3,2,1,1
2019,178615,30,0,69,33,36
2019,178615,30,2,1,1,0
2019,178615,30,3,68,32,36
2019,178615,40,0,59,27,32
2019,178615,40,2,1,1,0
2019,178615,40,3,31,16,15
2019,178615,40,4,27,10,17
2019,178615,42,0,59,27,32
2019,178615,42,2,1,1,0
2019,178615,42,3,31,16,15
2019,178615,42,4,27,10,17
2019,178624,0,0,232,124,108
2019,178624,10,0,232,124,108
2019,178624,10,1,39,27,12
2019,178624,10,2,55,33,22
2019,178624,10,3,81,44,37
2019,178624,10,4,55,18,37
2019,178624,10,5,2,2,0
2019,178624,20,0,91,56,35
2019,178624,20,1,39,27,12
2019,178624,20,2,50,28,22
2019,178624,20,3,2,1,1
2019,178624,30,0,78,43,35
2019,178624,30,2,4,4,0
2019,178624,30,3,72,39,33
2019,178624,30,4,2,0,2
2019,178624,40,0,63,25,38
2019,178624,40,2,1,1,0
2019,178624,40,3,7,4,3
2019,178624,40,4,53,18,35
2019,178624,40,5,2,2,0
2019,178624,42,0,63,25,38
2019,178624,42,2,1,1,0
2019,178624,42,3,7,4,3
2019,178624,42,4,53,18,35
2019,178624,42,5,2,2,0
2019,178679,0,0,20,18,2
2019,178679,10,0,20,18,2
2019,178679,10,1,20,18,2
2019,178679,40,0,20,18,2
2019,178679,40,1,20,18,2
2019,178679,42,0,20,18,2
2019,178679,42,1,20,18,2
2019,178697,0,0,98,56,42
2019,178697,10,0,98,56,42
2019,178697,10,1,25,16,9
2019,178697,10,2,42,20,22
2019,178697,10,3,28,17,11
2019,178697,10,4,3,3,0
2019,178697,40,0,98,56,42
2019,178697,40,1,25,16,9
2019,178697,40,2,42,20,22
2019,178697,40,3,28,17,11
2019,178697,40,4,3,3,0
2019,178697,41,0,2,1,1
2019,178697,41,1,2,1,1
2019,178697,42,0,96,55,41
2019,178697,42,1,23,15,8
2019,178697,42,2,42,20,22
2019,178697,42,3,28,17,11
2019,178697,42,4,3,3,0
2019,178697,45,0,2,1,1
2019,178697,45,1,2,1,1
2019,178721,0,0,118,58,60
2019,178721,10,0,118,58,60
2019,178721,10,1,20,14,6
2019,178721,10,2,36,19,17
2019,178721,10,3,43,17,26
2019,178721,10,4,4,2,2
2019,178721,10,5,15,6,9
2019,178721,20,0,48,31,17
2019,178721,20,1,20,14,6
2019,178721,20,2,28,17,11
2019,178721,30,0,35,14,21
2019,178721,30,2,6,1,5
2019,178721,30,3,29,13,16
2019,178721,40,0,35,13,22
2019,178721,40,2,2,1,1
2019,178721,40,3,14,4,10
2019,178721,40,4,4,2,2
2019,178721,40,5,15,6,9
2019,178721,42,0,35,13,22
2019,178721,42,2,2,1,1
2019,178721,42,3,14,4,10
2019,178721,42,4,4,2,2
2019,178721,42,5,15,6,9
2019,178891,0,0,101,96,5
2019,178891,10,0,101,96,5
2019,178891,10,4,101,96,5
2019,178891,40,0,101,96,5
2019,178891,40,4,101,96,5
2019,178891,41,0,101,96,5
2019,178891,41,4,101,96,5
2019,178891,45,0,101,96,5
2019,178891,45,4,101,96,5
2019,178989,0,0,35,0,35
2019,178989,10,0,35,0,35
2019,178989,10,1,5,0,5
2019,178989,10,2,4,0,4
2019,178989,10,3,20,0,20
2019,178989,10,4,6,0,6
2019,178989,40,0,35,0,35
2019,178989,40,1,5,0,5
2019,178989,40,2,4,0,4
2019,178989,40,3,20,0,20
2019,178989,40,4,6,0,6
2019,178989,41,0,24,0,24
2019,178989,41,1,4,0,4
2019,178989,41,2,3,0,3
2019,178989,41,3,17,0,17
2019,178989,42,0,11,0,11
2019,178989,42,1,1,0,1
2019,178989,42,2,1,0,1
2019,178989,42,3,3,0,3
2019,178989,42,4,6,0,6
2019,178989,44,0,24,0,24
2019,178989,44,1,4,0,4
2019,178989,44,2,3,0,3
2019,178989,44,3,17,0,17
2019,179043,0,0,129,59,70
2019,179043,10,0,129,59,70
2019,179043,10,1,39,22,17
2019,179043,10,2,35,15,20
2019,179043,10,3,41,16,25
2019,179043,10,4,7,2,5
2019,179043,10,5,6,3,3
2019,179043,10,6,1,1,0
2019,179043,20,0,77,38,39
2019,179043,20,1,38,22,16
2019,179043,20,2,35,15,20
2019,179043,20,3,3,1,2
2019,179043,20,5,1,0,1
2019,179043,30,0,31,10,21
2019,179043,30,3,31,10,21
2019,179043,40,0,21,11,10
2019,179043,40,1,1,0,1
2019,179043,40,3,7,5,2
2019,179043,40,4,7,2,5
2019,179043,40,5,5,3,2
2019,179043,40,6,1,1,0
2019,179043,42,0,16,8,8
2019,179043,42,1,1,0,1
2019,179043,42,3,6,4,2
2019,179043,42,4,5,2,3
2019,179043,42,5,4,2,2
2019,179043,43,0,5,3,2
2019,179043,43,3,1,1,0
2019,179043,43,4,2,0,2
2019,179043,43,5,1,1,0
2019,179043,43,6,1,1,0
2019,179159,0,0,1288,704,584
2019,179159,10,0,1283,701,582
2019,179159,10,1,373,253,120
2019,179159,10,2,407,215,192
2019,179159,10,3,458,215,243
2019,179159,10,4,45,18,27
2019,179159,20,0,499,318,181
2019,179159,20,1,278,197,81
2019,179159,20,2,221,121,100
2019,179159,30,0,142,72,70
2019,179159,30,1,1,1,0
2019,179159,30,2,16,9,7
2019,179159,30,3,125,62,63
2019,179159,40,0,642,311,331
2019,179159,40,1,94,55,39
2019,179159,40,2,170,85,85
2019,179159,40,3,333,153,180
2019,179159,40,4,45,18,27
2019,179159,41,0,7,0,7
2019,179159,41,1,4,0,4
2019,179159,41,2,3,0,3
2019,179159,42,0,635,311,324
2019,179159,42,1,90,55,35
2019,179159,42,2,167,85,82
2019,179159,42,3,333,153,180
2019,179159,42,4,45,18,27
2019,179159,44,0,7,0,7
2019,179159,44,1,4,0,4
2019,179159,44,2,3,0,3
2019,179159,50,0,5,3,2
2019,179256,0,0,5,4,1
2019,179256,10,0,5,4,1
2019,179256,10,1,5,4,1
2019,179256,40,0,5,4,1
2019,179256,40,1,5,4,1
2019,179256,42,0,5,4,1
2019,179256,42,1,5,4,1
2019,179265,0,0,67,26,41
2019,179265,10,0,67,26,41
2019,179265,10,1,15,9,6
2019,179265,10,2,17,7,10
2019,179265,10,3,28,9,19
2019,179265,10,4,7,1,6
2019,179265,20,0,13,7,6
2019,179265,20,1,8,5,3
2019,179265,20,2,5,2,3
2019,179265,30,0,22,11,11
2019,179265,30,1,2,1,1
2019,179265,30,2,6,4,2
2019,179265,30,3,14,6,8
2019,179265,40,0,32,8,24
2019,179265,40,1,5,3,2
2019,179265,40,2,6,1,5
2019,179265,40,3,14,3,11
2019,179265,40,4,7,1,6
2019,179265,42,0,32,8,24
2019,179265,42,1,5,3,2
2019,179265,42,2,6,1,5
2019,179265,42,3,14,3,11
2019,179265,42,4,7,1,6
2019,179308,0,0,321,136,185
2019,179308,10,0,321,136,185
2019,179308,10,1,143,65,78
2019,179308,10,2,79,34,45
2019,179308,10,3,70,27,43
2019,179308,10,4,18,8,10
2019,179308,10,5,5,1,4
2019,179308,10,6,6,1,5
2019,179308,40,0,321,136,185
2019,179308,40,1,143,65,78
2019,179308,40,2,79,34,45
2019,179308,40,3,70,27,43
2019,179308,40,4,18,8,10
2019,179308,40,5,5,1,4
2019,179308,40,6,6,1,5
2019,179308,42,0,311,134,177
2019,179308,42,1,143,65,78
2019,179308,42,2,79,34,45
2019,179308,42,3,70,27,43
2019,179308,42,4,18,8,10
2019,179308,42,5,1,0,1
2019,179308,43,0,10,2,8
2019,179308,43,5,4,1,3
2019,179308,43,6,6,1,5
2019,179317,0,0,8,3,5
2019,179317,10,0,8,3,5
2019,179317,10,1,7,3,4
2019,179317,10,3,1,0,1
2019,179317,20,0,7,3,4
2019,179317,20,1,7,3,4
2019,179317,40,0,1,0,1
2019,179317,40,3,1,0,1
2019,179317,41,0,1,0,1
2019,179317,41,3,1,0,1
2019,179317,44,0,1,0,1
2019,179317,44,3,1,0,1
2019,179326,0,0,149,71,78
2019,179326,10,0,149,71,78
2019,179326,10,1,41,30,11
2019,179326,10,2,16,10,6
2019,179326,10,3,43,21,22
2019,179326,10,4,49,10,39
2019,179326,20,0,68,44,24
2019,179326,20,1,41,30,11
2019,179326,20,2,14,9,5
2019,179326,20,3,11,5,6
2019,179326,20,4,2,0,2
2019,179326,30,0,33,17,16
2019,179326,30,2,2,1,1
2019,179326,30,3,31,16,15
2019,179326,40,0,48,10,38
2019,179326,40,3,1,0,1
2019,179326,40,4,47,10,37
2019,179326,42,0,6,2,4
2019,179326,42,4,6,2,4
2019,179326,43,0,42,8,34
2019,179326,43,3,1,0,1
2019,179326,43,4,41,8,33
2019,179344,0,0,36,16,20
2019,179344,10,0,36,16,20
2019,179344,10,1,7,5,2
2019,179344,10,2,6,3,3
2019,179344,10,3,19,7,12
2019,179344,10,4,3,1,2
2019,179344,10,5,1,0,1
2019,179344,20,0,27,14,13
2019,179344,20,1,7,5,2
2019,179344,20,2,6,3,3
2019,179344,20,3,13,5,8
2019,179344,20,4,1,1,0
2019,179344,30,0,8,2,6
2019,179344,30,3,6,2,4
2019,179344,30,4,2,0,2
2019,179344,40,0,1,0,1
2019,179344,40,5,1,0,1
2019,179344,42,0,1,0,1
2019,179344,42,5,1,0,1
2019,179450,0,0,26,3,23
2019,179450,10,0,26,3,23
2019,179450,10,2,6,0,6
2019,179450,10,3,20,3,17
2019,179450,40,0,26,3,23
2019,179450,40,2,6,0,6
2019,179450,40,3,20,3,17
2019,179450,41,0,2,0,2
2019,179450,41,2,1,0,1
2019,179450,41,3,1,0,1
2019,179450,42,0,24,3,21
2019,179450,42,2,5,0,5
2019,179450,42,3,19,3,16
2019,179450,45,0,2,0,2
2019,179450,45,2,1,0,1
2019,179450,45,3,1,0,1
2019,179511,0,0,6,1,5
2019,179511,10,0,6,1,5
2019,179511,10,4,6,1,5
2019,179511,40,0,6,1,5
2019,179511,40,4,6,1,5
2019,179511,41,0,6,1,5
2019,179511,41,4,6,1,5
2019,179511,45,0,6,1,5
2019,179511,45,4,6,1,5
2019,179539,0,0,80,26,54
2019,179539,10,0,80,26,54
2019,179539,10,4,80,26,54
2019,179539,40,0,80,26,54
2019,179539,40,4,80,26,54
2019,179539,42,0,80,26,54
2019,179539,42,4,80,26,54
2019,179548,0,0,41,14,27
2019,179548,10,0,41,14,27
2019,179548,10,1,4,1,3
2019,179548,10,2,9,6,3
2019,179548,10,3,23,3,20
2019,179548,10,4,5,4,1
2019,179548,20,0,9,4,5
2019,179548,20,1,4,1,3
2019,179548,20,2,5,3,2
2019,179548,30,0,12,2,10
2019,179548,30,2,2,1,1
2019,179548,30,3,10,1,9
2019,179548,40,0,20,8,12
2019,179548,40,2,2,2,0
2019,179548,40,3,13,2,11
2019,179548,40,4,5,4,1
2019,179548,42,0,4,0,4
2019,179548,42,3,4,0,4
2019,179548,43,0,16,8,8
2019,179548,43,2,2,2,0
2019,179548,43,3,9,2,7
2019,179548,43,4,5,4,1
2019,179557,0,0,385,180,205
2019,179557,10,0,382,179,203
2019,179557,10,1,104,60,44
2019,179557,10,2,73,34,39
2019,179557,10,3,80,36,44
2019,179557,10,4,124,48,76
2019,179557,10,5,1,1,0
2019,179557,20,0,177,94,83
2019,179557,20,1,104,60,44
2019,179557,20,2,73,34,39
2019,179557,30,0,80,36,44
2019,179557,30,3,80,36,44
2019,179557,40,0,125,49,76
2019,179557,40,4,124,48,76
2019,179557,40,5,1,1,0
2019,179557,41,0,113,43,70
2019,179557,41,4,113,43,70
2019,179557,42,0,12,6,6
2019,179557,42,4,11,5,6
2019,179557,42,5,1,1,0
2019,179557,44,0,113,43,70
2019,179557,44,4,113,43,70
2019,179557,50,0,3,1,2
2019,179566,0,0,765,385,380
2019,179566,10,0,765,385,380
2019,179566,10,1,233,152,81
2019,179566,10,2,142,80,62
2019,179566,10,3,232,100,132
2019,179566,10,4,150,49,101
2019,179566,10,6,8,4,4
2019,179566,20,0,371,229,142
2019,179566,20,1,230,152,78
2019,179566,20,2,133,75,58
2019,179566,20,3,7,2,5
2019,179566,20,4,1,0,1
2019,179566,30,0,195,93,102
2019,179566,30,2,2,2,0
2019,179566,30,3,193,91,102
2019,179566,40,0,199,63,136
2019,179566,40,1,3,0,3
2019,179566,40,2,7,3,4
2019,179566,40,3,32,7,25
2019,179566,40,4,149,49,100
2019,179566,40,6,8,4,4
2019,179566,42,0,199,63,136
2019,179566,42,1,3,0,3
2019,179566,42,2,7,3,4
2019,179566,42,3,32,7,25
2019,179566,42,4,149,49,100
2019,179566,42,6,8,4,4
2019,179645,0,0,65,26,39
2019,179645,10,0,65,26,39
2019,179645,10,1,10,7,3
2019,179645,10,2,11,5,6
2019,179645,10,3,11,4,7
2019,179645,10,4,29,6,23
2019,179645,10,6,4,4,0
2019,179645,20,0,14,8,6
2019,179645,20,1,8,5,3
2019,179645,20,2,6,3,3
2019,179645,30,0,1,0,1
2019,179645,30,3,1,0,1
2019,179645,40,0,50,18,32
2019,179645,40,1,2,2,0
2019,179645,40,2,5,2,3
2019,179645,40,3,10,4,6
2019,179645,40,4,29,6,23
2019,179645,40,6,4,4,0
2019,179645,42,0,50,18,32
2019,179645,42,1,2,2,0
2019,179645,42,2,5,2,3
2019,179645,42,3,10,4,6
2019,179645,42,4,29,6,23
2019,179645,42,6,4,4,0
2019,179715,0,0,38,10,28
2019,179715,10,0,38,10,28
2019,179715,10,6,38,10,28
2019,179715,20,0,23,6,17
2019,179715,20,6,23,6,17
2019,179715,30,0,15,4,11
2019,179715,30,6,15,4,11
2019,179812,0,0,54,30,24
2019,179812,10,0,50,29,21
2019,179812,10,1,8,6,2
2019,179812,10,2,16,11,5
2019,179812,10,3,26,12,14
2019,179812,40,0,50,29,21
2019,179812,40,1,8,6,2
2019,179812,40,2,16,11,5
2019,179812,40,3,26,12,14
2019,179812,41,0,50,29,21
2019,179812,41,1,8,6,2
2019,179812,41,2,16,11,5
2019,179812,41,3,26,12,14
2019,179812,44,0,50,29,21
2019,179812,44,1,8,6,2
2019,179812,44,2,16,11,5
2019,179812,44,3,26,12,14
2019,179812,50,0,4,1,3
2019,179867,0,0,1683,1117,566
2019,179867,10,0,1683,1117,566
2019,179867,10,1,674,534,140
2019,179867,10,2,311,205,106
2019,179867,10,3,358,205,153
2019,179867,10,4,123,71,52
2019,179867,10,5,209,98,111
2019,179867,10,6,8,4,4
2019,179867,20,0,960,722,238
2019,179867,20,1,666,527,139
2019,179867,20,2,294,195,99
2019,179867,30,0,378,217,161
2019,179867,30,1,7,6,1
2019,179867,30,2,16,9,7
2019,179867,30,3,355,202,153
2019,179867,40,0,345,178,167
2019,179867,40,1,1,1,0
2019,179867,40,2,1,1,0
2019,179867,40,3,3,3,0
2019,179867,40,4,123,71,52
2019,179867,40,5,209,98,111
2019,179867,40,6,8,4,4
2019,179867,42,0,333,169,164
2019,179867,42,1,1,1,0
2019,179867,42,2,1,1,0
2019,179867,42,3,3,3,0
2019,179867,42,4,119,68,51
2019,179867,42,5,203,93,110
2019,179867,42,6,6,3,3
2019,179867,43,0,12,9,3
2019,179867,43,4,4,3,1
2019,179867,43,5,6,5,1
2019,179867,43,6,2,1,1
2019,179894,0,0,197,107,90
2019,179894,10,0,194,106,88
2019,179894,10,1,77,45,32
2019,179894,10,2,69,36,33
2019,179894,10,3,40,24,16
2019,179894,10,4,7,1,6
2019,179894,10,5,1,0,1
2019,179894,20,0,145,81,64
2019,179894,20,1,77,45,32
2019,179894,20,2,66,34,32
2019,179894,20,3,2,2,0
2019,179894,30,0,33,20,13
2019,179894,30,2,3,2,1
2019,179894,30,3,30,18,12
2019,179894,40,0,16,5,11
2019,179894,40,3,8,4,4
2019,179894,40,4,7,1,6
2019,179894,40,5,1,0,1
2019,179894,42,0,16,5,11
2019,179894,42,3,8,4,4
2019,179894,42,4,7,1,6
2019,179894,42,5,1,0,1
2019,179894,50,0,3,1,2
2019,179946,0,0,52,28,24
2019,179946,10,0,46,27,19
2019,179946,10,1,16,11,5
2019,179946,10,2,17,9,8
2019,179946,10,3,10,5,5
2019,179946,10,4,3,2,1
2019,179946,20,0,33,20,13
2019,179946,20,1,16,11,5
2019,179946,20,2,17,9,8
2019,179946,30,0,9,5,4
2019,179946,30,3,9,5,4
2019,179946,40,0,4,2,2
2019,179946,40,3,1,0,1
2019,179946,40,4,3,2,1
2019,179946,42,0,3,2,1
2019,179946,42,4,3,2,1
2019,179946,43,0,1,0,1
2019,179946,43,3,1,0,1
2019,179946,50,0,6,1,5
2019,179955,0,0,70,38,32
2019,179955,10,0,70,38,32
2019,179955,10,1,27,14,13
2019,179955,10,2,19,12,7
2019,179955,10,3,20,11,9
2019,179955,10,4,4,1,3
2019,179955,20,0,42,23,19
2019,179955,20,1,27,14,13
2019,179955,20,2,14,8,6
2019,179955,20,3,1,1,0
2019,179955,30,0,18,12,6
2019,179955,30,2,5,4,1
2019,179955,30,3,13,8,5
2019,179955,40,0,10,3,7
2019,179955,40,3,6,2,4
2019,179955,40,4,4,1,3
2019,179955,41,0,7,2,5
2019,179955,41,3,6,2,4
2019,179955,41,4,1,0,1
2019,179955,42,0,3,1,2
2019,179955,42,4,3,1,2
2019,179955,44,0,7,2,5
2019,179955,44,3,6,2,4
2019,179955,44,4,1,0,1
2019,179964,0,0,64,28,36
2019,179964,10,0,64,28,36
2019,179964,10,1,8,2,6
2019,179964,10,2,17,11,6
2019,179964,10,3,32,12,20
2019,179964,10,4,7,3,4
2019,179964,20,0,8,3,5
2019,179964,20,1,6,1,5
2019,179964,20,2,2,2,0
2019,179964,30,0,56,25,31
2019,179964,30,1,2,1,1
2019,179964,30,2,15,9,6
2019,179964,30,3,32,12,20
2019,179964,30,4,7,3,4
2019,180054,0,0,49,19,30
2019,180054,10,0,49,19,30
2019,180054,10,4,49,19,30
2019,180054,40,0,49,19,30
2019,180054,40,4,49,19,30
2019,180054,42,0,28,10,18
2019,180054,42,4,28,10,18
2019,180054,43,0,21,9,12
2019,180054,43,4,21,9,12
2019,180106,0,0,82,39,43
2019,180106,10,0,82,39,43
2019,180106,10,1,20,14,6
2019,180106,10,2,37,18,19
2019,180106,10,3,18,5,13
2019,180106,10,4,7,2,5
2019,180106,20,0,45,25,20
2019,180106,20,1,19,13,6
2019,180106,20,2,24,11,13
2019,180106,20,3,2,1,1
2019,180106,30,0,29,11,18
2019,180106,30,2,13,7,6
2019,180106,30,3,16,4,12
2019,180106,40,0,8,3,5
2019,180106,40,1,1,1,0
2019,180106,40,4,7,2,5
2019,180106,42,0,8,3,5
2019,180106,42,1,1,1,0
2019,180106,42,4,7,2,5
2019,180151,0,0,11,5,6
2019,180151,10,0,11,5,6
2019,180151,10,4,11,5,6
2019,180151,20,0,3,2,1
2019,180151,20,4,3,2,1
2019,180151,30,0,8,3,5
2019,180151,30,4,8,3,5
2019,180160,0,0,13,10,3
2019,180160,10,0,12,9,3
2019,180160,10,4,12,9,3
2019,180160,40,0,12,9,3
2019,180160,40,4,12,9,3
2019,180160,42,0,12,9,3
2019,180160,42,4,12,9,3
2019,180160,50,0,1,1,0
2019,180179,0,0,156,83,73
2019,180179,10,0,156,83,73
2019,180179,10,1,31,17,14
2019,180179,10,2,27,18,9
2019,180179,10,3,48,21,27
2019,180179,10,4,8,5,3
2019,180179,10,5,42,22,20
2019,180179,20,0,66,40,26
2019,180179,20,1,30,16,14
2019,180179,20,2,27,18,9
2019,180179,20,3,2,1,1
2019,180179,20,5,7,5,2
2019,180179,30,0,52,27,25
2019,180179,30,3,36,15,21
2019,180179,30,4,2,2,0
2019,180179,30,5,14,10,4
2019,180179,40,0,38,16,22
2019,180179,40,1,1,1,0
2019,180179,40,3,10,5,5
2019,180179,40,4,6,3,3
2019,180179,40,5,21,7,14
2019,180179,42,0,38,16,22
2019,180179,42,1,1,1,0
2019,180179,42,3,10,5,5
2019,180179,42,4,6,3,3
2019,180179,42,5,21,7,14
2019,180197,0,0,65,35,30
2019,180197,10,0,49,23,26
2019,180197,10,1,12,5,7
2019,180197,10,2,28,14,14
2019,180197,10,3,9,4,5
2019,180197,20,0,38,19,19
2019,180197,20,1,12,5,7
2019,180197,20,2,26,14,12
2019,180197,30,0,10,3,7
2019,180197,30,2,2,0,2
2019,180197,30,3,8,3,5
2019,180197,40,0,1,1,0
2019,180197,40,3,1,1,0
2019,180197,42,0,1,1,0
2019,180197,42,3,1,1,0
2019,180197,50,0,16,12,4
2019,180203,0,0,13,7,6
2019,180203,10,0,13,7,6
2019,180203,10,4,13,7,6
2019,180203,40,0,13,7,6
2019,180203,40,4,13,7,6
2019,180203,42,0,6,4,2
2019,180203,42,4,6,4,2
2019,180203,43,0,7,3,4
2019,180203,43,4,7,3,4
2019,180212,0,0,20,12,8
2019,180212,10,0,20,12,8
2019,180212,10,4,20,12,8
2019,180212,40,0,20,12,8
2019,180212,40,4,20,12,8
2019,180212,42,0,20,12,8
2019,180212,42,4,20,12,8
2019,180249,0,0,39,19,20
2019,180249,10,0,39,19,20
2019,180249,10,4,39,19,20
2019,180249,20,0,21,9,12
2019,180249,20,4,21,9,12
2019,180249,30,0,12,5,7
2019,180249,30,4,12,5,7
2019,180249,40,0,6,5,1
2019,180249,40,4,6,5,1
2019,180249,42,0,6,5,1
2019,180249,42,4,6,5,1
2019,180258,0,0,53,23,30
2019,180258,10,0,53,23,30
2019,180258,10,1,12,6,6
2019,180258,10,2,13,4,9
2019,180258,10,3,14,8,6
2019,180258,10,4,8,2,6
2019,180258,10,5,2,0,2
2019,180258,10,6,4,3,1
2019,180258,20,0,17,9,8
2019,180258,20,1,11,6,5
2019,180258,20,2,4,2,2
2019,180258,20,6,2,1,1
2019,180258,30,0,19,12,7
2019,180258,30,2,5,2,3
2019,180258,30,3,12,8,4
2019,180258,30,6,2,2,0
2019,180258,40,0,17,2,15
2019,180258,40,1,1,0,1
2019,180258,40,2,4,0,4
2019,180258,40,3,2,0,2
2019,180258,40,4,8,2,6
2019,180258,40,5,2,0,2
2019,180258,42,0,17,2,15
2019,180258,42,1,1,0,1
2019,180258,42,2,4,0,4
2019,180258,42,3,2,0,2
2019,180258,42,4,8,2,6
2019,180258,42,5,2,0,2
2019,180276,0,0,31,19,12
2019,180276,10,0,31,19,12
2019,180276,10,4,31,19,12
2019,180276,20,0,15,10,5
2019,180276,20,4,15,10,5
2019,180276,30,0,13,6,7
2019,180276,30,4,13,6,7
2019,180276,40,0,3,3,0
2019,180276,40,4,3,3,0
2019,180276,42,0,3,3,0
2019,180276,42,4,3,3,0
2019,180328,0,0,13,3,10
2019,180328,10,0,13,3,10
2019,180328,10,4,13,3,10
2019,180328,40,0,13,3,10
2019,180328,40,4,13,3,10
2019,180328,42,0,13,3,10
2019,180328,42,4,13,3,10
2019,180373,0,0,22,11,11
2019,180373,10,0,22,11,11
2019,180373,10,4,22,11,11
2019,180373,40,0,22,11,11
2019,180373,40,4,22,11,11
2019,180373,42,0,22,11,11
2019,180373,42,4,22,11,11
2019,180416,0,0,136,85,51
2019,180416,10,0,136,85,51
2019,180416,10,1,37,26,11
2019,180416,10,2,30,19,11
2019,180416,10,3,36,22,14
2019,180416,10,4,33,18,15
2019,180416,20,0,63,36,27
2019,180416,20,1,36,25,11
2019,180416,20,2,13,5,8
2019,180416,20,3,1,1,0
2019,180416,20,4,13,5,8
2019,180416,30,0,58,39,19
2019,180416,30,1,1,1,0
2019,180416,30,2,17,14,3
2019,180416,30,3,30,18,12
2019,180416,30,4,10,6,4
2019,180416,40,0,15,10,5
2019,180416,40,3,5,3,2
2019,180416,40,4,10,7,3
2019,180416,42,0,15,10,5
2019,180416,42,3,5,3,2
2019,180416,42,4,10,7,3
2019,180461,0,0,751,385,366
2019,180461,10,0,751,385,366
2019,180461,10,1,205,153,52
2019,180461,10,2,186,95,91
2019,180461,10,3,176,73,103
2019,180461,10,4,43,17,26
2019,180461,10,6,141,47,94
2019,180461,20,0,385,246,139
2019,180461,20,1,200,148,52
2019,180461,20,2,180,95,85
2019,180461,20,4,5,3,2
2019,180461,30,0,198,83,115
2019,180461,30,1,5,5,0
2019,180461,30,2,6,0,6
2019,180461,30,3,176,73,103
2019,180461,30,4,11,5,6
2019,180461,40,0,168,56,112
2019,180461,40,4,27,9,18
2019,180461,40,6,141,47,94
2019,180461,42,0,65,17,48
2019,180461,42,4,9,4,5
2019,180461,42,6,56,13,43
2019,180461,43,0,103,39,64
2019,180461,43,4,18,5,13
2019,180461,43,6,85,34,51
2019,180489,0,0,469,274,195
2019,180489,10,0,469,274,195
2019,180489,10,1,225,143,82
2019,180489,10,2,123,73,50
2019,180489,10,3,85,38,47
2019,180489,10,4,28,17,11
2019,180489,10,5,8,3,5
2019,180489,20,0,327,207,120
2019,180489,20,1,222,142,80
2019,180489,20,2,105,65,40
2019,180489,30,0,75,35,40
2019,180489,30,1,1,1,0
2019,180489,30,2,15,6,9
2019,180489,30,3,57,26,31
2019,180489,30,4,2,2,0
2019,180489,40,0,67,32,35
2019,180489,40,1,2,0,2
2019,180489,40,2,3,2,1
2019,180489,40,3,28,12,16
2019,180489,40,4,26,15,11
2019,180489,40,5,8,3,5
2019,180489,42,0,63,30,33
2019,180489,42,1,2,0,2
2019,180489,42,2,3,2,1
2019,180489,42,3,27,11,16
2019,180489,42,4,23,14,9
2019,180489,42,5,8,3,5
2019,180489,43,0,4,2,2
2019,180489,43,3,1,1,0
2019,180489,43,4,3,1,2
2019,180522,0,0,51,36,15
2019,180522,10,0,51,36,15
2019,180522,10,1,16,14,2
2019,180522,10,2,6,5,1
2019,180522,10,3,26,14,12
2019,180522,10,4,3,3,0
2019,180522,20,0,20,18,2
2019,180522,20,1,16,14,2
2019,180522,20,2,2,2,0
2019,180522,20,3,2,2,0
2019,180522,30,0,24,14,10
2019,180522,30,2,3,2,1
2019,180522,30,3,21,12,9
2019,180522,40,0,7,4,3
2019,180522,40,2,1,1,0
2019,180522,40,3,3,0,3
2019,180522,40,4,3,3,0
2019,180522,42,0,7,4,3
2019,180522,42,2,1,1,0
2019,180522,42,3,3,0,3
2019,180522,42,4,3,3,0
2019,180595,0,0,67,32,35
2019,180595,10,0,67,32,35
2019,180595,10,1,26,18,8
2019,180595,10,2,15,4,11
2019,180595,10,3,22,8,14
2019,180595,10,4,4,2,2
2019,180595,20,0,40,22,18
2019,180595,20,1,26,18,8
2019,180595,20,2,14,4,10
2019,180595,30,0,14,5,9
2019,180595,30,3,14,5,9
2019,180595,40,0,13,5,8
2019,180595,40,2,1,0,1
2019,180595,40,3,8,3,5
2019,180595,40,4,4,2,2
2019,180595,42,0,13,5,8
2019,180595,42,2,1,0,1
2019,180595,42,3,8,3,5
2019,180595,42,4,4,2,2
2019,180647,0,0,69,28,41
2019,180647,10,0,69,28,41
2019,180647,10,4,69,28,41
2019,180647,40,0,69,28,41
2019,180647,40,4,69,28,41
2019,180647,41,0,69,28,41
2019,180647,41,4,69,28,41
2019,180647,44,0,69,28,41
2019,180647,44,4,69,28,41
2019,180692,0,0,66,34,32
2019,180692,10,0,66,34,32
2019,180692,10,1,28,19,9
2019,180692,10,2,13,6,7
2019,180692,10,3,11,5,6
2019,180692,10,4,14,4,10
2019,180692,20,0,36,23,13
2019,180692,20,1,28,19,9
2019,180692,20,2,8,4,4
2019,180692,30,0,16,7,9
2019,180692,30,2,5,2,3
2019,180692,30,3,10,4,6
2019,180692,30,4,1,1,0
2019,180692,40,0,14,4,10
2019,180692,40,3,1,1,0
2019,180692,40,4,13,3,10
2019,180692,42,0,14,4,10
2019,180692,42,3,1,1,0
2019,180692,42,4,13,3,10
2019,180814,0,0,85,44,41
2019,180814,10,0,85,44,41
2019,180814,10,1,17,11,6
2019,180814,10,2,30,13,17
2019,180814,10,3,30,16,14
2019,180814,10,4,8,4,4
2019,180814,40,0,85,44,41
2019,180814,40,1,17,11,6
2019,180814,40,2,30,13,17
2019,180814,40,3,30,16,14
2019,180814,40,4,8,4,4
2019,180814,42,0,85,44,41
2019,180814,42,1,17,11,6
2019,180814,42,2,30,13,17
2019,180814,42,3,30,16,14
2019,180814,42,4,8,4,4
2019,180832,0,0,61,6,55
2019,180832,10,0,61,6,55
2019,180832,10,1,3,0,3
2019,180832,10,2,18,1,17
2019,180832,10,3,21,4,17
2019,180832,10,4,19,1,18
2019,180832,40,0,61,6,55
2019,180832,40,1,3,0,3
2019,180832,40,2,18,1,17
2019,180832,40,3,21,4,17
2019,180832,40,4,19,1,18
2019,180832,42,0,61,6,55
2019,180832,42,1,3,0,3
2019,180832,42,2,18,1,17
2019,180832,42,3,21,4,17
2019,180832,42,4,19,1,18
2019,180878,0,0,41,7,34
2019,180878,10,0,41,7,34
2019,180878,10,1,4,1,3
2019,180878,10,2,13,4,9
2019,180878,10,3,23,2,21
2019,180878,10,4,1,0,1
2019,180878,40,0,41,7,34
2019,180878,40,1,4,1,3
2019,180878,40,2,13,4,9
2019,180878,40,3,23,2,21
2019,180878,40,4,1,0,1
2019,180878,42,0,41,7,34
2019,180878,42,1,4,1,3
2019,180878,42,2,13,4,9
2019,180878,42,3,23,2,21
2019,180878,42,4,1,0,1
2019,180902,0,0,167,80,87
2019,180902,10,0,167,80,87
2019,180902,10,6,167,80,87
2019,180902,40,0,167,80,87
2019,180902,40,6,167,80,87
2019,180902,42,0,167,80,87
2019,180902,42,6,167,80,87
2019,180948,0,0,88,49,39
2019,180948,10,0,88,49,39
2019,180948,10,1,41,21,20
2019,180948,10,2,15,11,4
2019,180948,10,3,25,13,12
2019,180948,10,4,5,2,3
2019,180948,10,5,2,2,0
2019,180948,20,0,44,25,19
2019,180948,20,1,38,21,17
2019,180948,20,2,6,4,2
2019,180948,30,0,32,16,16
2019,180948,30,2,8,6,2
2019,180948,30,3,22,10,12
2019,180948,30,4,2,0,2
2019,180948,40,0,12,8,4
2019,180948,40,1,3,0,3
2019,180948,40,2,1,1,0
2019,180948,40,3,3,3,0
2019,180948,40,4,3,2,1
2019,180948,40,5,2,2,0
2019,180948,42,0,12,8,4
2019,180948,42,1,3,0,3
2019,180948,42,2,1,1,0
2019,180948,42,3,3,3,0
2019,180948,42,4,3,2,1
2019,180948,42,5,2,2,0
2019,180984,0,0,63,41,22
2019,180984,10,0,63,41,22
2019,180984,10,1,25,20,5
2019,180984,10,2,13,7,6
2019,180984,10,3,24,14,10
2019,180984,10,4,1,0,1
2019,180984,40,0,63,41,22
2019,180984,40,1,25,20,5
2019,180984,40,2,13,7,6
2019,180984,40,3,24,14,10
2019,180984,40,4,1,0,1
2019,180984,41,0,62,41,21
2019,180984,41,1,25,20,5
2019,180984,41,2,13,7,6
2019,180984,41,3,24,14,10
2019,180984,43,0,1,0,1
2019,180984,43,4,1,0,1
2019,180984,44,0,30,19,11
2019,180984,44,1,1,1,0
2019,180984,44,2,5,4,1
2019,180984,44,3,24,14,10
2019,180984,45,0,32,22,10
2019,180984,45,1,24,19,5
2019,180984,45,2,8,3,5
2019,181002,0,0,669,354,315
2019,181002,10,0,669,354,315
2019,181002,10,1,179,123,56
2019,181002,10,2,187,101,86
2019,181002,10,3,250,114,136
2019,181002,10,4,53,16,37
2019,181002,20,0,332,211,121
2019,181002,20,1,171,118,53
2019,181002,20,2,140,80,60
2019,181002,20,3,21,13,8
2019,181002,30,0,135,66,69
2019,181002,30,1,4,2,2
2019,181002,30,2,17,9,8
2019,181002,30,3,113,54,59
2019,181002,30,4,1,1,0
2019,181002,40,0,202,77,125
2019,181002,40,1,4,3,1
2019,181002,40,2,30,12,18
2019,181002,40,3,116,47,69
2019,181002,40,4,52,15,37
2019,181002,42,0,202,77,125
2019,181002,42,1,4,3,1
2019,181002,42,2,30,12,18
2019,181002,42,3,116,47,69
2019,181002,42,4,52,15,37
2019,181020,0,0,101,48,53
2019,181020,10,0,101,48,53
2019,181020,10,1,28,19,9
2019,181020,10,2,31,14,17
2019,181020,10,3,40,15,25
2019,181020,10,4,1,0,1
2019,181020,10,5,1,0,1
2019,181020,20,0,41,26,15
2019,181020,20,1,26,18,8
2019,181020,20,2,15,8,7
2019,181020,30,0,25,10,15
2019,181020,30,1,1,0,1
2019,181020,30,2,5,2,3
2019,181020,30,3,19,8,11
2019,181020,40,0,35,12,23
2019,181020,40,1,1,1,0
2019,181020,40,2,11,4,7
2019,181020,40,3,21,7,14
2019,181020,40,4,1,0,1
2019,181020,40,5,1,0,1
2019,181020,42,0,35,12,23
2019,181020,42,1,1,1,0
2019,181020,42,2,11,4,7
2019,181020,42,3,21,7,14
2019,181020,42,4,1,0,1
2019,181020,42,5,1,0,1
2019,181127,0,0,69,41,28
2019,181127,10,0,69,41,28
2019,181127,10,1,26,16,10
2019,181127,10,2,10,6,4
2019,181127,10,3,24,12,12
2019,181127,10,4,9,7,2
2019,181127,20,0,35,21,14
2019,181127,20,1,26,16,10
2019,181127,20,2,9,5,4
2019,181127,30,0,21,11,10
2019,181127,30,2,1,1,0
2019,181127,30,3,20,10,10
2019,181127,40,0,13,9,4
2019,181127,40,3,4,2,2
2019,181127,40,4,9,7,2
2019,181127,42,0,13,9,4
2019,181127,42,3,4,2,2
2019,181127,42,4,9,7,2
2019,181215,0,0,328,173,155
2019,181215,10,0,328,173,155
2019,181215,10,1,98,58,40
2019,181215,10,2,89,47,42
2019,181215,10,3,76,45,31
2019,181215,10,4,1,0,1
2019,181215,10,5,64,23,41
2019,181215,20,0,170,94,76
2019,181215,20,1,98,58,40
2019,181215,20,2,70,35,35
2019,181215,20,3,2,1,1
2019,181215,30,0,86,52,34
2019,181215,30,2,19,12,7
2019,181215,30,3,67,40,27
2019,181215,40,0,72,27,45
2019,181215,40,3,7,4,3
2019,181215,40,4,1,0,1
2019,181215,40,5,64,23,41
2019,181215,42,0,72,27,45
2019,181215,42,3,7,4,3
2019,181215,42,4,1,0,1
2019,181215,42,5,64,23,41
2019,181297,0,0,66,1,65
2019,181297,10,0,66,1,65
2019,181297,10,1,11,1,10
2019,181297,10,2,13,0,13
2019,181297,10,3,38,0,38
2019,181297,10,4,4,0,4
2019,181297,40,0,66,1,65
2019,181297,40,1,11,1,10
2019,181297,40,2,13,0,13
2019,181297,40,3,38,0,38
2019,181297,40,4,4,0,4
2019,181297,42,0,66,1,65
2019,181297,42,1,11,1,10
2019,181297,42,2,13,0,13
2019,181297,42,3,38,0,38
2019,181297,42,4,4,0,4
2019,181303,0,0,249,120,129
2019,181303,10,0,249,120,129
2019,181303,10,4,249,120,129
2019,181303,40,0,249,120,129
2019,181303,40,4,249,120,129
2019,181303,42,0,86,58,28
2019,181303,42,4,86,58,28
2019,181303,43,0,163,62,101
2019,181303,43,4,163,62,101
2019,181312,0,0,66,28,38
2019,181312,10,0,66,28,38
2019,181312,10,4,66,28,38
2019,181312,40,0,66,28,38
2019,181312,40,4,66,28,38
2019,181312,42,0,66,28,38
2019,181312,42,4,66,28,38
2019,181330,0,0,36,15,21
2019,181330,10,0,36,15,21
2019,181330,10,1,12,6,6
2019,181330,10,2,14,5,9
2019,181330,10,3,10,4,6
2019,181330,20,0,14,7,7
2019,181330,20,1,11,6,5
2019,181330,20,2,3,1,2
2019,181330,30,0,22,8,14
2019,181330,30,1,1,0,1
2019,181330,30,2,11,4,7
2019,181330,30,3,10,4,6
2019,181376,0,0,6,5,1
2019,181376,10,0,6,5,1
2019,181376,10,1,1,1,0
2019,181376,10,2,3,3,0
2019,181376,10,3,2,1,1
2019,181376,40,0,6,5,1
2019,181376,40,1,1,1,0
2019,181376,40,2,3,3,0
2019,181376,40,3,2,1,1
2019,181376,42,0,6,5,1
2019,181376,42,1,1,1,0
2019,181376,42,2,3,3,0
2019,181376,42,3,2,1,1
2019,181394,0,0,532,276,256
2019,181394,10,0,532,276,256
2019,181394,10,1,119,79,40
2019,181394,10,2,150,72,78
2019,181394,10,3,128,63,65
2019,181394,10,4,97,45,52
2019,181394,10,5,36,15,21
2019,181394,10,6,2,2,0
2019,181394,20,0,268,149,119
2019,181394,20,1,119,79,40
2019,181394,20,2,148,70,78
2019,181394,20,3,1,0,1
2019,181394,30,0,126,64,62
2019,181394,30,2,1,1,0
2019,181394,30,3,125,63,62
2019,181394,40,0,138,63,75
2019,181394,40,2,1,1,0
2019,181394,40,3,2,0,2
2019,181394,40,4,97,45,52
2019,181394,40,5,36,15,21
2019,181394,40,6,2,2,0
2019,181394,42,0,138,63,75
2019,181394,42,2,1,1,0
2019,181394,42,3,2,0,2
2019,181394,42,4,97,45,52
2019,181394,42,5,36,15,21
2019,181394,42,6,2,2,0
2019,181419,0,0,15,8,7
2019,181419,10,0,12,8,4
2019,181419,10,4,12,8,4
2019,181419,40,0,12,8,4
2019,181419,40,4,12,8,4
2019,181419,41,0,2,0,2
2019,181419,41,4,2,0,2
2019,181419,42,0,10,8,2
2019,181419,42,4,10,8,2
2019,181419,45,0,2,0,2
2019,181419,45,4,2,0,2
2019,181419,50,0,3,0,3
2019,181428,0,0,515,195,320
2019,181428,10,0,507,193,314
2019,181428,10,1,88,59,29
2019,181428,10,2,141,65,76
2019,181428,10,3,201,59,142
2019,181428,10,4,77,10,67
2019,181428,20,0,96,57,39
2019,181428,20,1,64,44,20
2019,181428,20,2,32,13,19
2019,181428,30,0,200,97,103
2019,181428,30,1,18,12,6
2019,181428,30,2,84,44,40
2019,181428,30,3,98,41,57
2019,181428,40,0,211,39,172
2019,181428,40,1,6,3,3
2019,181428,40,2,25,8,17
2019,181428,40,3,103,18,85
2019,181428,40,4,77,10,67
2019,181428,42,0,210,39,171
2019,181428,42,1,6,3,3
2019,181428,42,2,25,8,17
2019,181428,42,3,102,18,84
2019,181428,42,4,77,10,67
2019,181428,43,0,1,0,1
2019,181428,43,3,1,0,1
2019,181428,50,0,8,2,6
2019,181446,0,0,114,46,68
2019,181446,10,0,114,46,68
2019,181446,10,1,42,17,25
2019,181446,10,2,27,13,14
2019,181446,10,3,32,11,21
2019,181446,10,4,13,5,8
2019,181446,20,0,65,29,36
2019,181446,20,1,42,17,25
2019,181446,20,2,23,12,11
2019,181446,30,0,30,10,20
2019,181446,30,2,2,0,2
2019,181446,30,3,27,10,17
2019,181446,30,4,1,0,1
2019,181446,40,0,19,7,12
2019,181446,40,2,2,1,1
2019,181446,40,3,5,1,4
2019,181446,40,4,12,5,7
2019,181446,41,0,14,5,9
2019,181446,41,2,2,1,1
2019,181446,41,3,5,1,4
2019,181446,41,4,7,3,4
2019,181446,42,0,5,2,3
2019,181446,42,4,5,2,3
2019,181446,44,0,14,5,9
2019,181446,44,2,2,1,1
2019,181446,44,3,5,1,4
2019,181446,44,4,7,3,4
2019,181464,0,0,1341,842,499
2019,181464,10,0,1341,842,499
2019,181464,10,1,446,348,98
2019,181464,10,2,339,215,124
2019,181464,10,3,275,162,113
2019,181464,10,5,275,112,163
2019,181464,10,6,6,5,1
2019,181464,20,0,773,553,220
2019,181464,20,1,444,347,97
2019,181464,20,2,329,206,123
2019,181464,30,0,286,171,115
2019,181464,30,1,1,0,1
2019,181464,30,2,10,9,1
2019,181464,30,3,275,162,113
2019,181464,40,0,282,118,164
2019,181464,40,1,1,1,0
2019,181464,40,5,275,112,163
2019,181464,40,6,6,5,1
2019,181464,41,0,181,77,104
2019,181464,41,1,1,1,0
2019,181464,41,5,180,76,104
2019,181464,42,0,101,41,60
2019,181464,42,5,95,36,59
2019,181464,42,6,6,5,1
2019,181464,44,0,180,76,104
2019,181464,44,5,180,76,104
2019,181464,45,0,1,1,0
2019,181464,45,1,1,1,0
2019,181491,0,0,129,74,55
2019,181491,10,0,124,69,55
2019,181491,10,4,124,69,55
2019,181491,40,0,124,69,55
2019,181491,40,4,124,69,55
2019,181491,42,0,124,69,55
2019,181491,42,4,124,69,55
2019,181491,50,0,5,5,0
2019,181534,0,0,52,25,27
2019,181534,10,0,52,25,27
2019,181534,10,1,11,6,5
2019,181534,10,2,8,4,4
2019,181534,10,3,22,10,12
2019,181534,10,4,11,5,6
2019,181534,20,0,15,8,7
2019,181534,20,1,11,6,5
2019,181534,20,2,4,2,2
2019,181534,30,0,20,8,12
2019,181534,30,2,3,1,2
2019,181534,30,3,17,7,10
2019,181534,40,0,17,9,8
2019,181534,40,2,1,1,0
2019,181534,40,3,5,3,2
2019,181534,40,4,11,5,6
2019,181534,41,0,17,9,8
2019,181534,41,2,1,1,0
2019,181534,41,3,5,3,2
2019,181534,41,4,11,5,6
2019,181534,44,0,17,9,8
2019,181534,44,2,1,1,0
2019,181534,44,3,5,3,2
2019,181534,44,4,11,5,6
2019,181604,0,0,73,7,66
2019,181604,10,0,73,7,66
2019,181604,10,1,12,3,9
2019,181604,10,2,17,2,15
2019,181604,10,3,27,2,25
2019,181604,10,4,17,0,17
2019,181604,40,0,73,7,66
2019,181604,40,1,12,3,9
2019,181604,40,2,17,2,15
2019,181604,40,3,27,2,25
2019,181604,40,4,17,0,17
2019,181604,41,0,22,3,19
2019,181604,41,1,9,1,8
2019,181604,41,2,13,2,11
2019,181604,42,0,51,4,47
2019,181604,42,1,3,2,1
2019,181604,42,2,4,0,4
2019,181604,42,3,27,2,25
2019,181604,42,4,17,0,17
2019,181604,44,0,22,3,19
2019,181604,44,1,9,1,8
2019,181604,44,2,13,2,11
2019,181640,0,0,362,182,180
2019,181640,10,0,362,182,180
2019,181640,10,6,362,182,180
2019,181640,40,0,362,182,180
2019,181640,40,6,362,182,180
2019,181640,42,0,362,182,180
2019,181640,42,6,362,182,180
2019,181738,0,0,61,29,32
2019,181738,10,0,61,29,32
2019,181738,10,1,17,10,7
2019,181738,10,2,14,4,10
2019,181738,10,3,27,14,13
2019,181738,10,4,1,0,1
2019,181738,10,5,2,1,1
2019,181738,20,0,13,7,6
2019,181738,20,1,11,6,5
2019,181738,20,2,2,1,1
2019,181738,30,0,46,21,25
2019,181738,30,1,6,4,2
2019,181738,30,2,12,3,9
2019,181738,30,3,27,14,13
2019,181738,30,4,1,0,1
2019,181738,40,0,2,1,1
2019,181738,40,5,2,1,1
2019,181738,42,0,2,1,1
2019,181738,42,5,2,1,1
2019,181765,0,0,14,7,7
2019,181765,10,0,14,7,7
2019,181765,10,1,1,0,1
2019,181765,10,2,6,4,2
2019,181765,10,3,5,1,4
2019,181765,10,4,1,1,0
2019,181765,10,5,1,1,0
2019,181765,40,0,14,7,7
2019,181765,40,1,1,0,1
2019,181765,40,2,6,4,2
2019,181765,40,3,5,1,4
2019,181765,40,4,1,1,0
2019,181765,40,5,1,1,0
2019,181765,42,0,14,7,7
2019,181765,42,1,1,0,1
2019,181765,42,2,6,4,2
2019,181765,42,3,5,1,4
2019,181765,42,4,1,1,0
2019,181765,42,5,1,1,0
2019,181783,0,0,121,64,57
2019,181783,10,0,121,64,57
2019,181783,10,1,48,31,17
2019,181783,10,2,29,11,18
2019,181783,10,3,31,14,17
2019,181783,10,4,9,6,3
2019,181783,10,5,4,2,2
2019,181783,20,0,66,38,28
2019,181783,20,1,48,31,17
2019,181783,20,2,17,6,11
2019,181783,20,3,1,1,0
2019,181783,30,0,39,18,21
2019,181783,30,2,12,5,7
2019,181783,30,3,27,13,14
2019,181783,40,0,16,8,8
2019,181783,40,3,3,0,3
2019,181783,40,4,9,6,3
2019,181783,40,5,4,2,2
2019,181783,42,0,16,8,8
2019,181783,42,3,3,0,3
2019,181783,42,4,9,6,3
2019,181783,42,5,4,2,2
2019,181817,0,0,63,32,31
2019,181817,10,0,63,32,31
2019,181817,10,6,63,32,31
2019,181817,20,0,48,28,20
2019,181817,20,6,48,28,20
2019,181817,30,0,15,4,11
2019,181817,30,6,15,4,11
2019,181853,0,0,27,17,10
2019,181853,10,0,27,17,10
2019,181853,10,1,6,6,0
2019,181853,10,2,12,8,4
2019,181853,10,3,9,3,6
2019,181853,20,0,12,9,3
2019,181853,20,1,5,5,0
2019,181853,20,2,7,4,3
2019,181853,30,0,3,3,0
2019,181853,30,2,3,3,0
2019,181853,40,0,12,5,7
2019,181853,40,1,1,1,0
2019,181853,40,2,2,1,1
2019,181853,40,3,9,3,6
2019,181853,42,0,12,5,7
2019,181853,42,1,1,1,0
2019,181853,42,2,2,1,1
2019,181853,42,3,9,3,6
2019,181941,0,0,22,16,6
2019,181941,10,0,22,16,6
2019,181941,10,4,22,16,6
2019,181941,40,0,22,16,6
2019,181941,40,4,22,16,6
2019,181941,41,0,22,16,6
2019,181941,41,4,22,16,6
2019,181941,45,0,22,16,6
2019,181941,45,4,22,16,6
2019,182005,0,0,541,282,259
2019,182005,10,0,541,282,259
2019,182005,10,1,369,197,172
2019,182005,10,4,112,60,52
2019,182005,10,5,1,0,1
2019,182005,10,6,59,25,34
2019,182005,20,0,371,198,173
2019,182005,20,1,369,197,172
2019,182005,20,6,2,1,1
2019,182005,30,0,90,44,46
2019,182005,30,4,77,41,36
2019,182005,30,5,1,0,1
2019,182005,30,6,12,3,9
2019,182005,40,0,80,40,40
2019,182005,40,4,35,19,16
2019,182005,40,6,45,21,24
2019,182005,42,0,80,40,40
2019,182005,42,4,35,19,16
2019,182005,42,6,45,21,24
2019,182148,0,0,9,0,9
2019,182148,10,0,9,0,9
2019,182148,10,6,9,0,9
2019,182148,40,0,9,0,9
2019,182148,40,6,9,0,9
2019,182148,41,0,9,0,9
2019,182148,41,6,9,0,9
2019,182148,45,0,9,0,9
2019,182148,45,6,9,0,9
2019,182281,0,0,1154,669,485
2019,182281,10,0,1154,669,485
2019,182281,10,1,289,217,72
2019,182281,10,2,205,118,87
2019,182281,10,3,181,98,83
2019,182281,10,4,2,2,0
2019,182281,10,5,73,31,42
2019,182281,10,6,404,203,201
2019,182281,20,0,482,333,149
2019,182281,20,1,289,217,72
2019,182281,20,2,189,113,76
2019,182281,20,3,4,3,1
2019,182281,30,0,193,100,93
2019,182281,30,2,16,5,11
2019,182281,30,3,177,95,82
2019,182281,40,0,479,236,243
2019,182281,40,4,2,2,0
2019,182281,40,5,73,31,42
2019,182281,40,6,404,203,201
2019,182281,42,0,479,236,243
2019,182281,42,4,2,2,0
2019,182281,42,5,73,31,42
2019,182281,42,6,404,203,201
2019,182290,0,0,945,549,396
2019,182290,10,0,945,549,396
2019,182290,10,1,201,147,54
2019,182290,10,2,191,116,75
2019,182290,10,3,284,171,113
2019,182290,10,4,1,1,0
2019,182290,10,5,166,70,96
2019,182290,10,6,102,44,58
2019,182290,20,0,380,252,128
2019,182290,20,1,201,147,54
2019,182290,20,2,178,105,73
2019,182290,20,3,1,0,1
2019,182290,30,0,296,182,114
2019,182290,30,2,13,11,2
2019,182290,30,3,283,171,112
2019,182290,40,0,269,115,154
2019,182290,40,4,1,1,0
2019,182290,40,5,166,70,96
2019,182290,40,6,102,44,58
2019,182290,42,0,269,115,154
2019,182290,42,4,1,1,0
2019,182290,42,5,166,70,96
2019,182290,42,6,102,44,58
2019,182306,0,0,71,43,28
2019,182306,10,0,71,43,28
2019,182306,10,1,32,16,16
2019,182306,10,4,35,25,10
2019,182306,10,6,4,2,2
2019,182306,20,0,32,16,16
2019,182306,20,1,32,16,16
2019,182306,30,0,23,15,8
2019,182306,30,4,23,15,8
2019,182306,40,0,16,12,4
2019,182306,40,4,12,10,2
2019,182306,40,6,4,2,2
2019,182306,42,0,16,12,4
2019,182306,42,4,12,10,2
2019,182306,42,6,4,2,2
2019,182458,0,0,37,20,17
2019,182458,10,0,37,20,17
2019,182458,10,1,9,4,5
2019,182458,10,2,11,5,6
2019,182458,10,3,14,9,5
2019,182458,10,4,3,2,1
2019,182458,40,0,37,20,17
2019,182458,40,1,9,4,5
2019,182458,40,2,11,5,6
2019,182458,40,3,14,9,5
2019,182458,40,4,3,2,1
2019,182458,42,0,37,20,17
2019,182458,42,1,9,4,5
2019,182458,42,2,11,5,6
2019,182458,42,3,14,9,5
2019,182458,42,4,3,2,1
2019,182500,0,0,166,82,84
2019,182500,10,0,166,82,84
2019,182500,10,1,106,55,51
2019,182500,10,4,60,27,33
2019,182500,20,0,106,55,51
2019,182500,20,1,106,55,51
2019,182500,30,0,44,18,26
2019,182500,30,4,44,18,26
2019,182500,40,0,16,9,7
2019,182500,40,4,16,9,7
2019,182500,42,0,16,9,7
2019,182500,42,4,16,9,7
2019,182564,0,0,53,27,26
2019,182564,10,0,53,27,26
2019,182564,10,1,28,14,14
2019,182564,10,4,24,12,12
2019,182564,10,6,1,1,0
2019,182564,20,0,28,14,14
2019,182564,20,1,28,14,14
2019,182564,30,0,17,10,7
2019,182564,30,4,17,10,7
2019,182564,40,0,8,3,5
2019,182564,40,4,7,2,5
2019,182564,40,6,1,1,0
2019,182564,42,0,8,3,5
2019,182564,42,4,7,2,5
2019,182564,42,6,1,1,0
2019,182634,0,0,52,21,31
2019,182634,10,0,52,21,31
2019,182634,10,1,16,8,8
2019,182634,10,2,16,7,9
2019,182634,10,3,20,6,14
2019,182634,20,0,31,15,16
2019,182634,20,1,16,8,8
2019,182634,20,2,15,7,8
2019,182634,30,0,6,1,5
2019,182634,30,2,1,0,1
2019,182634,30,3,5,1,4
2019,182634,40,0,15,5,10
2019,182634,40,3,15,5,10
2019,182634,42,0,15,5,10
2019,182634,42,3,15,5,10
2019,182670,0,0,706,446,260
2019,182670,10,0,706,446,260
2019,182670,10,1,309,224,85
2019,182670,10,2,183,108,75
2019,182670,10,3,129,78,51
2019,182670,10,4,12,5,7
2019,182670,10,5,66,27,39
2019,182670,10,6,7,4,3
2019,182670,20,0,427,295,132
2019,182670,20,1,284,207,77
2019,182670,20,2,143,88,55
2019,182670,30,0,160,91,69
2019,182670,30,1,3,2,1
2019,182670,30,2,35,17,18
2019,182670,30,3,122,72,50
2019,182670,40,0,119,60,59
2019,182670,40,1,22,15,7
2019,182670,40,2,5,3,2
2019,182670,40,3,7,6,1
2019,182670,40,4,12,5,7
2019,182670,40,5,66,27,39
2019,182670,40,6,7,4,3
2019,182670,41,0,119,60,59
2019,182670,41,1,22,15,7
2019,182670,41,2,5,3,2
2019,182670,41,3,7,6,1
2019,182670,41,4,12,5,7
2019,182670,41,5,66,27,39
2019,182670,41,6,7,4,3
2019,182670,44,0,119,60,59
2019,182670,44,1,22,15,7
2019,182670,44,2,5,3,2
2019,182670,44,3,7,6,1
2019,182670,44,4,12,5,7
2019,182670,44,5,66,27,39
2019,182670,44,6,7,4,3
2019,182795,0,0,89,42,47
2019,182795,10,0,89,42,47
2019,182795,10,1,19,13,6
2019,182795,10,2,27,16,11
2019,182795,10,3,38,13,25
2019,182795,10,4,5,0,5
2019,182795,40,0,89,42,47
2019,182795,40,1,19,13,6
2019,182795,40,2,27,16,11
2019,182795,40,3,38,13,25
2019,182795,40,4,5,0,5
2019,182795,42,0,89,42,47
2019,182795,42,1,19,13,6
2019,182795,42,2,27,16,11
2019,182795,42,3,38,13,25
2019,182795,42,4,5,0,5
2019,182829,0,0,24,13,11
2019,182829,10,0,24,13,11
2019,182829,10,1,14,10,4
2019,182829,10,2,2,0,2
2019,182829,10,5,8,3,5
2019,182829,20,0,13,10,3
2019,182829,20,1,13,10,3
2019,182829,30,0,1,0,1
2019,182829,30,2,1,0,1
2019,182829,40,0,10,3,7
2019,182829,40,1,1,0,1
2019,182829,40,2,1,0,1
2019,182829,40,5,8,3,5
2019,182829,41,0,10,3,7
2019,182829,41,1,1,0,1
2019,182829,41,2,1,0,1
2019,182829,41,5,8,3,5
2019,182829,44,0,10,3,7
2019,182829,44,1,1,0,1
2019,182829,44,2,1,0,1
2019,182829,44,5,8,3,5
2019,182917,0,0,8,7,1
2019,182917,10,0,8,7,1
2019,182917,10,1,8,7,1
2019,182917,40,0,8,7,1
2019,182917,40,1,8,7,1
2019,182917,42,0,8,7,1
2019,182917,42,1,8,7,1
2019,182980,0,0,75,40,35
2019,182980,10,0,75,40,35
2019,182980,10,1,25,12,13
2019,182980,10,2,23,15,8
2019,182980,10,3,24,12,12
2019,182980,10,4,3,1,2
2019,182980,40,0,75,40,35
2019,182980,40,1,25,12,13
2019,182980,40,2,23,15,8
2019,182980,40,3,24,12,12
2019,182980,40,4,3,1,2
2019,182980,41,0,65,35,30
2019,182980,41,1,24,12,12
2019,182980,41,2,19,12,7
2019,182980,41,3,19,10,9
2019,182980,41,4,3,1,2
2019,182980,42,0,10,5,5
2019,182980,42,1,1,0,1
2019,182980,42,2,4,3,1
2019,182980,42,3,5,2,3
2019,182980,44,0,65,35,30
2019,182980,44,1,24,12,12
2019,182980,44,2,19,12,7
2019,182980,44,3,19,10,9
2019,182980,44,4,3,1,2
2019,183026,0,0,156,80,76
2019,183026,10,0,148,76,72
2019,183026,10,1,41,23,18
2019,183026,10,2,43,19,24
2019,183026,10,3,57,27,30
2019,183026,10,4,7,7,0
2019,183026,40,0,148,76,72
2019,183026,40,1,41,23,18
2019,183026,40,2,43,19,24
2019,183026,40,3,57,27,30
2019,183026,40,4,7,7,0
2019,183026,41,0,84,45,39
2019,183026,41,1,39,23,16
2019,183026,41,2,35,17,18
2019,183026,41,3,7,2,5
2019,183026,41,4,3,3,0
2019,183026,42,0,64,31,33
2019,183026,42,1,2,0,2
2019,183026,42,2,8,2,6
2019,183026,42,3,50,25,25
2019,183026,42,4,4,4,0
2019,183026,44,0,84,45,39
2019,183026,44,1,39,23,16
2019,183026,44,2,35,17,18
2019,183026,44,3,7,2,5
2019,183026,44,4,3,3,0
2019,183026,50,0,8,4,4
2019,183044,0,0,746,366,380
2019,183044,10,0,746,366,380
2019,183044,10,1,187,128,59
2019,183044,10,2,205,92,113
2019,183044,10,3,182,71,111
2019,183044,10,5,172,75,97
2019,183044,20,0,361,212,149
2019,183044,20,1,182,125,57
2019,183044,20,2,179,87,92
2019,183044,30,0,144,65,79
2019,183044,30,1,1,1,0
2019,183044,30,2,4,2,2
2019,183044,30,3,139,62,77
2019,183044,40,0,241,89,152
2019,183044,40,1,4,2,2
2019,183044,40,2,22,3,19
2019,183044,40,3,43,9,34
2019,183044,40,5,172,75,97
2019,183044,41,0,241,89,152
2019,183044,41,1,4,2,2
2019,183044,41,2,22,3,19
2019,183044,41,3,43,9,34
2019,183044,41,5,172,75,97
2019,183044,44,0,241,89,152
2019,183044,44,1,4,2,2
2019,183044,44,2,22,3,19
2019,183044,44,3,43,9,34
2019,183044,44,5,172,75,97
2019,183062,0,0,181,87,94
2019,183062,10,0,181,87,94
2019,183062,10,1,71,36,35
2019,183062,10,2,60,32,28
2019,183062,10,3,39,15,24
2019,183062,10,4,2,0,2
2019,183062,10,5,6,2,4
2019,183062,10,6,3,2,1
2019,183062,20,0,127,66,61
2019,183062,20,1,71,36,35
2019,183062,20,2,54,29,25
2019,183062,20,3,2,1,1
2019,183062,30,0,36,14,22
2019,183062,30,2,4,2,2
2019,183062,30,3,31,12,19
2019,183062,30,4,1,0,1
2019,183062,40,0,18,7,11
2019,183062,40,2,2,1,1
2019,183062,40,3,6,2,4
2019,183062,40,4,1,0,1
2019,183062,40,5,6,2,4
2019,183062,40,6,3,2,1
2019,183062,41,0,18,7,11
2019,183062,41,2,2,1,1
2019,183062,41,3,6,2,4
2019,183062,41,4,1,0,1
2019,183062,41,5,6,2,4
2019,183062,41,6,3,2,1
2019,183062,44,0,18,7,11
2019,183062,44,2,2,1,1
2019,183062,44,3,6,2,4
2019,183062,44,4,1,0,1
2019,183062,44,5,6,2,4
2019,183062,44,6,3,2,1
2019,183071,0,0,42,24,18
2019,183071,10,0,42,24,18
2019,183071,10,1,4,3,1
2019,183071,10,2,15,7,8
2019,183071,10,3,11,7,4
2019,183071,10,5,12,7,5
2019,183071,20,0,19,10,9
2019,183071,20,1,4,3,1
2019,183071,20,2,15,7,8
2019,183071,30,0,11,7,4
2019,183071,30,3,11,7,4
2019,183071,40,0,12,7,5
2019,183071,40,5,12,7,5
2019,183071,41,0,12,7,5
2019,183071,41,5,12,7,5
2019,183071,44,0,12,7,5
2019,183071,44,5,12,7,5
2019,183080,0,0,193,96,97
2019,183080,10,0,193,96,97
2019,183080,10,1,70,41,29
2019,183080,10,2,51,21,30
2019,183080,10,3,37,17,20
2019,183080,10,4,1,0,1
2019,183080,10,5,34,17,17
2019,183080,20,0,114,61,53
2019,183080,20,1,70,41,29
2019,183080,20,2,44,20,24
2019,183080,30,0,35,17,18
2019,183080,30,2,3,1,2
2019,183080,30,3,31,16,15
2019,183080,30,4,1,0,1
2019,183080,40,0,44,18,26
2019,183080,40,2,4,0,4
2019,183080,40,3,6,1,5
2019,183080,40,5,34,17,17
2019,183080,41,0,44,18,26
2019,183080,41,2,4,0,4
2019,183080,41,3,6,1,5
2019,183080,41,5,34,17,17
2019,183080,44,0,44,18,26
2019,183080,44,2,4,0,4
2019,183080,44,3,6,1,5
2019,183080,44,5,34,17,17
2019,183099,0,0,89,31,58
2019,183099,10,0,89,31,58
2019,183099,10,1,74,26,48
2019,183099,10,2,11,2,9
2019,183099,10,3,2,1,1
2019,183099,10,4,2,2,0
2019,183099,40,0,89,31,58
2019,183099,40,1,74,26,48
2019,183099,40,2,11,2,9
2019,183099,40,3,2,1,1
2019,183099,40,4,2,2,0
2019,183099,42,0,89,31,58
2019,183099,42,1,74,26,48
2019,183099,42,2,11,2,9
2019,183099,42,3,2,1,1
2019,183099,42,4,2,2,0
2019,183105,0,0,23,12,11
2019,183105,10,0,23,12,11
2019,183105,10,1,11,2,9
2019,183105,10,2,8,6,2
2019,183105,10,3,1,1,0
2019,183105,10,4,3,3,0
2019,183105,40,0,23,12,11
2019,183105,40,1,11,2,9
2019,183105,40,2,8,6,2
2019,183105,40,3,1,1,0
2019,183105,40,4,3,3,0
2019,183105,42,0,23,12,11
2019,183105,42,1,11,2,9
2019,183105,42,2,8,6,2
2019,183105,42,3,1,1,0
2019,183105,42,4,3,3,0
2019,183114,0,0,26,4,22
2019,183114,10,0,26,4,22
2019,183114,10,1,15,2,13
2019,183114,10,2,9,2,7
2019,183114,10,3,2,0,2
2019,183114,40,0,26,4,22
2019,183114,40,1,15,2,13
2019,183114,40,2,9,2,7
2019,183114,40,3,2,0,2
2019,183114,42,0,26,4,22
2019,183114,42,1,15,2,13
2019,183114,42,2,9,2,7
2019,183114,42,3,2,0,2
2019,183123,0,0,23,15,8
2019,183123,10,0,23,15,8
2019,183123,10,1,13,5,8
2019,183123,10,2,2,2,0
2019,183123,10,3,6,6,0
2019,183123,10,4,2,2,0
2019,183123,40,0,23,15,8
2019,183123,40,1,13,5,8
2019,183123,40,2,2,2,0
2019,183123,40,3,6,6,0
2019,183123,40,4,2,2,0
2019,183123,42,0,23,15,8
2019,183123,42,1,13,5,8
2019,183123,42,2,2,2,0
2019,183123,42,3,6,6,0
2019,183123,42,4,2,2,0
2019,183132,0,0,49,22,27
2019,183132,10,0,49,22,27
2019,183132,10,1,29,10,19
2019,183132,10,2,18,10,8
2019,183132,10,3,1,1,0
2019,183132,10,4,1,1,0
2019,183132,40,0,49,22,27
2019,183132,40,1,29,10,19
2019,183132,40,2,18,10,8
2019,183132,40,3,1,1,0
2019,183132,40,4,1,1,0
2019,183132,42,0,49,22,27
2019,183132,42,1,29,10,19
2019,183132,42,2,18,10,8
2019,183132,42,3,1,1,0
2019,183132,42,4,1,1,0
2019,183141,0,0,31,17,14
2019,183141,10,0,31,17,14
2019,183141,10,1,26,12,14
2019,183141,10,2,5,5,0
2019,183141,40,0,31,17,14
2019,183141,40,1,26,12,14
2019,183141,40,2,5,5,0
2019,183141,42,0,31,17,14
2019,183141,42,1,26,12,14
2019,183141,42,2,5,5,0
2019,183150,0,0,33,10,23
2019,183150,10,0,33,10,23
2019,183150,10,1,26,8,18
2019,183150,10,2,5,1,4
2019,183150,10,3,1,0,1
2019,183150,10,4,1,1,0
2019,183150,40,0,33,10,23
2019,183150,40,1,26,8,18
2019,183150,40,2,5,1,4
2019,183150,40,3,1,0,1
2019,183150,40,4,1,1,0
2019,183150,42,0,33,10,23
2019,183150,42,1,26,8,18
2019,183150,42,2,5,1,4
2019,183150,42,3,1,0,1
2019,183150,42,4,1,1,0
2019,183211,0,0,64,18,46
2019,183211,10,0,64,18,46
2019,183211,10,1,12,7,5
2019,183211,10,2,15,5,10
2019,183211,10,3,24,5,19
2019,183211,10,4,13,1,12
2019,183211,20,0,27,12,15
2019,183211,20,1,12,7,5
2019,183211,20,2,15,5,10
2019,183211,30,0,1,0,1
2019,183211,30,3,1,0,1
2019,183211,40,0,36,6,30
2019,183211,40,3,23,5,18
2019,183211,40,4,13,1,12
2019,183211,42,0,36,6,30
2019,183211,42,3,23,5,18
2019,183211,42,4,13,1,12
2019,183239,0,0,159,73,86
2019,183239,10,0,159,73,86
2019,183239,10,1,50,32,18
2019,183239,10,2,49,19,30
2019,183239,10,3,40,21,19
2019,183239,10,4,6,1,5
2019,183239,10,5,2,0,2
2019,183239,10,6,12,0,12
2019,183239,20,0,91,48,43
2019,183239,20,1,49,31,18
2019,183239,20,2,41,16,25
2019,183239,20,3,1,1,0
2019,183239,30,0,35,15,20
2019,183239,30,2,8,3,5
2019,183239,30,3,26,12,14
2019,183239,30,4,1,0,1
2019,183239,40,0,33,10,23
2019,183239,40,1,1,1,0
2019,183239,40,3,13,8,5
2019,183239,40,4,5,1,4
2019,183239,40,5,2,0,2
2019,183239,40,6,12,0,12
2019,183239,42,0,33,10,23
2019,183239,42,1,1,1,0
2019,183239,42,3,13,8,5
2019,183239,42,4,5,1,4
2019,183239,42,5,2,0,2
2019,183239,42,6,12,0,12
2019,183248,0,0,13,0,13
2019,183248,10,0,13,0,13
2019,183248,10,4,13,0,13
2019,183248,40,0,13,0,13
2019,183248,40,4,13,0,13
2019,183248,41,0,13,0,13
2019,183248,41,4,13,0,13
2019,183248,45,0,13,0,13
2019,183248,45,4,13,0,13
2019,183257,0,0,16,0,16
2019,183257,10,0,16,0,16
2019,183257,10,5,16,0,16
2019,183257,40,0,16,0,16
2019,183257,40,5,16,0,16
2019,183257,41,0,16,0,16
2019,183257,41,5,16,0,16
2019,183257,44,0,16,0,16
2019,183257,44,5,16,0,16
2019,183275,0,0,6,5,1
2019,183275,10,0,6,5,1
2019,183275,10,6,6,5,1
2019,183275,40,0,6,5,1
2019,183275,40,6,6,5,1
2019,183275,42,0,6,5,1
2019,183275,42,6,6,5,1
2019,183488,0,0,9,4,5
2019,183488,10,0,9,4,5
2019,183488,10,1,3,2,1
2019,183488,10,4,6,2,4
2019,183488,40,0,9,4,5
2019,183488,40,1,3,2,1
2019,183488,40,4,6,2,4
2019,183488,41,0,9,4,5
2019,183488,41,1,3,2,1
2019,183488,41,4,6,2,4
2019,183488,45,0,9,4,5
2019,183488,45,1,3,2,1
2019,183488,45,4,6,2,4
2019,183655,0,0,73,30,43
2019,183655,10,0,71,30,41
2019,183655,10,1,22,10,12
2019,183655,10,2,22,7,15
2019,183655,10,3,22,10,12
2019,183655,10,6,5,3,2
2019,183655,20,0,58,24,34
2019,183655,20,1,22,10,12
2019,183655,20,2,22,7,15
2019,183655,20,3,14,7,7
2019,183655,30,0,8,3,5
2019,183655,30,3,8,3,5
2019,183655,40,0,5,3,2
2019,183655,40,6,5,3,2
2019,183655,42,0,5,3,2
2019,183655,42,6,5,3,2
2019,183655,50,0,2,0,2
2019,183743,0,0,221,102,119
2019,183743,10,0,221,102,119
2019,183743,10,1,73,48,25
2019,183743,10,2,59,25,34
2019,183743,10,3,63,23,40
2019,183743,10,4,14,5,9
2019,183743,10,5,7,1,6
2019,183743,10,6,5,0,5
2019,183743,20,0,184,88,96
2019,183743,20,1,73,48,25
2019,183743,20,2,58,24,34
2019,183743,20,3,49,15,34
2019,183743,20,4,4,1,3
2019,183743,30,0,25,13,12
2019,183743,30,2,1,1,0
2019,183743,30,3,14,8,6
2019,183743,30,4,10,4,6
2019,183743,40,0,12,1,11
2019,183743,40,5,7,1,6
2019,183743,40,6,5,0,5
2019,183743,41,0,5,0,5
2019,183743,41,6,5,0,5
2019,183743,43,0,7,1,6
2019,183743,43,5,7,1,6
2019,183743,45,0,5,0,5
2019,183743,45,6,5,0,5
2019,183789,0,0,100,53,47
2019,183789,10,0,100,53,47
2019,183789,10,6,100,53,47
2019,183789,40,0,100,53,47
2019,183789,40,6,100,53,47
2019,183789,42,0,100,53,47
2019,183789,42,6,100,53,47
2019,183804,0,0,16,16,0
2019,183804,10,0,16,16,0
2019,183804,10,1,14,14,0
2019,183804,10,2,1,1,0
2019,183804,10,3,1,1,0
2019,183804,40,0,16,16,0
2019,183804,40,1,14,14,0
2019,183804,40,2,1,1,0
2019,183804,40,3,1,1,0
2019,183804,41,0,16,16,0
2019,183804,41,1,14,14,0
2019,183804,41,2,1,1,0
2019,183804,41,3,1,1,0
2019,183804,45,0,16,16,0
2019,183804,45,1,14,14,0
2019,183804,45,2,1,1,0
2019,183804,45,3,1,1,0
2019,183822,0,0,61,24,37
2019,183822,10,0,61,24,37
2019,183822,10,1,28,11,17
2019,183822,10,2,20,10,10
2019,183822,10,3,13,3,10
2019,183822,20,0,42,18,24
2019,183822,20,1,28,11,17
2019,183822,20,2,14,7,7
2019,183822,30,0,18,5,13
2019,183822,30,2,5,2,3
2019,183822,30,3,13,3,10
2019,183822,40,0,1,1,0
2019,183822,40,2,1,1,0
2019,183822,41,0,1,1,0
2019,183822,41,2,1,1,0
2019,183822,45,0,1,1,0
2019,183822,45,2,1,1,0
2019,183859,0,0,199,84,115
2019,183859,10,0,199,84,115
2019,183859,10,1,81,41,40
2019,183859,10,2,42,15,27
2019,183859,10,3,45,20,25
2019,183859,10,4,31,8,23
2019,183859,20,0,168,76,92
2019,183859,20,1,81,41,40
2019,183859,20,2,42,15,27
2019,183859,20,3,45,20,25
2019,183859,30,0,28,8,20
2019,183859,30,4,28,8,20
2019,183859,40,0,3,0,3
2019,183859,40,4,3,0,3
2019,183859,42,0,1,0,1
2019,183859,42,4,1,0,1
2019,183859,43,0,2,0,2
2019,183859,43,4,2,0,2
2019,183877,0,0,68,30,38
2019,183877,10,0,68,30,38
2019,183877,10,1,3,2,1
2019,183877,10,2,3,0,3
2019,183877,10,3,28,12,16
2019,183877,10,4,34,16,18
2019,183877,20,0,36,15,21
2019,183877,20,1,3,2,1
2019,183877,20,2,3,0,3
2019,183877,20,3,28,12,16
2019,183877,20,4,2,1,1
2019,183877,30,0,32,15,17
2019,183877,30,4,32,15,17
2019,183910,0,0,81,29,52
2019,183910,10,0,79,29,50
2019,183910,10,1,35,17,18
2019,183910,10,2,12,4,8
2019,183910,10,3,29,8,21
2019,183910,10,4,3,0,3
2019,183910,20,0,42,20,22
2019,183910,20,1,35,17,18
2019,183910,20,2,6,3,3
2019,183910,20,3,1,0,1
2019,183910,30,0,33,8,25
2019,183910,30,2,6,1,5
2019,183910,30,3,27,7,20
2019,183910,40,0,4,1,3
2019,183910,40,3,1,1,0
2019,183910,40,4,3,0,3
2019,183910,42,0,4,1,3
2019,183910,42,3,1,1,0
2019,183910,42,4,3,0,3
2019,183910,50,0,2,0,2
2019,183938,0,0,127,58,69
2019,183938,10,0,111,49,62
2019,183938,10,1,28,16,12
2019,183938,10,2,15,7,8
2019,183938,10,3,68,26,42
2019,183938,20,0,103,45,58
2019,183938,20,1,28,16,12
2019,183938,20,2,15,7,8
2019,183938,20,3,60,22,38
2019,183938,30,0,8,4,4
2019,183938,30,3,8,4,4
2019,183938,50,0,16,9,7
2019,183974,0,0,77,37,40
2019,183974,10,0,77,37,40
2019,183974,10,1,14,5,9
2019,183974,10,2,23,12,11
2019,183974,10,3,34,17,17
2019,183974,10,4,6,3,3
2019,183974,20,0,16,8,8
2019,183974,20,1,7,3,4
2019,183974,20,2,9,5,4
2019,183974,30,0,8,2,6
2019,183974,30,2,1,0,1
2019,183974,30,3,6,2,4
2019,183974,30,4,1,0,1
2019,183974,40,0,53,27,26
2019,183974,40,1,7,2,5
2019,183974,40,2,13,7,6
2019,183974,40,3,28,15,13
2019,183974,40,4,5,3,2
2019,183974,42,0,12,7,5
2019,183974,42,1,3,1,2
2019,183974,42,2,5,3,2
2019,183974,42,3,4,3,1
2019,183974,43,0,41,20,21
2019,183974,43,1,4,1,3
2019,183974,43,2,8,4,4
2019,183974,43,3,24,12,12
2019,183974,43,4,5,3,2
2019,184180,0,0,164,76,88
2019,184180,10,0,164,76,88
2019,184180,10,1,35,19,16
2019,184180,10,2,41,16,25
2019,184180,10,3,78,34,44
2019,184180,10,4,10,7,3
2019,184180,20,0,101,47,54
2019,184180,20,1,35,19,16
2019,184180,20,2,36,15,21
2019,184180,20,3,30,13,17
2019,184180,30,0,61,29,32
2019,184180,30,2,5,1,4
2019,184180,30,3,46,21,25
2019,184180,30,4,10,7,3
2019,184180,40,0,2,0,2
2019,184180,40,3,2,0,2
2019,184180,42,0,2,0,2
2019,184180,42,3,2,0,2
2019,184205,0,0,34,13,21
2019,184205,10,0,34,13,21
2019,184205,10,1,4,2,2
2019,184205,10,2,12,4,8
2019,184205,10,3,8,3,5
2019,184205,10,4,8,3,5
2019,184205,10,6,2,1,1
2019,184205,30,0,32,12,20
2019,184205,30,1,4,2,2
2019,184205,30,2,12,4,8
2019,184205,30,3,8,3,5
2019,184205,30,4,8,3,5
2019,184205,40,0,2,1,1
2019,184205,40,6,2,1,1
2019,184205,42,0,2,1,1
2019,184205,42,6,2,1,1
2019,184348,0,0,139,73,66
2019,184348,10,0,139,73,66
2019,184348,10,1,45,26,19
2019,184348,10,2,51,27,24
2019,184348,10,3,42,20,22
2019,184348,10,4,1,0,1
2019,184348,20,0,94,52,42
2019,184348,20,1,45,26,19
2019,184348,20,2,49,26,23
2019,184348,30,0,16,9,7
2019,184348,30,3,16,9,7
2019,184348,40,0,29,12,17
2019,184348,40,2,2,1,1
2019,184348,40,3,26,11,15
2019,184348,40,4,1,0,1
2019,184348,41,0,18,7,11
2019,184348,41,2,1,0,1
2019,184348,41,3,16,7,9
2019,184348,41,4,1,0,1
2019,184348,42,0,11,5,6
2019,184348,42,2,1,1,0
2019,184348,42,3,10,4,6
2019,184348,44,0,18,7,11
2019,184348,44,2,1,0,1
2019,184348,44,3,16,7,9
2019,184348,44,4,1,0,1
2019,184481,0,0,90,46,44
2019,184481,10,0,90,46,44
2019,184481,10,1,18,12,6
2019,184481,10,2,26,11,15
2019,184481,10,3,30,16,14
2019,184481,10,4,15,7,8
2019,184481,10,5,1,0,1
2019,184481,20,0,83,45,38
2019,184481,20,1,18,12,6
2019,184481,20,2,26,11,15
2019,184481,20,3,27,16,11
2019,184481,20,4,12,6,6
2019,184481,30,0,6,1,5
2019,184481,30,3,3,0,3
2019,184481,30,4,3,1,2
2019,184481,40,0,1,0,1
2019,184481,40,5,1,0,1
2019,184481,42,0,1,0,1
2019,184481,42,5,1,0,1
2019,184603,0,0,163,91,72
2019,184603,10,0,163,91,72
2019,184603,10,1,48,31,17
2019,184603,10,2,31,17,14
2019,184603,10,3,46,26,20
2019,184603,10,4,4,0,4
2019,184603,10,5,34,17,17
2019,184603,20,0,78,48,30
2019,184603,20,1,48,31,17
2019,184603,20,2,25,14,11
2019,184603,20,3,5,3,2
2019,184603,30,0,42,26,16
2019,184603,30,2,5,3,2
2019,184603,30,3,37,23,14
2019,184603,40,0,43,17,26
2019,184603,40,2,1,0,1
2019,184603,40,3,4,0,4
2019,184603,40,4,4,0,4
2019,184603,40,5,34,17,17
2019,184603,42,0,43,17,26
2019,184603,42,2,1,0,1
2019,184603,42,3,4,0,4
2019,184603,42,4,4,0,4
2019,184603,42,5,34,17,17
2019,184612,0,0,82,32,50
2019,184612,10,0,82,32,50
2019,184612,10,1,14,6,8
2019,184612,10,2,26,15,11
2019,184612,10,3,30,11,19
2019,184612,10,4,12,0,12
2019,184612,40,0,82,32,50
2019,184612,40,1,14,6,8
2019,184612,40,2,26,15,11
2019,184612,40,3,30,11,19
2019,184612,40,4,12,0,12
2019,184612,42,0,82,32,50
2019,184612,42,1,14,6,8
2019,184612,42,2,26,15,11
2019,184612,42,3,30,11,19
2019,184612,42,4,12,0,12
2019,184694,0,0,158,76,82
2019,184694,10,0,158,76,82
2019,184694,10,1,41,27,14
2019,184694,10,2,42,18,24
2019,184694,10,3,55,23,32
2019,184694,10,5,20,8,12
2019,184694,20,0,78,47,31
2019,184694,20,1,41,27,14
2019,184694,20,2,34,17,17
2019,184694,20,3,3,3,0
2019,184694,30,0,47,18,29
2019,184694,30,2,6,1,5
2019,184694,30,3,41,17,24
2019,184694,40,0,33,11,22
2019,184694,40,2,2,0,2
2019,184694,40,3,11,3,8
2019,184694,40,5,20,8,12
2019,184694,42,0,33,11,22
2019,184694,42,2,2,0,2
2019,184694,42,3,11,3,8
2019,184694,42,5,20,8,12
2019,184773,0,0,91,31,60
2019,184773,10,0,91,31,60
2019,184773,10,1,23,10,13
2019,184773,10,2,30,9,21
2019,184773,10,3,34,12,22
2019,184773,10,4,2,0,2
2019,184773,10,6,2,0,2
2019,184773,20,0,53,20,33
2019,184773,20,1,23,10,13
2019,184773,20,2,29,9,20
2019,184773,20,3,1,1,0
2019,184773,30,0,29,10,19
2019,184773,30,2,1,0,1
2019,184773,30,3,28,10,18
2019,184773,40,0,9,1,8
2019,184773,40,3,5,1,4
2019,184773,40,4,2,0,2
2019,184773,40,6,2,0,2
2019,184773,42,0,9,1,8
2019,184773,42,3,5,1,4
2019,184773,42,4,2,0,2
2019,184773,42,6,2,0,2
2019,184782,0,0,798,416,382
2019,184782,10,0,798,416,382
2019,184782,10,1,146,97,49
2019,184782,10,2,180,93,87
2019,184782,10,3,260,137,123
2019,184782,10,4,66,28,38
2019,184782,10,5,126,55,71
2019,184782,10,6,20,6,14
2019,184782,20,0,277,162,115
2019,184782,20,1,128,84,44
2019,184782,20,2,118,65,53
2019,184782,20,3,19,9,10
2019,184782,20,4,12,4,8
2019,184782,30,0,213,110,103
2019,184782,30,1,7,5,2
2019,184782,30,2,30,15,15
2019,184782,30,3,165,85,80
2019,184782,30,4,9,4,5
2019,184782,30,5,1,1,0
2019,184782,30,6,1,0,1
2019,184782,40,0,308,144,164
2019,184782,40,1,11,8,3
2019,184782,40,2,32,13,19
2019,184782,40,3,76,43,33
2019,184782,40,4,45,20,25
2019,184782,40,5,125,54,71
2019,184782,40,6,19,6,13
2019,184782,41,0,128,57,71
2019,184782,41,2,2,1,1
2019,184782,41,3,2,2,0
2019,184782,41,5,124,54,70
2019,184782,42,0,165,82,83
2019,184782,42,1,9,7,2
2019,184782,42,2,26,11,15
2019,184782,42,3,67,38,29
2019,184782,42,4,45,20,25
2019,184782,42,6,18,6,12
2019,184782,43,0,15,5,10
2019,184782,43,1,2,1,1
2019,184782,43,2,4,1,3
2019,184782,43,3,7,3,4
2019,184782,43,5,1,0,1
2019,184782,43,6,1,0,1
2019,184782,44,0,128,57,71
2019,184782,44,2,2,1,1
2019,184782,44,3,2,2,0
2019,184782,44,5,124,54,70
2019,184791,0,0,81,27,54
2019,184791,10,0,79,25,54
2019,184791,10,1,10,2,8
2019,184791,10,2,14,4,10
2019,184791,10,3,29,15,14
2019,184791,10,4,26,4,22
2019,184791,20,0,50,21,29
2019,184791,20,1,10,2,8
2019,184791,20,2,14,4,10
2019,184791,20,3,26,15,11
2019,184791,30,0,29,4,25
2019,184791,30,3,3,0,3
2019,184791,30,4,26,4,22
2019,184791,50,0,2,2,0
2019,184959,0,0,13,7,6
2019,184959,10,0,13,7,6
2019,184959,10,1,4,4,0
2019,184959,10,2,3,1,2
2019,184959,10,4,6,2,4
2019,184959,40,0,13,7,6
2019,184959,40,1,4,4,0
2019,184959,40,2,3,1,2
2019,184959,40,4,6,2,4
2019,184959,41,0,13,7,6
2019,184959,41,1,4,4,0
2019,184959,41,2,3,1,2
2019,184959,41,4,6,2,4
2019,184959,45,0,13,7,6
2019,184959,45,1,4,4,0
2019,184959,45,2,3,1,2
2019,184959,45,4,6,2,4
2019,184995,0,0,106,50,56
2019,184995,10,0,106,50,56
2019,184995,10,1,18,12,6
2019,184995,10,2,11,5,6
2019,184995,10,3,34,17,17
2019,184995,10,4,34,15,19
2019,184995,10,5,9,1,8
2019,184995,20,0,63,34,29
2019,184995,20,1,18,12,6
2019,184995,20,2,11,5,6
2019,184995,20,3,34,17,17
2019,184995,30,0,19,8,11
2019,184995,30,4,19,8,11
2019,184995,40,0,24,8,16
2019,184995,40,4,15,7,8
2019,184995,40,5,9,1,8
2019,184995,42,0,24,8,16
2019,184995,42,4,15,7,8
2019,184995,42,5,9,1,8
2019,185129,0,0,249,129,120
2019,185129,10,0,249,129,120
2019,185129,10,1,77,39,38
2019,185129,10,2,84,44,40
2019,185129,10,3,88,46,42
2019,185129,20,0,162,77,85
2019,185129,20,1,73,35,38
2019,185129,20,2,67,36,31
2019,185129,20,3,22,6,16
2019,185129,30,0,82,47,35
2019,185129,30,1,4,4,0
2019,185129,30,2,16,7,9
2019,185129,30,3,62,36,26
2019,185129,40,0,5,5,0
2019,185129,40,2,1,1,0
2019,185129,40,3,4,4,0
2019,185129,41,0,5,5,0
2019,185129,41,2,1,1,0
2019,185129,41,3,4,4,0
2019,185129,45,0,5,5,0
2019,185129,45,2,1,1,0
2019,185129,45,3,4,4,0
2019,185262,0,0,358,158,200
2019,185262,10,0,358,158,200
2019,185262,10,1,54,25,29
2019,185262,10,2,67,33,34
2019,185262,10,3,100,47,53
2019,185262,10,5,137,53,84
2019,185262,20,0,177,81,96
2019,185262,20,1,54,25,29
2019,185262,20,2,67,33,34
2019,185262,20,3,56,23,33
2019,185262,30,0,44,24,20
2019,185262,30,3,44,24,20
2019,185262,40,0,137,53,84
2019,185262,40,5,137,53,84
2019,185262,42,0,137,53,84
2019,185262,42,5,137,53,84
2019,185509,0,0,109,52,57
2019,185509,10,0,109,52,57
2019,185509,10,1,59,30,29
2019,185509,10,2,18,5,13
2019,185509,10,3,30,17,13
2019,185509,10,4,2,0,2
2019,185509,20,0,85,42,43
2019,185509,20,1,59,30,29
2019,185509,20,2,17,5,12
2019,185509,20,3,9,7,2
2019,185509,30,0,24,10,14
2019,185509,30,2,1,0,1
2019,185509,30,3,21,10,11
2019,185509,30,4,2,0,2
2019,185536,0,0,143,72,71
2019,185536,10,0,143,72,71
2019,185536,10,1,39,20,19
2019,185536,10,2,37,15,22
2019,185536,10,3,38,19,19
2019,185536,10,4,29,18,11
2019,185536,20,0,114,54,60
2019,185536,20,1,39,20,19
2019,185536,20,2,37,15,22
2019,185536,20,3,38,19,19
2019,185536,30,0,24,14,10
2019,185536,30,4,24,14,10
2019,185536,40,0,5,4,1
2019,185536,40,4,5,4,1
2019,185536,42,0,3,2,1
2019,185536,42,4,3,2,1
2019,185536,43,0,2,2,0
2019,185536,43,4,2,2,0
2019,185572,0,0,320,144,176
2019,185572,10,0,320,144,176
2019,185572,10,1,41,24,17
2019,185572,10,2,94,41,53
2019,185572,10,3,79,39,40
2019,185572,10,4,16,9,7
2019,185572,10,5,90,31,59
2019,185572,20,0,135,65,70
2019,185572,20,1,41,24,17
2019,185572,20,2,94,41,53
2019,185572,30,0,79,39,40
2019,185572,30,3,79,39,40
2019,185572,40,0,106,40,66
2019,185572,40,4,16,9,7
2019,185572,40,5,90,31,59
2019,185572,41,0,87,31,56
2019,185572,41,5,87,31,56
2019,185572,42,0,19,9,10
2019,185572,42,4,16,9,7
2019,185572,42,5,3,0,3
2019,185572,44,0,87,31,56
2019,185572,44,5,87,31,56
2019,185590,0,0,643,328,315
2019,185590,10,0,643,328,315
2019,185590,10,1,195,102,93
2019,185590,10,2,212,113,99
2019,185590,10,3,149,78,71
2019,185590,10,4,1,0,1
2019,185590,10,6,86,35,51
2019,185590,20,0,408,213,195
2019,185590,20,1,193,101,92
2019,185590,20,2,199,106,93
2019,185590,20,3,16,6,10
2019,185590,30,0,131,69,62
2019,185590,30,1,2,1,1
2019,185590,30,2,13,7,6
2019,185590,30,3,116,61,55
2019,185590,40,0,104,46,58
2019,185590,40,3,17,11,6
2019,185590,40,4,1,0,1
2019,185590,40,6,86,35,51
2019,185590,41,0,86,35,51
2019,185590,41,6,86,35,51
2019,185590,42,0,18,11,7
2019,185590,42,3,17,11,6
2019,185590,42,4,1,0,1
2019,185590,44,0,86,35,51
2019,185590,44,6,86,35,51
2019,185721,0,0,9,3,6
2019,185721,10,0,9,3,6
2019,185721,10,1,1,0,1
2019,185721,10,2,1,1,0
2019,185721,10,4,7,2,5
2019,185721,40,0,9,3,6
2019,185721,40,1,1,0,1
2019,185721,40,2,1,1,0
2019,185721,40,4,7,2,5
2019,185721,41,0,9,3,6
2019,185721,41,1,1,0,1
2019,185721,41,2,1,1,0
2019,185721,41,4,7,2,5
2019,185721,45,0,9,3,6
2019,185721,45,1,1,0,1
2019,185721,45,2,1,1,0
2019,185721,45,4,7,2,5
2019,185758,0,0,11,7,4
2019,185758,10,0,11,7,4
2019,185758,10,1,2,0,2
2019,185758,10,2,3,3,0
2019,185758,10,3,6,4,2
2019,185758,20,0,5,3,2
2019,185758,20,1,2,0,2
2019,185758,20,2,3,3,0
2019,185758,30,0,5,3,2
2019,185758,30,3,5,3,2
2019,185758,40,0,1,1,0
2019,185758,40,3,1,1,0
2019,185758,42,0,1,1,0
2019,185758,42,3,1,1,0
2019,185828,0,0,443,335,108
2019,185828,10,0,439,333,106
2019,185828,10,1,140,122,18
2019,185828,10,2,95,74,21
2019,185828,10,3,83,54,29
2019,185828,10,5,121,83,38
2019,185828,20,0,223,187,36
2019,185828,20,1,139,121,18
2019,185828,20,2,84,66,18
2019,185828,30,0,95,63,32
2019,185828,30,1,1,1,0
2019,185828,30,2,11,8,3
2019,185828,30,3,83,54,29
2019,185828,40,0,121,83,38
2019,185828,40,5,121,83,38
2019,185828,41,0,36,24,12
2019,185828,41,5,36,24,12
2019,185828,42,0,85,59,26
2019,185828,42,5,85,59,26
2019,185828,44,0,36,24,12
2019,185828,44,5,36,24,12
2019,185828,50,0,4,2,2
2019,185873,0,0,110,49,61
2019,185873,10,0,44,19,25
2019,185873,10,1,12,4,8
2019,185873,10,2,12,6,6
2019,185873,10,3,12,5,7
2019,185873,10,4,7,4,3
2019,185873,10,6,1,0,1
2019,185873,20,0,43,19,24
2019,185873,20,1,12,4,8
2019,185873,20,2,12,6,6
2019,185873,20,3,12,5,7
2019,185873,20,4,6,4,2
2019,185873,20,6,1,0,1
2019,185873,30,0,1,0,1
2019,185873,30,4,1,0,1
2019,185873,50,0,66,30,36
2019,186034,0,0,86,36,50
2019,186034,10,0,86,36,50
2019,186034,10,1,13,8,5
2019,186034,10,2,25,7,18
2019,186034,10,3,26,14,12
2019,186034,10,4,22,7,15
2019,186034,20,0,64,29,35
2019,186034,20,1,13,8,5
2019,186034,20,2,25,7,18
2019,186034,20,3,26,14,12
2019,186034,30,0,21,6,15
2019,186034,30,4,21,6,15
2019,186034,40,0,1,1,0
2019,186034,40,4,1,1,0
2019,186034,42,0,1,1,0
2019,186034,42,4,1,1,0
2019,186122,0,0,44,29,15
2019,186122,10,0,44,29,15
2019,186122,10,1,20,17,3
2019,186122,10,2,13,6,7
2019,186122,10,3,8,5,3
2019,186122,10,5,2,0,2
2019,186122,10,6,1,1,0
2019,186122,20,0,33,23,10
2019,186122,20,1,20,17,3
2019,186122,20,2,13,6,7
2019,186122,30,0,6,3,3
2019,186122,30,3,6,3,3
2019,186122,40,0,5,3,2
2019,186122,40,3,2,2,0
2019,186122,40,5,2,0,2
2019,186122,40,6,1,1,0
2019,186122,41,0,5,3,2
2019,186122,41,3,2,2,0
2019,186122,41,5,2,0,2
2019,186122,41,6,1,1,0
2019,186122,44,0,5,3,2
2019,186122,44,3,2,2,0
2019,186122,44,5,2,0,2
2019,186122,44,6,1,1,0
2019,186131,0,0,985,629,356
2019,186131,10,0,985,629,356
2019,186131,10,1,492,362,130
2019,186131,10,2,115,69,46
2019,186131,10,3,184,107,77
2019,186131,10,4,18,14,4
2019,186131,10,5,176,77,99
2019,186131,20,0,607,431,176
2019,186131,20,1,492,362,130
2019,186131,20,2,115,69,46
2019,186131,30,0,184,107,77
2019,186131,30,3,184,107,77
2019,186131,40,0,194,91,103
2019,186131,40,4,18,14,4
2019,186131,40,5,176,77,99
2019,186131,41,0,96,43,53
2019,186131,41,4,5,4,1
2019,186131,41,5,91,39,52
2019,186131,42,0,98,48,50
2019,186131,42,4,13,10,3
2019,186131,42,5,85,38,47
2019,186131,44,0,96,43,53
2019,186131,44,4,5,4,1
2019,186131,44,5,91,39,52
2019,186186,0,0,17,17,0
2019,186186,10,0,17,17,0
2019,186186,10,4,17,17,0
2019,186186,40,0,17,17,0
2019,186186,40,4,17,17,0
2019,186186,42,0,17,17,0
2019,186186,42,4,17,17,0
2019,186201,0,0,220,105,115
2019,186201,10,0,220,105,115
2019,186201,10,1,73,39,34
2019,186201,10,2,95,41,54
2019,186201,10,3,50,25,25
2019,186201,10,4,2,0,2
2019,186201,20,0,174,83,91
2019,186201,20,1,73,39,34
2019,186201,20,2,92,38,54
2019,186201,20,3,8,6,2
2019,186201,20,4,1,0,1
2019,186201,30,0,32,16,16
2019,186201,30,2,3,3,0
2019,186201,30,3,29,13,16
2019,186201,40,0,14,6,8
2019,186201,40,3,13,6,7
2019,186201,40,4,1,0,1
2019,186201,43,0,14,6,8
2019,186201,43,3,13,6,7
2019,186201,43,4,1,0,1
2019,186283,0,0,205,103,102
2019,186283,10,0,205,103,102
2019,186283,10,1,73,45,28
2019,186283,10,2,84,40,44
2019,186283,10,3,41,14,27
2019,186283,10,5,6,3,3
2019,186283,10,6,1,1,0
2019,186283,20,0,147,83,64
2019,186283,20,1,71,45,26
2019,186283,20,2,76,38,38
2019,186283,30,0,46,15,31
2019,186283,30,1,1,0,1
2019,186283,30,2,8,2,6
2019,186283,30,3,36,12,24
2019,186283,30,5,1,1,0
2019,186283,40,0,12,5,7
2019,186283,40,1,1,0,1
2019,186283,40,3,5,2,3
2019,186283,40,5,5,2,3
2019,186283,40,6,1,1,0
2019,186283,41,0,7,3,4
2019,186283,41,3,1,0,1
2019,186283,41,5,5,2,3
2019,186283,41,6,1,1,0
2019,186283,42,0,4,1,3
2019,186283,42,1,1,0,1
2019,186283,42,3,3,1,2
2019,186283,43,0,1,1,0
2019,186283,43,3,1,1,0
2019,186283,44,0,5,2,3
2019,186283,44,3,1,0,1
2019,186283,44,5,3,1,2
2019,186283,44,6,1,1,0
2019,186283,45,0,2,1,1
2019,186283,45,5,2,1,1
2019,186371,0,0,312,163,149
2019,186371,10,0,312,163,149
2019,186371,10,1,107,65,42
2019,186371,10,2,85,46,39
2019,186371,10,3,105,40,65
2019,186371,10,4,14,11,3
2019,186371,10,5,1,1,0
2019,186371,20,0,160,99,61
2019,186371,20,1,95,63,32
2019,186371,20,2,65,36,29
2019,186371,30,0,70,30,40
2019,186371,30,1,1,0,1
2019,186371,30,2,8,5,3
2019,186371,30,3,61,25,36
2019,186371,40,0,82,34,48
2019,186371,40,1,11,2,9
2019,186371,40,2,12,5,7
2019,186371,40,3,44,15,29
2019,186371,40,4,14,11,3
2019,186371,40,5,1,1,0
2019,186371,41,0,82,34,48
2019,186371,41,1,11,2,9
2019,186371,41,2,12,5,7
2019,186371,41,3,44,15,29
2019,186371,41,4,14,11,3
2019,186371,41,5,1,1,0
2019,186371,44,0,82,34,48
2019,186371,44,1,11,2,9
2019,186371,44,2,12,5,7
2019,186371,44,3,44,15,29
2019,186371,44,4,14,11,3
2019,186371,44,5,1,1,0
2019,186380,0,0,3448,1869,1579
2019,186380,10,0,3448,1869,1579
2019,186380,10,1,1113,784,329
2019,186380,10,2,818,423,395
2019,186380,10,3,1198,550,648
2019,186380,10,4,258,96,162
2019,186380,10,5,61,16,45
2019,186380,20,0,1261,825,436
2019,186380,20,1,884,637,247
2019,186380,20,2,377,188,189
2019,186380,30,0,426,234,192
2019,186380,30,1,41,24,17
2019,186380,30,2,76,40,36
2019,186380,30,3,309,170,139
2019,186380,40,0,1761,810,951
2019,186380,40,1,188,123,65
2019,186380,40,2,365,195,170
2019,186380,40,3,889,380,509
2019,186380,40,4,258,96,162
2019,186380,40,5,61,16,45
2019,186380,41,0,1761,810,951
2019,186380,41,1,188,123,65
2019,186380,41,2,365,195,170
2019,186380,41,3,889,380,509
2019,186380,41,4,258,96,162
2019,186380,41,5,61,16,45
2019,186380,44,0,1761,810,951
2019,186380,44,1,188,123,65
2019,186380,44,2,365,195,170
2019,186380,44,3,889,380,509
2019,186380,44,4,258,96,162
2019,186380,44,5,61,16,45
2019,186399,0,0,580,354,226
2019,186399,10,0,580,354,226
2019,186399,10,1,201,136,65
2019,186399,10,2,150,91,59
2019,186399,10,3,196,114,82
2019,186399,10,4,28,10,18
2019,186399,10,5,5,3,2
2019,186399,20,0,290,192,98
2019,186399,20,1,176,125,51
2019,186399,20,2,114,67,47
2019,186399,30,0,111,60,51
2019,186399,30,1,9,3,6
2019,186399,30,2,14,10,4
2019,186399,30,3,88,47,41
2019,186399,40,0,179,102,77
2019,186399,40,1,16,8,8
2019,186399,40,2,22,14,8
2019,186399,40,3,108,67,41
2019,186399,40,4,28,10,18
2019,186399,40,5,5,3,2
2019,186399,41,0,179,102,77
2019,186399,41,1,16,8,8
2019,186399,41,2,22,14,8
2019,186399,41,3,108,67,41
2019,186399,41,4,28,10,18
2019,186399,41,5,5,3,2
2019,186399,44,0,179,102,77
2019,186399,44,1,16,8,8
2019,186399,44,2,22,14,8
2019,186399,44,3,108,67,41
2019,186399,44,4,28,10,18
2019,186399,44,5,5,3,2
2019,186432,0,0,114,55,59
2019,186432,10,0,114,55,59
2019,186432,10,1,29,16,13
2019,186432,10,2,34,18,16
2019,186432,10,3,33,15,18
2019,186432,10,4,8,3,5
2019,186432,10,5,7,3,4
2019,186432,10,6,3,0,3
2019,186432,20,0,65,34,31
2019,186432,20,1,29,16,13
2019,186432,20,2,30,14,16
2019,186432,20,3,5,4,1
2019,186432,20,5,1,0,1
2019,186432,30,0,30,14,16
2019,186432,30,2,4,4,0
2019,186432,30,3,25,10,15
2019,186432,30,4,1,0,1
2019,186432,40,0,19,7,12
2019,186432,40,3,3,1,2
2019,186432,40,4,7,3,4
2019,186432,40,5,6,3,3
2019,186432,40,6,3,0,3
2019,186432,42,0,19,7,12
2019,186432,42,3,3,1,2
2019,186432,42,4,7,3,4
2019,186432,42,5,6,3,3
2019,186432,42,6,3,0,3
2019,186469,0,0,16,7,9
2019,186469,10,0,16,7,9
2019,186469,10,1,1,1,0
2019,186469,10,2,7,4,3
2019,186469,10,3,6,1,5
2019,186469,10,4,1,0,1
2019,186469,10,6,1,1,0
2019,186469,20,0,11,6,5
2019,186469,20,1,1,1,0
2019,186469,20,2,6,4,2
2019,186469,20,3,4,1,3
2019,186469,30,0,4,0,4
2019,186469,30,2,1,0,1
2019,186469,30,3,2,0,2
2019,186469,30,4,1,0,1
2019,186469,40,0,1,1,0
2019,186469,40,6,1,1,0
2019,186469,42,0,1,1,0
2019,186469,42,6,1,1,0
2019,186584,0,0,495,253,242
2019,186584,10,0,495,253,242
2019,186584,10,1,118,70,48
2019,186584,10,2,153,83,70
2019,186584,10,3,96,37,59
2019,186584,10,4,40,11,29
2019,186584,10,5,19,10,9
2019,186584,10,6,69,42,27
2019,186584,20,0,223,130,93
2019,186584,20,1,110,65,45
2019,186584,20,2,112,64,48
2019,186584,20,3,1,1,0
2019,186584,30,0,63,32,31
2019,186584,30,2,9,4,5
2019,186584,30,3,54,28,26
2019,186584,40,0,209,91,118
2019,186584,40,1,8,5,3
2019,186584,40,2,32,15,17
2019,186584,40,3,41,8,33
2019,186584,40,4,40,11,29
2019,186584,40,5,19,10,9
2019,186584,40,6,69,42,27
2019,186584,41,0,98,43,55
2019,186584,41,1,8,5,3
2019,186584,41,2,23,13,10
2019,186584,41,3,27,7,20
2019,186584,41,4,12,1,11
2019,186584,41,6,28,17,11
2019,186584,42,0,111,48,63
2019,186584,42,2,9,2,7
2019,186584,42,3,14,1,13
2019,186584,42,4,28,10,18
2019,186584,42,5,19,10,9
2019,186584,42,6,41,25,16
2019,186584,44,0,27,16,11
2019,186584,44,6,27,16,11
2019,186584,45,0,71,27,44
2019,186584,45,1,8,5,3
2019,186584,45,2,23,13,10
2019,186584,45,3,27,7,20
2019,186584,45,4,12,1,11
2019,186584,45,6,1,1,0
2019,186618,0,0,57,13,44
2019,186618,10,0,57,13,44
2019,186618,10,1,16,7,9
2019,186618,10,2,7,2,5
2019,186618,10,3,28,4,24
2019,186618,10,4,6,0,6
2019,186618,20,0,21,8,13
2019,186618,20,1,16,7,9
2019,186618,20,2,4,0,4
2019,186618,20,3,1,1,0
2019,186618,30,0,6,1,5
2019,186618,30,2,2,1,1
2019,186618,30,3,4,0,4
2019,186618,40,0,30,4,26
2019,186618,40,2,1,1,0
2019,186618,40,3,23,3,20
2019,186618,40,4,6,0,6
2019,186618,42,0,30,4,26
2019,186618,42,2,1,1,0
2019,186618,42,3,23,3,20
2019,186618,42,4,6,0,6
2019,186645,0,0,123,55,68
2019,186645,10,0,123,55,68
2019,186645,10,1,37,15,22
2019,186645,10,2,37,15,22
2019,186645,10,3,33,16,17
2019,186645,10,4,16,9,7
2019,186645,20,0,91,40,51
2019,186645,20,1,37,15,22
2019,186645,20,2,37,15,22
2019,186645,20,3,14,9,5
2019,186645,20,4,3,1,2
2019,186645,30,0,27,13,14
2019,186645,30,3,19,7,12
2019,186645,30,4,8,6,2
2019,186645,40,0,5,2,3
2019,186645,40,4,5,2,3
2019,186645,42,0,4,1,3
2019,186645,42,4,4,1,3
2019,186645,43,0,1,1,0
2019,186645,43,4,1,1,0
2019,186867,0,0,299,218,81
2019,186867,10,0,299,218,81
2019,186867,10,1,69,60,9
2019,186867,10,2,96,66,30
2019,186867,10,3,111,76,35
2019,186867,10,5,23,16,7
2019,186867,20,0,93,71,22
2019,186867,20,1,45,41,4
2019,186867,20,2,48,30,18
2019,186867,30,0,99,68,31
2019,186867,30,1,2,2,0
2019,186867,30,2,9,6,3
2019,186867,30,3,88,60,28
2019,186867,40,0,107,79,28
2019,186867,40,1,22,17,5
2019,186867,40,2,39,30,9
2019,186867,40,3,23,16,7
2019,186867,40,5,23,16,7
2019,186867,41,0,107,79,28
2019,186867,41,1,22,17,5
2019,186867,41,2,39,30,9
2019,186867,41,3,23,16,7
2019,186867,41,5,23,16,7
2019,186867,44,0,107,79,28
2019,186867,44,1,22,17,5
2019,186867,44,2,39,30,9
2019,186867,44,3,23,16,7
2019,186867,44,5,23,16,7
2019,186876,0,0,352,155,197
2019,186876,10,0,352,155,197
2019,186876,10,1,82,38,44
2019,186876,10,2,116,55,61
2019,186876,10,3,134,54,80
2019,186876,10,4,20,8,12
2019,186876,20,0,205,97,108
2019,186876,20,1,82,38,44
2019,186876,20,2,114,54,60
2019,186876,20,3,8,4,4
2019,186876,20,4,1,1,0
2019,186876,30,0,110,43,67
2019,186876,30,2,2,1,1
2019,186876,30,3,101,40,61
2019,186876,30,4,7,2,5
2019,186876,40,0,37,15,22
2019,186876,40,3,25,10,15
2019,186876,40,4,12,5,7
2019,186876,42,0,35,14,21
2019,186876,42,3,24,9,15
2019,186876,42,4,11,5,6
2019,186876,43,0,2,1,1
2019,186876,43,3,1,1,0
2019,186876,43,4,1,0,1
2019,187134,0,0,373,174,199
2019,187134,10,0,373,174,199
2019,187134,10,1,139,65,74
2019,187134,10,2,128,60,68
2019,187134,10,3,105,49,56
2019,187134,10,4,1,0,1
2019,187134,20,0,265,122,143
2019,187134,20,1,138,65,73
2019,187134,20,2,112,51,61
2019,187134,20,3,15,6,9
2019,187134,30,0,85,39,46
2019,187134,30,1,1,0,1
2019,187134,30,2,15,8,7
2019,187134,30,3,69,31,38
2019,187134,40,0,23,13,10
2019,187134,40,2,1,1,0
2019,187134,40,3,21,12,9
2019,187134,40,4,1,0,1
2019,187134,42,0,23,13,10
2019,187134,42,2,1,1,0
2019,187134,42,3,21,12,9
2019,187134,42,4,1,0,1
2019,187198,0,0,102,40,62
2019,187198,10,0,102,40,62
2019,187198,10,1,43,20,23
2019,187198,10,2,37,12,25
2019,187198,10,3,22,8,14
2019,187198,20,0,102,40,62
2019,187198,20,1,43,20,23
2019,187198,20,2,37,12,25
2019,187198,20,3,22,8,14
2019,187444,0,0,391,189,202
2019,187444,10,0,391,189,202
2019,187444,10,1,195,107,88
2019,187444,10,2,92,35,57
2019,187444,10,3,94,40,54
2019,187444,10,4,10,7,3
2019,187444,20,0,287,140,147
2019,187444,20,1,194,106,88
2019,187444,20,2,87,32,55
2019,187444,20,3,6,2,4
2019,187444,30,0,87,40,47
2019,187444,30,1,1,1,0
2019,187444,30,2,5,3,2
2019,187444,30,3,78,34,44
2019,187444,30,4,3,2,1
2019,187444,40,0,17,9,8
2019,187444,40,3,10,4,6
2019,187444,40,4,7,5,2
2019,187444,42,0,17,9,8
2019,187444,42,3,10,4,6
2019,187444,42,4,7,5,2
2019,187532,0,0,320,128,192
2019,187532,10,0,320,128,192
2019,187532,10,4,320,128,192
2019,187532,40,0,320,128,192
2019,187532,40,4,320,128,192
2019,187532,42,0,161,57,104
2019,187532,42,4,161,57,104
2019,187532,43,0,159,71,88
2019,187532,43,4,159,71,88
2019,187596,0,0,85,56,29
2019,187596,10,0,85,56,29
2019,187596,10,1,3,2,1
2019,187596,10,2,20,14,6
2019,187596,10,3,34,17,17
2019,187596,10,4,16,13,3
2019,187596,10,5,6,6,0
2019,187596,10,6,6,4,2
2019,187596,40,0,85,56,29
2019,187596,40,1,3,2,1
2019,187596,40,2,20,14,6
2019,187596,40,3,34,17,17
2019,187596,40,4,16,13,3
2019,187596,40,5,6,6,0
2019,187596,40,6,6,4,2
2019,187596,42,0,4,1,3
2019,187596,42,1,1,0,1
2019,187596,42,2,1,0,1
2019,187596,42,4,1,1,0
2019,187596,42,6,1,0,1
2019,187596,43,0,81,55,26
2019,187596,43,1,2,2,0
2019,187596,43,2,19,14,5
2019,187596,43,3,34,17,17
2019,187596,43,4,15,12,3
2019,187596,43,5,6,6,0
2019,187596,43,6,5,4,1
2019,187620,0,0,125,62,63
2019,187620,10,0,125,62,63
2019,187620,10,1,37,16,21
2019,187620,10,2,21,10,11
2019,187620,10,3,38,20,18
2019,187620,10,4,28,16,12
2019,187620,10,6,1,0,1
2019,187620,20,0,70,35,35
2019,187620,20,1,37,16,21
2019,187620,20,2,20,9,11
2019,187620,20,3,13,10,3
2019,187620,30,0,51,24,27
2019,187620,30,3,25,10,15
2019,187620,30,4,26,14,12
2019,187620,40,0,4,3,1
2019,187620,40,2,1,1,0
2019,187620,40,4,2,2,0
2019,187620,40,6,1,0,1
2019,187620,41,0,1,0,1
2019,187620,41,6,1,0,1
2019,187620,42,0,3,3,0
2019,187620,42,2,1,1,0
2019,187620,42,4,2,2,0
2019,187620,44,0,1,0,1
2019,187620,44,6,1,0,1
2019,187639,0,0,56,16,40
2019,187639,10,0,56,16,40
2019,187639,10,4,56,16,40
2019,187639,40,0,56,16,40
2019,187639,40,4,56,16,40
2019,187639,42,0,56,16,40
2019,187639,42,4,56,16,40
2019,187648,0,0,163,87,76
2019,187648,10,0,163,87,76
2019,187648,10,1,33,22,11
2019,187648,10,2,19,8,11
2019,187648,10,3,69,44,25
2019,187648,10,4,42,13,29
2019,187648,20,0,52,30,22
2019,187648,20,1,32,21,11
2019,187648,20,2,17,7,10
2019,187648,20,4,3,2,1
2019,187648,30,0,69,45,24
2019,187648,30,2,2,1,1
2019,187648,30,3,67,44,23
2019,187648,40,0,42,12,30
2019,187648,40,1,1,1,0
2019,187648,40,3,2,0,2
2019,187648,40,4,39,11,28
2019,187648,41,0,1,1,0
2019,187648,41,1,1,1,0
2019,187648,42,0,40,11,29
2019,187648,42,3,1,0,1
2019,187648,42,4,39,11,28
2019,187648,43,0,1,0,1
2019,187648,43,3,1,0,1
2019,187648,44,0,1,1,0
2019,187648,44,1,1,1,0
2019,187666,0,0,45,26,19
2019,187666,10,0,45,26,19
2019,187666,10,4,45,26,19
2019,187666,20,0,19,13,6
2019,187666,20,4,19,13,6
2019,187666,30,0,14,7,7
2019,187666,30,4,14,7,7
2019,187666,40,0,12,6,6
2019,187666,40,4,12,6,6
2019,187666,42,0,6,3,3
2019,187666,42,4,6,3,3
2019,187666,43,0,6,3,3
2019,187666,43,4,6,3,3
2019,187745,0,0,26,14,12
2019,187745,10,0,26,14,12
2019,187745,10,2,6,4,2
2019,187745,10,3,20,10,10
2019,187745,40,0,26,14,12
2019,187745,40,2,6,4,2
2019,187745,40,3,20,10,10
2019,187745,41,0,26,14,12
2019,187745,41,2,6,4,2
2019,187745,41,3,20,10,10
2019,187745,44,0,26,14,12
2019,187745,44,2,6,4,2
2019,187745,44,3,20,10,10
2019,187897,0,0,132,66,66
2019,187897,10,0,132,66,66
2019,187897,10,1,25,14,11
2019,187897,10,2,33,20,13
2019,187897,10,3,30,13,17
2019,187897,10,4,44,19,25
2019,187897,20,0,56,32,24
2019,187897,20,1,25,14,11
2019,187897,20,2,30,17,13
2019,187897,20,3,1,1,0
2019,187897,30,0,28,12,16
2019,187897,30,2,3,3,0
2019,187897,30,3,25,9,16
2019,187897,40,0,48,22,26
2019,187897,40,3,4,3,1
2019,187897,40,4,44,19,25
2019,187897,42,0,48,22,26
2019,187897,42,3,4,3,1
2019,187897,42,4,44,19,25
2019,187903,0,0,71,28,43
2019,187903,10,0,71,28,43
2019,187903,10,1,71,28,43
2019,187903,40,0,71,28,43
2019,187903,40,1,71,28,43
2019,187903,42,0,71,28,43
2019,187903,42,1,71,28,43
2019,187912,0,0,82,50,32
2019,187912,10,0,82,50,32
2019,187912,10,1,14,9,5
2019,187912,10,2,22,14,8
2019,187912,10,3,21,8,13
2019,187912,10,4,25,19,6
2019,187912,20,0,43,23,20
2019,187912,20,1,14,9,5
2019,187912,20,2,18,11,7
2019,187912,20,3,11,3,8
2019,187912,30,0,20,11,9
2019,187912,30,2,4,3,1
2019,187912,30,3,10,5,5
2019,187912,30,4,6,3,3
2019,187912,40,0,19,16,3
2019,187912,40,4,19,16,3
2019,187912,42,0,19,16,3
2019,187912,42,4,19,16,3
2019,187958,0,0,59,29,30
2019,187958,10,0,59,29,30
2019,187958,10,1,3,2,1
2019,187958,10,2,13,7,6
2019,187958,10,3,12,4,8
2019,187958,10,5,31,16,15
2019,187958,20,0,16,9,7
2019,187958,20,1,3,2,1
2019,187958,20,2,13,7,6
2019,187958,30,0,11,4,7
2019,187958,30,3,11,4,7
2019,187958,40,0,32,16,16
2019,187958,40,3,1,0,1
2019,187958,40,5,31,16,15
2019,187958,42,0,32,16,16
2019,187958,42,3,1,0,1
2019,187958,42,5,31,16,15
2019,187967,0,0,131,104,27
2019,187967,10,0,129,103,26
2019,187967,10,1,42,35,7
2019,187967,10,2,38,31,7
2019,187967,10,3,39,33,6
2019,187967,10,4,9,4,5
2019,187967,10,5,1,0,1
2019,187967,20,0,76,62,14
2019,187967,20,1,40,33,7
2019,187967,20,2,36,29,7
2019,187967,30,0,37,31,6
2019,187967,30,2,1,1,0
2019,187967,30,3,36,30,6
2019,187967,40,0,16,10,6
2019,187967,40,1,2,2,0
2019,187967,40,2,1,1,0
2019,187967,40,3,3,3,0
2019,187967,40,4,9,4,5
2019,187967,40,5,1,0,1
2019,187967,41,0,13,7,6
2019,187967,41,2,1,1,0
2019,187967,41,3,2,2,0
2019,187967,41,4,9,4,5
2019,187967,41,5,1,0,1
2019,187967,42,0,3,3,0
2019,187967,42,1,2,2,0
2019,187967,42,3,1,1,0
2019,187967,45,0,13,7,6
2019,187967,45,2,1,1,0
2019,187967,45,3,2,2,0
2019,187967,45,4,9,4,5
2019,187967,45,5,1,0,1
2019,187967,50,0,2,1,1
2019,187976,0,0,6,2,4
2019,187976,10,0,6,2,4
2019,187976,10,2,1,0,1
2019,187976,10,5,5,2,3
2019,187976,20,0,1,0,1
2019,187976,20,2,1,0,1
2019,187976,40,0,5,2,3
2019,187976,40,5,5,2,3
2019,187976,42,0,5,2,3
2019,187976,42,5,5,2,3
2019,187985,0,0,1726,855,871
2019,187985,10,0,1726,855,871
2019,187985,10,1,407,253,154
2019,187985,10,2,496,248,248
2019,187985,10,3,549,254,295
2019,187985,10,4,64,28,36
2019,187985,10,5,209,71,138
2019,187985,10,6,1,1,0
2019,187985,20,0,591,345,246
2019,187985,20,1,296,186,110
2019,187985,20,2,294,158,136
2019,187985,20,3,1,1,0
2019,187985,30,0,253,119,134
2019,187985,30,1,3,2,1
2019,187985,30,2,19,6,13
2019,187985,30,3,231,111,120
2019,187985,40,0,882,391,491
2019,187985,40,1,108,65,43
2019,187985,40,2,183,84,99
2019,187985,40,3,317,142,175
2019,187985,40,4,64,28,36
2019,187985,40,5,209,71,138
2019,187985,40,6,1,1,0
2019,187985,42,0,882,391,491
2019,187985,42,1,108,65,43
2019,187985,42,2,183,84,99
2019,187985,42,3,317,142,175
2019,187985,42,4,64,28,36
2019,187985,42,5,209,71,138
2019,187985,42,6,1,1,0
2019,187994,0,0,31,14,17
2019,187994,10,0,31,14,17
2019,187994,10,1,17,8,9
2019,187994,10,2,8,3,5
2019,187994,10,3,5,2,3
2019,187994,10,4,1,1,0
2019,187994,20,0,20,9,11
2019,187994,20,1,13,6,7
2019,187994,20,2,4,2,2
2019,187994,20,3,3,1,2
2019,187994,30,0,2,1,1
2019,187994,30,1,1,1,0
2019,187994,30,2,1,0,1
2019,187994,40,0,9,4,5
2019,187994,40,1,3,1,2
2019,187994,40,2,3,1,2
2019,187994,40,3,2,1,1
2019,187994,40,4,1,1,0
2019,187994,42,0,9,4,5
2019,187994,42,1,3,1,2
2019,187994,42,2,3,1,2
2019,187994,42,3,2,1,1
2019,187994,42,4,1,1,0
2019,188003,0,0,34,19,15
2019,188003,10,0,34,19,15
2019,188003,10,1,9,7,2
2019,188003,10,2,6,4,2
2019,188003,10,3,6,4,2
2019,188003,10,4,13,4,9
2019,188003,20,0,13,9,4
2019,188003,20,1,9,7,2
2019,188003,20,2,3,1,2
2019,188003,20,3,1,1,0
2019,188003,30,0,12,5,7
2019,188003,30,2,3,3,0
2019,188003,30,3,3,2,1
2019,188003,30,4,6,0,6
2019,188003,40,0,9,5,4
2019,188003,40,3,2,1,1
2019,188003,40,4,7,4,3
2019,188003,42,0,9,5,4
2019,188003,42,3,2,1,1
2019,188003,42,4,7,4,3
2019,188021,0,0,14,6,8
2019,188021,10,0,14,6,8
2019,188021,10,1,3,1,2
2019,188021,10,2,6,3,3
2019,188021,10,3,1,0,1
2019,188021,10,4,3,1,2
2019,188021,10,6,1,1,0
2019,188021,20,0,8,4,4
2019,188021,20,1,3,1,2
2019,188021,20,2,5,3,2
2019,188021,30,0,1,0,1
2019,188021,30,3,1,0,1
2019,188021,40,0,5,2,3
2019,188021,40,2,1,0,1
2019,188021,40,4,3,1,2
2019,188021,40,6,1,1,0
2019,188021,41,0,1,1,0
2019,188021,41,6,1,1,0
2019,188021,42,0,4,1,3
2019,188021,42,2,1,0,1
2019,188021,42,4,3,1,2
2019,188021,44,0,1,1,0
2019,188021,44,6,1,1,0
2019,188030,0,0,628,349,279
2019,188030,10,0,628,349,279
2019,188030,10,1,202,136,66
2019,188030,10,2,190,103,87
2019,188030,10,3,202,97,105
2019,188030,10,4,5,3,2
2019,188030,10,6,29,10,19
2019,188030,20,0,351,226,125
2019,188030,20,1,182,126,56
2019,188030,20,2,163,98,65
2019,188030,20,3,6,2,4
2019,188030,30,0,142,77,65
2019,188030,30,2,3,1,2
2019,188030,30,3,139,76,63
2019,188030,40,0,135,46,89
2019,188030,40,1,20,10,10
2019,188030,40,2,24,4,20
2019,188030,40,3,57,19,38
2019,188030,40,4,5,3,2
2019,188030,40,6,29,10,19
2019,188030,41,0,29,10,19
2019,188030,41,6,29,10,19
2019,188030,42,0,106,36,70
2019,188030,42,1,20,10,10
2019,188030,42,2,24,4,20
2019,188030,42,3,57,19,38
2019,188030,42,4,5,3,2
2019,188030,44,0,29,10,19
2019,188030,44,6,29,10,19
2019,188049,0,0,34,14,20
2019,188049,10,0,34,14,20
2019,188049,10,1,2,0,2
2019,188049,10,2,5,1,4
2019,188049,10,3,12,7,5
2019,188049,10,5,15,6,9
2019,188049,20,0,7,1,6
2019,188049,20,1,2,0,2
2019,188049,20,2,5,1,4
2019,188049,30,0,11,7,4
2019,188049,30,3,11,7,4
2019,188049,40,0,16,6,10
2019,188049,40,3,1,0,1
2019,188049,40,5,15,6,9
2019,188049,42,0,16,6,10
2019,188049,42,3,1,0,1
2019,188049,42,5,15,6,9
2019,188058,0,0,46,15,31
2019,188058,10,0,46,15,31
2019,188058,10,2,18,6,12
2019,188058,10,3,22,7,15
2019,188058,10,4,3,1,2
2019,188058,10,5,3,1,2
2019,188058,20,0,18,6,12
2019,188058,20,2,18,6,12
2019,188058,30,0,22,7,15
2019,188058,30,3,22,7,15
2019,188058,40,0,6,2,4
2019,188058,40,4,3,1,2
2019,188058,40,5,3,1,2
2019,188058,42,0,6,2,4
2019,188058,42,4,3,1,2
2019,188058,42,5,3,1,2
2019,188100,0,0,151,76,75
2019,188100,10,0,151,76,75
2019,188100,10,1,21,14,7
2019,188100,10,2,25,11,14
2019,188100,10,3,64,29,35
2019,188100,10,4,41,22,19
2019,188100,40,0,151,76,75
2019,188100,40,1,21,14,7
2019,188100,40,2,25,11,14
2019,188100,40,3,64,29,35
2019,188100,40,4,41,22,19
2019,188100,42,0,151,76,75
2019,188100,42,1,21,14,7
2019,188100,42,2,25,11,14
2019,188100,42,3,64,29,35
2019,188100,42,4,41,22,19
2019,188137,0,0,74,43,31
2019,188137,10,0,74,43,31
2019,188137,10,1,3,1,2
2019,188137,10,2,10,6,4
2019,188137,10,3,61,36,25
2019,188137,40,0,74,43,31
2019,188137,40,1,3,1,2
2019,188137,40,2,10,6,4
2019,188137,40,3,61,36,25
2019,188137,41,0,53,32,21
2019,188137,41,1,3,1,2
2019,188137,41,2,10,6,4
2019,188137,41,3,40,25,15
2019,188137,42,0,21,11,10
2019,188137,42,3,21,11,10
2019,188137,45,0,53,32,21
2019,188137,45,1,3,1,2
2019,188137,45,2,10,6,4
2019,188137,45,3,40,25,15
2019,188182,0,0,27,10,17
2019,188182,10,0,27,10,17
2019,188182,10,1,3,1,2
2019,188182,10,2,5,2,3
2019,188182,10,3,13,5,8
2019,188182,10,4,5,1,4
2019,188182,10,5,1,1,0
2019,188182,40,0,27,10,17
2019,188182,40,1,3,1,2
2019,188182,40,2,5,2,3
2019,188182,40,3,13,5,8
2019,188182,40,4,5,1,4
2019,188182,40,5,1,1,0
2019,188182,42,0,27,10,17
2019,188182,42,1,3,1,2
2019,188182,42,2,5,2,3
2019,188182,42,3,13,5,8
2019,188182,42,4,5,1,4
2019,188182,42,5,1,1,0
2019,188207,0,0,4,0,4
2019,188207,10,0,4,0,4
2019,188207,10,4,4,0,4
2019,188207,40,0,4,0,4
2019,188207,40,4,4,0,4
2019,188207,41,0,4,0,4
2019,188207,41,4,4,0,4
2019,188207,45,0,4,0,4
2019,188207,45,4,4,0,4
2019,188216,0,0,20,12,8
2019,188216,10,0,19,11,8
2019,188216,10,4,19,11,8
2019,188216,40,0,19,11,8
2019,188216,40,4,19,11,8
2019,188216,41,0,19,11,8
2019,188216,41,4,19,11,8
2019,188216,45,0,19,11,8
2019,188216,45,4,19,11,8
2019,188216,50,0,1,1,0
2019,188225,0,0,19,8,11
2019,188225,10,0,19,8,11
2019,188225,10,2,3,3,0
2019,188225,10,3,2,1,1
2019,188225,10,4,7,4,3
2019,188225,10,5,7,0,7
2019,188225,20,0,3,3,0
2019,188225,20,2,3,3,0
2019,188225,30,0,2,1,1
2019,188225,30,3,2,1,1
2019,188225,40,0,14,4,10
2019,188225,40,4,7,4,3
2019,188225,40,5,7,0,7
2019,188225,42,0,14,4,10
2019,188225,42,4,7,4,3
2019,188225,42,5,7,0,7
2019,188261,0,0,15,13,2
2019,188261,10,0,15,13,2
2019,188261,10,4,15,13,2
2019,188261,40,0,15,13,2
2019,188261,40,4,15,13,2
2019,188261,42,0,15,13,2
2019,188261,42,4,15,13,2
2019,188304,0,0,92,44,48
2019,188304,10,0,92,44,48
2019,188304,10,1,17,11,6
2019,188304,10,2,31,13,18
2019,188304,10,3,34,13,21
2019,188304,10,4,10,7,3
2019,188304,20,0,43,22,21
2019,188304,20,1,17,11,6
2019,188304,20,2,26,11,15
2019,188304,30,0,36,15,21
2019,188304,30,2,5,2,3
2019,188304,30,3,30,13,17
2019,188304,30,4,1,0,1
2019,188304,40,0,13,7,6
2019,188304,40,3,4,0,4
2019,188304,40,4,9,7,2
2019,188304,42,0,13,7,6
2019,188304,42,3,4,0,4
2019,188304,42,4,9,7,2
2019,188340,0,0,40,30,10
2019,188340,10,0,40,30,10
2019,188340,10,1,11,8,3
2019,188340,10,2,9,7,2
2019,188340,10,3,15,10,5
2019,188340,10,4,5,5,0
2019,188340,20,0,16,12,4
2019,188340,20,1,11,8,3
2019,188340,20,2,5,4,1
2019,188340,30,0,9,5,4
2019,188340,30,2,2,1,1
2019,188340,30,3,7,4,3
2019,188340,40,0,15,13,2
2019,188340,40,2,2,2,0
2019,188340,40,3,8,6,2
2019,188340,40,4,5,5,0
2019,188340,42,0,15,13,2
2019,188340,42,2,2,2,0
2019,188340,42,3,8,6,2
2019,188340,42,4,5,5,0
2019,188429,0,0,361,165,196
2019,188429,10,0,361,165,196
2019,188429,10,1,93,52,41
2019,188429,10,2,132,60,72
2019,188429,10,3,74,33,41
2019,188429,10,4,11,2,9
2019,188429,10,5,19,7,12
2019,188429,10,6,32,11,21
2019,188429,20,0,224,111,113
2019,188429,20,1,93,52,41
2019,188429,20,2,129,58,71
2019,188429,20,3,2,1,1
2019,188429,30,0,75,34,41
2019,188429,30,2,3,2,1
2019,188429,30,3,72,32,40
2019,188429,40,0,62,20,42
2019,188429,40,4,11,2,9
2019,188429,40,5,19,7,12
2019,188429,40,6,32,11,21
2019,188429,41,0,51,18,33
2019,188429,41,5,19,7,12
2019,188429,41,6,32,11,21
2019,188429,42,0,11,2,9
2019,188429,42,4,11,2,9
2019,188429,44,0,51,18,33
2019,188429,44,5,19,7,12
2019,188429,44,6,32,11,21
2019,188438,0,0,95,48,47
2019,188438,10,0,95,48,47
2019,188438,10,1,34,18,16
2019,188438,10,2,23,15,8
2019,188438,10,3,21,7,14
2019,188438,10,4,15,8,7
2019,188438,10,6,2,0,2
2019,188438,20,0,67,39,28
2019,188438,20,1,33,17,16
2019,188438,20,2,22,15,7
2019,188438,20,3,10,5,5
2019,188438,20,4,2,2,0
2019,188438,30,0,25,9,16
2019,188438,30,1,1,1,0
2019,188438,30,2,1,0,1
2019,188438,30,3,11,2,9
2019,188438,30,4,12,6,6
2019,188438,40,0,3,0,3
2019,188438,40,4,1,0,1
2019,188438,40,6,2,0,2
2019,188438,42,0,1,0,1
2019,188438,42,4,1,0,1
2019,188438,43,0,2,0,2
2019,188438,43,6,2,0,2
2019,188517,0,0,9,6,3
2019,188517,10,0,9,6,3
2019,188517,10,4,9,6,3
2019,188517,40,0,9,6,3
2019,188517,40,4,9,6,3
2019,188517,41,0,9,6,3
2019,188517,41,4,9,6,3
2019,188517,45,0,9,6,3
2019,188517,45,4,9,6,3
2019,188526,0,0,89,46,43
2019,188526,10,0,89,46,43
2019,188526,10,1,7,4,3
2019,188526,10,2,38,24,14
2019,188526,10,3,28,11,17
2019,188526,10,4,16,7,9
2019,188526,20,0,29,19,10
2019,188526,20,1,3,3,0
2019,188526,20,2,26,16,10
2019,188526,30,0,9,7,2
2019,188526,30,2,1,0,1
2019,188526,30,3,8,7,1
2019,188526,40,0,51,20,31
2019,188526,40,1,4,1,3
2019,188526,40,2,11,8,3
2019,188526,40,3,20,4,16
2019,188526,40,4,16,7,9
2019,188526,41,0,30,13,17
2019,188526,41,1,3,1,2
2019,188526,41,2,8,6,2
2019,188526,41,3,10,2,8
2019,188526,41,4,9,4,5
2019,188526,42,0,21,7,14
2019,188526,42,1,1,0,1
2019,188526,42,2,3,2,1
2019,188526,42,3,10,2,8
2019,188526,42,4,7,3,4
2019,188526,44,0,30,13,17
2019,188526,44,1,3,1,2
2019,188526,44,2,8,6,2
2019,188526,44,3,10,2,8
2019,188526,44,4,9,4,5
2019,188535,0,0,38,21,17
2019,188535,10,0,38,21,17
2019,188535,10,1,26,14,12
2019,188535,10,2,4,2,2
2019,188535,10,3,8,5,3
2019,188535,20,0,23,14,9
2019,188535,20,1,22,13,9
2019,188535,20,2,1,1,0
2019,188535,30,0,5,2,3
2019,188535,30,2,3,1,2
2019,188535,30,3,2,1,1
2019,188535,40,0,10,5,5
2019,188535,40,1,4,1,3
2019,188535,40,3,6,4,2
2019,188535,41,0,4,1,3
2019,188535,41,1,3,1,2
2019,188535,41,3,1,0,1
2019,188535,42,0,6,4,2
2019,188535,42,1,1,0,1
2019,188535,42,3,5,4,1
2019,188535,44,0,4,1,3
2019,188535,44,1,3,1,2
2019,188535,44,3,1,0,1
2019,188580,0,0,566,336,230
2019,188580,10,0,331,206,125
2019,188580,10,1,77,59,18
2019,188580,10,2,89,59,30
2019,188580,10,3,118,63,55
2019,188580,10,4,21,9,12
2019,188580,10,6,26,16,10
2019,188580,20,0,29,23,6
2019,188580,20,1,22,18,4
2019,188580,20,3,1,1,0
2019,188580,20,6,6,4,2
2019,188580,30,0,108,68,40
2019,188580,30,1,23,17,6
2019,188580,30,2,42,28,14
2019,188580,30,3,30,15,15
2019,188580,30,6,13,8,5
2019,188580,40,0,194,115,79
2019,188580,40,1,32,24,8
2019,188580,40,2,47,31,16
2019,188580,40,3,87,47,40
2019,188580,40,4,21,9,12
2019,188580,40,6,7,4,3
2019,188580,41,0,165,103,62
2019,188580,41,1,32,24,8
2019,188580,41,2,46,30,16
2019,188580,41,3,80,45,35
2019,188580,41,6,7,4,3
2019,188580,42,0,29,12,17
2019,188580,42,2,1,1,0
2019,188580,42,3,7,2,5
2019,188580,42,4,21,9,12
2019,188580,44,0,165,103,62
2019,188580,44,1,32,24,8
2019,188580,44,2,46,30,16
2019,188580,44,3,80,45,35
2019,188580,44,6,7,4,3
2019,188580,50,0,235,130,105
2019,188641,0,0,156,84,72
2019,188641,10,0,156,84,72
2019,188641,10,1,60,36,24
2019,188641,10,2,28,16,12
2019,188641,10,3,55,26,29
2019,188641,10,4,3,1,2
2019,188641,10,5,2,0,2
2019,188641,10,6,8,5,3
2019,188641,20,0,85,51,34
2019,188641,20,1,59,36,23
2019,188641,20,2,25,15,10
2019,188641,20,3,1,0,1
2019,188641,30,0,49,25,24
2019,188641,30,1,1,0,1
2019,188641,30,2,2,0,2
2019,188641,30,3,45,25,20
2019,188641,30,4,1,0,1
2019,188641,40,0,22,8,14
2019,188641,40,2,1,1,0
2019,188641,40,3,9,1,8
2019,188641,40,4,2,1,1
2019,188641,40,5,2,0,2
2019,188641,40,6,8,5,3
2019,188641,41,0,9,2,7
2019,188641,41,2,1,1,0
2019,188641,41,3,4,0,4
2019,188641,41,4,1,1,0
2019,188641,41,5,2,0,2
2019,188641,41,6,1,0,1
2019,188641,42,0,12,5,7
2019,188641,42,3,5,1,4
2019,188641,42,4,1,0,1
2019,188641,42,6,6,4,2
2019,188641,43,0,1,1,0
2019,188641,43,6,1,1,0
2019,188641,44,0,9,2,7
2019,188641,44,2,1,1,0
2019,188641,44,3,4,0,4
2019,188641,44,4,1,1,0
2019,188641,44,5,2,0,2
2019,188641,44,6,1,0,1
2019,188678,0,0,10,4,6
2019,188678,10,0,10,4,6
2019,188678,10,6,10,4,6
2019,188678,40,0,10,4,6
2019,188678,40,6,10,4,6
2019,188678,43,0,10,4,6
2019,188678,43,6,10,4,6
2019,188854,0,0,102,63,39
2019,188854,10,0,102,63,39
2019,188854,10,4,102,63,39
2019,188854,40,0,102,63,39
2019,188854,40,4,102,63,39
2019,188854,41,0,102,63,39
2019,188854,41,4,102,63,39
2019,188854,45,0,102,63,39
2019,188854,45,4,102,63,39
2019,189015,0,0,29,5,24
2019,189015,10,0,25,5,20
2019,189015,10,6,25,5,20
2019,189015,40,0,25,5,20
2019,189015,40,6,25,5,20
2019,189015,41,0,1,0,1
2019,189015,41,6,1,0,1
2019,189015,42,0,24,5,19
2019,189015,42,6,24,5,19
2019,189015,45,0,1,0,1
2019,189015,45,6,1,0,1
2019,189015,50,0,4,0,4
2019,189088,0,0,200,113,87
2019,189088,10,0,200,113,87
2019,189088,10,1,50,31,19
2019,189088,10,2,69,35,34
2019,189088,10,3,80,47,33
2019,189088,10,4,1,0,1
2019,189088,20,0,95,55,40
2019,189088,20,1,42,28,14
2019,189088,20,2,53,27,26
2019,189088,30,0,54,33,21
2019,189088,30,2,1,0,1
2019,189088,30,3,53,33,20
2019,189088,40,0,51,25,26
2019,189088,40,1,8,3,5
2019,189088,40,2,15,8,7
2019,189088,40,3,27,14,13
2019,189088,40,4,1,0,1
2019,189088,41,0,51,25,26
2019,189088,41,1,8,3,5
2019,189088,41,2,15,8,7
2019,189088,41,3,27,14,13
2019,189088,41,4,1,0,1
2019,189088,44,0,51,25,26
2019,189088,44,1,8,3,5
2019,189088,44,2,15,8,7
2019,189088,44,3,27,14,13
2019,189088,44,4,1,0,1
2019,189097,0,0,251,92,159
2019,189097,10,0,251,92,159
2019,189097,10,1,98,45,53
2019,189097,10,2,26,9,17
2019,189097,10,3,50,18,32
2019,189097,10,4,46,14,32
2019,189097,10,5,31,6,25
2019,189097,20,0,115,52,63
2019,189097,20,1,92,44,48
2019,189097,20,2,23,8,15
2019,189097,30,0,46,17,29
2019,189097,30,3,46,17,29
2019,189097,40,0,90,23,67
2019,189097,40,1,6,1,5
2019,189097,40,2,3,1,2
2019,189097,40,3,4,1,3
2019,189097,40,4,46,14,32
2019,189097,40,5,31,6,25
2019,189097,41,0,48,12,36
2019,189097,41,1,6,1,5
2019,189097,41,2,3,1,2
2019,189097,41,3,4,1,3
2019,189097,41,4,17,7,10
2019,189097,41,5,18,2,16
2019,189097,42,0,41,11,30
2019,189097,42,4,28,7,21
2019,189097,42,5,13,4,9
2019,189097,43,0,1,0,1
2019,189097,43,4,1,0,1
2019,189097,44,0,47,12,35
2019,189097,44,1,6,1,5
2019,189097,44,2,3,1,2
2019,189097,44,3,4,1,3
2019,189097,44,4,16,7,9
2019,189097,44,5,18,2,16
2019,189097,45,0,1,0,1
2019,189097,45,4,1,0,1
2019,189228,0,0,59,28,31
2019,189228,10,0,59,28,31
2019,189228,10,6,59,28,31
2019,189228,40,0,59,28,31
2019,189228,40,6,59,28,31
2019,189228,42,0,58,28,30
2019,189228,42,6,58,28,30
2019,189228,43,0,1,0,1
2019,189228,43,6,1,0,1
2019,189282,0,0,5,0,5
2019,189282,10,0,5,0,5
2019,189282,10,1,2,0,2
2019,189282,10,2,2,0,2
2019,189282,10,3,1,0,1
2019,189282,40,0,5,0,5
2019,189282,40,1,2,0,2
2019,189282,40,2,2,0,2
2019,189282,40,3,1,0,1
2019,189282,41,0,5,0,5
2019,189282,41,1,2,0,2
2019,189282,41,2,2,0,2
2019,189282,41,3,1,0,1
2019,189282,44,0,5,0,5
2019,189282,44,1,2,0,2
2019,189282,44,2,2,0,2
2019,189282,44,3,1,0,1
2019,189413,0,0,39,14,25
2019,189413,10,0,39,14,25
2019,189413,10,1,3,2,1
2019,189413,10,2,7,3,4
2019,189413,10,3,16,6,10
2019,189413,10,4,13,3,10
2019,189413,40,0,39,14,25
2019,189413,40,1,3,2,1
2019,189413,40,2,7,3,4
2019,189413,40,3,16,6,10
2019,189413,40,4,13,3,10
2019,189413,41,0,6,1,5
2019,189413,41,1,1,0,1
2019,189413,41,2,4,1,3
2019,189413,41,3,1,0,1
2019,189413,42,0,29,12,17
2019,189413,42,1,2,2,0
2019,189413,42,2,3,2,1
2019,189413,42,3,15,6,9
2019,189413,42,4,9,2,7
2019,189413,43,0,4,1,3
2019,189413,43,4,4,1,3
2019,189413,44,0,6,1,5
2019,189413,44,1,1,0,1
2019,189413,44,2,4,1,3
2019,189413,44,3,1,0,1
2019,189501,0,0,65,24,41
2019,189501,10,0,65,24,41
2019,189501,10,1,36,21,15
2019,189501,10,2,9,1,8
2019,189501,10,3,20,2,18
2019,189501,20,0,33,19,14
2019,189501,20,1,33,19,14
2019,189501,30,0,6,1,5
2019,189501,30,2,2,0,2
2019,189501,30,3,4,1,3
2019,189501,40,0,26,4,22
2019,189501,40,1,3,2,1
2019,189501,40,2,7,1,6
2019,189501,40,3,16,1,15
2019,189501,41,0,14,2,12
2019,189501,41,1,3,2,1
2019,189501,41,2,4,0,4
2019,189501,41,3,7,0,7
2019,189501,42,0,12,2,10
2019,189501,42,2,3,1,2
2019,189501,42,3,9,1,8
2019,189501,44,0,14,2,12
2019,189501,44,1,3,2,1
2019,189501,44,2,4,0,4
2019,189501,44,3,7,0,7
2019,189547,0,0,162,72,90
2019,189547,10,0,162,72,90
2019,189547,10,1,62,34,28
2019,189547,10,2,46,18,28
2019,189547,10,3,29,8,21
2019,189547,10,4,3,1,2
2019,189547,10,6,22,11,11
2019,189547,20,0,118,56,62
2019,189547,20,1,62,34,28
2019,189547,20,2,46,18,28
2019,189547,20,3,10,4,6
2019,189547,30,0,22,5,17
2019,189547,30,3,19,4,15
2019,189547,30,4,3,1,2
2019,189547,40,0,22,11,11
2019,189547,40,6,22,11,11
2019,189547,43,0,22,11,11
2019,189547,43,6,22,11,11
2019,189565,0,0,27,11,16
2019,189565,10,0,27,11,16
2019,189565,10,4,27,11,16
2019,189565,40,0,27,11,16
2019,189565,40,4,27,11,16
2019,189565,41,0,27,11,16
2019,189565,41,4,27,11,16
2019,189565,45,0,27,11,16
2019,189565,45,4,27,11,16
2019,189583,0,0,32,12,20
2019,189583,10,0,31,12,19
2019,189583,10,4,31,12,19
2019,189583,40,0,31,12,19
2019,189583,40,4,31,12,19
2019,189583,41,0,31,12,19
2019,189583,41,4,31,12,19
2019,189583,45,0,31,12,19
2019,189583,45,4,31,12,19
2019,189583,50,0,1,0,1
2019,189592,0,0,13,7,6
2019,189592,10,0,13,7,6
2019,189592,10,4,13,7,6
2019,189592,40,0,13,7,6
2019,189592,40,4,13,7,6
2019,189592,41,0,13,7,6
2019,189592,41,4,13,7,6
2019,189592,45,0,13,7,6
2019,189592,45,4,13,7,6
2019,189705,0,0,150,87,63
2019,189705,10,0,150,87,63
2019,189705,10,1,52,34,18
2019,189705,10,2,58,32,26
2019,189705,10,3,32,18,14
2019,189705,10,4,8,3,5
2019,189705,20,0,109,66,43
2019,189705,20,1,52,34,18
2019,189705,20,2,57,32,25
2019,189705,30,0,26,13,13
2019,189705,30,2,1,0,1
2019,189705,30,3,25,13,12
2019,189705,40,0,15,8,7
2019,189705,40,3,7,5,2
2019,189705,40,4,8,3,5
2019,189705,42,0,15,8,7
2019,189705,42,3,7,5,2
2019,189705,42,4,8,3,5
2019,189811,0,0,17,4,13
2019,189811,10,0,17,4,13
2019,189811,10,4,17,4,13
2019,189811,40,0,17,4,13
2019,189811,40,4,17,4,13
2019,189811,41,0,17,4,13
2019,189811,41,4,17,4,13
2019,189811,45,0,17,4,13
2019,189811,45,4,17,4,13
2019,189839,0,0,43,20,23
2019,189839,10,0,43,20,23
2019,189839,10,1,26,13,13
2019,189839,10,2,8,4,4
2019,189839,10,3,7,2,5
2019,189839,10,4,2,1,1
2019,189839,20,0,35,18,17
2019,189839,20,1,26,13,13
2019,189839,20,2,8,4,4
2019,189839,20,3,1,1,0
2019,189839,30,0,8,2,6
2019,189839,30,3,6,1,5
2019,189839,30,4,2,1,1
2019,189848,0,0,54,20,34
2019,189848,10,0,54,20,34
2019,189848,10,1,22,9,13
2019,189848,10,2,14,3,11
2019,189848,10,3,8,2,6
2019,189848,10,4,10,6,4
2019,189848,20,0,33,12,21
2019,189848,20,1,22,9,13
2019,189848,20,2,11,3,8
2019,189848,30,0,11,2,9
2019,189848,30,2,3,0,3
2019,189848,30,3,8,2,6
2019,189848,40,0,10,6,4
2019,189848,40,4,10,6,4
2019,189848,42,0,10,6,4
2019,189848,42,4,10,6,4
2019,189857,0,0,17,17,0
2019,189857,10,0,17,17,0
2019,189857,10,4,17,17,0
2019,189857,40,0,17,17,0
2019,189857,40,4,17,17,0
2019,189857,42,0,17,17,0
2019,189857,42,4,17,17,0
2019,189981,0,0,7,7,0
2019,189981,10,0,7,7,0
2019,189981,10,1,2,2,0
2019,189981,10,3,5,5,0
2019,189981,40,0,7,7,0
2019,189981,40,1,2,2,0
2019,189981,40,3,5,5,0
2019,189981,41,0,7,7,0
2019,189981,41,1,2,2,0
2019,189981,41,3,5,5,0
2019,189981,44,0,7,7,0
2019,189981,44,1,2,2,0
2019,189981,44,3,5,5,0
2019,190044,0,0,239,154,85
2019,190044,10,0,239,154,85
2019,190044,10,1,53,42,11
2019,190044,10,2,64,44,20
2019,190044,10,3,98,51,47
2019,190044,10,4,13,7,6
2019,190044,10,6,11,10,1
2019,190044,20,0,105,79,26
2019,190044,20,1,52,42,10
2019,190044,20,2,53,37,16
2019,190044,30,0,67,40,27
2019,190044,30,2,2,2,0
2019,190044,30,3,65,38,27
2019,190044,40,0,67,35,32
2019,190044,40,1,1,0,1
2019,190044,40,2,9,5,4
2019,190044,40,3,33,13,20
2019,190044,40,4,13,7,6
2019,190044,40,6,11,10,1
2019,190044,41,0,56,25,31
2019,190044,41,1,1,0,1
2019,190044,41,2,9,5,4
2019,190044,41,3,33,13,20
2019,190044,41,4,12,6,6
2019,190044,41,6,1,1,0
2019,190044,42,0,7,7,0
2019,190044,42,4,1,1,0
2019,190044,42,6,6,6,0
2019,190044,43,0,4,3,1
2019,190044,43,6,4,3,1
2019,190044,45,0,56,25,31
2019,190044,45,1,1,0,1
2019,190044,45,2,9,5,4
2019,190044,45,3,33,13,20
2019,190044,45,4,12,6,6
2019,190044,45,6,1,1,0
2019,190053,0,0,37,17,20
2019,190053,10,0,37,17,20
2019,190053,10,1,19,6,13
2019,190053,10,2,6,3,3
2019,190053,10,3,11,7,4
2019,190053,10,4,1,1,0
2019,190053,20,0,33,13,20
2019,190053,20,1,19,6,13
2019,190053,20,2,6,3,3
2019,190053,20,3,8,4,4
2019,190053,30,0,3,3,0
2019,190053,30,3,3,3,0
2019,190053,40,0,1,1,0
2019,190053,40,4,1,1,0
2019,190053,42,0,1,1,0
2019,190053,42,4,1,1,0
2019,190071,0,0,8,1,7
2019,190071,10,0,7,1,6
2019,190071,10,4,7,1,6
2019,190071,40,0,7,1,6
2019,190071,40,4,7,1,6
2019,190071,41,0,7,1,6
2019,190071,41,4,7,1,6
2019,190071,44,0,7,1,6
2019,190071,44,4,7,1,6
2019,190071,50,0,1,0,1
2019,190080,0,0,5,3,2
2019,190080,10,0,5,3,2
2019,190080,10,1,4,2,2
2019,190080,10,2,1,1,0
2019,190080,20,0,3,1,2
2019,190080,20,1,3,1,2
2019,190080,30,0,1,1,0
2019,190080,30,2,1,1,0
2019,190080,40,0,1,1,0
2019,190080,40,1,1,1,0
2019,190080,41,0,1,1,0
2019,190080,41,1,1,1,0
2019,190080,44,0,1,1,0
2019,190080,44,1,1,1,0
2019,190099,0,0,348,194,154
2019,190099,10,0,344,193,151
2019,190099,10,1,107,70,37
2019,190099,10,2,78,41,37
2019,190099,10,3,119,66,53
2019,190099,10,4,14,5,9
2019,190099,10,5,26,11,15
2019,190099,20,0,185,111,74
2019,190099,20,1,107,70,37
2019,190099,20,2,78,41,37
2019,190099,30,0,75,42,33
2019,190099,30,3,75,42,33
2019,190099,40,0,84,40,44
2019,190099,40,3,44,24,20
2019,190099,40,4,14,5,9
2019,190099,40,5,26,11,15
2019,190099,42,0,84,40,44
2019,190099,42,3,44,24,20
2019,190099,42,4,14,5,9
2019,190099,42,5,26,11,15
2019,190099,50,0,4,1,3
2019,190114,0,0,20,11,9
2019,190114,10,0,20,11,9
2019,190114,10,1,11,6,5
2019,190114,10,2,8,5,3
2019,190114,10,3,1,0,1
2019,190114,40,0,20,11,9
2019,190114,40,1,11,6,5
2019,190114,40,2,8,5,3
2019,190114,40,3,1,0,1
2019,190114,41,0,20,11,9
2019,190114,41,1,11,6,5
2019,190114,41,2,8,5,3
2019,190114,41,3,1,0,1
2019,190114,44,0,20,11,9
2019,190114,44,1,11,6,5
2019,190114,44,2,8,5,3
2019,190114,44,3,1,0,1
2019,190150,0,0,4352,2414,1938
2019,190150,10,0,4352,2414,1938
2019,190150,10,1,1430,1014,416
2019,190150,10,2,708,410,298
2019,190150,10,3,1614,713,901
2019,190150,10,4,150,62,88
2019,190150,10,5,450,215,235
2019,190150,20,0,1172,844,328
2019,190150,20,1,981,722,259
2019,190150,20,2,191,122,69
2019,190150,30,0,578,352,226
2019,190150,30,1,41,30,11
2019,190150,30,2,106,71,35
2019,190150,30,3,414,242,172
2019,190150,30,4,6,4,2
2019,190150,30,5,11,5,6
2019,190150,40,0,2602,1218,1384
2019,190150,40,1,408,262,146
2019,190150,40,2,411,217,194
2019,190150,40,3,1200,471,729
2019,190150,40,4,144,58,86
2019,190150,40,5,439,210,229
2019,190150,41,0,21,19,2
2019,190150,41,1,19,17,2
2019,190150,41,2,2,2,0
2019,190150,42,0,2425,1134,1291
2019,190150,42,1,379,239,140
2019,190150,42,2,397,208,189
2019,190150,42,3,1114,441,673
2019,190150,42,4,127,53,74
2019,190150,42,5,408,193,215
2019,190150,43,0,156,65,91
2019,190150,43,1,10,6,4
2019,190150,43,2,12,7,5
2019,190150,43,3,86,30,56
2019,190150,43,4,17,5,12
2019,190150,43,5,31,17,14
2019,190150,44,0,21,19,2
2019,190150,44,1,19,17,2
2019,190150,44,2,2,2,0
2019,190169,0,0,42,18,24
2019,190169,10,0,42,18,24
2019,190169,10,1,11,5,6
2019,190169,10,2,15,5,10
2019,190169,10,3,12,6,6
2019,190169,10,4,4,2,2
2019,190169,20,0,33,13,20
2019,190169,20,1,11,5,6
2019,190169,20,2,15,5,10
2019,190169,20,3,4,2,2
2019,190169,20,4,3,1,2
2019,190169,30,0,7,4,3
2019,190169,30,3,6,3,3
2019,190169,30,4,1,1,0
2019,190169,40,0,2,1,1
2019,190169,40,3,2,1,1
2019,190169,42,0,2,1,1
2019,190169,42,3,2,1,1
2019,190248,0,0,49,14,35
2019,190248,10,0,49,14,35
2019,190248,10,1,9,3,6
2019,190248,10,2,13,3,10
2019,190248,10,3,23,5,18
2019,190248,10,4,4,3,1
2019,190248,40,0,49,14,35
2019,190248,40,1,9,3,6
2019,190248,40,2,13,3,10
2019,190248,40,3,23,5,18
2019,190248,40,4,4,3,1
2019,190248,41,0,43,11,32
2019,190248,41,1,7,1,6
2019,190248,41,2,12,3,9
2019,190248,41,3,20,4,16
2019,190248,41,4,4,3,1
2019,190248,42,0,6,3,3
2019,190248,42,1,2,2,0
2019,190248,42,2,1,0,1
2019,190248,42,3,3,1,2
2019,190248,44,0,43,11,32
2019,190248,44,1,7,1,6
2019,190248,44,2,12,3,9
2019,190248,44,3,20,4,16
2019,190248,44,4,4,3,1
2019,190372,0,0,54,35,19
2019,190372,10,0,54,35,19
2019,190372,10,1,26,20,6
2019,190372,10,2,12,9,3
2019,190372,10,3,16,6,10
2019,190372,20,0,32,25,7
2019,190372,20,1,26,20,6
2019,190372,20,2,6,5,1
2019,190372,30,0,22,10,12
2019,190372,30,2,6,4,2
2019,190372,30,3,16,6,10
2019,190415,0,0,1827,1136,691
2019,190415,10,0,1827,1136,691
2019,190415,10,1,754,555,199
2019,190415,10,2,398,234,164
2019,190415,10,3,354,198,156
2019,190415,10,4,26,13,13
2019,190415,10,5,295,136,159
2019,190415,20,0,1056,738,318
2019,190415,20,1,703,528,175
2019,190415,20,2,353,210,143
2019,190415,30,0,344,199,145
2019,190415,30,1,8,4,4
2019,190415,30,2,25,18,7
2019,190415,30,3,311,177,134
2019,190415,40,0,427,199,228
2019,190415,40,1,43,23,20
2019,190415,40,2,20,6,14
2019,190415,40,3,43,21,22
2019,190415,40,4,26,13,13
2019,190415,40,5,295,136,159
2019,190415,41,0,332,156,176
2019,190415,41,1,37,19,18
2019,190415,41,2,16,4,12
2019,190415,41,3,28,13,15
2019,190415,41,4,7,4,3
2019,190415,41,5,244,116,128
2019,190415,42,0,67,32,35
2019,190415,42,1,4,3,1
2019,190415,42,2,1,1,0
2019,190415,42,3,13,8,5
2019,190415,42,4,11,4,7
2019,190415,42,5,38,16,22
2019,190415,43,0,28,11,17
2019,190415,43,1,2,1,1
2019,190415,43,2,3,1,2
2019,190415,43,3,2,0,2
2019,190415,43,4,8,5,3
2019,190415,43,5,13,4,9
2019,190415,44,0,332,156,176
2019,190415,44,1,37,19,18
2019,190415,44,2,16,4,12
2019,190415,44,3,28,13,15
2019,190415,44,4,7,4,3
2019,190415,44,5,244,116,128
2019,190424,0,0,1811,994,817
2019,190424,10,0,1811,994,817
2019,190424,10,1,276,204,72
2019,190424,10,2,284,177,107
2019,190424,10,3,1067,525,542
2019,190424,10,4,182,88,94
2019,190424,10,5,2,0,2
2019,190424,20,0,123,98,25
2019,190424,20,1,116,93,23
2019,190424,20,2,7,5,2
2019,190424,30,0,283,151,132
2019,190424,30,1,8,6,2
2019,190424,30,2,24,15,9
2019,190424,30,3,250,129,121
2019,190424,30,4,1,1,0
2019,190424,40,0,1405,745,660
2019,190424,40,1,152,105,47
2019,190424,40,2,253,157,96
2019,190424,40,3,817,396,421
2019,190424,40,4,181,87,94
2019,190424,40,5,2,0,2
2019,190424,42,0,1405,745,660
2019,190424,42,1,152,105,47
2019,190424,42,2,253,157,96
2019,190424,42,3,817,396,421
2019,190424,42,4,181,87,94
2019,190424,42,5,2,0,2
2019,190442,0,0,83,44,39
2019,190442,10,0,83,44,39
2019,190442,10,1,32,17,15
2019,190442,10,2,26,19,7
2019,190442,10,3,6,4,2
2019,190442,10,4,19,4,15
2019,190442,20,0,63,39,24
2019,190442,20,1,32,17,15
2019,190442,20,2,25,18,7
2019,190442,20,3,5,3,2
2019,190442,20,4,1,1,0
2019,190442,30,0,13,2,11
2019,190442,30,2,1,1,0
2019,190442,30,3,1,1,0
2019,190442,30,4,11,0,11
2019,190442,40,0,7,3,4
2019,190442,40,4,7,3,4
2019,190442,43,0,7,3,4
2019,190442,43,4,7,3,4
2019,190451,0,0,16,0,16
2019,190451,10,0,16,0,16
2019,190451,10,2,6,0,6
2019,190451,10,3,5,0,5
2019,190451,10,4,5,0,5
2019,190451,40,0,16,0,16
2019,190451,40,2,6,0,6
2019,190451,40,3,5,0,5
2019,190451,40,4,5,0,5
2019,190451,41,0,16,0,16
2019,190451,41,2,6,0,6
2019,190451,41,3,5,0,5
2019,190451,41,4,5,0,5
2019,190451,45,0,16,0,16
2019,190451,45,2,6,0,6
2019,190451,45,3,5,0,5
2019,190451,45,4,5,0,5
2019,190503,0,0,138,97,41
2019,190503,10,0,138,97,41
2019,190503,10,1,35,24,11
2019,190503,10,2,48,33,15
2019,190503,10,3,26,19,7
2019,190503,10,4,29,21,8
2019,190503,40,0,138,97,41
2019,190503,40,1,35,24,11
2019,190503,40,2,48,33,15
2019,190503,40,3,26,19,7
2019,190503,40,4,29,21,8
2019,190503,41,0,138,97,41
2019,190503,41,1,35,24,11
2019,190503,41,2,48,33,15
2019,190503,41,3,26,19,7
2019,190503,41,4,29,21,8
2019,190503,44,0,138,97,41
2019,190503,44,1,35,24,11
2019,190503,44,2,48,33,15
2019,190503,44,3,26,19,7
2019,190503,44,4,29,21,8
2019,190512,0,0,486,297,189
2019,190512,10,0,486,297,189
2019,190512,10,1,185,125,60
2019,190512,10,2,125,72,53
2019,190512,10,3,128,76,52
2019,190512,10,5,48,24,24
2019,190512,20,0,328,209,119
2019,190512,20,1,172,116,56
2019,190512,20,2,122,70,52
2019,190512,20,3,10,8,2
2019,190512,20,5,24,15,9
2019,190512,30,0,134,74,60
2019,190512,30,2,3,2,1
2019,190512,30,3,114,66,48
2019,190512,30,5,17,6,11
2019,190512,40,0,24,14,10
2019,190512,40,1,13,9,4
2019,190512,40,3,4,2,2
2019,190512,40,5,7,3,4
2019,190512,42,0,24,14,10
2019,190512,42,1,13,9,4
2019,190512,42,3,4,2,2
2019,190512,42,5,7,3,4
2019,190521,0,0,554,262,292
2019,190521,10,0,554,262,292
2019,190521,10,1,119,65,54
2019,190521,10,2,157,65,92
2019,190521,10,3,187,83,104
2019,190521,10,4,18,10,8
2019,190521,10,5,73,39,34
2019,190521,20,0,324,155,169
2019,190521,20,1,119,65,54
2019,190521,20,2,119,50,69
2019,190521,20,3,36,15,21
2019,190521,20,5,50,25,25
2019,190521,30,0,204,91,113
2019,190521,30,2,38,15,23
2019,190521,30,3,145,64,81
2019,190521,30,5,21,12,9
2019,190521,40,0,26,16,10
2019,190521,40,3,6,4,2
2019,190521,40,4,18,10,8
2019,190521,40,5,2,2,0
2019,190521,42,0,26,16,10
2019,190521,42,3,6,4,2
2019,190521,42,4,18,10,8
2019,190521,42,5,2,2,0
2019,190530,0,0,283,149,134
2019,190530,10,0,283,149,134
2019,190530,10,1,81,48,33
2019,190530,10,2,71,35,36
2019,190530,10,3,90,41,49
2019,190530,10,5,41,25,16
2019,190530,20,0,180,98,82
2019,190530,20,1,81,48,33
2019,190530,20,2,56,28,28
2019,190530,20,3,18,9,9
2019,190530,20,5,25,13,12
2019,190530,30,0,91,47,44
2019,190530,30,2,15,7,8
2019,190530,30,3,66,31,35
2019,190530,30,5,10,9,1
2019,190530,40,0,12,4,8
2019,190530,40,3,6,1,5
2019,190530,40,5,6,3,3
2019,190530,42,0,12,4,8
2019,190530,42,3,6,1,5
2019,190530,42,5,6,3,3
2019,190549,0,0,504,274,230
2019,190549,10,0,504,274,230
2019,190549,10,1,195,124,71
2019,190549,10,2,144,72,72
2019,190549,10,3,104,46,58
2019,190549,10,5,61,32,29
2019,190549,20,0,367,209,158
2019,190549,20,1,186,121,65
2019,190549,20,2,138,68,70
2019,190549,20,3,20,9,11
2019,190549,20,5,23,11,12
2019,190549,30,0,97,45,52
2019,190549,30,1,1,0,1
2019,190549,30,2,5,4,1
2019,190549,30,3,84,37,47
2019,190549,30,5,7,4,3
2019,190549,40,0,40,20,20
2019,190549,40,1,8,3,5
2019,190549,40,2,1,0,1
2019,190549,40,5,31,17,14
2019,190549,42,0,40,20,20
2019,190549,42,1,8,3,5
2019,190549,42,2,1,0,1
2019,190549,42,5,31,17,14
2019,190558,0,0,359,194,165
2019,190558,10,0,359,194,165
2019,190558,10,1,134,82,52
2019,190558,10,2,108,55,53
2019,190558,10,3,72,38,34
2019,190558,10,5,45,19,26
2019,190558,20,0,261,145,116
2019,190558,20,1,128,79,49
2019,190558,20,2,103,53,50
2019,190558,20,3,10,6,4
2019,190558,20,5,20,7,13
2019,190558,30,0,76,39,37
2019,190558,30,1,2,2,0
2019,190558,30,2,5,2,3
2019,190558,30,3,62,32,30
2019,190558,30,5,7,3,4
2019,190558,40,0,22,10,12
2019,190558,40,1,4,1,3
2019,190558,40,5,18,9,9
2019,190558,42,0,22,10,12
2019,190558,42,1,4,1,3
2019,190558,42,5,18,9,9
2019,190567,0,0,569,350,219
2019,190567,10,0,569,350,219
2019,190567,10,1,261,180,81
2019,190567,10,2,158,92,66
2019,190567,10,3,96,50,46
2019,190567,10,5,54,28,26
2019,190567,20,0,427,275,152
2019,190567,20,1,235,170,65
2019,190567,20,2,145,83,62
2019,190567,20,3,10,5,5
2019,190567,20,5,37,17,20
2019,190567,30,0,104,59,45
2019,190567,30,1,2,1,1
2019,190567,30,2,11,7,4
2019,190567,30,3,84,45,39
2019,190567,30,5,7,6,1
2019,190567,40,0,38,16,22
2019,190567,40,1,24,9,15
2019,190567,40,2,2,2,0
2019,190567,40,3,2,0,2
2019,190567,40,5,10,5,5
2019,190567,42,0,38,16,22
2019,190567,42,1,24,9,15
2019,190567,42,2,2,2,0
2019,190567,42,3,2,0,2
2019,190567,42,5,10,5,5
2019,190576,0,0,236,133,103
2019,190576,10,0,236,133,103
2019,190576,10,1,161,98,63
2019,190576,10,2,47,20,27
2019,190576,10,3,24,13,11
2019,190576,10,5,4,2,2
2019,190576,20,0,156,88,68
2019,190576,20,1,121,73,48
2019,190576,20,2,32,13,19
2019,190576,20,3,2,1,1
2019,190576,20,5,1,1,0
2019,190576,30,0,38,20,18
2019,190576,30,1,3,2,1
2019,190576,30,2,13,6,7
2019,190576,30,3,21,12,9
2019,190576,30,5,1,0,1
2019,190576,40,0,42,25,17
2019,190576,40,1,37,23,14
2019,190576,40,2,2,1,1
2019,190576,40,3,1,0,1
2019,190576,40,5,2,1,1
2019,190576,42,0,42,25,17
2019,190576,42,1,37,23,14
2019,190576,42,2,2,1,1
2019,190576,42,3,1,0,1
2019,190576,42,5,2,1,1
2019,190585,0,0,181,84,97
2019,190585,10,0,181,84,97
2019,190585,10,1,36,18,18
2019,190585,10,2,37,14,23
2019,190585,10,3,71,33,38
2019,190585,10,4,3,2,1
2019,190585,10,5,34,17,17
2019,190585,20,0,111,52,59
2019,190585,20,1,36,18,18
2019,190585,20,2,37,14,23
2019,190585,20,3,15,8,7
2019,190585,20,5,23,12,11
2019,190585,30,0,53,23,30
2019,190585,30,3,49,22,27
2019,190585,30,5,4,1,3
2019,190585,40,0,17,9,8
2019,190585,40,3,7,3,4
2019,190585,40,4,3,2,1
2019,190585,40,5,7,4,3
2019,190585,42,0,17,9,8
2019,190585,42,3,7,3,4
2019,190585,42,4,3,2,1
2019,190585,42,5,7,4,3
2019,190594,0,0,632,292,340
2019,190594,10,0,632,292,340
2019,190594,10,1,275,139,136
2019,190594,10,2,204,101,103
2019,190594,10,3,85,27,58
2019,190594,10,5,68,25,43
2019,190594,20,0,466,236,230
2019,190594,20,1,230,125,105
2019,190594,20,2,191,94,97
2019,190594,20,3,11,4,7
2019,190594,20,5,34,13,21
2019,190594,30,0,119,40,79
2019,190594,30,1,2,0,2
2019,190594,30,2,13,7,6
2019,190594,30,3,74,23,51
2019,190594,30,5,30,10,20
2019,190594,40,0,47,16,31
2019,190594,40,1,43,14,29
2019,190594,40,5,4,2,2
2019,190594,42,0,47,16,31
2019,190594,42,1,43,14,29
2019,190594,42,5,4,2,2
2019,190600,0,0,400,208,192
2019,190600,10,0,400,208,192
2019,190600,10,1,102,65,37
2019,190600,10,2,158,84,74
2019,190600,10,3,75,27,48
2019,190600,10,5,65,32,33
2019,190600,20,0,298,163,135
2019,190600,20,1,99,63,36
2019,190600,20,2,147,76,71
2019,190600,20,3,21,9,12
2019,190600,20,5,31,15,16
2019,190600,30,0,75,30,45
2019,190600,30,2,10,7,3
2019,190600,30,3,51,17,34
2019,190600,30,5,14,6,8
2019,190600,40,0,27,15,12
2019,190600,40,1,3,2,1
2019,190600,40,2,1,1,0
2019,190600,40,3,3,1,2
2019,190600,40,5,20,11,9
2019,190600,42,0,27,15,12
2019,190600,42,1,3,2,1
2019,190600,42,2,1,1,0
2019,190600,42,3,3,1,2
2019,190600,42,5,20,11,9
2019,190619,0,0,328,147,181
2019,190619,10,0,328,147,181
2019,190619,10,1,69,40,29
2019,190619,10,2,69,22,47
2019,190619,10,3,87,40,47
2019,190619,10,4,3,2,1
2019,190619,10,5,100,43,57
2019,190619,20,0,222,104,118
2019,190619,20,1,69,40,29
2019,190619,20,2,62,19,43
2019,190619,20,3,32,18,14
2019,190619,20,5,59,27,32
2019,190619,30,0,81,35,46
2019,190619,30,2,7,3,4
2019,190619,30,3,53,21,32
2019,190619,30,5,21,11,10
2019,190619,40,0,25,8,17
2019,190619,40,3,2,1,1
2019,190619,40,4,3,2,1
2019,190619,40,5,20,5,15
2019,190619,42,0,25,8,17
2019,190619,42,3,2,1,1
2019,190619,42,4,3,2,1
2019,190619,42,5,20,5,15
2019,190628,0,0,357,155,202
2019,190628,10,0,357,155,202
2019,190628,10,1,114,55,59
2019,190628,10,2,131,53,78
2019,190628,10,3,68,26,42
2019,190628,10,4,3,0,3
2019,190628,10,5,41,21,20
2019,190628,20,0,221,107,114
2019,190628,20,1,114,55,59
2019,190628,20,2,70,33,37
2019,190628,20,3,3,2,1
2019,190628,20,5,34,17,17
2019,190628,30,0,127,45,82
2019,190628,30,2,61,20,41
2019,190628,30,3,62,23,39
2019,190628,30,5,4,2,2
2019,190628,40,0,9,3,6
2019,190628,40,3,3,1,2
2019,190628,40,4,3,0,3
2019,190628,40,5,3,2,1
2019,190628,42,0,9,3,6
2019,190628,42,3,3,1,2
2019,190628,42,4,3,0,3
2019,190628,42,5,3,2,1
2019,190637,0,0,380,166,214
2019,190637,10,0,380,166,214
2019,190637,10,1,87,51,36
2019,190637,10,2,114,47,67
2019,190637,10,3,100,44,56
2019,190637,10,4,2,1,1
2019,190637,10,5,77,23,54
2019,190637,20,0,240,112,128
2019,190637,20,1,82,50,32
2019,190637,20,2,109,44,65
2019,190637,20,3,9,5,4
2019,190637,20,5,40,13,27
2019,190637,30,0,101,40,61
2019,190637,30,2,5,3,2
2019,190637,30,3,80,33,47
2019,190637,30,5,16,4,12
2019,190637,40,0,39,14,25
2019,190637,40,1,5,1,4
2019,190637,40,3,11,6,5
2019,190637,40,4,2,1,1
2019,190637,40,5,21,6,15
2019,190637,42,0,39,14,25
2019,190637,42,1,5,1,4
2019,190637,42,3,11,6,5
2019,190637,42,4,2,1,1
2019,190637,42,5,21,6,15
2019,190646,0,0,159,83,76
2019,190646,10,0,159,83,76
2019,190646,10,1,42,27,15
2019,190646,10,2,35,15,20
2019,190646,10,3,47,20,27
2019,190646,10,4,2,1,1
2019,190646,10,5,33,20,13
2019,190646,20,0,93,55,38
2019,190646,20,1,38,24,14
2019,190646,20,2,24,9,15
2019,190646,20,3,9,5,4
2019,190646,20,5,22,17,5
2019,190646,30,0,47,20,27
2019,190646,30,1,2,2,0
2019,190646,30,2,10,6,4
2019,190646,30,3,31,12,19
2019,190646,30,5,4,0,4
2019,190646,40,0,19,8,11
2019,190646,40,1,2,1,1
2019,190646,40,2,1,0,1
2019,190646,40,3,7,3,4
2019,190646,40,4,2,1,1
2019,190646,40,5,7,3,4
2019,190646,42,0,19,8,11
2019,190646,42,1,2,1,1
2019,190646,42,2,1,0,1
2019,190646,42,3,7,3,4
2019,190646,42,4,2,1,1
2019,190646,42,5,7,3,4
2019,190655,0,0,389,201,188
2019,190655,10,0,389,201,188
2019,190655,10,1,89,45,44
2019,190655,10,2,139,73,66
2019,190655,10,3,139,71,68
2019,190655,10,4,1,0,1
2019,190655,10,5,21,12,9
2019,190655,20,0,289,157,132
2019,190655,20,1,88,44,44
2019,190655,20,2,122,64,58
2019,190655,20,3,60,39,21
2019,190655,20,5,19,10,9
2019,190655,30,0,95,41,54
2019,190655,30,2,17,9,8
2019,190655,30,3,76,30,46
2019,190655,30,5,2,2,0
2019,190655,40,0,5,3,2
2019,190655,40,1,1,1,0
2019,190655,40,3,3,2,1
2019,190655,40,4,1,0,1
2019,190655,42,0,5,3,2
2019,190655,42,1,1,1,0
2019,190655,42,3,3,2,1
2019,190655,42,4,1,0,1
2019,190664,0,0,583,312,271
2019,190664,10,0,583,312,271
2019,190664,10,1,202,133,69
2019,190664,10,2,168,73,95
2019,190664,10,3,97,53,44
2019,190664,10,5,116,53,63
2019,190664,20,0,429,227,202
2019,190664,20,1,194,129,65
2019,190664,20,2,162,69,93
2019,190664,20,3,12,6,6
2019,190664,20,5,61,23,38
2019,190664,30,0,117,64,53
2019,190664,30,1,1,0,1
2019,190664,30,2,6,4,2
2019,190664,30,3,83,46,37
2019,190664,30,5,27,14,13
2019,190664,40,0,37,21,16
2019,190664,40,1,7,4,3
2019,190664,40,3,2,1,1
2019,190664,40,5,28,16,12
2019,190664,42,0,37,21,16
2019,190664,42,1,7,4,3
2019,190664,42,3,2,1,1
2019,190664,42,5,28,16,12
2019,190673,0,0,390,189,201
2019,190673,10,0,390,189,201
2019,190673,10,1,71,32,39
2019,190673,10,2,123,62,61
2019,190673,10,3,121,56,65
2019,190673,10,4,1,1,0
2019,190673,10,5,74,38,36
2019,190673,20,0,243,125,118
2019,190673,20,1,71,32,39
2019,190673,20,2,123,62,61
2019,190673,20,3,4,3,1
2019,190673,20,5,45,28,17
2019,190673,30,0,144,62,82
2019,190673,30,3,116,53,63
2019,190673,30,5,28,9,19
2019,190673,40,0,3,2,1
2019,190673,40,3,1,0,1
2019,190673,40,4,1,1,0
2019,190673,40,5,1,1,0
2019,190673,42,0,3,2,1
2019,190673,42,3,1,0,1
2019,190673,42,4,1,1,0
2019,190673,42,5,1,1,0
2019,190682,0,0,58,20,38
2019,190682,10,0,58,20,38
2019,190682,10,1,33,15,18
2019,190682,10,2,14,4,10
2019,190682,10,3,5,0,5
2019,190682,10,4,6,1,5
2019,190682,20,0,28,13,15
2019,190682,20,1,27,12,15
2019,190682,20,2,1,1,0
2019,190682,30,0,15,3,12
2019,190682,30,1,1,0,1
2019,190682,30,2,13,3,10
2019,190682,30,3,1,0,1
2019,190682,40,0,15,4,11
2019,190682,40,1,5,3,2
2019,190682,40,3,4,0,4
2019,190682,40,4,6,1,5
2019,190682,42,0,15,4,11
2019,190682,42,1,5,3,2
2019,190682,42,3,4,0,4
2019,190682,42,4,6,1,5
2019,190691,0,0,188,95,93
2019,190691,10,0,188,95,93
2019,190691,10,1,51,27,24
2019,190691,10,2,67,33,34
2019,190691,10,3,47,23,24
2019,190691,10,5,23,12,11
2019,190691,20,0,130,70,60
2019,190691,20,1,44,26,18
2019,190691,20,2,62,31,31
2019,190691,20,3,10,6,4
2019,190691,20,5,14,7,7
2019,190691,30,0,47,21,26
2019,190691,30,1,1,0,1
2019,190691,30,2,5,2,3
2019,190691,30,3,37,17,20
2019,190691,30,5,4,2,2
2019,190691,40,0,11,4,7
2019,190691,40,1,6,1,5
2019,190691,40,5,5,3,2
2019,190691,42,0,11,4,7
2019,190691,42,1,6,1,5
2019,190691,42,5,5,3,2
2019,190716,0,0,179,63,116
2019,190716,10,0,179,63,116
2019,190716,10,1,19,8,11
2019,190716,10,2,81,29,52
2019,190716,10,3,78,25,53
2019,190716,10,4,1,1,0
2019,190716,20,0,78,33,45
2019,190716,20,1,19,8,11
2019,190716,20,2,57,25,32
2019,190716,20,3,2,0,2
2019,190716,30,0,25,15,10
2019,190716,30,2,1,0,1
2019,190716,30,3,24,15,9
2019,190716,40,0,76,15,61
2019,190716,40,2,23,4,19
2019,190716,40,3,52,10,42
2019,190716,40,4,1,1,0
2019,190716,41,0,59,9,50
2019,190716,41,2,23,4,19
2019,190716,41,3,36,5,31
2019,190716,42,0,17,6,11
2019,190716,42,3,16,5,11
2019,190716,42,4,1,1,0
2019,190716,44,0,59,9,50
2019,190716,44,2,23,4,19
2019,190716,44,3,36,5,31
2019,190725,0,0,150,53,97
2019,190725,10,0,150,53,97
2019,190725,10,1,15,7,8
2019,190725,10,2,47,20,27
2019,190725,10,3,74,22,52
2019,190725,10,4,8,3,5
2019,190725,10,6,6,1,5
2019,190725,20,0,60,27,33
2019,190725,20,1,15,7,8
2019,190725,20,2,44,20,24
2019,190725,20,3,1,0,1
2019,190725,30,0,51,14,37
2019,190725,30,2,3,0,3
2019,190725,30,3,48,14,34
2019,190725,40,0,39,12,27
2019,190725,40,3,25,8,17
2019,190725,40,4,8,3,5
2019,190725,40,6,6,1,5
2019,190725,42,0,23,6,17
2019,190725,42,3,17,4,13
2019,190725,42,4,3,1,2
2019,190725,42,6,3,1,2
2019,190725,43,0,16,6,10
2019,190725,43,3,8,4,4
2019,190725,43,4,5,2,3
2019,190725,43,6,3,0,3
2019,190752,0,0,7,7,0
2019,190752,10,0,7,7,0
2019,190752,10,4,7,7,0
2019,190752,40,0,7,7,0
2019,190752,40,4,7,7,0
2019,190752,42,0,7,7,0
2019,190752,42,4,7,7,0
2019,190761,0,0,76,27,49
2019,190761,10,0,76,27,49
2019,190761,10,1,5,1,4
2019,190761,10,2,17,8,9
2019,190761,10,3,45,17,28
2019,190761,10,4,9,1,8
2019,190761,20,0,32,10,22
2019,190761,20,1,5,1,4
2019,190761,20,2,15,6,9
2019,190761,20,3,12,3,9
2019,190761,30,0,26,11,15
2019,190761,30,2,2,2,0
2019,190761,30,3,20,8,12
2019,190761,30,4,4,1,3
2019,190761,40,0,18,6,12
2019,190761,40,3,13,6,7
2019,190761,40,4,5,0,5
2019,190761,42,0,18,6,12
2019,190761,42,3,13,6,7
2019,190761,42,4,5,0,5
2019,190840,0,0,125,55,70
2019,190840,10,0,125,55,70
2019,190840,10,1,28,14,14
2019,190840,10,2,26,11,15
2019,190840,10,3,37,17,20
2019,190840,10,4,31,13,18
2019,190840,10,6,3,0,3
2019,190840,20,0,93,46,47
2019,190840,20,1,28,14,14
2019,190840,20,2,26,11,15
2019,190840,20,3,28,15,13
2019,190840,20,4,11,6,5
2019,190840,30,0,31,8,23
2019,190840,30,3,9,2,7
2019,190840,30,4,19,6,13
2019,190840,30,6,3,0,3
2019,190840,40,0,1,1,0
2019,190840,40,4,1,1,0
2019,190840,43,0,1,1,0
2019,190840,43,4,1,1,0
2019,190956,0,0,13,0,13
2019,190956,10,0,13,0,13
2019,190956,10,4,13,0,13
2019,190956,40,0,13,0,13
2019,190956,40,4,13,0,13
2019,190956,41,0,13,0,13
2019,190956,41,4,13,0,13
2019,190956,45,0,13,0,13
2019,190956,45,4,13,0,13
2019,190983,0,0,66,32,34
2019,190983,10,0,62,30,32
2019,190983,10,1,9,5,4
2019,190983,10,2,23,11,12
2019,190983,10,3,26,11,15
2019,190983,10,4,1,1,0
2019,190983,10,5,3,2,1
2019,190983,20,0,32,16,16
2019,190983,20,1,9,5,4
2019,190983,20,2,23,11,12
2019,190983,30,0,23,10,13
2019,190983,30,3,23,10,13
2019,190983,40,0,7,4,3
2019,190983,40,3,3,1,2
2019,190983,40,4,1,1,0
2019,190983,40,5,3,2,1
2019,190983,42,0,7,4,3
2019,190983,42,3,3,1,2
2019,190983,42,4,1,1,0
2019,190983,42,5,3,2,1
2019,190983,50,0,4,2,2
2019,191083,0,0,287,141,146
2019,191083,10,0,287,141,146
2019,191083,10,1,108,48,60
2019,191083,10,2,59,34,25
2019,191083,10,3,29,15,14
2019,191083,10,4,91,44,47
2019,191083,20,0,244,120,124
2019,191083,20,1,108,48,60
2019,191083,20,2,59,34,25
2019,191083,20,3,29,15,14
2019,191083,20,4,48,23,25
2019,191083,30,0,43,21,22
2019,191083,30,4,43,21,22
2019,191126,0,0,226,95,131
2019,191126,10,0,226,95,131
2019,191126,10,1,58,26,32
2019,191126,10,2,73,33,40
2019,191126,10,3,95,36,59
2019,191126,20,0,195,86,109
2019,191126,20,1,58,26,32
2019,191126,20,2,65,30,35
2019,191126,20,3,72,30,42
2019,191126,30,0,31,9,22
2019,191126,30,2,8,3,5
2019,191126,30,3,23,6,17
2019,191199,0,0,113,59,54
2019,191199,10,0,113,59,54
2019,191199,10,1,38,21,17
2019,191199,10,2,24,14,10
2019,191199,10,3,28,13,15
2019,191199,10,4,23,11,12
2019,191199,20,0,75,42,33
2019,191199,20,1,38,21,17
2019,191199,20,2,22,13,9
2019,191199,20,3,15,8,7
2019,191199,30,0,38,17,21
2019,191199,30,2,2,1,1
2019,191199,30,3,13,5,8
2019,191199,30,4,23,11,12
2019,191205,0,0,28,13,15
2019,191205,10,0,28,13,15
2019,191205,10,1,4,1,3
2019,191205,10,2,6,4,2
2019,191205,10,3,10,6,4
2019,191205,10,4,8,2,6
2019,191205,40,0,28,13,15
2019,191205,40,1,4,1,3
2019,191205,40,2,6,4,2
2019,191205,40,3,10,6,4
2019,191205,40,4,8,2,6
2019,191205,42,0,28,13,15
2019,191205,42,1,4,1,3
2019,191205,42,2,6,4,2
2019,191205,42,3,10,6,4
2019,191205,42,4,8,2,6
2019,191241,0,0,753,417,336
2019,191241,10,0,583,334,249
2019,191241,10,1,242,165,77
2019,191241,10,2,200,103,97
2019,191241,10,3,127,56,71
2019,191241,10,4,14,10,4
2019,191241,20,0,459,279,180
2019,191241,20,1,242,165,77
2019,191241,20,2,193,100,93
2019,191241,20,3,24,14,10
2019,191241,30,0,110,45,65
2019,191241,30,2,7,3,4
2019,191241,30,3,103,42,61
2019,191241,40,0,14,10,4
2019,191241,40,4,14,10,4
2019,191241,41,0,6,5,1
2019,191241,41,4,6,5,1
2019,191241,42,0,8,5,3
2019,191241,42,4,8,5,3
2019,191241,44,0,6,5,1
2019,191241,44,4,6,5,1
2019,191241,50,0,170,83,87
2019,191302,0,0,40,23,17
2019,191302,10,0,40,23,17
2019,191302,10,1,9,8,1
2019,191302,10,2,6,4,2
2019,191302,10,3,20,10,10
2019,191302,10,4,5,1,4
2019,191302,20,0,35,22,13
2019,191302,20,1,9,8,1
2019,191302,20,2,6,4,2
2019,191302,20,3,20,10,10
2019,191302,30,0,5,1,4
2019,191302,30,4,5,1,4
2019,191320,0,0,5,3,2
2019,191320,10,0,5,3,2
2019,191320,10,1,3,3,0
2019,191320,10,2,1,0,1
2019,191320,10,5,1,0,1
2019,191320,40,0,5,3,2
2019,191320,40,1,3,3,0
2019,191320,40,2,1,0,1
2019,191320,40,5,1,0,1
2019,191320,41,0,5,3,2
2019,191320,41,1,3,3,0
2019,191320,41,2,1,0,1
2019,191320,41,5,1,0,1
2019,191320,44,0,5,3,2
2019,191320,44,1,3,3,0
2019,191320,44,2,1,0,1
2019,191320,44,5,1,0,1
2019,191339,0,0,86,33,53
2019,191339,10,0,86,33,53
2019,191339,10,1,27,7,20
2019,191339,10,2,23,9,14
2019,191339,10,3,12,7,5
2019,191339,10,4,24,10,14
2019,191339,40,0,86,33,53
2019,191339,40,1,27,7,20
2019,191339,40,2,23,9,14
2019,191339,40,3,12,7,5
2019,191339,40,4,24,10,14
2019,191339,41,0,66,27,39
2019,191339,41,1,27,7,20
2019,191339,41,2,23,9,14
2019,191339,41,3,11,7,4
2019,191339,41,4,5,4,1
2019,191339,42,0,19,5,14
2019,191339,42,3,1,0,1
2019,191339,42,4,18,5,13
2019,191339,43,0,1,1,0
2019,191339,43,4,1,1,0
2019,191339,44,0,66,27,39
2019,191339,44,1,27,7,20
2019,191339,44,2,23,9,14
2019,191339,44,3,11,7,4
2019,191339,44,4,5,4,1
2019,191515,0,0,204,103,101
2019,191515,10,0,204,103,101
2019,191515,10,1,76,45,31
2019,191515,10,2,41,24,17
2019,191515,10,3,45,15,30
2019,191515,10,4,2,2,0
2019,191515,10,5,1,1,0
2019,191515,10,6,39,16,23
2019,191515,20,0,116,69,47
2019,191515,20,1,76,45,31
2019,191515,20,2,40,24,16
2019,191515,30,0,48,17,31
2019,191515,30,2,1,0,1
2019,191515,30,3,45,15,30
2019,191515,30,4,2,2,0
2019,191515,40,0,40,17,23
2019,191515,40,5,1,1,0
2019,191515,40,6,39,16,23
2019,191515,41,0,15,5,10
2019,191515,41,6,15,5,10
2019,191515,42,0,25,12,13
2019,191515,42,5,1,1,0
2019,191515,42,6,24,11,13
2019,191515,44,0,15,5,10
2019,191515,44,6,15,5,10
2019,191533,0,0,101,50,51
2019,191533,10,0,101,50,51
2019,191533,10,1,38,23,15
2019,191533,10,2,23,12,11
2019,191533,10,3,39,15,24
2019,191533,10,4,1,0,1
2019,191533,20,0,55,35,20
2019,191533,20,1,37,23,14
2019,191533,20,2,18,12,6
2019,191533,30,0,29,10,19
2019,191533,30,2,3,0,3
2019,191533,30,3,26,10,16
2019,191533,40,0,17,5,12
2019,191533,40,1,1,0,1
2019,191533,40,2,2,0,2
2019,191533,40,3,13,5,8
2019,191533,40,4,1,0,1
2019,191533,42,0,17,5,12
2019,191533,42,1,1,0,1
2019,191533,42,2,2,0,2
2019,191533,42,3,13,5,8
2019,191533,42,4,1,0,1
2019,191597,0,0,19,4,15
2019,191597,10,0,19,4,15
2019,191597,10,1,2,0,2
2019,191597,10,2,4,1,3
2019,191597,10,3,10,2,8
2019,191597,10,4,3,1,2
2019,191597,40,0,19,4,15
2019,191597,40,1,2,0,2
2019,191597,40,2,4,1,3
2019,191597,40,3,10,2,8
2019,191597,40,4,3,1,2
2019,191597,42,0,19,4,15
2019,191597,42,1,2,0,2
2019,191597,42,2,4,1,3
2019,191597,42,3,10,2,8
2019,191597,42,4,3,1,2
2019,191612,0,0,47,24,23
2019,191612,10,0,47,24,23
2019,191612,10,1,8,4,4
2019,191612,10,2,14,6,8
2019,191612,10,3,20,12,8
2019,191612,10,4,5,2,3
2019,191612,20,0,38,21,17
2019,191612,20,1,8,4,4
2019,191612,20,2,14,6,8
2019,191612,20,3,13,9,4
2019,191612,20,4,3,2,1
2019,191612,30,0,9,3,6
2019,191612,30,3,7,3,4
2019,191612,30,4,2,0,2
2019,191621,0,0,36,21,15
2019,191621,10,0,36,21,15
2019,191621,10,1,13,9,4
2019,191621,10,2,5,3,2
2019,191621,10,3,18,9,9
2019,191621,20,0,5,4,1
2019,191621,20,1,5,4,1
2019,191621,30,0,8,5,3
2019,191621,30,2,1,1,0
2019,191621,30,3,7,4,3
2019,191621,40,0,23,12,11
2019,191621,40,1,8,5,3
2019,191621,40,2,4,2,2
2019,191621,40,3,11,5,6
2019,191621,41,0,14,8,6
2019,191621,41,1,8,5,3
2019,191621,41,2,3,1,2
2019,191621,41,3,3,2,1
2019,191621,42,0,9,4,5
2019,191621,42,2,1,1,0
2019,191621,42,3,8,3,5
2019,191621,44,0,14,8,6
2019,191621,44,1,8,5,3
2019,191621,44,2,3,1,2
2019,191621,44,3,3,2,1
2019,191630,0,0,216,114,102
2019,191630,10,0,201,105,96
2019,191630,10,1,51,34,17
2019,191630,10,2,92,43,49
2019,191630,10,3,53,26,27
2019,191630,10,4,5,2,3
2019,191630,20,0,143,77,66
2019,191630,20,1,51,34,17
2019,191630,20,2,92,43,49
2019,191630,30,0,37,16,21
2019,191630,30,3,37,16,21
2019,191630,40,0,21,12,9
2019,191630,40,3,16,10,6
2019,191630,40,4,5,2,3
2019,191630,41,0,4,3,1
2019,191630,41,3,3,3,0
2019,191630,41,4,1,0,1
2019,191630,42,0,17,9,8
2019,191630,42,3,13,7,6
2019,191630,42,4,4,2,2
2019,191630,44,0,3,2,1
2019,191630,44,3,2,2,0
2019,191630,44,4,1,0,1
2019,191630,45,0,1,1,0
2019,191630,45,3,1,1,0
2019,191630,50,0,15,9,6
2019,191649,0,0,505,269,236
2019,191649,10,0,505,269,236
2019,191649,10,1,209,124,85
2019,191649,10,2,170,96,74
2019,191649,10,3,124,48,76
2019,191649,10,4,2,1,1
2019,191649,20,0,339,196,143
2019,191649,20,1,194,119,75
2019,191649,20,2,145,77,68
2019,191649,30,0,97,54,43
2019,191649,30,1,1,1,0
2019,191649,30,2,9,8,1
2019,191649,30,3,87,45,42
2019,191649,40,0,69,19,50
2019,191649,40,1,14,4,10
2019,191649,40,2,16,11,5
2019,191649,40,3,37,3,34
2019,191649,40,4,2,1,1
2019,191649,41,0,53,17,36
2019,191649,41,1,14,4,10
2019,191649,41,2,12,10,2
2019,191649,41,3,25,2,23
2019,191649,41,4,2,1,1
2019,191649,42,0,15,2,13
2019,191649,42,2,3,1,2
2019,191649,42,3,12,1,11
2019,191649,43,0,1,0,1
2019,191649,43,2,1,0,1
2019,191649,44,0,27,6,21
2019,191649,44,1,10,3,7
2019,191649,44,2,1,1,0
2019,191649,44,3,16,2,14
2019,191649,45,0,26,11,15
2019,191649,45,1,4,1,3
2019,191649,45,2,11,9,2
2019,191649,45,3,9,0,9
2019,191649,45,4,2,1,1
2019,191676,0,0,60,35,25
2019,191676,10,0,60,35,25
2019,191676,10,1,23,18,5
2019,191676,10,2,12,6,6
2019,191676,10,3,25,11,14
2019,191676,20,0,28,18,10
2019,191676,20,1,20,15,5
2019,191676,20,2,8,3,5
2019,191676,30,0,19,11,8
2019,191676,30,1,2,2,0
2019,191676,30,2,2,2,0
2019,191676,30,3,15,7,8
2019,191676,40,0,13,6,7
2019,191676,40,1,1,1,0
2019,191676,40,2,2,1,1
2019,191676,40,3,10,4,6
2019,191676,42,0,13,6,7
2019,191676,42,1,1,1,0
2019,191676,42,2,2,1,1
2019,191676,42,3,10,4,6
2019,191719,0,0,224,105,119
2019,191719,10,0,224,105,119
2019,191719,10,1,35,15,20
2019,191719,10,2,41,14,27
2019,191719,10,3,89,48,41
2019,191719,10,4,59,28,31
2019,191719,20,0,165,77,88
2019,191719,20,1,35,15,20
2019,191719,20,2,41,14,27
2019,191719,20,3,89,48,41
2019,191719,30,0,59,28,31
2019,191719,30,4,59,28,31
2019,191931,0,0,169,86,83
2019,191931,10,0,169,86,83
2019,191931,10,1,48,32,16
2019,191931,10,2,51,28,23
2019,191931,10,3,55,19,36
2019,191931,10,4,4,2,2
2019,191931,10,5,11,5,6
2019,191931,20,0,97,59,38
2019,191931,20,1,45,31,14
2019,191931,20,2,51,28,23
2019,191931,20,3,1,0,1
2019,191931,30,0,52,18,34
2019,191931,30,3,52,18,34
2019,191931,40,0,20,9,11
2019,191931,40,1,3,1,2
2019,191931,40,3,2,1,1
2019,191931,40,4,4,2,2
2019,191931,40,5,11,5,6
2019,191931,43,0,20,9,11
2019,191931,43,1,3,1,2
2019,191931,43,3,2,1,1
2019,191931,43,4,4,2,2
2019,191931,43,5,11,5,6
2019,191968,0,0,520,266,254
2019,191968,10,0,520,266,254
2019,191968,10,1,115,63,52
2019,191968,10,2,174,91,83
2019,191968,10,3,194,94,100
2019,191968,10,4,30,14,16
2019,191968,10,6,7,4,3
2019,191968,20,0,268,144,124
2019,191968,20,1,110,60,50
2019,191968,20,2,158,84,74
2019,191968,30,0,102,51,51
2019,191968,30,2,4,2,2
2019,191968,30,3,98,49,49
2019,191968,40,0,150,71,79
2019,191968,40,1,5,3,2
2019,191968,40,2,12,5,7
2019,191968,40,3,96,45,51
2019,191968,40,4,30,14,16
2019,191968,40,6,7,4,3
2019,191968,41,0,98,44,54
2019,191968,41,1,5,3,2
2019,191968,41,2,12,5,7
2019,191968,41,3,69,31,38
2019,191968,41,4,11,5,6
2019,191968,41,6,1,0,1
2019,191968,42,0,52,27,25
2019,191968,42,3,27,14,13
2019,191968,42,4,19,9,10
2019,191968,42,6,6,4,2
2019,191968,44,0,98,44,54
2019,191968,44,1,5,3,2
2019,191968,44,2,12,5,7
2019,191968,44,3,69,31,38
2019,191968,44,4,11,5,6
2019,191968,44,6,1,0,1
2019,191986,0,0,73,33,40
2019,191986,10,0,73,33,40
2019,191986,10,1,20,10,10
2019,191986,10,2,12,4,8
2019,191986,10,3,27,13,14
2019,191986,10,4,14,6,8
2019,191986,20,0,55,23,32
2019,191986,20,1,20,10,10
2019,191986,20,2,12,4,8
2019,191986,20,3,23,9,14
2019,191986,30,0,17,10,7
2019,191986,30,3,4,4,0
2019,191986,30,4,13,6,7
2019,191986,40,0,1,0,1
2019,191986,40,4,1,0,1
2019,191986,42,0,1,0,1
2019,191986,42,4,1,0,1
2019,192004,0,0,7,2,5
2019,192004,10,0,7,2,5
2019,192004,10,4,7,2,5
2019,192004,40,0,7,2,5
2019,192004,40,4,7,2,5
2019,192004,42,0,7,2,5
2019,192004,42,4,7,2,5
2019,192022,0,0,73,33,40
2019,192022,10,0,72,33,39
2019,192022,10,1,22,10,12
2019,192022,10,2,13,8,5
2019,192022,10,3,27,10,17
2019,192022,10,4,9,4,5
2019,192022,10,6,1,1,0
2019,192022,20,0,58,27,31
2019,192022,20,1,22,10,12
2019,192022,20,2,13,8,5
2019,192022,20,3,23,9,14
2019,192022,30,0,13,5,8
2019,192022,30,3,4,1,3
2019,192022,30,4,9,4,5
2019,192022,40,0,1,1,0
2019,192022,40,6,1,1,0
2019,192022,43,0,1,1,0
2019,192022,43,6,1,1,0
2019,192022,50,0,1,0,1
2019,192040,0,0,34,21,13
2019,192040,10,0,34,21,13
2019,192040,10,1,15,13,2
2019,192040,10,2,8,6,2
2019,192040,10,3,9,2,7
2019,192040,10,4,2,0,2
2019,192040,20,0,23,19,4
2019,192040,20,1,15,13,2
2019,192040,20,2,8,6,2
2019,192040,30,0,2,1,1
2019,192040,30,3,2,1,1
2019,192040,40,0,9,1,8
2019,192040,40,3,7,1,6
2019,192040,40,4,2,0,2
2019,192040,41,0,6,1,5
2019,192040,41,3,5,1,4
2019,192040,41,4,1,0,1
2019,192040,42,0,3,0,3
2019,192040,42,3,2,0,2
2019,192040,42,4,1,0,1
2019,192040,44,0,6,1,5
2019,192040,44,3,5,1,4
2019,192040,44,4,1,0,1
2019,192110,0,0,132,76,56
2019,192110,10,0,132,76,56
2019,192110,10,6,132,76,56
2019,192110,40,0,132,76,56
2019,192110,40,6,132,76,56
2019,192110,41,0,90,57,33
2019,192110,41,6,90,57,33
2019,192110,42,0,42,19,23
2019,192110,42,6,42,19,23
2019,192110,44,0,90,57,33
2019,192110,44,6,90,57,33
2019,192192,0,0,86,30,56
2019,192192,10,0,86,30,56
2019,192192,10,1,23,8,15
2019,192192,10,2,28,11,17
2019,192192,10,3,33,10,23
2019,192192,10,4,2,1,1
2019,192192,20,0,51,19,32
2019,192192,20,1,23,8,15
2019,192192,20,2,26,10,16
2019,192192,20,3,2,1,1
2019,192192,30,0,29,8,21
2019,192192,30,2,2,1,1
2019,192192,30,3,27,7,20
2019,192192,40,0,6,3,3
2019,192192,40,3,4,2,2
2019,192192,40,4,2,1,1
2019,192192,42,0,6,3,3
2019,192192,42,3,4,2,2
2019,192192,42,4,2,1,1
2019,192271,0,0,21,9,12
2019,192271,10,0,21,9,12
2019,192271,10,2,5,2,3
2019,192271,10,3,6,3,3
2019,192271,10,4,1,1,0
2019,192271,10,5,9,3,6
2019,192271,40,0,21,9,12
2019,192271,40,2,5,2,3
2019,192271,40,3,6,3,3
2019,192271,40,4,1,1,0
2019,192271,40,5,9,3,6
2019,192271,41,0,21,9,12
2019,192271,41,2,5,2,3
2019,192271,41,3,6,3,3
2019,192271,41,4,1,1,0
2019,192271,41,5,9,3,6
2019,192271,45,0,21,9,12
2019,192271,45,2,5,2,3
2019,192271,45,3,6,3,3
2019,192271,45,4,1,1,0
2019,192271,45,5,9,3,6
2019,192323,0,0,177,98,79
2019,192323,10,0,177,98,79
2019,192323,10,1,50,32,18
2019,192323,10,2,63,34,29
2019,192323,10,3,31,18,13
2019,192323,10,4,33,14,19
2019,192323,20,0,111,64,47
2019,192323,20,1,50,32,18
2019,192323,20,2,60,31,29
2019,192323,20,3,1,1,0
2019,192323,30,0,21,12,9
2019,192323,30,2,2,2,0
2019,192323,30,3,19,10,9
2019,192323,40,0,45,22,23
2019,192323,40,2,1,1,0
2019,192323,40,3,11,7,4
2019,192323,40,4,33,14,19
2019,192323,41,0,32,13,19
2019,192323,41,4,32,13,19
2019,192323,42,0,13,9,4
2019,192323,42,2,1,1,0
2019,192323,42,3,11,7,4
2019,192323,42,4,1,1,0
2019,192323,44,0,32,13,19
2019,192323,44,4,32,13,19
2019,192448,0,0,467,227,240
2019,192448,10,0,467,227,240
2019,192448,10,1,151,91,60
2019,192448,10,2,173,86,87
2019,192448,10,3,132,48,84
2019,192448,10,4,11,2,9
2019,192448,20,0,270,154,116
2019,192448,20,1,141,88,53
2019,192448,20,2,129,66,63
2019,192448,30,0,62,26,36
2019,192448,30,1,2,1,1
2019,192448,30,2,14,9,5
2019,192448,30,3,44,15,29
2019,192448,30,4,2,1,1
2019,192448,40,0,135,47,88
2019,192448,40,1,8,2,6
2019,192448,40,2,30,11,19
2019,192448,40,3,88,33,55
2019,192448,40,4,9,1,8
2019,192448,41,0,4,0,4
2019,192448,41,2,3,0,3
2019,192448,41,4,1,0,1
2019,192448,42,0,131,47,84
2019,192448,42,1,8,2,6
2019,192448,42,2,27,11,16
2019,192448,42,3,88,33,55
2019,192448,42,4,8,1,7
2019,192448,44,0,4,0,4
2019,192448,44,2,3,0,3
2019,192448,44,4,1,0,1
2019,192509,0,0,17,6,11
2019,192509,10,0,17,6,11
2019,192509,10,4,17,6,11
2019,192509,40,0,17,6,11
2019,192509,40,4,17,6,11
2019,192509,41,0,17,6,11
2019,192509,41,4,17,6,11
2019,192509,45,0,17,6,11
2019,192509,45,4,17,6,11
2019,192688,0,0,15,9,6
2019,192688,10,0,15,9,6
2019,192688,10,1,15,9,6
2019,192688,40,0,15,9,6
2019,192688,40,1,15,9,6
2019,192688,41,0,15,9,6
2019,192688,41,1,15,9,6
2019,192688,45,0,15,9,6
2019,192688,45,1,15,9,6
2019,192703,0,0,239,131,108
2019,192703,10,0,239,131,108
2019,192703,10,1,65,40,25
2019,192703,10,2,80,45,35
2019,192703,10,3,92,46,46
2019,192703,10,4,2,0,2
2019,192703,20,0,147,81,66
2019,192703,20,1,63,39,24
2019,192703,20,2,73,38,35
2019,192703,20,3,11,4,7
2019,192703,30,0,72,38,34
2019,192703,30,1,1,0,1
2019,192703,30,2,4,4,0
2019,192703,30,3,67,34,33
2019,192703,40,0,20,12,8
2019,192703,40,1,1,1,0
2019,192703,40,2,3,3,0
2019,192703,40,3,14,8,6
2019,192703,40,4,2,0,2
2019,192703,42,0,20,12,8
2019,192703,42,1,1,1,0
2019,192703,42,2,3,3,0
2019,192703,42,3,14,8,6
2019,192703,42,4,2,0,2
2019,192712,0,0,99,64,35
2019,192712,10,0,99,64,35
2019,192712,10,4,99,64,35
2019,192712,40,0,99,64,35
2019,192712,40,4,99,64,35
2019,192712,41,0,99,64,35
2019,192712,41,4,99,64,35
2019,192712,44,0,99,64,35
2019,192712,44,4,99,64,35
2019,192749,0,0,112,56,56
2019,192749,10,0,112,56,56
2019,192749,10,1,46,27,19
2019,192749,10,2,34,14,20
2019,192749,10,3,14,6,8
2019,192749,10,4,1,1,0
2019,192749,10,5,17,8,9
2019,192749,20,0,73,36,37
2019,192749,20,1,44,27,17
2019,192749,20,2,27,9,18
2019,192749,20,3,2,0,2
2019,192749,30,0,15,7,8
2019,192749,30,1,1,0,1
2019,192749,30,2,5,4,1
2019,192749,30,3,9,3,6
2019,192749,40,0,24,13,11
2019,192749,40,1,1,0,1
2019,192749,40,2,2,1,1
2019,192749,40,3,3,3,0
2019,192749,40,4,1,1,0
2019,192749,40,5,17,8,9
2019,192749,41,0,15,8,7
2019,192749,41,4,1,1,0
2019,192749,41,5,14,7,7
2019,192749,42,0,9,5,4
2019,192749,42,1,1,0,1
2019,192749,42,2,2,1,1
2019,192749,42,3,3,3,0
2019,192749,42,5,3,1,2
2019,192749,44,0,15,8,7
2019,192749,44,4,1,1,0
2019,192749,44,5,14,7,7
2019,192785,0,0,31,8,23
2019,192785,10,0,31,8,23
2019,192785,10,1,2,1,1
2019,192785,10,2,6,3,3
2019,192785,10,3,10,4,6
2019,192785,10,4,13,0,13
2019,192785,40,0,31,8,23
2019,192785,40,1,2,1,1
2019,192785,40,2,6,3,3
2019,192785,40,3,10,4,6
2019,192785,40,4,13,0,13
2019,192785,42,0,6,1,5
2019,192785,42,1,1,0,1
2019,192785,42,3,1,1,0
2019,192785,42,4,4,0,4
2019,192785,43,0,25,7,18
2019,192785,43,1,1,1,0
2019,192785,43,2,6,3,3
2019,192785,43,3,9,3,6
2019,192785,43,4,9,0,9
2019,192819,0,0,247,118,129
2019,192819,10,0,247,118,129
2019,192819,10,1,25,16,9
2019,192819,10,2,66,34,32
2019,192819,10,3,68,31,37
2019,192819,10,4,5,3,2
2019,192819,10,5,70,29,41
2019,192819,10,6,13,5,8
2019,192819,20,0,94,52,42
2019,192819,20,1,24,15,9
2019,192819,20,2,58,30,28
2019,192819,20,3,12,7,5
2019,192819,30,0,59,25,34
2019,192819,30,2,7,3,4
2019,192819,30,3,52,22,30
2019,192819,40,0,94,41,53
2019,192819,40,1,1,1,0
2019,192819,40,2,1,1,0
2019,192819,40,3,4,2,2
2019,192819,40,4,5,3,2
2019,192819,40,5,70,29,41
2019,192819,40,6,13,5,8
2019,192819,42,0,94,41,53
2019,192819,42,1,1,1,0
2019,192819,42,2,1,1,0
2019,192819,42,3,4,2,2
2019,192819,42,4,5,3,2
2019,192819,42,5,70,29,41
2019,192819,42,6,13,5,8
2019,192864,0,0,93,31,62
2019,192864,10,0,93,31,62
2019,192864,10,1,28,11,17
2019,192864,10,2,36,13,23
2019,192864,10,3,27,7,20
2019,192864,10,4,2,0,2
2019,192864,20,0,64,24,40
2019,192864,20,1,28,11,17
2019,192864,20,2,36,13,23
2019,192864,30,0,26,6,20
2019,192864,30,3,26,6,20
2019,192864,40,0,3,1,2
2019,192864,40,3,1,1,0
2019,192864,40,4,2,0,2
2019,192864,42,0,3,1,2
2019,192864,42,3,1,1,0
2019,192864,42,4,2,0,2
2019,192925,0,0,86,34,52
2019,192925,10,0,86,34,52
2019,192925,10,1,11,8,3
2019,192925,10,2,27,10,17
2019,192925,10,3,47,16,31
2019,192925,10,4,1,0,1
2019,192925,20,0,22,12,10
2019,192925,20,1,10,8,2
2019,192925,20,2,12,4,8
2019,192925,30,0,10,4,6
2019,192925,30,1,1,0,1
2019,192925,30,2,6,1,5
2019,192925,30,3,3,3,0
2019,192925,40,0,54,18,36
2019,192925,40,2,9,5,4
2019,192925,40,3,44,13,31
2019,192925,40,4,1,0,1
2019,192925,42,0,54,18,36
2019,192925,42,2,9,5,4
2019,192925,42,3,44,13,31
2019,192925,42,4,1,0,1
2019,193016,0,0,247,94,153
2019,193016,10,0,247,94,153
2019,193016,10,1,31,15,16
2019,193016,10,2,78,29,49
2019,193016,10,3,121,43,78
2019,193016,10,4,17,7,10
2019,193016,20,0,63,26,37
2019,193016,20,1,22,13,9
2019,193016,20,2,34,11,23
2019,193016,20,3,7,2,5
2019,193016,30,0,27,12,15
2019,193016,30,1,1,0,1
2019,193016,30,2,4,3,1
2019,193016,30,3,22,9,13
2019,193016,40,0,157,56,101
2019,193016,40,1,8,2,6
2019,193016,40,2,40,15,25
2019,193016,40,3,92,32,60
2019,193016,40,4,17,7,10
2019,193016,41,0,113,38,75
2019,193016,41,1,4,1,3
2019,193016,41,2,28,12,16
2019,193016,41,3,70,20,50
2019,193016,41,4,11,5,6
2019,193016,42,0,44,18,26
2019,193016,42,1,4,1,3
2019,193016,42,2,12,3,9
2019,193016,42,3,22,12,10
2019,193016,42,4,6,2,4
2019,193016,44,0,113,38,75
2019,193016,44,1,4,1,3
2019,193016,44,2,28,12,16
2019,193016,44,3,70,20,50
2019,193016,44,4,11,5,6
2019,193201,0,0,11,2,9
2019,193201,50,0,11,2,9
2019,193247,0,0,17,17,0
2019,193247,10,0,17,17,0
2019,193247,10,1,3,3,0
2019,193247,10,2,4,4,0
2019,193247,10,3,3,3,0
2019,193247,10,5,7,7,0
2019,193247,20,0,17,17,0
2019,193247,20,1,3,3,0
2019,193247,20,2,4,4,0
2019,193247,20,3,3,3,0
2019,193247,20,5,7,7,0
2019,193283,0,0,123,70,53
2019,193283,10,0,123,70,53
2019,193283,10,1,18,11,7
2019,193283,10,2,40,24,16
2019,193283,10,3,31,17,14
2019,193283,10,4,34,18,16
2019,193283,20,0,86,50,36
2019,193283,20,1,18,11,7
2019,193283,20,2,40,24,16
2019,193283,20,3,24,12,12
2019,193283,20,4,4,3,1
2019,193283,30,0,33,20,13
2019,193283,30,3,7,5,2
2019,193283,30,4,26,15,11
2019,193283,40,0,4,0,4
2019,193283,40,4,4,0,4
2019,193283,42,0,2,0,2
2019,193283,42,4,2,0,2
2019,193283,43,0,2,0,2
2019,193283,43,4,2,0,2
2019,193292,0,0,192,55,137
2019,193292,10,0,192,55,137
2019,193292,10,1,55,14,41
2019,193292,10,2,57,17,40
2019,193292,10,3,68,17,51
2019,193292,10,4,12,7,5
2019,193292,20,0,127,34,93
2019,193292,20,1,54,14,40
2019,193292,20,2,51,15,36
2019,193292,20,3,22,5,17
2019,193292,30,0,65,21,44
2019,193292,30,1,1,0,1
2019,193292,30,2,6,2,4
2019,193292,30,3,46,12,34
2019,193292,30,4,12,7,5
2019,193308,0,0,233,96,137
2019,193308,10,0,233,96,137
2019,193308,10,4,233,96,137
2019,193308,40,0,233,96,137
2019,193308,40,4,233,96,137
2019,193308,41,0,233,96,137
2019,193308,41,4,233,96,137
2019,193308,45,0,233,96,137
2019,193308,45,4,233,96,137
2019,193326,0,0,271,120,151
2019,193326,10,0,271,120,151
2019,193326,10,1,85,32,53
2019,193326,10,2,97,45,52
2019,193326,10,3,52,25,27
2019,193326,10,4,28,11,17
2019,193326,10,5,9,7,2
2019,193326,20,0,211,92,119
2019,193326,20,1,83,32,51
2019,193326,20,2,91,41,50
2019,193326,20,3,37,19,18
2019,193326,30,0,46,18,28
2019,193326,30,1,2,0,2
2019,193326,30,2,5,3,2
2019,193326,30,3,12,5,7
2019,193326,30,4,26,9,17
2019,193326,30,5,1,1,0
2019,193326,40,0,14,10,4
2019,193326,40,2,1,1,0
2019,193326,40,3,3,1,2
2019,193326,40,4,2,2,0
2019,193326,40,5,8,6,2
2019,193326,42,0,14,10,4
2019,193326,42,2,1,1,0
2019,193326,42,3,3,1,2
2019,193326,42,4,2,2,0
2019,193326,42,5,8,6,2
2019,193353,0,0,85,39,46
2019,193353,10,0,85,39,46
2019,193353,10,1,22,12,10
2019,193353,10,2,30,13,17
2019,193353,10,3,21,10,11
2019,193353,10,4,8,1,7
2019,193353,10,5,4,3,1
2019,193353,20,0,52,25,27
2019,193353,20,1,22,12,10
2019,193353,20,2,30,13,17
2019,193353,30,0,29,11,18
2019,193353,30,3,21,10,11
2019,193353,30,4,8,1,7
2019,193353,40,0,4,3,1
2019,193353,40,5,4,3,1
2019,193353,42,0,4,3,1
2019,193353,42,5,4,3,1
2019,193399,0,0,82,36,46
2019,193399,10,0,82,36,46
2019,193399,10,1,14,9,5
2019,193399,10,2,36,15,21
2019,193399,10,3,22,11,11
2019,193399,10,4,10,1,9
2019,193399,20,0,26,17,9
2019,193399,20,1,9,7,2
2019,193399,20,2,16,9,7
2019,193399,20,3,1,1,0
2019,193399,30,0,41,16,25
2019,193399,30,1,4,2,2
2019,193399,30,2,20,6,14
2019,193399,30,3,16,8,8
2019,193399,30,4,1,0,1
2019,193399,40,0,15,3,12
2019,193399,40,1,1,0,1
2019,193399,40,3,5,2,3
2019,193399,40,4,9,1,8
2019,193399,41,0,1,0,1
2019,193399,41,1,1,0,1
2019,193399,42,0,14,3,11
2019,193399,42,3,5,2,3
2019,193399,42,4,9,1,8
2019,193399,44,0,1,0,1
2019,193399,44,1,1,0,1
2019,193405,0,0,3242,1761,1481
2019,193405,10,0,3242,1761,1481
2019,193405,10,1,459,322,137
2019,193405,10,2,566,348,218
2019,193405,10,3,1903,955,948
2019,193405,10,4,314,136,178
2019,193405,20,0,230,152,78
2019,193405,20,1,210,142,68
2019,193405,20,2,20,10,10
2019,193405,30,0,2075,1151,924
2019,193405,30,1,209,150,59
2019,193405,30,2,427,263,164
2019,193405,30,3,1439,738,701
2019,193405,40,0,937,458,479
2019,193405,40,1,40,30,10
2019,193405,40,2,119,75,44
2019,193405,40,3,464,217,247
2019,193405,40,4,314,136,178
2019,193405,42,0,937,458,479
2019,193405,42,1,40,30,10
2019,193405,42,2,119,75,44
2019,193405,42,3,464,217,247
2019,193405,42,4,314,136,178
2019,193478,0,0,385,152,233
2019,193478,10,0,385,152,233
2019,193478,10,1,146,62,84
2019,193478,10,2,112,37,75
2019,193478,10,3,67,42,25
2019,193478,10,4,39,10,29
2019,193478,10,5,14,1,13
2019,193478,10,6,7,0,7
2019,193478,20,0,338,140,198
2019,193478,20,1,145,61,84
2019,193478,20,2,112,37,75
2019,193478,20,3,67,42,25
2019,193478,20,5,12,0,12
2019,193478,20,6,2,0,2
2019,193478,30,0,32,8,24
2019,193478,30,1,1,1,0
2019,193478,30,4,31,7,24
2019,193478,40,0,15,4,11
2019,193478,40,4,8,3,5
2019,193478,40,5,2,1,1
2019,193478,40,6,5,0,5
2019,193478,42,0,15,4,11
2019,193478,42,4,8,3,5
2019,193478,42,5,2,1,1
2019,193478,42,6,5,0,5
2019,193584,0,0,186,70,116
2019,193584,10,0,186,70,116
2019,193584,10,1,68,34,34
2019,193584,10,2,42,13,29
2019,193584,10,3,73,21,52
2019,193584,10,4,3,2,1
2019,193584,20,0,105,47,58
2019,193584,20,1,67,34,33
2019,193584,20,2,34,11,23
2019,193584,20,3,4,2,2
2019,193584,30,0,30,9,21
2019,193584,30,3,30,9,21
2019,193584,40,0,51,14,37
2019,193584,40,1,1,0,1
2019,193584,40,2,8,2,6
2019,193584,40,3,39,10,29
2019,193584,40,4,3,2,1
2019,193584,42,0,51,14,37
2019,193584,42,1,1,0,1
2019,193584,42,2,8,2,6
2019,193584,42,3,39,10,29
2019,193584,42,4,3,2,1
2019,193654,0,0,427,211,216
2019,193654,10,0,416,205,211
2019,193654,10,1,94,50,44
2019,193654,10,2,152,78,74
2019,193654,10,3,168,75,93
2019,193654,10,4,1,1,0
2019,193654,10,5,1,1,0
2019,193654,20,0,136,72,64
2019,193654,20,1,66,37,29
2019,193654,20,2,70,35,35
2019,193654,30,0,43,17,26
2019,193654,30,1,2,1,1
2019,193654,30,2,5,3,2
2019,193654,30,3,36,13,23
2019,193654,40,0,237,116,121
2019,193654,40,1,26,12,14
2019,193654,40,2,77,40,37
2019,193654,40,3,132,62,70
2019,193654,40,4,1,1,0
2019,193654,40,5,1,1,0
2019,193654,41,0,203,95,108
2019,193654,41,1,21,9,12
2019,193654,41,2,71,35,36
2019,193654,41,3,111,51,60
2019,193654,42,0,31,20,11
2019,193654,42,1,5,3,2
2019,193654,42,2,6,5,1
2019,193654,42,3,19,11,8
2019,193654,42,4,1,1,0
2019,193654,43,0,3,1,2
2019,193654,43,3,2,0,2
2019,193654,43,5,1,1,0
2019,193654,44,0,203,95,108
2019,193654,44,1,21,9,12
2019,193654,44,2,71,35,36
2019,193654,44,3,111,51,60
2019,193654,50,0,11,6,5
2019,193751,0,0,51,29,22
2019,193751,10,0,45,25,20
2019,193751,10,1,14,8,6
2019,193751,10,2,14,8,6
2019,193751,10,3,12,7,5
2019,193751,10,4,5,2,3
2019,193751,40,0,45,25,20
2019,193751,40,1,14,8,6
2019,193751,40,2,14,8,6
2019,193751,40,3,12,7,5
2019,193751,40,4,5,2,3
2019,193751,41,0,38,23,15
2019,193751,41,1,13,8,5
2019,193751,41,2,14,8,6
2019,193751,41,3,10,6,4
2019,193751,41,4,1,1,0
2019,193751,42,0,7,2,5
2019,193751,42,1,1,0,1
2019,193751,42,3,2,1,1
2019,193751,42,4,4,1,3
2019,193751,44,0,38,23,15
2019,193751,44,1,13,8,5
2019,193751,44,2,14,8,6
2019,193751,44,3,10,6,4
2019,193751,44,4,1,1,0
2019,193751,50,0,6,4,2
2019,193821,0,0,57,31,26
2019,193821,10,0,57,31,26
2019,193821,10,1,43,26,17
2019,193821,10,2,7,2,5
2019,193821,10,3,3,0,3
2019,193821,10,4,4,3,1
2019,193821,20,0,38,24,14
2019,193821,20,1,38,24,14
2019,193821,30,0,2,1,1
2019,193821,30,2,2,1,1
2019,193821,40,0,17,6,11
2019,193821,40,1,5,2,3
2019,193821,40,2,5,1,4
2019,193821,40,3,3,0,3
2019,193821,40,4,4,3,1
2019,193821,42,0,17,6,11
2019,193821,42,1,5,2,3
2019,193821,42,2,5,1,4
2019,193821,42,3,3,0,3
2019,193821,42,4,4,3,1
2019,193830,0,0,332,225,107
2019,193830,10,0,332,225,107
2019,193830,10,1,113,96,17
2019,193830,10,2,70,45,25
2019,193830,10,3,128,72,56
2019,193830,10,4,21,12,9
2019,193830,20,0,68,58,10
2019,193830,20,1,59,52,7
2019,193830,20,2,7,5,2
2019,193830,20,3,2,1,1
2019,193830,30,0,264,167,97
2019,193830,30,1,54,44,10
2019,193830,30,2,63,40,23
2019,193830,30,3,126,71,55
2019,193830,30,4,21,12,9
2019,193858,0,0,4,2,2
2019,193858,10,0,4,2,2
2019,193858,10,4,4,2,2
2019,193858,40,0,4,2,2
2019,193858,40,4,4,2,2
2019,193858,43,0,4,2,2
2019,193858,43,4,4,2,2
2019,193894,0,0,14,10,4
2019,193894,10,0,14,10,4
2019,193894,10,1,5,4,1
2019,193894,10,2,3,3,0
2019,193894,10,3,3,1,2
2019,193894,10,4,3,2,1
2019,193894,40,0,14,10,4
2019,193894,40,1,5,4,1
2019,193894,40,2,3,3,0
2019,193894,40,3,3,1,2
2019,193894,40,4,3,2,1
2019,193894,42,0,14,10,4
2019,193894,42,1,5,4,1
2019,193894,42,2,3,3,0
2019,193894,42,3,3,1,2
2019,193894,42,4,3,2,1
2019,193900,0,0,5887,3337,2550
2019,193900,10,0,5887,3337,2550
2019,193900,10,1,1474,1035,439
2019,193900,10,2,1068,639,429
2019,193900,10,3,1760,873,887
2019,193900,10,4,316,183,133
2019,193900,10,5,226,95,131
2019,193900,10,6,1043,512,531
2019,193900,20,0,1534,1029,505
2019,193900,20,1,1030,736,294
2019,193900,20,2,467,275,192
2019,193900,20,3,10,5,5
2019,193900,20,6,27,13,14
2019,193900,30,0,430,215,215
2019,193900,30,1,12,6,6
2019,193900,30,2,58,35,23
2019,193900,30,3,330,166,164
2019,193900,30,6,30,8,22
2019,193900,40,0,3923,2093,1830
2019,193900,40,1,432,293,139
2019,193900,40,2,543,329,214
2019,193900,40,3,1420,702,718
2019,193900,40,4,316,183,133
2019,193900,40,5,226,95,131
2019,193900,40,6,986,491,495
2019,193900,41,0,3923,2093,1830
2019,193900,41,1,432,293,139
2019,193900,41,2,543,329,214
2019,193900,41,3,1420,702,718
2019,193900,41,4,316,183,133
2019,193900,41,5,226,95,131
2019,193900,41,6,986,491,495
2019,193900,45,0,3923,2093,1830
2019,193900,45,1,432,293,139
2019,193900,45,2,543,329,214
2019,193900,45,3,1420,702,718
2019,193900,45,4,316,183,133
2019,193900,45,5,226,95,131
2019,193900,45,6,986,491,495
2019,193946,0,0,98,46,52
2019,193946,10,0,98,46,52
2019,193946,10,1,52,23,29
2019,193946,10,2,18,9,9
2019,193946,10,3,10,5,5
2019,193946,10,4,18,9,9
2019,193946,20,0,79,36,43
2019,193946,20,1,52,23,29
2019,193946,20,2,18,9,9
2019,193946,20,3,9,4,5
2019,193946,30,0,16,8,8
2019,193946,30,3,1,1,0
2019,193946,30,4,15,7,8
2019,193946,40,0,3,2,1
2019,193946,40,4,3,2,1
2019,193946,42,0,2,1,1
2019,193946,42,4,2,1,1
2019,193946,43,0,1,1,0
2019,193946,43,4,1,1,0
2019,193973,0,0,156,89,67
2019,193973,10,0,156,89,67
2019,193973,10,1,41,28,13
2019,193973,10,2,65,36,29
2019,193973,10,3,30,17,13
2019,193973,10,4,5,2,3
2019,193973,10,6,15,6,9
2019,193973,20,0,105,63,42
2019,193973,20,1,41,28,13
2019,193973,20,2,64,35,29
2019,193973,30,0,32,19,13
2019,193973,30,2,1,1,0
2019,193973,30,3,30,17,13
2019,193973,30,4,1,1,0
2019,193973,40,0,19,7,12
2019,193973,40,4,4,1,3
2019,193973,40,6,15,6,9
2019,193973,41,0,12,5,7
2019,193973,41,4,1,1,0
2019,193973,41,6,11,4,7
2019,193973,42,0,7,2,5
2019,193973,42,4,3,0,3
2019,193973,42,6,4,2,2
2019,193973,44,0,12,5,7
2019,193973,44,4,1,1,0
2019,193973,44,6,11,4,7
2019,194028,0,0,48,18,30
2019,194028,10,0,40,14,26
2019,194028,10,1,4,0,4
2019,194028,10,2,7,2,5
2019,194028,10,3,7,4,3
2019,194028,10,4,22,8,14
2019,194028,20,0,20,5,15
2019,194028,20,1,4,0,4
2019,194028,20,2,7,2,5
2019,194028,20,3,5,2,3
2019,194028,20,4,4,1,3
2019,194028,30,0,11,5,6
2019,194028,30,3,2,2,0
2019,194028,30,4,9,3,6
2019,194028,40,0,9,4,5
2019,194028,40,4,9,4,5
2019,194028,41,0,9,4,5
2019,194028,41,4,9,4,5
2019,194028,45,0,9,4,5
2019,194028,45,4,9,4,5
2019,194028,50,0,8,4,4
2019,194073,0,0,36,18,18
2019,194073,10,0,36,18,18
2019,194073,10,1,12,6,6
2019,194073,10,2,10,4,6
2019,194073,10,3,6,4,2
2019,194073,10,4,8,4,4
2019,194073,40,0,36,18,18
2019,194073,40,1,12,6,6
2019,194073,40,2,10,4,6
2019,194073,40,3,6,4,2
2019,194073,40,4,8,4,4
2019,194073,41,0,18,9,9
2019,194073,41,1,6,3,3
2019,194073,41,2,5,2,3
2019,194073,41,3,3,2,1
2019,194073,41,4,4,2,2
2019,194073,43,0,18,9,9
2019,194073,43,1,6,3,3
2019,194073,43,2,5,2,3
2019,194073,43,3,3,2,1
2019,194073,43,4,4,2,2
2019,194073,44,0,18,9,9
2019,194073,44,1,6,3,3
2019,194073,44,2,5,2,3
2019,194073,44,3,3,2,1
2019,194073,44,4,4,2,2
2019,194091,0,0,344,200,144
2019,194091,10,0,344,200,144
2019,194091,10,1,60,47,13
2019,194091,10,2,138,77,61
2019,194091,10,3,137,70,67
2019,194091,10,4,8,6,2
2019,194091,10,6,1,0,1
2019,194091,20,0,143,88,55
2019,194091,20,1,52,41,11
2019,194091,20,2,85,45,40
2019,194091,20,3,6,2,4
2019,194091,30,0,68,41,27
2019,194091,30,1,1,0,1
2019,194091,30,2,8,7,1
2019,194091,30,3,59,34,25
2019,194091,40,0,133,71,62
2019,194091,40,1,7,6,1
2019,194091,40,2,45,25,20
2019,194091,40,3,72,34,38
2019,194091,40,4,8,6,2
2019,194091,40,6,1,0,1
2019,194091,41,0,133,71,62
2019,194091,41,1,7,6,1
2019,194091,41,2,45,25,20
2019,194091,41,3,72,34,38
2019,194091,41,4,8,6,2
2019,194091,41,6,1,0,1
2019,194091,44,0,133,71,62
2019,194091,44,1,7,6,1
2019,194091,44,2,45,25,20
2019,194091,44,3,72,34,38
2019,194091,44,4,8,6,2
2019,194091,44,6,1,0,1
2019,194161,0,0,61,33,28
2019,194161,10,0,61,33,28
2019,194161,10,1,29,14,15
2019,194161,10,2,12,8,4
2019,194161,10,3,15,8,7
2019,194161,10,5,5,3,2
2019,194161,20,0,20,10,10
2019,194161,20,1,19,9,10
2019,194161,20,2,1,1,0
2019,194161,30,0,36,20,16
2019,194161,30,1,10,5,5
2019,194161,30,2,11,7,4
2019,194161,30,3,15,8,7
2019,194161,40,0,5,3,2
2019,194161,40,5,5,3,2
2019,194161,42,0,5,3,2
2019,194161,42,5,5,3,2
2019,194222,0,0,172,76,96
2019,194222,10,0,171,75,96
2019,194222,10,1,75,29,46
2019,194222,10,2,52,20,32
2019,194222,10,3,33,19,14
2019,194222,10,4,8,5,3
2019,194222,10,5,2,2,0
2019,194222,10,6,1,0,1
2019,194222,20,0,140,59,81
2019,194222,20,1,75,29,46
2019,194222,20,2,51,20,31
2019,194222,20,3,12,9,3
2019,194222,20,4,2,1,1
2019,194222,30,0,24,11,13
2019,194222,30,2,1,0,1
2019,194222,30,3,20,10,10
2019,194222,30,4,3,1,2
2019,194222,40,0,7,5,2
2019,194222,40,3,1,0,1
2019,194222,40,4,3,3,0
2019,194222,40,5,2,2,0
2019,194222,40,6,1,0,1
2019,194222,41,0,5,4,1
2019,194222,41,4,2,2,0
2019,194222,41,5,2,2,0
2019,194222,41,6,1,0,1
2019,194222,42,0,1,1,0
2019,194222,42,4,1,1,0
2019,194222,43,0,1,0,1
2019,194222,43,3,1,0,1
2019,194222,44,0,5,4,1
2019,194222,44,4,2,2,0
2019,194222,44,5,2,2,0
2019,194222,44,6,1,0,1
2019,194222,50,0,1,1,0
2019,194240,0,0,137,60,77
2019,194240,10,0,137,60,77
2019,194240,10,1,46,23,23
2019,194240,10,2,28,12,16
2019,194240,10,3,33,14,19
2019,194240,10,4,30,11,19
2019,194240,20,0,109,51,58
2019,194240,20,1,46,23,23
2019,194240,20,2,27,12,15
2019,194240,20,3,30,14,16
2019,194240,20,4,6,2,4
2019,194240,30,0,25,9,16
2019,194240,30,3,3,0,3
2019,194240,30,4,22,9,13
2019,194240,40,0,3,0,3
2019,194240,40,2,1,0,1
2019,194240,40,4,2,0,2
2019,194240,42,0,3,0,3
2019,194240,42,2,1,0,1
2019,194240,42,4,2,0,2
2019,194310,0,0,489,223,266
2019,194310,10,0,489,223,266
2019,194310,10,1,195,110,85
2019,194310,10,2,141,57,84
2019,194310,10,3,111,40,71
2019,194310,10,4,2,1,1
2019,194310,10,5,40,15,25
2019,194310,20,0,290,147,143
2019,194310,20,1,178,98,80
2019,194310,20,2,104,45,59
2019,194310,20,3,8,4,4
2019,194310,30,0,79,27,52
2019,194310,30,1,2,0,2
2019,194310,30,2,8,2,6
2019,194310,30,3,69,25,44
2019,194310,40,0,120,49,71
2019,194310,40,1,15,12,3
2019,194310,40,2,29,10,19
2019,194310,40,3,34,11,23
2019,194310,40,4,2,1,1
2019,194310,40,5,40,15,25
2019,194310,42,0,120,49,71
2019,194310,42,1,15,12,3
2019,194310,42,2,29,10,19
2019,194310,42,3,34,11,23
2019,194310,42,4,2,1,1
2019,194310,42,5,40,15,25
2019,194392,0,0,52,24,28
2019,194392,10,0,48,22,26
2019,194392,10,1,19,7,12
2019,194392,10,2,12,8,4
2019,194392,10,3,7,3,4
2019,194392,10,4,10,4,6
2019,194392,40,0,48,22,26
2019,194392,40,1,19,7,12
2019,194392,40,2,12,8,4
2019,194392,40,3,7,3,4
2019,194392,40,4,10,4,6
2019,194392,41,0,29,13,16
2019,194392,41,1,17,7,10
2019,194392,41,2,9,6,3
2019,194392,41,3,3,0,3
2019,194392,42,0,16,8,8
2019,194392,42,2,2,1,1
2019,194392,42,3,4,3,1
2019,194392,42,4,10,4,6
2019,194392,43,0,3,1,2
2019,194392,43,1,2,0,2
2019,194392,43,2,1,1,0
2019,194392,44,0,29,13,16
2019,194392,44,1,17,7,10
2019,194392,44,2,9,6,3
2019,194392,44,3,3,0,3
2019,194392,50,0,4,2,2
2019,194499,0,0,15,4,11
2019,194499,10,0,15,4,11
2019,194499,10,6,15,4,11
2019,194499,40,0,15,4,11
2019,194499,40,6,15,4,11
2019,194499,43,0,15,4,11
2019,194499,43,6,15,4,11
2019,194578,0,0,180,86,94
2019,194578,10,0,180,86,94
2019,194578,10,1,89,45,44
2019,194578,10,2,55,28,27
2019,194578,10,3,36,13,23
2019,194578,20,0,114,59,55
2019,194578,20,1,81,42,39
2019,194578,20,2,30,16,14
2019,194578,20,3,3,1,2
2019,194578,30,0,55,22,33
2019,194578,30,1,7,3,4
2019,194578,30,2,22,10,12
2019,194578,30,3,26,9,17
2019,194578,40,0,11,5,6
2019,194578,40,1,1,0,1
2019,194578,40,2,3,2,1
2019,194578,40,3,7,3,4
2019,194578,41,0,11,5,6
2019,194578,41,1,1,0,1
2019,194578,41,2,3,2,1
2019,194578,41,3,7,3,4
2019,194578,44,0,11,5,6
2019,194578,44,1,1,0,1
2019,194578,44,2,3,2,1
2019,194578,44,3,7,3,4
2019,194736,0,0,8,8,0
2019,194736,10,0,8,8,0
2019,194736,10,4,8,8,0
2019,194736,40,0,8,8,0
2019,194736,40,4,8,8,0
2019,194736,42,0,8,8,0
2019,194736,42,4,8,8,0
2019,194763,0,0,13,13,0
2019,194763,10,0,13,13,0
2019,194763,10,1,3,3,0
2019,194763,10,2,6,6,0
2019,194763,10,3,4,4,0
2019,194763,20,0,13,13,0
2019,194763,20,1,3,3,0
2019,194763,20,2,6,6,0
2019,194763,20,3,4,4,0
2019,194824,0,0,467,341,126
2019,194824,10,0,460,338,122
2019,194824,10,1,183,156,27
2019,194824,10,2,77,50,27
2019,194824,10,3,65,45,20
2019,194824,10,5,135,87,48
2019,194824,20,0,242,189,53
2019,194824,20,1,166,140,26
2019,194824,20,2,76,49,27
2019,194824,30,0,66,46,20
2019,194824,30,2,1,1,0
2019,194824,30,3,65,45,20
2019,194824,40,0,152,103,49
2019,194824,40,1,17,16,1
2019,194824,40,5,135,87,48
2019,194824,41,0,152,103,49
2019,194824,41,1,17,16,1
2019,194824,41,5,135,87,48
2019,194824,44,0,152,103,49
2019,194824,44,1,17,16,1
2019,194824,44,5,135,87,48
2019,194824,50,0,7,3,4
2019,194958,0,0,95,34,61
2019,194958,10,0,95,34,61
2019,194958,10,1,40,23,17
2019,194958,10,2,24,6,18
2019,194958,10,3,26,5,21
2019,194958,10,5,5,0,5
2019,194958,20,0,56,25,31
2019,194958,20,1,39,22,17
2019,194958,20,2,16,3,13
2019,194958,20,3,1,0,1
2019,194958,30,0,32,9,23
2019,194958,30,1,1,1,0
2019,194958,30,2,8,3,5
2019,194958,30,3,23,5,18
2019,194958,40,0,7,0,7
2019,194958,40,3,2,0,2
2019,194958,40,5,5,0,5
2019,194958,42,0,7,0,7
2019,194958,42,3,2,0,2
2019,194958,42,5,5,0,5
2019,195003,0,0,1044,662,382
2019,195003,10,0,1044,662,382
2019,195003,10,1,254,185,69
2019,195003,10,2,265,165,100
2019,195003,10,3,194,116,78
2019,195003,10,5,331,196,135
2019,195003,20,0,527,355,172
2019,195003,20,1,252,183,69
2019,195003,20,2,264,165,99
2019,195003,20,3,11,7,4
2019,195003,30,0,167,105,62
2019,195003,30,2,1,0,1
2019,195003,30,3,166,105,61
2019,195003,40,0,350,202,148
2019,195003,40,1,2,2,0
2019,195003,40,3,17,4,13
2019,195003,40,5,331,196,135
2019,195003,41,0,163,91,72
2019,195003,41,5,163,91,72
2019,195003,42,0,187,111,76
2019,195003,42,1,2,2,0
2019,195003,42,3,17,4,13
2019,195003,42,5,168,105,63
2019,195003,44,0,163,91,72
2019,195003,44,5,163,91,72
2019,195030,0,0,2454,1474,980
2019,195030,10,0,2454,1474,980
2019,195030,10,1,670,501,169
2019,195030,10,2,635,385,250
2019,195030,10,3,812,441,371
2019,195030,10,4,214,99,115
2019,195030,10,5,37,23,14
2019,195030,10,6,86,25,61
2019,195030,20,0,575,420,155
2019,195030,20,1,407,311,96
2019,195030,20,2,168,109,59
2019,195030,30,0,761,428,333
2019,195030,30,1,94,67,27
2019,195030,30,2,127,75,52
2019,195030,30,3,460,255,205
2019,195030,30,4,80,31,49
2019,195030,40,0,1118,626,492
2019,195030,40,1,169,123,46
2019,195030,40,2,340,201,139
2019,195030,40,3,352,186,166
2019,195030,40,4,134,68,66
2019,195030,40,5,37,23,14
2019,195030,40,6,86,25,61
2019,195030,41,0,1047,594,453
2019,195030,41,1,167,122,45
2019,195030,41,2,338,201,137
2019,195030,41,3,328,171,157
2019,195030,41,4,125,61,64
2019,195030,41,5,21,15,6
2019,195030,41,6,68,24,44
2019,195030,42,0,66,30,36
2019,195030,42,1,1,1,0
2019,195030,42,2,1,0,1
2019,195030,42,3,23,14,9
2019,195030,42,4,7,6,1
2019,195030,42,5,16,8,8
2019,195030,42,6,18,1,17
2019,195030,43,0,5,2,3
2019,195030,43,1,1,0,1
2019,195030,43,2,1,0,1
2019,195030,43,3,1,1,0
2019,195030,43,4,2,1,1
2019,195030,44,0,1047,594,453
2019,195030,44,1,167,122,45
2019,195030,44,2,338,201,137
2019,195030,44,3,328,171,157
2019,195030,44,4,125,61,64
2019,195030,44,5,21,15,6
2019,195030,44,6,68,24,44
2019,195049,0,0,77,58,19
2019,195049,10,0,77,58,19
2019,195049,10,1,39,36,3
2019,195049,10,2,19,10,9
2019,195049,10,3,18,11,7
2019,195049,10,6,1,1,0
2019,195049,20,0,39,36,3
2019,195049,20,1,39,36,3
2019,195049,30,0,17,11,6
2019,195049,30,2,7,5,2
2019,195049,30,3,10,6,4
2019,195049,40,0,21,11,10
2019,195049,40,2,12,5,7
2019,195049,40,3,8,5,3
2019,195049,40,6,1,1,0
2019,195049,41,0,20,10,10
2019,195049,41,2,12,5,7
2019,195049,41,3,8,5,3
2019,195049,42,0,1,1,0
2019,195049,42,6,1,1,0
2019,195049,44,0,20,10,10
2019,195049,44,2,12,5,7
2019,195049,44,3,8,5,3
2019,195058,0,0,90,36,54
2019,195058,10,0,90,36,54
2019,195058,10,1,22,6,16
2019,195058,10,2,15,8,7
2019,195058,10,3,23,7,16
2019,195058,10,4,16,7,9
2019,195058,10,5,14,8,6
2019,195058,20,0,57,20,37
2019,195058,20,1,22,6,16
2019,195058,20,2,15,8,7
2019,195058,20,3,20,6,14
2019,195058,30,0,19,8,11
2019,195058,30,3,3,1,2
2019,195058,30,4,16,7,9
2019,195058,40,0,14,8,6
2019,195058,40,5,14,8,6
2019,195058,42,0,14,8,6
2019,195058,42,5,14,8,6
2019,195128,0,0,120,29,91
2019,195128,10,0,120,29,91
2019,195128,10,1,18,6,12
2019,195128,10,2,37,9,28
2019,195128,10,3,51,12,39
2019,195128,10,4,1,0,1
2019,195128,10,5,13,2,11
2019,195128,20,0,46,15,31
2019,195128,20,1,18,6,12
2019,195128,20,2,28,9,19
2019,195128,30,0,16,6,10
2019,195128,30,3,16,6,10
2019,195128,40,0,58,8,50
2019,195128,40,2,9,0,9
2019,195128,40,3,35,6,29
2019,195128,40,4,1,0,1
2019,195128,40,5,13,2,11
2019,195128,41,0,45,5,40
2019,195128,41,2,9,0,9
2019,195128,41,3,34,5,29
2019,195128,41,5,2,0,2
2019,195128,42,0,13,3,10
2019,195128,42,3,1,1,0
2019,195128,42,4,1,0,1
2019,195128,42,5,11,2,9
2019,195128,44,0,45,5,40
2019,195128,44,2,9,0,9
2019,195128,44,3,34,5,29
2019,195128,44,5,2,0,2
2019,195164,0,0,146,82,64
2019,195164,10,0,145,82,63
2019,195164,10,1,33,25,8
2019,195164,10,2,33,22,11
2019,195164,10,3,47,19,28
2019,195164,10,5,23,13,10
2019,195164,10,6,9,3,6
2019,195164,20,0,71,46,25
2019,195164,20,1,30,23,7
2019,195164,20,2,30,19,11
2019,195164,20,3,11,4,7
2019,195164,30,0,36,20,16
2019,195164,30,1,3,2,1
2019,195164,30,2,3,3,0
2019,195164,30,3,30,15,15
2019,195164,40,0,38,16,22
2019,195164,40,3,6,0,6
2019,195164,40,5,23,13,10
2019,195164,40,6,9,3,6
2019,195164,42,0,38,16,22
2019,195164,42,3,6,0,6
2019,195164,42,5,23,13,10
2019,195164,42,6,9,3,6
2019,195164,50,0,1,0,1
2019,195173,0,0,93,45,48
2019,195173,10,0,93,45,48
2019,195173,10,1,27,15,12
2019,195173,10,2,23,9,14
2019,195173,10,3,27,10,17
2019,195173,10,5,16,11,5
2019,195173,20,0,48,24,24
2019,195173,20,1,27,15,12
2019,195173,20,2,21,9,12
2019,195173,30,0,29,10,19
2019,195173,30,2,2,0,2
2019,195173,30,3,27,10,17
2019,195173,40,0,16,11,5
2019,195173,40,5,16,11,5
2019,195173,42,0,16,11,5
2019,195173,42,5,16,11,5
2019,195191,0,0,21,5,16
2019,195191,10,0,21,5,16
2019,195191,10,1,1,0,1
2019,195191,10,2,10,1,9
2019,195191,10,3,7,3,4
2019,195191,10,4,3,1,2
2019,195191,40,0,21,5,16
2019,195191,40,1,1,0,1
2019,195191,40,2,10,1,9
2019,195191,40,3,7,3,4
2019,195191,40,4,3,1,2
2019,195191,41,0,21,5,16
2019,195191,41,1,1,0,1
2019,195191,41,2,10,1,9
2019,195191,41,3,7,3,4
2019,195191,41,4,3,1,2
2019,195191,45,0,21,5,16
2019,195191,45,1,1,0,1
2019,195191,45,2,10,1,9
2019,195191,45,3,7,3,4
2019,195191,45,4,3,1,2
2019,195216,0,0,182,87,95
2019,195216,10,0,182,87,95
2019,195216,10,1,39,23,16
2019,195216,10,2,80,35,45
2019,195216,10,3,58,26,32
2019,195216,10,4,3,1,2
2019,195216,10,5,1,1,0
2019,195216,10,6,1,1,0
2019,195216,20,0,118,57,61
2019,195216,20,1,38,22,16
2019,195216,20,2,80,35,45
2019,195216,30,0,40,19,21
2019,195216,30,3,39,18,21
2019,195216,30,4,1,1,0
2019,195216,40,0,24,11,13
2019,195216,40,1,1,1,0
2019,195216,40,3,19,8,11
2019,195216,40,4,2,0,2
2019,195216,40,5,1,1,0
2019,195216,40,6,1,1,0
2019,195216,42,0,24,11,13
2019,195216,42,1,1,1,0
2019,195216,42,3,19,8,11
2019,195216,42,4,2,0,2
2019,195216,42,5,1,1,0
2019,195216,42,6,1,1,0
2019,195234,0,0,172,76,96
2019,195234,10,0,172,76,96
2019,195234,10,1,41,16,25
2019,195234,10,2,67,32,35
2019,195234,10,3,58,26,32
2019,195234,10,4,6,2,4
2019,195234,20,0,116,52,64
2019,195234,20,1,41,16,25
2019,195234,20,2,66,31,35
2019,195234,20,3,9,5,4
2019,195234,30,0,41,19,22
2019,195234,30,2,1,1,0
2019,195234,30,3,40,18,22
2019,195234,40,0,15,5,10
2019,195234,40,3,9,3,6
2019,195234,40,4,6,2,4
2019,195234,42,0,15,5,10
2019,195234,42,3,9,3,6
2019,195234,42,4,6,2,4
2019,195243,0,0,47,18,29
2019,195243,10,0,47,18,29
2019,195243,10,1,18,8,10
2019,195243,10,2,10,4,6
2019,195243,10,3,14,4,10
2019,195243,10,4,5,2,3
2019,195243,20,0,28,12,16
2019,195243,20,1,18,8,10
2019,195243,20,2,9,4,5
2019,195243,20,3,1,0,1
2019,195243,30,0,14,4,10
2019,195243,30,2,1,0,1
2019,195243,30,3,13,4,9
2019,195243,40,0,5,2,3
2019,195243,40,4,5,2,3
2019,195243,42,0,5,2,3
2019,195243,42,4,5,2,3
2019,195304,0,0,103,53,50
2019,195304,10,0,103,53,50
2019,195304,10,6,103,53,50
2019,195304,20,0,71,39,32
2019,195304,20,6,71,39,32
2019,195304,30,0,17,9,8
2019,195304,30,6,17,9,8
2019,195304,40,0,15,5,10
2019,195304,40,6,15,5,10
2019,195304,42,0,15,5,10
2019,195304,42,6,15,5,10
2019,195322,0,0,50,20,30
2019,195322,10,0,50,20,30
2019,195322,10,1,21,10,11
2019,195322,10,2,9,3,6
2019,195322,10,3,11,5,6
2019,195322,10,4,9,2,7
2019,195322,20,0,11,4,7
2019,195322,20,1,9,4,5
2019,195322,20,2,2,0,2
2019,195322,30,0,39,16,23
2019,195322,30,1,12,6,6
2019,195322,30,2,7,3,4
2019,195322,30,3,11,5,6
2019,195322,30,4,9,2,7
2019,195438,0,0,19,19,0
2019,195438,10,0,19,19,0
2019,195438,10,4,19,19,0
2019,195438,40,0,19,19,0
2019,195438,40,4,19,19,0
2019,195438,42,0,4,4,0
2019,195438,42,4,4,4,0
2019,195438,43,0,15,15,0
2019,195438,43,4,15,15,0
2019,195474,0,0,214,112,102
2019,195474,10,0,214,112,102
2019,195474,10,1,65,36,29
2019,195474,10,2,77,43,34
2019,195474,10,3,59,27,32
2019,195474,10,4,13,6,7
2019,195474,20,0,141,77,64
2019,195474,20,1,65,36,29
2019,195474,20,2,73,39,34
2019,195474,20,3,3,2,1
2019,195474,30,0,40,24,16
2019,195474,30,2,4,4,0
2019,195474,30,3,36,20,16
2019,195474,40,0,33,11,22
2019,195474,40,3,20,5,15
2019,195474,40,4,13,6,7
2019,195474,42,0,33,11,22
2019,195474,42,3,20,5,15
2019,195474,42,4,13,6,7
2019,195526,0,0,298,136,162
2019,195526,10,0,298,136,162
2019,195526,10,1,67,43,24
2019,195526,10,2,78,30,48
2019,195526,10,3,92,43,49
2019,195526,10,4,11,0,11
2019,195526,10,5,19,5,14
2019,195526,10,6,31,15,16
2019,195526,20,0,134,67,67
2019,195526,20,1,66,42,24
2019,195526,20,2,68,25,43
2019,195526,30,0,58,28,30
2019,195526,30,2,8,3,5
2019,195526,30,3,49,24,25
2019,195526,30,5,1,1,0
2019,195526,40,0,106,41,65
2019,195526,40,1,1,1,0
2019,195526,40,2,2,2,0
2019,195526,40,3,43,19,24
2019,195526,40,4,11,0,11
2019,195526,40,5,18,4,14
2019,195526,40,6,31,15,16
2019,195526,41,0,80,29,51
2019,195526,41,1,1,1,0
2019,195526,41,2,2,2,0
2019,195526,41,3,25,9,16
2019,195526,41,4,10,0,10
2019,195526,41,5,13,3,10
2019,195526,41,6,29,14,15
2019,195526,42,0,26,12,14
2019,195526,42,3,18,10,8
2019,195526,42,4,1,0,1
2019,195526,42,5,5,1,4
2019,195526,42,6,2,1,1
2019,195526,44,0,80,29,51
2019,195526,44,1,1,1,0
2019,195526,44,2,2,2,0
2019,195526,44,3,25,9,16
2019,195526,44,4,10,0,10
2019,195526,44,5,13,3,10
2019,195526,44,6,29,14,15
2019,195544,0,0,59,27,32
2019,195544,10,0,59,27,32
2019,195544,10,1,10,5,5
2019,195544,10,2,21,7,14
2019,195544,10,3,27,14,13
2019,195544,10,4,1,1,0
2019,195544,20,0,28,12,16
2019,195544,20,1,10,5,5
2019,195544,20,2,18,7,11
2019,195544,30,0,18,10,8
2019,195544,30,2,3,0,3
2019,195544,30,3,14,9,5
2019,195544,30,4,1,1,0
2019,195544,40,0,13,5,8
2019,195544,40,3,13,5,8
2019,195544,42,0,13,5,8
2019,195544,42,3,13,5,8
2019,195562,0,0,102,39,63
2019,195562,10,0,102,39,63
2019,195562,10,1,22,9,13
2019,195562,10,2,31,11,20
2019,195562,10,3,49,19,30
2019,195562,20,0,41,16,25
2019,195562,20,1,22,9,13
2019,195562,20,2,19,7,12
2019,195562,30,0,50,18,32
2019,195562,30,2,12,4,8
2019,195562,30,3,38,14,24
2019,195562,40,0,11,5,6
2019,195562,40,3,11,5,6
2019,195562,42,0,11,5,6
2019,195562,42,3,11,5,6
2019,195580,0,0,5,4,1
2019,195580,10,0,5,4,1
2019,195580,10,1,2,2,0
2019,195580,10,2,1,1,0
2019,195580,10,3,2,1,1
2019,195580,20,0,3,3,0
2019,195580,20,1,2,2,0
2019,195580,20,2,1,1,0
2019,195580,30,0,2,1,1
2019,195580,30,3,2,1,1
2019,195702,0,0,19,2,17
2019,195702,10,0,19,2,17
2019,195702,10,2,17,2,15
2019,195702,10,3,2,0,2
2019,195702,20,0,13,1,12
2019,195702,20,2,13,1,12
2019,195702,30,0,4,1,3
2019,195702,30,2,4,1,3
2019,195702,40,0,2,0,2
2019,195702,40,3,2,0,2
2019,195702,41,0,2,0,2
2019,195702,41,3,2,0,2
2019,195702,44,0,2,0,2
2019,195702,44,3,2,0,2
2019,195720,0,0,230,97,133
2019,195720,10,0,225,96,129
2019,195720,10,1,36,24,12
2019,195720,10,2,108,44,64
2019,195720,10,3,68,24,44
2019,195720,10,4,13,4,9
2019,195720,20,0,137,65,72
2019,195720,20,1,36,24,12
2019,195720,20,2,97,40,57
2019,195720,20,3,4,1,3
2019,195720,30,0,33,13,20
2019,195720,30,2,8,3,5
2019,195720,30,3,25,10,15
2019,195720,40,0,55,18,37
2019,195720,40,2,3,1,2
2019,195720,40,3,39,13,26
2019,195720,40,4,13,4,9
2019,195720,41,0,31,11,20
2019,195720,41,2,2,1,1
2019,195720,41,3,25,8,17
2019,195720,41,4,4,2,2
2019,195720,42,0,22,6,16
2019,195720,42,2,1,0,1
2019,195720,42,3,12,4,8
2019,195720,42,4,9,2,7
2019,195720,43,0,2,1,1
2019,195720,43,3,2,1,1
2019,195720,44,0,31,11,20
2019,195720,44,2,2,1,1
2019,195720,44,3,25,8,17
2019,195720,44,4,4,2,2
2019,195720,50,0,5,1,4
2019,195784,0,0,18,8,10
2019,195784,10,0,18,8,10
2019,195784,10,4,18,8,10
2019,195784,40,0,18,8,10
2019,195784,40,4,18,8,10
2019,195784,41,0,18,8,10
2019,195784,41,4,18,8,10
2019,195784,45,0,18,8,10
2019,195784,45,4,18,8,10
2019,195809,0,0,663,359,304
2019,195809,10,0,663,359,304
2019,195809,10,1,216,131,85
2019,195809,10,2,297,154,143
2019,195809,10,3,148,74,74
2019,195809,10,4,2,0,2
2019,195809,20,0,486,273,213
2019,195809,20,1,200,123,77
2019,195809,20,2,286,150,136
2019,195809,30,0,127,60,67
2019,195809,30,1,1,1,0
2019,195809,30,2,6,2,4
2019,195809,30,3,119,57,62
2019,195809,30,4,1,0,1
2019,195809,40,0,50,26,24
2019,195809,40,1,15,7,8
2019,195809,40,2,5,2,3
2019,195809,40,3,29,17,12
2019,195809,40,4,1,0,1
2019,195809,42,0,50,26,24
2019,195809,42,1,15,7,8
2019,195809,42,2,5,2,3
2019,195809,42,3,29,17,12
2019,195809,42,4,1,0,1
2019,195988,0,0,35,18,17
2019,195988,10,0,35,18,17
2019,195988,10,1,18,8,10
2019,195988,10,2,12,7,5
2019,195988,10,3,5,3,2
2019,195988,20,0,29,14,15
2019,195988,20,1,18,8,10
2019,195988,20,2,11,6,5
2019,195988,30,0,4,2,2
2019,195988,30,3,4,2,2
2019,195988,40,0,2,2,0
2019,195988,40,2,1,1,0
2019,195988,40,3,1,1,0
2019,195988,42,0,2,2,0
2019,195988,42,2,1,1,0
2019,195988,42,3,1,1,0
2019,196006,0,0,183,128,55
2019,196006,10,0,183,128,55
2019,196006,10,1,23,15,8
2019,196006,10,2,34,24,10
2019,196006,10,3,72,46,26
2019,196006,10,4,26,23,3
2019,196006,10,5,28,20,8
2019,196006,20,0,68,48,20
2019,196006,20,1,23,15,8
2019,196006,20,2,31,23,8
2019,196006,20,3,13,9,4
2019,196006,20,4,1,1,0
2019,196006,30,0,83,59,24
2019,196006,30,2,1,1,0
2019,196006,30,3,59,37,22
2019,196006,30,4,23,21,2
2019,196006,40,0,32,21,11
2019,196006,40,2,2,0,2
2019,196006,40,4,2,1,1
2019,196006,40,5,28,20,8
2019,196006,42,0,15,11,4
2019,196006,42,2,1,0,1
2019,196006,42,4,1,0,1
2019,196006,42,5,13,11,2
2019,196006,43,0,17,10,7
2019,196006,43,2,1,0,1
2019,196006,43,4,1,1,0
2019,196006,43,5,15,9,6
2019,196015,0,0,124,70,54
2019,196015,10,0,124,70,54
2019,196015,10,1,27,14,13
2019,196015,10,2,31,18,13
2019,196015,10,3,21,13,8
2019,196015,10,4,8,4,4
2019,196015,10,5,37,21,16
2019,196015,20,0,53,31,22
2019,196015,20,1,27,14,13
2019,196015,20,2,25,16,9
2019,196015,20,3,1,1,0
2019,196015,30,0,32,17,15
2019,196015,30,2,6,2,4
2019,196015,30,3,19,11,8
2019,196015,30,4,7,4,3
2019,196015,40,0,39,22,17
2019,196015,40,3,1,1,0
2019,196015,40,4,1,0,1
2019,196015,40,5,37,21,16
2019,196015,41,0,28,17,11
2019,196015,41,5,28,17,11
2019,196015,42,0,11,5,6
2019,196015,42,3,1,1,0
2019,196015,42,4,1,0,1
2019,196015,42,5,9,4,5
2019,196015,44,0,28,17,11
2019,196015,44,5,28,17,11
2019,196024,0,0,144,76,68
2019,196024,10,0,144,76,68
2019,196024,10,1,29,16,13
2019,196024,10,2,44,17,27
2019,196024,10,3,48,26,22
2019,196024,10,4,23,17,6
2019,196024,20,0,67,35,32
2019,196024,20,1,28,15,13
2019,196024,20,2,28,12,16
2019,196024,20,3,9,7,2
2019,196024,20,4,2,1,1
2019,196024,30,0,73,37,36
2019,196024,30,1,1,1,0
2019,196024,30,2,16,5,11
2019,196024,30,3,38,18,20
2019,196024,30,4,18,13,5
2019,196024,40,0,4,4,0
2019,196024,40,3,1,1,0
2019,196024,40,4,3,3,0
2019,196024,42,0,3,3,0
2019,196024,42,4,3,3,0
2019,196024,43,0,1,1,0
2019,196024,43,3,1,1,0
2019,196033,0,0,105,63,42
2019,196033,10,0,105,63,42
2019,196033,10,1,31,20,11
2019,196033,10,2,34,20,14
2019,196033,10,3,26,14,12
2019,196033,10,4,11,6,5
2019,196033,10,5,3,3,0
2019,196033,20,0,56,34,22
2019,196033,20,1,28,18,10
2019,196033,20,2,26,16,10
2019,196033,20,3,2,0,2
2019,196033,30,0,29,15,14
2019,196033,30,2,8,4,4
2019,196033,30,3,20,10,10
2019,196033,30,4,1,1,0
2019,196033,40,0,20,14,6
2019,196033,40,1,3,2,1
2019,196033,40,3,4,4,0
2019,196033,40,4,10,5,5
2019,196033,40,5,3,3,0
2019,196033,42,0,2,2,0
2019,196033,42,1,1,1,0
2019,196033,42,3,1,1,0
2019,196033,43,0,18,12,6
2019,196033,43,1,2,1,1
2019,196033,43,3,3,3,0
2019,196033,43,4,10,5,5
2019,196033,43,5,3,3,0
2019,196042,0,0,265,140,125
2019,196042,10,0,265,140,125
2019,196042,10,1,57,31,26
2019,196042,10,2,50,27,23
2019,196042,10,3,148,78,70
2019,196042,10,5,10,4,6
2019,196042,20,0,105,60,45
2019,196042,20,1,55,30,25
2019,196042,20,2,43,26,17
2019,196042,20,3,7,4,3
2019,196042,30,0,122,58,64
2019,196042,30,1,2,1,1
2019,196042,30,2,6,0,6
2019,196042,30,3,114,57,57
2019,196042,40,0,38,22,16
2019,196042,40,2,1,1,0
2019,196042,40,3,27,17,10
2019,196042,40,5,10,4,6
2019,196042,42,0,38,22,16
2019,196042,42,2,1,1,0
2019,196042,42,3,27,17,10
2019,196042,42,5,10,4,6
2019,196051,0,0,142,73,69
2019,196051,10,0,142,73,69
2019,196051,10,1,22,15,7
2019,196051,10,2,60,31,29
2019,196051,10,3,53,25,28
2019,196051,10,4,7,2,5
2019,196051,20,0,87,49,38
2019,196051,20,1,22,15,7
2019,196051,20,2,60,31,29
2019,196051,20,3,5,3,2
2019,196051,30,0,50,22,28
2019,196051,30,3,48,22,26
2019,196051,30,4,2,0,2
2019,196051,40,0,5,2,3
2019,196051,40,4,5,2,3
2019,196051,42,0,2,1,1
2019,196051,42,4,2,1,1
2019,196051,43,0,3,1,2
2019,196051,43,4,3,1,2
2019,196060,0,0,667,393,274
2019,196060,10,0,667,393,274
2019,196060,10,1,167,118,49
2019,196060,10,2,220,128,92
2019,196060,10,3,186,101,85
2019,196060,10,5,94,46,48
2019,196060,20,0,384,243,141
2019,196060,20,1,166,117,49
2019,196060,20,2,218,126,92
2019,196060,30,0,168,92,76
2019,196060,30,2,2,2,0
2019,196060,30,3,166,90,76
2019,196060,40,0,115,58,57
2019,196060,40,1,1,1,0
2019,196060,40,3,20,11,9
2019,196060,40,5,94,46,48
2019,196060,41,0,65,28,37
2019,196060,41,3,10,4,6
2019,196060,41,5,55,24,31
2019,196060,42,0,43,24,19
2019,196060,42,1,1,1,0
2019,196060,42,3,5,3,2
2019,196060,42,5,37,20,17
2019,196060,43,0,7,6,1
2019,196060,43,3,5,4,1
2019,196060,43,5,2,2,0
2019,196060,44,0,65,28,37
2019,196060,44,3,10,4,6
2019,196060,44,5,55,24,31
2019,196079,0,0,733,412,321
2019,196079,10,0,733,412,321
2019,196079,10,1,181,128,53
2019,196079,10,2,215,128,87
2019,196079,10,3,228,119,109
2019,196079,10,4,21,7,14
2019,196079,10,5,88,30,58
2019,196079,20,0,385,254,131
2019,196079,20,1,178,128,50
2019,196079,20,2,202,125,77
2019,196079,20,3,1,0,1
2019,196079,20,4,4,1,3
2019,196079,30,0,179,97,82
2019,196079,30,2,1,1,0
2019,196079,30,3,171,92,79
2019,196079,30,4,7,4,3
2019,196079,40,0,169,61,108
2019,196079,40,1,3,0,3
2019,196079,40,2,12,2,10
2019,196079,40,3,56,27,29
2019,196079,40,4,10,2,8
2019,196079,40,5,88,30,58
2019,196079,41,0,86,23,63
2019,196079,41,2,9,0,9
2019,196079,41,3,26,10,16
2019,196079,41,4,7,1,6
2019,196079,41,5,44,12,32
2019,196079,42,0,79,37,42
2019,196079,42,1,2,0,2
2019,196079,42,2,3,2,1
2019,196079,42,3,30,17,13
2019,196079,42,4,3,1,2
2019,196079,42,5,41,17,24
2019,196079,43,0,4,1,3
2019,196079,43,1,1,0,1
2019,196079,43,5,3,1,2
2019,196079,44,0,86,23,63
2019,196079,44,2,9,0,9
2019,196079,44,3,26,10,16
2019,196079,44,4,7,1,6
2019,196079,44,5,44,12,32
2019,196088,0,0,1654,1027,627
2019,196088,10,0,1654,1027,627
2019,196088,10,1,535,399,136
2019,196088,10,2,521,303,218
2019,196088,10,3,509,284,225
2019,196088,10,4,19,8,11
2019,196088,10,5,70,33,37
2019,196088,20,0,824,569,255
2019,196088,20,1,468,354,114
2019,196088,20,2,356,215,141
2019,196088,30,0,277,168,109
2019,196088,30,1,13,8,5
2019,196088,30,2,19,11,8
2019,196088,30,3,242,146,96
2019,196088,30,4,3,3,0
2019,196088,40,0,553,290,263
2019,196088,40,1,54,37,17
2019,196088,40,2,146,77,69
2019,196088,40,3,267,138,129
2019,196088,40,4,16,5,11
2019,196088,40,5,70,33,37
2019,196088,41,0,242,106,136
2019,196088,41,1,11,5,6
2019,196088,41,2,53,20,33
2019,196088,41,3,118,56,62
2019,196088,41,4,9,2,7
2019,196088,41,5,51,23,28
2019,196088,42,0,311,184,127
2019,196088,42,1,43,32,11
2019,196088,42,2,93,57,36
2019,196088,42,3,149,82,67
2019,196088,42,4,7,3,4
2019,196088,42,5,19,10,9
2019,196088,44,0,242,106,136
2019,196088,44,1,11,5,6
2019,196088,44,2,53,20,33
2019,196088,44,3,118,56,62
2019,196088,44,4,9,2,7
2019,196088,44,5,51,23,28
2019,196097,0,0,1910,1072,838
2019,196097,10,0,1910,1072,838
2019,196097,10,1,504,373,131
2019,196097,10,2,469,289,180
2019,196097,10,3,647,324,323
2019,196097,10,4,154,28,126
2019,196097,10,5,136,58,78
2019,196097,20,0,728,516,212
2019,196097,20,1,452,341,111
2019,196097,20,2,275,175,100
2019,196097,20,3,1,0,1
2019,196097,30,0,213,142,71
2019,196097,30,1,12,10,2
2019,196097,30,2,15,11,4
2019,196097,30,3,186,121,65
2019,196097,40,0,969,414,555
2019,196097,40,1,40,22,18
2019,196097,40,2,179,103,76
2019,196097,40,3,460,203,257
2019,196097,40,4,154,28,126
2019,196097,40,5,136,58,78
2019,196097,41,0,129,44,85
2019,196097,41,1,6,2,4
2019,196097,41,2,37,5,32
2019,196097,41,3,52,14,38
2019,196097,41,4,5,1,4
2019,196097,41,5,29,22,7
2019,196097,42,0,840,370,470
2019,196097,42,1,34,20,14
2019,196097,42,2,142,98,44
2019,196097,42,3,408,189,219
2019,196097,42,4,149,27,122
2019,196097,42,5,107,36,71
2019,196097,44,0,129,44,85
2019,196097,44,1,6,2,4
2019,196097,44,2,37,5,32
2019,196097,44,3,52,14,38
2019,196097,44,4,5,1,4
2019,196097,44,5,29,22,7
2019,196103,0,0,132,88,44
2019,196103,10,0,132,88,44
2019,196103,10,1,49,41,8
2019,196103,10,2,34,21,13
2019,196103,10,3,34,18,16
2019,196103,10,4,11,5,6
2019,196103,10,5,4,3,1
2019,196103,20,0,89,65,24
2019,196103,20,1,49,41,8
2019,196103,20,2,33,20,13
2019,196103,20,3,3,2,1
2019,196103,20,4,4,2,2
2019,196103,30,0,35,17,18
2019,196103,30,2,1,1,0
2019,196103,30,3,28,13,15
2019,196103,30,4,6,3,3
2019,196103,40,0,8,6,2
2019,196103,40,3,3,3,0
2019,196103,40,4,1,0,1
2019,196103,40,5,4,3,1
2019,196103,41,0,4,3,1
2019,196103,41,3,2,2,0
2019,196103,41,5,2,1,1
2019,196103,42,0,2,2,0
2019,196103,42,5,2,2,0
2019,196103,43,0,2,1,1
2019,196103,43,3,1,1,0
2019,196103,43,4,1,0,1
2019,196103,44,0,4,3,1
2019,196103,44,3,2,2,0
2019,196103,44,5,2,1,1
2019,196112,0,0,136,92,44
2019,196112,10,0,136,92,44
2019,196112,10,1,30,23,7
2019,196112,10,2,47,33,14
2019,196112,10,3,37,23,14
2019,196112,10,4,2,0,2
2019,196112,10,5,20,13,7
2019,196112,20,0,71,51,20
2019,196112,20,1,28,21,7
2019,196112,20,2,41,29,12
2019,196112,20,3,2,1,1
2019,196112,30,0,36,24,12
2019,196112,30,2,3,2,1
2019,196112,30,3,33,22,11
2019,196112,40,0,29,17,12
2019,196112,40,1,2,2,0
2019,196112,40,2,3,2,1
2019,196112,40,3,2,0,2
2019,196112,40,4,2,0,2
2019,196112,40,5,20,13,7
2019,196112,41,0,26,15,11
2019,196112,41,1,2,2,0
2019,196112,41,3,2,0,2
2019,196112,41,4,2,0,2
2019,196112,41,5,20,13,7
2019,196112,42,0,3,2,1
2019,196112,42,2,3,2,1
2019,196112,44,0,26,15,11
2019,196112,44,1,2,2,0
2019,196112,44,3,2,0,2
2019,196112,44,4,2,0,2
2019,196112,44,5,20,13,7
2019,196121,0,0,341,163,178
2019,196121,10,0,341,163,178
2019,196121,10,1,61,36,25
2019,196121,10,2,131,63,68
2019,196121,10,3,85,42,43
2019,196121,10,4,20,4,16
2019,196121,10,5,44,18,26
2019,196121,20,0,182,94,88
2019,196121,20,1,61,36,25
2019,196121,20,2,119,58,61
2019,196121,20,3,2,0,2
2019,196121,30,0,108,48,60
2019,196121,30,2,11,5,6
2019,196121,30,3,78,39,39
2019,196121,30,4,19,4,15
2019,196121,40,0,51,21,30
2019,196121,40,2,1,0,1
2019,196121,40,3,5,3,2
2019,196121,40,4,1,0,1
2019,196121,40,5,44,18,26
2019,196121,41,0,38,14,24
2019,196121,41,2,1,0,1
2019,196121,41,3,4,2,2
2019,196121,41,4,1,0,1
2019,196121,41,5,32,12,20
2019,196121,42,0,13,7,6
2019,196121,42,3,1,1,0
2019,196121,42,5,12,6,6
2019,196121,44,0,38,14,24
2019,196121,44,2,1,0,1
2019,196121,44,3,4,2,2
2019,196121,44,4,1,0,1
2019,196121,44,5,32,12,20
2019,196130,0,0,362,184,178
2019,196130,10,0,362,184,178
2019,196130,10,1,92,62,30
2019,196130,10,2,154,73,81
2019,196130,10,3,65,31,34
2019,196130,10,5,51,18,33
2019,196130,20,0,235,130,105
2019,196130,20,1,91,61,30
2019,196130,20,2,142,68,74
2019,196130,20,3,2,1,1
2019,196130,30,0,74,35,39
2019,196130,30,2,12,5,7
2019,196130,30,3,62,30,32
2019,196130,40,0,53,19,34
2019,196130,40,1,1,1,0
2019,196130,40,3,1,0,1
2019,196130,40,5,51,18,33
2019,196130,41,0,26,13,13
2019,196130,41,1,1,1,0
2019,196130,41,5,25,12,13
2019,196130,42,0,4,1,3
2019,196130,42,5,4,1,3
2019,196130,43,0,23,5,18
2019,196130,43,3,1,0,1
2019,196130,43,5,22,5,17
2019,196130,44,0,26,13,13
2019,196130,44,1,1,1,0
2019,196130,44,5,25,12,13
2019,196149,0,0,326,155,171
2019,196149,10,0,326,155,171
2019,196149,10,1,74,41,33
2019,196149,10,2,95,39,56
2019,196149,10,3,89,46,43
2019,196149,10,4,15,6,9
2019,196149,10,5,53,23,30
2019,196149,20,0,162,76,86
2019,196149,20,1,74,41,33
2019,196149,20,2,80,29,51
2019,196149,20,3,4,4,0
2019,196149,20,4,4,2,2
2019,196149,30,0,97,46,51
2019,196149,30,2,15,10,5
2019,196149,30,3,76,35,41
2019,196149,30,4,6,1,5
2019,196149,40,0,67,33,34
2019,196149,40,3,9,7,2
2019,196149,40,4,5,3,2
2019,196149,40,5,53,23,30
2019,196149,41,0,50,20,30
2019,196149,41,5,50,20,30
2019,196149,42,0,3,3,0
2019,196149,42,3,1,1,0
2019,196149,42,5,2,2,0
2019,196149,43,0,14,10,4
2019,196149,43,3,8,6,2
2019,196149,43,4,5,3,2
2019,196149,43,5,1,1,0
2019,196149,44,0,50,20,30
2019,196149,44,5,50,20,30
2019,196158,0,0,245,140,105
2019,196158,10,0,245,140,105
2019,196158,10,1,63,41,22
2019,196158,10,2,90,47,43
2019,196158,10,3,50,31,19
2019,196158,10,5,42,21,21
2019,196158,20,0,148,87,61
2019,196158,20,1,63,41,22
2019,196158,20,2,84,45,39
2019,196158,20,3,1,1,0
2019,196158,30,0,55,32,23
2019,196158,30,2,6,2,4
2019,196158,30,3,49,30,19
2019,196158,40,0,42,21,21
2019,196158,40,5,42,21,21
2019,196158,41,0,14,4,10
2019,196158,41,5,14,4,10
2019,196158,42,0,28,17,11
2019,196158,42,5,28,17,11
2019,196158,44,0,14,4,10
2019,196158,44,5,14,4,10
2019,196167,0,0,252,137,115
2019,196167,10,0,252,137,115
2019,196167,10,1,75,50,25
2019,196167,10,2,74,40,34
2019,196167,10,3,64,26,38
2019,196167,10,4,1,1,0
2019,196167,10,5,38,20,18
2019,196167,20,0,146,86,60
2019,196167,20,1,74,49,25
2019,196167,20,2,66,37,29
2019,196167,20,3,6,0,6
2019,196167,30,0,58,24,34
2019,196167,30,2,8,3,5
2019,196167,30,3,49,20,29
2019,196167,30,4,1,1,0
2019,196167,40,0,48,27,21
2019,196167,40,1,1,1,0
2019,196167,40,3,9,6,3
2019,196167,40,5,38,20,18
2019,196167,41,0,34,17,17
2019,196167,41,3,1,1,0
2019,196167,41,5,33,16,17
2019,196167,42,0,14,10,4
2019,196167,42,1,1,1,0
2019,196167,42,3,8,5,3
2019,196167,42,5,5,4,1
2019,196167,44,0,34,17,17
2019,196167,44,3,1,1,0
2019,196167,44,5,33,16,17
2019,196176,0,0,344,163,181
2019,196176,10,0,344,163,181
2019,196176,10,1,55,34,21
2019,196176,10,2,139,71,68
2019,196176,10,3,76,31,45
2019,196176,10,4,9,1,8
2019,196176,10,5,65,26,39
2019,196176,20,0,191,98,93
2019,196176,20,1,55,34,21
2019,196176,20,2,126,61,65
2019,196176,20,3,5,3,2
2019,196176,20,4,5,0,5
2019,196176,30,0,84,36,48
2019,196176,30,2,12,9,3
2019,196176,30,3,68,26,42
2019,196176,30,4,4,1,3
2019,196176,40,0,69,29,40
2019,196176,40,2,1,1,0
2019,196176,40,3,3,2,1
2019,196176,40,5,65,26,39
2019,196176,41,0,43,16,27
2019,196176,41,5,43,16,27
2019,196176,42,0,26,13,13
2019,196176,42,2,1,1,0
2019,196176,42,3,3,2,1
2019,196176,42,5,22,10,12
2019,196176,44,0,43,16,27
2019,196176,44,5,43,16,27
2019,196185,0,0,284,152,132
2019,196185,10,0,284,152,132
2019,196185,10,1,57,36,21
2019,196185,10,2,102,55,47
2019,196185,10,3,87,39,48
2019,196185,10,5,38,22,16
2019,196185,20,0,158,89,69
2019,196185,20,1,56,35,21
2019,196185,20,2,93,49,44
2019,196185,20,3,9,5,4
2019,196185,30,0,82,38,44
2019,196185,30,2,9,6,3
2019,196185,30,3,73,32,41
2019,196185,40,0,44,25,19
2019,196185,40,1,1,1,0
2019,196185,40,3,5,2,3
2019,196185,40,5,38,22,16
2019,196185,41,0,13,8,5
2019,196185,41,5,13,8,5
2019,196185,42,0,30,16,14
2019,196185,42,1,1,1,0
2019,196185,42,3,5,2,3
2019,196185,42,5,24,13,11
2019,196185,43,0,1,1,0
2019,196185,43,5,1,1,0
2019,196185,44,0,13,8,5
2019,196185,44,5,13,8,5
2019,196194,0,0,371,197,174
2019,196194,10,0,371,197,174
2019,196194,10,1,79,50,29
2019,196194,10,2,98,49,49
2019,196194,10,3,168,84,84
2019,196194,10,4,18,9,9
2019,196194,10,5,8,5,3
2019,196194,20,0,169,100,69
2019,196194,20,1,78,50,28
2019,196194,20,2,81,43,38
2019,196194,20,3,10,7,3
2019,196194,30,0,113,48,65
2019,196194,30,1,1,0,1
2019,196194,30,2,17,6,11
2019,196194,30,3,92,41,51
2019,196194,30,4,3,1,2
2019,196194,40,0,89,49,40
2019,196194,40,3,66,36,30
2019,196194,40,4,15,8,7
2019,196194,40,5,8,5,3
2019,196194,41,0,1,1,0
2019,196194,41,3,1,1,0
2019,196194,42,0,48,24,24
2019,196194,42,3,37,18,19
2019,196194,42,4,3,1,2
2019,196194,42,5,8,5,3
2019,196194,43,0,40,24,16
2019,196194,43,3,28,17,11
2019,196194,43,4,12,7,5
2019,196194,44,0,1,1,0
2019,196194,44,3,1,1,0
2019,196200,0,0,243,118,125
2019,196200,10,0,243,118,125
2019,196200,10,1,66,41,25
2019,196200,10,2,77,41,36
2019,196200,10,3,69,29,40
2019,196200,10,4,20,6,14
2019,196200,10,5,11,1,10
2019,196200,20,0,148,84,64
2019,196200,20,1,66,41,25
2019,196200,20,2,75,41,34
2019,196200,20,3,2,1,1
2019,196200,20,4,5,1,4
2019,196200,30,0,61,23,38
2019,196200,30,2,2,0,2
2019,196200,30,3,53,20,33
2019,196200,30,4,6,3,3
2019,196200,40,0,34,11,23
2019,196200,40,3,14,8,6
2019,196200,40,4,9,2,7
2019,196200,40,5,11,1,10
2019,196200,41,0,8,0,8
2019,196200,41,4,1,0,1
2019,196200,41,5,7,0,7
2019,196200,42,0,26,11,15
2019,196200,42,3,14,8,6
2019,196200,42,4,8,2,6
2019,196200,42,5,4,1,3
2019,196200,44,0,8,0,8
2019,196200,44,4,1,0,1
2019,196200,44,5,7,0,7
2019,196219,0,0,185,87,98
2019,196219,10,0,185,87,98
2019,196219,10,1,31,16,15
2019,196219,10,2,68,33,35
2019,196219,10,3,82,36,46
2019,196219,10,5,4,2,2
2019,196219,20,0,90,45,45
2019,196219,20,1,31,16,15
2019,196219,20,2,59,29,30
2019,196219,30,0,53,27,26
2019,196219,30,2,6,3,3
2019,196219,30,3,47,24,23
2019,196219,40,0,42,15,27
2019,196219,40,2,3,1,2
2019,196219,40,3,35,12,23
2019,196219,40,5,4,2,2
2019,196219,41,0,13,3,10
2019,196219,41,2,3,1,2
2019,196219,41,3,8,1,7
2019,196219,41,5,2,1,1
2019,196219,42,0,29,12,17
2019,196219,42,3,27,11,16
2019,196219,42,5,2,1,1
2019,196219,44,0,13,3,10
2019,196219,44,2,3,1,2
2019,196219,44,3,8,1,7
2019,196219,44,5,2,1,1
2019,196228,0,0,71,28,43
2019,196228,10,0,71,28,43
2019,196228,10,1,15,12,3
2019,196228,10,2,19,5,14
2019,196228,10,3,36,10,26
2019,196228,10,4,1,1,0
2019,196228,20,0,18,15,3
2019,196228,20,1,14,12,2
2019,196228,20,2,4,3,1
2019,196228,30,0,1,0,1
2019,196228,30,3,1,0,1
2019,196228,40,0,52,13,39
2019,196228,40,1,1,0,1
2019,196228,40,2,15,2,13
2019,196228,40,3,35,10,25
2019,196228,40,4,1,1,0
2019,196228,41,0,1,1,0
2019,196228,41,3,1,1,0
2019,196228,42,0,51,12,39
2019,196228,42,1,1,0,1
2019,196228,42,2,15,2,13
2019,196228,42,3,34,9,25
2019,196228,42,4,1,1,0
2019,196228,44,0,1,1,0
2019,196228,44,3,1,1,0
2019,196237,0,0,174,81,93
2019,196237,10,0,174,81,93
2019,196237,10,1,24,11,13
2019,196237,10,2,68,32,36
2019,196237,10,3,64,29,35
2019,196237,10,4,3,3,0
2019,196237,10,5,15,6,9
2019,196237,20,0,91,43,48
2019,196237,20,1,24,11,13
2019,196237,20,2,66,31,35
2019,196237,20,4,1,1,0
2019,196237,30,0,53,25,28
2019,196237,30,3,53,25,28
2019,196237,40,0,30,13,17
2019,196237,40,2,2,1,1
2019,196237,40,3,11,4,7
2019,196237,40,4,2,2,0
2019,196237,40,5,15,6,9
2019,196237,41,0,1,0,1
2019,196237,41,5,1,0,1
2019,196237,42,0,28,12,16
2019,196237,42,2,2,1,1
2019,196237,42,3,11,4,7
2019,196237,42,4,1,1,0
2019,196237,42,5,14,6,8
2019,196237,43,0,1,1,0
2019,196237,43,4,1,1,0
2019,196237,44,0,1,0,1
2019,196237,44,5,1,0,1
2019,196246,0,0,254,133,121
2019,196246,10,0,254,133,121
2019,196246,10,1,60,40,20
2019,196246,10,2,85,49,36
2019,196246,10,3,62,23,39
2019,196246,10,5,47,21,26
2019,196246,20,0,141,86,55
2019,196246,20,1,60,40,20
2019,196246,20,2,77,44,33
2019,196246,20,3,4,2,2
2019,196246,30,0,66,26,40
2019,196246,30,2,8,5,3
2019,196246,30,3,58,21,37
2019,196246,40,0,47,21,26
2019,196246,40,5,47,21,26
2019,196246,41,0,7,3,4
2019,196246,41,5,7,3,4
2019,196246,42,0,40,18,22
2019,196246,42,5,40,18,22
2019,196246,44,0,7,3,4
2019,196246,44,5,7,3,4
2019,196255,0,0,492,289,203
2019,196255,10,0,492,289,203
2019,196255,10,1,133,96,37
2019,196255,10,2,101,56,45
2019,196255,10,3,244,134,110
2019,196255,10,4,12,3,9
2019,196255,10,5,2,0,2
2019,196255,20,0,156,104,52
2019,196255,20,1,102,73,29
2019,196255,20,2,52,29,23
2019,196255,20,3,2,2,0
2019,196255,30,0,119,62,57
2019,196255,30,1,15,9,6
2019,196255,30,2,9,5,4
2019,196255,30,3,95,48,47
2019,196255,40,0,217,123,94
2019,196255,40,1,16,14,2
2019,196255,40,2,40,22,18
2019,196255,40,3,147,84,63
2019,196255,40,4,12,3,9
2019,196255,40,5,2,0,2
2019,196255,41,0,28,16,12
2019,196255,41,1,1,0,1
2019,196255,41,2,5,2,3
2019,196255,41,3,18,12,6
2019,196255,41,4,4,2,2
2019,196255,42,0,189,107,82
2019,196255,42,1,15,14,1
2019,196255,42,2,35,20,15
2019,196255,42,3,129,72,57
2019,196255,42,4,8,1,7
2019,196255,42,5,2,0,2
2019,196255,44,0,28,16,12
2019,196255,44,1,1,0,1
2019,196255,44,2,5,2,3
2019,196255,44,3,18,12,6
2019,196255,44,4,4,2,2
2019,196264,0,0,165,56,109
2019,196264,10,0,165,56,109
2019,196264,10,1,36,14,22
2019,196264,10,2,91,34,57
2019,196264,10,3,30,6,24
2019,196264,10,4,1,0,1
2019,196264,10,5,7,2,5
2019,196264,20,0,131,46,85
2019,196264,20,1,35,13,22
2019,196264,20,2,85,31,54
2019,196264,20,3,11,2,9
2019,196264,30,0,20,6,14
2019,196264,30,2,5,3,2
2019,196264,30,3,14,3,11
2019,196264,30,4,1,0,1
2019,196264,40,0,14,4,10
2019,196264,40,1,1,1,0
2019,196264,40,2,1,0,1
2019,196264,40,3,5,1,4
2019,196264,40,5,7,2,5
2019,196264,41,0,1,0,1
2019,196264,41,5,1,0,1
2019,196264,42,0,13,4,9
2019,196264,42,1,1,1,0
2019,196264,42,2,1,0,1
2019,196264,42,3,5,1,4
2019,196264,42,5,6,2,4
2019,196264,44,0,1,0,1
2019,196264,44,5,1,0,1
2019,196291,0,0,92,72,20
2019,196291,10,0,92,72,20
2019,196291,10,1,24,19,5
2019,196291,10,2,18,12,6
2019,196291,10,3,18,12,6
2019,196291,10,4,1,1,0
2019,196291,10,5,31,28,3
2019,196291,20,0,42,31,11
2019,196291,20,1,23,18,5
2019,196291,20,2,16,10,6
2019,196291,20,3,3,3,0
2019,196291,30,0,16,10,6
2019,196291,30,2,1,1,0
2019,196291,30,3,15,9,6
2019,196291,40,0,34,31,3
2019,196291,40,1,1,1,0
2019,196291,40,2,1,1,0
2019,196291,40,4,1,1,0
2019,196291,40,5,31,28,3
2019,196291,41,0,28,26,2
2019,196291,41,2,1,1,0
2019,196291,41,5,27,25,2
2019,196291,42,0,6,5,1
2019,196291,42,1,1,1,0
2019,196291,42,4,1,1,0
2019,196291,42,5,4,3,1
2019,196291,44,0,28,26,2
2019,196291,44,2,1,1,0
2019,196291,44,5,27,25,2
2019,196307,0,0,562,368,194
2019,196307,10,0,562,368,194
2019,196307,10,1,119,98,21
2019,196307,10,2,138,92,46
2019,196307,10,3,287,170,117
2019,196307,10,4,18,8,10
2019,196307,20,0,151,117,34
2019,196307,20,1,88,73,15
2019,196307,20,2,61,43,18
2019,196307,20,3,2,1,1
2019,196307,30,0,49,32,17
2019,196307,30,1,2,2,0
2019,196307,30,2,7,5,2
2019,196307,30,3,40,25,15
2019,196307,40,0,362,219,143
2019,196307,40,1,29,23,6
2019,196307,40,2,70,44,26
2019,196307,40,3,245,144,101
2019,196307,40,4,18,8,10
2019,196307,41,0,259,156,103
2019,196307,41,1,25,19,6
2019,196307,41,2,57,37,20
2019,196307,41,3,166,97,69
2019,196307,41,4,11,3,8
2019,196307,42,0,103,63,40
2019,196307,42,1,4,4,0
2019,196307,42,2,13,7,6
2019,196307,42,3,79,47,32
2019,196307,42,4,7,5,2
2019,196307,44,0,259,156,103
2019,196307,44,1,25,19,6
2019,196307,44,2,57,37,20
2019,196307,44,3,166,97,69
2019,196307,44,4,11,3,8
2019,196389,0,0,60,29,31
2019,196389,10,0,60,29,31
2019,196389,10,4,60,29,31
2019,196389,40,0,60,29,31
2019,196389,40,4,60,29,31
2019,196389,41,0,60,29,31
2019,196389,41,4,60,29,31
2019,196389,44,0,60,29,31
2019,196389,44,4,60,29,31
2019,196413,0,0,1139,650,489
2019,196413,10,0,1138,650,488
2019,196413,10,1,428,287,141
2019,196413,10,2,340,180,160
2019,196413,10,3,353,175,178
2019,196413,10,4,10,4,6
2019,196413,10,5,7,4,3
2019,196413,20,0,660,410,250
2019,196413,20,1,347,241,106
2019,196413,20,2,306,166,140
2019,196413,20,3,7,3,4
2019,196413,30,0,224,120,104
2019,196413,30,1,1,1,0
2019,196413,30,2,2,2,0
2019,196413,30,3,221,117,104
2019,196413,40,0,254,120,134
2019,196413,40,1,80,45,35
2019,196413,40,2,32,12,20
2019,196413,40,3,125,55,70
2019,196413,40,4,10,4,6
2019,196413,40,5,7,4,3
2019,196413,41,0,254,120,134
2019,196413,41,1,80,45,35
2019,196413,41,2,32,12,20
2019,196413,41,3,125,55,70
2019,196413,41,4,10,4,6
2019,196413,41,5,7,4,3
2019,196413,44,0,254,120,134
2019,196413,44,1,80,45,35
2019,196413,44,2,32,12,20
2019,196413,44,3,125,55,70
2019,196413,44,4,10,4,6
2019,196413,44,5,7,4,3
2019,196413,50,0,1,0,1
2019,196431,0,0,20,20,0
2019,196431,10,0,20,20,0
2019,196431,10,4,20,20,0
2019,196431,40,0,20,20,0
2019,196431,40,4,20,20,0
2019,196431,42,0,20,20,0
2019,196431,42,4,20,20,0
2019,196468,0,0,226,81,145
2019,196468,10,0,226,81,145
2019,196468,10,1,90,40,50
2019,196468,10,2,57,19,38
2019,196468,10,3,17,8,9
2019,196468,10,4,4,0,4
2019,196468,10,5,48,11,37
2019,196468,10,6,10,3,7
2019,196468,20,0,125,50,75
2019,196468,20,1,80,35,45
2019,196468,20,2,45,15,30
2019,196468,30,0,21,9,12
2019,196468,30,2,4,1,3
2019,196468,30,3,17,8,9
2019,196468,40,0,80,22,58
2019,196468,40,1,10,5,5
2019,196468,40,2,8,3,5
2019,196468,40,4,4,0,4
2019,196468,40,5,48,11,37
2019,196468,40,6,10,3,7
2019,196468,41,0,46,13,33
2019,196468,41,1,10,5,5
2019,196468,41,2,8,3,5
2019,196468,41,4,2,0,2
2019,196468,41,5,26,5,21
2019,196468,42,0,34,9,25
2019,196468,42,4,2,0,2
2019,196468,42,5,22,6,16
2019,196468,42,6,10,3,7
2019,196468,44,0,46,13,33
2019,196468,44,1,10,5,5
2019,196468,44,2,8,3,5
2019,196468,44,4,2,0,2
2019,196468,44,5,26,5,21
2019,196565,0,0,55,20,35
2019,196565,10,0,55,20,35
2019,196565,10,1,40,17,23
2019,196565,10,2,6,0,6
2019,196565,10,3,7,2,5
2019,196565,10,4,2,1,1
2019,196565,20,0,44,17,27
2019,196565,20,1,40,17,23
2019,196565,20,2,4,0,4
2019,196565,30,0,11,3,8
2019,196565,30,2,2,0,2
2019,196565,30,3,7,2,5
2019,196565,30,4,2,1,1
2019,196592,0,0,489,255,234
2019,196592,10,0,489,255,234
2019,196592,10,1,57,39,18
2019,196592,10,2,129,70,59
2019,196592,10,3,192,87,105
2019,196592,10,4,97,54,43
2019,196592,10,5,10,5,5
2019,196592,10,6,4,0,4
2019,196592,20,0,29,21,8
2019,196592,20,1,22,15,7
2019,196592,20,2,6,5,1
2019,196592,20,4,1,1,0
2019,196592,30,0,1,0,1
2019,196592,30,3,1,0,1
2019,196592,40,0,459,234,225
2019,196592,40,1,35,24,11
2019,196592,40,2,123,65,58
2019,196592,40,3,191,87,104
2019,196592,40,4,96,53,43
2019,196592,40,5,10,5,5
2019,196592,40,6,4,0,4
2019,196592,41,0,93,44,49
2019,196592,41,1,14,8,6
2019,196592,41,2,35,15,20
2019,196592,41,3,34,12,22
2019,196592,41,4,10,9,1
2019,196592,42,0,366,190,176
2019,196592,42,1,21,16,5
2019,196592,42,2,88,50,38
2019,196592,42,3,157,75,82
2019,196592,42,4,86,44,42
2019,196592,42,5,10,5,5
2019,196592,42,6,4,0,4
2019,196592,44,0,81,34,47
2019,196592,44,1,13,8,5
2019,196592,44,2,33,13,20
2019,196592,44,3,33,12,21
2019,196592,44,4,2,1,1
2019,196592,45,0,12,10,2
2019,196592,45,1,1,0,1
2019,196592,45,2,2,2,0
2019,196592,45,3,1,0,1
2019,196592,45,4,8,8,0
2019,196653,0,0,36,12,24
2019,196653,10,0,36,12,24
2019,196653,10,1,11,3,8
2019,196653,10,2,4,3,1
2019,196653,10,3,13,3,10
2019,196653,10,4,7,2,5
2019,196653,10,5,1,1,0
2019,196653,40,0,36,12,24
2019,196653,40,1,11,3,8
2019,196653,40,2,4,3,1
2019,196653,40,3,13,3,10
2019,196653,40,4,7,2,5
2019,196653,40,5,1,1,0
2019,196653,41,0,26,8,18
2019,196653,41,1,11,3,8
2019,196653,41,2,4,3,1
2019,196653,41,3,10,2,8
2019,196653,41,4,1,0,1
2019,196653,42,0,10,4,6
2019,196653,42,3,3,1,2
2019,196653,42,4,6,2,4
2019,196653,42,5,1,1,0
2019,196653,44,0,12,3,9
2019,196653,44,1,1,0,1
2019,196653,44,2,2,1,1
2019,196653,44,3,8,2,6
2019,196653,44,4,1,0,1
2019,196653,45,0,14,5,9
2019,196653,45,1,10,3,7
2019,196653,45,2,2,2,0
2019,196653,45,3,2,0,2
2019,196699,0,0,61,27,34
2019,196699,10,0,61,27,34
2019,196699,10,1,19,11,8
2019,196699,10,2,16,6,10
2019,196699,10,3,22,9,13
2019,196699,10,4,4,1,3
2019,196699,20,0,45,22,23
2019,196699,20,1,19,11,8
2019,196699,20,2,16,6,10
2019,196699,20,3,10,5,5
2019,196699,30,0,11,3,8
2019,196699,30,3,8,2,6
2019,196699,30,4,3,1,2
2019,196699,40,0,5,2,3
2019,196699,40,3,4,2,2
2019,196699,40,4,1,0,1
2019,196699,42,0,5,2,3
2019,196699,42,3,4,2,2
2019,196699,42,4,1,0,1
2019,196866,0,0,213,123,90
2019,196866,10,0,213,123,90
2019,196866,10,1,81,49,32
2019,196866,10,2,57,32,25
2019,196866,10,3,32,16,16
2019,196866,10,4,23,16,7
2019,196866,10,5,20,10,10
2019,196866,20,0,138,81,57
2019,196866,20,1,81,49,32
2019,196866,20,2,57,32,25
2019,196866,30,0,32,16,16
2019,196866,30,3,32,16,16
2019,196866,40,0,43,26,17
2019,196866,40,4,23,16,7
2019,196866,40,5,20,10,10
2019,196866,41,0,40,24,16
2019,196866,41,4,20,14,6
2019,196866,41,5,20,10,10
2019,196866,42,0,3,2,1
2019,196866,42,4,3,2,1
2019,196866,44,0,40,24,16
2019,196866,44,4,20,14,6
2019,196866,44,5,20,10,10
2019,196884,0,0,19,8,11
2019,196884,10,0,19,8,11
2019,196884,10,1,8,3,5
2019,196884,10,2,9,5,4
2019,196884,10,3,2,0,2
2019,196884,20,0,15,6,9
2019,196884,20,1,8,3,5
2019,196884,20,2,7,3,4
2019,196884,30,0,2,0,2
2019,196884,30,3,2,0,2
2019,196884,40,0,2,2,0
2019,196884,40,2,2,2,0
2019,196884,41,0,2,2,0
2019,196884,41,2,2,2,0
2019,196884,44,0,2,2,0
2019,196884,44,2,2,2,0
2019,197018,0,0,102,102,0
2019,197018,10,0,65,65,0
2019,197018,10,1,16,16,0
2019,197018,10,2,6,6,0
2019,197018,10,3,14,14,0
2019,197018,10,4,15,15,0
2019,197018,10,5,14,14,0
2019,197018,40,0,65,65,0
2019,197018,40,1,16,16,0
2019,197018,40,2,6,6,0
2019,197018,40,3,14,14,0
2019,197018,40,4,15,15,0
2019,197018,40,5,14,14,0
2019,197018,43,0,65,65,0
2019,197018,43,1,16,16,0
2019,197018,43,2,6,6,0
2019,197018,43,3,14,14,0
2019,197018,43,4,15,15,0
2019,197018,43,5,14,14,0
2019,197018,50,0,37,37,0
2019,197027,0,0,107,91,16
2019,197027,10,0,102,86,16
2019,197027,10,1,26,21,5
2019,197027,10,2,26,23,3
2019,197027,10,3,20,15,5
2019,197027,10,4,30,27,3
2019,197027,20,0,54,45,9
2019,197027,20,1,26,21,5
2019,197027,20,2,23,20,3
2019,197027,20,3,5,4,1
2019,197027,30,0,18,14,4
2019,197027,30,2,3,3,0
2019,197027,30,3,15,11,4
2019,197027,40,0,30,27,3
2019,197027,40,4,30,27,3
2019,197027,42,0,30,27,3
2019,197027,42,4,30,27,3
2019,197027,50,0,5,5,0
2019,197036,0,0,261,186,75
2019,197036,10,0,261,186,75
2019,197036,10,1,45,34,11
2019,197036,10,2,47,36,11
2019,197036,10,3,97,72,25
2019,197036,10,4,42,28,14
2019,197036,10,5,16,5,11
2019,197036,10,6,14,11,3
2019,197036,20,0,84,62,22
2019,197036,20,1,43,32,11
2019,197036,20,2,39,28,11
2019,197036,20,3,2,2,0
2019,197036,30,0,20,16,4
2019,197036,30,1,1,1,0
2019,197036,30,3,19,15,4
2019,197036,40,0,157,108,49
2019,197036,40,1,1,1,0
2019,197036,40,2,8,8,0
2019,197036,40,3,76,55,21
2019,197036,40,4,42,28,14
2019,197036,40,5,16,5,11
2019,197036,40,6,14,11,3
2019,197036,41,0,157,108,49
2019,197036,41,1,1,1,0
2019,197036,41,2,8,8,0
2019,197036,41,3,76,55,21
2019,197036,41,4,42,28,14
2019,197036,41,5,16,5,11
2019,197036,41,6,14,11,3
2019,197036,44,0,157,108,49
2019,197036,44,1,1,1,0
2019,197036,44,2,8,8,0
2019,197036,44,3,76,55,21
2019,197036,44,4,42,28,14
2019,197036,44,5,16,5,11
2019,197036,44,6,14,11,3
2019,197045,0,0,159,84,75
2019,197045,10,0,159,84,75
2019,197045,10,1,32,21,11
2019,197045,10,2,48,29,19
2019,197045,10,3,44,19,25
2019,197045,10,6,35,15,20
2019,197045,20,0,75,45,30
2019,197045,20,1,32,21,11
2019,197045,20,2,41,24,17
2019,197045,20,3,2,0,2
2019,197045,30,0,49,24,25
2019,197045,30,2,7,5,2
2019,197045,30,3,42,19,23
2019,197045,40,0,35,15,20
2019,197045,40,6,35,15,20
2019,197045,41,0,30,12,18
2019,197045,41,6,30,12,18
2019,197045,42,0,5,3,2
2019,197045,42,6,5,3,2
2019,197045,44,0,30,12,18
2019,197045,44,6,30,12,18
2019,197133,0,0,287,146,141
2019,197133,10,0,287,146,141
2019,197133,10,1,94,50,44
2019,197133,10,2,77,40,37
2019,197133,10,3,50,23,27
2019,197133,10,5,12,7,5
2019,197133,10,6,54,26,28
2019,197133,20,0,176,92,84
2019,197133,20,1,94,50,44
2019,197133,20,2,77,40,37
2019,197133,20,6,5,2,3
2019,197133,30,0,50,23,27
2019,197133,30,3,50,23,27
2019,197133,40,0,61,31,30
2019,197133,40,5,12,7,5
2019,197133,40,6,49,24,25
2019,197133,41,0,35,21,14
2019,197133,41,5,12,7,5
2019,197133,41,6,23,14,9
2019,197133,42,0,26,10,16
2019,197133,42,6,26,10,16
2019,197133,44,0,35,21,14
2019,197133,44,5,12,7,5
2019,197133,44,6,23,14,9
2019,197142,0,0,30,12,18
2019,197142,10,0,30,12,18
2019,197142,10,1,7,2,5
2019,197142,10,2,7,2,5
2019,197142,10,3,8,4,4
2019,197142,10,4,8,4,4
2019,197142,40,0,30,12,18
2019,197142,40,1,7,2,5
2019,197142,40,2,7,2,5
2019,197142,40,3,8,4,4
2019,197142,40,4,8,4,4
2019,197142,42,0,30,12,18
2019,197142,42,1,7,2,5
2019,197142,42,2,7,2,5
2019,197142,42,3,8,4,4
2019,197142,42,4,8,4,4
2019,197151,0,0,444,262,182
2019,197151,10,0,444,262,182
2019,197151,10,6,444,262,182
2019,197151,40,0,444,262,182
2019,197151,40,6,444,262,182
2019,197151,43,0,444,262,182
2019,197151,43,6,444,262,182
2019,197197,0,0,113,50,63
2019,197197,10,0,107,48,59
2019,197197,10,1,33,18,15
2019,197197,10,2,36,15,21
2019,197197,10,3,21,9,12
2019,197197,10,4,1,0,1
2019,197197,10,6,16,6,10
2019,197197,20,0,62,32,30
2019,197197,20,1,33,18,15
2019,197197,20,2,25,13,12
2019,197197,20,3,4,1,3
2019,197197,30,0,23,10,13
2019,197197,30,2,6,2,4
2019,197197,30,3,17,8,9
2019,197197,40,0,22,6,16
2019,197197,40,2,5,0,5
2019,197197,40,4,1,0,1
2019,197197,40,6,16,6,10
2019,197197,41,0,9,2,7
2019,197197,41,6,9,2,7
2019,197197,42,0,13,4,9
2019,197197,42,2,5,0,5
2019,197197,42,4,1,0,1
2019,197197,42,6,7,4,3
2019,197197,45,0,9,2,7
2019,197197,45,6,9,2,7
2019,197197,50,0,6,2,4
2019,197221,0,0,9,8,1
2019,197221,10,0,9,8,1
2019,197221,10,1,5,4,1
2019,197221,10,2,1,1,0
2019,197221,10,3,3,3,0
2019,197221,40,0,9,8,1
2019,197221,40,1,5,4,1
2019,197221,40,2,1,1,0
2019,197221,40,3,3,3,0
2019,197221,41,0,9,8,1
2019,197221,41,1,5,4,1
2019,197221,41,2,1,1,0
2019,197221,41,3,3,3,0
2019,197221,44,0,9,8,1
2019,197221,44,1,5,4,1
2019,197221,44,2,1,1,0
2019,197221,44,3,3,3,0
2019,197230,0,0,38,17,21
2019,197230,10,0,38,17,21
2019,197230,10,1,13,8,5
2019,197230,10,2,7,2,5
2019,197230,10,3,15,6,9
2019,197230,10,4,2,0,2
2019,197230,10,5,1,1,0
2019,197230,20,0,20,10,10
2019,197230,20,1,13,8,5
2019,197230,20,2,7,2,5
2019,197230,30,0,11,4,7
2019,197230,30,3,11,4,7
2019,197230,40,0,7,3,4
2019,197230,40,3,4,2,2
2019,197230,40,4,2,0,2
2019,197230,40,5,1,1,0
2019,197230,41,0,2,0,2
2019,197230,41,3,2,0,2
2019,197230,42,0,5,3,2
2019,197230,42,3,2,2,0
2019,197230,42,4,2,0,2
2019,197230,42,5,1,1,0
2019,197230,44,0,2,0,2
2019,197230,44,3,2,0,2
2019,197285,0,0,22,11,11
2019,197285,10,0,22,11,11
2019,197285,10,1,3,1,2
2019,197285,10,2,4,2,2
2019,197285,10,3,11,5,6
2019,197285,10,4,4,3,1
2019,197285,40,0,22,11,11
2019,197285,40,1,3,1,2
2019,197285,40,2,4,2,2
2019,197285,40,3,11,5,6
2019,197285,40,4,4,3,1
2019,197285,41,0,22,11,11
2019,197285,41,1,3,1,2
2019,197285,41,2,4,2,2
2019,197285,41,3,11,5,6
2019,197285,41,4,4,3,1
2019,197285,45,0,22,11,11
2019,197285,45,1,3,1,2
2019,197285,45,2,4,2,2
2019,197285,45,3,11,5,6
2019,197285,45,4,4,3,1
2019,197294,0,0,167,76,91
2019,197294,10,0,167,76,91
2019,197294,10,1,47,20,27
2019,197294,10,2,30,18,12
2019,197294,10,3,52,24,28
2019,197294,10,4,38,14,24
2019,197294,20,0,124,61,63
2019,197294,20,1,47,20,27
2019,197294,20,2,30,18,12
2019,197294,20,3,47,23,24
2019,197294,30,0,42,15,27
2019,197294,30,3,5,1,4
2019,197294,30,4,37,14,23
2019,197294,40,0,1,0,1
2019,197294,40,4,1,0,1
2019,197294,42,0,1,0,1
2019,197294,42,4,1,0,1
2019,197647,0,0,11,11,0
2019,197647,10,0,11,11,0
2019,197647,10,4,11,11,0
2019,197647,40,0,11,11,0
2019,197647,40,4,11,11,0
2019,197647,42,0,11,11,0
2019,197647,42,4,11,11,0
2019,197674,0,0,17,17,0
2019,197674,10,0,17,17,0
2019,197674,10,1,4,4,0
2019,197674,10,4,13,13,0
2019,197674,20,0,11,11,0
2019,197674,20,1,4,4,0
2019,197674,20,4,7,7,0
2019,197674,30,0,2,2,0
2019,197674,30,4,2,2,0
2019,197674,40,0,4,4,0
2019,197674,40,4,4,4,0
2019,197674,42,0,4,4,0
2019,197674,42,4,4,4,0
2019,197708,0,0,344,214,130
2019,197708,10,0,344,214,130
2019,197708,10,1,95,71,24
2019,197708,10,2,68,33,35
2019,197708,10,3,48,24,24
2019,197708,10,4,133,86,47
2019,197708,20,0,146,100,46
2019,197708,20,1,89,68,21
2019,197708,20,2,54,29,25
2019,197708,20,3,3,3,0
2019,197708,30,0,26,10,16
2019,197708,30,2,4,0,4
2019,197708,30,3,22,10,12
2019,197708,40,0,172,104,68
2019,197708,40,1,6,3,3
2019,197708,40,2,10,4,6
2019,197708,40,3,23,11,12
2019,197708,40,4,133,86,47
2019,197708,42,0,172,104,68
2019,197708,42,1,6,3,3
2019,197708,42,2,10,4,6
2019,197708,42,3,23,11,12
2019,197708,42,4,133,86,47
2019,197735,0,0,51,51,0
2019,197735,10,0,51,51,0
2019,197735,10,4,51,51,0
2019,197735,40,0,51,51,0
2019,197735,40,4,51,51,0
2019,197735,42,0,51,51,0
2019,197735,42,4,51,51,0
2019,197814,0,0,74,30,44
2019,197814,10,0,74,30,44
2019,197814,10,6,74,30,44
2019,197814,40,0,74,30,44
2019,197814,40,6,74,30,44
2019,197814,42,0,74,30,44
2019,197814,42,6,74,30,44
2019,197850,0,0,73,38,35
2019,197850,10,0,60,26,34
2019,197850,10,6,60,26,34
2019,197850,40,0,60,26,34
2019,197850,40,6,60,26,34
2019,197850,42,0,60,26,34
2019,197850,42,6,60,26,34
2019,197850,50,0,13,12,1
2019,197869,0,0,1014,526,488
2019,197869,10,0,1014,526,488
2019,197869,10,1,330,192,138
2019,197869,10,2,215,112,103
2019,197869,10,3,229,112,117
2019,197869,10,4,12,5,7
2019,197869,10,5,202,91,111
2019,197869,10,6,26,14,12
2019,197869,20,0,535,297,238
2019,197869,20,1,328,190,138
2019,197869,20,2,207,107,100
2019,197869,30,0,211,106,105
2019,197869,30,2,7,4,3
2019,197869,30,3,204,102,102
2019,197869,40,0,268,123,145
2019,197869,40,1,2,2,0
2019,197869,40,2,1,1,0
2019,197869,40,3,25,10,15
2019,197869,40,4,12,5,7
2019,197869,40,5,202,91,111
2019,197869,40,6,26,14,12
2019,197869,41,0,91,42,49
2019,197869,41,1,1,1,0
2019,197869,41,3,8,4,4
2019,197869,41,4,3,1,2
2019,197869,41,5,72,30,42
2019,197869,41,6,7,6,1
2019,197869,42,0,169,80,89
2019,197869,42,1,1,1,0
2019,197869,42,2,1,1,0
2019,197869,42,3,17,6,11
2019,197869,42,4,9,4,5
2019,197869,42,5,126,60,66
2019,197869,42,6,15,8,7
2019,197869,43,0,8,1,7
2019,197869,43,5,4,1,3
2019,197869,43,6,4,0,4
2019,197869,44,0,91,42,49
2019,197869,44,1,1,1,0
2019,197869,44,3,8,4,4
2019,197869,44,4,3,1,2
2019,197869,44,5,72,30,42
2019,197869,44,6,7,6,1
2019,197887,0,0,162,61,101
2019,197887,10,0,162,61,101
2019,197887,10,6,162,61,101
2019,197887,40,0,162,61,101
2019,197887,40,6,162,61,101
2019,197887,42,0,162,61,101
2019,197887,42,6,162,61,101
2019,197911,0,0,69,34,35
2019,197911,10,0,67,34,33
2019,197911,10,1,15,7,8
2019,197911,10,2,16,9,7
2019,197911,10,3,35,18,17
2019,197911,10,4,1,0,1
2019,197911,20,0,29,15,14
2019,197911,20,1,15,7,8
2019,197911,20,2,13,8,5
2019,197911,20,3,1,0,1
2019,197911,30,0,26,16,10
2019,197911,30,2,2,0,2
2019,197911,30,3,24,16,8
2019,197911,40,0,12,3,9
2019,197911,40,2,1,1,0
2019,197911,40,3,10,2,8
2019,197911,40,4,1,0,1
2019,197911,41,0,1,1,0
2019,197911,41,2,1,1,0
2019,197911,42,0,11,2,9
2019,197911,42,3,10,2,8
2019,197911,42,4,1,0,1
2019,197911,44,0,1,1,0
2019,197911,44,2,1,1,0
2019,197911,50,0,2,0,2
2019,197966,0,0,43,15,28
2019,197966,10,0,42,14,28
2019,197966,10,6,42,14,28
2019,197966,40,0,42,14,28
2019,197966,40,6,42,14,28
2019,197966,42,0,42,14,28
2019,197966,42,6,42,14,28
2019,197966,50,0,1,1,0
2019,197984,0,0,76,39,37
2019,197984,10,0,76,39,37
2019,197984,10,1,7,5,2
2019,197984,10,2,32,16,16
2019,197984,10,3,23,12,11
2019,197984,10,4,2,1,1
2019,197984,10,5,12,5,7
2019,197984,20,0,28,13,15
2019,197984,20,1,7,5,2
2019,197984,20,2,20,8,12
2019,197984,20,3,1,0,1
2019,197984,30,0,20,13,7
2019,197984,30,2,8,5,3
2019,197984,30,3,12,8,4
2019,197984,40,0,28,13,15
2019,197984,40,2,4,3,1
2019,197984,40,3,10,4,6
2019,197984,40,4,2,1,1
2019,197984,40,5,12,5,7
2019,197984,42,0,28,13,15
2019,197984,42,2,4,3,1
2019,197984,42,3,10,4,6
2019,197984,42,4,2,1,1
2019,197984,42,5,12,5,7
2019,197993,0,0,36,12,24
2019,197993,10,0,36,12,24
2019,197993,10,1,4,1,3
2019,197993,10,2,11,5,6
2019,197993,10,3,17,6,11
2019,197993,10,4,4,0,4
2019,197993,20,0,18,5,13
2019,197993,20,1,4,1,3
2019,197993,20,2,10,4,6
2019,197993,20,3,3,0,3
2019,197993,20,4,1,0,1
2019,197993,30,0,9,4,5
2019,197993,30,2,1,1,0
2019,197993,30,3,7,3,4
2019,197993,30,4,1,0,1
2019,197993,40,0,9,3,6
2019,197993,40,3,7,3,4
2019,197993,40,4,2,0,2
2019,197993,42,0,9,3,6
2019,197993,42,3,7,3,4
2019,197993,42,4,2,0,2
2019,198011,0,0,45,21,24
2019,198011,10,0,45,21,24
2019,198011,10,6,45,21,24
2019,198011,40,0,45,21,24
2019,198011,40,6,45,21,24
2019,198011,42,0,45,21,24
2019,198011,42,6,45,21,24
2019,198039,0,0,73,38,35
2019,198039,10,0,73,38,35
2019,198039,10,6,73,38,35
2019,198039,40,0,73,38,35
2019,198039,40,6,73,38,35
2019,198039,42,0,73,38,35
2019,198039,42,6,73,38,35
2019,198066,0,0,50,26,24
2019,198066,10,0,50,26,24
2019,198066,10,1,8,2,6
2019,198066,10,2,18,12,6
2019,198066,10,3,24,12,12
2019,198066,20,0,23,11,12
2019,198066,20,1,8,2,6
2019,198066,20,2,15,9,6
2019,198066,30,0,20,10,10
2019,198066,30,3,20,10,10
2019,198066,40,0,7,5,2
2019,198066,40,2,3,3,0
2019,198066,40,3,4,2,2
2019,198066,42,0,7,5,2
2019,198066,42,2,3,3,0
2019,198066,42,3,4,2,2
2019,198084,0,0,50,19,31
2019,198084,10,0,50,19,31
2019,198084,10,6,50,19,31
2019,198084,40,0,50,19,31
2019,198084,40,6,50,19,31
2019,198084,42,0,49,19,30
2019,198084,42,6,49,19,30
2019,198084,43,0,1,0,1
2019,198084,43,6,1,0,1
2019,198109,0,0,29,4,25
2019,198109,10,0,29,4,25
2019,198109,10,2,9,1,8
2019,198109,10,3,9,1,8
2019,198109,10,4,10,2,8
2019,198109,10,6,1,0,1
2019,198109,40,0,29,4,25
2019,198109,40,2,9,1,8
2019,198109,40,3,9,1,8
2019,198109,40,4,10,2,8
2019,198109,40,6,1,0,1
2019,198109,41,0,29,4,25
2019,198109,41,2,9,1,8
2019,198109,41,3,9,1,8
2019,198109,41,4,10,2,8
2019,198109,41,6,1,0,1
2019,198109,45,0,29,4,25
2019,198109,45,2,9,1,8
2019,198109,45,3,9,1,8
2019,198109,45,4,10,2,8
2019,198109,45,6,1,0,1
2019,198118,0,0,92,37,55
2019,198118,10,0,92,37,55
2019,198118,10,6,92,37,55
2019,198118,40,0,92,37,55
2019,198118,40,6,92,37,55
2019,198118,42,0,92,37,55
2019,198118,42,6,92,37,55
2019,198136,0,0,268,148,120
2019,198136,10,0,265,147,118
2019,198136,10,1,36,24,12
2019,198136,10,2,107,58,49
2019,198136,10,3,91,49,42
2019,198136,10,4,26,13,13
2019,198136,10,5,1,0,1
2019,198136,10,6,4,3,1
2019,198136,20,0,56,30,26
2019,198136,20,1,26,18,8
2019,198136,20,2,30,12,18
2019,198136,30,0,174,96,78
2019,198136,30,1,9,6,3
2019,198136,30,2,77,46,31
2019,198136,30,3,75,40,35
2019,198136,30,4,11,3,8
2019,198136,30,6,2,1,1
2019,198136,40,0,35,21,14
2019,198136,40,1,1,0,1
2019,198136,40,3,16,9,7
2019,198136,40,4,15,10,5
2019,198136,40,5,1,0,1
2019,198136,40,6,2,2,0
2019,198136,42,0,34,20,14
2019,198136,42,1,1,0,1
2019,198136,42,3,16,9,7
2019,198136,42,4,14,9,5
2019,198136,42,5,1,0,1
2019,198136,42,6,2,2,0
2019,198136,43,0,1,1,0
2019,198136,43,4,1,1,0
2019,198136,50,0,3,1,2
2019,198154,0,0,268,123,145
2019,198154,10,0,268,123,145
2019,198154,10,6,268,123,145
2019,198154,40,0,268,123,145
2019,198154,40,6,268,123,145
2019,198154,42,0,268,123,145
2019,198154,42,6,268,123,145
2019,198206,0,0,62,28,34
2019,198206,10,0,62,28,34
2019,198206,10,6,62,28,34
2019,198206,40,0,62,28,34
2019,198206,40,6,62,28,34
2019,198206,42,0,62,28,34
2019,198206,42,6,62,28,34
2019,198215,0,0,84,40,44
2019,198215,10,0,83,39,44
2019,198215,10,1,17,10,7
2019,198215,10,2,19,11,8
2019,198215,10,3,44,17,27
2019,198215,10,4,3,1,2
2019,198215,20,0,34,21,13
2019,198215,20,1,17,10,7
2019,198215,20,2,13,8,5
2019,198215,20,3,4,3,1
2019,198215,30,0,31,13,18
2019,198215,30,2,6,3,3
2019,198215,30,3,25,10,15
2019,198215,40,0,18,5,13
2019,198215,40,3,15,4,11
2019,198215,40,4,3,1,2
2019,198215,41,0,5,2,3
2019,198215,41,3,4,1,3
2019,198215,41,4,1,1,0
2019,198215,43,0,13,3,10
2019,198215,43,3,11,3,8
2019,198215,43,4,2,0,2
2019,198215,44,0,5,2,3
2019,198215,44,3,4,1,3
2019,198215,44,4,1,1,0
2019,198215,50,0,1,1,0
2019,198233,0,0,140,67,73
2019,198233,10,0,140,67,73
2019,198233,10,6,140,67,73
2019,198233,40,0,140,67,73
2019,198233,40,6,140,67,73
2019,198233,42,0,140,67,73
2019,198233,42,6,140,67,73
2019,198251,0,0,161,65,96
2019,198251,10,0,161,65,96
2019,198251,10,4,155,63,92
2019,198251,10,6,6,2,4
2019,198251,40,0,161,65,96
2019,198251,40,4,155,63,92
2019,198251,40,6,6,2,4
2019,198251,42,0,161,65,96
2019,198251,42,4,155,63,92
2019,198251,42,6,6,2,4
2019,198260,0,0,398,181,217
2019,198260,10,0,398,181,217
2019,198260,10,6,398,181,217
2019,198260,40,0,398,181,217
2019,198260,40,6,398,181,217
2019,198260,42,0,398,181,217
2019,198260,42,6,398,181,217
2019,198303,0,0,53,27,26
2019,198303,10,0,53,27,26
2019,198303,10,1,11,6,5
2019,198303,10,2,21,11,10
2019,198303,10,3,19,10,9
2019,198303,10,4,2,0,2
2019,198303,20,0,26,15,11
2019,198303,20,1,10,6,4
2019,198303,20,2,15,8,7
2019,198303,20,3,1,1,0
2019,198303,30,0,18,10,8
2019,198303,30,1,1,0,1
2019,198303,30,2,3,2,1
2019,198303,30,3,14,8,6
2019,198303,40,0,9,2,7
2019,198303,40,2,3,1,2
2019,198303,40,3,4,1,3
2019,198303,40,4,2,0,2
2019,198303,42,0,9,2,7
2019,198303,42,2,3,1,2
2019,198303,42,3,4,1,3
2019,198303,42,4,2,0,2
2019,198321,0,0,67,31,36
2019,198321,10,0,67,31,36
2019,198321,10,6,67,31,36
2019,198321,40,0,67,31,36
2019,198321,40,6,67,31,36
2019,198321,42,0,17,11,6
2019,198321,42,6,17,11,6
2019,198321,43,0,50,20,30
2019,198321,43,6,50,20,30
2019,198330,0,0,138,61,77
2019,198330,10,0,138,61,77
2019,198330,10,6,138,61,77
2019,198330,40,0,138,61,77
2019,198330,40,6,138,61,77
2019,198330,42,0,138,61,77
2019,198330,42,6,138,61,77
2019,198367,0,0,64,30,34
2019,198367,10,0,64,30,34
2019,198367,10,6,64,30,34
2019,198367,40,0,64,30,34
2019,198367,40,6,64,30,34
2019,198367,42,0,63,29,34
2019,198367,42,6,63,29,34
2019,198367,43,0,1,1,0
2019,198367,43,6,1,1,0
2019,198376,0,0,88,43,45
2019,198376,10,0,88,43,45
2019,198376,10,6,88,43,45
2019,198376,40,0,88,43,45
2019,198376,40,6,88,43,45
2019,198376,42,0,88,43,45
2019,198376,42,6,88,43,45
2019,198385,0,0,221,112,109
2019,198385,10,0,218,110,108
2019,198385,10,1,89,53,36
2019,198385,10,2,35,20,15
2019,198385,10,3,89,36,53
2019,198385,10,4,2,1,1
2019,198385,10,5,3,0,3
2019,198385,20,0,120,71,49
2019,198385,20,1,87,51,36
2019,198385,20,2,32,19,13
2019,198385,20,3,1,1,0
2019,198385,30,0,42,12,30
2019,198385,30,2,1,0,1
2019,198385,30,3,40,11,29
2019,198385,30,4,1,1,0
2019,198385,40,0,56,27,29
2019,198385,40,1,2,2,0
2019,198385,40,2,2,1,1
2019,198385,40,3,48,24,24
2019,198385,40,4,1,0,1
2019,198385,40,5,3,0,3
2019,198385,41,0,53,27,26
2019,198385,41,1,2,2,0
2019,198385,41,2,2,1,1
2019,198385,41,3,45,24,21
2019,198385,41,4,1,0,1
2019,198385,41,5,3,0,3
2019,198385,42,0,3,0,3
2019,198385,42,3,3,0,3
2019,198385,44,0,48,25,23
2019,198385,44,1,1,1,0
2019,198385,44,2,1,1,0
2019,198385,44,3,42,23,19
2019,198385,44,4,1,0,1
2019,198385,44,5,3,0,3
2019,198385,45,0,5,2,3
2019,198385,45,1,1,1,0
2019,198385,45,2,1,0,1
2019,198385,45,3,3,1,2
2019,198385,50,0,3,2,1
2019,198419,0,0,4059,2394,1665
2019,198419,10,0,4059,2394,1665
2019,198419,10,1,1335,977,358
2019,198419,10,2,932,546,386
2019,198419,10,3,1257,645,612
2019,198419,10,4,387,170,217
2019,198419,10,5,148,56,92
2019,198419,20,0,1353,999,354
2019,198419,20,1,1007,778,229
2019,198419,20,2,346,221,125
2019,198419,30,0,323,192,131
2019,198419,30,2,120,65,55
2019,198419,30,3,203,127,76
2019,198419,40,0,2383,1203,1180
2019,198419,40,1,328,199,129
2019,198419,40,2,466,260,206
2019,198419,40,3,1054,518,536
2019,198419,40,4,387,170,217
2019,198419,40,5,148,56,92
2019,198419,41,0,1967,1015,952
2019,198419,41,1,306,186,120
2019,198419,41,2,456,253,203
2019,198419,41,3,1038,509,529
2019,198419,41,4,131,58,73
2019,198419,41,5,36,9,27
2019,198419,42,0,416,188,228
2019,198419,42,1,22,13,9
2019,198419,42,2,10,7,3
2019,198419,42,3,16,9,7
2019,198419,42,4,256,112,144
2019,198419,42,5,112,47,65
2019,198419,44,0,1967,1015,952
2019,198419,44,1,306,186,120
2019,198419,44,2,456,253,203
2019,198419,44,3,1038,509,529
2019,198419,44,4,131,58,73
2019,198419,44,5,36,9,27
2019,198455,0,0,138,42,96
2019,198455,10,0,133,41,92
2019,198455,10,4,4,2,2
2019,198455,10,6,129,39,90
2019,198455,40,0,133,41,92
2019,198455,40,4,4,2,2
2019,198455,40,6,129,39,90
2019,198455,42,0,133,41,92
2019,198455,42,4,4,2,2
2019,198455,42,6,129,39,90
2019,198455,50,0,5,1,4
2019,198464,0,0,1436,727,709
2019,198464,10,0,1413,715,698
2019,198464,10,1,315,212,103
2019,198464,10,2,492,258,234
2019,198464,10,3,423,174,249
2019,198464,10,4,183,71,112
2019,198464,20,0,707,428,279
2019,198464,20,1,294,206,88
2019,198464,20,2,409,220,189
2019,198464,20,3,4,2,2
2019,198464,30,0,240,110,130
2019,198464,30,2,6,3,3
2019,198464,30,3,234,107,127
2019,198464,40,0,466,177,289
2019,198464,40,1,21,6,15
2019,198464,40,2,77,35,42
2019,198464,40,3,185,65,120
2019,198464,40,4,183,71,112
2019,198464,41,0,163,54,109
2019,198464,41,1,10,1,9
2019,198464,41,2,47,22,25
2019,198464,41,3,90,30,60
2019,198464,41,4,16,1,15
2019,198464,42,0,24,9,15
2019,198464,42,1,1,1,0
2019,198464,42,2,3,0,3
2019,198464,42,3,11,6,5
2019,198464,42,4,9,2,7
2019,198464,43,0,279,114,165
2019,198464,43,1,10,4,6
2019,198464,43,2,27,13,14
2019,198464,43,3,84,29,55
2019,198464,43,4,158,68,90
2019,198464,44,0,163,54,109
2019,198464,44,1,10,1,9
2019,198464,44,2,47,22,25
2019,198464,44,3,90,30,60
2019,198464,44,4,16,1,15
2019,198464,50,0,23,12,11
2019,198491,0,0,72,20,52
2019,198491,10,0,72,20,52
2019,198491,10,6,72,20,52
2019,198491,40,0,72,20,52
2019,198491,40,6,72,20,52
2019,198491,42,0,72,20,52
2019,198491,42,6,72,20,52
2019,198507,0,0,89,56,33
2019,198507,10,0,89,56,33
2019,198507,10,1,25,19,6
2019,198507,10,2,27,16,11
2019,198507,10,3,23,15,8
2019,198507,10,5,13,6,7
2019,198507,10,6,1,0,1
2019,198507,20,0,46,31,15
2019,198507,20,1,22,17,5
2019,198507,20,2,23,13,10
2019,198507,20,3,1,1,0
2019,198507,30,0,23,15,8
2019,198507,30,1,1,1,0
2019,198507,30,2,2,2,0
2019,198507,30,3,17,11,6
2019,198507,30,5,3,1,2
2019,198507,40,0,20,10,10
2019,198507,40,1,2,1,1
2019,198507,40,2,2,1,1
2019,198507,40,3,5,3,2
2019,198507,40,5,10,5,5
2019,198507,40,6,1,0,1
2019,198507,41,0,4,4,0
2019,198507,41,1,1,1,0
2019,198507,41,2,1,1,0
2019,198507,41,3,1,1,0
2019,198507,41,5,1,1,0
2019,198507,42,0,15,6,9
2019,198507,42,1,1,0,1
2019,198507,42,2,1,0,1
2019,198507,42,3,4,2,2
2019,198507,42,5,9,4,5
2019,198507,43,0,1,0,1
2019,198507,43,6,1,0,1
2019,198507,44,0,4,4,0
2019,198507,44,1,1,1,0
2019,198507,44,2,1,1,0
2019,198507,44,3,1,1,0
2019,198507,44,5,1,1,0
2019,198516,0,0,446,223,223
2019,198516,10,0,446,223,223
2019,198516,10,1,80,43,37
2019,198516,10,2,147,78,69
2019,198516,10,3,155,72,83
2019,198516,10,4,14,6,8
2019,198516,10,5,50,24,26
2019,198516,20,0,203,111,92
2019,198516,20,1,74,41,33
2019,198516,20,2,129,70,59
2019,198516,30,0,115,50,65
2019,198516,30,1,3,1,2
2019,198516,30,2,3,1,2
2019,198516,30,3,109,48,61
2019,198516,40,0,128,62,66
2019,198516,40,1,3,1,2
2019,198516,40,2,15,7,8
2019,198516,40,3,46,24,22
2019,198516,40,4,14,6,8
2019,198516,40,5,50,24,26
2019,198516,42,0,128,62,66
2019,198516,42,1,3,1,2
2019,198516,42,2,15,7,8
2019,198516,42,3,46,24,22
2019,198516,42,4,14,6,8
2019,198516,42,5,50,24,26
2019,198534,0,0,314,140,174
2019,198534,10,0,314,140,174
2019,198534,10,6,314,140,174
2019,198534,40,0,314,140,174
2019,198534,40,6,314,140,174
2019,198534,42,0,305,137,168
2019,198534,42,6,305,137,168
2019,198534,43,0,9,3,6
2019,198534,43,6,9,3,6
2019,198543,0,0,269,143,126
2019,198543,10,0,267,142,125
2019,198543,10,1,81,59,22
2019,198543,10,2,77,38,39
2019,198543,10,3,60,22,38
2019,198543,10,4,3,0,3
2019,198543,10,5,44,21,23
2019,198543,10,6,2,2,0
2019,198543,20,0,153,93,60
2019,198543,20,1,75,54,21
2019,198543,20,2,70,35,35
2019,198543,20,3,6,2,4
2019,198543,20,6,2,2,0
2019,198543,30,0,49,19,30
2019,198543,30,1,4,3,1
2019,198543,30,2,5,3,2
2019,198543,30,3,39,13,26
2019,198543,30,4,1,0,1
2019,198543,40,0,65,30,35
2019,198543,40,1,2,2,0
2019,198543,40,2,2,0,2
2019,198543,40,3,15,7,8
2019,198543,40,4,2,0,2
2019,198543,40,5,44,21,23
2019,198543,41,0,5,3,2
2019,198543,41,4,1,0,1
2019,198543,41,5,4,3,1
2019,198543,42,0,60,27,33
2019,198543,42,1,2,2,0
2019,198543,42,2,2,0,2
2019,198543,42,3,15,7,8
2019,198543,42,4,1,0,1
2019,198543,42,5,40,18,22
2019,198543,44,0,5,3,2
2019,198543,44,4,1,0,1
2019,198543,44,5,4,3,1
2019,198543,50,0,2,1,1
2019,198552,0,0,219,87,132
2019,198552,10,0,219,87,132
2019,198552,10,1,33,7,26
2019,198552,10,2,22,6,16
2019,198552,10,3,6,3,3
2019,198552,10,4,158,71,87
2019,198552,40,0,219,87,132
2019,198552,40,1,33,7,26
2019,198552,40,2,22,6,16
2019,198552,40,3,6,3,3
2019,198552,40,4,158,71,87
2019,198552,41,0,219,87,132
2019,198552,41,1,33,7,26
2019,198552,41,2,22,6,16
2019,198552,41,3,6,3,3
2019,198552,41,4,158,71,87
2019,198552,45,0,219,87,132
2019,198552,45,1,33,7,26
2019,198552,45,2,22,6,16
2019,198552,45,3,6,3,3
2019,198552,45,4,158,71,87
2019,198561,0,0,159,73,86
2019,198561,10,0,159,73,86
2019,198561,10,1,60,37,23
2019,198561,10,2,32,16,16
2019,198561,10,3,48,13,35
2019,198561,10,4,18,6,12
2019,198561,10,5,1,1,0
2019,198561,20,0,71,41,30
2019,198561,20,1,53,32,21
2019,198561,20,2,17,8,9
2019,198561,20,3,1,1,0
2019,198561,30,0,20,5,15
2019,198561,30,2,6,2,4
2019,198561,30,3,14,3,11
2019,198561,40,0,68,27,41
2019,198561,40,1,7,5,2
2019,198561,40,2,9,6,3
2019,198561,40,3,33,9,24
2019,198561,40,4,18,6,12
2019,198561,40,5,1,1,0
2019,198561,42,0,68,27,41
2019,198561,42,1,7,5,2
2019,198561,42,2,9,6,3
2019,198561,42,3,33,9,24
2019,198561,42,4,18,6,12
2019,198561,42,5,1,1,0
2019,198570,0,0,144,47,97
2019,198570,10,0,144,47,97
2019,198570,10,6,144,47,97
2019,198570,40,0,144,47,97
2019,198570,40,6,144,47,97
2019,198570,42,0,36,19,17
2019,198570,42,6,36,19,17
2019,198570,43,0,108,28,80
2019,198570,43,6,108,28,80
2019,198598,0,0,46,24,22
2019,198598,10,0,45,23,22
2019,198598,10,1,22,14,8
2019,198598,10,2,12,7,5
2019,198598,10,3,9,1,8
2019,198598,10,4,2,1,1
2019,198598,20,0,11,8,3
2019,198598,20,1,10,8,2
2019,198598,20,2,1,0,1
2019,198598,30,0,5,1,4
2019,198598,30,1,1,0,1
2019,198598,30,2,3,1,2
2019,198598,30,3,1,0,1
2019,198598,40,0,29,14,15
2019,198598,40,1,11,6,5
2019,198598,40,2,8,6,2
2019,198598,40,3,8,1,7
2019,198598,40,4,2,1,1
2019,198598,41,0,11,7,4
2019,198598,41,1,10,6,4
2019,198598,41,2,1,1,0
2019,198598,42,0,18,7,11
2019,198598,42,1,1,0,1
2019,198598,42,2,7,5,2
2019,198598,42,3,8,1,7
2019,198598,42,4,2,1,1
2019,198598,44,0,11,7,4
2019,198598,44,1,10,6,4
2019,198598,44,2,1,1,0
2019,198598,50,0,1,1,0
2019,198613,0,0,101,47,54
2019,198613,10,0,101,47,54
2019,198613,10,1,33,18,15
2019,198613,10,2,32,16,16
2019,198613,10,3,31,11,20
2019,198613,10,4,5,2,3
2019,198613,20,0,62,33,29
2019,198613,20,1,33,18,15
2019,198613,20,2,27,14,13
2019,198613,20,3,2,1,1
2019,198613,30,0,19,4,15
2019,198613,30,2,5,2,3
2019,198613,30,3,14,2,12
2019,198613,40,0,20,10,10
2019,198613,40,3,15,8,7
2019,198613,40,4,5,2,3
2019,198613,42,0,20,10,10
2019,198613,42,3,15,8,7
2019,198613,42,4,5,2,3
2019,198622,0,0,284,152,132
2019,198622,10,0,284,152,132
2019,198622,10,6,284,152,132
2019,198622,40,0,284,152,132
2019,198622,40,6,284,152,132
2019,198622,42,0,284,152,132
2019,198622,42,6,284,152,132
2019,198640,0,0,47,27,20
2019,198640,10,0,47,27,20
2019,198640,10,6,47,27,20
2019,198640,40,0,47,27,20
2019,198640,40,6,47,27,20
2019,198640,42,0,47,27,20
2019,198640,42,6,47,27,20
2019,198668,0,0,57,28,29
2019,198668,10,0,56,28,28
2019,198668,10,6,56,28,28
2019,198668,40,0,56,28,28
2019,198668,40,6,56,28,28
2019,198668,42,0,56,28,28
2019,198668,42,6,56,28,28
2019,198668,50,0,1,0,1
2019,198695,0,0,329,168,161
2019,198695,10,0,329,168,161
2019,198695,10,1,37,27,10
2019,198695,10,2,96,51,45
2019,198695,10,3,152,72,80
2019,198695,10,4,44,18,26
2019,198695,20,0,94,56,38
2019,198695,20,1,32,25,7
2019,198695,20,2,62,31,31
2019,198695,30,0,121,61,60
2019,198695,30,1,2,1,1
2019,198695,30,2,22,12,10
2019,198695,30,3,97,48,49
2019,198695,40,0,114,51,63
2019,198695,40,1,3,1,2
2019,198695,40,2,12,8,4
2019,198695,40,3,55,24,31
2019,198695,40,4,44,18,26
2019,198695,42,0,114,51,63
2019,198695,42,1,3,1,2
2019,198695,42,2,12,8,4
2019,198695,42,3,55,24,31
2019,198695,42,4,44,18,26
2019,198710,0,0,56,24,32
2019,198710,10,0,56,24,32
2019,198710,10,6,56,24,32
2019,198710,40,0,56,24,32
2019,198710,40,6,56,24,32
2019,198710,42,0,56,24,32
2019,198710,42,6,56,24,32
2019,198729,0,0,33,10,23
2019,198729,10,0,33,10,23
2019,198729,10,6,33,10,23
2019,198729,40,0,33,10,23
2019,198729,40,6,33,10,23
2019,198729,42,0,33,10,23
2019,198729,42,6,33,10,23
2019,198756,0,0,86,40,46
2019,198756,10,0,86,40,46
2019,198756,10,1,11,5,6
2019,198756,10,2,24,10,14
2019,198756,10,3,40,18,22
2019,198756,10,4,11,7,4
2019,198756,20,0,34,14,20
2019,198756,20,1,10,4,6
2019,198756,20,2,19,6,13
2019,198756,20,3,5,4,1
2019,198756,30,0,21,9,12
2019,198756,30,2,4,3,1
2019,198756,30,3,17,6,11
2019,198756,40,0,31,17,14
2019,198756,40,1,1,1,0
2019,198756,40,2,1,1,0
2019,198756,40,3,18,8,10
2019,198756,40,4,11,7,4
2019,198756,42,0,31,17,14
2019,198756,42,1,1,1,0
2019,198756,42,2,1,1,0
2019,198756,42,3,18,8,10
2019,198756,42,4,11,7,4
2019,198774,0,0,113,44,69
2019,198774,10,0,113,44,69
2019,198774,10,6,113,44,69
2019,198774,40,0,113,44,69
2019,198774,40,6,113,44,69
2019,198774,42,0,113,44,69
2019,198774,42,6,113,44,69
2019,198808,0,0,57,23,34
2019,198808,10,0,57,23,34
2019,198808,10,1,13,7,6
2019,198808,10,2,17,8,9
2019,198808,10,3,13,4,9
2019,198808,10,4,14,4,10
2019,198808,40,0,57,23,34
2019,198808,40,1,13,7,6
2019,198808,40,2,17,8,9
2019,198808,40,3,13,4,9
2019,198808,40,4,14,4,10
2019,198808,41,0,50,21,29
2019,198808,41,1,13,7,6
2019,198808,41,2,16,8,8
2019,198808,41,3,12,4,8
2019,198808,41,4,9,2,7
2019,198808,42,0,7,2,5
2019,198808,42,2,1,0,1
2019,198808,42,3,1,0,1
2019,198808,42,4,5,2,3
2019,198808,44,0,50,21,29
2019,198808,44,1,13,7,6
2019,198808,44,2,16,8,8
2019,198808,44,3,12,4,8
2019,198808,44,4,9,2,7
2019,198817,0,0,108,43,65
2019,198817,10,0,108,43,65
2019,198817,10,6,108,43,65
2019,198817,40,0,108,43,65
2019,198817,40,6,108,43,65
2019,198817,42,0,108,43,65
2019,198817,42,6,108,43,65
2019,198835,0,0,145,58,87
2019,198835,10,0,145,58,87
2019,198835,10,1,39,22,17
2019,198835,10,2,36,20,16
2019,198835,10,3,42,10,32
2019,198835,10,4,28,6,22
2019,198835,20,0,63,37,26
2019,198835,20,1,39,22,17
2019,198835,20,2,24,15,9
2019,198835,30,0,30,9,21
2019,198835,30,2,5,2,3
2019,198835,30,3,25,7,18
2019,198835,40,0,52,12,40
2019,198835,40,2,7,3,4
2019,198835,40,3,17,3,14
2019,198835,40,4,28,6,22
2019,198835,42,0,52,12,40
2019,198835,42,2,7,3,4
2019,198835,42,3,17,3,14
2019,198835,42,4,28,6,22
2019,198862,0,0,66,33,33
2019,198862,10,0,66,33,33
2019,198862,10,1,14,5,9
2019,198862,10,2,9,6,3
2019,198862,10,3,19,10,9
2019,198862,10,4,24,12,12
2019,198862,20,0,10,5,5
2019,198862,20,1,8,3,5
2019,198862,20,3,2,2,0
2019,198862,30,0,12,7,5
2019,198862,30,1,2,1,1
2019,198862,30,2,6,3,3
2019,198862,30,3,3,2,1
2019,198862,30,4,1,1,0
2019,198862,40,0,44,21,23
2019,198862,40,1,4,1,3
2019,198862,40,2,3,3,0
2019,198862,40,3,14,6,8
2019,198862,40,4,23,11,12
2019,198862,42,0,44,21,23
2019,198862,42,1,4,1,3
2019,198862,42,2,3,3,0
2019,198862,42,3,14,6,8
2019,198862,42,4,23,11,12
2019,198871,0,0,33,11,22
2019,198871,10,0,33,11,22
2019,198871,10,1,2,1,1
2019,198871,10,2,4,3,1
2019,198871,10,3,12,7,5
2019,198871,10,4,15,0,15
2019,198871,40,0,33,11,22
2019,198871,40,1,2,1,1
2019,198871,40,2,4,3,1
2019,198871,40,3,12,7,5
2019,198871,40,4,15,0,15
2019,198871,42,0,33,11,22
2019,198871,42,1,2,1,1
2019,198871,42,2,4,3,1
2019,198871,42,3,12,7,5
2019,198871,42,4,15,0,15
2019,198899,0,0,93,41,52
2019,198899,10,0,93,41,52
2019,198899,10,1,22,13,9
2019,198899,10,2,28,11,17
2019,198899,10,3,34,14,20
2019,198899,10,4,7,3,4
2019,198899,10,5,2,0,2
2019,198899,20,0,48,23,25
2019,198899,20,1,22,13,9
2019,198899,20,2,23,9,14
2019,198899,20,3,3,1,2
2019,198899,30,0,28,12,16
2019,198899,30,2,4,1,3
2019,198899,30,3,23,11,12
2019,198899,30,4,1,0,1
2019,198899,40,0,17,6,11
2019,198899,40,2,1,1,0
2019,198899,40,3,8,2,6
2019,198899,40,4,6,3,3
2019,198899,40,5,2,0,2
2019,198899,42,0,17,6,11
2019,198899,42,2,1,1,0
2019,198899,42,3,8,2,6
2019,198899,42,4,6,3,3
2019,198899,42,5,2,0,2
2019,198905,0,0,26,10,16
2019,198905,10,0,26,10,16
2019,198905,10,6,26,10,16
2019,198905,40,0,26,10,16
2019,198905,40,6,26,10,16
2019,198905,42,0,26,10,16
2019,198905,42,6,26,10,16
2019,198914,0,0,33,15,18
2019,198914,10,0,33,15,18
2019,198914,10,6,33,15,18
2019,198914,40,0,33,15,18
2019,198914,40,6,33,15,18
2019,198914,42,0,33,15,18
2019,198914,42,6,33,15,18
2019,198923,0,0,36,17,19
2019,198923,10,0,36,17,19
2019,198923,10,4,36,17,19
2019,198923,40,0,36,17,19
2019,198923,40,4,36,17,19
2019,198923,42,0,36,17,19
2019,198923,42,4,36,17,19
2019,198950,0,0,129,44,85
2019,198950,10,0,129,44,85
2019,198950,10,1,53,17,36
2019,198950,10,2,26,10,16
2019,198950,10,3,41,12,29
2019,198950,10,4,8,4,4
2019,198950,10,6,1,1,0
2019,198950,20,0,73,25,48
2019,198950,20,1,50,16,34
2019,198950,20,2,23,9,14
2019,198950,30,0,30,8,22
2019,198950,30,1,1,0,1
2019,198950,30,2,1,0,1
2019,198950,30,3,28,8,20
2019,198950,40,0,26,11,15
2019,198950,40,1,2,1,1
2019,198950,40,2,2,1,1
2019,198950,40,3,13,4,9
2019,198950,40,4,8,4,4
2019,198950,40,6,1,1,0
2019,198950,41,0,6,0,6
2019,198950,41,1,1,0,1
2019,198950,41,2,1,0,1
2019,198950,41,3,3,0,3
2019,198950,41,4,1,0,1
2019,198950,42,0,20,11,9
2019,198950,42,1,1,1,0
2019,198950,42,2,1,1,0
2019,198950,42,3,10,4,6
2019,198950,42,4,7,4,3
2019,198950,42,6,1,1,0
2019,198950,44,0,6,0,6
2019,198950,44,1,1,0,1
2019,198950,44,2,1,0,1
2019,198950,44,3,3,0,3
2019,198950,44,4,1,0,1
2019,198969,0,0,157,86,71
2019,198969,10,0,157,86,71
2019,198969,10,1,41,25,16
2019,198969,10,2,45,29,16
2019,198969,10,3,51,28,23
2019,198969,10,4,20,4,16
2019,198969,20,0,68,43,25
2019,198969,20,1,40,25,15
2019,198969,20,2,27,17,10
2019,198969,20,3,1,1,0
2019,198969,30,0,47,27,20
2019,198969,30,1,1,0,1
2019,198969,30,2,9,7,2
2019,198969,30,3,36,19,17
2019,198969,30,4,1,1,0
2019,198969,40,0,42,16,26
2019,198969,40,2,9,5,4
2019,198969,40,3,14,8,6
2019,198969,40,4,19,3,16
2019,198969,42,0,42,16,26
2019,198969,42,2,9,5,4
2019,198969,42,3,14,8,6
2019,198969,42,4,19,3,16
2019,198978,0,0,2,0,2
2019,198978,10,0,2,0,2
2019,198978,10,4,2,0,2
2019,198978,40,0,2,0,2
2019,198978,40,4,2,0,2
2019,198978,41,0,2,0,2
2019,198978,41,4,2,0,2
2019,198978,45,0,2,0,2
2019,198978,45,4,2,0,2
2019,198987,0,0,85,32,53
2019,198987,10,0,85,32,53
2019,198987,10,6,85,32,53
2019,198987,40,0,85,32,53
2019,198987,40,6,85,32,53
2019,198987,42,0,85,32,53
2019,198987,42,6,85,32,53
2019,199023,0,0,39,21,18
2019,199023,10,0,39,21,18
2019,199023,10,4,39,21,18
2019,199023,40,0,39,21,18
2019,199023,40,4,39,21,18
2019,199023,42,0,39,21,18
2019,199023,42,4,39,21,18
2019,199032,0,0,43,28,15
2019,199032,10,0,43,28,15
2019,199032,10,1,17,12,5
2019,199032,10,2,8,5,3
2019,199032,10,3,16,9,7
2019,199032,10,4,2,2,0
2019,199032,20,0,17,13,4
2019,199032,20,1,12,10,2
2019,199032,20,2,4,2,2
2019,199032,20,3,1,1,0
2019,199032,30,0,7,5,2
2019,199032,30,1,1,0,1
2019,199032,30,2,3,2,1
2019,199032,30,3,3,3,0
2019,199032,40,0,19,10,9
2019,199032,40,1,4,2,2
2019,199032,40,2,1,1,0
2019,199032,40,3,12,5,7
2019,199032,40,4,2,2,0
2019,199032,42,0,19,10,9
2019,199032,42,1,4,2,2
2019,199032,42,2,1,1,0
2019,199032,42,3,12,5,7
2019,199032,42,4,2,2,0
2019,199069,0,0,86,48,38
2019,199069,10,0,86,48,38
2019,199069,10,1,20,13,7
2019,199069,10,2,26,17,9
2019,199069,10,3,35,16,19
2019,199069,10,4,5,2,3
2019,199069,40,0,86,48,38
2019,199069,40,1,20,13,7
2019,199069,40,2,26,17,9
2019,199069,40,3,35,16,19
2019,199069,40,4,5,2,3
2019,199069,41,0,69,40,29
2019,199069,41,1,19,12,7
2019,199069,41,2,26,17,9
2019,199069,41,3,23,10,13
2019,199069,41,4,1,1,0
2019,199069,42,0,17,8,9
2019,199069,42,1,1,1,0
2019,199069,42,3,12,6,6
2019,199069,42,4,4,1,3
2019,199069,44,0,69,40,29
2019,199069,44,1,19,12,7
2019,199069,44,2,26,17,9
2019,199069,44,3,23,10,13
2019,199069,44,4,1,1,0
2019,199087,0,0,118,47,71
2019,199087,10,0,118,47,71
2019,199087,10,6,118,47,71
2019,199087,40,0,118,47,71
2019,199087,40,6,118,47,71
2019,199087,42,0,118,47,71
2019,199087,42,6,118,47,71
2019,199102,0,0,460,264,196
2019,199102,10,0,459,263,196
2019,199102,10,1,101,78,23
2019,199102,10,2,178,98,80
2019,199102,10,3,116,53,63
2019,199102,10,4,5,2,3
2019,199102,10,5,20,11,9
2019,199102,10,6,39,21,18
2019,199102,20,0,246,160,86
2019,199102,20,1,96,73,23
2019,199102,20,2,149,87,62
2019,199102,20,3,1,0,1
2019,199102,30,0,142,69,73
2019,199102,30,1,5,5,0
2019,199102,30,2,29,11,18
2019,199102,30,3,102,48,54
2019,199102,30,5,5,4,1
2019,199102,30,6,1,1,0
2019,199102,40,0,71,34,37
2019,199102,40,3,13,5,8
2019,199102,40,4,5,2,3
2019,199102,40,5,15,7,8
2019,199102,40,6,38,20,18
2019,199102,41,0,3,3,0
2019,199102,41,5,3,3,0
2019,199102,42,0,59,27,32
2019,199102,42,3,12,4,8
2019,199102,42,4,5,2,3
2019,199102,42,5,9,4,5
2019,199102,42,6,33,17,16
2019,199102,43,0,9,4,5
2019,199102,43,3,1,1,0
2019,199102,43,5,3,0,3
2019,199102,43,6,5,3,2
2019,199102,44,0,3,3,0
2019,199102,44,5,3,3,0
2019,199102,50,0,1,1,0
2019,199111,0,0,220,118,102
2019,199111,10,0,220,118,102
2019,199111,10,1,69,45,24
2019,199111,10,2,54,28,26
2019,199111,10,3,50,23,27
2019,199111,10,4,1,0,1
2019,199111,10,5,46,22,24
2019,199111,20,0,119,69,50
2019,199111,20,1,66,42,24
2019,199111,20,2,52,26,26
2019,199111,20,3,1,1,0
2019,199111,30,0,50,24,26
2019,199111,30,1,1,1,0
2019,199111,30,2,2,2,0
2019,199111,30,3,47,21,26
2019,199111,40,0,51,25,26
2019,199111,40,1,2,2,0
2019,199111,40,3,2,1,1
2019,199111,40,4,1,0,1
2019,199111,40,5,46,22,24
2019,199111,41,0,22,11,11
2019,199111,41,4,1,0,1
2019,199111,41,5,21,11,10
2019,199111,42,0,29,14,15
2019,199111,42,1,2,2,0
2019,199111,42,3,2,1,1
2019,199111,42,5,25,11,14
2019,199111,44,0,22,11,11
2019,199111,44,4,1,0,1
2019,199111,44,5,21,11,10
2019,199120,0,0,1880,989,891
2019,199120,10,0,1880,989,891
2019,199120,10,1,702,452,250
2019,199120,10,2,515,259,256
2019,199120,10,3,407,178,229
2019,199120,10,4,48,10,38
2019,199120,10,5,203,87,116
2019,199120,10,6,5,3,2
2019,199120,20,0,998,622,376
2019,199120,20,1,622,411,211
2019,199120,20,2,376,211,165
2019,199120,30,0,280,147,133
2019,199120,30,2,22,6,16
2019,199120,30,3,255,140,115
2019,199120,30,4,2,0,2
2019,199120,30,5,1,1,0
2019,199120,40,0,602,220,382
2019,199120,40,1,80,41,39
2019,199120,40,2,117,42,75
2019,199120,40,3,152,38,114
2019,199120,40,4,46,10,36
2019,199120,40,5,202,86,116
2019,199120,40,6,5,3,2
2019,199120,41,0,380,138,242
2019,199120,41,1,64,30,34
2019,199120,41,2,89,29,60
2019,199120,41,3,76,19,57
2019,199120,41,4,3,0,3
2019,199120,41,5,148,60,88
2019,199120,42,0,189,68,121
2019,199120,42,1,16,11,5
2019,199120,42,2,28,13,15
2019,199120,42,3,74,18,56
2019,199120,42,4,41,8,33
2019,199120,42,5,27,16,11
2019,199120,42,6,3,2,1
2019,199120,43,0,33,14,19
2019,199120,43,3,2,1,1
2019,199120,43,4,2,2,0
2019,199120,43,5,27,10,17
2019,199120,43,6,2,1,1
2019,199120,44,0,380,138,242
2019,199120,44,1,64,30,34
2019,199120,44,2,89,29,60
2019,199120,44,3,76,19,57
2019,199120,44,4,3,0,3
2019,199120,44,5,148,60,88
2019,199139,0,0,1095,550,545
2019,199139,10,0,1095,550,545
2019,199139,10,1,277,188,89
2019,199139,10,2,308,163,145
2019,199139,10,3,268,115,153
2019,199139,10,5,242,84,158
2019,199139,20,0,529,328,201
2019,199139,20,1,247,174,73
2019,199139,20,2,281,154,127
2019,199139,20,3,1,0,1
2019,199139,30,0,213,96,117
2019,199139,30,2,2,1,1
2019,199139,30,3,211,95,116
2019,199139,40,0,353,126,227
2019,199139,40,1,30,14,16
2019,199139,40,2,25,8,17
2019,199139,40,3,56,20,36
2019,199139,40,5,242,84,158
2019,199139,41,0,335,122,213
2019,199139,41,1,30,14,16
2019,199139,41,2,23,8,15
2019,199139,41,3,54,20,34
2019,199139,41,5,228,80,148
2019,199139,42,0,17,4,13
2019,199139,42,2,2,0,2
2019,199139,42,3,2,0,2
2019,199139,42,5,13,4,9
2019,199139,43,0,1,0,1
2019,199139,43,5,1,0,1
2019,199139,44,0,335,122,213
2019,199139,44,1,30,14,16
2019,199139,44,2,23,8,15
2019,199139,44,3,54,20,34
2019,199139,44,5,228,80,148
2019,199148,0,0,879,403,476
2019,199148,10,0,860,392,468
2019,199148,10,1,197,113,84
2019,199148,10,2,239,111,128
2019,199148,10,3,235,85,150
2019,199148,10,4,9,2,7
2019,199148,10,5,178,79,99
2019,199148,10,6,2,2,0
2019,199148,20,0,399,211,188
2019,199148,20,1,187,109,78
2019,199148,20,2,211,101,110
2019,199148,20,3,1,1,0
2019,199148,30,0,167,67,100
2019,199148,30,2,3,2,1
2019,199148,30,3,164,65,99
2019,199148,40,0,294,114,180
2019,199148,40,1,10,4,6
2019,199148,40,2,25,8,17
2019,199148,40,3,70,19,51
2019,199148,40,4,9,2,7
2019,199148,40,5,178,79,99
2019,199148,40,6,2,2,0
2019,199148,41,0,242,87,155
2019,199148,41,1,8,2,6
2019,199148,41,2,24,8,16
2019,199148,41,3,53,12,41
2019,199148,41,4,7,2,5
2019,199148,41,5,149,62,87
2019,199148,41,6,1,1,0
2019,199148,42,0,51,26,25
2019,199148,42,1,2,2,0
2019,199148,42,2,1,0,1
2019,199148,42,3,16,6,10
2019,199148,42,4,2,0,2
2019,199148,42,5,29,17,12
2019,199148,42,6,1,1,0
2019,199148,43,0,1,1,0
2019,199148,43,3,1,1,0
2019,199148,44,0,242,87,155
2019,199148,44,1,8,2,6
2019,199148,44,2,24,8,16
2019,199148,44,3,53,12,41
2019,199148,44,4,7,2,5
2019,199148,44,5,149,62,87
2019,199148,44,6,1,1,0
2019,199148,50,0,19,11,8
2019,199157,0,0,366,176,190
2019,199157,10,0,366,176,190
2019,199157,10,1,84,48,36
2019,199157,10,2,113,58,55
2019,199157,10,3,83,36,47
2019,199157,10,4,16,8,8
2019,199157,10,5,52,19,33
2019,199157,10,6,18,7,11
2019,199157,20,0,180,102,78
2019,199157,20,1,78,46,32
2019,199157,20,2,98,55,43
2019,199157,20,3,4,1,3
2019,199157,30,0,75,31,44
2019,199157,30,1,2,1,1
2019,199157,30,2,9,1,8
2019,199157,30,3,64,29,35
2019,199157,40,0,111,43,68
2019,199157,40,1,4,1,3
2019,199157,40,2,6,2,4
2019,199157,40,3,15,6,9
2019,199157,40,4,16,8,8
2019,199157,40,5,52,19,33
2019,199157,40,6,18,7,11
2019,199157,41,0,21,8,13
2019,199157,41,2,2,1,1
2019,199157,41,3,2,0,2
2019,199157,41,4,4,2,2
2019,199157,41,5,10,5,5
2019,199157,41,6,3,0,3
2019,199157,42,0,88,34,54
2019,199157,42,1,4,1,3
2019,199157,42,2,4,1,3
2019,199157,42,3,13,6,7
2019,199157,42,4,12,6,6
2019,199157,42,5,42,14,28
2019,199157,42,6,13,6,7
2019,199157,43,0,2,1,1
2019,199157,43,6,2,1,1
2019,199157,44,0,21,8,13
2019,199157,44,2,2,1,1
2019,199157,44,3,2,0,2
2019,199157,44,4,4,2,2
2019,199157,44,5,10,5,5
2019,199157,44,6,3,0,3
2019,199184,0,0,154,100,54
2019,199184,10,0,154,100,54
2019,199184,10,1,30,25,5
2019,199184,10,2,59,34,25
2019,199184,10,3,41,27,14
2019,199184,10,4,24,14,10
2019,199184,40,0,154,100,54
2019,199184,40,1,30,25,5
2019,199184,40,2,59,34,25
2019,199184,40,3,41,27,14
2019,199184,40,4,24,14,10
2019,199184,41,0,145,94,51
2019,199184,41,1,30,25,5
2019,199184,41,2,59,34,25
2019,199184,41,3,41,27,14
2019,199184,41,4,15,8,7
2019,199184,42,0,9,6,3
2019,199184,42,4,9,6,3
2019,199184,44,0,145,94,51
2019,199184,44,1,30,25,5
2019,199184,44,2,59,34,25
2019,199184,44,3,41,27,14
2019,199184,44,4,15,8,7
2019,199193,0,0,1769,1078,691
2019,199193,10,0,1757,1074,683
2019,199193,10,1,675,500,175
2019,199193,10,2,452,272,180
2019,199193,10,3,449,226,223
2019,199193,10,4,1,1,0
2019,199193,10,5,180,75,105
2019,199193,20,0,1016,719,297
2019,199193,20,1,643,485,158
2019,199193,20,2,373,234,139
2019,199193,30,0,361,197,164
2019,199193,30,2,21,13,8
2019,199193,30,3,340,184,156
2019,199193,40,0,380,158,222
2019,199193,40,1,32,15,17
2019,199193,40,2,58,25,33
2019,199193,40,3,109,42,67
2019,199193,40,4,1,1,0
2019,199193,40,5,180,75,105
2019,199193,41,0,261,110,151
2019,199193,41,1,25,11,14
2019,199193,41,2,49,21,28
2019,199193,41,3,86,34,52
2019,199193,41,5,101,44,57
2019,199193,42,0,33,15,18
2019,199193,42,1,3,1,2
2019,199193,42,2,2,1,1
2019,199193,42,3,9,3,6
2019,199193,42,4,1,1,0
2019,199193,42,5,18,9,9
2019,199193,43,0,86,33,53
2019,199193,43,1,4,3,1
2019,199193,43,2,7,3,4
2019,199193,43,3,14,5,9
2019,199193,43,5,61,22,39
2019,199193,44,0,261,110,151
2019,199193,44,1,25,11,14
2019,199193,44,2,49,21,28
2019,199193,44,3,86,34,52
2019,199193,44,5,101,44,57
2019,199193,50,0,12,4,8
2019,199209,0,0,59,30,29
2019,199209,10,0,59,30,29
2019,199209,10,1,13,8,5
2019,199209,10,2,20,11,9
2019,199209,10,3,20,8,12
2019,199209,10,4,6,3,3
2019,199209,20,0,35,19,16
2019,199209,20,1,13,8,5
2019,199209,20,2,19,10,9
2019,199209,20,3,3,1,2
2019,199209,30,0,18,9,9
2019,199209,30,2,1,1,0
2019,199209,30,3,15,7,8
2019,199209,30,4,2,1,1
2019,199209,40,0,6,2,4
2019,199209,40,3,2,0,2
2019,199209,40,4,4,2,2
2019,199209,42,0,6,2,4
2019,199209,42,3,2,0,2
2019,199209,42,4,4,2,2
2019,199218,0,0,688,323,365
2019,199218,10,0,688,323,365
2019,199218,10,1,181,121,60
2019,199218,10,2,181,91,90
2019,199218,10,3,170,69,101
2019,199218,10,5,156,42,114
2019,199218,20,0,355,209,146
2019,199218,20,1,179,119,60
2019,199218,20,2,174,90,84
2019,199218,20,3,2,0,2
2019,199218,30,0,172,68,104
2019,199218,30,2,7,1,6
2019,199218,30,3,165,67,98
2019,199218,40,0,161,46,115
2019,199218,40,1,2,2,0
2019,199218,40,3,3,2,1
2019,199218,40,5,156,42,114
2019,199218,42,0,161,46,115
2019,199218,42,1,2,2,0
2019,199218,42,3,3,2,1
2019,199218,42,5,156,42,114
2019,199263,0,0,27,15,12
2019,199263,10,0,27,15,12
2019,199263,10,4,27,15,12
2019,199263,40,0,27,15,12
2019,199263,40,4,27,15,12
2019,199263,42,0,27,15,12
2019,199263,42,4,27,15,12
2019,199272,0,0,39,13,26
2019,199272,10,0,39,13,26
2019,199272,10,1,5,2,3
2019,199272,10,2,8,3,5
2019,199272,10,3,26,8,18
2019,199272,20,0,8,3,5
2019,199272,20,1,5,2,3
2019,199272,20,2,3,1,2
2019,199272,40,0,31,10,21
2019,199272,40,2,5,2,3
2019,199272,40,3,26,8,18
2019,199272,41,0,23,8,15
2019,199272,41,2,5,2,3
2019,199272,41,3,18,6,12
2019,199272,42,0,8,2,6
2019,199272,42,3,8,2,6
2019,199272,44,0,23,8,15
2019,199272,44,2,5,2,3
2019,199272,44,3,18,6,12
2019,199281,0,0,313,145,168
2019,199281,10,0,313,145,168
2019,199281,10,1,71,46,25
2019,199281,10,2,71,33,38
2019,199281,10,3,95,34,61
2019,199281,10,4,4,2,2
2019,199281,10,5,71,30,41
2019,199281,10,6,1,0,1
2019,199281,20,0,137,75,62
2019,199281,20,1,66,43,23
2019,199281,20,2,67,30,37
2019,199281,20,3,4,2,2
2019,199281,30,0,83,33,50
2019,199281,30,1,3,1,2
2019,199281,30,2,4,3,1
2019,199281,30,3,76,29,47
2019,199281,40,0,93,37,56
2019,199281,40,1,2,2,0
2019,199281,40,3,15,3,12
2019,199281,40,4,4,2,2
2019,199281,40,5,71,30,41
2019,199281,40,6,1,0,1
2019,199281,41,0,9,5,4
2019,199281,41,1,2,2,0
2019,199281,41,5,7,3,4
2019,199281,42,0,84,32,52
2019,199281,42,3,15,3,12
2019,199281,42,4,4,2,2
2019,199281,42,5,64,27,37
2019,199281,42,6,1,0,1
2019,199281,44,0,9,5,4
2019,199281,44,1,2,2,0
2019,199281,44,5,7,3,4
2019,199306,0,0,91,37,54
2019,199306,10,0,91,37,54
2019,199306,10,1,14,7,7
2019,199306,10,2,33,13,20
2019,199306,10,3,43,16,27
2019,199306,10,4,1,1,0
2019,199306,40,0,91,37,54
2019,199306,40,1,14,7,7
2019,199306,40,2,33,13,20
2019,199306,40,3,43,16,27
2019,199306,40,4,1,1,0
2019,199306,41,0,39,20,19
2019,199306,41,1,12,7,5
2019,199306,41,2,23,11,12
2019,199306,41,3,4,2,2
2019,199306,42,0,14,2,12
2019,199306,42,1,2,0,2
2019,199306,42,2,3,0,3
2019,199306,42,3,9,2,7
2019,199306,43,0,38,15,23
2019,199306,43,2,7,2,5
2019,199306,43,3,30,12,18
2019,199306,43,4,1,1,0
2019,199306,44,0,39,20,19
2019,199306,44,1,12,7,5
2019,199306,44,2,23,11,12
2019,199306,44,3,4,2,2
2019,199324,0,0,60,29,31
2019,199324,10,0,60,29,31
2019,199324,10,6,60,29,31
2019,199324,40,0,60,29,31
2019,199324,40,6,60,29,31
2019,199324,42,0,60,29,31
2019,199324,42,6,60,29,31
2019,199333,0,0,181,69,112
2019,199333,10,0,181,69,112
2019,199333,10,6,181,69,112
2019,199333,40,0,181,69,112
2019,199333,40,6,181,69,112
2019,199333,42,0,181,69,112
2019,199333,42,6,181,69,112
2019,199412,0,0,135,55,80
2019,199412,10,0,135,55,80
2019,199412,10,1,30,21,9
2019,199412,10,2,35,11,24
2019,199412,10,3,43,16,27
2019,199412,10,4,21,4,17
2019,199412,10,5,6,3,3
2019,199412,20,0,62,31,31
2019,199412,20,1,29,20,9
2019,199412,20,2,31,10,21
2019,199412,20,3,2,1,1
2019,199412,30,0,25,11,14
2019,199412,30,2,1,1,0
2019,199412,30,3,23,10,13
2019,199412,30,4,1,0,1
2019,199412,40,0,48,13,35
2019,199412,40,1,1,1,0
2019,199412,40,2,3,0,3
2019,199412,40,3,18,5,13
2019,199412,40,4,20,4,16
2019,199412,40,5,6,3,3
2019,199412,42,0,48,13,35
2019,199412,42,1,1,1,0
2019,199412,42,2,3,0,3
2019,199412,42,3,18,5,13
2019,199412,42,4,20,4,16
2019,199412,42,5,6,3,3
2019,199421,0,0,84,38,46
2019,199421,10,0,83,38,45
2019,199421,10,6,83,38,45
2019,199421,40,0,83,38,45
2019,199421,40,6,83,38,45
2019,199421,42,0,83,38,45
2019,199421,42,6,83,38,45
2019,199421,50,0,1,0,1
2019,199449,0,0,99,41,58
2019,199449,10,0,99,41,58
2019,199449,10,6,99,41,58
2019,199449,40,0,99,41,58
2019,199449,40,6,99,41,58
2019,199449,42,0,99,41,58
2019,199449,42,6,99,41,58
2019,199458,0,0,12,10,2
2019,199458,10,0,12,10,2
2019,199458,10,1,5,5,0
2019,199458,10,3,6,4,2
2019,199458,10,4,1,1,0
2019,199458,40,0,12,10,2
2019,199458,40,1,5,5,0
2019,199458,40,3,6,4,2
2019,199458,40,4,1,1,0
2019,199458,42,0,12,10,2
2019,199458,42,1,5,5,0
2019,199458,42,3,6,4,2
2019,199458,42,4,1,1,0
2019,199467,0,0,24,9,15
2019,199467,10,0,24,9,15
2019,199467,10,6,24,9,15
2019,199467,40,0,24,9,15
2019,199467,40,6,24,9,15
2019,199467,42,0,24,9,15
2019,199467,42,6,24,9,15
2019,199476,0,0,73,28,45
2019,199476,10,0,73,28,45
2019,199476,10,4,73,28,45
2019,199476,40,0,73,28,45
2019,199476,40,4,73,28,45
2019,199476,42,0,35,18,17
2019,199476,42,4,35,18,17
2019,199476,43,0,38,10,28
2019,199476,43,4,38,10,28
2019,199485,0,0,54,20,34
2019,199485,10,0,54,20,34
2019,199485,10,6,54,20,34
2019,199485,40,0,54,20,34
2019,199485,40,6,54,20,34
2019,199485,42,0,54,20,34
2019,199485,42,6,54,20,34
2019,199494,0,0,170,60,110
2019,199494,10,0,170,60,110
2019,199494,10,6,170,60,110
2019,199494,40,0,170,60,110
2019,199494,40,6,170,60,110
2019,199494,42,0,170,60,110
2019,199494,42,6,170,60,110
2019,199582,0,0,68,35,33
2019,199582,10,0,68,35,33
2019,199582,10,1,5,3,2
2019,199582,10,2,14,8,6
2019,199582,10,3,38,20,18
2019,199582,10,4,11,4,7
2019,199582,20,0,11,5,6
2019,199582,20,1,5,3,2
2019,199582,20,2,6,2,4
2019,199582,40,0,57,30,27
2019,199582,40,2,8,6,2
2019,199582,40,3,38,20,18
2019,199582,40,4,11,4,7
2019,199582,42,0,57,30,27
2019,199582,42,2,8,6,2
2019,199582,42,3,38,20,18
2019,199582,42,4,11,4,7
2019,199607,0,0,51,10,41
2019,199607,10,0,48,9,39
2019,199607,10,1,10,1,9
2019,199607,10,2,22,6,16
2019,199607,10,3,14,2,12
2019,199607,10,4,1,0,1
2019,199607,10,6,1,0,1
2019,199607,20,0,26,8,18
2019,199607,20,1,10,1,9
2019,199607,20,2,15,6,9
2019,199607,20,3,1,1,0
2019,199607,30,0,5,1,4
2019,199607,30,2,2,0,2
2019,199607,30,3,3,1,2
2019,199607,40,0,17,0,17
2019,199607,40,2,5,0,5
2019,199607,40,3,10,0,10
2019,199607,40,4,1,0,1
2019,199607,40,6,1,0,1
2019,199607,41,0,6,0,6
2019,199607,41,2,5,0,5
2019,199607,41,3,1,0,1
2019,199607,42,0,11,0,11
2019,199607,42,3,9,0,9
2019,199607,42,4,1,0,1
2019,199607,42,6,1,0,1
2019,199607,44,0,6,0,6
2019,199607,44,2,5,0,5
2019,199607,44,3,1,0,1
2019,199607,50,0,3,1,2
2019,199625,0,0,57,17,40
2019,199625,10,0,57,17,40
2019,199625,10,4,57,17,40
2019,199625,40,0,57,17,40
2019,199625,40,4,57,17,40
2019,199625,42,0,57,17,40
2019,199625,42,4,57,17,40
2019,199634,0,0,119,37,82
2019,199634,10,0,119,37,82
2019,199634,10,6,119,37,82
2019,199634,40,0,119,37,82
2019,199634,40,6,119,37,82
2019,199634,42,0,119,37,82
2019,199634,42,6,119,37,82
2019,199643,0,0,63,28,35
2019,199643,10,0,63,28,35
2019,199643,10,1,2,2,0
2019,199643,10,2,11,6,5
2019,199643,10,3,36,13,23
2019,199643,10,4,14,7,7
2019,199643,40,0,63,28,35
2019,199643,40,1,2,2,0
2019,199643,40,2,11,6,5
2019,199643,40,3,36,13,23
2019,199643,40,4,14,7,7
2019,199643,42,0,63,28,35
2019,199643,42,1,2,2,0
2019,199643,42,2,11,6,5
2019,199643,42,3,36,13,23
2019,199643,42,4,14,7,7
2019,199698,0,0,45,19,26
2019,199698,10,0,45,19,26
2019,199698,10,1,8,4,4
2019,199698,10,2,14,6,8
2019,199698,10,3,12,6,6
2019,199698,10,4,11,3,8
2019,199698,20,0,8,5,3
2019,199698,20,1,6,3,3
2019,199698,20,2,2,2,0
2019,199698,40,0,37,14,23
2019,199698,40,1,2,1,1
2019,199698,40,2,12,4,8
2019,199698,40,3,12,6,6
2019,199698,40,4,11,3,8
2019,199698,42,0,9,4,5
2019,199698,42,2,6,3,3
2019,199698,42,3,2,1,1
2019,199698,42,4,1,0,1
2019,199698,43,0,28,10,18
2019,199698,43,1,2,1,1
2019,199698,43,2,6,1,5
2019,199698,43,3,10,5,5
2019,199698,43,4,10,3,7
2019,199722,0,0,58,23,35
2019,199722,10,0,58,23,35
2019,199722,10,6,58,23,35
2019,199722,40,0,58,23,35
2019,199722,40,6,58,23,35
2019,199722,42,0,58,23,35
2019,199722,42,6,58,23,35
2019,199731,0,0,79,35,44
2019,199731,10,0,79,35,44
2019,199731,10,6,79,35,44
2019,199731,40,0,79,35,44
2019,199731,40,6,79,35,44
2019,199731,42,0,78,35,43
2019,199731,42,6,78,35,43
2019,199731,43,0,1,0,1
2019,199731,43,6,1,0,1
2019,199740,0,0,78,31,47
2019,199740,10,0,78,31,47
2019,199740,10,6,78,31,47
2019,199740,40,0,78,31,47
2019,199740,40,6,78,31,47
2019,199740,42,0,78,31,47
2019,199740,42,6,78,31,47
2019,199759,0,0,57,54,3
2019,199759,10,0,57,54,3
2019,199759,10,1,29,29,0
2019,199759,10,2,10,10,0
2019,199759,10,3,15,12,3
2019,199759,10,4,3,3,0
2019,199759,40,0,57,54,3
2019,199759,40,1,29,29,0
2019,199759,40,2,10,10,0
2019,199759,40,3,15,12,3
2019,199759,40,4,3,3,0
2019,199759,41,0,57,54,3
2019,199759,41,1,29,29,0
2019,199759,41,2,10,10,0
2019,199759,41,3,15,12,3
2019,199759,41,4,3,3,0
2019,199759,44,0,57,54,3
2019,199759,44,1,29,29,0
2019,199759,44,2,10,10,0
2019,199759,44,3,15,12,3
2019,199759,44,4,3,3,0
2019,199768,0,0,95,35,60
2019,199768,10,0,95,35,60
2019,199768,10,6,95,35,60
2019,199768,40,0,95,35,60
2019,199768,40,6,95,35,60
2019,199768,42,0,95,35,60
2019,199768,42,6,95,35,60
2019,199786,0,0,117,50,67
2019,199786,10,0,117,50,67
2019,199786,10,6,117,50,67
2019,199786,40,0,117,50,67
2019,199786,40,6,117,50,67
2019,199786,42,0,115,50,65
2019,199786,42,6,115,50,65
2019,199786,43,0,2,0,2
2019,199786,43,6,2,0,2
2019,199795,0,0,37,14,23
2019,199795,10,0,37,14,23
2019,199795,10,6,37,14,23
2019,199795,40,0,37,14,23
2019,199795,40,6,37,14,23
2019,199795,42,0,37,14,23
2019,199795,42,6,37,14,23
2019,199838,0,0,93,38,55
2019,199838,10,0,93,38,55
2019,199838,10,4,93,38,55
2019,199838,40,0,93,38,55
2019,199838,40,4,93,38,55
2019,199838,42,0,93,38,55
2019,199838,42,4,93,38,55
2019,199847,0,0,1945,1144,801
2019,199847,10,0,1945,1144,801
2019,199847,10,1,447,316,131
2019,199847,10,2,430,271,159
2019,199847,10,3,718,360,358
2019,199847,10,4,250,130,120
2019,199847,10,5,36,21,15
2019,199847,10,6,64,46,18
2019,199847,20,0,527,345,182
2019,199847,20,1,306,208,98
2019,199847,20,2,189,110,79
2019,199847,20,3,2,2,0
2019,199847,20,4,4,2,2
2019,199847,20,6,26,23,3
2019,199847,30,0,183,84,99
2019,199847,30,1,3,2,1
2019,199847,30,2,16,11,5
2019,199847,30,3,160,69,91
2019,199847,30,4,4,2,2
2019,199847,40,0,1235,715,520
2019,199847,40,1,138,106,32
2019,199847,40,2,225,150,75
2019,199847,40,3,556,289,267
2019,199847,40,4,242,126,116
2019,199847,40,5,36,21,15
2019,199847,40,6,38,23,15
2019,199847,41,0,135,68,67
2019,199847,41,3,1,1,0
2019,199847,41,4,127,64,63
2019,199847,41,5,3,2,1
2019,199847,41,6,4,1,3
2019,199847,42,0,1100,647,453
2019,199847,42,1,138,106,32
2019,199847,42,2,225,150,75
2019,199847,42,3,555,288,267
2019,199847,42,4,115,62,53
2019,199847,42,5,33,19,14
2019,199847,42,6,34,22,12
2019,199847,44,0,128,67,61
2019,199847,44,3,1,1,0
2019,199847,44,4,121,63,58
2019,199847,44,5,3,2,1
2019,199847,44,6,3,1,2
2019,199847,45,0,7,1,6
2019,199847,45,4,6,1,5
2019,199847,45,6,1,0,1
2019,199856,0,0,577,238,339
2019,199856,10,0,576,238,338
2019,199856,10,6,576,238,338
2019,199856,40,0,576,238,338
2019,199856,40,6,576,238,338
2019,199856,42,0,557,231,326
2019,199856,42,6,557,231,326
2019,199856,43,0,19,7,12
2019,199856,43,6,19,7,12
2019,199856,50,0,1,0,1
2019,199865,0,0,55,20,35
2019,199865,10,0,55,20,35
2019,199865,10,6,55,20,35
2019,199865,40,0,55,20,35
2019,199865,40,6,55,20,35
2019,199865,41,0,43,17,26
2019,199865,41,6,43,17,26
2019,199865,42,0,12,3,9
2019,199865,42,6,12,3,9
2019,199865,44,0,43,17,26
2019,199865,44,6,43,17,26
2019,199892,0,0,117,53,64
2019,199892,10,0,117,53,64
2019,199892,10,6,117,53,64
2019,199892,40,0,117,53,64
2019,199892,40,6,117,53,64
2019,199892,42,0,117,53,64
2019,199892,42,6,117,53,64
2019,199908,0,0,67,30,37
2019,199908,10,0,67,30,37
2019,199908,10,6,67,30,37
2019,199908,40,0,67,30,37
2019,199908,40,6,67,30,37
2019,199908,42,0,67,30,37
2019,199908,42,6,67,30,37
2019,199926,0,0,104,49,55
2019,199926,10,0,102,47,55
2019,199926,10,6,102,47,55
2019,199926,40,0,102,47,55
2019,199926,40,6,102,47,55
2019,199926,41,0,1,0,1
2019,199926,41,6,1,0,1
2019,199926,42,0,101,47,54
2019,199926,42,6,101,47,54
2019,199926,45,0,1,0,1
2019,199926,45,6,1,0,1
2019,199926,50,0,2,2,0
2019,199953,0,0,46,17,29
2019,199953,10,0,46,17,29
2019,199953,10,6,46,17,29
2019,199953,40,0,46,17,29
2019,199953,40,6,46,17,29
2019,199953,42,0,32,11,21
2019,199953,42,6,32,11,21
2019,199953,43,0,14,6,8
2019,199953,43,6,14,6,8
2019,199962,0,0,186,78,108
2019,199962,10,0,186,78,108
2019,199962,10,1,32,15,17
2019,199962,10,2,60,30,30
2019,199962,10,3,78,29,49
2019,199962,10,4,16,4,12
2019,199962,40,0,186,78,108
2019,199962,40,1,32,15,17
2019,199962,40,2,60,30,30
2019,199962,40,3,78,29,49
2019,199962,40,4,16,4,12
2019,199962,42,0,186,78,108
2019,199962,42,1,32,15,17
2019,199962,42,2,60,30,30
2019,199962,42,3,78,29,49
2019,199962,42,4,16,4,12
2019,199999,0,0,264,112,152
2019,199999,10,0,264,112,152
2019,199999,10,1,47,30,17
2019,199999,10,2,105,51,54
2019,199999,10,3,71,21,50
2019,199999,10,4,28,4,24
2019,199999,10,5,11,5,6
2019,199999,10,6,2,1,1
2019,199999,20,0,146,80,66
2019,199999,20,1,47,30,17
2019,199999,20,2,99,50,49
2019,199999,30,0,57,19,38
2019,199999,30,2,4,1,3
2019,199999,30,3,53,18,35
2019,199999,40,0,61,13,48
2019,199999,40,2,2,0,2
2019,199999,40,3,18,3,15
2019,199999,40,4,28,4,24
2019,199999,40,5,11,5,6
2019,199999,40,6,2,1,1
2019,199999,41,0,43,7,36
2019,199999,41,2,1,0,1
2019,199999,41,3,11,2,9
2019,199999,41,4,26,4,22
2019,199999,41,5,5,1,4
2019,199999,42,0,13,5,8
2019,199999,42,3,4,1,3
2019,199999,42,4,2,0,2
2019,199999,42,5,6,4,2
2019,199999,42,6,1,0,1
2019,199999,43,0,5,1,4
2019,199999,43,2,1,0,1
2019,199999,43,3,3,0,3
2019,199999,43,6,1,1,0
2019,199999,44,0,43,7,36
2019,199999,44,2,1,0,1
2019,199999,44,3,11,2,9
2019,199999,44,4,26,4,22
2019,199999,44,5,5,1,4
2019,200004,0,0,511,251,260
2019,200004,10,0,511,251,260
2019,200004,10,1,105,70,35
2019,200004,10,2,126,62,64
2019,200004,10,3,216,92,124
2019,200004,10,4,58,23,35
2019,200004,10,5,6,4,2
2019,200004,20,0,215,122,93
2019,200004,20,1,95,63,32
2019,200004,20,2,119,59,60
2019,200004,20,3,1,0,1
2019,200004,30,0,137,71,66
2019,200004,30,1,6,3,3
2019,200004,30,2,5,3,2
2019,200004,30,3,126,65,61
2019,200004,40,0,159,58,101
2019,200004,40,1,4,4,0
2019,200004,40,2,2,0,2
2019,200004,40,3,89,27,62
2019,200004,40,4,58,23,35
2019,200004,40,5,6,4,2
2019,200004,41,0,18,10,8
2019,200004,41,1,4,4,0
2019,200004,41,2,1,0,1
2019,200004,41,3,7,3,4
2019,200004,41,4,5,2,3
2019,200004,41,5,1,1,0
2019,200004,42,0,131,44,87
2019,200004,42,2,1,0,1
2019,200004,42,3,75,21,54
2019,200004,42,4,50,20,30
2019,200004,42,5,5,3,2
2019,200004,43,0,10,4,6
2019,200004,43,3,7,3,4
2019,200004,43,4,3,1,2
2019,200004,44,0,18,10,8
2019,200004,44,1,4,4,0
2019,200004,44,2,1,0,1
2019,200004,44,3,7,3,4
2019,200004,44,4,5,2,3
2019,200004,44,5,1,1,0
2019,200013,0,0,18,1,17
2019,200013,10,0,18,1,17
2019,200013,10,4,18,1,17
2019,200013,40,0,18,1,17
2019,200013,40,4,18,1,17
2019,200013,41,0,18,1,17
2019,200013,41,4,18,1,17
2019,200013,45,0,18,1,17
2019,200013,45,4,18,1,17
2019,200022,0,0,118,67,51
2019,200022,10,0,118,67,51
2019,200022,10,1,9,4,5
2019,200022,10,2,60,36,24
2019,200022,10,3,49,27,22
2019,200022,20,0,70,40,30
2019,200022,20,1,9,4,5
2019,200022,20,2,60,36,24
2019,200022,20,3,1,0,1
2019,200022,30,0,37,19,18
2019,200022,30,3,37,19,18
2019,200022,40,0,11,8,3
2019,200022,40,3,11,8,3
2019,200022,42,0,11,8,3
2019,200022,42,3,11,8,3
2019,200059,0,0,70,33,37
2019,200059,10,0,70,33,37
2019,200059,10,1,10,8,2
2019,200059,10,2,16,7,9
2019,200059,10,3,28,17,11
2019,200059,10,4,13,1,12
2019,200059,10,5,3,0,3
2019,200059,20,0,37,23,14
2019,200059,20,1,10,8,2
2019,200059,20,2,13,6,7
2019,200059,20,3,14,9,5
2019,200059,30,0,15,6,9
2019,200059,30,2,3,1,2
2019,200059,30,3,11,5,6
2019,200059,30,4,1,0,1
2019,200059,40,0,18,4,14
2019,200059,40,3,3,3,0
2019,200059,40,4,12,1,11
2019,200059,40,5,3,0,3
2019,200059,42,0,18,4,14
2019,200059,42,3,3,3,0
2019,200059,42,4,12,1,11
2019,200059,42,5,3,0,3
2019,200086,0,0,24,11,13
2019,200086,10,0,24,11,13
2019,200086,10,6,24,11,13
2019,200086,40,0,24,11,13
2019,200086,40,6,24,11,13
2019,200086,42,0,24,11,13
2019,200086,42,6,24,11,13
2019,200156,0,0,76,34,42
2019,200156,10,0,76,34,42
2019,200156,10,1,19,13,6
2019,200156,10,2,23,5,18
2019,200156,10,3,29,14,15
2019,200156,10,4,5,2,3
2019,200156,40,0,76,34,42
2019,200156,40,1,19,13,6
2019,200156,40,2,23,5,18
2019,200156,40,3,29,14,15
2019,200156,40,4,5,2,3
2019,200156,41,0,76,34,42
2019,200156,41,1,19,13,6
2019,200156,41,2,23,5,18
2019,200156,41,3,29,14,15
2019,200156,41,4,5,2,3
2019,200156,44,0,76,34,42
2019,200156,44,1,19,13,6
2019,200156,44,2,23,5,18
2019,200156,44,3,29,14,15
2019,200156,44,4,5,2,3
2019,200192,0,0,40,16,24
2019,200192,10,0,40,16,24
2019,200192,10,1,3,1,2
2019,200192,10,2,9,3,6
2019,200192,10,3,13,6,7
2019,200192,10,4,15,6,9
2019,200192,20,0,11,6,5
2019,200192,20,1,3,1,2
2019,200192,20,2,6,3,3
2019,200192,20,3,2,2,0
2019,200192,30,0,10,5,5
2019,200192,30,3,6,3,3
2019,200192,30,4,4,2,2
2019,200192,40,0,19,5,14
2019,200192,40,2,3,0,3
2019,200192,40,3,5,1,4
2019,200192,40,4,11,4,7
2019,200192,42,0,19,5,14
2019,200192,42,2,3,0,3
2019,200192,42,3,5,1,4
2019,200192,42,4,11,4,7
2019,200208,0,0,19,11,8
2019,200208,10,0,19,11,8
2019,200208,10,4,19,11,8
2019,200208,40,0,19,11,8
2019,200208,40,4,19,11,8
2019,200208,42,0,19,11,8
2019,200208,42,4,19,11,8
2019,200217,0,0,164,76,88
2019,200217,10,0,164,76,88
2019,200217,10,1,22,10,12
2019,200217,10,2,33,17,16
2019,200217,10,3,97,43,54
2019,200217,10,4,12,6,6
2019,200217,40,0,164,76,88
2019,200217,40,1,22,10,12
2019,200217,40,2,33,17,16
2019,200217,40,3,97,43,54
2019,200217,40,4,12,6,6
2019,200217,42,0,164,76,88
2019,200217,42,1,22,10,12
2019,200217,42,2,33,17,16
2019,200217,42,3,97,43,54
2019,200217,42,4,12,6,6
2019,200226,0,0,50,23,27
2019,200226,10,0,47,22,25
2019,200226,10,1,9,7,2
2019,200226,10,2,17,9,8
2019,200226,10,3,10,4,6
2019,200226,10,4,11,2,9
2019,200226,20,0,22,16,6
2019,200226,20,1,8,7,1
2019,200226,20,2,13,8,5
2019,200226,20,3,1,1,0
2019,200226,30,0,14,4,10
2019,200226,30,1,1,0,1
2019,200226,30,2,4,1,3
2019,200226,30,3,7,2,5
2019,200226,30,4,2,1,1
2019,200226,40,0,11,2,9
2019,200226,40,3,2,1,1
2019,200226,40,4,9,1,8
2019,200226,42,0,11,2,9
2019,200226,42,3,2,1,1
2019,200226,42,4,9,1,8
2019,200226,50,0,3,1,2
2019,200253,0,0,146,59,87
2019,200253,10,0,146,59,87
2019,200253,10,1,33,19,14
2019,200253,10,2,24,10,14
2019,200253,10,3,49,23,26
2019,200253,10,4,40,7,33
2019,200253,20,0,69,34,35
2019,200253,20,1,33,19,14
2019,200253,20,2,21,9,12
2019,200253,20,3,15,6,9
2019,200253,30,0,47,18,29
2019,200253,30,2,3,1,2
2019,200253,30,3,33,16,17
2019,200253,30,4,11,1,10
2019,200253,40,0,30,7,23
2019,200253,40,3,1,1,0
2019,200253,40,4,29,6,23
2019,200253,42,0,30,7,23
2019,200253,42,3,1,1,0
2019,200253,42,4,29,6,23
2019,200280,0,0,708,418,290
2019,200280,10,0,656,387,269
2019,200280,10,1,154,107,47
2019,200280,10,2,189,118,71
2019,200280,10,3,182,90,92
2019,200280,10,4,69,33,36
2019,200280,10,5,41,27,14
2019,200280,10,6,21,12,9
2019,200280,20,0,299,204,95
2019,200280,20,1,148,103,45
2019,200280,20,2,147,98,49
2019,200280,20,3,4,3,1
2019,200280,30,0,81,49,32
2019,200280,30,2,3,3,0
2019,200280,30,3,78,46,32
2019,200280,40,0,276,134,142
2019,200280,40,1,6,4,2
2019,200280,40,2,39,17,22
2019,200280,40,3,100,41,59
2019,200280,40,4,69,33,36
2019,200280,40,5,41,27,14
2019,200280,40,6,21,12,9
2019,200280,42,0,276,134,142
2019,200280,42,1,6,4,2
2019,200280,42,2,39,17,22
2019,200280,42,3,100,41,59
2019,200280,42,4,69,33,36
2019,200280,42,5,41,27,14
2019,200280,42,6,21,12,9
2019,200280,50,0,52,31,21
2019,200305,0,0,104,60,44
2019,200305,10,0,104,60,44
2019,200305,10,1,2,1,1
2019,200305,10,2,64,42,22
2019,200305,10,3,17,5,12
2019,200305,10,4,21,12,9
2019,200305,20,0,65,42,23
2019,200305,20,1,2,1,1
2019,200305,20,2,63,41,22
2019,200305,30,0,37,18,19
2019,200305,30,2,1,1,0
2019,200305,30,3,15,5,10
2019,200305,30,4,21,12,9
2019,200305,40,0,2,0,2
2019,200305,40,3,2,0,2
2019,200305,42,0,2,0,2
2019,200305,42,3,2,0,2
2019,200314,0,0,31,11,20
2019,200314,10,0,31,11,20
2019,200314,10,1,2,2,0
2019,200314,10,2,6,2,4
2019,200314,10,3,3,2,1
2019,200314,10,4,20,5,15
2019,200314,20,0,6,2,4
2019,200314,20,1,1,1,0
2019,200314,20,2,5,1,4
2019,200314,30,0,4,1,3
2019,200314,30,3,1,1,0
2019,200314,30,4,3,0,3
2019,200314,40,0,21,8,13
2019,200314,40,1,1,1,0
2019,200314,40,2,1,1,0
2019,200314,40,3,2,1,1
2019,200314,40,4,17,5,12
2019,200314,42,0,4,1,3
2019,200314,42,3,2,1,1
2019,200314,42,4,2,0,2
2019,200314,43,0,17,7,10
2019,200314,43,1,1,1,0
2019,200314,43,2,1,1,0
2019,200314,43,4,15,5,10
2019,200332,0,0,553,302,251
2019,200332,10,0,553,302,251
2019,200332,10,1,130,99,31
2019,200332,10,2,182,96,86
2019,200332,10,3,166,77,89
2019,200332,10,4,2,2,0
2019,200332,10,5,73,28,45
2019,200332,20,0,278,182,96
2019,200332,20,1,129,98,31
2019,200332,20,2,149,84,65
2019,200332,30,0,120,70,50
2019,200332,30,2,10,3,7
2019,200332,30,3,110,67,43
2019,200332,40,0,155,50,105
2019,200332,40,1,1,1,0
2019,200332,40,2,23,9,14
2019,200332,40,3,56,10,46
2019,200332,40,4,2,2,0
2019,200332,40,5,73,28,45
2019,200332,42,0,155,50,105
2019,200332,42,1,1,1,0
2019,200332,42,2,23,9,14
2019,200332,42,3,56,10,46
2019,200332,42,4,2,2,0
2019,200332,42,5,73,28,45
2019,200341,0,0,30,14,16
2019,200341,10,0,30,14,16
2019,200341,10,1,3,1,2
2019,200341,10,2,16,8,8
2019,200341,10,3,3,1,2
2019,200341,10,4,8,4,4
2019,200341,20,0,19,9,10
2019,200341,20,1,3,1,2
2019,200341,20,2,16,8,8
2019,200341,30,0,3,1,2
2019,200341,30,3,3,1,2
2019,200341,40,0,8,4,4
2019,200341,40,4,8,4,4
2019,200341,42,0,8,4,4
2019,200341,42,4,8,4,4
2019,200466,0,0,26,14,12
2019,200466,10,0,26,14,12
2019,200466,10,6,26,14,12
2019,200466,40,0,26,14,12
2019,200466,40,6,26,14,12
2019,200466,43,0,26,14,12
2019,200466,43,6,26,14,12
2019,200484,0,0,15,11,4
2019,200484,10,0,15,11,4
2019,200484,10,2,5,5,0
2019,200484,10,3,9,5,4
2019,200484,10,6,1,1,0
2019,200484,40,0,15,11,4
2019,200484,40,2,5,5,0
2019,200484,40,3,9,5,4
2019,200484,40,6,1,1,0
2019,200484,41,0,1,1,0
2019,200484,41,6,1,1,0
2019,200484,42,0,14,10,4
2019,200484,42,2,5,5,0
2019,200484,42,3,9,5,4
2019,200484,44,0,1,1,0
2019,200484,44,6,1,1,0
2019,200527,0,0,46,23,23
2019,200527,10,0,46,23,23
2019,200527,10,4,46,23,23
2019,200527,40,0,46,23,23
2019,200527,40,4,46,23,23
2019,200527,43,0,46,23,23
2019,200527,43,4,46,23,23
2019,200554,0,0,37,21,16
2019,200554,10,0,37,21,16
2019,200554,10,4,37,21,16
2019,200554,40,0,37,21,16
2019,200554,40,4,37,21,16
2019,200554,42,0,2,2,0
2019,200554,42,4,2,2,0
2019,200554,43,0,35,19,16
2019,200554,43,4,35,19,16
2019,200572,0,0,69,31,38
2019,200572,10,0,69,31,38
2019,200572,10,1,11,6,5
2019,200572,10,2,22,11,11
2019,200572,10,3,32,13,19
2019,200572,10,4,4,1,3
2019,200572,20,0,37,18,19
2019,200572,20,1,11,6,5
2019,200572,20,2,21,11,10
2019,200572,20,3,5,1,4
2019,200572,30,0,23,10,13
2019,200572,30,2,1,0,1
2019,200572,30,3,21,10,11
2019,200572,30,4,1,0,1
2019,200572,40,0,9,3,6
2019,200572,40,3,6,2,4
2019,200572,40,4,3,1,2
2019,200572,41,0,9,3,6
2019,200572,41,3,6,2,4
2019,200572,41,4,3,1,2
2019,200572,44,0,9,3,6
2019,200572,44,3,6,2,4
2019,200572,44,4,3,1,2
2019,200590,0,0,10,4,6
2019,200590,10,0,10,4,6
2019,200590,10,4,10,4,6
2019,200590,40,0,10,4,6
2019,200590,40,4,10,4,6
2019,200590,41,0,10,4,6
2019,200590,41,4,10,4,6
2019,200590,45,0,10,4,6
2019,200590,45,4,10,4,6
2019,200785,0,0,11,1,10
2019,200785,10,0,11,1,10
2019,200785,10,1,1,0,1
2019,200785,10,2,3,0,3
2019,200785,10,3,6,1,5
2019,200785,10,4,1,0,1
2019,200785,40,0,11,1,10
2019,200785,40,1,1,0,1
2019,200785,40,2,3,0,3
2019,200785,40,3,6,1,5
2019,200785,40,4,1,0,1
2019,200785,41,0,11,1,10
2019,200785,41,1,1,0,1
2019,200785,41,2,3,0,3
2019,200785,41,3,6,1,5
2019,200785,41,4,1,0,1
2019,200785,45,0,11,1,10
2019,200785,45,1,1,0,1
2019,200785,45,2,3,0,3
2019,200785,45,3,6,1,5
2019,200785,45,4,1,0,1
2019,200800,0,0,631,365,266
2019,200800,10,0,631,365,266
2019,200800,10,1,214,156,58
2019,200800,10,2,175,100,75
2019,200800,10,3,69,33,36
2019,200800,10,4,120,42,78
2019,200800,10,5,53,34,19
2019,200800,20,0,378,250,128
2019,200800,20,1,212,154,58
2019,200800,20,2,166,96,70
2019,200800,30,0,59,30,29
2019,200800,30,2,6,3,3
2019,200800,30,3,53,27,26
2019,200800,40,0,194,85,109
2019,200800,40,1,2,2,0
2019,200800,40,2,3,1,2
2019,200800,40,3,16,6,10
2019,200800,40,4,120,42,78
2019,200800,40,5,53,34,19
2019,200800,42,0,194,85,109
2019,200800,42,1,2,2,0
2019,200800,42,2,3,1,2
2019,200800,42,3,16,6,10
2019,200800,42,4,120,42,78
2019,200800,42,5,53,34,19
2019,200846,0,0,17,9,8
2019,200846,10,0,17,9,8
2019,200846,10,1,5,3,2
2019,200846,10,2,8,5,3
2019,200846,10,3,2,0,2
2019,200846,10,4,2,1,1
2019,200846,20,0,13,8,5
2019,200846,20,1,5,3,2
2019,200846,20,2,8,5,3
2019,200846,30,0,2,0,2
2019,200846,30,3,2,0,2
2019,200846,40,0,2,1,1
2019,200846,40,4,2,1,1
2019,200846,42,0,2,1,1
2019,200846,42,4,2,1,1
2019,200873,0,0,4,2,2
2019,200873,10,0,4,2,2
2019,200873,10,1,4,2,2
2019,200873,40,0,4,2,2
2019,200873,40,1,4,2,2
2019,200873,41,0,3,2,1
2019,200873,41,1,3,2,1
2019,200873,42,0,1,0,1
2019,200873,42,1,1,0,1
2019,200873,44,0,3,2,1
2019,200873,44,1,3,2,1
2019,201061,0,0,9,6,3
2019,201061,10,0,9,6,3
2019,201061,10,1,2,2,0
2019,201061,10,2,4,3,1
2019,201061,10,3,3,1,2
2019,201061,40,0,9,6,3
2019,201061,40,1,2,2,0
2019,201061,40,2,4,3,1
2019,201061,40,3,3,1,2
2019,201061,41,0,9,6,3
2019,201061,41,1,2,2,0
2019,201061,41,2,4,3,1
2019,201061,41,3,3,1,2
2019,201061,45,0,9,6,3
2019,201061,45,1,2,2,0
2019,201061,45,2,4,3,1
2019,201061,45,3,3,1,2
2019,201104,0,0,186,104,82
2019,201104,10,0,186,104,82
2019,201104,10,1,50,39,11
2019,201104,10,2,47,25,22
2019,201104,10,3,47,26,21
2019,201104,10,4,42,14,28
2019,201104,20,0,103,68,35
2019,201104,20,1,50,39,11
2019,201104,20,2,46,25,21
2019,201104,20,3,7,4,3
2019,201104,30,0,31,16,15
2019,201104,30,2,1,0,1
2019,201104,30,3,30,16,14
2019,201104,40,0,52,20,32
2019,201104,40,3,10,6,4
2019,201104,40,4,42,14,28
2019,201104,41,0,5,3,2
2019,201104,41,3,1,1,0
2019,201104,41,4,4,2,2
2019,201104,42,0,47,17,30
2019,201104,42,3,9,5,4
2019,201104,42,4,38,12,26
2019,201104,44,0,5,3,2
2019,201104,44,3,1,1,0
2019,201104,44,4,4,2,2
2019,201140,0,0,7,7,0
2019,201140,10,0,7,7,0
2019,201140,10,1,1,1,0
2019,201140,10,2,3,3,0
2019,201140,10,3,3,3,0
2019,201140,40,0,7,7,0
2019,201140,40,1,1,1,0
2019,201140,40,2,3,3,0
2019,201140,40,3,3,3,0
2019,201140,41,0,3,3,0
2019,201140,41,1,1,1,0
2019,201140,41,2,2,2,0
2019,201140,42,0,4,4,0
2019,201140,42,2,1,1,0
2019,201140,42,3,3,3,0
2019,201140,44,0,3,3,0
2019,201140,44,1,1,1,0
2019,201140,44,2,2,2,0
2019,201177,0,0,14,2,12
2019,201177,10,0,14,2,12
2019,201177,10,2,3,1,2
2019,201177,10,3,9,1,8
2019,201177,10,4,2,0,2
2019,201177,40,0,14,2,12
2019,201177,40,2,3,1,2
2019,201177,40,3,9,1,8
2019,201177,40,4,2,0,2
2019,201177,41,0,14,2,12
2019,201177,41,2,3,1,2
2019,201177,41,3,9,1,8
2019,201177,41,4,2,0,2
2019,201177,44,0,14,2,12
2019,201177,44,2,3,1,2
2019,201177,44,3,9,1,8
2019,201177,44,4,2,0,2
2019,201195,0,0,227,108,119
2019,201195,10,0,226,108,118
2019,201195,10,1,80,44,36
2019,201195,10,2,68,34,34
2019,201195,10,3,75,29,46
2019,201195,10,4,3,1,2
2019,201195,20,0,114,61,53
2019,201195,20,1,74,41,33
2019,201195,20,2,39,20,19
2019,201195,20,3,1,0,1
2019,201195,30,0,75,33,42
2019,201195,30,1,4,1,3
2019,201195,30,2,22,11,11
2019,201195,30,3,49,21,28
2019,201195,40,0,37,14,23
2019,201195,40,1,2,2,0
2019,201195,40,2,7,3,4
2019,201195,40,3,25,8,17
2019,201195,40,4,3,1,2
2019,201195,41,0,18,8,10
2019,201195,41,1,2,2,0
2019,201195,41,2,2,1,1
2019,201195,41,3,13,5,8
2019,201195,41,4,1,0,1
2019,201195,42,0,19,6,13
2019,201195,42,2,5,2,3
2019,201195,42,3,12,3,9
2019,201195,42,4,2,1,1
2019,201195,44,0,18,8,10
2019,201195,44,1,2,2,0
2019,201195,44,2,2,1,1
2019,201195,44,3,13,5,8
2019,201195,44,4,1,0,1
2019,201195,50,0,1,0,1
2019,201283,0,0,29,11,18
2019,201283,10,0,29,11,18
2019,201283,10,1,12,6,6
2019,201283,10,2,9,2,7
2019,201283,10,3,4,2,2
2019,201283,10,4,4,1,3
2019,201283,40,0,29,11,18
2019,201283,40,1,12,6,6
2019,201283,40,2,9,2,7
2019,201283,40,3,4,2,2
2019,201283,40,4,4,1,3
2019,201283,41,0,26,11,15
2019,201283,41,1,12,6,6
2019,201283,41,2,9,2,7
2019,201283,41,3,3,2,1
2019,201283,41,4,2,1,1
2019,201283,42,0,3,0,3
2019,201283,42,3,1,0,1
2019,201283,42,4,2,0,2
2019,201283,44,0,26,11,15
2019,201283,44,1,12,6,6
2019,201283,44,2,9,2,7
2019,201283,44,3,3,2,1
2019,201283,44,4,2,1,1
2019,201371,0,0,51,26,25
2019,201371,10,0,51,26,25
2019,201371,10,1,18,11,7
2019,201371,10,2,10,5,5
2019,201371,10,3,23,10,13
2019,201371,20,0,25,16,9
2019,201371,20,1,18,11,7
2019,201371,20,2,6,4,2
2019,201371,20,3,1,1,0
2019,201371,30,0,9,3,6
2019,201371,30,2,2,1,1
2019,201371,30,3,7,2,5
2019,201371,40,0,17,7,10
2019,201371,40,2,2,0,2
2019,201371,40,3,15,7,8
2019,201371,41,0,17,7,10
2019,201371,41,2,2,0,2
2019,201371,41,3,15,7,8
2019,201371,44,0,17,7,10
2019,201371,44,2,2,0,2
2019,201371,44,3,15,7,8
2019,201432,0,0,44,19,25
2019,201432,10,0,44,19,25
2019,201432,10,1,14,7,7
2019,201432,10,2,20,8,12
2019,201432,10,3,10,4,6
2019,201432,20,0,18,10,8
2019,201432,20,1,6,4,2
2019,201432,20,2,12,6,6
2019,201432,30,0,1,0,1
2019,201432,30,3,1,0,1
2019,201432,40,0,25,9,16
2019,201432,40,1,8,3,5
2019,201432,40,2,8,2,6
2019,201432,40,3,9,4,5
2019,201432,42,0,25,9,16
2019,201432,42,1,8,3,5
2019,201432,42,2,8,2,6
2019,201432,42,3,9,4,5
2019,201441,0,0,760,383,377
2019,201441,10,0,760,383,377
2019,201441,10,1,260,145,115
2019,201441,10,2,269,125,144
2019,201441,10,3,231,113,118
2019,201441,20,0,390,215,175
2019,201441,20,1,189,120,69
2019,201441,20,2,198,92,106
2019,201441,20,3,3,3,0
2019,201441,30,0,112,60,52
2019,201441,30,2,3,3,0
2019,201441,30,3,109,57,52
2019,201441,40,0,258,108,150
2019,201441,40,1,71,25,46
2019,201441,40,2,68,30,38
2019,201441,40,3,119,53,66
2019,201441,42,0,258,108,150
2019,201441,42,1,71,25,46
2019,201441,42,2,68,30,38
2019,201441,42,3,119,53,66
2019,201469,0,0,37,8,29
2019,201469,10,0,37,8,29
2019,201469,10,4,37,8,29
2019,201469,40,0,37,8,29
2019,201469,40,4,37,8,29
2019,201469,41,0,37,8,29
2019,201469,41,4,37,8,29
2019,201469,45,0,37,8,29
2019,201469,45,4,37,8,29
2019,201548,0,0,163,79,84
2019,201548,10,0,163,79,84
2019,201548,10,1,63,37,26
2019,201548,10,2,32,14,18
2019,201548,10,3,30,12,18
2019,201548,10,4,38,16,22
2019,201548,20,0,90,49,41
2019,201548,20,1,60,36,24
2019,201548,20,2,29,13,16
2019,201548,20,3,1,0,1
2019,201548,30,0,19,8,11
2019,201548,30,1,1,1,0
2019,201548,30,3,18,7,11
2019,201548,40,0,54,22,32
2019,201548,40,1,2,0,2
2019,201548,40,2,3,1,2
2019,201548,40,3,11,5,6
2019,201548,40,4,38,16,22
2019,201548,41,0,7,3,4
2019,201548,41,4,7,3,4
2019,201548,42,0,47,19,28
2019,201548,42,1,2,0,2
2019,201548,42,2,3,1,2
2019,201548,42,3,11,5,6
2019,201548,42,4,31,13,18
2019,201548,44,0,7,3,4
2019,201548,44,4,7,3,4
2019,201645,0,0,1227,724,503
2019,201645,10,0,1227,724,503
2019,201645,10,1,460,349,111
2019,201645,10,2,299,168,131
2019,201645,10,3,242,120,122
2019,201645,10,4,109,41,68
2019,201645,10,5,80,28,52
2019,201645,10,6,37,18,19
2019,201645,20,0,575,414,161
2019,201645,20,1,388,303,85
2019,201645,20,2,187,111,76
2019,201645,30,0,150,86,64
2019,201645,30,1,1,1,0
2019,201645,30,2,22,16,6
2019,201645,30,3,127,69,58
2019,201645,40,0,502,224,278
2019,201645,40,1,71,45,26
2019,201645,40,2,90,41,49
2019,201645,40,3,115,51,64
2019,201645,40,4,109,41,68
2019,201645,40,5,80,28,52
2019,201645,40,6,37,18,19
2019,201645,41,0,385,178,207
2019,201645,41,1,71,45,26
2019,201645,41,2,90,41,49
2019,201645,41,3,115,51,64
2019,201645,41,4,109,41,68
2019,201645,42,0,109,41,68
2019,201645,42,5,80,28,52
2019,201645,42,6,29,13,16
2019,201645,43,0,8,5,3
2019,201645,43,6,8,5,3
2019,201645,45,0,385,178,207
2019,201645,45,1,71,45,26
2019,201645,45,2,90,41,49
2019,201645,45,3,115,51,64
2019,201645,45,4,109,41,68
2019,201654,0,0,227,145,82
2019,201654,10,0,227,145,82
2019,201654,10,1,67,56,11
2019,201654,10,2,74,47,27
2019,201654,10,3,81,40,41
2019,201654,10,4,5,2,3
2019,201654,20,0,104,76,28
2019,201654,20,1,60,50,10
2019,201654,20,2,43,25,18
2019,201654,20,3,1,1,0
2019,201654,30,0,52,38,14
2019,201654,30,1,7,6,1
2019,201654,30,2,16,14,2
2019,201654,30,3,29,18,11
2019,201654,40,0,71,31,40
2019,201654,40,2,15,8,7
2019,201654,40,3,51,21,30
2019,201654,40,4,5,2,3
2019,201654,42,0,71,31,40
2019,201654,42,2,15,8,7
2019,201654,42,3,51,21,30
2019,201654,42,4,5,2,3
2019,201672,0,0,61,25,36
2019,201672,10,0,61,25,36
2019,201672,10,1,10,4,6
2019,201672,10,2,12,3,9
2019,201672,10,3,18,9,9
2019,201672,10,4,21,9,12
2019,201672,20,0,2,1,1
2019,201672,20,1,2,1,1
2019,201672,40,0,59,24,35
2019,201672,40,1,8,3,5
2019,201672,40,2,12,3,9
2019,201672,40,3,18,9,9
2019,201672,40,4,21,9,12
2019,201672,41,0,29,11,18
2019,201672,41,1,4,1,3
2019,201672,41,2,11,3,8
2019,201672,41,3,8,4,4
2019,201672,41,4,6,3,3
2019,201672,42,0,30,13,17
2019,201672,42,1,4,2,2
2019,201672,42,2,1,0,1
2019,201672,42,3,10,5,5
2019,201672,42,4,15,6,9
2019,201672,44,0,29,11,18
2019,201672,44,1,4,1,3
2019,201672,44,2,11,3,8
2019,201672,44,3,8,4,4
2019,201672,44,4,6,3,3
2019,201690,0,0,98,62,36
2019,201690,10,0,98,62,36
2019,201690,10,1,20,12,8
2019,201690,10,2,34,23,11
2019,201690,10,3,42,27,15
2019,201690,10,4,2,0,2
2019,201690,20,0,54,34,20
2019,201690,20,1,20,12,8
2019,201690,20,2,27,19,8
2019,201690,20,3,7,3,4
2019,201690,30,0,37,24,13
2019,201690,30,2,7,4,3
2019,201690,30,3,30,20,10
2019,201690,40,0,7,4,3
2019,201690,40,3,5,4,1
2019,201690,40,4,2,0,2
2019,201690,41,0,7,4,3
2019,201690,41,3,5,4,1
2019,201690,41,4,2,0,2
2019,201690,44,0,7,4,3
2019,201690,44,3,5,4,1
2019,201690,44,4,2,0,2
2019,201751,0,0,4,1,3
2019,201751,10,0,4,1,3
2019,201751,10,4,4,1,3
2019,201751,40,0,4,1,3
2019,201751,40,4,4,1,3
2019,201751,41,0,4,1,3
2019,201751,41,4,4,1,3
2019,201751,45,0,4,1,3
2019,201751,45,4,4,1,3
2019,201821,0,0,42,6,36
2019,201821,10,0,42,6,36
2019,201821,10,2,4,2,2
2019,201821,10,3,33,4,29
2019,201821,10,4,5,0,5
2019,201821,40,0,42,6,36
2019,201821,40,2,4,2,2
2019,201821,40,3,33,4,29
2019,201821,40,4,5,0,5
2019,201821,41,0,42,6,36
2019,201821,41,2,4,2,2
2019,201821,41,3,33,4,29
2019,201821,41,4,5,0,5
2019,201821,45,0,42,6,36
2019,201821,45,2,4,2,2
2019,201821,45,3,33,4,29
2019,201821,45,4,5,0,5
2019,201885,0,0,2205,1243,962
2019,201885,10,0,2205,1243,962
2019,201885,10,1,590,403,187
2019,201885,10,2,649,362,287
2019,201885,10,3,816,411,405
2019,201885,10,4,144,61,83
2019,201885,10,6,6,6,0
2019,201885,20,0,763,495,268
2019,201885,20,1,435,315,120
2019,201885,20,2,325,179,146
2019,201885,20,3,3,1,2
2019,201885,30,0,219,130,89
2019,201885,30,1,4,3,1
2019,201885,30,2,14,5,9
2019,201885,30,3,201,122,79
2019,201885,40,0,1223,618,605
2019,201885,40,1,151,85,66
2019,201885,40,2,310,178,132
2019,201885,40,3,612,288,324
2019,201885,40,4,144,61,83
2019,201885,40,6,6,6,0
2019,201885,41,0,1108,578,530
2019,201885,41,1,142,81,61
2019,201885,41,2,290,171,119
2019,201885,41,3,552,271,281
2019,201885,41,4,124,55,69
2019,201885,42,0,36,15,21
2019,201885,42,1,1,0,1
2019,201885,42,2,2,1,1
2019,201885,42,3,27,12,15
2019,201885,42,4,6,2,4
2019,201885,43,0,79,25,54
2019,201885,43,1,8,4,4
2019,201885,43,2,18,6,12
2019,201885,43,3,33,5,28
2019,201885,43,4,14,4,10
2019,201885,43,6,6,6,0
2019,201885,44,0,1108,578,530
2019,201885,44,1,142,81,61
2019,201885,44,2,290,171,119
2019,201885,44,3,552,271,281
2019,201885,44,4,124,55,69
2019,201928,0,0,145,53,92
2019,201928,10,0,145,53,92
2019,201928,10,6,145,53,92
2019,201928,20,0,113,46,67
2019,201928,20,6,113,46,67
2019,201928,30,0,26,6,20
2019,201928,30,6,26,6,20
2019,201928,40,0,6,1,5
2019,201928,40,6,6,1,5
2019,201928,42,0,6,1,5
2019,201928,42,6,6,1,5
2019,201946,0,0,76,38,38
2019,201946,10,0,76,38,38
2019,201946,10,1,31,15,16
2019,201946,10,2,26,12,14
2019,201946,10,3,18,11,7
2019,201946,10,4,1,0,1
2019,201946,20,0,53,25,28
2019,201946,20,1,31,15,16
2019,201946,20,2,22,10,12
2019,201946,30,0,9,6,3
2019,201946,30,2,1,0,1
2019,201946,30,3,8,6,2
2019,201946,40,0,14,7,7
2019,201946,40,2,3,2,1
2019,201946,40,3,10,5,5
2019,201946,40,4,1,0,1
2019,201946,41,0,13,6,7
2019,201946,41,2,3,2,1
2019,201946,41,3,9,4,5
2019,201946,41,4,1,0,1
2019,201946,42,0,1,1,0
2019,201946,42,3,1,1,0
2019,201946,44,0,13,6,7
2019,201946,44,2,3,2,1
2019,201946,44,3,9,4,5
2019,201946,44,4,1,0,1
2019,201955,0,0,169,64,105
2019,201955,10,0,169,64,105
2019,201955,10,1,29,7,22
2019,201955,10,2,79,32,47
2019,201955,10,3,56,22,34
2019,201955,10,4,5,3,2
2019,201955,20,0,104,38,66
2019,201955,20,1,28,7,21
2019,201955,20,2,75,31,44
2019,201955,20,3,1,0,1
2019,201955,30,0,45,16,29
2019,201955,30,3,45,16,29
2019,201955,40,0,20,10,10
2019,201955,40,1,1,0,1
2019,201955,40,2,4,1,3
2019,201955,40,3,10,6,4
2019,201955,40,4,5,3,2
2019,201955,41,0,15,8,7
2019,201955,41,1,1,0,1
2019,201955,41,2,4,1,3
2019,201955,41,3,5,4,1
2019,201955,41,4,5,3,2
2019,201955,42,0,5,2,3
2019,201955,42,3,5,2,3
2019,201955,44,0,15,8,7
2019,201955,44,1,1,0,1
2019,201955,44,2,4,1,3
2019,201955,44,3,5,4,1
2019,201955,44,4,5,3,2
2019,201964,0,0,105,74,31
2019,201964,10,0,105,74,31
2019,201964,10,1,6,4,2
2019,201964,10,2,7,5,2
2019,201964,10,3,9,7,2
2019,201964,10,6,83,58,25
2019,201964,40,0,105,74,31
2019,201964,40,1,6,4,2
2019,201964,40,2,7,5,2
2019,201964,40,3,9,7,2
2019,201964,40,6,83,58,25
2019,201964,42,0,105,74,31
2019,201964,42,1,6,4,2
2019,201964,42,2,7,5,2
2019,201964,42,3,9,7,2
2019,201964,42,6,83,58,25
2019,201973,0,0,86,24,62
2019,201973,10,0,81,22,59
2019,201973,10,1,16,7,9
2019,201973,10,2,18,5,13
2019,201973,10,3,23,5,18
2019,201973,10,4,24,5,19
2019,201973,40,0,81,22,59
2019,201973,40,1,16,7,9
2019,201973,40,2,18,5,13
2019,201973,40,3,23,5,18
2019,201973,40,4,24,5,19
2019,201973,41,0,44,16,28
2019,201973,41,1,16,7,9
2019,201973,41,2,18,5,13
2019,201973,41,3,9,3,6
2019,201973,41,4,1,1,0
2019,201973,42,0,37,6,31
2019,201973,42,3,14,2,12
2019,201973,42,4,23,4,19
2019,201973,44,0,44,16,28
2019,201973,44,1,16,7,9
2019,201973,44,2,18,5,13
2019,201973,44,3,9,3,6
2019,201973,44,4,1,1,0
2019,201973,50,0,5,2,3
2019,202046,0,0,51,34,17
2019,202046,10,0,51,34,17
2019,202046,10,1,12,7,5
2019,202046,10,2,16,11,5
2019,202046,10,3,10,6,4
2019,202046,10,5,13,10,3
2019,202046,40,0,51,34,17
2019,202046,40,1,12,7,5
2019,202046,40,2,16,11,5
2019,202046,40,3,10,6,4
2019,202046,40,5,13,10,3
2019,202046,41,0,38,24,14
2019,202046,41,1,12,7,5
2019,202046,41,2,16,11,5
2019,202046,41,3,10,6,4
2019,202046,42,0,13,10,3
2019,202046,42,5,13,10,3
2019,202046,44,0,38,24,14
2019,202046,44,1,12,7,5
2019,202046,44,2,16,11,5
2019,202046,44,3,10,6,4
2019,202073,0,0,29,17,12
2019,202073,10,0,29,17,12
2019,202073,10,6,29,17,12
2019,202073,40,0,29,17,12
2019,202073,40,6,29,17,12
2019,202073,42,0,29,17,12
2019,202073,42,6,29,17,12
2019,202134,0,0,547,294,253
2019,202134,10,0,547,294,253
2019,202134,10,1,136,92,44
2019,202134,10,2,176,99,77
2019,202134,10,3,127,56,71
2019,202134,10,4,2,2,0
2019,202134,10,5,106,45,61
2019,202134,20,0,305,187,118
2019,202134,20,1,134,91,43
2019,202134,20,2,171,96,75
2019,202134,30,0,99,40,59
2019,202134,30,2,2,1,1
2019,202134,30,3,97,39,58
2019,202134,40,0,143,67,76
2019,202134,40,1,2,1,1
2019,202134,40,2,3,2,1
2019,202134,40,3,30,17,13
2019,202134,40,4,2,2,0
2019,202134,40,5,106,45,61
2019,202134,42,0,143,67,76
2019,202134,42,1,2,1,1
2019,202134,42,2,3,2,1
2019,202134,42,3,30,17,13
2019,202134,42,4,2,2,0
2019,202134,42,5,106,45,61
2019,202161,0,0,7,1,6
2019,202161,10,0,7,1,6
2019,202161,10,6,7,1,6
2019,202161,40,0,7,1,6
2019,202161,40,6,7,1,6
2019,202161,41,0,7,1,6
2019,202161,41,6,7,1,6
2019,202161,45,0,7,1,6
2019,202161,45,6,7,1,6
2019,202170,0,0,66,36,30
2019,202170,10,0,66,36,30
2019,202170,10,1,18,9,9
2019,202170,10,2,23,11,12
2019,202170,10,3,23,15,8
2019,202170,10,6,2,1,1
2019,202170,40,0,66,36,30
2019,202170,40,1,18,9,9
2019,202170,40,2,23,11,12
2019,202170,40,3,23,15,8
2019,202170,40,6,2,1,1
2019,202170,41,0,64,35,29
2019,202170,41,1,18,9,9
2019,202170,41,2,23,11,12
2019,202170,41,3,23,15,8
2019,202170,42,0,2,1,1
2019,202170,42,6,2,1,1
2019,202170,44,0,61,34,27
2019,202170,44,1,15,8,7
2019,202170,44,2,23,11,12
2019,202170,44,3,23,15,8
2019,202170,45,0,3,1,2
2019,202170,45,1,3,1,2
2019,202222,0,0,349,160,189
2019,202222,10,0,349,160,189
2019,202222,10,1,113,50,63
2019,202222,10,2,67,42,25
2019,202222,10,3,63,28,35
2019,202222,10,4,55,25,30
2019,202222,10,6,51,15,36
2019,202222,20,0,243,120,123
2019,202222,20,1,113,50,63
2019,202222,20,2,67,42,25
2019,202222,20,3,63,28,35
2019,202222,30,0,55,25,30
2019,202222,30,4,55,25,30
2019,202222,40,0,51,15,36
2019,202222,40,6,51,15,36
2019,202222,42,0,51,15,36
2019,202222,42,6,51,15,36
2019,202356,0,0,428,178,250
2019,202356,10,0,428,178,250
2019,202356,10,1,41,12,29
2019,202356,10,2,95,41,54
2019,202356,10,3,260,112,148
2019,202356,10,5,32,13,19
2019,202356,20,0,329,140,189
2019,202356,20,1,41,12,29
2019,202356,20,2,89,37,52
2019,202356,20,3,199,91,108
2019,202356,30,0,67,25,42
2019,202356,30,2,6,4,2
2019,202356,30,3,61,21,40
2019,202356,40,0,32,13,19
2019,202356,40,5,32,13,19
2019,202356,43,0,32,13,19
2019,202356,43,5,32,13,19
2019,202480,0,0,667,362,305
2019,202480,10,0,657,359,298
2019,202480,10,1,128,96,32
2019,202480,10,2,178,105,73
2019,202480,10,3,142,73,69
2019,202480,10,5,175,65,110
2019,202480,10,6,34,20,14
2019,202480,20,0,302,197,105
2019,202480,20,1,128,96,32
2019,202480,20,2,171,100,71
2019,202480,20,3,3,1,2
2019,202480,30,0,146,77,69
2019,202480,30,2,7,5,2
2019,202480,30,3,139,72,67
2019,202480,40,0,209,85,124
2019,202480,40,5,175,65,110
2019,202480,40,6,34,20,14
2019,202480,42,0,209,85,124
2019,202480,42,5,175,65,110
2019,202480,42,6,34,20,14
2019,202480,50,0,10,3,7
2019,202514,0,0,37,22,15
2019,202514,10,0,37,22,15
2019,202514,10,1,7,5,2
2019,202514,10,2,7,5,2
2019,202514,10,3,23,12,11
2019,202514,20,0,14,11,3
2019,202514,20,1,7,5,2
2019,202514,20,2,5,4,1
2019,202514,20,3,2,2,0
2019,202514,30,0,15,7,8
2019,202514,30,3,15,7,8
2019,202514,40,0,8,4,4
2019,202514,40,2,2,1,1
2019,202514,40,3,6,3,3
2019,202514,42,0,8,4,4
2019,202514,42,2,2,1,1
2019,202514,42,3,6,3,3
2019,202523,0,0,252,133,119
2019,202523,10,0,252,133,119
2019,202523,10,1,43,30,13
2019,202523,10,2,98,47,51
2019,202523,10,3,99,48,51
2019,202523,10,4,12,8,4
2019,202523,20,0,137,74,63
2019,202523,20,1,43,30,13
2019,202523,20,2,94,44,50
2019,202523,30,0,48,20,28
2019,202523,30,2,1,0,1
2019,202523,30,3,47,20,27
2019,202523,40,0,67,39,28
2019,202523,40,2,3,3,0
2019,202523,40,3,52,28,24
2019,202523,40,4,12,8,4
2019,202523,42,0,67,39,28
2019,202523,42,2,3,3,0
2019,202523,42,3,52,28,24
2019,202523,42,4,12,8,4
2019,202648,0,0,48,21,27
2019,202648,10,0,48,21,27
2019,202648,10,1,2,2,0
2019,202648,10,2,20,8,12
2019,202648,10,3,15,6,9
2019,202648,10,4,11,5,6
2019,202648,40,0,48,21,27
2019,202648,40,1,2,2,0
2019,202648,40,2,20,8,12
2019,202648,40,3,15,6,9
2019,202648,40,4,11,5,6
2019,202648,41,0,41,19,22
2019,202648,41,1,1,1,0
2019,202648,41,2,17,7,10
2019,202648,41,3,14,6,8
2019,202648,41,4,9,5,4
2019,202648,42,0,7,2,5
2019,202648,42,1,1,1,0
2019,202648,42,2,3,1,2
2019,202648,42,3,1,0,1
2019,202648,42,4,2,0,2
2019,202648,44,0,41,19,22
2019,202648,44,1,1,1,0
2019,202648,44,2,17,7,10
2019,202648,44,3,14,6,8
2019,202648,44,4,9,5,4
2019,202763,0,0,226,106,120
2019,202763,10,0,226,106,120
2019,202763,10,1,35,19,16
2019,202763,10,2,50,27,23
2019,202763,10,3,97,40,57
2019,202763,10,4,44,20,24
2019,202763,20,0,100,57,43
2019,202763,20,1,32,16,16
2019,202763,20,2,46,26,20
2019,202763,20,3,21,14,7
2019,202763,20,4,1,1,0
2019,202763,30,0,50,17,33
2019,202763,30,1,1,1,0
2019,202763,30,2,2,0,2
2019,202763,30,3,47,16,31
2019,202763,40,0,76,32,44
2019,202763,40,1,2,2,0
2019,202763,40,2,2,1,1
2019,202763,40,3,29,10,19
2019,202763,40,4,43,19,24
2019,202763,42,0,76,32,44
2019,202763,42,1,2,2,0
2019,202763,42,2,2,1,1
2019,202763,42,3,29,10,19
2019,202763,42,4,43,19,24
2019,202806,0,0,74,39,35
2019,202806,10,0,74,39,35
2019,202806,10,6,74,39,35
2019,202806,40,0,74,39,35
2019,202806,40,6,74,39,35
2019,202806,41,0,74,39,35
2019,202806,41,6,74,39,35
2019,202806,45,0,74,39,35
2019,202806,45,6,74,39,35
2019,202903,0,0,20,12,8
2019,202903,10,0,19,11,8
2019,202903,10,1,4,3,1
2019,202903,10,2,2,2,0
2019,202903,10,3,9,5,4
2019,202903,10,4,4,1,3
2019,202903,40,0,19,11,8
2019,202903,40,1,4,3,1
2019,202903,40,2,2,2,0
2019,202903,40,3,9,5,4
2019,202903,40,4,4,1,3
2019,202903,41,0,19,11,8
2019,202903,41,1,4,3,1
2019,202903,41,2,2,2,0
2019,202903,41,3,9,5,4
2019,202903,41,4,4,1,3
2019,202903,44,0,19,11,8
2019,202903,44,1,4,3,1
2019,202903,44,2,2,2,0
2019,202903,44,3,9,5,4
2019,202903,44,4,4,1,3
2019,202903,50,0,1,1,0
2019,202912,0,0,32,7,25
2019,202912,10,0,32,7,25
2019,202912,10,1,2,1,1
2019,202912,10,2,8,1,7
2019,202912,10,3,10,4,6
2019,202912,10,4,12,1,11
2019,202912,40,0,32,7,25
2019,202912,40,1,2,1,1
2019,202912,40,2,8,1,7
2019,202912,40,3,10,4,6
2019,202912,40,4,12,1,11
2019,202912,42,0,10,5,5
2019,202912,42,1,2,1,1
2019,202912,42,2,2,0,2
2019,202912,42,3,6,4,2
2019,202912,43,0,22,2,20
2019,202912,43,2,6,1,5
2019,202912,43,3,4,0,4
2019,202912,43,4,12,1,11
2019,203067,0,0,37,18,19
2019,203067,10,0,35,17,18
2019,203067,10,1,15,8,7
2019,203067,10,2,11,5,6
2019,203067,10,3,7,3,4
2019,203067,10,4,2,1,1
2019,203067,20,0,26,13,13
2019,203067,20,1,15,8,7
2019,203067,20,2,11,5,6
2019,203067,30,0,5,2,3
2019,203067,30,3,5,2,3
2019,203067,40,0,4,2,2
2019,203067,40,3,2,1,1
2019,203067,40,4,2,1,1
2019,203067,41,0,2,1,1
2019,203067,41,4,2,1,1
2019,203067,42,0,2,1,1
2019,203067,42,3,2,1,1
2019,203067,44,0,2,1,1
2019,203067,44,4,2,1,1
2019,203067,50,0,2,1,1
2019,203085,0,0,64,32,32
2019,203085,10,0,64,32,32
2019,203085,10,1,14,8,6
2019,203085,10,2,8,2,6
2019,203085,10,3,39,20,19
2019,203085,10,4,3,2,1
2019,203085,20,0,23,11,12
2019,203085,20,1,14,8,6
2019,203085,20,2,7,2,5
2019,203085,20,3,2,1,1
2019,203085,30,0,14,6,8
2019,203085,30,2,1,0,1
2019,203085,30,3,13,6,7
2019,203085,40,0,27,15,12
2019,203085,40,3,24,13,11
2019,203085,40,4,3,2,1
2019,203085,41,0,17,9,8
2019,203085,41,3,15,8,7
2019,203085,41,4,2,1,1
2019,203085,42,0,7,4,3
2019,203085,42,3,7,4,3
2019,203085,43,0,3,2,1
2019,203085,43,3,2,1,1
2019,203085,43,4,1,1,0
2019,203085,44,0,17,9,8
2019,203085,44,3,15,8,7
2019,203085,44,4,2,1,1
2019,203128,0,0,64,27,37
2019,203128,10,0,64,27,37
2019,203128,10,1,10,2,8
2019,203128,10,2,30,14,16
2019,203128,10,3,18,7,11
2019,203128,10,4,6,4,2
2019,203128,20,0,37,15,22
2019,203128,20,1,10,2,8
2019,203128,20,2,27,13,14
2019,203128,30,0,17,5,12
2019,203128,30,2,3,1,2
2019,203128,30,3,12,4,8
2019,203128,30,4,2,0,2
2019,203128,40,0,10,7,3
2019,203128,40,3,6,3,3
2019,203128,40,4,4,4,0
2019,203128,41,0,2,2,0
2019,203128,41,3,1,1,0
2019,203128,41,4,1,1,0
2019,203128,42,0,8,5,3
2019,203128,42,3,5,2,3
2019,203128,42,4,3,3,0
2019,203128,44,0,2,2,0
2019,203128,44,3,1,1,0
2019,203128,44,4,1,1,0
2019,203155,0,0,34,16,18
2019,203155,10,0,34,16,18
2019,203155,10,6,34,16,18
2019,203155,40,0,34,16,18
2019,203155,40,6,34,16,18
2019,203155,41,0,34,16,18
2019,203155,41,6,34,16,18
2019,203155,45,0,34,16,18
2019,203155,45,6,34,16,18
2019,203331,0,0,61,23,38
2019,203331,10,0,61,23,38
2019,203331,10,1,4,1,3
2019,203331,10,2,6,1,5
2019,203331,10,3,5,3,2
2019,203331,10,4,46,18,28
2019,203331,40,0,61,23,38
2019,203331,40,1,4,1,3
2019,203331,40,2,6,1,5
2019,203331,40,3,5,3,2
2019,203331,40,4,46,18,28
2019,203331,41,0,61,23,38
2019,203331,41,1,4,1,3
2019,203331,41,2,6,1,5
2019,203331,41,3,5,3,2
2019,203331,41,4,46,18,28
2019,203331,44,0,61,23,38
2019,203331,44,1,4,1,3
2019,203331,44,2,6,1,5
2019,203331,44,3,5,3,2
2019,203331,44,4,46,18,28
2019,203368,0,0,180,102,78
2019,203368,10,0,177,101,76
2019,203368,10,1,60,36,24
2019,203368,10,2,66,37,29
2019,203368,10,3,47,26,21
2019,203368,10,4,4,2,2
2019,203368,20,0,132,76,56
2019,203368,20,1,59,35,24
2019,203368,20,2,66,37,29
2019,203368,20,3,7,4,3
2019,203368,30,0,31,14,17
2019,203368,30,3,30,14,16
2019,203368,30,4,1,0,1
2019,203368,40,0,14,11,3
2019,203368,40,1,1,1,0
2019,203368,40,3,10,8,2
2019,203368,40,4,3,2,1
2019,203368,42,0,14,11,3
2019,203368,42,1,1,1,0
2019,203368,42,3,10,8,2
2019,203368,42,4,3,2,1
2019,203368,50,0,3,1,2
2019,203386,0,0,89,13,76
2019,203386,10,0,89,13,76
2019,203386,10,1,6,5,1
2019,203386,10,2,20,2,18
2019,203386,10,3,11,0,11
2019,203386,10,4,52,6,46
2019,203386,40,0,89,13,76
2019,203386,40,1,6,5,1
2019,203386,40,2,20,2,18
2019,203386,40,3,11,0,11
2019,203386,40,4,52,6,46
2019,203386,41,0,89,13,76
2019,203386,41,1,6,5,1
2019,203386,41,2,20,2,18
2019,203386,41,3,11,0,11
2019,203386,41,4,52,6,46
2019,203386,45,0,89,13,76
2019,203386,45,1,6,5,1
2019,203386,45,2,20,2,18
2019,203386,45,3,11,0,11
2019,203386,45,4,52,6,46
2019,203447,0,0,42,14,28
2019,203447,10,0,42,14,28
2019,203447,10,1,2,2,0
2019,203447,10,2,14,6,8
2019,203447,10,3,2,1,1
2019,203447,10,5,24,5,19
2019,203447,20,0,14,7,7
2019,203447,20,1,1,1,0
2019,203447,20,2,12,6,6
2019,203447,20,3,1,0,1
2019,203447,40,0,28,7,21
2019,203447,40,1,1,1,0
2019,203447,40,2,2,0,2
2019,203447,40,3,1,1,0
2019,203447,40,5,24,5,19
2019,203447,42,0,28,7,21
2019,203447,42,1,1,1,0
2019,203447,42,2,2,0,2
2019,203447,42,3,1,1,0
2019,203447,42,5,24,5,19
2019,203456,0,0,19,9,10
2019,203456,10,0,19,9,10
2019,203456,10,2,9,7,2
2019,203456,10,5,10,2,8
2019,203456,20,0,6,4,2
2019,203456,20,2,6,4,2
2019,203456,40,0,13,5,8
2019,203456,40,2,3,3,0
2019,203456,40,5,10,2,8
2019,203456,42,0,13,5,8
2019,203456,42,2,3,3,0
2019,203456,42,5,10,2,8
2019,203465,0,0,109,52,57
2019,203465,10,0,109,52,57
2019,203465,10,1,12,7,5
2019,203465,10,2,42,23,19
2019,203465,10,3,32,17,15
2019,203465,10,5,23,5,18
2019,203465,20,0,54,31,23
2019,203465,20,1,9,6,3
2019,203465,20,2,36,20,16
2019,203465,20,3,9,5,4
2019,203465,30,0,15,9,6
2019,203465,30,3,15,9,6
2019,203465,40,0,40,12,28
2019,203465,40,1,3,1,2
2019,203465,40,2,6,3,3
2019,203465,40,3,8,3,5
2019,203465,40,5,23,5,18
2019,203465,42,0,40,12,28
2019,203465,42,1,3,1,2
2019,203465,42,2,6,3,3
2019,203465,42,3,8,3,5
2019,203465,42,5,23,5,18
2019,203474,0,0,47,21,26
2019,203474,10,0,47,21,26
2019,203474,10,1,6,3,3
2019,203474,10,2,20,8,12
2019,203474,10,3,8,5,3
2019,203474,10,5,13,5,8
2019,203474,20,0,20,11,9
2019,203474,20,1,5,3,2
2019,203474,20,2,13,7,6
2019,203474,20,3,2,1,1
2019,203474,30,0,5,4,1
2019,203474,30,3,5,4,1
2019,203474,40,0,22,6,16
2019,203474,40,1,1,0,1
2019,203474,40,2,7,1,6
2019,203474,40,3,1,0,1
2019,203474,40,5,13,5,8
2019,203474,42,0,22,6,16
2019,203474,42,1,1,0,1
2019,203474,42,2,7,1,6
2019,203474,42,3,1,0,1
2019,203474,42,5,13,5,8
2019,203483,0,0,50,25,25
2019,203483,10,0,50,25,25
2019,203483,10,1,5,2,3
2019,203483,10,2,13,7,6
2019,203483,10,3,13,9,4
2019,203483,10,5,19,7,12
2019,203483,20,0,18,10,8
2019,203483,20,1,4,2,2
2019,203483,20,2,12,7,5
2019,203483,20,3,2,1,1
2019,203483,30,0,7,4,3
2019,203483,30,3,7,4,3
2019,203483,40,0,25,11,14
2019,203483,40,1,1,0,1
2019,203483,40,2,1,0,1
2019,203483,40,3,4,4,0
2019,203483,40,5,19,7,12
2019,203483,42,0,25,11,14
2019,203483,42,1,1,0,1
2019,203483,42,2,1,0,1
2019,203483,42,3,4,4,0
2019,203483,42,5,19,7,12
2019,203492,0,0,38,14,24
2019,203492,10,0,38,14,24
2019,203492,10,1,2,1,1
2019,203492,10,2,8,4,4
2019,203492,10,3,8,3,5
2019,203492,10,5,20,6,14
2019,203492,20,0,9,5,4
2019,203492,20,1,1,1,0
2019,203492,20,2,6,3,3
2019,203492,20,3,2,1,1
2019,203492,30,0,5,1,4
2019,203492,30,3,5,1,4
2019,203492,40,0,24,8,16
2019,203492,40,1,1,0,1
2019,203492,40,2,2,1,1
2019,203492,40,3,1,1,0
2019,203492,40,5,20,6,14
2019,203492,42,0,24,8,16
2019,203492,42,1,1,0,1
2019,203492,42,2,2,1,1
2019,203492,42,3,1,1,0
2019,203492,42,5,20,6,14
2019,203517,0,0,970,455,515
2019,203517,10,0,970,455,515
2019,203517,10,1,231,142,89
2019,203517,10,2,341,162,179
2019,203517,10,3,251,116,135
2019,203517,10,4,147,35,112
2019,203517,20,0,436,249,187
2019,203517,20,1,181,121,60
2019,203517,20,2,248,123,125
2019,203517,20,3,7,5,2
2019,203517,30,0,163,78,85
2019,203517,30,1,1,0,1
2019,203517,30,2,7,4,3
2019,203517,30,3,155,74,81
2019,203517,40,0,371,128,243
2019,203517,40,1,49,21,28
2019,203517,40,2,86,35,51
2019,203517,40,3,89,37,52
2019,203517,40,4,147,35,112
2019,203517,42,0,371,128,243
2019,203517,42,1,49,21,28
2019,203517,42,2,86,35,51
2019,203517,42,3,89,37,52
2019,203517,42,4,147,35,112
2019,203526,0,0,41,10,31
2019,203526,10,0,41,10,31
2019,203526,10,1,5,2,3
2019,203526,10,2,13,2,11
2019,203526,10,3,6,1,5
2019,203526,10,5,17,5,12
2019,203526,20,0,8,3,5
2019,203526,20,1,3,2,1
2019,203526,20,2,5,1,4
2019,203526,30,0,2,1,1
2019,203526,30,2,1,1,0
2019,203526,30,3,1,0,1
2019,203526,40,0,31,6,25
2019,203526,40,1,2,0,2
2019,203526,40,2,7,0,7
2019,203526,40,3,5,1,4
2019,203526,40,5,17,5,12
2019,203526,42,0,31,6,25
2019,203526,42,1,2,0,2
2019,203526,42,2,7,0,7
2019,203526,42,3,5,1,4
2019,203526,42,5,17,5,12
2019,203535,0,0,206,107,99
2019,203535,10,0,206,107,99
2019,203535,10,1,74,48,26
2019,203535,10,2,52,28,24
2019,203535,10,3,68,27,41
2019,203535,10,4,11,4,7
2019,203535,10,6,1,0,1
2019,203535,20,0,105,58,47
2019,203535,20,1,70,44,26
2019,203535,20,2,35,14,21
2019,203535,30,0,49,29,20
2019,203535,30,1,1,1,0
2019,203535,30,2,17,14,3
2019,203535,30,3,31,14,17
2019,203535,40,0,52,20,32
2019,203535,40,1,3,3,0
2019,203535,40,3,37,13,24
2019,203535,40,4,11,4,7
2019,203535,40,6,1,0,1
2019,203535,41,0,9,3,6
2019,203535,41,1,1,1,0
2019,203535,41,3,7,2,5
2019,203535,41,4,1,0,1
2019,203535,42,0,43,17,26
2019,203535,42,1,2,2,0
2019,203535,42,3,30,11,19
2019,203535,42,4,10,4,6
2019,203535,42,6,1,0,1
2019,203535,44,0,9,3,6
2019,203535,44,1,1,1,0
2019,203535,44,3,7,2,5
2019,203535,44,4,1,0,1
2019,203544,0,0,66,18,48
2019,203544,10,0,66,18,48
2019,203544,10,1,17,7,10
2019,203544,10,2,29,8,21
2019,203544,10,3,19,3,16
2019,203544,10,4,1,0,1
2019,203544,40,0,66,18,48
2019,203544,40,1,17,7,10
2019,203544,40,2,29,8,21
2019,203544,40,3,19,3,16
2019,203544,40,4,1,0,1
2019,203544,42,0,66,18,48
2019,203544,42,1,17,7,10
2019,203544,42,2,29,8,21
2019,203544,42,3,19,3,16
2019,203544,42,4,1,0,1
2019,203580,0,0,47,16,31
2019,203580,10,0,47,16,31
2019,203580,10,1,7,4,3
2019,203580,10,2,16,5,11
2019,203580,10,3,19,7,12
2019,203580,10,4,5,0,5
2019,203580,20,0,22,8,14
2019,203580,20,1,7,4,3
2019,203580,20,2,15,4,11
2019,203580,30,0,10,5,5
2019,203580,30,3,10,5,5
2019,203580,40,0,15,3,12
2019,203580,40,2,1,1,0
2019,203580,40,3,9,2,7
2019,203580,40,4,5,0,5
2019,203580,42,0,15,3,12
2019,203580,42,2,1,1,0
2019,203580,42,3,9,2,7
2019,203580,42,4,5,0,5
2019,203599,0,0,117,55,62
2019,203599,10,0,117,55,62
2019,203599,10,1,73,36,37
2019,203599,10,2,19,8,11
2019,203599,10,3,12,5,7
2019,203599,10,4,13,6,7
2019,203599,20,0,101,50,51
2019,203599,20,1,73,36,37
2019,203599,20,2,18,8,10
2019,203599,20,3,6,2,4
2019,203599,20,4,4,4,0
2019,203599,30,0,16,5,11
2019,203599,30,2,1,0,1
2019,203599,30,3,6,3,3
2019,203599,30,4,9,2,7
2019,203678,0,0,73,28,45
2019,203678,10,0,73,28,45
2019,203678,10,1,8,3,5
2019,203678,10,2,5,2,3
2019,203678,10,3,31,12,19
2019,203678,10,4,29,11,18
2019,203678,40,0,73,28,45
2019,203678,40,1,8,3,5
2019,203678,40,2,5,2,3
2019,203678,40,3,31,12,19
2019,203678,40,4,29,11,18
2019,203678,42,0,73,28,45
2019,203678,42,1,8,3,5
2019,203678,42,2,5,2,3
2019,203678,42,3,31,12,19
2019,203678,42,4,29,11,18
2019,203720,0,0,9,5,4
2019,203720,10,0,9,5,4
2019,203720,10,4,9,5,4
2019,203720,40,0,9,5,4
2019,203720,40,4,9,5,4
2019,203720,41,0,9,5,4
2019,203720,41,4,9,5,4
2019,203720,45,0,9,5,4
2019,203720,45,4,9,5,4
2019,203748,0,0,121,56,65
2019,203748,10,0,114,54,60
2019,203748,10,1,53,24,29
2019,203748,10,2,17,8,9
2019,203748,10,3,32,15,17
2019,203748,10,4,12,7,5
2019,203748,20,0,86,39,47
2019,203748,20,1,53,24,29
2019,203748,20,2,17,8,9
2019,203748,20,3,16,7,9
2019,203748,30,0,23,12,11
2019,203748,30,3,14,8,6
2019,203748,30,4,9,4,5
2019,203748,40,0,5,3,2
2019,203748,40,3,2,0,2
2019,203748,40,4,3,3,0
2019,203748,42,0,5,3,2
2019,203748,42,3,2,0,2
2019,203748,42,4,3,3,0
2019,203748,50,0,7,2,5
2019,203757,0,0,52,13,39
2019,203757,10,0,52,13,39
2019,203757,10,1,7,2,5
2019,203757,10,2,15,4,11
2019,203757,10,3,15,5,10
2019,203757,10,4,15,2,13
2019,203757,40,0,52,13,39
2019,203757,40,1,7,2,5
2019,203757,40,2,15,4,11
2019,203757,40,3,15,5,10
2019,203757,40,4,15,2,13
2019,203757,41,0,19,7,12
2019,203757,41,1,5,2,3
2019,203757,41,2,11,3,8
2019,203757,41,3,3,2,1
2019,203757,42,0,33,6,27
2019,203757,42,1,2,0,2
2019,203757,42,2,4,1,3
2019,203757,42,3,12,3,9
2019,203757,42,4,15,2,13
2019,203757,44,0,19,7,12
2019,203757,44,1,5,2,3
2019,203757,44,2,11,3,8
2019,203757,44,3,3,2,1
2019,203775,0,0,76,41,35
2019,203775,10,0,75,40,35
2019,203775,10,1,32,22,10
2019,203775,10,2,23,13,10
2019,203775,10,3,14,5,9
2019,203775,10,4,6,0,6
2019,203775,20,0,51,32,19
2019,203775,20,1,32,22,10
2019,203775,20,2,19,10,9
2019,203775,30,0,11,5,6
2019,203775,30,2,4,3,1
2019,203775,30,3,7,2,5
2019,203775,40,0,13,3,10
2019,203775,40,3,7,3,4
2019,203775,40,4,6,0,6
2019,203775,42,0,13,3,10
2019,203775,42,3,7,3,4
2019,203775,42,4,6,0,6
2019,203775,50,0,1,1,0
2019,203845,0,0,113,65,48
2019,203845,10,0,113,65,48
2019,203845,10,1,31,20,11
2019,203845,10,2,27,15,12
2019,203845,10,3,50,28,22
2019,203845,10,4,5,2,3
2019,203845,20,0,51,31,20
2019,203845,20,1,31,20,11
2019,203845,20,2,20,11,9
2019,203845,30,0,23,16,7
2019,203845,30,2,1,0,1
2019,203845,30,3,22,16,6
2019,203845,40,0,39,18,21
2019,203845,40,2,6,4,2
2019,203845,40,3,28,12,16
2019,203845,40,4,5,2,3
2019,203845,42,0,39,18,21
2019,203845,42,2,6,4,2
2019,203845,42,3,28,12,16
2019,203845,42,4,5,2,3
2019,203881,0,0,56,21,35
2019,203881,10,0,56,21,35
2019,203881,10,1,25,8,17
2019,203881,10,2,6,2,4
2019,203881,10,3,7,5,2
2019,203881,10,4,18,6,12
2019,203881,40,0,56,21,35
2019,203881,40,1,25,8,17
2019,203881,40,2,6,2,4
2019,203881,40,3,7,5,2
2019,203881,40,4,18,6,12
2019,203881,42,0,56,21,35
2019,203881,42,1,25,8,17
2019,203881,42,2,6,2,4
2019,203881,42,3,7,5,2
2019,203881,42,4,18,6,12
2019,203960,0,0,60,9,51
2019,203960,10,0,60,9,51
2019,203960,10,1,3,1,2
2019,203960,10,2,14,2,12
2019,203960,10,3,41,6,35
2019,203960,10,4,2,0,2
2019,203960,40,0,60,9,51
2019,203960,40,1,3,1,2
2019,203960,40,2,14,2,12
2019,203960,40,3,41,6,35
2019,203960,40,4,2,0,2
2019,203960,41,0,27,6,21
2019,203960,41,1,3,1,2
2019,203960,41,2,12,2,10
2019,203960,41,3,12,3,9
2019,203960,42,0,33,3,30
2019,203960,42,2,2,0,2
2019,203960,42,3,29,3,26
2019,203960,42,4,2,0,2
2019,203960,44,0,27,6,21
2019,203960,44,1,3,1,2
2019,203960,44,2,12,2,10
2019,203960,44,3,12,3,9
2019,203997,0,0,12,8,4
2019,203997,10,0,12,8,4
2019,203997,10,1,7,5,2
2019,203997,10,2,3,2,1
2019,203997,10,3,1,0,1
2019,203997,10,6,1,1,0
2019,203997,20,0,10,7,3
2019,203997,20,1,7,5,2
2019,203997,20,2,3,2,1
2019,203997,30,0,1,0,1
2019,203997,30,3,1,0,1
2019,203997,40,0,1,1,0
2019,203997,40,6,1,1,0
2019,203997,41,0,1,1,0
2019,203997,41,6,1,1,0
2019,203997,44,0,1,1,0
2019,203997,44,6,1,1,0
2019,204006,0,0,91,39,52
2019,204006,10,0,91,39,52
2019,204006,10,1,11,6,5
2019,204006,10,2,33,13,20
2019,204006,10,3,16,4,12
2019,204006,10,4,8,4,4
2019,204006,10,5,8,1,7
2019,204006,10,6,15,11,4
2019,204006,20,0,42,18,24
2019,204006,20,1,11,6,5
2019,204006,20,2,31,12,19
2019,204006,30,0,18,5,13
2019,204006,30,2,2,1,1
2019,204006,30,3,16,4,12
2019,204006,40,0,31,16,15
2019,204006,40,4,8,4,4
2019,204006,40,5,8,1,7
2019,204006,40,6,15,11,4
2019,204006,41,0,8,1,7
2019,204006,41,5,8,1,7
2019,204006,42,0,23,15,8
2019,204006,42,4,8,4,4
2019,204006,42,6,15,11,4
2019,204006,44,0,8,1,7
2019,204006,44,5,8,1,7
2019,204015,0,0,63,35,28
2019,204015,10,0,63,35,28
2019,204015,10,1,11,6,5
2019,204015,10,2,14,10,4
2019,204015,10,3,13,6,7
2019,204015,10,4,4,4,0
2019,204015,10,5,17,7,10
2019,204015,10,6,4,2,2
2019,204015,20,0,26,16,10
2019,204015,20,1,11,6,5
2019,204015,20,2,14,10,4
2019,204015,20,3,1,0,1
2019,204015,30,0,12,6,6
2019,204015,30,3,12,6,6
2019,204015,40,0,25,13,12
2019,204015,40,4,4,4,0
2019,204015,40,5,17,7,10
2019,204015,40,6,4,2,2
2019,204015,41,0,17,7,10
2019,204015,41,5,17,7,10
2019,204015,42,0,8,6,2
2019,204015,42,4,4,4,0
2019,204015,42,6,4,2,2
2019,204015,44,0,17,7,10
2019,204015,44,5,17,7,10
2019,204024,0,0,984,552,432
2019,204024,10,0,984,552,432
2019,204024,10,1,233,142,91
2019,204024,10,2,210,125,85
2019,204024,10,3,187,119,68
2019,204024,10,4,88,43,45
2019,204024,10,5,133,57,76
2019,204024,10,6,133,66,67
2019,204024,20,0,437,264,173
2019,204024,20,1,233,142,91
2019,204024,20,2,201,119,82
2019,204024,20,3,3,3,0
2019,204024,30,0,193,122,71
2019,204024,30,2,9,6,3
2019,204024,30,3,184,116,68
2019,204024,40,0,354,166,188
2019,204024,40,4,88,43,45
2019,204024,40,5,133,57,76
2019,204024,40,6,133,66,67
2019,204024,41,0,133,57,76
2019,204024,41,5,133,57,76
2019,204024,42,0,221,109,112
2019,204024,42,4,88,43,45
2019,204024,42,6,133,66,67
2019,204024,44,0,133,57,76
2019,204024,44,5,133,57,76
2019,204176,0,0,48,2,46
2019,204176,10,0,48,2,46
2019,204176,10,1,1,0,1
2019,204176,10,2,13,0,13
2019,204176,10,3,20,0,20
2019,204176,10,4,14,2,12
2019,204176,40,0,48,2,46
2019,204176,40,1,1,0,1
2019,204176,40,2,13,0,13
2019,204176,40,3,20,0,20
2019,204176,40,4,14,2,12
2019,204176,42,0,48,2,46
2019,204176,42,1,1,0,1
2019,204176,42,2,13,0,13
2019,204176,42,3,20,0,20
2019,204176,42,4,14,2,12
2019,204185,0,0,148,75,73
2019,204185,10,0,148,75,73
2019,204185,10,1,44,23,21
2019,204185,10,2,51,35,16
2019,204185,10,3,46,15,31
2019,204185,10,4,7,2,5
2019,204185,20,0,83,51,32
2019,204185,20,1,39,21,18
2019,204185,20,2,44,30,14
2019,204185,30,0,39,17,22
2019,204185,30,1,5,2,3
2019,204185,30,2,3,3,0
2019,204185,30,3,31,12,19
2019,204185,40,0,26,7,19
2019,204185,40,2,4,2,2
2019,204185,40,3,15,3,12
2019,204185,40,4,7,2,5
2019,204185,41,0,22,6,16
2019,204185,41,2,4,2,2
2019,204185,41,3,14,3,11
2019,204185,41,4,4,1,3
2019,204185,42,0,3,1,2
2019,204185,42,3,1,0,1
2019,204185,42,4,2,1,1
2019,204185,43,0,1,0,1
2019,204185,43,4,1,0,1
2019,204185,45,0,22,6,16
2019,204185,45,2,4,2,2
2019,204185,45,3,14,3,11
2019,204185,45,4,4,1,3
2019,204194,0,0,59,33,26
2019,204194,10,0,59,33,26
2019,204194,10,1,26,20,6
2019,204194,10,2,8,4,4
2019,204194,10,3,23,8,15
2019,204194,10,4,2,1,1
2019,204194,40,0,59,33,26
2019,204194,40,1,26,20,6
2019,204194,40,2,8,4,4
2019,204194,40,3,23,8,15
2019,204194,40,4,2,1,1
2019,204194,41,0,21,16,5
2019,204194,41,1,18,15,3
2019,204194,41,2,3,1,2
2019,204194,42,0,38,17,21
2019,204194,42,1,8,5,3
2019,204194,42,2,5,3,2
2019,204194,42,3,23,8,15
2019,204194,42,4,2,1,1
2019,204194,44,0,21,16,5
2019,204194,44,1,18,15,3
2019,204194,44,2,3,1,2
2019,204200,0,0,100,42,58
2019,204200,10,0,100,42,58
2019,204200,10,1,15,9,6
2019,204200,10,2,24,9,15
2019,204200,10,3,35,15,20
2019,204200,10,4,26,9,17
2019,204200,20,0,34,16,18
2019,204200,20,1,15,9,6
2019,204200,20,2,19,7,12
2019,204200,30,0,19,8,11
2019,204200,30,2,1,0,1
2019,204200,30,3,18,8,10
2019,204200,40,0,47,18,29
2019,204200,40,2,4,2,2
2019,204200,40,3,17,7,10
2019,204200,40,4,26,9,17
2019,204200,42,0,47,18,29
2019,204200,42,2,4,2,2
2019,204200,42,3,17,7,10
2019,204200,42,4,26,9,17
2019,204255,0,0,41,20,21
2019,204255,10,0,41,20,21
2019,204255,10,1,11,5,6
2019,204255,10,2,12,6,6
2019,204255,10,3,5,3,2
2019,204255,10,4,13,6,7
2019,204255,40,0,41,20,21
2019,204255,40,1,11,5,6
2019,204255,40,2,12,6,6
2019,204255,40,3,5,3,2
2019,204255,40,4,13,6,7
2019,204255,42,0,41,20,21
2019,204255,42,1,11,5,6
2019,204255,42,2,12,6,6
2019,204255,42,3,5,3,2
2019,204255,42,4,13,6,7
2019,204264,0,0,92,48,44
2019,204264,10,0,92,48,44
2019,204264,10,1,25,15,10
2019,204264,10,2,37,22,15
2019,204264,10,3,28,11,17
2019,204264,10,4,2,0,2
2019,204264,20,0,51,33,18
2019,204264,20,1,23,15,8
2019,204264,20,2,27,17,10
2019,204264,20,3,1,1,0
2019,204264,30,0,6,2,4
2019,204264,30,2,2,0,2
2019,204264,30,3,4,2,2
2019,204264,40,0,35,13,22
2019,204264,40,1,2,0,2
2019,204264,40,2,8,5,3
2019,204264,40,3,23,8,15
2019,204264,40,4,2,0,2
2019,204264,41,0,35,13,22
2019,204264,41,1,2,0,2
2019,204264,41,2,8,5,3
2019,204264,41,3,23,8,15
2019,204264,41,4,2,0,2
2019,204264,44,0,35,13,22
2019,204264,44,1,2,0,2
2019,204264,44,2,8,5,3
2019,204264,44,3,23,8,15
2019,204264,44,4,2,0,2
2019,204422,0,0,47,13,34
2019,204422,10,0,47,13,34
2019,204422,10,2,18,4,14
2019,204422,10,3,22,7,15
2019,204422,10,4,7,2,5
2019,204422,40,0,47,13,34
2019,204422,40,2,18,4,14
2019,204422,40,3,22,7,15
2019,204422,40,4,7,2,5
2019,204422,41,0,30,7,23
2019,204422,41,2,18,4,14
2019,204422,41,3,10,2,8
2019,204422,41,4,2,1,1
2019,204422,42,0,17,6,11
2019,204422,42,3,12,5,7
2019,204422,42,4,5,1,4
2019,204422,44,0,30,7,23
2019,204422,44,2,18,4,14
2019,204422,44,3,10,2,8
2019,204422,44,4,2,1,1
2019,204440,0,0,36,13,23
2019,204440,50,0,36,13,23
2019,204468,0,0,50,15,35
2019,204468,10,0,50,15,35
2019,204468,10,1,4,2,2
2019,204468,10,2,16,4,12
2019,204468,10,3,27,7,20
2019,204468,10,4,3,2,1
2019,204468,40,0,50,15,35
2019,204468,40,1,4,2,2
2019,204468,40,2,16,4,12
2019,204468,40,3,27,7,20
2019,204468,40,4,3,2,1
2019,204468,42,0,50,15,35
2019,204468,42,1,4,2,2
2019,204468,42,2,16,4,12
2019,204468,42,3,27,7,20
2019,204468,42,4,3,2,1
2019,204477,0,0,78,50,28
2019,204477,10,0,78,50,28
2019,204477,10,1,24,19,5
2019,204477,10,2,30,20,10
2019,204477,10,3,21,8,13
2019,204477,10,4,1,1,0
2019,204477,10,6,2,2,0
2019,204477,20,0,37,28,9
2019,204477,20,1,20,17,3
2019,204477,20,2,17,11,6
2019,204477,30,0,10,4,6
2019,204477,30,3,9,3,6
2019,204477,30,6,1,1,0
2019,204477,40,0,31,18,13
2019,204477,40,1,4,2,2
2019,204477,40,2,13,9,4
2019,204477,40,3,12,5,7
2019,204477,40,4,1,1,0
2019,204477,40,6,1,1,0
2019,204477,41,0,1,0,1
2019,204477,41,3,1,0,1
2019,204477,42,0,30,18,12
2019,204477,42,1,4,2,2
2019,204477,42,2,13,9,4
2019,204477,42,3,11,5,6
2019,204477,42,4,1,1,0
2019,204477,42,6,1,1,0
2019,204477,44,0,1,0,1
2019,204477,44,3,1,0,1
2019,204486,0,0,101,81,20
2019,204486,10,0,101,81,20
2019,204486,10,1,7,3,4
2019,204486,10,2,5,1,4
2019,204486,10,3,7,5,2
2019,204486,10,4,82,72,10
2019,204486,40,0,101,81,20
2019,204486,40,1,7,3,4
2019,204486,40,2,5,1,4
2019,204486,40,3,7,5,2
2019,204486,40,4,82,72,10
2019,204486,41,0,101,81,20
2019,204486,41,1,7,3,4
2019,204486,41,2,5,1,4
2019,204486,41,3,7,5,2
2019,204486,41,4,82,72,10
2019,204486,45,0,101,81,20
2019,204486,45,1,7,3,4
2019,204486,45,2,5,1,4
2019,204486,45,3,7,5,2
2019,204486,45,4,82,72,10
2019,204501,0,0,307,168,139
2019,204501,10,0,307,168,139
2019,204501,10,1,95,64,31
2019,204501,10,2,82,45,37
2019,204501,10,3,81,39,42
2019,204501,10,4,4,0,4
2019,204501,10,6,45,20,25
2019,204501,20,0,169,102,67
2019,204501,20,1,92,61,31
2019,204501,20,2,76,41,35
2019,204501,20,3,1,0,1
2019,204501,30,0,67,36,31
2019,204501,30,1,1,1,0
2019,204501,30,2,5,4,1
2019,204501,30,3,61,31,30
2019,204501,40,0,71,30,41
2019,204501,40,1,2,2,0
2019,204501,40,2,1,0,1
2019,204501,40,3,19,8,11
2019,204501,40,4,4,0,4
2019,204501,40,6,45,20,25
2019,204501,41,0,37,17,20
2019,204501,41,1,1,1,0
2019,204501,41,2,1,0,1
2019,204501,41,3,12,5,7
2019,204501,41,4,2,0,2
2019,204501,41,6,21,11,10
2019,204501,42,0,20,7,13
2019,204501,42,1,1,1,0
2019,204501,42,3,5,1,4
2019,204501,42,4,1,0,1
2019,204501,42,6,13,5,8
2019,204501,43,0,14,6,8
2019,204501,43,3,2,2,0
2019,204501,43,4,1,0,1
2019,204501,43,6,11,4,7
2019,204501,44,0,22,9,13
2019,204501,44,3,9,4,5
2019,204501,44,4,2,0,2
2019,204501,44,6,11,5,6
2019,204501,45,0,15,8,7
2019,204501,45,1,1,1,0
2019,204501,45,2,1,0,1
2019,204501,45,3,3,1,2
2019,204501,45,6,10,6,4
2019,204608,0,0,38,37,1
2019,204608,50,0,38,37,1
2019,204617,0,0,61,31,30
2019,204617,10,0,61,31,30
2019,204617,10,1,9,4,5
2019,204617,10,2,22,13,9
2019,204617,10,3,24,11,13
2019,204617,10,4,1,0,1
2019,204617,10,5,5,3,2
2019,204617,20,0,31,18,13
2019,204617,20,1,9,4,5
2019,204617,20,2,21,13,8
2019,204617,20,3,1,1,0
2019,204617,30,0,12,4,8
2019,204617,30,2,1,0,1
2019,204617,30,3,11,4,7
2019,204617,40,0,18,9,9
2019,204617,40,3,12,6,6
2019,204617,40,4,1,0,1
2019,204617,40,5,5,3,2
2019,204617,41,0,11,5,6
2019,204617,41,3,10,5,5
2019,204617,41,4,1,0,1
2019,204617,42,0,7,4,3
2019,204617,42,3,2,1,1
2019,204617,42,5,5,3,2
2019,204617,44,0,11,5,6
2019,204617,44,3,10,5,5
2019,204617,44,4,1,0,1
2019,204635,0,0,221,132,89
2019,204635,10,0,221,132,89
2019,204635,10,1,57,44,13
2019,204635,10,2,69,39,30
2019,204635,10,3,78,43,35
2019,204635,10,4,17,6,11
2019,204635,20,0,129,86,43
2019,204635,20,1,57,44,13
2019,204635,20,2,63,36,27
2019,204635,20,3,9,6,3
2019,204635,30,0,57,30,27
2019,204635,30,2,3,2,1
2019,204635,30,3,54,28,26
2019,204635,40,0,35,16,19
2019,204635,40,2,3,1,2
2019,204635,40,3,15,9,6
2019,204635,40,4,17,6,11
2019,204635,41,0,6,4,2
2019,204635,41,2,2,1,1
2019,204635,41,3,2,2,0
2019,204635,41,4,2,1,1
2019,204635,42,0,29,12,17
2019,204635,42,2,1,0,1
2019,204635,42,3,13,7,6
2019,204635,42,4,15,5,10
2019,204635,44,0,6,4,2
2019,204635,44,2,2,1,1
2019,204635,44,3,2,2,0
2019,204635,44,4,2,1,1
2019,204662,0,0,24,16,8
2019,204662,10,0,24,16,8
2019,204662,10,1,2,1,1
2019,204662,10,2,11,7,4
2019,204662,10,3,11,8,3
2019,204662,20,0,14,9,5
2019,204662,20,1,2,1,1
2019,204662,20,2,11,7,4
2019,204662,20,3,1,1,0
2019,204662,30,0,8,5,3
2019,204662,30,3,8,5,3
2019,204662,40,0,2,2,0
2019,204662,40,3,2,2,0
2019,204662,41,0,2,2,0
2019,204662,41,3,2,2,0
2019,204662,44,0,2,2,0
2019,204662,44,3,2,2,0
2019,204671,0,0,30,18,12
2019,204671,10,0,30,18,12
2019,204671,10,1,12,9,3
2019,204671,10,2,17,8,9
2019,204671,10,3,1,1,0
2019,204671,20,0,29,17,12
2019,204671,20,1,12,9,3
2019,204671,20,2,17,8,9
2019,204671,30,0,1,1,0
2019,204671,30,3,1,1,0
2019,204680,0,0,32,18,14
2019,204680,10,0,32,18,14
2019,204680,10,1,6,6,0
2019,204680,10,2,24,10,14
2019,204680,10,3,2,2,0
2019,204680,20,0,30,16,14
2019,204680,20,1,6,6,0
2019,204680,20,2,24,10,14
2019,204680,30,0,2,2,0
2019,204680,30,3,2,2,0
2019,204699,0,0,38,17,21
2019,204699,10,0,38,17,21
2019,204699,10,1,6,5,1
2019,204699,10,2,16,6,10
2019,204699,10,3,16,6,10
2019,204699,20,0,22,11,11
2019,204699,20,1,6,5,1
2019,204699,20,2,16,6,10
2019,204699,30,0,13,5,8
2019,204699,30,3,13,5,8
2019,204699,40,0,3,1,2
2019,204699,40,3,3,1,2
2019,204699,41,0,3,1,2
2019,204699,41,3,3,1,2
2019,204699,44,0,3,1,2
2019,204699,44,3,3,1,2
2019,204705,0,0,50,28,22
2019,204705,10,0,50,28,22
2019,204705,10,1,9,5,4
2019,204705,10,2,28,18,10
2019,204705,10,3,13,5,8
2019,204705,20,0,37,23,14
2019,204705,20,1,9,5,4
2019,204705,20,2,28,18,10
2019,204705,30,0,13,5,8
2019,204705,30,3,13,5,8
2019,204796,0,0,4292,2425,1867
2019,204796,10,0,4261,2417,1844
2019,204796,10,1,1276,900,376
2019,204796,10,2,1174,653,521
2019,204796,10,3,1796,858,938
2019,204796,10,4,15,6,9
2019,204796,20,0,1834,1195,639
2019,204796,20,1,1053,759,294
2019,204796,20,2,766,430,336
2019,204796,20,3,14,6,8
2019,204796,20,4,1,0,1
2019,204796,30,0,650,353,297
2019,204796,30,1,4,3,1
2019,204796,30,2,31,24,7
2019,204796,30,3,602,321,281
2019,204796,30,4,13,5,8
2019,204796,40,0,1777,869,908
2019,204796,40,1,219,138,81
2019,204796,40,2,377,199,178
2019,204796,40,3,1180,531,649
2019,204796,40,4,1,1,0
2019,204796,41,0,1777,869,908
2019,204796,41,1,219,138,81
2019,204796,41,2,377,199,178
2019,204796,41,3,1180,531,649
2019,204796,41,4,1,1,0
2019,204796,44,0,1777,869,908
2019,204796,44,1,219,138,81
2019,204796,44,2,377,199,178
2019,204796,44,3,1180,531,649
2019,204796,44,4,1,1,0
2019,204796,50,0,31,8,23
2019,204802,0,0,13,7,6
2019,204802,10,0,13,7,6
2019,204802,10,2,11,6,5
2019,204802,10,3,1,0,1
2019,204802,10,5,1,1,0
2019,204802,20,0,11,6,5
2019,204802,20,2,11,6,5
2019,204802,30,0,1,0,1
2019,204802,30,3,1,0,1
2019,204802,40,0,1,1,0
2019,204802,40,5,1,1,0
2019,204802,42,0,1,1,0
2019,204802,42,5,1,1,0
2019,204820,0,0,40,17,23
2019,204820,10,0,40,17,23
2019,204820,10,2,11,7,4
2019,204820,10,3,5,2,3
2019,204820,10,5,24,8,16
2019,204820,20,0,12,7,5
2019,204820,20,2,11,7,4
2019,204820,20,3,1,0,1
2019,204820,30,0,4,2,2
2019,204820,30,3,4,2,2
2019,204820,40,0,24,8,16
2019,204820,40,5,24,8,16
2019,204820,42,0,24,8,16
2019,204820,42,5,24,8,16
2019,204839,0,0,34,8,26
2019,204839,10,0,34,8,26
2019,204839,10,2,11,1,10
2019,204839,10,3,5,2,3
2019,204839,10,5,18,5,13
2019,204839,20,0,11,1,10
2019,204839,20,2,11,1,10
2019,204839,30,0,5,2,3
2019,204839,30,3,5,2,3
2019,204839,40,0,18,5,13
2019,204839,40,5,18,5,13
2019,204839,42,0,18,5,13
2019,204839,42,5,18,5,13
2019,204848,0,0,29,16,13
2019,204848,10,0,29,16,13
2019,204848,10,1,3,2,1
2019,204848,10,2,18,11,7
2019,204848,10,3,3,1,2
2019,204848,10,5,5,2,3
2019,204848,20,0,20,13,7
2019,204848,20,1,3,2,1
2019,204848,20,2,17,11,6
2019,204848,30,0,4,1,3
2019,204848,30,2,1,0,1
2019,204848,30,3,3,1,2
2019,204848,40,0,5,2,3
2019,204848,40,5,5,2,3
2019,204848,42,0,5,2,3
2019,204848,42,5,5,2,3
2019,204857,0,0,1088,616,472
2019,204857,10,0,1088,616,472
2019,204857,10,1,272,188,84
2019,204857,10,2,287,183,104
2019,204857,10,3,172,96,76
2019,204857,10,4,8,3,5
2019,204857,10,5,314,134,180
2019,204857,10,6,35,12,23
2019,204857,20,0,550,364,186
2019,204857,20,1,272,188,84
2019,204857,20,2,276,174,102
2019,204857,20,3,2,2,0
2019,204857,30,0,181,103,78
2019,204857,30,2,11,9,2
2019,204857,30,3,170,94,76
2019,204857,40,0,357,149,208
2019,204857,40,4,8,3,5
2019,204857,40,5,314,134,180
2019,204857,40,6,35,12,23
2019,204857,42,0,357,149,208
2019,204857,42,4,8,3,5
2019,204857,42,5,314,134,180
2019,204857,42,6,35,12,23
2019,204866,0,0,31,13,18
2019,204866,10,0,31,13,18
2019,204866,10,1,7,5,2
2019,204866,10,2,18,7,11
2019,204866,10,3,4,1,3
2019,204866,10,5,2,0,2
2019,204866,20,0,25,12,13
2019,204866,20,1,7,5,2
2019,204866,20,2,18,7,11
2019,204866,30,0,4,1,3
2019,204866,30,3,4,1,3
2019,204866,40,0,2,0,2
2019,204866,40,5,2,0,2
2019,204866,42,0,2,0,2
2019,204866,42,5,2,0,2
2019,204884,0,0,6,1,5
2019,204884,50,0,6,1,5
2019,204909,0,0,128,76,52
2019,204909,10,0,128,76,52
2019,204909,10,1,55,41,14
2019,204909,10,2,42,21,21
2019,204909,10,3,31,14,17
2019,204909,20,0,93,60,33
2019,204909,20,1,55,41,14
2019,204909,20,2,37,18,19
2019,204909,20,3,1,1,0
2019,204909,30,0,27,13,14
2019,204909,30,2,5,3,2
2019,204909,30,3,22,10,12
2019,204909,40,0,8,3,5
2019,204909,40,3,8,3,5
2019,204909,42,0,8,3,5
2019,204909,42,3,8,3,5
2019,204936,0,0,164,74,90
2019,204936,10,0,164,74,90
2019,204936,10,1,55,33,22
2019,204936,10,2,60,21,39
2019,204936,10,3,32,11,21
2019,204936,10,4,8,3,5
2019,204936,10,5,9,6,3
2019,204936,20,0,101,47,54
2019,204936,20,1,51,30,21
2019,204936,20,2,50,17,33
2019,204936,30,0,26,10,16
2019,204936,30,2,4,3,1
2019,204936,30,3,22,7,15
2019,204936,40,0,37,17,20
2019,204936,40,1,4,3,1
2019,204936,40,2,6,1,5
2019,204936,40,3,10,4,6
2019,204936,40,4,8,3,5
2019,204936,40,5,9,6,3
2019,204936,42,0,37,17,20
2019,204936,42,1,4,3,1
2019,204936,42,2,6,1,5
2019,204936,42,3,10,4,6
2019,204936,42,4,8,3,5
2019,204936,42,5,9,6,3
2019,204945,0,0,120,61,59
2019,204945,10,0,120,61,59
2019,204945,10,1,70,31,39
2019,204945,10,2,14,8,6
2019,204945,10,3,15,11,4
2019,204945,10,4,21,11,10
2019,204945,20,0,105,55,50
2019,204945,20,1,70,31,39
2019,204945,20,2,14,8,6
2019,204945,20,3,12,10,2
2019,204945,20,4,9,6,3
2019,204945,30,0,15,6,9
2019,204945,30,3,3,1,2
2019,204945,30,4,12,5,7
2019,204990,0,0,4,3,1
2019,204990,10,0,4,3,1
2019,204990,10,1,3,3,0
2019,204990,10,2,1,0,1
2019,204990,20,0,2,2,0
2019,204990,20,1,2,2,0
2019,204990,30,0,1,0,1
2019,204990,30,2,1,0,1
2019,204990,40,0,1,1,0
2019,204990,40,1,1,1,0
2019,204990,41,0,1,1,0
2019,204990,41,1,1,1,0
2019,204990,45,0,1,1,0
2019,204990,45,1,1,1,0
2019,205027,0,0,19,15,4
2019,205027,10,0,19,15,4
2019,205027,10,1,3,3,0
2019,205027,10,2,6,6,0
2019,205027,10,3,7,4,3
2019,205027,10,4,3,2,1
2019,205027,40,0,19,15,4
2019,205027,40,1,3,3,0
2019,205027,40,2,6,6,0
2019,205027,40,3,7,4,3
2019,205027,40,4,3,2,1
2019,205027,41,0,19,15,4
2019,205027,41,1,3,3,0
2019,205027,41,2,6,6,0
2019,205027,41,3,7,4,3
2019,205027,41,4,3,2,1
2019,205027,44,0,19,15,4
2019,205027,44,1,3,3,0
2019,205027,44,2,6,6,0
2019,205027,44,3,7,4,3
2019,205027,44,4,3,2,1
2019,205054,0,0,15,1,14
2019,205054,10,0,15,1,14
2019,205054,10,4,15,1,14
2019,205054,40,0,15,1,14
2019,205054,40,4,15,1,14
2019,205054,42,0,15,1,14
2019,205054,42,4,15,1,14
2019,205179,0,0,15,3,12
2019,205179,10,0,15,3,12
2019,205179,10,4,15,3,12
2019,205179,40,0,15,3,12
2019,205179,40,4,15,3,12
2019,205179,41,0,15,3,12
2019,205179,41,4,15,3,12
2019,205179,45,0,15,3,12
2019,205179,45,4,15,3,12
2019,205203,0,0,68,34,34
2019,205203,10,0,68,34,34
2019,205203,10,1,18,13,5
2019,205203,10,2,7,3,4
2019,205203,10,3,34,14,20
2019,205203,10,4,9,4,5
2019,205203,20,0,35,20,15
2019,205203,20,1,16,11,5
2019,205203,20,2,6,3,3
2019,205203,20,3,13,6,7
2019,205203,30,0,16,4,12
2019,205203,30,3,16,4,12
2019,205203,40,0,17,10,7
2019,205203,40,1,2,2,0
2019,205203,40,2,1,0,1
2019,205203,40,3,5,4,1
2019,205203,40,4,9,4,5
2019,205203,41,0,16,9,7
2019,205203,41,1,1,1,0
2019,205203,41,2,1,0,1
2019,205203,41,3,5,4,1
2019,205203,41,4,9,4,5
2019,205203,43,0,1,1,0
2019,205203,43,1,1,1,0
2019,205203,44,0,16,9,7
2019,205203,44,1,1,1,0
2019,205203,44,2,1,0,1
2019,205203,44,3,5,4,1
2019,205203,44,4,9,4,5
2019,205391,0,0,15,8,7
2019,205391,10,0,15,8,7
2019,205391,10,4,15,8,7
2019,205391,40,0,15,8,7
2019,205391,40,4,15,8,7
2019,205391,42,0,15,8,7
2019,205391,42,4,15,8,7
2019,205443,0,0,137,77,60
2019,205443,10,0,137,77,60
2019,205443,10,1,35,24,11
2019,205443,10,2,52,31,21
2019,205443,10,3,41,19,22
2019,205443,10,4,6,2,4
2019,205443,10,6,3,1,2
2019,205443,20,0,67,44,23
2019,205443,20,1,35,24,11
2019,205443,20,2,32,20,12
2019,205443,30,0,55,27,28
2019,205443,30,2,19,10,9
2019,205443,30,3,36,17,19
2019,205443,40,0,15,6,9
2019,205443,40,2,1,1,0
2019,205443,40,3,5,2,3
2019,205443,40,4,6,2,4
2019,205443,40,6,3,1,2
2019,205443,41,0,2,1,1
2019,205443,41,4,2,1,1
2019,205443,42,0,10,4,6
2019,205443,42,2,1,1,0
2019,205443,42,3,5,2,3
2019,205443,42,4,4,1,3
2019,205443,43,0,3,1,2
2019,205443,43,6,3,1,2
2019,205443,44,0,2,1,1
2019,205443,44,4,2,1,1
2019,205470,0,0,332,135,197
2019,205470,10,0,332,135,197
2019,205470,10,1,160,69,91
2019,205470,10,2,86,29,57
2019,205470,10,3,38,17,21
2019,205470,10,4,48,20,28
2019,205470,20,0,186,78,108
2019,205470,20,1,158,68,90
2019,205470,20,2,28,10,18
2019,205470,30,0,104,39,65
2019,205470,30,1,2,1,1
2019,205470,30,2,58,19,39
2019,205470,30,3,38,17,21
2019,205470,30,4,6,2,4
2019,205470,40,0,42,18,24
2019,205470,40,4,42,18,24
2019,205470,42,0,36,16,20
2019,205470,42,4,36,16,20
2019,205470,43,0,6,2,4
2019,205470,43,4,6,2,4
2019,205841,0,0,176,75,101
2019,205841,10,0,176,75,101
2019,205841,10,1,3,2,1
2019,205841,10,2,50,23,27
2019,205841,10,3,66,26,40
2019,205841,10,4,57,24,33
2019,205841,40,0,176,75,101
2019,205841,40,1,3,2,1
2019,205841,40,2,50,23,27
2019,205841,40,3,66,26,40
2019,205841,40,4,57,24,33
2019,205841,42,0,176,75,101
2019,205841,42,1,3,2,1
2019,205841,42,2,50,23,27
2019,205841,42,3,66,26,40
2019,205841,42,4,57,24,33
2019,205887,0,0,18,2,16
2019,205887,10,0,18,2,16
2019,205887,10,6,18,2,16
2019,205887,40,0,18,2,16
2019,205887,40,6,18,2,16
2019,205887,41,0,18,2,16
2019,205887,41,6,18,2,16
2019,205887,45,0,18,2,16
2019,205887,45,6,18,2,16
2019,205957,0,0,129,95,34
2019,205957,10,0,129,95,34
2019,205957,10,1,61,49,12
2019,205957,10,2,21,17,4
2019,205957,10,3,36,25,11
2019,205957,10,4,11,4,7
2019,205957,20,0,83,66,17
2019,205957,20,1,57,47,10
2019,205957,20,2,19,15,4
2019,205957,20,3,7,4,3
2019,205957,30,0,15,11,4
2019,205957,30,3,14,10,4
2019,205957,30,4,1,1,0
2019,205957,40,0,31,18,13
2019,205957,40,1,4,2,2
2019,205957,40,2,2,2,0
2019,205957,40,3,15,11,4
2019,205957,40,4,10,3,7
2019,205957,42,0,31,18,13
2019,205957,42,1,4,2,2
2019,205957,42,2,2,2,0
2019,205957,42,3,15,11,4
2019,205957,42,4,10,3,7
2019,205966,0,0,44,22,22
2019,205966,10,0,44,22,22
2019,205966,10,2,24,12,12
2019,205966,10,3,14,8,6
2019,205966,10,4,6,2,4
2019,205966,40,0,44,22,22
2019,205966,40,2,24,12,12
2019,205966,40,3,14,8,6
2019,205966,40,4,6,2,4
2019,205966,43,0,44,22,22
2019,205966,43,2,24,12,12
2019,205966,43,3,14,8,6
2019,205966,43,4,6,2,4
2019,206011,0,0,33,17,16
2019,206011,10,0,33,17,16
2019,206011,10,1,3,2,1
2019,206011,10,2,12,7,5
2019,206011,10,3,9,5,4
2019,206011,10,4,9,3,6
2019,206011,20,0,16,10,6
2019,206011,20,1,3,2,1
2019,206011,20,2,12,7,5
2019,206011,20,3,1,1,0
2019,206011,30,0,17,7,10
2019,206011,30,3,8,4,4
2019,206011,30,4,9,3,6
2019,206048,0,0,71,41,30
2019,206048,10,0,71,41,30
2019,206048,10,1,15,11,4
2019,206048,10,2,21,6,15
2019,206048,10,3,27,18,9
2019,206048,10,4,8,6,2
2019,206048,40,0,71,41,30
2019,206048,40,1,15,11,4
2019,206048,40,2,21,6,15
2019,206048,40,3,27,18,9
2019,206048,40,4,8,6,2
2019,206048,41,0,63,35,28
2019,206048,41,1,15,11,4
2019,206048,41,2,21,6,15
2019,206048,41,3,27,18,9
2019,206048,42,0,8,6,2
2019,206048,42,4,8,6,2
2019,206048,44,0,63,35,28
2019,206048,44,1,15,11,4
2019,206048,44,2,21,6,15
2019,206048,44,3,27,18,9
2019,206084,0,0,821,457,364
2019,206084,10,0,821,457,364
2019,206084,10,1,241,169,72
2019,206084,10,2,179,111,68
2019,206084,10,3,161,81,80
2019,206084,10,4,31,7,24
2019,206084,10,5,161,61,100
2019,206084,10,6,48,28,20
2019,206084,20,0,390,260,130
2019,206084,20,1,228,158,70
2019,206084,20,2,154,97,57
2019,206084,20,3,6,4,2
2019,206084,20,4,1,0,1
2019,206084,20,6,1,1,0
2019,206084,30,0,175,92,83
2019,206084,30,1,4,4,0
2019,206084,30,2,19,10,9
2019,206084,30,3,146,77,69
2019,206084,30,4,6,1,5
2019,206084,40,0,256,105,151
2019,206084,40,1,9,7,2
2019,206084,40,2,6,4,2
2019,206084,40,3,9,0,9
2019,206084,40,4,24,6,18
2019,206084,40,5,161,61,100
2019,206084,40,6,47,27,20
2019,206084,42,0,45,18,27
2019,206084,42,1,8,6,2
2019,206084,42,3,6,0,6
2019,206084,42,4,15,4,11
2019,206084,42,5,16,8,8
2019,206084,43,0,211,87,124
2019,206084,43,1,1,1,0
2019,206084,43,2,6,4,2
2019,206084,43,3,3,0,3
2019,206084,43,4,9,2,7
2019,206084,43,5,145,53,92
2019,206084,43,6,47,27,20
2019,206279,0,0,31,14,17
2019,206279,10,0,31,14,17
2019,206279,10,6,31,14,17
2019,206279,40,0,31,14,17
2019,206279,40,6,31,14,17
2019,206279,42,0,31,14,17
2019,206279,42,6,31,14,17
2019,206288,0,0,13,8,5
2019,206288,10,0,13,8,5
2019,206288,10,1,6,3,3
2019,206288,10,2,4,3,1
2019,206288,10,3,2,1,1
2019,206288,10,4,1,1,0
2019,206288,20,0,10,6,4
2019,206288,20,1,6,3,3
2019,206288,20,2,4,3,1
2019,206288,30,0,2,1,1
2019,206288,30,3,2,1,1
2019,206288,40,0,1,1,0
2019,206288,40,4,1,1,0
2019,206288,41,0,1,1,0
2019,206288,41,4,1,1,0
2019,206288,44,0,1,1,0
2019,206288,44,4,1,1,0
2019,206349,0,0,56,8,48
2019,206349,10,0,56,8,48
2019,206349,10,1,13,4,9
2019,206349,10,2,14,2,12
2019,206349,10,3,19,0,19
2019,206349,10,4,10,2,8
2019,206349,20,0,24,5,19
2019,206349,20,1,13,4,9
2019,206349,20,2,11,1,10
2019,206349,30,0,4,0,4
2019,206349,30,3,4,0,4
2019,206349,40,0,28,3,25
2019,206349,40,2,3,1,2
2019,206349,40,3,15,0,15
2019,206349,40,4,10,2,8
2019,206349,42,0,28,3,25
2019,206349,42,2,3,1,2
2019,206349,42,3,15,0,15
2019,206349,42,4,10,2,8
2019,206437,0,0,126,49,77
2019,206437,10,0,126,49,77
2019,206437,10,1,35,14,21
2019,206437,10,2,40,21,19
2019,206437,10,3,48,12,36
2019,206437,10,4,2,2,0
2019,206437,10,5,1,0,1
2019,206437,20,0,67,33,34
2019,206437,20,1,35,14,21
2019,206437,20,2,27,17,10
2019,206437,20,3,5,2,3
2019,206437,30,0,25,10,15
2019,206437,30,2,3,2,1
2019,206437,30,3,22,8,14
2019,206437,40,0,34,6,28
2019,206437,40,2,10,2,8
2019,206437,40,3,21,2,19
2019,206437,40,4,2,2,0
2019,206437,40,5,1,0,1
2019,206437,42,0,34,6,28
2019,206437,42,2,10,2,8
2019,206437,42,3,21,2,19
2019,206437,42,4,2,2,0
2019,206437,42,5,1,0,1
2019,206446,0,0,48,17,31
2019,206446,10,0,48,17,31
2019,206446,10,1,13,5,8
2019,206446,10,2,8,3,5
2019,206446,10,3,18,4,14
2019,206446,10,4,9,5,4
2019,206446,40,0,48,17,31
2019,206446,40,1,13,5,8
2019,206446,40,2,8,3,5
2019,206446,40,3,18,4,14
2019,206446,40,4,9,5,4
2019,206446,42,0,48,17,31
2019,206446,42,1,13,5,8
2019,206446,42,2,8,3,5
2019,206446,42,3,18,4,14
2019,206446,42,4,9,5,4
2019,206491,0,0,20,13,7
2019,206491,10,0,20,13,7
2019,206491,10,2,11,7,4
2019,206491,10,3,6,4,2
2019,206491,10,4,2,1,1
2019,206491,10,5,1,1,0
2019,206491,20,0,10,7,3
2019,206491,20,2,10,7,3
2019,206491,30,0,6,3,3
2019,206491,30,2,1,0,1
2019,206491,30,3,5,3,2
2019,206491,40,0,4,3,1
2019,206491,40,3,1,1,0
2019,206491,40,4,2,1,1
2019,206491,40,5,1,1,0
2019,206491,42,0,4,3,1
2019,206491,42,3,1,1,0
2019,206491,42,4,2,1,1
2019,206491,42,5,1,1,0
2019,206507,0,0,61,34,27
2019,206507,10,0,61,34,27
2019,206507,10,1,15,8,7
2019,206507,10,2,17,6,11
2019,206507,10,3,27,18,9
2019,206507,10,4,2,2,0
2019,206507,20,0,27,13,14
2019,206507,20,1,15,8,7
2019,206507,20,2,11,4,7
2019,206507,20,3,1,1,0
2019,206507,30,0,18,10,8
2019,206507,30,2,4,1,3
2019,206507,30,3,14,9,5
2019,206507,40,0,16,11,5
2019,206507,40,2,2,1,1
2019,206507,40,3,12,8,4
2019,206507,40,4,2,2,0
2019,206507,42,0,16,11,5
2019,206507,42,2,2,1,1
2019,206507,42,3,12,8,4
2019,206507,42,4,2,2,0
2019,206525,0,0,117,62,55
2019,206525,10,0,117,62,55
2019,206525,10,1,41,25,16
2019,206525,10,2,40,20,20
2019,206525,10,3,36,17,19
2019,206525,20,0,79,44,35
2019,206525,20,1,40,25,15
2019,206525,20,2,38,19,19
2019,206525,20,3,1,0,1
2019,206525,30,0,26,14,12
2019,206525,30,1,1,0,1
2019,206525,30,2,2,1,1
2019,206525,30,3,23,13,10
2019,206525,40,0,12,4,8
2019,206525,40,3,12,4,8
2019,206525,41,0,7,3,4
2019,206525,41,3,7,3,4
2019,206525,42,0,5,1,4
2019,206525,42,3,5,1,4
2019,206525,44,0,7,3,4
2019,206525,44,3,7,3,4
2019,206589,0,0,186,92,94
2019,206589,10,0,186,92,94
2019,206589,10,1,50,33,17
2019,206589,10,2,56,23,33
2019,206589,10,3,72,33,39
2019,206589,10,4,8,3,5
2019,206589,20,0,106,56,50
2019,206589,20,1,50,33,17
2019,206589,20,2,56,23,33
2019,206589,30,0,35,13,22
2019,206589,30,3,35,13,22
2019,206589,40,0,45,23,22
2019,206589,40,3,37,20,17
2019,206589,40,4,8,3,5
2019,206589,41,0,19,10,9
2019,206589,41,3,17,10,7
2019,206589,41,4,2,0,2
2019,206589,42,0,26,13,13
2019,206589,42,3,20,10,10
2019,206589,42,4,6,3,3
2019,206589,44,0,19,10,9
2019,206589,44,3,17,10,7
2019,206589,44,4,2,0,2
2019,206604,0,0,631,348,283
2019,206604,10,0,630,348,282
2019,206604,10,1,185,128,57
2019,206604,10,2,212,111,101
2019,206604,10,3,79,40,39
2019,206604,10,4,39,22,17
2019,206604,10,5,110,44,66
2019,206604,10,6,5,3,2
2019,206604,20,0,345,211,134
2019,206604,20,1,163,113,50
2019,206604,20,2,182,98,84
2019,206604,30,0,35,20,15
2019,206604,30,3,35,20,15
2019,206604,40,0,250,117,133
2019,206604,40,1,22,15,7
2019,206604,40,2,30,13,17
2019,206604,40,3,44,20,24
2019,206604,40,4,39,22,17
2019,206604,40,5,110,44,66
2019,206604,40,6,5,3,2
2019,206604,41,0,206,92,114
2019,206604,41,1,21,14,7
2019,206604,41,2,30,13,17
2019,206604,41,3,40,18,22
2019,206604,41,5,110,44,66
2019,206604,41,6,5,3,2
2019,206604,42,0,39,22,17
2019,206604,42,4,39,22,17
2019,206604,43,0,5,3,2
2019,206604,43,1,1,1,0
2019,206604,43,3,4,2,2
2019,206604,44,0,94,44,50
2019,206604,44,1,14,9,5
2019,206604,44,2,19,8,11
2019,206604,44,3,36,18,18
2019,206604,44,5,21,7,14
2019,206604,44,6,4,2,2
2019,206604,45,0,112,48,64
2019,206604,45,1,7,5,2
2019,206604,45,2,11,5,6
2019,206604,45,3,4,0,4
2019,206604,45,5,89,37,52
2019,206604,45,6,1,1,0
2019,206604,50,0,1,0,1
2019,206622,0,0,398,173,225
2019,206622,10,0,398,173,225
2019,206622,10,1,70,43,27
2019,206622,10,2,113,55,58
2019,206622,10,3,73,30,43
2019,206622,10,4,114,27,87
2019,206622,10,5,27,17,10
2019,206622,10,6,1,1,0
2019,206622,20,0,185,99,86
2019,206622,20,1,70,43,27
2019,206622,20,2,110,53,57
2019,206622,20,3,5,3,2
2019,206622,30,0,71,29,42
2019,206622,30,2,3,2,1
2019,206622,30,3,68,27,41
2019,206622,40,0,142,45,97
2019,206622,40,4,114,27,87
2019,206622,40,5,27,17,10
2019,206622,40,6,1,1,0
2019,206622,42,0,135,40,95
2019,206622,42,4,111,25,86
2019,206622,42,5,23,14,9
2019,206622,42,6,1,1,0
2019,206622,43,0,7,5,2
2019,206622,43,4,3,2,1
2019,206622,43,5,4,3,1
2019,206695,0,0,400,220,180
2019,206695,10,0,400,220,180
2019,206695,10,1,152,103,49
2019,206695,10,2,107,59,48
2019,206695,10,3,81,37,44
2019,206695,10,5,60,21,39
2019,206695,20,0,267,167,100
2019,206695,20,1,151,103,48
2019,206695,20,2,107,59,48
2019,206695,20,3,9,5,4
2019,206695,30,0,61,29,32
2019,206695,30,3,61,29,32
2019,206695,40,0,72,24,48
2019,206695,40,1,1,0,1
2019,206695,40,3,11,3,8
2019,206695,40,5,60,21,39
2019,206695,41,0,25,7,18
2019,206695,41,3,7,2,5
2019,206695,41,5,18,5,13
2019,206695,42,0,47,17,30
2019,206695,42,1,1,0,1
2019,206695,42,3,4,1,3
2019,206695,42,5,42,16,26
2019,206695,44,0,25,7,18
2019,206695,44,3,7,2,5
2019,206695,44,5,18,5,13
2019,206817,0,0,14,6,8
2019,206817,10,0,14,6,8
2019,206817,10,1,1,0,1
2019,206817,10,2,5,3,2
2019,206817,10,3,8,3,5
2019,206817,40,0,14,6,8
2019,206817,40,1,1,0,1
2019,206817,40,2,5,3,2
2019,206817,40,3,8,3,5
2019,206817,42,0,14,6,8
2019,206817,42,1,1,0,1
2019,206817,42,2,5,3,2
2019,206817,42,3,8,3,5
2019,206835,0,0,33,14,19
2019,206835,10,0,33,14,19
2019,206835,10,1,3,2,1
2019,206835,10,2,3,2,1
2019,206835,10,3,23,10,13
2019,206835,10,4,1,0,1
2019,206835,10,6,3,0,3
2019,206835,40,0,33,14,19
2019,206835,40,1,3,2,1
2019,206835,40,2,3,2,1
2019,206835,40,3,23,10,13
2019,206835,40,4,1,0,1
2019,206835,40,6,3,0,3
2019,206835,42,0,33,14,19
2019,206835,42,1,3,2,1
2019,206835,42,2,3,2,1
2019,206835,42,3,23,10,13
2019,206835,42,4,1,0,1
2019,206835,42,6,3,0,3
2019,206862,0,0,62,34,28
2019,206862,10,0,61,33,28
2019,206862,10,1,21,12,9
2019,206862,10,2,21,11,10
2019,206862,10,3,17,8,9
2019,206862,10,4,2,2,0
2019,206862,40,0,61,33,28
2019,206862,40,1,21,12,9
2019,206862,40,2,21,11,10
2019,206862,40,3,17,8,9
2019,206862,40,4,2,2,0
2019,206862,41,0,37,23,14
2019,206862,41,1,19,11,8
2019,206862,41,2,14,9,5
2019,206862,41,3,3,2,1
2019,206862,41,4,1,1,0
2019,206862,42,0,23,10,13
2019,206862,42,1,2,1,1
2019,206862,42,2,6,2,4
2019,206862,42,3,14,6,8
2019,206862,42,4,1,1,0
2019,206862,43,0,1,0,1
2019,206862,43,2,1,0,1
2019,206862,44,0,37,23,14
2019,206862,44,1,19,11,8
2019,206862,44,2,14,9,5
2019,206862,44,3,3,2,1
2019,206862,44,4,1,1,0
2019,206862,50,0,1,1,0
2019,206914,0,0,135,77,58
2019,206914,10,0,135,77,58
2019,206914,10,1,37,27,10
2019,206914,10,2,30,16,14
2019,206914,10,3,30,19,11
2019,206914,10,4,38,15,23
2019,206914,20,0,72,45,27
2019,206914,20,1,37,27,10
2019,206914,20,2,30,16,14
2019,206914,20,3,5,2,3
2019,206914,30,0,24,16,8
2019,206914,30,3,24,16,8
2019,206914,40,0,39,16,23
2019,206914,40,3,1,1,0
2019,206914,40,4,38,15,23
2019,206914,42,0,39,16,23
2019,206914,42,3,1,1,0
2019,206914,42,4,38,15,23
2019,206923,0,0,48,19,29
2019,206923,10,0,48,19,29
2019,206923,10,4,48,19,29
2019,206923,40,0,48,19,29
2019,206923,40,4,48,19,29
2019,206923,41,0,48,19,29
2019,206923,41,4,48,19,29
2019,206923,45,0,48,19,29
2019,206923,45,4,48,19,29
2019,206932,0,0,16,3,13
2019,206932,10,0,16,3,13
2019,206932,10,4,16,3,13
2019,206932,40,0,16,3,13
2019,206932,40,4,16,3,13
2019,206932,41,0,16,3,13
2019,206932,41,4,16,3,13
2019,206932,45,0,16,3,13
2019,206932,45,4,16,3,13
2019,206941,0,0,547,260,287
2019,206941,10,0,547,260,287
2019,206941,10,1,196,113,83
2019,206941,10,2,86,31,55
2019,206941,10,3,120,54,66
2019,206941,10,4,44,18,26
2019,206941,10,5,101,44,57
2019,206941,20,0,252,129,123
2019,206941,20,1,196,113,83
2019,206941,20,2,51,15,36
2019,206941,20,3,5,1,4
2019,206941,30,0,136,60,76
2019,206941,30,2,34,16,18
2019,206941,30,3,90,40,50
2019,206941,30,4,12,4,8
2019,206941,40,0,159,71,88
2019,206941,40,2,1,0,1
2019,206941,40,3,25,13,12
2019,206941,40,4,32,14,18
2019,206941,40,5,101,44,57
2019,206941,42,0,159,71,88
2019,206941,42,2,1,0,1
2019,206941,42,3,25,13,12
2019,206941,42,4,32,14,18
2019,206941,42,5,101,44,57
2019,206996,0,0,47,16,31
2019,206996,10,0,47,16,31
2019,206996,10,6,47,16,31
2019,206996,40,0,47,16,31
2019,206996,40,6,47,16,31
2019,206996,42,0,47,16,31
2019,206996,42,6,47,16,31
2019,207041,0,0,132,61,71
2019,207041,10,0,132,61,71
2019,207041,10,1,22,13,9
2019,207041,10,2,15,10,5
2019,207041,10,3,55,30,25
2019,207041,10,4,34,8,26
2019,207041,10,5,4,0,4
2019,207041,10,6,2,0,2
2019,207041,20,0,38,25,13
2019,207041,20,1,21,13,8
2019,207041,20,2,15,10,5
2019,207041,20,3,2,2,0
2019,207041,30,0,44,21,23
2019,207041,30,3,42,21,21
2019,207041,30,6,2,0,2
2019,207041,40,0,50,15,35
2019,207041,40,1,1,0,1
2019,207041,40,3,11,7,4
2019,207041,40,4,34,8,26
2019,207041,40,5,4,0,4
2019,207041,42,0,50,15,35
2019,207041,42,1,1,0,1
2019,207041,42,3,11,7,4
2019,207041,42,4,34,8,26
2019,207041,42,5,4,0,4
2019,207050,0,0,41,16,25
2019,207050,10,0,41,16,25
2019,207050,10,1,17,7,10
2019,207050,10,4,24,9,15
2019,207050,20,0,17,7,10
2019,207050,20,1,17,7,10
2019,207050,30,0,18,7,11
2019,207050,30,4,18,7,11
2019,207050,40,0,6,2,4
2019,207050,40,4,6,2,4
2019,207050,42,0,6,2,4
2019,207050,42,4,6,2,4
2019,207069,0,0,31,13,18
2019,207069,10,0,31,13,18
2019,207069,10,1,30,13,17
2019,207069,10,4,1,0,1
2019,207069,20,0,10,4,6
2019,207069,20,1,10,4,6
2019,207069,30,0,14,4,10
2019,207069,30,1,13,4,9
2019,207069,30,4,1,0,1
2019,207069,40,0,7,5,2
2019,207069,40,1,7,5,2
2019,207069,42,0,7,5,2
2019,207069,42,1,7,5,2
2019,207157,0,0,15,8,7
2019,207157,10,0,15,8,7
2019,207157,10,6,15,8,7
2019,207157,40,0,15,8,7
2019,207157,40,6,15,8,7
2019,207157,42,0,15,8,7
2019,207157,42,6,15,8,7
2019,207209,0,0,122,60,62
2019,207209,10,0,122,60,62
2019,207209,10,1,4,2,2
2019,207209,10,2,26,18,8
2019,207209,10,3,51,26,25
2019,207209,10,4,40,14,26
2019,207209,10,6,1,0,1
2019,207209,20,0,22,14,8
2019,207209,20,1,4,2,2
2019,207209,20,2,17,11,6
2019,207209,20,3,1,1,0
2019,207209,30,0,34,18,16
2019,207209,30,2,7,6,1
2019,207209,30,3,22,9,13
2019,207209,30,4,5,3,2
2019,207209,40,0,66,28,38
2019,207209,40,2,2,1,1
2019,207209,40,3,28,16,12
2019,207209,40,4,35,11,24
2019,207209,40,6,1,0,1
2019,207209,42,0,66,28,38
2019,207209,42,2,2,1,1
2019,207209,42,3,28,16,12
2019,207209,42,4,35,11,24
2019,207209,42,6,1,0,1
2019,207236,0,0,56,27,29
2019,207236,10,0,56,27,29
2019,207236,10,1,4,2,2
2019,207236,10,2,3,1,2
2019,207236,10,3,7,1,6
2019,207236,10,4,42,23,19
2019,207236,20,0,14,4,10
2019,207236,20,1,4,2,2
2019,207236,20,2,3,1,2
2019,207236,20,3,7,1,6
2019,207236,30,0,18,11,7
2019,207236,30,4,18,11,7
2019,207236,40,0,24,12,12
2019,207236,40,4,24,12,12
2019,207236,42,0,24,12,12
2019,207236,42,4,24,12,12
2019,207254,0,0,138,126,12
2019,207254,50,0,138,126,12
2019,207263,0,0,284,137,147
2019,207263,10,0,284,137,147
2019,207263,10,1,63,41,22
2019,207263,10,2,75,40,35
2019,207263,10,3,96,43,53
2019,207263,10,4,46,11,35
2019,207263,10,5,4,2,2
2019,207263,20,0,128,74,54
2019,207263,20,1,60,39,21
2019,207263,20,2,65,33,32
2019,207263,20,3,3,2,1
2019,207263,30,0,82,35,47
2019,207263,30,1,1,1,0
2019,207263,30,2,6,4,2
2019,207263,30,3,67,28,39
2019,207263,30,4,8,2,6
2019,207263,40,0,74,28,46
2019,207263,40,1,2,1,1
2019,207263,40,2,4,3,1
2019,207263,40,3,26,13,13
2019,207263,40,4,38,9,29
2019,207263,40,5,4,2,2
2019,207263,41,0,28,9,19
2019,207263,41,3,8,5,3
2019,207263,41,4,18,3,15
2019,207263,41,5,2,1,1
2019,207263,42,0,39,19,20
2019,207263,42,1,2,1,1
2019,207263,42,2,4,3,1
2019,207263,42,3,13,8,5
2019,207263,42,4,19,6,13
2019,207263,42,5,1,1,0
2019,207263,43,0,7,0,7
2019,207263,43,3,5,0,5
2019,207263,43,4,1,0,1
2019,207263,43,5,1,0,1
2019,207263,45,0,28,9,19
2019,207263,45,3,8,5,3
2019,207263,45,4,18,3,15
2019,207263,45,5,2,1,1
2019,207281,0,0,100,44,56
2019,207281,10,0,100,44,56
2019,207281,10,4,100,44,56
2019,207281,20,0,58,26,32
2019,207281,20,4,58,26,32
2019,207281,30,0,37,14,23
2019,207281,30,4,37,14,23
2019,207281,40,0,5,4,1
2019,207281,40,4,5,4,1
2019,207281,42,0,5,4,1
2019,207281,42,4,5,4,1
2019,207290,0,0,55,18,37
2019,207290,10,0,55,18,37
2019,207290,10,4,55,18,37
2019,207290,40,0,55,18,37
2019,207290,40,4,55,18,37
2019,207290,42,0,55,18,37
2019,207290,42,4,55,18,37
2019,207306,0,0,91,39,52
2019,207306,10,0,91,39,52
2019,207306,10,1,26,17,9
2019,207306,10,2,12,3,9
2019,207306,10,3,27,7,20
2019,207306,10,4,25,12,13
2019,207306,10,5,1,0,1
2019,207306,20,0,40,19,21
2019,207306,20,1,25,17,8
2019,207306,20,2,8,2,6
2019,207306,20,3,7,0,7
2019,207306,30,0,19,7,12
2019,207306,30,2,4,1,3
2019,207306,30,3,15,6,9
2019,207306,40,0,32,13,19
2019,207306,40,1,1,0,1
2019,207306,40,3,5,1,4
2019,207306,40,4,25,12,13
2019,207306,40,5,1,0,1
2019,207306,42,0,32,13,19
2019,207306,42,1,1,0,1
2019,207306,42,3,5,1,4
2019,207306,42,4,25,12,13
2019,207306,42,5,1,0,1
2019,207315,0,0,142,83,59
2019,207315,10,0,140,83,57
2019,207315,10,1,39,25,14
2019,207315,10,2,43,28,15
2019,207315,10,3,56,28,28
2019,207315,10,6,2,2,0
2019,207315,20,0,48,30,18
2019,207315,20,1,30,20,10
2019,207315,20,2,18,10,8
2019,207315,30,0,9,4,5
2019,207315,30,2,5,3,2
2019,207315,30,3,4,1,3
2019,207315,40,0,83,49,34
2019,207315,40,1,9,5,4
2019,207315,40,2,20,15,5
2019,207315,40,3,52,27,25
2019,207315,40,6,2,2,0
2019,207315,42,0,83,49,34
2019,207315,42,1,9,5,4
2019,207315,42,2,20,15,5
2019,207315,42,3,52,27,25
2019,207315,42,6,2,2,0
2019,207315,50,0,2,0,2
2019,207324,0,0,95,66,29
2019,207324,10,0,95,66,29
2019,207324,10,1,46,40,6
2019,207324,10,2,18,12,6
2019,207324,10,3,20,10,10
2019,207324,10,4,11,4,7
2019,207324,20,0,56,45,11
2019,207324,20,1,42,37,5
2019,207324,20,2,12,7,5
2019,207324,20,3,2,1,1
2019,207324,30,0,23,13,10
2019,207324,30,1,1,0,1
2019,207324,30,2,5,4,1
2019,207324,30,3,12,7,5
2019,207324,30,4,5,2,3
2019,207324,40,0,16,8,8
2019,207324,40,1,3,3,0
2019,207324,40,2,1,1,0
2019,207324,40,3,6,2,4
2019,207324,40,4,6,2,4
2019,207324,42,0,16,8,8
2019,207324,42,1,3,3,0
2019,207324,42,2,1,1,0
2019,207324,42,3,6,2,4
2019,207324,42,4,6,2,4
2019,207342,0,0,1223,604,619
2019,207342,10,0,1223,604,619
2019,207342,10,1,204,139,65
2019,207342,10,2,214,109,105
2019,207342,10,3,427,209,218
2019,207342,10,4,378,147,231
2019,207342,20,0,161,112,49
2019,207342,20,1,127,91,36
2019,207342,20,2,34,21,13
2019,207342,30,0,71,31,40
2019,207342,30,1,5,3,2
2019,207342,30,2,20,8,12
2019,207342,30,3,46,20,26
2019,207342,40,0,991,461,530
2019,207342,40,1,72,45,27
2019,207342,40,2,160,80,80
2019,207342,40,3,381,189,192
2019,207342,40,4,378,147,231
2019,207342,42,0,991,461,530
2019,207342,42,1,72,45,27
2019,207342,42,2,160,80,80
2019,207342,42,3,381,189,192
2019,207342,42,4,378,147,231
2019,207351,0,0,45,25,20
2019,207351,10,0,45,25,20
2019,207351,10,1,8,6,2
2019,207351,10,2,5,3,2
2019,207351,10,3,15,7,8
2019,207351,10,4,17,9,8
2019,207351,20,0,11,7,4
2019,207351,20,1,8,6,2
2019,207351,20,2,3,1,2
2019,207351,30,0,17,9,8
2019,207351,30,2,2,2,0
2019,207351,30,3,15,7,8
2019,207351,40,0,17,9,8
2019,207351,40,4,17,9,8
2019,207351,42,0,17,9,8
2019,207351,42,4,17,9,8
2019,207388,0,0,1245,740,505
2019,207388,10,0,1245,740,505
2019,207388,10,1,318,239,79
2019,207388,10,2,259,162,97
2019,207388,10,3,287,168,119
2019,207388,10,4,1,0,1
2019,207388,10,5,128,58,70
2019,207388,10,6,252,113,139
2019,207388,20,0,560,390,170
2019,207388,20,1,316,237,79
2019,207388,20,2,241,151,90
2019,207388,20,3,2,2,0
2019,207388,20,4,1,0,1
2019,207388,30,0,304,178,126
2019,207388,30,1,2,2,0
2019,207388,30,2,18,11,7
2019,207388,30,3,284,165,119
2019,207388,40,0,381,172,209
2019,207388,40,3,1,1,0
2019,207388,40,5,128,58,70
2019,207388,40,6,252,113,139
2019,207388,42,0,381,172,209
2019,207388,42,3,1,1,0
2019,207388,42,5,128,58,70
2019,207388,42,6,252,113,139
2019,207397,0,0,76,27,49
2019,207397,10,0,76,27,49
2019,207397,10,1,7,4,3
2019,207397,10,2,18,5,13
2019,207397,10,3,23,7,16
2019,207397,10,4,28,11,17
2019,207397,20,0,25,9,16
2019,207397,20,1,7,4,3
2019,207397,20,2,18,5,13
2019,207397,30,0,51,18,33
2019,207397,30,3,23,7,16
2019,207397,30,4,28,11,17
2019,207403,0,0,111,63,48
2019,207403,10,0,111,63,48
2019,207403,10,1,33,23,10
2019,207403,10,2,26,20,6
2019,207403,10,3,43,15,28
2019,207403,10,4,9,5,4
2019,207403,20,0,48,33,15
2019,207403,20,1,30,21,9
2019,207403,20,2,17,12,5
2019,207403,20,3,1,0,1
2019,207403,30,0,39,19,20
2019,207403,30,1,1,1,0
2019,207403,30,2,7,6,1
2019,207403,30,3,31,12,19
2019,207403,40,0,24,11,13
2019,207403,40,1,2,1,1
2019,207403,40,2,2,2,0
2019,207403,40,3,11,3,8
2019,207403,40,4,9,5,4
2019,207403,41,0,3,2,1
2019,207403,41,2,2,2,0
2019,207403,41,3,1,0,1
2019,207403,42,0,21,9,12
2019,207403,42,1,2,1,1
2019,207403,42,3,10,3,7
2019,207403,42,4,9,5,4
2019,207403,44,0,3,2,1
2019,207403,44,2,2,2,0
2019,207403,44,3,1,0,1
2019,207449,0,0,120,57,63
2019,207449,10,0,120,57,63
2019,207449,10,4,120,57,63
2019,207449,40,0,120,57,63
2019,207449,40,4,120,57,63
2019,207449,42,0,120,57,63
2019,207449,42,4,120,57,63
2019,207458,0,0,199,101,98
2019,207458,10,0,199,101,98
2019,207458,10,1,79,52,27
2019,207458,10,2,52,23,29
2019,207458,10,3,48,21,27
2019,207458,10,4,19,5,14
2019,207458,10,6,1,0,1
2019,207458,20,0,87,55,32
2019,207458,20,1,61,43,18
2019,207458,20,2,26,12,14
2019,207458,30,0,28,10,18
2019,207458,30,2,13,5,8
2019,207458,30,3,15,5,10
2019,207458,40,0,84,36,48
2019,207458,40,1,18,9,9
2019,207458,40,2,13,6,7
2019,207458,40,3,33,16,17
2019,207458,40,4,19,5,14
2019,207458,40,6,1,0,1
2019,207458,42,0,84,36,48
2019,207458,42,1,18,9,9
2019,207458,42,2,13,6,7
2019,207458,42,3,33,16,17
2019,207458,42,4,19,5,14
2019,207458,42,6,1,0,1
2019,207500,0,0,1299,789,510
2019,207500,10,0,1299,789,510
2019,207500,10,1,403,292,111
2019,207500,10,2,353,218,135
2019,207500,10,3,294,165,129
2019,207500,10,4,138,53,85
2019,207500,10,5,111,61,50
2019,207500,20,0,701,479,222
2019,207500,20,1,390,284,106
2019,207500,20,2,311,195,116
2019,207500,30,0,243,137,106
2019,207500,30,2,15,8,7
2019,207500,30,3,228,129,99
2019,207500,40,0,355,173,182
2019,207500,40,1,13,8,5
2019,207500,40,2,27,15,12
2019,207500,40,3,66,36,30
2019,207500,40,4,138,53,85
2019,207500,40,5,111,61,50
2019,207500,41,0,211,104,107
2019,207500,41,1,12,8,4
2019,207500,41,2,24,14,10
2019,207500,41,3,59,31,28
2019,207500,41,4,58,23,35
2019,207500,41,5,58,28,30
2019,207500,42,0,119,59,60
2019,207500,42,1,1,0,1
2019,207500,42,2,3,1,2
2019,207500,42,3,7,5,2
2019,207500,42,4,64,23,41
2019,207500,42,5,44,30,14
2019,207500,43,0,25,10,15
2019,207500,43,4,16,7,9
2019,207500,43,5,9,3,6
2019,207500,44,0,211,104,107
2019,207500,44,1,12,8,4
2019,207500,44,2,24,14,10
2019,207500,44,3,59,31,28
2019,207500,44,4,58,23,35
2019,207500,44,5,58,28,30
2019,207564,0,0,92,61,31
2019,207564,10,0,92,61,31
2019,207564,10,6,92,61,31
2019,207564,40,0,92,61,31
2019,207564,40,6,92,61,31
2019,207564,41,0,92,61,31
2019,207564,41,6,92,61,31
2019,207564,45,0,92,61,31
2019,207564,45,6,92,61,31
2019,207582,0,0,161,88,73
2019,207582,10,0,161,88,73
2019,207582,10,1,46,33,13
2019,207582,10,2,41,23,18
2019,207582,10,3,49,19,30
2019,207582,10,4,24,12,12
2019,207582,10,5,1,1,0
2019,207582,20,0,43,28,15
2019,207582,20,1,34,25,9
2019,207582,20,2,8,3,5
2019,207582,20,3,1,0,1
2019,207582,30,0,91,46,45
2019,207582,30,1,11,8,3
2019,207582,30,2,33,20,13
2019,207582,30,3,47,18,29
2019,207582,40,0,27,14,13
2019,207582,40,1,1,0,1
2019,207582,40,3,1,1,0
2019,207582,40,4,24,12,12
2019,207582,40,5,1,1,0
2019,207582,42,0,27,14,13
2019,207582,42,1,1,0,1
2019,207582,42,3,1,1,0
2019,207582,42,4,24,12,12
2019,207582,42,5,1,1,0
2019,207661,0,0,97,54,43
2019,207661,10,0,97,54,43
2019,207661,10,1,29,18,11
2019,207661,10,2,19,14,5
2019,207661,10,3,29,11,18
2019,207661,10,4,20,11,9
2019,207661,20,0,45,30,15
2019,207661,20,1,27,17,10
2019,207661,20,2,18,13,5
2019,207661,30,0,18,11,7
2019,207661,30,1,1,1,0
2019,207661,30,2,1,1,0
2019,207661,30,3,14,7,7
2019,207661,30,4,2,2,0
2019,207661,40,0,34,13,21
2019,207661,40,1,1,0,1
2019,207661,40,3,15,4,11
2019,207661,40,4,18,9,9
2019,207661,41,0,34,13,21
2019,207661,41,1,1,0,1
2019,207661,41,3,15,4,11
2019,207661,41,4,18,9,9
2019,207661,45,0,34,13,21
2019,207661,45,1,1,0,1
2019,207661,45,3,15,4,11
2019,207661,45,4,18,9,9
2019,207670,0,0,132,52,80
2019,207670,10,0,116,41,75
2019,207670,10,1,116,41,75
2019,207670,20,0,62,27,35
2019,207670,20,1,62,27,35
2019,207670,30,0,39,10,29
2019,207670,30,1,39,10,29
2019,207670,40,0,15,4,11
2019,207670,40,1,15,4,11
2019,207670,42,0,15,4,11
2019,207670,42,1,15,4,11
2019,207670,50,0,16,11,5
2019,207722,0,0,49,27,22
2019,207722,10,0,49,27,22
2019,207722,10,1,17,5,12
2019,207722,10,2,14,10,4
2019,207722,10,3,9,7,2
2019,207722,10,4,9,5,4
2019,207722,20,0,30,14,16
2019,207722,20,1,17,5,12
2019,207722,20,2,13,9,4
2019,207722,30,0,9,7,2
2019,207722,30,2,1,1,0
2019,207722,30,3,8,6,2
2019,207722,40,0,10,6,4
2019,207722,40,3,1,1,0
2019,207722,40,4,9,5,4
2019,207722,42,0,10,6,4
2019,207722,42,3,1,1,0
2019,207722,42,4,9,5,4
2019,207740,0,0,44,15,29
2019,207740,10,0,44,15,29
2019,207740,10,1,5,2,3
2019,207740,10,2,4,1,3
2019,207740,10,3,27,9,18
2019,207740,10,4,8,3,5
2019,207740,20,0,9,3,6
2019,207740,20,1,5,2,3
2019,207740,20,2,4,1,3
2019,207740,30,0,27,8,19
2019,207740,30,3,26,8,18
2019,207740,30,4,1,0,1
2019,207740,40,0,8,4,4
2019,207740,40,3,1,1,0
2019,207740,40,4,7,3,4
2019,207740,42,0,8,4,4
2019,207740,42,3,1,1,0
2019,207740,42,4,7,3,4
2019,207847,0,0,123,71,52
2019,207847,10,0,123,71,52
2019,207847,10,1,47,34,13
2019,207847,10,2,21,13,8
2019,207847,10,3,30,15,15
2019,207847,10,4,25,9,16
2019,207847,20,0,67,45,22
2019,207847,20,1,47,34,13
2019,207847,20,2,18,10,8
2019,207847,20,3,2,1,1
2019,207847,30,0,30,15,15
2019,207847,30,2,3,3,0
2019,207847,30,3,26,12,14
2019,207847,30,4,1,0,1
2019,207847,40,0,26,11,15
2019,207847,40,3,2,2,0
2019,207847,40,4,24,9,15
2019,207847,42,0,26,11,15
2019,207847,42,3,2,2,0
2019,207847,42,4,24,9,15
2019,207856,0,0,24,16,8
2019,207856,10,0,24,16,8
2019,207856,10,6,24,16,8
2019,207856,40,0,24,16,8
2019,207856,40,6,24,16,8
2019,207856,42,0,3,1,2
2019,207856,42,6,3,1,2
2019,207856,43,0,21,15,6
2019,207856,43,6,21,15,6
2019,207865,0,0,205,94,111
2019,207865,10,0,205,94,111
2019,207865,10,1,42,23,19
2019,207865,10,2,46,21,25
2019,207865,10,3,54,28,26
2019,207865,10,4,63,22,41
2019,207865,20,0,93,45,48
2019,207865,20,1,42,23,19
2019,207865,20,2,40,16,24
2019,207865,20,3,9,6,3
2019,207865,20,4,2,0,2
2019,207865,30,0,36,20,16
2019,207865,30,2,5,4,1
2019,207865,30,3,31,16,15
2019,207865,40,0,76,29,47
2019,207865,40,2,1,1,0
2019,207865,40,3,14,6,8
2019,207865,40,4,61,22,39
2019,207865,42,0,76,29,47
2019,207865,42,2,1,1,0
2019,207865,42,3,14,6,8
2019,207865,42,4,61,22,39
2019,207935,0,0,287,99,188
2019,207935,10,0,287,99,188
2019,207935,10,2,113,32,81
2019,207935,10,3,170,65,105
2019,207935,10,4,4,2,2
2019,207935,40,0,287,99,188
2019,207935,40,2,113,32,81
2019,207935,40,3,170,65,105
2019,207935,40,4,4,2,2
2019,207935,42,0,287,99,188
2019,207935,42,2,113,32,81
2019,207935,42,3,170,65,105
2019,207935,42,4,4,2,2
2019,207962,0,0,19,19,0
2019,207962,10,0,19,19,0
2019,207962,10,4,19,19,0
2019,207962,40,0,19,19,0
2019,207962,40,4,19,19,0
2019,207962,41,0,19,19,0
2019,207962,41,4,19,19,0
2019,207962,45,0,19,19,0
2019,207962,45,4,19,19,0
2019,207971,0,0,341,217,124
2019,207971,10,0,341,217,124
2019,207971,10,1,116,90,26
2019,207971,10,2,99,73,26
2019,207971,10,3,105,45,60
2019,207971,10,4,21,9,12
2019,207971,20,0,183,149,34
2019,207971,20,1,103,86,17
2019,207971,20,2,80,63,17
2019,207971,30,0,54,26,28
2019,207971,30,2,3,3,0
2019,207971,30,3,51,23,28
2019,207971,40,0,104,42,62
2019,207971,40,1,13,4,9
2019,207971,40,2,16,7,9
2019,207971,40,3,54,22,32
2019,207971,40,4,21,9,12
2019,207971,41,0,76,31,45
2019,207971,41,1,11,4,7
2019,207971,41,2,15,6,9
2019,207971,41,3,34,15,19
2019,207971,41,4,16,6,10
2019,207971,42,0,28,11,17
2019,207971,42,1,2,0,2
2019,207971,42,2,1,1,0
2019,207971,42,3,20,7,13
2019,207971,42,4,5,3,2
2019,207971,44,0,76,31,45
2019,207971,44,1,11,4,7
2019,207971,44,2,15,6,9
2019,207971,44,3,34,15,19
2019,207971,44,4,16,6,10
2019,208035,0,0,25,4,21
2019,208035,10,0,25,4,21
2019,208035,10,4,25,4,21
2019,208035,20,0,8,1,7
2019,208035,20,4,8,1,7
2019,208035,30,0,17,3,14
2019,208035,30,4,17,3,14
2019,208275,0,0,55,24,31
2019,208275,10,0,55,24,31
2019,208275,10,4,55,24,31
2019,208275,20,0,44,18,26
2019,208275,20,4,44,18,26
2019,208275,30,0,11,6,5
2019,208275,30,4,11,6,5
2019,208318,0,0,128,61,67
2019,208318,10,0,128,61,67
2019,208318,10,1,37,19,18
2019,208318,10,2,23,15,8
2019,208318,10,3,62,23,39
2019,208318,10,4,6,4,2
2019,208318,20,0,73,40,33
2019,208318,20,1,37,19,18
2019,208318,20,2,21,14,7
2019,208318,20,3,15,7,8
2019,208318,30,0,49,17,32
2019,208318,30,2,2,1,1
2019,208318,30,3,47,16,31
2019,208318,40,0,6,4,2
2019,208318,40,4,6,4,2
2019,208318,42,0,6,4,2
2019,208318,42,4,6,4,2
2019,208390,0,0,192,91,101
2019,208390,10,0,192,91,101
2019,208390,10,4,192,91,101
2019,208390,40,0,192,91,101
2019,208390,40,4,192,91,101
2019,208390,42,0,192,91,101
2019,208390,42,4,192,91,101
2019,208406,0,0,134,70,64
2019,208406,10,0,134,70,64
2019,208406,10,4,134,70,64
2019,208406,40,0,134,70,64
2019,208406,40,4,134,70,64
2019,208406,42,0,134,70,64
2019,208406,42,4,134,70,64
2019,208415,0,0,28,16,12
2019,208415,10,0,28,16,12
2019,208415,10,4,28,16,12
2019,208415,40,0,28,16,12
2019,208415,40,4,28,16,12
2019,208415,42,0,28,16,12
2019,208415,42,4,28,16,12
2019,208479,0,0,16,4,12
2019,208479,10,0,16,4,12
2019,208479,10,4,16,4,12
2019,208479,40,0,16,4,12
2019,208479,40,4,16,4,12
2019,208479,41,0,16,4,12
2019,208479,41,4,16,4,12
2019,208479,45,0,16,4,12
2019,208479,45,4,16,4,12
2019,208488,0,0,74,35,39
2019,208488,10,0,74,35,39
2019,208488,10,1,24,15,9
2019,208488,10,2,24,12,12
2019,208488,10,3,18,7,11
2019,208488,10,6,8,1,7
2019,208488,20,0,4,3,1
2019,208488,20,1,1,1,0
2019,208488,20,2,3,2,1
2019,208488,30,0,5,2,3
2019,208488,30,2,2,1,1
2019,208488,30,3,3,1,2
2019,208488,40,0,65,30,35
2019,208488,40,1,23,14,9
2019,208488,40,2,19,9,10
2019,208488,40,3,15,6,9
2019,208488,40,6,8,1,7
2019,208488,41,0,54,25,29
2019,208488,41,1,22,13,9
2019,208488,41,2,18,9,9
2019,208488,41,3,9,3,6
2019,208488,41,6,5,0,5
2019,208488,42,0,10,5,5
2019,208488,42,1,1,1,0
2019,208488,42,2,1,0,1
2019,208488,42,3,5,3,2
2019,208488,42,6,3,1,2
2019,208488,43,0,1,0,1
2019,208488,43,3,1,0,1
2019,208488,44,0,54,25,29
2019,208488,44,1,22,13,9
2019,208488,44,2,18,9,9
2019,208488,44,3,9,3,6
2019,208488,44,6,5,0,5
2019,208512,0,0,14,3,11
2019,208512,10,0,14,3,11
2019,208512,10,4,14,3,11
2019,208512,40,0,14,3,11
2019,208512,40,4,14,3,11
2019,208512,43,0,14,3,11
2019,208512,43,4,14,3,11
2019,208646,0,0,102,58,44
2019,208646,10,0,102,58,44
2019,208646,10,1,25,15,10
2019,208646,10,2,40,24,16
2019,208646,10,3,20,12,8
2019,208646,10,4,17,7,10
2019,208646,20,0,58,32,26
2019,208646,20,1,22,12,10
2019,208646,20,2,35,20,15
2019,208646,20,3,1,0,1
2019,208646,30,0,15,10,5
2019,208646,30,2,4,3,1
2019,208646,30,3,11,7,4
2019,208646,40,0,29,16,13
2019,208646,40,1,3,3,0
2019,208646,40,2,1,1,0
2019,208646,40,3,8,5,3
2019,208646,40,4,17,7,10
2019,208646,42,0,29,16,13
2019,208646,42,1,3,3,0
2019,208646,42,2,1,1,0
2019,208646,42,3,8,5,3
2019,208646,42,4,17,7,10
2019,208725,0,0,8,7,1
2019,208725,10,0,7,6,1
2019,208725,10,4,7,6,1
2019,208725,40,0,7,6,1
2019,208725,40,4,7,6,1
2019,208725,41,0,7,6,1
2019,208725,41,4,7,6,1
2019,208725,45,0,7,6,1
2019,208725,45,4,7,6,1
2019,208725,50,0,1,1,0
2019,208822,0,0,204,108,96
2019,208822,10,0,204,108,96
2019,208822,10,1,66,43,23
2019,208822,10,2,57,34,23
2019,208822,10,3,76,30,46
2019,208822,10,5,1,0,1
2019,208822,10,6,4,1,3
2019,208822,20,0,79,52,27
2019,208822,20,1,58,38,20
2019,208822,20,2,21,14,7
2019,208822,30,0,85,40,45
2019,208822,30,1,8,5,3
2019,208822,30,2,18,10,8
2019,208822,30,3,59,25,34
2019,208822,40,0,40,16,24
2019,208822,40,2,18,10,8
2019,208822,40,3,17,5,12
2019,208822,40,5,1,0,1
2019,208822,40,6,4,1,3
2019,208822,42,0,36,15,21
2019,208822,42,2,18,10,8
2019,208822,42,3,17,5,12
2019,208822,42,5,1,0,1
2019,208822,43,0,4,1,3
2019,208822,43,6,4,1,3
2019,209038,0,0,190,78,112
2019,209038,10,0,190,78,112
2019,209038,10,6,190,78,112
2019,209038,40,0,190,78,112
2019,209038,40,6,190,78,112
2019,209038,42,0,190,78,112
2019,209038,42,6,190,78,112
2019,209056,0,0,216,98,118
2019,209056,10,0,216,98,118
2019,209056,10,1,62,39,23
2019,209056,10,2,86,38,48
2019,209056,10,3,48,14,34
2019,209056,10,4,16,6,10
2019,209056,10,5,2,1,1
2019,209056,10,6,2,0,2
2019,209056,20,0,133,72,61
2019,209056,20,1,53,37,16
2019,209056,20,2,80,35,45
2019,209056,30,0,27,8,19
2019,209056,30,2,2,0,2
2019,209056,30,3,25,8,17
2019,209056,40,0,56,18,38
2019,209056,40,1,9,2,7
2019,209056,40,2,4,3,1
2019,209056,40,3,23,6,17
2019,209056,40,4,16,6,10
2019,209056,40,5,2,1,1
2019,209056,40,6,2,0,2
2019,209056,41,0,7,2,5
2019,209056,41,1,7,2,5
2019,209056,42,0,49,16,33
2019,209056,42,1,2,0,2
2019,209056,42,2,4,3,1
2019,209056,42,3,23,6,17
2019,209056,42,4,16,6,10
2019,209056,42,5,2,1,1
2019,209056,42,6,2,0,2
2019,209056,45,0,7,2,5
2019,209056,45,1,7,2,5
2019,209065,0,0,132,50,82
2019,209065,10,0,132,50,82
2019,209065,10,1,44,22,22
2019,209065,10,2,41,14,27
2019,209065,10,3,47,14,33
2019,209065,20,0,80,35,45
2019,209065,20,1,43,22,21
2019,209065,20,2,35,12,23
2019,209065,20,3,2,1,1
2019,209065,30,0,29,9,20
2019,209065,30,2,2,1,1
2019,209065,30,3,27,8,19
2019,209065,40,0,23,6,17
2019,209065,40,1,1,0,1
2019,209065,40,2,4,1,3
2019,209065,40,3,18,5,13
2019,209065,42,0,23,6,17
2019,209065,42,1,1,0,1
2019,209065,42,2,4,1,3
2019,209065,42,3,18,5,13
2019,209074,0,0,130,68,62
2019,209074,10,0,130,68,62
2019,209074,10,6,130,68,62
2019,209074,40,0,130,68,62
2019,209074,40,6,130,68,62
2019,209074,42,0,130,68,62
2019,209074,42,6,130,68,62
2019,209241,0,0,13,9,4
2019,209241,10,0,13,9,4
2019,209241,10,1,6,5,1
2019,209241,10,2,7,4,3
2019,209241,40,0,13,9,4
2019,209241,40,1,6,5,1
2019,209241,40,2,7,4,3
2019,209241,42,0,13,9,4
2019,209241,42,1,6,5,1
2019,209241,42,2,7,4,3
2019,209250,0,0,154,69,85
2019,209250,10,0,154,69,85
2019,209250,10,4,154,69,85
2019,209250,20,0,116,59,57
2019,209250,20,4,116,59,57
2019,209250,30,0,37,10,27
2019,209250,30,4,37,10,27
2019,209250,40,0,1,0,1
2019,209250,40,4,1,0,1
2019,209250,42,0,1,0,1
2019,209250,42,4,1,0,1
2019,209287,0,0,27,18,9
2019,209287,10,0,27,18,9
2019,209287,10,1,9,8,1
2019,209287,10,2,8,5,3
2019,209287,10,3,10,5,5
2019,209287,20,0,4,3,1
2019,209287,20,1,4,3,1
2019,209287,40,0,23,15,8
2019,209287,40,1,5,5,0
2019,209287,40,2,8,5,3
2019,209287,40,3,10,5,5
2019,209287,41,0,21,15,6
2019,209287,41,1,5,5,0
2019,209287,41,2,8,5,3
2019,209287,41,3,8,5,3
2019,209287,42,0,2,0,2
2019,209287,42,3,2,0,2
2019,209287,45,0,21,15,6
2019,209287,45,1,5,5,0
2019,209287,45,2,8,5,3
2019,209287,45,3,8,5,3
2019,209296,0,0,29,14,15
2019,209296,10,0,29,14,15
2019,209296,10,1,4,2,2
2019,209296,10,2,3,2,1
2019,209296,10,3,22,10,12
2019,209296,40,0,29,14,15
2019,209296,40,1,4,2,2
2019,209296,40,2,3,2,1
2019,209296,40,3,22,10,12
2019,209296,42,0,29,14,15
2019,209296,42,1,4,2,2
2019,209296,42,2,3,2,1
2019,209296,42,3,22,10,12
2019,209409,0,0,28,17,11
2019,209409,10,0,28,17,11
2019,209409,10,1,7,4,3
2019,209409,10,2,9,6,3
2019,209409,10,3,8,5,3
2019,209409,10,4,4,2,2
2019,209409,40,0,28,17,11
2019,209409,40,1,7,4,3
2019,209409,40,2,9,6,3
2019,209409,40,3,8,5,3
2019,209409,40,4,4,2,2
2019,209409,42,0,28,17,11
2019,209409,42,1,7,4,3
2019,209409,42,2,9,6,3
2019,209409,42,3,8,5,3
2019,209409,42,4,4,2,2
2019,209490,0,0,1695,737,958
2019,209490,10,0,1695,737,958
2019,209490,10,1,232,150,82
2019,209490,10,2,321,168,153
2019,209490,10,3,687,302,385
2019,209490,10,4,447,117,330
2019,209490,10,5,8,0,8
2019,209490,20,0,84,51,33
2019,209490,20,1,66,43,23
2019,209490,20,2,18,8,10
2019,209490,30,0,48,33,15
2019,209490,30,1,6,4,2
2019,209490,30,2,20,13,7
2019,209490,30,3,22,16,6
2019,209490,40,0,1563,653,910
2019,209490,40,1,160,103,57
2019,209490,40,2,283,147,136
2019,209490,40,3,665,286,379
2019,209490,40,4,447,117,330
2019,209490,40,5,8,0,8
2019,209490,41,0,25,11,14
2019,209490,41,1,7,4,3
2019,209490,41,2,6,2,4
2019,209490,41,3,12,5,7
2019,209490,42,0,1511,640,871
2019,209490,42,1,153,99,54
2019,209490,42,2,277,145,132
2019,209490,42,3,640,280,360
2019,209490,42,4,440,116,324
2019,209490,42,5,1,0,1
2019,209490,43,0,27,2,25
2019,209490,43,3,13,1,12
2019,209490,43,4,7,1,6
2019,209490,43,5,7,0,7
2019,209490,44,0,25,11,14
2019,209490,44,1,7,4,3
2019,209490,44,2,6,2,4
2019,209490,44,3,12,5,7
2019,209506,0,0,164,101,63
2019,209506,10,0,164,101,63
2019,209506,10,1,41,27,14
2019,209506,10,2,56,39,17
2019,209506,10,3,45,25,20
2019,209506,10,4,22,10,12
2019,209506,20,0,80,56,24
2019,209506,20,1,41,27,14
2019,209506,20,2,35,25,10
2019,209506,20,3,4,4,0
2019,209506,30,0,59,32,27
2019,209506,30,2,19,13,6
2019,209506,30,3,37,18,19
2019,209506,30,4,3,1,2
2019,209506,40,0,25,13,12
2019,209506,40,2,2,1,1
2019,209506,40,3,4,3,1
2019,209506,40,4,19,9,10
2019,209506,42,0,25,13,12
2019,209506,42,2,2,1,1
2019,209506,42,3,4,3,1
2019,209506,42,4,19,9,10
2019,209542,0,0,1391,806,585
2019,209542,10,0,1391,806,585
2019,209542,10,1,356,261,95
2019,209542,10,2,302,180,122
2019,209542,10,3,267,146,121
2019,209542,10,4,466,219,247
2019,209542,20,0,627,431,196
2019,209542,20,1,354,260,94
2019,209542,20,2,269,169,100
2019,209542,20,3,1,1,0
2019,209542,20,4,3,1,2
2019,209542,30,0,244,134,110
2019,209542,30,2,16,6,10
2019,209542,30,3,228,128,100
2019,209542,40,0,520,241,279
2019,209542,40,1,2,1,1
2019,209542,40,2,17,5,12
2019,209542,40,3,38,17,21
2019,209542,40,4,463,218,245
2019,209542,42,0,520,241,279
2019,209542,42,1,2,1,1
2019,209542,42,2,17,5,12
2019,209542,42,3,38,17,21
2019,209542,42,4,463,218,245
2019,209551,0,0,1152,638,514
2019,209551,10,0,1152,638,514
2019,209551,10,1,297,201,96
2019,209551,10,2,292,168,124
2019,209551,10,3,227,119,108
2019,209551,10,4,313,145,168
2019,209551,10,5,23,5,18
2019,209551,20,0,571,355,216
2019,209551,20,1,283,190,93
2019,209551,20,2,283,164,119
2019,209551,20,4,5,1,4
2019,209551,30,0,225,119,106
2019,209551,30,1,1,1,0
2019,209551,30,2,8,4,4
2019,209551,30,3,216,114,102
2019,209551,40,0,356,164,192
2019,209551,40,1,13,10,3
2019,209551,40,2,1,0,1
2019,209551,40,3,11,5,6
2019,209551,40,4,308,144,164
2019,209551,40,5,23,5,18
2019,209551,41,0,231,101,130
2019,209551,41,1,11,9,2
2019,209551,41,3,1,1,0
2019,209551,41,4,199,88,111
2019,209551,41,5,20,3,17
2019,209551,42,0,110,56,54
2019,209551,42,1,2,1,1
2019,209551,42,2,1,0,1
2019,209551,42,3,10,4,6
2019,209551,42,4,94,49,45
2019,209551,42,5,3,2,1
2019,209551,43,0,15,7,8
2019,209551,43,4,15,7,8
2019,209551,44,0,231,101,130
2019,209551,44,1,11,9,2
2019,209551,44,3,1,1,0
2019,209551,44,4,199,88,111
2019,209551,44,5,20,3,17
2019,209603,0,0,25,9,16
2019,209603,10,0,25,9,16
2019,209603,10,1,3,2,1
2019,209603,10,2,18,6,12
2019,209603,10,3,4,1,3
2019,209603,40,0,25,9,16
2019,209603,40,1,3,2,1
2019,209603,40,2,18,6,12
2019,209603,40,3,4,1,3
2019,209603,42,0,25,9,16
2019,209603,42,1,3,2,1
2019,209603,42,2,18,6,12
2019,209603,42,3,4,1,3
2019,209612,0,0,291,132,159
2019,209612,10,0,289,132,157
2019,209612,10,1,73,45,28
2019,209612,10,2,82,40,42
2019,209612,10,3,117,41,76
2019,209612,10,4,16,5,11
2019,209612,10,6,1,1,0
2019,209612,20,0,129,72,57
2019,209612,20,1,69,42,27
2019,209612,20,2,59,29,30
2019,209612,20,3,1,1,0
2019,209612,30,0,60,23,37
2019,209612,30,1,1,1,0
2019,209612,30,2,9,3,6
2019,209612,30,3,50,19,31
2019,209612,40,0,100,37,63
2019,209612,40,1,3,2,1
2019,209612,40,2,14,8,6
2019,209612,40,3,66,21,45
2019,209612,40,4,16,5,11
2019,209612,40,6,1,1,0
2019,209612,41,0,36,15,21
2019,209612,41,1,3,2,1
2019,209612,41,2,14,8,6
2019,209612,41,3,14,3,11
2019,209612,41,4,5,2,3
2019,209612,42,0,64,22,42
2019,209612,42,3,52,18,34
2019,209612,42,4,11,3,8
2019,209612,42,6,1,1,0
2019,209612,44,0,36,15,21
2019,209612,44,1,3,2,1
2019,209612,44,2,14,8,6
2019,209612,44,3,14,3,11
2019,209612,44,4,5,2,3
2019,209612,50,0,2,0,2
2019,209746,0,0,401,190,211
2019,209746,10,0,401,190,211
2019,209746,10,4,401,190,211
2019,209746,20,0,300,138,162
2019,209746,20,4,300,138,162
2019,209746,30,0,82,45,37
2019,209746,30,4,82,45,37
2019,209746,40,0,19,7,12
2019,209746,40,4,19,7,12
2019,209746,42,0,19,7,12
2019,209746,42,4,19,7,12
2019,209807,0,0,764,385,379
2019,209807,10,0,764,385,379
2019,209807,10,1,209,141,68
2019,209807,10,2,202,111,91
2019,209807,10,3,198,75,123
2019,209807,10,4,154,57,97
2019,209807,10,6,1,1,0
2019,209807,20,0,379,231,148
2019,209807,20,1,195,133,62
2019,209807,20,2,183,97,86
2019,209807,20,3,1,1,0
2019,209807,30,0,125,50,75
2019,209807,30,1,2,1,1
2019,209807,30,2,2,2,0
2019,209807,30,3,121,47,74
2019,209807,40,0,260,104,156
2019,209807,40,1,12,7,5
2019,209807,40,2,17,12,5
2019,209807,40,3,76,27,49
2019,209807,40,4,154,57,97
2019,209807,40,6,1,1,0
2019,209807,41,0,194,80,114
2019,209807,41,1,11,7,4
2019,209807,41,2,15,10,5
2019,209807,41,3,61,26,35
2019,209807,41,4,106,36,70
2019,209807,41,6,1,1,0
2019,209807,42,0,63,24,39
2019,209807,42,1,1,0,1
2019,209807,42,2,2,2,0
2019,209807,42,3,12,1,11
2019,209807,42,4,48,21,27
2019,209807,43,0,3,0,3
2019,209807,43,3,3,0,3
2019,209807,44,0,54,28,26
2019,209807,44,1,4,4,0
2019,209807,44,2,2,2,0
2019,209807,44,3,17,8,9
2019,209807,44,4,31,14,17
2019,209807,45,0,140,52,88
2019,209807,45,1,7,3,4
2019,209807,45,2,13,8,5
2019,209807,45,3,44,18,26
2019,209807,45,4,75,22,53
2019,209807,45,6,1,1,0
2019,209825,0,0,276,122,154
2019,209825,10,0,276,122,154
2019,209825,10,1,50,35,15
2019,209825,10,2,83,42,41
2019,209825,10,3,64,24,40
2019,209825,10,4,53,13,40
2019,209825,10,5,14,3,11
2019,209825,10,6,12,5,7
2019,209825,20,0,128,75,53
2019,209825,20,1,49,35,14
2019,209825,20,2,78,40,38
2019,209825,20,3,1,0,1
2019,209825,30,0,66,25,41
2019,209825,30,2,4,1,3
2019,209825,30,3,62,24,38
2019,209825,40,0,82,22,60
2019,209825,40,1,1,0,1
2019,209825,40,2,1,1,0
2019,209825,40,3,1,0,1
2019,209825,40,4,53,13,40
2019,209825,40,5,14,3,11
2019,209825,40,6,12,5,7
2019,209825,42,0,69,18,51
2019,209825,42,1,1,0,1
2019,209825,42,2,1,1,0
2019,209825,42,3,1,0,1
2019,209825,42,4,43,10,33
2019,209825,42,5,12,3,9
2019,209825,42,6,11,4,7
2019,209825,43,0,13,4,9
2019,209825,43,4,10,3,7
2019,209825,43,5,2,0,2
2019,209825,43,6,1,1,0
2019,209922,0,0,175,97,78
2019,209922,10,0,175,97,78
2019,209922,10,1,64,39,25
2019,209922,10,2,33,19,14
2019,209922,10,3,35,16,19
2019,209922,10,6,43,23,20
2019,209922,20,0,117,69,48
2019,209922,20,1,64,39,25
2019,209922,20,2,31,19,12
2019,209922,20,3,22,11,11
2019,209922,30,0,30,13,17
2019,209922,30,2,2,0,2
2019,209922,30,3,10,4,6
2019,209922,30,6,18,9,9
2019,209922,40,0,28,15,13
2019,209922,40,3,3,1,2
2019,209922,40,6,25,14,11
2019,209922,41,0,10,3,7
2019,209922,41,6,10,3,7
2019,209922,42,0,18,12,6
2019,209922,42,3,3,1,2
2019,209922,42,6,15,11,4
2019,209922,44,0,10,3,7
2019,209922,44,6,10,3,7
2019,209940,0,0,70,32,38
2019,209940,10,0,70,32,38
2019,209940,10,4,70,32,38
2019,209940,20,0,51,24,27
2019,209940,20,4,51,24,27
2019,209940,30,0,13,4,9
2019,209940,30,4,13,4,9
2019,209940,40,0,6,4,2
2019,209940,40,4,6,4,2
2019,209940,42,0,4,2,2
2019,209940,42,4,4,2,2
2019,209940,43,0,2,2,0
2019,209940,43,4,2,2,0
2019,210076,0,0,46,14,32
2019,210076,10,0,46,14,32
2019,210076,10,4,46,14,32
2019,210076,40,0,46,14,32
2019,210076,40,4,46,14,32
2019,210076,41,0,46,14,32
2019,210076,41,4,46,14,32
2019,210076,45,0,46,14,32
2019,210076,45,4,46,14,32
2019,210146,0,0,145,78,67
2019,210146,10,0,145,78,67
2019,210146,10,1,65,42,23
2019,210146,10,2,26,12,14
2019,210146,10,3,36,14,22
2019,210146,10,4,18,10,8
2019,210146,20,0,89,53,36
2019,210146,20,1,65,42,23
2019,210146,20,2,23,10,13
2019,210146,20,3,1,1,0
2019,210146,30,0,36,14,22
2019,210146,30,2,3,2,1
2019,210146,30,3,33,12,21
2019,210146,40,0,20,11,9
2019,210146,40,3,2,1,1
2019,210146,40,4,18,10,8
2019,210146,41,0,14,8,6
2019,210146,41,4,14,8,6
2019,210146,42,0,6,3,3
2019,210146,42,3,2,1,1
2019,210146,42,4,4,2,2
2019,210146,44,0,14,8,6
2019,210146,44,4,14,8,6
2019,210155,0,0,51,29,22
2019,210155,10,0,51,29,22
2019,210155,10,1,19,14,5
2019,210155,10,2,14,9,5
2019,210155,10,3,17,6,11
2019,210155,10,5,1,0,1
2019,210155,20,0,33,23,10
2019,210155,20,1,19,14,5
2019,210155,20,2,14,9,5
2019,210155,30,0,17,6,11
2019,210155,30,3,17,6,11
2019,210155,40,0,1,0,1
2019,210155,40,5,1,0,1
2019,210155,42,0,1,0,1
2019,210155,42,5,1,0,1
2019,210234,0,0,39,19,20
2019,210234,10,0,39,19,20
2019,210234,10,4,39,19,20
2019,210234,20,0,23,14,9
2019,210234,20,4,23,14,9
2019,210234,30,0,6,1,5
2019,210234,30,4,6,1,5
2019,210234,40,0,10,4,6
2019,210234,40,4,10,4,6
2019,210234,41,0,8,4,4
2019,210234,41,4,8,4,4
2019,210234,42,0,2,0,2
2019,210234,42,4,2,0,2
2019,210234,44,0,8,4,4
2019,210234,44,4,8,4,4
2019,210270,0,0,61,38,23
2019,210270,10,0,61,38,23
2019,210270,10,4,61,38,23
2019,210270,40,0,61,38,23
2019,210270,40,4,61,38,23
2019,210270,41,0,47,30,17
2019,210270,41,4,47,30,17
2019,210270,42,0,14,8,6
2019,210270,42,4,14,8,6
2019,210270,45,0,47,30,17
2019,210270,45,4,47,30,17
2019,210304,0,0,27,13,14
2019,210304,10,0,27,13,14
2019,210304,10,1,5,4,1
2019,210304,10,2,10,3,7
2019,210304,10,3,9,5,4
2019,210304,10,4,3,1,2
2019,210304,40,0,27,13,14
2019,210304,40,1,5,4,1
2019,210304,40,2,10,3,7
2019,210304,40,3,9,5,4
2019,210304,40,4,3,1,2
2019,210304,41,0,6,3,3
2019,210304,41,1,2,1,1
2019,210304,41,2,2,1,1
2019,210304,41,3,2,1,1
2019,210304,42,0,21,10,11
2019,210304,42,1,3,3,0
2019,210304,42,2,8,2,6
2019,210304,42,3,7,4,3
2019,210304,42,4,3,1,2
2019,210304,45,0,6,3,3
2019,210304,45,1,2,1,1
2019,210304,45,2,2,1,1
2019,210304,45,3,2,1,1
2019,210331,0,0,48,34,14
2019,210331,10,0,48,34,14
2019,210331,10,1,14,13,1
2019,210331,10,2,19,13,6
2019,210331,10,3,15,8,7
2019,210331,40,0,48,34,14
2019,210331,40,1,14,13,1
2019,210331,40,2,19,13,6
2019,210331,40,3,15,8,7
2019,210331,42,0,48,34,14
2019,210331,42,1,14,13,1
2019,210331,42,2,19,13,6
2019,210331,42,3,15,8,7
2019,210368,0,0,19,13,6
2019,210368,10,0,19,13,6
2019,210368,10,1,10,7,3
2019,210368,10,2,3,3,0
2019,210368,10,3,5,2,3
2019,210368,10,4,1,1,0
2019,210368,40,0,19,13,6
2019,210368,40,1,10,7,3
2019,210368,40,2,3,3,0
2019,210368,40,3,5,2,3
2019,210368,40,4,1,1,0
2019,210368,42,0,19,13,6
2019,210368,42,1,10,7,3
2019,210368,42,2,3,3,0
2019,210368,42,3,5,2,3
2019,210368,42,4,1,1,0
2019,210401,0,0,178,93,85
2019,210401,10,0,178,93,85
2019,210401,10,1,74,44,30
2019,210401,10,2,58,27,31
2019,210401,10,3,38,20,18
2019,210401,10,4,8,2,6
2019,210401,20,0,125,66,59
2019,210401,20,1,72,43,29
2019,210401,20,2,53,23,30
2019,210401,30,0,31,18,13
2019,210401,30,2,5,4,1
2019,210401,30,3,26,14,12
2019,210401,40,0,22,9,13
2019,210401,40,1,2,1,1
2019,210401,40,3,12,6,6
2019,210401,40,4,8,2,6
2019,210401,41,0,8,3,5
2019,210401,41,1,2,1,1
2019,210401,41,4,6,2,4
2019,210401,42,0,14,6,8
2019,210401,42,3,12,6,6
2019,210401,42,4,2,0,2
2019,210401,44,0,8,3,5
2019,210401,44,1,2,1,1
2019,210401,44,4,6,2,4
2019,210429,0,0,296,135,161
2019,210429,10,0,296,135,161
2019,210429,10,1,78,42,36
2019,210429,10,2,55,25,30
2019,210429,10,3,87,36,51
2019,210429,10,4,71,31,40
2019,210429,10,5,5,1,4
2019,210429,20,0,132,65,67
2019,210429,20,1,77,41,36
2019,210429,20,2,54,24,30
2019,210429,20,3,1,0,1
2019,210429,30,0,34,11,23
2019,210429,30,2,1,1,0
2019,210429,30,3,33,10,23
2019,210429,40,0,130,59,71
2019,210429,40,1,1,1,0
2019,210429,40,3,53,26,27
2019,210429,40,4,71,31,40
2019,210429,40,5,5,1,4
2019,210429,42,0,130,59,71
2019,210429,42,1,1,1,0
2019,210429,42,3,53,26,27
2019,210429,42,4,71,31,40
2019,210429,42,5,5,1,4
2019,210438,0,0,36,17,19
2019,210438,10,0,36,17,19
2019,210438,10,1,3,3,0
2019,210438,10,2,15,8,7
2019,210438,10,3,16,5,11
2019,210438,10,4,1,0,1
2019,210438,10,6,1,1,0
2019,210438,20,0,16,9,7
2019,210438,20,1,3,3,0
2019,210438,20,2,12,6,6
2019,210438,20,3,1,0,1
2019,210438,30,0,16,5,11
2019,210438,30,2,3,2,1
2019,210438,30,3,13,3,10
2019,210438,40,0,4,3,1
2019,210438,40,3,2,2,0
2019,210438,40,4,1,0,1
2019,210438,40,6,1,1,0
2019,210438,42,0,4,3,1
2019,210438,42,3,2,2,0
2019,210438,42,4,1,0,1
2019,210438,42,6,1,1,0
2019,210492,0,0,35,22,13
2019,210492,10,0,35,22,13
2019,210492,10,1,2,1,1
2019,210492,10,2,7,7,0
2019,210492,10,3,24,12,12
2019,210492,10,4,1,1,0
2019,210492,10,5,1,1,0
2019,210492,20,0,6,5,1
2019,210492,20,1,2,1,1
2019,210492,20,2,4,4,0
2019,210492,30,0,5,3,2
2019,210492,30,3,5,3,2
2019,210492,40,0,24,14,10
2019,210492,40,2,3,3,0
2019,210492,40,3,19,9,10
2019,210492,40,4,1,1,0
2019,210492,40,5,1,1,0
2019,210492,41,0,11,5,6
2019,210492,41,2,2,2,0
2019,210492,41,3,9,3,6
2019,210492,42,0,13,9,4
2019,210492,42,2,1,1,0
2019,210492,42,3,10,6,4
2019,210492,42,4,1,1,0
2019,210492,42,5,1,1,0
2019,210492,44,0,11,5,6
2019,210492,44,2,2,2,0
2019,210492,44,3,9,3,6
2019,210571,0,0,108,53,55
2019,210571,10,0,108,53,55
2019,210571,10,1,23,14,9
2019,210571,10,2,37,21,16
2019,210571,10,3,33,15,18
2019,210571,10,4,15,3,12
2019,210571,20,0,53,32,21
2019,210571,20,1,23,14,9
2019,210571,20,2,30,18,12
2019,210571,30,0,27,14,13
2019,210571,30,2,5,1,4
2019,210571,30,3,22,13,9
2019,210571,40,0,28,7,21
2019,210571,40,2,2,2,0
2019,210571,40,3,11,2,9
2019,210571,40,4,15,3,12
2019,210571,41,0,18,4,14
2019,210571,41,2,2,2,0
2019,210571,41,3,6,1,5
2019,210571,41,4,10,1,9
2019,210571,42,0,10,3,7
2019,210571,42,3,5,1,4
2019,210571,42,4,5,2,3
2019,210571,44,0,18,4,14
2019,210571,44,2,2,2,0
2019,210571,44,3,6,1,5
2019,210571,44,4,10,1,9
2019,210599,0,0,26,21,5
2019,210599,10,0,26,21,5
2019,210599,10,4,26,21,5
2019,210599,40,0,26,21,5
2019,210599,40,4,26,21,5
2019,210599,41,0,26,21,5
2019,210599,41,4,26,21,5
2019,210599,45,0,26,21,5
2019,210599,45,4,26,21,5
2019,210605,0,0,246,107,139
2019,210605,10,0,246,107,139
2019,210605,10,1,140,63,77
2019,210605,10,2,55,25,30
2019,210605,10,3,41,14,27
2019,210605,10,4,10,5,5
2019,210605,20,0,178,80,98
2019,210605,20,1,137,60,77
2019,210605,20,2,30,16,14
2019,210605,20,3,11,4,7
2019,210605,30,0,56,22,34
2019,210605,30,1,1,1,0
2019,210605,30,2,23,9,14
2019,210605,30,3,27,9,18
2019,210605,30,4,5,3,2
2019,210605,40,0,12,5,7
2019,210605,40,1,2,2,0
2019,210605,40,2,2,0,2
2019,210605,40,3,3,1,2
2019,210605,40,4,5,2,3
2019,210605,41,0,12,5,7
2019,210605,41,1,2,2,0
2019,210605,41,2,2,0,2
2019,210605,41,3,3,1,2
2019,210605,41,4,5,2,3
2019,210605,45,0,12,5,7
2019,210605,45,1,2,2,0
2019,210605,45,2,2,0,2
2019,210605,45,3,3,1,2
2019,210605,45,4,5,2,3
2019,210669,0,0,152,69,83
2019,210669,10,0,152,69,83
2019,210669,10,1,36,22,14
2019,210669,10,2,45,17,28
2019,210669,10,3,65,27,38
2019,210669,10,4,6,3,3
2019,210669,20,0,78,36,42
2019,210669,20,1,36,22,14
2019,210669,20,2,42,14,28
2019,210669,30,0,42,18,24
2019,210669,30,3,42,18,24
2019,210669,40,0,32,15,17
2019,210669,40,2,3,3,0
2019,210669,40,3,23,9,14
2019,210669,40,4,6,3,3
2019,210669,41,0,32,15,17
2019,210669,41,2,3,3,0
2019,210669,41,3,23,9,14
2019,210669,41,4,6,3,3
2019,210669,44,0,32,15,17
2019,210669,44,2,3,3,0
2019,210669,44,3,23,9,14
2019,210669,44,4,6,3,3
2019,210739,0,0,127,56,71
2019,210739,10,0,127,56,71
2019,210739,10,1,17,10,7
2019,210739,10,2,41,20,21
2019,210739,10,3,64,24,40
2019,210739,10,4,5,2,3
2019,210739,20,0,43,25,18
2019,210739,20,1,14,9,5
2019,210739,20,2,29,16,13
2019,210739,30,0,72,27,45
2019,210739,30,1,3,1,2
2019,210739,30,2,11,4,7
2019,210739,30,3,55,21,34
2019,210739,30,4,3,1,2
2019,210739,40,0,12,4,8
2019,210739,40,2,1,0,1
2019,210739,40,3,9,3,6
2019,210739,40,4,2,1,1
2019,210739,41,0,1,1,0
2019,210739,41,3,1,1,0
2019,210739,42,0,11,3,8
2019,210739,42,2,1,0,1
2019,210739,42,3,8,2,6
2019,210739,42,4,2,1,1
2019,210739,44,0,1,1,0
2019,210739,44,3,1,1,0
2019,210775,0,0,118,47,71
2019,210775,10,0,118,47,71
2019,210775,10,1,11,5,6
2019,210775,10,2,37,19,18
2019,210775,10,3,48,20,28
2019,210775,10,4,22,3,19
2019,210775,20,0,56,28,28
2019,210775,20,1,11,5,6
2019,210775,20,2,36,19,17
2019,210775,20,3,9,4,5
2019,210775,30,0,26,13,13
2019,210775,30,3,26,13,13
2019,210775,40,0,36,6,30
2019,210775,40,2,1,0,1
2019,210775,40,3,13,3,10
2019,210775,40,4,22,3,19
2019,210775,41,0,27,5,22
2019,210775,41,3,10,3,7
2019,210775,41,4,17,2,15
2019,210775,42,0,8,1,7
2019,210775,42,2,1,0,1
2019,210775,42,3,3,0,3
2019,210775,42,4,4,1,3
2019,210775,43,0,1,0,1
2019,210775,43,4,1,0,1
2019,210775,44,0,27,5,22
2019,210775,44,3,10,3,7
2019,210775,44,4,17,2,15
2019,210809,0,0,14,11,3
2019,210809,10,0,13,10,3
2019,210809,10,1,4,4,0
2019,210809,10,2,1,1,0
2019,210809,10,3,7,4,3
2019,210809,10,4,1,1,0
2019,210809,40,0,13,10,3
2019,210809,40,1,4,4,0
2019,210809,40,2,1,1,0
2019,210809,40,3,7,4,3
2019,210809,40,4,1,1,0
2019,210809,41,0,13,10,3
2019,210809,41,1,4,4,0
2019,210809,41,2,1,1,0
2019,210809,41,3,7,4,3
2019,210809,41,4,1,1,0
2019,210809,44,0,13,10,3
2019,210809,44,1,4,4,0
2019,210809,44,2,1,1,0
2019,210809,44,3,7,4,3
2019,210809,44,4,1,1,0
2019,210809,50,0,1,1,0
2019,211024,0,0,28,16,12
2019,211024,10,0,28,16,12
2019,211024,10,1,23,12,11
2019,211024,10,2,5,4,1
2019,211024,40,0,28,16,12
2019,211024,40,1,23,12,11
2019,211024,40,2,5,4,1
2019,211024,42,0,28,16,12
2019,211024,42,1,23,12,11
2019,211024,42,2,5,4,1
2019,211079,0,0,51,18,33
2019,211079,10,0,51,18,33
2019,211079,10,1,11,2,9
2019,211079,10,2,13,3,10
2019,211079,10,3,20,9,11
2019,211079,10,4,7,4,3
2019,211079,20,0,32,7,25
2019,211079,20,1,11,2,9
2019,211079,20,2,13,3,10
2019,211079,20,3,7,2,5
2019,211079,20,4,1,0,1
2019,211079,30,0,14,7,7
2019,211079,30,3,13,7,6
2019,211079,30,4,1,0,1
2019,211079,40,0,5,4,1
2019,211079,40,4,5,4,1
2019,211079,43,0,5,4,1
2019,211079,43,4,5,4,1
2019,211088,0,0,177,70,107
2019,211088,10,0,177,70,107
2019,211088,10,1,31,19,12
2019,211088,10,2,55,20,35
2019,211088,10,3,71,23,48
2019,211088,10,4,20,8,12
2019,211088,20,0,82,38,44
2019,211088,20,1,30,19,11
2019,211088,20,2,46,17,29
2019,211088,20,3,6,2,4
2019,211088,30,0,28,13,15
2019,211088,30,2,3,2,1
2019,211088,30,3,25,11,14
2019,211088,40,0,67,19,48
2019,211088,40,1,1,0,1
2019,211088,40,2,6,1,5
2019,211088,40,3,40,10,30
2019,211088,40,4,20,8,12
2019,211088,42,0,67,19,48
2019,211088,42,1,1,0,1
2019,211088,42,2,6,1,5
2019,211088,42,3,40,10,30
2019,211088,42,4,20,8,12
2019,211130,0,0,8,6,2
2019,211130,10,0,8,6,2
2019,211130,10,1,3,3,0
2019,211130,10,2,1,1,0
2019,211130,10,3,4,2,2
2019,211130,40,0,8,6,2
2019,211130,40,1,3,3,0
2019,211130,40,2,1,1,0
2019,211130,40,3,4,2,2
2019,211130,41,0,8,6,2
2019,211130,41,1,3,3,0
2019,211130,41,2,1,1,0
2019,211130,41,3,4,2,2
2019,211130,44,0,8,6,2
2019,211130,44,1,3,3,0
2019,211130,44,2,1,1,0
2019,211130,44,3,4,2,2
2019,211149,0,0,13,4,9
2019,211149,10,0,13,4,9
2019,211149,10,4,13,4,9
2019,211149,40,0,13,4,9
2019,211149,40,4,13,4,9
2019,211149,41,0,13,4,9
2019,211149,41,4,13,4,9
2019,211149,45,0,13,4,9
2019,211149,45,4,13,4,9
2019,211158,0,0,380,205,175
2019,211158,10,0,380,205,175
2019,211158,10,1,122,87,35
2019,211158,10,2,106,53,53
2019,211158,10,3,108,44,64
2019,211158,10,4,44,21,23
2019,211158,20,0,255,148,107
2019,211158,20,1,122,87,35
2019,211158,20,2,101,50,51
2019,211158,20,3,31,11,20
2019,211158,20,4,1,0,1
2019,211158,30,0,83,37,46
2019,211158,30,2,5,3,2
2019,211158,30,3,76,33,43
2019,211158,30,4,2,1,1
2019,211158,40,0,42,20,22
2019,211158,40,3,1,0,1
2019,211158,40,4,41,20,21
2019,211158,42,0,42,20,22
2019,211158,42,3,1,0,1
2019,211158,42,4,41,20,21
2019,211273,0,0,152,59,93
2019,211273,10,0,152,59,93
2019,211273,10,1,48,23,25
2019,211273,10,2,39,18,21
2019,211273,10,3,41,13,28
2019,211273,10,4,6,1,5
2019,211273,10,5,18,4,14
2019,211273,20,0,87,41,46
2019,211273,20,1,48,23,25
2019,211273,20,2,39,18,21
2019,211273,30,0,41,13,28
2019,211273,30,3,41,13,28
2019,211273,40,0,24,5,19
2019,211273,40,4,6,1,5
2019,211273,40,5,18,4,14
2019,211273,41,0,16,4,12
2019,211273,41,4,2,1,1
2019,211273,41,5,14,3,11
2019,211273,43,0,8,1,7
2019,211273,43,4,4,0,4
2019,211273,43,5,4,1,3
2019,211273,45,0,16,4,12
2019,211273,45,4,2,1,1
2019,211273,45,5,14,3,11
2019,211291,0,0,423,246,177
2019,211291,10,0,423,246,177
2019,211291,10,1,127,86,41
2019,211291,10,2,131,74,57
2019,211291,10,3,161,86,75
2019,211291,10,4,2,0,2
2019,211291,10,6,2,0,2
2019,211291,20,0,249,154,95
2019,211291,20,1,122,82,40
2019,211291,20,2,127,72,55
2019,211291,30,0,113,59,54
2019,211291,30,1,3,3,0
2019,211291,30,2,2,1,1
2019,211291,30,3,108,55,53
2019,211291,40,0,61,33,28
2019,211291,40,1,2,1,1
2019,211291,40,2,2,1,1
2019,211291,40,3,53,31,22
2019,211291,40,4,2,0,2
2019,211291,40,6,2,0,2
2019,211291,41,0,7,3,4
2019,211291,41,1,1,0,1
2019,211291,41,2,2,1,1
2019,211291,41,3,2,2,0
2019,211291,41,6,2,0,2
2019,211291,42,0,54,30,24
2019,211291,42,1,1,1,0
2019,211291,42,3,51,29,22
2019,211291,42,4,2,0,2
2019,211291,44,0,7,3,4
2019,211291,44,1,1,0,1
2019,211291,44,2,2,1,1
2019,211291,44,3,2,2,0
2019,211291,44,6,2,0,2
2019,211307,0,0,140,57,83
2019,211307,10,0,140,57,83
2019,211307,10,1,62,32,30
2019,211307,10,2,52,17,35
2019,211307,10,3,14,6,8
2019,211307,10,4,12,2,10
2019,211307,20,0,94,39,55
2019,211307,20,1,56,27,29
2019,211307,20,2,38,12,26
2019,211307,30,0,39,16,23
2019,211307,30,1,6,5,1
2019,211307,30,2,14,5,9
2019,211307,30,3,12,5,7
2019,211307,30,4,7,1,6
2019,211307,40,0,7,2,5
2019,211307,40,3,2,1,1
2019,211307,40,4,5,1,4
2019,211307,42,0,7,2,5
2019,211307,42,3,2,1,1
2019,211307,42,4,5,1,4
2019,211343,0,0,61,21,40
2019,211343,10,0,61,21,40
2019,211343,10,1,13,3,10
2019,211343,10,2,14,7,7
2019,211343,10,3,12,6,6
2019,211343,10,4,19,5,14
2019,211343,10,6,3,0,3
2019,211343,20,0,43,17,26
2019,211343,20,1,13,3,10
2019,211343,20,2,14,7,7
2019,211343,20,3,12,6,6
2019,211343,20,4,4,1,3
2019,211343,30,0,15,4,11
2019,211343,30,4,15,4,11
2019,211343,40,0,3,0,3
2019,211343,40,6,3,0,3
2019,211343,43,0,3,0,3
2019,211343,43,6,3,0,3
2019,211352,0,0,76,29,47
2019,211352,10,0,76,29,47
2019,211352,10,1,15,8,7
2019,211352,10,2,22,6,16
2019,211352,10,3,32,11,21
2019,211352,10,4,7,4,3
2019,211352,20,0,35,13,22
2019,211352,20,1,15,8,7
2019,211352,20,2,20,5,15
2019,211352,30,0,29,12,17
2019,211352,30,2,2,1,1
2019,211352,30,3,27,11,16
2019,211352,40,0,12,4,8
2019,211352,40,3,5,0,5
2019,211352,40,4,7,4,3
2019,211352,41,0,7,2,5
2019,211352,41,3,4,0,4
2019,211352,41,4,3,2,1
2019,211352,42,0,5,2,3
2019,211352,42,3,1,0,1
2019,211352,42,4,4,2,2
2019,211352,44,0,7,2,5
2019,211352,44,3,4,0,4
2019,211352,44,4,3,2,1
2019,211361,0,0,269,133,136
2019,211361,10,0,269,133,136
2019,211361,10,1,91,47,44
2019,211361,10,2,74,40,34
2019,211361,10,3,79,35,44
2019,211361,10,4,25,11,14
2019,211361,20,0,173,89,84
2019,211361,20,1,91,47,44
2019,211361,20,2,61,33,28
2019,211361,20,3,20,9,11
2019,211361,20,4,1,0,1
2019,211361,30,0,62,27,35
2019,211361,30,2,12,7,5
2019,211361,30,3,49,20,29
2019,211361,30,4,1,0,1
2019,211361,40,0,34,17,17
2019,211361,40,2,1,0,1
2019,211361,40,3,10,6,4
2019,211361,40,4,23,11,12
2019,211361,42,0,34,17,17
2019,211361,42,2,1,0,1
2019,211361,42,3,10,6,4
2019,211361,42,4,23,11,12
2019,211431,0,0,107,25,82
2019,211431,10,0,107,25,82
2019,211431,10,1,27,10,17
2019,211431,10,2,27,6,21
2019,211431,10,3,35,7,28
2019,211431,10,4,18,2,16
2019,211431,20,0,42,14,28
2019,211431,20,1,26,9,17
2019,211431,20,2,16,5,11
2019,211431,30,0,27,5,22
2019,211431,30,1,1,1,0
2019,211431,30,2,5,1,4
2019,211431,30,3,20,3,17
2019,211431,30,4,1,0,1
2019,211431,40,0,38,6,32
2019,211431,40,2,6,0,6
2019,211431,40,3,15,4,11
2019,211431,40,4,17,2,15
2019,211431,42,0,38,6,32
2019,211431,42,2,6,0,6
2019,211431,42,3,15,4,11
2019,211431,42,4,17,2,15
2019,211440,0,0,1278,894,384
2019,211440,10,0,1116,778,338
2019,211440,10,1,413,322,91
2019,211440,10,2,271,183,88
2019,211440,10,3,250,145,105
2019,211440,10,6,182,128,54
2019,211440,20,0,477,372,105
2019,211440,20,1,361,290,71
2019,211440,20,2,116,82,34
2019,211440,30,0,254,164,90
2019,211440,30,2,79,58,21
2019,211440,30,3,175,106,69
2019,211440,40,0,385,242,143
2019,211440,40,1,52,32,20
2019,211440,40,2,76,43,33
2019,211440,40,3,75,39,36
2019,211440,40,6,182,128,54
2019,211440,41,0,203,114,89
2019,211440,41,1,52,32,20
2019,211440,41,2,76,43,33
2019,211440,41,3,75,39,36
2019,211440,42,0,182,128,54
2019,211440,42,6,182,128,54
2019,211440,44,0,203,114,89
2019,211440,44,1,52,32,20
2019,211440,44,2,76,43,33
2019,211440,44,3,75,39,36
2019,211440,50,0,162,116,46
2019,211468,0,0,82,25,57
2019,211468,10,0,82,25,57
2019,211468,10,1,23,9,14
2019,211468,10,2,16,7,9
2019,211468,10,3,28,9,19
2019,211468,10,4,15,0,15
2019,211468,20,0,33,13,20
2019,211468,20,1,23,9,14
2019,211468,20,2,10,4,6
2019,211468,30,0,5,2,3
2019,211468,30,2,2,1,1
2019,211468,30,3,3,1,2
2019,211468,40,0,44,10,34
2019,211468,40,2,4,2,2
2019,211468,40,3,25,8,17
2019,211468,40,4,15,0,15
2019,211468,41,0,3,1,2
2019,211468,41,2,2,1,1
2019,211468,41,3,1,0,1
2019,211468,42,0,41,9,32
2019,211468,42,2,2,1,1
2019,211468,42,3,24,8,16
2019,211468,42,4,15,0,15
2019,211468,44,0,3,1,2
2019,211468,44,2,2,1,1
2019,211468,44,3,1,0,1
2019,211477,0,0,36,20,16
2019,211477,10,0,36,20,16
2019,211477,10,1,6,2,4
2019,211477,10,2,9,6,3
2019,211477,10,3,9,6,3
2019,211477,10,4,12,6,6
2019,211477,40,0,36,20,16
2019,211477,40,1,6,2,4
2019,211477,40,2,9,6,3
2019,211477,40,3,9,6,3
2019,211477,40,4,12,6,6
2019,211477,41,0,36,20,16
2019,211477,41,1,6,2,4
2019,211477,41,2,9,6,3
2019,211477,41,3,9,6,3
2019,211477,41,4,12,6,6
2019,211477,45,0,36,20,16
2019,211477,45,1,6,2,4
2019,211477,45,2,9,6,3
2019,211477,45,3,9,6,3
2019,211477,45,4,12,6,6
2019,211556,0,0,126,43,83
2019,211556,10,0,126,43,83
2019,211556,10,1,13,3,10
2019,211556,10,2,41,17,24
2019,211556,10,3,70,21,49
2019,211556,10,4,2,2,0
2019,211556,20,0,6,2,4
2019,211556,20,1,5,1,4
2019,211556,20,2,1,1,0
2019,211556,40,0,120,41,79
2019,211556,40,1,8,2,6
2019,211556,40,2,40,16,24
2019,211556,40,3,70,21,49
2019,211556,40,4,2,2,0
2019,211556,41,0,120,41,79
2019,211556,41,1,8,2,6
2019,211556,41,2,40,16,24
2019,211556,41,3,70,21,49
2019,211556,41,4,2,2,0
2019,211556,44,0,120,41,79
2019,211556,44,1,8,2,6
2019,211556,44,2,40,16,24
2019,211556,44,3,70,21,49
2019,211556,44,4,2,2,0
2019,211583,0,0,68,26,42
2019,211583,10,0,68,26,42
2019,211583,10,1,15,6,9
2019,211583,10,2,13,5,8
2019,211583,10,3,33,14,19
2019,211583,10,4,7,1,6
2019,211583,20,0,25,11,14
2019,211583,20,1,15,6,9
2019,211583,20,2,9,4,5
2019,211583,20,3,1,1,0
2019,211583,30,0,22,8,14
2019,211583,30,2,1,0,1
2019,211583,30,3,21,8,13
2019,211583,40,0,21,7,14
2019,211583,40,2,3,1,2
2019,211583,40,3,11,5,6
2019,211583,40,4,7,1,6
2019,211583,42,0,21,7,14
2019,211583,42,2,3,1,2
2019,211583,42,3,11,5,6
2019,211583,42,4,7,1,6
2019,211608,0,0,35,19,16
2019,211608,10,0,35,19,16
2019,211608,10,1,16,10,6
2019,211608,10,2,9,4,5
2019,211608,10,3,7,4,3
2019,211608,10,4,3,1,2
2019,211608,20,0,25,14,11
2019,211608,20,1,16,10,6
2019,211608,20,2,9,4,5
2019,211608,30,0,7,4,3
2019,211608,30,3,7,4,3
2019,211608,40,0,3,1,2
2019,211608,40,4,3,1,2
2019,211608,42,0,3,1,2
2019,211608,42,4,3,1,2
2019,211644,0,0,209,98,111
2019,211644,10,0,209,98,111
2019,211644,10,1,65,45,20
2019,211644,10,2,47,21,26
2019,211644,10,3,53,19,34
2019,211644,10,4,44,13,31
2019,211644,20,0,133,75,58
2019,211644,20,1,63,43,20
2019,211644,20,2,39,16,23
2019,211644,20,3,29,16,13
2019,211644,20,4,2,0,2
2019,211644,30,0,35,10,25
2019,211644,30,1,2,2,0
2019,211644,30,2,8,5,3
2019,211644,30,3,23,3,20
2019,211644,30,4,2,0,2
2019,211644,40,0,41,13,28
2019,211644,40,3,1,0,1
2019,211644,40,4,40,13,27
2019,211644,42,0,41,13,28
2019,211644,42,3,1,0,1
2019,211644,42,4,40,13,27
2019,211893,0,0,4,2,2
2019,211893,10,0,4,2,2
2019,211893,10,6,4,2,2
2019,211893,40,0,4,2,2
2019,211893,40,6,4,2,2
2019,211893,42,0,4,2,2
2019,211893,42,6,4,2,2
2019,211927,0,0,133,56,77
2019,211927,10,0,133,56,77
2019,211927,10,1,53,23,30
2019,211927,10,2,51,21,30
2019,211927,10,3,22,8,14
2019,211927,10,4,7,4,3
2019,211927,20,0,106,46,60
2019,211927,20,1,53,23,30
2019,211927,20,2,51,21,30
2019,211927,20,3,2,2,0
2019,211927,30,0,20,6,14
2019,211927,30,3,20,6,14
2019,211927,40,0,7,4,3
2019,211927,40,4,7,4,3
2019,211927,42,0,5,3,2
2019,211927,42,4,5,3,2
2019,211927,43,0,2,1,1
2019,211927,43,4,2,1,1
2019,211981,0,0,90,49,41
2019,211981,10,0,90,49,41
2019,211981,10,1,27,15,12
2019,211981,10,2,28,20,8
2019,211981,10,3,26,13,13
2019,211981,10,4,7,1,6
2019,211981,10,5,2,0,2
2019,211981,20,0,49,32,17
2019,211981,20,1,27,15,12
2019,211981,20,2,18,15,3
2019,211981,20,3,4,2,2
2019,211981,30,0,15,8,7
2019,211981,30,2,4,2,2
2019,211981,30,3,10,6,4
2019,211981,30,4,1,0,1
2019,211981,40,0,26,9,17
2019,211981,40,2,6,3,3
2019,211981,40,3,12,5,7
2019,211981,40,4,6,1,5
2019,211981,40,5,2,0,2
2019,211981,41,0,26,9,17
2019,211981,41,2,6,3,3
2019,211981,41,3,12,5,7
2019,211981,41,4,6,1,5
2019,211981,41,5,2,0,2
2019,211981,44,0,26,9,17
2019,211981,44,2,6,3,3
2019,211981,44,3,12,5,7
2019,211981,44,4,6,1,5
2019,211981,44,5,2,0,2
2019,212009,0,0,229,109,120
2019,212009,10,0,229,109,120
2019,212009,10,1,57,35,22
2019,212009,10,2,83,42,41
2019,212009,10,3,68,26,42
2019,212009,10,4,21,6,15
2019,212009,20,0,132,74,58
2019,212009,20,1,57,35,22
2019,212009,20,2,73,38,35
2019,212009,20,3,2,1,1
2019,212009,30,0,59,23,36
2019,212009,30,2,10,4,6
2019,212009,30,3,48,19,29
2019,212009,30,4,1,0,1
2019,212009,40,0,38,12,26
2019,212009,40,3,18,6,12
2019,212009,40,4,20,6,14
2019,212009,42,0,35,12,23
2019,212009,42,3,15,6,9
2019,212009,42,4,20,6,14
2019,212009,43,0,3,0,3
2019,212009,43,3,3,0,3
2019,212045,0,0,10,6,4
2019,212045,10,0,10,6,4
2019,212045,10,4,10,6,4
2019,212045,40,0,10,6,4
2019,212045,40,4,10,6,4
2019,212045,41,0,10,6,4
2019,212045,41,4,10,6,4
2019,212045,45,0,10,6,4
2019,212045,45,4,10,6,4
2019,212054,0,0,1425,740,685
2019,212054,10,0,1425,740,685
2019,212054,10,1,293,214,79
2019,212054,10,2,240,121,119
2019,212054,10,3,136,75,61
2019,212054,10,4,756,330,426
2019,212054,20,0,505,316,189
2019,212054,20,1,282,205,77
2019,212054,20,2,222,110,112
2019,212054,20,3,1,1,0
2019,212054,30,0,164,94,70
2019,212054,30,1,11,9,2
2019,212054,30,2,18,11,7
2019,212054,30,3,135,74,61
2019,212054,40,0,756,330,426
2019,212054,40,4,756,330,426
2019,212054,41,0,699,308,391
2019,212054,41,4,699,308,391
2019,212054,42,0,57,22,35
2019,212054,42,4,57,22,35
2019,212054,44,0,699,308,391
2019,212054,44,4,699,308,391
2019,212106,0,0,493,237,256
2019,212106,10,0,493,237,256
2019,212106,10,1,103,68,35
2019,212106,10,2,189,105,84
2019,212106,10,3,173,54,119
2019,212106,10,4,28,10,18
2019,212106,20,0,279,168,111
2019,212106,20,1,101,66,35
2019,212106,20,2,176,101,75
2019,212106,20,3,2,1,1
2019,212106,30,0,85,31,54
2019,212106,30,2,5,1,4
2019,212106,30,3,80,30,50
2019,212106,40,0,129,38,91
2019,212106,40,1,2,2,0
2019,212106,40,2,8,3,5
2019,212106,40,3,91,23,68
2019,212106,40,4,28,10,18
2019,212106,42,0,129,38,91
2019,212106,42,1,2,2,0
2019,212106,42,2,8,3,5
2019,212106,42,3,91,23,68
2019,212106,42,4,28,10,18
2019,212115,0,0,246,125,121
2019,212115,10,0,246,125,121
2019,212115,10,1,86,56,30
2019,212115,10,2,68,35,33
2019,212115,10,3,46,20,26
2019,212115,10,4,46,14,32
2019,212115,20,0,149,88,61
2019,212115,20,1,85,56,29
2019,212115,20,2,52,27,25
2019,212115,20,3,10,5,5
2019,212115,20,4,2,0,2
2019,212115,30,0,57,24,33
2019,212115,30,1,1,0,1
2019,212115,30,2,16,8,8
2019,212115,30,3,34,14,20
2019,212115,30,4,6,2,4
2019,212115,40,0,40,13,27
2019,212115,40,3,2,1,1
2019,212115,40,4,38,12,26
2019,212115,41,0,3,0,3
2019,212115,41,3,1,0,1
2019,212115,41,4,2,0,2
2019,212115,42,0,37,13,24
2019,212115,42,3,1,1,0
2019,212115,42,4,36,12,24
2019,212115,44,0,3,0,3
2019,212115,44,3,1,0,1
2019,212115,44,4,2,0,2
2019,212133,0,0,106,45,61
2019,212133,10,0,106,45,61
2019,212133,10,1,31,19,12
2019,212133,10,2,22,10,12
2019,212133,10,3,22,6,16
2019,212133,10,5,25,7,18
2019,212133,10,6,6,3,3
2019,212133,20,0,48,27,21
2019,212133,20,1,31,19,12
2019,212133,20,2,17,8,9
2019,212133,30,0,26,8,18
2019,212133,30,2,5,2,3
2019,212133,30,3,21,6,15
2019,212133,40,0,32,10,22
2019,212133,40,3,1,0,1
2019,212133,40,5,25,7,18
2019,212133,40,6,6,3,3
2019,212133,42,0,32,10,22
2019,212133,42,3,1,0,1
2019,212133,42,5,25,7,18
2019,212133,42,6,6,3,3
2019,212160,0,0,249,128,121
2019,212160,10,0,249,128,121
2019,212160,10,1,90,55,35
2019,212160,10,2,66,38,28
2019,212160,10,3,67,31,36
2019,212160,10,4,26,4,22
2019,212160,20,0,183,110,73
2019,212160,20,1,90,55,35
2019,212160,20,2,59,33,26
2019,212160,20,3,33,22,11
2019,212160,20,4,1,0,1
2019,212160,30,0,40,13,27
2019,212160,30,2,7,5,2
2019,212160,30,3,30,8,22
2019,212160,30,4,3,0,3
2019,212160,40,0,26,5,21
2019,212160,40,3,4,1,3
2019,212160,40,4,22,4,18
2019,212160,41,0,2,0,2
2019,212160,41,4,2,0,2
2019,212160,42,0,24,5,19
2019,212160,42,3,4,1,3
2019,212160,42,4,20,4,16
2019,212160,44,0,2,0,2
2019,212160,44,4,2,0,2
2019,212197,0,0,123,59,64
2019,212197,10,0,123,59,64
2019,212197,10,1,34,22,12
2019,212197,10,2,52,27,25
2019,212197,10,3,23,7,16
2019,212197,10,4,2,0,2
2019,212197,10,5,12,3,9
2019,212197,20,0,83,48,35
2019,212197,20,1,34,22,12
2019,212197,20,2,49,26,23
2019,212197,30,0,22,7,15
2019,212197,30,2,3,1,2
2019,212197,30,3,19,6,13
2019,212197,40,0,18,4,14
2019,212197,40,3,4,1,3
2019,212197,40,4,2,0,2
2019,212197,40,5,12,3,9
2019,212197,42,0,18,4,14
2019,212197,42,3,4,1,3
2019,212197,42,4,2,0,2
2019,212197,42,5,12,3,9
2019,212434,0,0,32,21,11
2019,212434,50,0,32,21,11
2019,212452,0,0,5,4,1
2019,212452,10,0,5,4,1
2019,212452,10,1,5,4,1
2019,212452,40,0,5,4,1
2019,212452,40,1,5,4,1
2019,212452,41,0,5,4,1
2019,212452,41,1,5,4,1
2019,212452,45,0,5,4,1
2019,212452,45,1,5,4,1
2019,212577,0,0,273,145,128
2019,212577,10,0,273,145,128
2019,212577,10,1,95,61,34
2019,212577,10,2,79,36,43
2019,212577,10,3,91,45,46
2019,212577,10,4,8,3,5
2019,212577,20,0,158,91,67
2019,212577,20,1,84,55,29
2019,212577,20,2,74,36,38
2019,212577,30,0,44,15,29
2019,212577,30,3,44,15,29
2019,212577,40,0,71,39,32
2019,212577,40,1,11,6,5
2019,212577,40,2,5,0,5
2019,212577,40,3,47,30,17
2019,212577,40,4,8,3,5
2019,212577,41,0,34,15,19
2019,212577,41,1,10,5,5
2019,212577,41,2,5,0,5
2019,212577,41,3,18,10,8
2019,212577,41,4,1,0,1
2019,212577,42,0,37,24,13
2019,212577,42,1,1,1,0
2019,212577,42,3,29,20,9
2019,212577,42,4,7,3,4
2019,212577,44,0,34,15,19
2019,212577,44,1,10,5,5
2019,212577,44,2,5,0,5
2019,212577,44,3,18,10,8
2019,212577,44,4,1,0,1
2019,212601,0,0,234,113,121
2019,212601,10,0,234,113,121
2019,212601,10,1,29,20,9
2019,212601,10,2,72,39,33
2019,212601,10,3,119,50,69
2019,212601,10,4,14,4,10
2019,212601,20,0,90,54,36
2019,212601,20,1,27,18,9
2019,212601,20,2,48,29,19
2019,212601,20,3,15,7,8
2019,212601,30,0,74,32,42
2019,212601,30,1,2,2,0
2019,212601,30,2,12,9,3
2019,212601,30,3,59,21,38
2019,212601,30,4,1,0,1
2019,212601,40,0,70,27,43
2019,212601,40,2,12,1,11
2019,212601,40,3,45,22,23
2019,212601,40,4,13,4,9
2019,212601,42,0,70,27,43
2019,212601,42,2,12,1,11
2019,212601,42,3,45,22,23
2019,212601,42,4,13,4,9
2019,212656,0,0,65,43,22
2019,212656,10,0,65,43,22
2019,212656,10,1,27,19,8
2019,212656,10,2,27,18,9
2019,212656,10,3,10,5,5
2019,212656,10,4,1,1,0
2019,212656,20,0,36,25,11
2019,212656,20,1,25,18,7
2019,212656,20,2,11,7,4
2019,212656,30,0,12,8,4
2019,212656,30,1,2,1,1
2019,212656,30,2,7,5,2
2019,212656,30,3,3,2,1
2019,212656,40,0,17,10,7
2019,212656,40,2,9,6,3
2019,212656,40,3,7,3,4
2019,212656,40,4,1,1,0
2019,212656,42,0,17,10,7
2019,212656,42,2,9,6,3
2019,212656,42,3,7,3,4
2019,212656,42,4,1,1,0
2019,212674,0,0,227,127,100
2019,212674,10,0,227,127,100
2019,212674,10,1,60,33,27
2019,212674,10,2,87,50,37
2019,212674,10,3,64,36,28
2019,212674,10,4,3,1,2
2019,212674,10,5,13,7,6
2019,212674,20,0,147,83,64
2019,212674,20,1,60,33,27
2019,212674,20,2,87,50,37
2019,212674,30,0,49,27,22
2019,212674,30,3,49,27,22
2019,212674,40,0,31,17,14
2019,212674,40,3,15,9,6
2019,212674,40,4,3,1,2
2019,212674,40,5,13,7,6
2019,212674,41,0,18,9,9
2019,212674,41,3,4,2,2
2019,212674,41,4,2,0,2
2019,212674,41,5,12,7,5
2019,212674,42,0,13,8,5
2019,212674,42,3,11,7,4
2019,212674,42,4,1,1,0
2019,212674,42,5,1,0,1
2019,212674,44,0,8,3,5
2019,212674,44,3,4,2,2
2019,212674,44,4,2,0,2
2019,212674,44,5,2,1,1
2019,212674,45,0,10,6,4
2019,212674,45,5,10,6,4
2019,212771,0,0,4,2,2
2019,212771,10,0,4,2,2
2019,212771,10,1,4,2,2
2019,212771,40,0,4,2,2
2019,212771,40,1,4,2,2
2019,212771,41,0,4,2,2
2019,212771,41,1,4,2,2
2019,212771,44,0,4,2,2
2019,212771,44,1,4,2,2
2019,212832,0,0,94,21,73
2019,212832,10,0,94,21,73
2019,212832,10,1,8,4,4
2019,212832,10,2,20,11,9
2019,212832,10,3,45,4,41
2019,212832,10,4,21,2,19
2019,212832,20,0,25,10,15
2019,212832,20,1,5,3,2
2019,212832,20,2,12,6,6
2019,212832,20,3,8,1,7
2019,212832,30,0,8,1,7
2019,212832,30,2,1,1,0
2019,212832,30,3,7,0,7
2019,212832,40,0,61,10,51
2019,212832,40,1,3,1,2
2019,212832,40,2,7,4,3
2019,212832,40,3,30,3,27
2019,212832,40,4,21,2,19
2019,212832,42,0,5,1,4
2019,212832,42,1,2,0,2
2019,212832,42,3,1,1,0
2019,212832,42,4,2,0,2
2019,212832,43,0,56,9,47
2019,212832,43,1,1,1,0
2019,212832,43,2,7,4,3
2019,212832,43,3,29,2,27
2019,212832,43,4,19,2,17
2019,212869,0,0,62,15,47
2019,212869,10,0,62,15,47
2019,212869,10,1,17,8,9
2019,212869,10,2,13,1,12
2019,212869,10,3,13,4,9
2019,212869,10,4,19,2,17
2019,212869,20,0,3,1,2
2019,212869,20,1,3,1,2
2019,212869,40,0,59,14,45
2019,212869,40,1,14,7,7
2019,212869,40,2,13,1,12
2019,212869,40,3,13,4,9
2019,212869,40,4,19,2,17
2019,212869,42,0,59,14,45
2019,212869,42,1,14,7,7
2019,212869,42,2,13,1,12
2019,212869,42,3,13,4,9
2019,212869,42,4,19,2,17
2019,212878,0,0,288,104,184
2019,212878,10,0,288,104,184
2019,212878,10,1,109,48,61
2019,212878,10,2,89,28,61
2019,212878,10,3,62,17,45
2019,212878,10,4,27,10,17
2019,212878,10,6,1,1,0
2019,212878,20,0,203,79,124
2019,212878,20,1,109,48,61
2019,212878,20,2,72,22,50
2019,212878,20,3,20,7,13
2019,212878,20,4,2,2,0
2019,212878,30,0,84,24,60
2019,212878,30,2,17,6,11
2019,212878,30,3,42,10,32
2019,212878,30,4,25,8,17
2019,212878,40,0,1,1,0
2019,212878,40,6,1,1,0
2019,212878,42,0,1,1,0
2019,212878,42,6,1,1,0
2019,212911,0,0,165,76,89
2019,212911,10,0,165,76,89
2019,212911,10,1,47,27,20
2019,212911,10,2,39,16,23
2019,212911,10,3,69,28,41
2019,212911,10,4,5,3,2
2019,212911,10,5,5,2,3
2019,212911,20,0,79,41,38
2019,212911,20,1,44,26,18
2019,212911,20,2,35,15,20
2019,212911,30,0,27,11,16
2019,212911,30,3,27,11,16
2019,212911,40,0,59,24,35
2019,212911,40,1,3,1,2
2019,212911,40,2,4,1,3
2019,212911,40,3,42,17,25
2019,212911,40,4,5,3,2
2019,212911,40,5,5,2,3
2019,212911,41,0,59,24,35
2019,212911,41,1,3,1,2
2019,212911,41,2,4,1,3
2019,212911,41,3,42,17,25
2019,212911,41,4,5,3,2
2019,212911,41,5,5,2,3
2019,212911,44,0,59,24,35
2019,212911,44,1,3,1,2
2019,212911,44,2,4,1,3
2019,212911,44,3,42,17,25
2019,212911,44,4,5,3,2
2019,212911,44,5,5,2,3
2019,212975,0,0,25,15,10
2019,212975,50,0,25,15,10
2019,212984,0,0,80,22,58
2019,212984,10,0,80,22,58
2019,212984,10,1,18,5,13
2019,212984,10,2,17,7,10
2019,212984,10,3,32,9,23
2019,212984,10,4,13,1,12
2019,212984,40,0,80,22,58
2019,212984,40,1,18,5,13
2019,212984,40,2,17,7,10
2019,212984,40,3,32,9,23
2019,212984,40,4,13,1,12
2019,212984,41,0,26,10,16
2019,212984,41,1,16,5,11
2019,212984,41,2,8,3,5
2019,212984,41,3,2,2,0
2019,212984,42,0,54,12,42
2019,212984,42,1,2,0,2
2019,212984,42,2,9,4,5
2019,212984,42,3,30,7,23
2019,212984,42,4,13,1,12
2019,212984,44,0,26,10,16
2019,212984,44,1,16,5,11
2019,212984,44,2,8,3,5
2019,212984,44,3,2,2,0
2019,213011,0,0,76,27,49
2019,213011,10,0,76,27,49
2019,213011,10,1,25,10,15
2019,213011,10,2,10,5,5
2019,213011,10,3,24,6,18
2019,213011,10,4,11,3,8
2019,213011,10,6,6,3,3
2019,213011,20,0,30,11,19
2019,213011,20,1,25,10,15
2019,213011,20,2,4,1,3
2019,213011,20,3,1,0,1
2019,213011,30,0,40,13,27
2019,213011,30,2,6,4,2
2019,213011,30,3,23,6,17
2019,213011,30,4,11,3,8
2019,213011,40,0,6,3,3
2019,213011,40,6,6,3,3
2019,213011,42,0,6,3,3
2019,213011,42,6,6,3,3
2019,213020,0,0,507,255,252
2019,213020,10,0,507,255,252
2019,213020,10,1,197,122,75
2019,213020,10,2,175,82,93
2019,213020,10,3,93,40,53
2019,213020,10,4,42,11,31
2019,213020,20,0,391,214,177
2019,213020,20,1,197,122,75
2019,213020,20,2,167,78,89
2019,213020,20,3,25,14,11
2019,213020,20,4,2,0,2
2019,213020,30,0,69,25,44
2019,213020,30,2,8,4,4
2019,213020,30,3,56,20,36
2019,213020,30,4,5,1,4
2019,213020,40,0,47,16,31
2019,213020,40,3,12,6,6
2019,213020,40,4,35,10,25
2019,213020,42,0,47,16,31
2019,213020,42,3,12,6,6
2019,213020,42,4,35,10,25
2019,213181,0,0,27,1,26
2019,213181,50,0,27,1,26
2019,213233,0,0,30,19,11
2019,213233,10,0,30,19,11
2019,213233,10,6,30,19,11
2019,213233,40,0,30,19,11
2019,213233,40,6,30,19,11
2019,213233,41,0,30,19,11
2019,213233,41,6,30,19,11
2019,213233,44,0,30,19,11
2019,213233,44,6,30,19,11
2019,213251,0,0,112,61,51
2019,213251,10,0,112,61,51
2019,213251,10,1,58,37,21
2019,213251,10,2,24,13,11
2019,213251,10,3,21,5,16
2019,213251,10,4,8,5,3
2019,213251,10,5,1,1,0
2019,213251,20,0,81,50,31
2019,213251,20,1,58,37,21
2019,213251,20,2,23,13,10
2019,213251,30,0,11,3,8
2019,213251,30,2,1,0,1
2019,213251,30,3,10,3,7
2019,213251,40,0,20,8,12
2019,213251,40,3,11,2,9
2019,213251,40,4,8,5,3
2019,213251,40,5,1,1,0
2019,213251,41,0,19,7,12
2019,213251,41,3,11,2,9
2019,213251,41,4,8,5,3
2019,213251,43,0,1,1,0
2019,213251,43,5,1,1,0
2019,213251,44,0,19,7,12
2019,213251,44,3,11,2,9
2019,213251,44,4,8,5,3
2019,213303,0,0,47,19,28
2019,213303,10,0,47,19,28
2019,213303,10,1,15,5,10
2019,213303,10,2,11,4,7
2019,213303,10,3,16,9,7
2019,213303,10,4,5,1,4
2019,213303,20,0,29,9,20
2019,213303,20,1,15,5,10
2019,213303,20,2,11,4,7
2019,213303,20,3,3,0,3
2019,213303,30,0,10,6,4
2019,213303,30,3,10,6,4
2019,213303,40,0,8,4,4
2019,213303,40,3,3,3,0
2019,213303,40,4,5,1,4
2019,213303,42,0,8,4,4
2019,213303,42,3,3,3,0
2019,213303,42,4,5,1,4
2019,213321,0,0,140,65,75
2019,213321,10,0,140,65,75
2019,213321,10,1,45,25,20
2019,213321,10,2,51,25,26
2019,213321,10,3,35,14,21
2019,213321,10,4,9,1,8
2019,213321,20,0,69,36,33
2019,213321,20,1,33,21,12
2019,213321,20,2,36,15,21
2019,213321,30,0,25,13,12
2019,213321,30,1,1,0,1
2019,213321,30,2,1,1,0
2019,213321,30,3,23,12,11
2019,213321,40,0,46,16,30
2019,213321,40,1,11,4,7
2019,213321,40,2,14,9,5
2019,213321,40,3,12,2,10
2019,213321,40,4,9,1,8
2019,213321,42,0,13,3,10
2019,213321,42,1,3,0,3
2019,213321,42,2,4,2,2
2019,213321,42,3,5,1,4
2019,213321,42,4,1,0,1
2019,213321,43,0,33,13,20
2019,213321,43,1,8,4,4
2019,213321,43,2,10,7,3
2019,213321,43,3,7,1,6
2019,213321,43,4,8,1,7
2019,213349,0,0,375,194,181
2019,213349,10,0,375,194,181
2019,213349,10,1,111,67,44
2019,213349,10,2,128,75,53
2019,213349,10,3,113,40,73
2019,213349,10,4,23,12,11
2019,213349,20,0,260,143,117
2019,213349,20,1,109,66,43
2019,213349,20,2,122,71,51
2019,213349,20,3,29,6,23
2019,213349,30,0,64,32,32
2019,213349,30,1,2,1,1
2019,213349,30,2,6,4,2
2019,213349,30,3,55,26,29
2019,213349,30,4,1,1,0
2019,213349,40,0,51,19,32
2019,213349,40,3,29,8,21
2019,213349,40,4,22,11,11
2019,213349,42,0,51,19,32
2019,213349,42,3,29,8,21
2019,213349,42,4,22,11,11
2019,213358,0,0,61,26,35
2019,213358,10,0,61,26,35
2019,213358,10,1,24,11,13
2019,213358,10,2,13,6,7
2019,213358,10,3,22,8,14
2019,213358,10,4,2,1,1
2019,213358,40,0,61,26,35
2019,213358,40,1,24,11,13
2019,213358,40,2,13,6,7
2019,213358,40,3,22,8,14
2019,213358,40,4,2,1,1
2019,213358,41,0,58,24,34
2019,213358,41,1,24,11,13
2019,213358,41,2,13,6,7
2019,213358,41,3,21,7,14
2019,213358,42,0,3,2,1
2019,213358,42,3,1,1,0
2019,213358,42,4,2,1,1
2019,213358,44,0,58,24,34
2019,213358,44,1,24,11,13
2019,213358,44,2,13,6,7
2019,213358,44,3,21,7,14
2019,213367,0,0,213,88,125
2019,213367,10,0,213,88,125
2019,213367,10,1,39,23,16
2019,213367,10,2,87,38,49
2019,213367,10,3,77,26,51
2019,213367,10,4,10,1,9
2019,213367,20,0,124,63,61
2019,213367,20,1,38,23,15
2019,213367,20,2,81,37,44
2019,213367,20,3,5,3,2
2019,213367,30,0,44,13,31
2019,213367,30,1,1,0,1
2019,213367,30,2,4,1,3
2019,213367,30,3,39,12,27
2019,213367,40,0,45,12,33
2019,213367,40,2,2,0,2
2019,213367,40,3,33,11,22
2019,213367,40,4,10,1,9
2019,213367,42,0,45,12,33
2019,213367,42,2,2,0,2
2019,213367,42,3,33,11,22
2019,213367,42,4,10,1,9
2019,213376,0,0,32,12,20
2019,213376,10,0,31,11,20
2019,213376,10,1,3,2,1
2019,213376,10,2,1,0,1
2019,213376,10,3,11,3,8
2019,213376,10,4,16,6,10
2019,213376,20,0,14,5,9
2019,213376,20,1,3,2,1
2019,213376,20,2,1,0,1
2019,213376,20,3,10,3,7
2019,213376,30,0,17,6,11
2019,213376,30,3,1,0,1
2019,213376,30,4,16,6,10
2019,213376,50,0,1,1,0
2019,213385,0,0,259,151,108
2019,213385,10,0,259,151,108
2019,213385,10,1,79,49,30
2019,213385,10,2,77,55,22
2019,213385,10,3,96,43,53
2019,213385,10,4,7,4,3
2019,213385,20,0,152,101,51
2019,213385,20,1,77,48,29
2019,213385,20,2,75,53,22
2019,213385,30,0,72,32,40
2019,213385,30,2,1,1,0
2019,213385,30,3,71,31,40
2019,213385,40,0,35,18,17
2019,213385,40,1,2,1,1
2019,213385,40,2,1,1,0
2019,213385,40,3,25,12,13
2019,213385,40,4,7,4,3
2019,213385,41,0,11,5,6
2019,213385,41,1,1,0,1
2019,213385,41,3,4,1,3
2019,213385,41,4,6,4,2
2019,213385,42,0,23,12,11
2019,213385,42,1,1,1,0
2019,213385,42,3,21,11,10
2019,213385,42,4,1,0,1
2019,213385,43,0,1,1,0
2019,213385,43,2,1,1,0
2019,213385,44,0,11,5,6
2019,213385,44,1,1,0,1
2019,213385,44,3,4,1,3
2019,213385,44,4,6,4,2
2019,213400,0,0,76,56,20
2019,213400,10,0,76,56,20
2019,213400,10,1,28,26,2
2019,213400,10,2,5,4,1
2019,213400,10,3,43,26,17
2019,213400,40,0,76,56,20
2019,213400,40,1,28,26,2
2019,213400,40,2,5,4,1
2019,213400,40,3,43,26,17
2019,213400,42,0,49,38,11
2019,213400,42,1,14,13,1
2019,213400,42,2,4,4,0
2019,213400,42,3,31,21,10
2019,213400,43,0,27,18,9
2019,213400,43,1,14,13,1
2019,213400,43,2,1,0,1
2019,213400,43,3,12,5,7
2019,213446,0,0,6,2,4
2019,213446,10,0,6,2,4
2019,213446,10,1,4,2,2
2019,213446,10,2,1,0,1
2019,213446,10,3,1,0,1
2019,213446,20,0,4,2,2
2019,213446,20,1,4,2,2
2019,213446,30,0,2,0,2
2019,213446,30,2,1,0,1
2019,213446,30,3,1,0,1
2019,213507,0,0,120,68,52
2019,213507,10,0,120,68,52
2019,213507,10,1,30,22,8
2019,213507,10,2,49,30,19
2019,213507,10,3,38,14,24
2019,213507,10,6,3,2,1
2019,213507,20,0,66,43,23
2019,213507,20,1,30,22,8
2019,213507,20,2,36,21,15
2019,213507,30,0,30,12,18
2019,213507,30,2,10,7,3
2019,213507,30,3,20,5,15
2019,213507,40,0,24,13,11
2019,213507,40,2,3,2,1
2019,213507,40,3,18,9,9
2019,213507,40,6,3,2,1
2019,213507,41,0,22,11,11
2019,213507,41,2,3,2,1
2019,213507,41,3,17,8,9
2019,213507,41,6,2,1,1
2019,213507,42,0,1,1,0
2019,213507,42,3,1,1,0
2019,213507,43,0,1,1,0
2019,213507,43,6,1,1,0
2019,213507,44,0,21,11,10
2019,213507,44,2,3,2,1
2019,213507,44,3,16,8,8
2019,213507,44,6,2,1,1
2019,213507,45,0,1,0,1
2019,213507,45,3,1,0,1
2019,213525,0,0,81,30,51
2019,213525,10,0,81,30,51
2019,213525,10,1,21,5,16
2019,213525,10,2,21,8,13
2019,213525,10,3,32,13,19
2019,213525,10,4,7,4,3
2019,213525,40,0,81,30,51
2019,213525,40,1,21,5,16
2019,213525,40,2,21,8,13
2019,213525,40,3,32,13,19
2019,213525,40,4,7,4,3
2019,213525,42,0,81,30,51
2019,213525,42,1,21,5,16
2019,213525,42,2,21,8,13
2019,213525,42,3,32,13,19
2019,213525,42,4,7,4,3
2019,213534,0,0,21,8,13
2019,213534,10,0,21,8,13
2019,213534,10,4,21,8,13
2019,213534,40,0,21,8,13
2019,213534,40,4,21,8,13
2019,213534,41,0,21,8,13
2019,213534,41,4,21,8,13
2019,213534,45,0,21,8,13
2019,213534,45,4,21,8,13
2019,213543,0,0,548,355,193
2019,213543,10,0,548,355,193
2019,213543,10,1,189,145,44
2019,213543,10,2,162,99,63
2019,213543,10,3,104,55,49
2019,213543,10,5,77,49,28
2019,213543,10,6,16,7,9
2019,213543,20,0,345,238,107
2019,213543,20,1,188,144,44
2019,213543,20,2,157,94,63
2019,213543,30,0,110,61,49
2019,213543,30,1,1,1,0
2019,213543,30,2,5,5,0
2019,213543,30,3,104,55,49
2019,213543,40,0,93,56,37
2019,213543,40,5,77,49,28
2019,213543,40,6,16,7,9
2019,213543,41,0,90,54,36
2019,213543,41,5,74,47,27
2019,213543,41,6,16,7,9
2019,213543,42,0,3,2,1
2019,213543,42,5,3,2,1
2019,213543,44,0,90,54,36
2019,213543,44,5,74,47,27
2019,213543,44,6,16,7,9
2019,213570,0,0,21,7,14
2019,213570,10,0,21,7,14
2019,213570,10,4,21,7,14
2019,213570,40,0,21,7,14
2019,213570,40,4,21,7,14
2019,213570,41,0,21,7,14
2019,213570,41,4,21,7,14
2019,213570,45,0,21,7,14
2019,213570,45,4,21,7,14
2019,213589,0,0,9,9,0
2019,213589,10,0,9,9,0
2019,213589,10,4,9,9,0
2019,213589,40,0,9,9,0
2019,213589,40,4,9,9,0
2019,213589,41,0,9,9,0
2019,213589,41,4,9,9,0
2019,213589,45,0,9,9,0
2019,213589,45,4,9,9,0
2019,213598,0,0,100,54,46
2019,213598,10,0,100,54,46
2019,213598,10,1,26,19,7
2019,213598,10,2,24,15,9
2019,213598,10,3,39,16,23
2019,213598,10,4,1,1,0
2019,213598,10,5,10,3,7
2019,213598,20,0,48,34,14
2019,213598,20,1,25,19,6
2019,213598,20,2,22,14,8
2019,213598,20,3,1,1,0
2019,213598,30,0,37,15,22
2019,213598,30,1,1,0,1
2019,213598,30,2,2,1,1
2019,213598,30,3,33,13,20
2019,213598,30,4,1,1,0
2019,213598,40,0,15,5,10
2019,213598,40,3,5,2,3
2019,213598,40,5,10,3,7
2019,213598,42,0,15,5,10
2019,213598,42,3,5,2,3
2019,213598,42,5,10,3,7
2019,213613,0,0,190,97,93
2019,213613,10,0,190,97,93
2019,213613,10,1,84,47,37
2019,213613,10,2,48,24,24
2019,213613,10,3,48,21,27
2019,213613,10,4,10,5,5
2019,213613,20,0,149,77,72
2019,213613,20,1,84,47,37
2019,213613,20,2,48,24,24
2019,213613,20,3,17,6,11
2019,213613,30,0,25,11,14
2019,213613,30,3,24,10,14
2019,213613,30,4,1,1,0
2019,213613,40,0,16,9,7
2019,213613,40,3,7,5,2
2019,213613,40,4,9,4,5
2019,213613,41,0,1,0,1
2019,213613,41,4,1,0,1
2019,213613,42,0,15,9,6
2019,213613,42,3,7,5,2
2019,213613,42,4,8,4,4
2019,213613,44,0,1,0,1
2019,213613,44,4,1,0,1
2019,213631,0,0,7,6,1
2019,213631,10,0,7,6,1
2019,213631,10,1,3,3,0
2019,213631,10,3,4,3,1
2019,213631,20,0,3,3,0
2019,213631,20,1,3,3,0
2019,213631,30,0,4,3,1
2019,213631,30,3,4,3,1
2019,213659,0,0,100,50,50
2019,213659,10,0,100,50,50
2019,213659,10,1,31,15,16
2019,213659,10,2,29,13,16
2019,213659,10,3,27,15,12
2019,213659,10,4,12,6,6
2019,213659,10,5,1,1,0
2019,213659,40,0,100,50,50
2019,213659,40,1,31,15,16
2019,213659,40,2,29,13,16
2019,213659,40,3,27,15,12
2019,213659,40,4,12,6,6
2019,213659,40,5,1,1,0
2019,213659,42,0,100,50,50
2019,213659,42,1,31,15,16
2019,213659,42,2,29,13,16
2019,213659,42,3,27,15,12
2019,213659,42,4,12,6,6
2019,213659,42,5,1,1,0
2019,213668,0,0,90,51,39
2019,213668,10,0,90,51,39
2019,213668,10,1,18,13,5
2019,213668,10,2,24,11,13
2019,213668,10,3,40,24,16
2019,213668,10,4,1,0,1
2019,213668,10,5,7,3,4
2019,213668,20,0,53,31,22
2019,213668,20,1,18,13,5
2019,213668,20,2,24,11,13
2019,213668,20,3,11,7,4
2019,213668,30,0,23,13,10
2019,213668,30,3,22,13,9
2019,213668,30,4,1,0,1
2019,213668,40,0,14,7,7
2019,213668,40,3,7,4,3
2019,213668,40,5,7,3,4
2019,213668,41,0,14,7,7
2019,213668,41,3,7,4,3
2019,213668,41,5,7,3,4
2019,213668,44,0,7,4,3
2019,213668,44,3,7,4,3
2019,213668,45,0,7,3,4
2019,213668,45,5,7,3,4
2019,213774,0,0,34,10,24
2019,213774,10,0,34,10,24
2019,213774,10,1,9,3,6
2019,213774,10,2,1,1,0
2019,213774,10,3,8,2,6
2019,213774,10,4,16,4,12
2019,213774,40,0,34,10,24
2019,213774,40,1,9,3,6
2019,213774,40,2,1,1,0
2019,213774,40,3,8,2,6
2019,213774,40,4,16,4,12
2019,213774,42,0,34,10,24
2019,213774,42,1,9,3,6
2019,213774,42,2,1,1,0
2019,213774,42,3,8,2,6
2019,213774,42,4,16,4,12
2019,213783,0,0,91,39,52
2019,213783,10,0,91,39,52
2019,213783,10,1,28,15,13
2019,213783,10,2,35,17,18
2019,213783,10,3,19,5,14
2019,213783,10,4,9,2,7
2019,213783,20,0,69,33,36
2019,213783,20,1,28,15,13
2019,213783,20,2,33,17,16
2019,213783,20,3,7,1,6
2019,213783,20,4,1,0,1
2019,213783,30,0,16,4,12
2019,213783,30,2,2,0,2
2019,213783,30,3,12,4,8
2019,213783,30,4,2,0,2
2019,213783,40,0,6,2,4
2019,213783,40,4,6,2,4
2019,213783,42,0,6,2,4
2019,213783,42,4,6,2,4
2019,213826,0,0,151,56,95
2019,213826,10,0,151,56,95
2019,213826,10,1,15,11,4
2019,213826,10,2,56,22,34
2019,213826,10,3,50,15,35
2019,213826,10,4,30,8,22
2019,213826,20,0,67,35,32
2019,213826,20,1,15,11,4
2019,213826,20,2,50,22,28
2019,213826,20,3,2,2,0
2019,213826,30,0,29,8,21
2019,213826,30,2,3,0,3
2019,213826,30,3,26,8,18
2019,213826,40,0,55,13,42
2019,213826,40,2,3,0,3
2019,213826,40,3,22,5,17
2019,213826,40,4,30,8,22
2019,213826,42,0,55,13,42
2019,213826,42,2,3,0,3
2019,213826,42,3,22,5,17
2019,213826,42,4,30,8,22
2019,213914,0,0,10,0,10
2019,213914,50,0,10,0,10
2019,213987,0,0,139,77,62
2019,213987,10,0,139,77,62
2019,213987,10,1,24,18,6
2019,213987,10,2,40,23,17
2019,213987,10,3,56,27,29
2019,213987,10,4,12,5,7
2019,213987,10,5,7,4,3
2019,213987,20,0,63,40,23
2019,213987,20,1,23,17,6
2019,213987,20,2,40,23,17
2019,213987,30,0,35,17,18
2019,213987,30,3,35,17,18
2019,213987,40,0,41,20,21
2019,213987,40,1,1,1,0
2019,213987,40,3,21,10,11
2019,213987,40,4,12,5,7
2019,213987,40,5,7,4,3
2019,213987,42,0,41,20,21
2019,213987,42,1,1,1,0
2019,213987,42,3,21,10,11
2019,213987,42,4,12,5,7
2019,213987,42,5,7,4,3
2019,213996,0,0,201,116,85
2019,213996,10,0,201,116,85
2019,213996,10,1,81,61,20
2019,213996,10,2,48,25,23
2019,213996,10,3,49,22,27
2019,213996,10,5,23,8,15
2019,213996,20,0,121,81,40
2019,213996,20,1,78,59,19
2019,213996,20,2,42,22,20
2019,213996,20,3,1,0,1
2019,213996,30,0,42,24,18
2019,213996,30,1,3,2,1
2019,213996,30,2,3,3,0
2019,213996,30,3,36,19,17
2019,213996,40,0,38,11,27
2019,213996,40,2,3,0,3
2019,213996,40,3,12,3,9
2019,213996,40,5,23,8,15
2019,213996,41,0,13,1,12
2019,213996,41,2,3,0,3
2019,213996,41,3,10,1,9
2019,213996,42,0,25,10,15
2019,213996,42,3,2,2,0
2019,213996,42,5,23,8,15
2019,213996,45,0,13,1,12
2019,213996,45,2,3,0,3
2019,213996,45,3,10,1,9
2019,214041,0,0,274,141,133
2019,214041,10,0,274,141,133
2019,214041,10,1,85,51,34
2019,214041,10,2,106,51,55
2019,214041,10,3,81,39,42
2019,214041,10,4,2,0,2
2019,214041,20,0,217,117,100
2019,214041,20,1,85,51,34
2019,214041,20,2,105,51,54
2019,214041,20,3,27,15,12
2019,214041,30,0,52,22,30
2019,214041,30,2,1,0,1
2019,214041,30,3,49,22,27
2019,214041,30,4,2,0,2
2019,214041,40,0,5,2,3
2019,214041,40,3,5,2,3
2019,214041,42,0,5,2,3
2019,214041,42,3,5,2,3
2019,214069,0,0,144,58,86
2019,214069,10,0,144,58,86
2019,214069,10,1,26,14,12
2019,214069,10,2,37,19,18
2019,214069,10,3,76,22,54
2019,214069,10,4,5,3,2
2019,214069,20,0,60,31,29
2019,214069,20,1,26,14,12
2019,214069,20,2,34,17,17
2019,214069,30,0,38,17,21
2019,214069,30,2,3,2,1
2019,214069,30,3,35,15,20
2019,214069,40,0,46,10,36
2019,214069,40,3,41,7,34
2019,214069,40,4,5,3,2
2019,214069,42,0,46,10,36
2019,214069,42,3,41,7,34
2019,214069,42,4,5,3,2
2019,214111,0,0,164,63,101
2019,214111,10,0,164,63,101
2019,214111,10,1,14,7,7
2019,214111,10,2,36,8,28
2019,214111,10,3,75,30,45
2019,214111,10,4,34,17,17
2019,214111,10,5,2,0,2
2019,214111,10,6,3,1,2
2019,214111,20,0,110,41,69
2019,214111,20,1,14,7,7
2019,214111,20,2,34,8,26
2019,214111,20,3,62,26,36
2019,214111,30,0,46,20,26
2019,214111,30,2,2,0,2
2019,214111,30,3,13,4,9
2019,214111,30,4,31,16,15
2019,214111,40,0,8,2,6
2019,214111,40,4,3,1,2
2019,214111,40,5,2,0,2
2019,214111,40,6,3,1,2
2019,214111,43,0,8,2,6
2019,214111,43,4,3,1,2
2019,214111,43,5,2,0,2
2019,214111,43,6,3,1,2
2019,214148,0,0,25,9,16
2019,214148,10,0,25,9,16
2019,214148,10,1,4,0,4
2019,214148,10,2,9,6,3
2019,214148,10,3,10,3,7
2019,214148,10,4,2,0,2
2019,214148,20,0,1,0,1
2019,214148,20,1,1,0,1
2019,214148,40,0,24,9,15
2019,214148,40,1,3,0,3
2019,214148,40,2,9,6,3
2019,214148,40,3,10,3,7
2019,214148,40,4,2,0,2
2019,214148,41,0,20,7,13
2019,214148,41,1,3,0,3
2019,214148,41,2,8,5,3
2019,214148,41,3,9,2,7
2019,214148,42,0,4,2,2
2019,214148,42,2,1,1,0
2019,214148,42,3,1,1,0
2019,214148,42,4,2,0,2
2019,214148,44,0,20,7,13
2019,214148,44,1,3,0,3
2019,214148,44,2,8,5,3
2019,214148,44,3,9,2,7
2019,214157,0,0,153,54,99
2019,214157,10,0,153,54,99
2019,214157,10,1,31,19,12
2019,214157,10,2,53,15,38
2019,214157,10,3,49,15,34
2019,214157,10,4,14,4,10
2019,214157,10,5,6,1,5
2019,214157,20,0,75,34,41
2019,214157,20,1,31,19,12
2019,214157,20,2,44,15,29
2019,214157,30,0,53,13,40
2019,214157,30,2,7,0,7
2019,214157,30,3,42,12,30
2019,214157,30,4,4,1,3
2019,214157,40,0,25,7,18
2019,214157,40,2,2,0,2
2019,214157,40,3,7,3,4
2019,214157,40,4,10,3,7
2019,214157,40,5,6,1,5
2019,214157,41,0,20,6,14
2019,214157,41,2,2,0,2
2019,214157,41,3,7,3,4
2019,214157,41,4,5,2,3
2019,214157,41,5,6,1,5
2019,214157,42,0,5,1,4
2019,214157,42,4,5,1,4
2019,214157,45,0,20,6,14
2019,214157,45,2,2,0,2
2019,214157,45,3,7,3,4
2019,214157,45,4,5,2,3
2019,214157,45,5,6,1,5
2019,214166,0,0,61,19,42
2019,214166,10,0,61,19,42
2019,214166,10,1,10,2,8
2019,214166,10,2,17,6,11
2019,214166,10,3,19,8,11
2019,214166,10,4,15,3,12
2019,214166,40,0,61,19,42
2019,214166,40,1,10,2,8
2019,214166,40,2,17,6,11
2019,214166,40,3,19,8,11
2019,214166,40,4,15,3,12
2019,214166,42,0,61,19,42
2019,214166,42,1,10,2,8
2019,214166,42,2,17,6,11
2019,214166,42,3,19,8,11
2019,214166,42,4,15,3,12
2019,214175,0,0,184,97,87
2019,214175,10,0,184,97,87
2019,214175,10,1,59,41,18
2019,214175,10,2,39,17,22
2019,214175,10,3,55,26,29
2019,214175,10,5,30,12,18
2019,214175,10,6,1,1,0
2019,214175,20,0,97,57,40
2019,214175,20,1,58,40,18
2019,214175,20,2,39,17,22
2019,214175,30,0,48,22,26
2019,214175,30,1,1,1,0
2019,214175,30,3,47,21,26
2019,214175,40,0,39,18,21
2019,214175,40,3,8,5,3
2019,214175,40,5,30,12,18
2019,214175,40,6,1,1,0
2019,214175,41,0,16,8,8
2019,214175,41,3,3,1,2
2019,214175,41,5,12,6,6
2019,214175,41,6,1,1,0
2019,214175,42,0,23,10,13
2019,214175,42,3,5,4,1
2019,214175,42,5,18,6,12
2019,214175,44,0,16,8,8
2019,214175,44,3,3,1,2
2019,214175,44,5,12,6,6
2019,214175,44,6,1,1,0
2019,214272,0,0,96,40,56
2019,214272,10,0,96,40,56
2019,214272,10,1,22,12,10
2019,214272,10,2,30,12,18
2019,214272,10,3,39,14,25
2019,214272,10,4,5,2,3
2019,214272,40,0,96,40,56
2019,214272,40,1,22,12,10
2019,214272,40,2,30,12,18
2019,214272,40,3,39,14,25
2019,214272,40,4,5,2,3
2019,214272,41,0,77,30,47
2019,214272,41,1,22,12,10
2019,214272,41,2,28,10,18
2019,214272,41,3,23,7,16
2019,214272,41,4,4,1,3
2019,214272,42,0,19,10,9
2019,214272,42,2,2,2,0
2019,214272,42,3,16,7,9
2019,214272,42,4,1,1,0
2019,214272,44,0,77,30,47
2019,214272,44,1,22,12,10
2019,214272,44,2,28,10,18
2019,214272,44,3,23,7,16
2019,214272,44,4,4,1,3
2019,214290,0,0,31,28,3
2019,214290,10,0,31,28,3
2019,214290,10,4,31,28,3
2019,214290,40,0,31,28,3
2019,214290,40,4,31,28,3
2019,214290,41,0,31,28,3
2019,214290,41,4,31,28,3
2019,214290,45,0,31,28,3
2019,214290,45,4,31,28,3
2019,214379,0,0,125,49,76
2019,214379,10,0,123,47,76
2019,214379,10,1,55,26,29
2019,214379,10,2,23,11,12
2019,214379,10,3,39,9,30
2019,214379,10,4,6,1,5
2019,214379,20,0,84,39,45
2019,214379,20,1,55,26,29
2019,214379,20,2,20,9,11
2019,214379,20,3,9,4,5
2019,214379,30,0,35,7,28
2019,214379,30,2,3,2,1
2019,214379,30,3,27,4,23
2019,214379,30,4,5,1,4
2019,214379,40,0,4,1,3
2019,214379,40,3,3,1,2
2019,214379,40,4,1,0,1
2019,214379,43,0,4,1,3
2019,214379,43,3,3,1,2
2019,214379,43,4,1,0,1
2019,214379,50,0,2,2,0
2019,214528,0,0,10,9,1
2019,214528,10,0,10,9,1
2019,214528,10,6,10,9,1
2019,214528,40,0,10,9,1
2019,214528,40,6,10,9,1
2019,214528,41,0,10,9,1
2019,214528,41,6,10,9,1
2019,214528,45,0,10,9,1
2019,214528,45,6,10,9,1
2019,214564,0,0,92,22,70
2019,214564,10,0,79,21,58
2019,214564,10,1,7,3,4
2019,214564,10,2,17,6,11
2019,214564,10,3,44,9,35
2019,214564,10,4,11,3,8
2019,214564,20,0,14,4,10
2019,214564,20,1,6,2,4
2019,214564,20,2,8,2,6
2019,214564,30,0,9,3,6
2019,214564,30,1,1,1,0
2019,214564,30,2,2,1,1
2019,214564,30,3,6,1,5
2019,214564,40,0,56,14,42
2019,214564,40,2,7,3,4
2019,214564,40,3,38,8,30
2019,214564,40,4,11,3,8
2019,214564,42,0,56,14,42
2019,214564,42,2,7,3,4
2019,214564,42,3,38,8,30
2019,214564,42,4,11,3,8
2019,214564,50,0,13,1,12
2019,214582,0,0,16,6,10
2019,214582,10,0,16,6,10
2019,214582,10,4,16,6,10
2019,214582,40,0,16,6,10
2019,214582,40,4,16,6,10
2019,214582,41,0,16,6,10
2019,214582,41,4,16,6,10
2019,214582,45,0,16,6,10
2019,214582,45,4,16,6,10
2019,214777,0,0,5914,3337,2577
2019,214777,10,0,5795,3265,2530
2019,214777,10,1,1444,1052,392
2019,214777,10,2,1535,876,659
2019,214777,10,3,2184,1064,1120
2019,214777,10,4,226,82,144
2019,214777,10,5,400,185,215
2019,214777,10,6,6,6,0
2019,214777,20,0,2144,1457,687
2019,214777,20,1,1190,883,307
2019,214777,20,2,943,565,378
2019,214777,20,3,11,9,2
2019,214777,30,0,883,476,407
2019,214777,30,1,6,5,1
2019,214777,30,2,57,33,24
2019,214777,30,3,820,438,382
2019,214777,40,0,2768,1332,1436
2019,214777,40,1,248,164,84
2019,214777,40,2,535,278,257
2019,214777,40,3,1353,617,736
2019,214777,40,4,226,82,144
2019,214777,40,5,400,185,215
2019,214777,40,6,6,6,0
2019,214777,41,0,1091,500,591
2019,214777,41,1,112,64,48
2019,214777,41,2,266,121,145
2019,214777,41,3,465,200,265
2019,214777,41,4,55,23,32
2019,214777,41,5,192,91,101
2019,214777,41,6,1,1,0
2019,214777,42,0,1674,830,844
2019,214777,42,1,136,100,36
2019,214777,42,2,269,157,112
2019,214777,42,3,886,415,471
2019,214777,42,4,171,59,112
2019,214777,42,5,207,94,113
2019,214777,42,6,5,5,0
2019,214777,43,0,3,2,1
2019,214777,43,3,2,2,0
2019,214777,43,5,1,0,1
2019,214777,44,0,1022,458,564
2019,214777,44,1,104,60,44
2019,214777,44,2,255,113,142
2019,214777,44,3,424,177,247
2019,214777,44,4,52,22,30
2019,214777,44,5,187,86,101
2019,214777,45,0,69,42,27
2019,214777,45,1,8,4,4
2019,214777,45,2,11,8,3
2019,214777,45,3,41,23,18
2019,214777,45,4,3,1,2
2019,214777,45,5,5,5,0
2019,214777,45,6,1,1,0
2019,214777,50,0,119,72,47
2019,214883,0,0,27,13,14
2019,214883,10,0,27,13,14
2019,214883,10,1,13,6,7
2019,214883,10,2,11,5,6
2019,214883,10,3,3,2,1
2019,214883,40,0,27,13,14
2019,214883,40,1,13,6,7
2019,214883,40,2,11,5,6
2019,214883,40,3,3,2,1
2019,214883,41,0,27,13,14
2019,214883,41,1,13,6,7
2019,214883,41,2,11,5,6
2019,214883,41,3,3,2,1
2019,214883,45,0,27,13,14
2019,214883,45,1,13,6,7
2019,214883,45,2,11,5,6
2019,214883,45,3,3,2,1
2019,214892,0,0,32,16,16
2019,214892,10,0,32,16,16
2019,214892,10,4,32,16,16
2019,214892,40,0,32,16,16
2019,214892,40,4,32,16,16
2019,214892,43,0,32,16,16
2019,214892,43,4,32,16,16
2019,214944,0,0,18,15,3
2019,214944,10,0,18,15,3
2019,214944,10,4,18,15,3
2019,214944,40,0,18,15,3
2019,214944,40,4,18,15,3
2019,214944,41,0,18,15,3
2019,214944,41,4,18,15,3
2019,214944,45,0,18,15,3
2019,214944,45,4,18,15,3
2019,214971,0,0,12,7,5
2019,214971,10,0,12,7,5
2019,214971,10,1,8,6,2
2019,214971,10,2,3,1,2
2019,214971,10,3,1,0,1
2019,214971,40,0,12,7,5
2019,214971,40,1,8,6,2
2019,214971,40,2,3,1,2
2019,214971,40,3,1,0,1
2019,214971,41,0,2,0,2
2019,214971,41,2,1,0,1
2019,214971,41,3,1,0,1
2019,214971,42,0,10,7,3
2019,214971,42,1,8,6,2
2019,214971,42,2,2,1,1
2019,214971,45,0,2,0,2
2019,214971,45,2,1,0,1
2019,214971,45,3,1,0,1
2019,215053,0,0,13,7,6
2019,215053,10,0,13,7,6
2019,215053,10,2,2,2,0
2019,215053,10,3,11,5,6
2019,215053,40,0,13,7,6
2019,215053,40,2,2,2,0
2019,215053,40,3,11,5,6
2019,215053,41,0,13,7,6
2019,215053,41,2,2,2,0
2019,215053,41,3,11,5,6
2019,215053,44,0,13,7,6
2019,215053,44,2,2,2,0
2019,215053,44,3,11,5,6
2019,215062,0,0,2250,1390,860
2019,215062,10,0,2187,1358,829
2019,215062,10,1,938,714,224
2019,215062,10,2,338,221,117
2019,215062,10,3,403,215,188
2019,215062,10,4,156,63,93
2019,215062,10,5,352,145,207
2019,215062,20,0,1267,930,337
2019,215062,20,1,938,714,224
2019,215062,20,2,329,216,113
2019,215062,30,0,412,220,192
2019,215062,30,2,9,5,4
2019,215062,30,3,403,215,188
2019,215062,40,0,508,208,300
2019,215062,40,4,156,63,93
2019,215062,40,5,352,145,207
2019,215062,41,0,164,60,104
2019,215062,41,5,164,60,104
2019,215062,42,0,344,148,196
2019,215062,42,4,156,63,93
2019,215062,42,5,188,85,103
2019,215062,44,0,164,60,104
2019,215062,44,5,164,60,104
2019,215062,50,0,63,32,31
2019,215105,0,0,104,60,44
2019,215105,10,0,104,60,44
2019,215105,10,1,15,10,5
2019,215105,10,2,43,24,19
2019,215105,10,3,44,25,19
2019,215105,10,6,2,1,1
2019,215105,20,0,12,7,5
2019,215105,20,1,6,2,4
2019,215105,20,2,6,5,1
2019,215105,40,0,92,53,39
2019,215105,40,1,9,8,1
2019,215105,40,2,37,19,18
2019,215105,40,3,44,25,19
2019,215105,40,6,2,1,1
2019,215105,41,0,75,43,32
2019,215105,41,1,9,8,1
2019,215105,41,2,36,19,17
2019,215105,41,3,30,16,14
2019,215105,42,0,17,10,7
2019,215105,42,2,1,0,1
2019,215105,42,3,14,9,5
2019,215105,42,6,2,1,1
2019,215105,44,0,75,43,32
2019,215105,44,1,9,8,1
2019,215105,44,2,36,19,17
2019,215105,44,3,30,16,14
2019,215114,0,0,47,32,15
2019,215114,10,0,47,32,15
2019,215114,10,1,19,11,8
2019,215114,10,2,16,14,2
2019,215114,10,3,11,7,4
2019,215114,10,4,1,0,1
2019,215114,40,0,47,32,15
2019,215114,40,1,19,11,8
2019,215114,40,2,16,14,2
2019,215114,40,3,11,7,4
2019,215114,40,4,1,0,1
2019,215114,41,0,26,17,9
2019,215114,41,1,15,8,7
2019,215114,41,2,8,7,1
2019,215114,41,3,3,2,1
2019,215114,42,0,21,15,6
2019,215114,42,1,4,3,1
2019,215114,42,2,8,7,1
2019,215114,42,3,8,5,3
2019,215114,42,4,1,0,1
2019,215114,44,0,26,17,9
2019,215114,44,1,15,8,7
2019,215114,44,2,8,7,1
2019,215114,44,3,3,2,1
2019,215123,0,0,196,103,93
2019,215123,10,0,196,103,93
2019,215123,10,1,66,45,21
2019,215123,10,2,67,37,30
2019,215123,10,3,55,17,38
2019,215123,10,4,8,4,4
2019,215123,20,0,26,13,13
2019,215123,20,1,25,12,13
2019,215123,20,2,1,1,0
2019,215123,30,0,102,65,37
2019,215123,30,1,38,30,8
2019,215123,30,2,64,35,29
2019,215123,40,0,68,25,43
2019,215123,40,1,3,3,0
2019,215123,40,2,2,1,1
2019,215123,40,3,55,17,38
2019,215123,40,4,8,4,4
2019,215123,42,0,68,25,43
2019,215123,42,1,3,3,0
2019,215123,42,2,2,1,1
2019,215123,42,3,55,17,38
2019,215123,42,4,8,4,4
2019,215132,0,0,162,78,84
2019,215132,10,0,162,78,84
2019,215132,10,1,27,19,8
2019,215132,10,2,47,19,28
2019,215132,10,3,72,31,41
2019,215132,10,4,11,7,4
2019,215132,10,5,5,2,3
2019,215132,20,0,47,29,18
2019,215132,20,1,25,17,8
2019,215132,20,2,22,12,10
2019,215132,30,0,26,13,13
2019,215132,30,2,5,2,3
2019,215132,30,3,21,11,10
2019,215132,40,0,89,36,53
2019,215132,40,1,2,2,0
2019,215132,40,2,20,5,15
2019,215132,40,3,51,20,31
2019,215132,40,4,11,7,4
2019,215132,40,5,5,2,3
2019,215132,41,0,28,12,16
2019,215132,41,2,13,4,9
2019,215132,41,3,12,7,5
2019,215132,41,5,3,1,2
2019,215132,42,0,61,24,37
2019,215132,42,1,2,2,0
2019,215132,42,2,7,1,6
2019,215132,42,3,39,13,26
2019,215132,42,4,11,7,4
2019,215132,42,5,2,1,1
2019,215132,44,0,28,12,16
2019,215132,44,2,13,4,9
2019,215132,44,3,12,7,5
2019,215132,44,5,3,1,2
2019,215239,0,0,336,151,185
2019,215239,10,0,336,151,185
2019,215239,10,1,13,7,6
2019,215239,10,2,63,24,39
2019,215239,10,3,223,109,114
2019,215239,10,4,14,5,9
2019,215239,10,5,23,6,17
2019,215239,20,0,257,125,132
2019,215239,20,1,13,7,6
2019,215239,20,2,61,23,38
2019,215239,20,3,183,95,88
2019,215239,30,0,56,20,36
2019,215239,30,2,2,1,1
2019,215239,30,3,40,14,26
2019,215239,30,4,14,5,9
2019,215239,40,0,23,6,17
2019,215239,40,5,23,6,17
2019,215239,43,0,23,6,17
2019,215239,43,5,23,6,17
2019,215266,0,0,76,48,28
2019,215266,10,0,76,48,28
2019,215266,10,1,8,6,2
2019,215266,10,2,27,17,10
2019,215266,10,3,31,21,10
2019,215266,10,4,9,4,5
2019,215266,10,5,1,0,1
2019,215266,20,0,32,22,10
2019,215266,20,1,8,6,2
2019,215266,20,2,24,16,8
2019,215266,30,0,13,6,7
2019,215266,30,3,13,6,7
2019,215266,40,0,31,20,11
2019,215266,40,2,3,1,2
2019,215266,40,3,18,15,3
2019,215266,40,4,9,4,5
2019,215266,40,5,1,0,1
2019,215266,41,0,22,12,10
2019,215266,41,2,3,1,2
2019,215266,41,3,11,8,3
2019,215266,41,4,7,3,4
2019,215266,41,5,1,0,1
2019,215266,43,0,9,8,1
2019,215266,43,3,7,7,0
2019,215266,43,4,2,1,1
2019,215266,44,0,22,12,10
2019,215266,44,2,3,1,2
2019,215266,44,3,11,8,3
2019,215266,44,4,7,3,4
2019,215266,44,5,1,0,1
2019,215275,0,0,78,36,42
2019,215275,10,0,78,36,42
2019,215275,10,1,7,5,2
2019,215275,10,2,31,13,18
2019,215275,10,3,18,8,10
2019,215275,10,4,21,9,12
2019,215275,10,6,1,1,0
2019,215275,20,0,32,16,16
2019,215275,20,1,6,4,2
2019,215275,20,2,26,12,14
2019,215275,30,0,5,4,1
2019,215275,30,3,5,4,1
2019,215275,40,0,41,16,25
2019,215275,40,1,1,1,0
2019,215275,40,2,5,1,4
2019,215275,40,3,13,4,9
2019,215275,40,4,21,9,12
2019,215275,40,6,1,1,0
2019,215275,41,0,24,6,18
2019,215275,41,1,1,1,0
2019,215275,41,2,5,1,4
2019,215275,41,3,12,3,9
2019,215275,41,4,6,1,5
2019,215275,43,0,17,10,7
2019,215275,43,3,1,1,0
2019,215275,43,4,15,8,7
2019,215275,43,6,1,1,0
2019,215275,44,0,24,6,18
2019,215275,44,1,1,1,0
2019,215275,44,2,5,1,4
2019,215275,44,3,12,3,9
2019,215275,44,4,6,1,5
2019,215284,0,0,142,76,66
2019,215284,10,0,142,76,66
2019,215284,10,1,16,13,3
2019,215284,10,2,54,31,23
2019,215284,10,3,44,24,20
2019,215284,10,4,28,8,20
2019,215284,20,0,67,42,25
2019,215284,20,1,16,13,3
2019,215284,20,2,51,29,22
2019,215284,30,0,17,8,9
2019,215284,30,3,16,8,8
2019,215284,30,4,1,0,1
2019,215284,40,0,58,26,32
2019,215284,40,2,3,2,1
2019,215284,40,3,28,16,12
2019,215284,40,4,27,8,19
2019,215284,41,0,52,26,26
2019,215284,41,2,3,2,1
2019,215284,41,3,27,16,11
2019,215284,41,4,22,8,14
2019,215284,43,0,6,0,6
2019,215284,43,3,1,0,1
2019,215284,43,4,5,0,5
2019,215284,44,0,52,26,26
2019,215284,44,2,3,2,1
2019,215284,44,3,27,16,11
2019,215284,44,4,22,8,14
2019,215293,0,0,4259,2419,1840
2019,215293,10,0,4259,2419,1840
2019,215293,10,1,1059,776,283
2019,215293,10,2,1012,586,426
2019,215293,10,3,1709,863,846
2019,215293,10,4,218,84,134
2019,215293,10,5,261,110,151
2019,215293,20,0,1163,812,351
2019,215293,20,1,749,563,186
2019,215293,20,2,414,249,165
2019,215293,30,0,453,267,186
2019,215293,30,1,4,2,2
2019,215293,30,2,29,13,16
2019,215293,30,3,420,252,168
2019,215293,40,0,2643,1340,1303
2019,215293,40,1,306,211,95
2019,215293,40,2,569,324,245
2019,215293,40,3,1289,611,678
2019,215293,40,4,218,84,134
2019,215293,40,5,261,110,151
2019,215293,41,0,807,355,452
2019,215293,41,1,76,49,27
2019,215293,41,2,111,56,55
2019,215293,41,3,373,157,216
2019,215293,41,4,58,19,39
2019,215293,41,5,189,74,115
2019,215293,42,0,1614,884,730
2019,215293,42,1,214,151,63
2019,215293,42,2,429,254,175
2019,215293,42,3,853,429,424
2019,215293,42,4,110,47,63
2019,215293,42,5,8,3,5
2019,215293,43,0,222,101,121
2019,215293,43,1,16,11,5
2019,215293,43,2,29,14,15
2019,215293,43,3,63,25,38
2019,215293,43,4,50,18,32
2019,215293,43,5,64,33,31
2019,215293,44,0,807,355,452
2019,215293,44,1,76,49,27
2019,215293,44,2,111,56,55
2019,215293,44,3,373,157,216
2019,215293,44,4,58,19,39
2019,215293,44,5,189,74,115
2019,215309,0,0,22,8,14
2019,215309,10,0,22,8,14
2019,215309,10,1,1,1,0
2019,215309,10,2,4,3,1
2019,215309,10,3,11,4,7
2019,215309,10,4,6,0,6
2019,215309,20,0,5,4,1
2019,215309,20,1,1,1,0
2019,215309,20,2,4,3,1
2019,215309,40,0,17,4,13
2019,215309,40,3,11,4,7
2019,215309,40,4,6,0,6
2019,215309,41,0,2,1,1
2019,215309,41,3,1,1,0
2019,215309,41,4,1,0,1
2019,215309,42,0,4,0,4
2019,215309,42,3,1,0,1
2019,215309,42,4,3,0,3
2019,215309,43,0,11,3,8
2019,215309,43,3,9,3,6
2019,215309,43,4,2,0,2
2019,215309,44,0,2,1,1
2019,215309,44,3,1,1,0
2019,215309,44,4,1,0,1
2019,215381,0,0,45,41,4
2019,215381,50,0,45,41,4
2019,215415,0,0,73,42,31
2019,215415,10,0,73,42,31
2019,215415,10,4,73,42,31
2019,215415,40,0,73,42,31
2019,215415,40,4,73,42,31
2019,215415,41,0,73,42,31
2019,215415,41,4,73,42,31
2019,215415,45,0,73,42,31
2019,215415,45,4,73,42,31
2019,215424,0,0,14,11,3
2019,215424,10,0,14,11,3
2019,215424,10,1,8,7,1
2019,215424,10,2,4,2,2
2019,215424,10,3,2,2,0
2019,215424,20,0,9,7,2
2019,215424,20,1,8,7,1
2019,215424,20,2,1,0,1
2019,215424,30,0,4,3,1
2019,215424,30,2,3,2,1
2019,215424,30,3,1,1,0
2019,215424,40,0,1,1,0
2019,215424,40,3,1,1,0
2019,215424,42,0,1,1,0
2019,215424,42,3,1,1,0
2019,215442,0,0,154,79,75
2019,215442,10,0,146,75,71
2019,215442,10,1,59,33,26
2019,215442,10,2,35,17,18
2019,215442,10,3,35,18,17
2019,215442,10,5,12,5,7
2019,215442,10,6,5,2,3
2019,215442,20,0,91,49,42
2019,215442,20,1,59,33,26
2019,215442,20,2,32,16,16
2019,215442,30,0,38,19,19
2019,215442,30,2,3,1,2
2019,215442,30,3,35,18,17
2019,215442,40,0,17,7,10
2019,215442,40,5,12,5,7
2019,215442,40,6,5,2,3
2019,215442,43,0,17,7,10
2019,215442,43,5,12,5,7
2019,215442,43,6,5,2,3
2019,215442,50,0,8,4,4
2019,215585,0,0,61,16,45
2019,215585,10,0,58,15,43
2019,215585,10,1,11,4,7
2019,215585,10,2,16,3,13
2019,215585,10,3,19,4,15
2019,215585,10,4,12,4,8
2019,215585,40,0,58,15,43
2019,215585,40,1,11,4,7
2019,215585,40,2,16,3,13
2019,215585,40,3,19,4,15
2019,215585,40,4,12,4,8
2019,215585,41,0,55,14,41
2019,215585,41,1,11,4,7
2019,215585,41,2,16,3,13
2019,215585,41,3,19,4,15
2019,215585,41,4,9,3,6
2019,215585,43,0,3,1,2
2019,215585,43,4,3,1,2
2019,215585,44,0,55,14,41
2019,215585,44,1,11,4,7
2019,215585,44,2,16,3,13
2019,215585,44,3,19,4,15
2019,215585,44,4,9,3,6
2019,215585,50,0,3,1,2
2019,215619,0,0,5,2,3
2019,215619,10,0,5,2,3
2019,215619,10,1,3,2,1
2019,215619,10,2,1,0,1
2019,215619,10,3,1,0,1
2019,215619,20,0,4,2,2
2019,215619,20,1,3,2,1
2019,215619,20,2,1,0,1
2019,215619,40,0,1,0,1
2019,215619,40,3,1,0,1
2019,215619,41,0,1,0,1
2019,215619,41,3,1,0,1
2019,215619,44,0,1,0,1
2019,215619,44,3,1,0,1
2019,215637,0,0,17,12,5
2019,215637,10,0,17,12,5
2019,215637,10,4,17,12,5
2019,215637,40,0,17,12,5
2019,215637,40,4,17,12,5
2019,215637,41,0,17,12,5
2019,215637,41,4,17,12,5
2019,215637,45,0,17,12,5
2019,215637,45,4,17,12,5
2019,215655,0,0,196,101,95
2019,215655,10,0,196,101,95
2019,215655,10,1,90,52,38
2019,215655,10,2,62,30,32
2019,215655,10,3,35,16,19
2019,215655,10,5,9,3,6
2019,215655,20,0,161,87,74
2019,215655,20,1,89,51,38
2019,215655,20,2,54,26,28
2019,215655,20,3,18,10,8
2019,215655,30,0,26,11,15
2019,215655,30,1,1,1,0
2019,215655,30,2,8,4,4
2019,215655,30,3,17,6,11
2019,215655,40,0,9,3,6
2019,215655,40,5,9,3,6
2019,215655,41,0,6,2,4
2019,215655,41,5,6,2,4
2019,215655,42,0,3,1,2
2019,215655,42,5,3,1,2
2019,215655,44,0,6,2,4
2019,215655,44,5,6,2,4
2019,215682,0,0,28,28,0
2019,215682,10,0,28,28,0
2019,215682,10,4,28,28,0
2019,215682,40,0,28,28,0
2019,215682,40,4,28,28,0
2019,215682,41,0,28,28,0
2019,215682,41,4,28,28,0
2019,215682,45,0,28,28,0
2019,215682,45,4,28,28,0
2019,215691,0,0,28,12,16
2019,215691,10,0,28,12,16
2019,215691,10,1,2,1,1
2019,215691,10,2,10,5,5
2019,215691,10,3,16,6,10
2019,215691,20,0,10,5,5
2019,215691,20,1,2,1,1
2019,215691,20,2,8,4,4
2019,215691,30,0,3,1,2
2019,215691,30,3,3,1,2
2019,215691,40,0,15,6,9
2019,215691,40,2,2,1,1
2019,215691,40,3,13,5,8
2019,215691,41,0,12,5,7
2019,215691,41,2,2,1,1
2019,215691,41,3,10,4,6
2019,215691,42,0,3,1,2
2019,215691,42,3,3,1,2
2019,215691,44,0,12,5,7
2019,215691,44,2,2,1,1
2019,215691,44,3,10,4,6
2019,215743,0,0,117,52,65
2019,215743,10,0,114,50,64
2019,215743,10,1,29,20,9
2019,215743,10,2,40,16,24
2019,215743,10,3,38,13,25
2019,215743,10,4,7,1,6
2019,215743,20,0,53,32,21
2019,215743,20,1,29,20,9
2019,215743,20,2,24,12,12
2019,215743,30,0,25,9,16
2019,215743,30,2,6,2,4
2019,215743,30,3,17,7,10
2019,215743,30,4,2,0,2
2019,215743,40,0,36,9,27
2019,215743,40,2,10,2,8
2019,215743,40,3,21,6,15
2019,215743,40,4,5,1,4
2019,215743,41,0,34,8,26
2019,215743,41,2,10,2,8
2019,215743,41,3,19,5,14
2019,215743,41,4,5,1,4
2019,215743,42,0,2,1,1
2019,215743,42,3,2,1,1
2019,215743,45,0,34,8,26
2019,215743,45,2,10,2,8
2019,215743,45,3,19,5,14
2019,215743,45,4,5,1,4
2019,215743,50,0,3,2,1
2019,215770,0,0,299,161,138
2019,215770,10,0,299,161,138
2019,215770,10,1,82,51,31
2019,215770,10,2,90,44,46
2019,215770,10,3,72,38,34
2019,215770,10,6,55,28,27
2019,215770,20,0,192,106,86
2019,215770,20,1,82,51,31
2019,215770,20,2,90,44,46
2019,215770,20,3,20,11,9
2019,215770,30,0,52,27,25
2019,215770,30,3,52,27,25
2019,215770,40,0,55,28,27
2019,215770,40,6,55,28,27
2019,215770,42,0,55,28,27
2019,215770,42,6,55,28,27
2019,215798,0,0,107,72,35
2019,215798,10,0,107,72,35
2019,215798,10,1,25,18,7
2019,215798,10,2,42,31,11
2019,215798,10,3,35,18,17
2019,215798,10,4,5,5,0
2019,215798,20,0,61,45,16
2019,215798,20,1,21,15,6
2019,215798,20,2,40,30,10
2019,215798,30,0,16,8,8
2019,215798,30,3,16,8,8
2019,215798,40,0,30,19,11
2019,215798,40,1,4,3,1
2019,215798,40,2,2,1,1
2019,215798,40,3,19,10,9
2019,215798,40,4,5,5,0
2019,215798,41,0,17,9,8
2019,215798,41,1,4,3,1
2019,215798,41,2,1,0,1
2019,215798,41,3,11,5,6
2019,215798,41,4,1,1,0
2019,215798,42,0,13,10,3
2019,215798,42,2,1,1,0
2019,215798,42,3,8,5,3
2019,215798,42,4,4,4,0
2019,215798,44,0,17,9,8
2019,215798,44,1,4,3,1
2019,215798,44,2,1,0,1
2019,215798,44,3,11,5,6
2019,215798,44,4,1,1,0
2019,215929,0,0,280,163,117
2019,215929,10,0,280,163,117
2019,215929,10,1,91,60,31
2019,215929,10,2,84,50,34
2019,215929,10,3,60,34,26
2019,215929,10,4,3,3,0
2019,215929,10,5,4,2,2
2019,215929,10,6,38,14,24
2019,215929,20,0,186,116,70
2019,215929,20,1,91,60,31
2019,215929,20,2,82,49,33
2019,215929,20,3,13,7,6
2019,215929,30,0,52,31,21
2019,215929,30,2,2,1,1
2019,215929,30,3,47,27,20
2019,215929,30,4,3,3,0
2019,215929,40,0,42,16,26
2019,215929,40,5,4,2,2
2019,215929,40,6,38,14,24
2019,215929,41,0,16,5,11
2019,215929,41,6,16,5,11
2019,215929,42,0,26,11,15
2019,215929,42,5,4,2,2
2019,215929,42,6,22,9,13
2019,215929,44,0,16,5,11
2019,215929,44,6,16,5,11
2019,215947,0,0,98,44,54
2019,215947,10,0,98,44,54
2019,215947,10,1,13,6,7
2019,215947,10,2,50,25,25
2019,215947,10,3,27,11,16
2019,215947,10,4,8,2,6
2019,215947,20,0,48,23,25
2019,215947,20,1,12,5,7
2019,215947,20,2,36,18,18
2019,215947,30,0,29,14,15
2019,215947,30,2,14,7,7
2019,215947,30,3,15,7,8
2019,215947,40,0,21,7,14
2019,215947,40,1,1,1,0
2019,215947,40,3,12,4,8
2019,215947,40,4,8,2,6
2019,215947,41,0,3,3,0
2019,215947,41,1,1,1,0
2019,215947,41,3,2,2,0
2019,215947,42,0,18,4,14
2019,215947,42,3,10,2,8
2019,215947,42,4,8,2,6
2019,215947,44,0,3,3,0
2019,215947,44,1,1,1,0
2019,215947,44,3,2,2,0
2019,215992,0,0,16,5,11
2019,215992,10,0,16,5,11
2019,215992,10,4,16,5,11
2019,215992,40,0,16,5,11
2019,215992,40,4,16,5,11
2019,215992,41,0,16,5,11
2019,215992,41,4,16,5,11
2019,215992,45,0,16,5,11
2019,215992,45,4,16,5,11
2019,216010,0,0,308,181,127
2019,216010,10,0,308,181,127
2019,216010,10,1,106,72,34
2019,216010,10,2,117,68,49
2019,216010,10,3,52,27,25
2019,216010,10,4,33,14,19
2019,216010,20,0,224,138,86
2019,216010,20,1,105,71,34
2019,216010,20,2,102,56,46
2019,216010,20,3,17,11,6
2019,216010,30,0,49,29,20
2019,216010,30,1,1,1,0
2019,216010,30,2,15,12,3
2019,216010,30,3,32,15,17
2019,216010,30,4,1,1,0
2019,216010,40,0,35,14,21
2019,216010,40,3,3,1,2
2019,216010,40,4,32,13,19
2019,216010,42,0,35,14,21
2019,216010,42,3,3,1,2
2019,216010,42,4,32,13,19
2019,216038,0,0,381,189,192
2019,216038,10,0,381,189,192
2019,216038,10,1,86,42,44
2019,216038,10,2,128,64,64
2019,216038,10,3,117,59,58
2019,216038,10,4,50,24,26
2019,216038,20,0,213,103,110
2019,216038,20,1,85,41,44
2019,216038,20,2,102,48,54
2019,216038,20,3,26,14,12
2019,216038,30,0,116,61,55
2019,216038,30,1,1,1,0
2019,216038,30,2,25,15,10
2019,216038,30,3,89,44,45
2019,216038,30,4,1,1,0
2019,216038,40,0,52,25,27
2019,216038,40,2,1,1,0
2019,216038,40,3,2,1,1
2019,216038,40,4,49,23,26
2019,216038,41,0,3,2,1
2019,216038,41,2,1,1,0
2019,216038,41,3,1,0,1
2019,216038,41,4,1,1,0
2019,216038,42,0,49,23,26
2019,216038,42,3,1,1,0
2019,216038,42,4,48,22,26
2019,216038,44,0,3,2,1
2019,216038,44,2,1,1,0
2019,216038,44,3,1,0,1
2019,216038,44,4,1,1,0
2019,216047,0,0,20,17,3
2019,216047,10,0,20,17,3
2019,216047,10,1,5,5,0
2019,216047,10,2,1,0,1
2019,216047,10,3,9,8,1
2019,216047,10,4,5,4,1
2019,216047,40,0,20,17,3
2019,216047,40,1,5,5,0
2019,216047,40,2,1,0,1
2019,216047,40,3,9,8,1
2019,216047,40,4,5,4,1
2019,216047,41,0,20,17,3
2019,216047,41,1,5,5,0
2019,216047,41,2,1,0,1
2019,216047,41,3,9,8,1
2019,216047,41,4,5,4,1
2019,216047,44,0,20,17,3
2019,216047,44,1,5,5,0
2019,216047,44,2,1,0,1
2019,216047,44,3,9,8,1
2019,216047,44,4,5,4,1
2019,216083,0,0,35,13,22
2019,216083,10,0,35,13,22
2019,216083,10,4,35,13,22
2019,216083,40,0,35,13,22
2019,216083,40,4,35,13,22
2019,216083,42,0,35,13,22
2019,216083,42,4,35,13,22
2019,216278,0,0,138,71,67
2019,216278,10,0,138,71,67
2019,216278,10,1,25,18,7
2019,216278,10,2,55,28,27
2019,216278,10,3,50,20,30
2019,216278,10,5,6,3,3
2019,216278,10,6,2,2,0
2019,216278,20,0,79,46,33
2019,216278,20,1,25,18,7
2019,216278,20,2,54,28,26
2019,216278,30,0,46,15,31
2019,216278,30,2,1,0,1
2019,216278,30,3,45,15,30
2019,216278,40,0,13,10,3
2019,216278,40,3,5,5,0
2019,216278,40,5,6,3,3
2019,216278,40,6,2,2,0
2019,216278,42,0,13,10,3
2019,216278,42,3,5,5,0
2019,216278,42,5,6,3,3
2019,216278,42,6,2,2,0
2019,216287,0,0,223,115,108
2019,216287,10,0,223,115,108
2019,216287,10,1,93,52,41
2019,216287,10,2,48,23,25
2019,216287,10,3,82,40,42
2019,216287,20,0,132,72,60
2019,216287,20,1,89,51,38
2019,216287,20,2,43,21,22
2019,216287,30,0,49,23,26
2019,216287,30,2,4,1,3
2019,216287,30,3,45,22,23
2019,216287,40,0,42,20,22
2019,216287,40,1,4,1,3
2019,216287,40,2,1,1,0
2019,216287,40,3,37,18,19
2019,216287,41,0,36,17,19
2019,216287,41,1,3,0,3
2019,216287,41,2,1,1,0
2019,216287,41,3,32,16,16
2019,216287,42,0,6,3,3
2019,216287,42,1,1,1,0
2019,216287,42,3,5,2,3
2019,216287,44,0,36,17,19
2019,216287,44,1,3,0,3
2019,216287,44,2,1,1,0
2019,216287,44,3,32,16,16
2019,216296,0,0,73,56,17
2019,216296,10,0,73,56,17
2019,216296,10,1,11,9,2
2019,216296,10,2,8,6,2
2019,216296,10,3,11,9,2
2019,216296,10,4,43,32,11
2019,216296,20,0,48,38,10
2019,216296,20,1,11,9,2
2019,216296,20,2,8,6,2
2019,216296,20,3,11,9,2
2019,216296,20,4,18,14,4
2019,216296,30,0,25,18,7
2019,216296,30,4,25,18,7
2019,216339,0,0,2297,1333,964
2019,216339,10,0,2297,1333,964
2019,216339,10,1,613,437,176
2019,216339,10,2,714,394,320
2019,216339,10,3,881,465,416
2019,216339,10,4,89,37,52
2019,216339,20,0,727,484,243
2019,216339,20,1,413,306,107
2019,216339,20,2,312,176,136
2019,216339,20,3,2,2,0
2019,216339,30,0,244,126,118
2019,216339,30,1,2,1,1
2019,216339,30,2,32,14,18
2019,216339,30,3,208,110,98
2019,216339,30,4,2,1,1
2019,216339,40,0,1326,723,603
2019,216339,40,1,198,130,68
2019,216339,40,2,370,204,166
2019,216339,40,3,671,353,318
2019,216339,40,4,87,36,51
2019,216339,41,0,1326,723,603
2019,216339,41,1,198,130,68
2019,216339,41,2,370,204,166
2019,216339,41,3,671,353,318
2019,216339,41,4,87,36,51
2019,216339,44,0,803,416,387
2019,216339,44,1,71,42,29
2019,216339,44,2,237,130,107
2019,216339,44,3,429,219,210
2019,216339,44,4,66,25,41
2019,216339,45,0,523,307,216
2019,216339,45,1,127,88,39
2019,216339,45,2,133,74,59
2019,216339,45,3,242,134,108
2019,216339,45,4,21,11,10
2019,216357,0,0,57,33,24
2019,216357,10,0,57,33,24
2019,216357,10,1,23,16,7
2019,216357,10,2,12,6,6
2019,216357,10,3,17,9,8
2019,216357,10,4,2,2,0
2019,216357,10,5,3,0,3
2019,216357,20,0,33,21,12
2019,216357,20,1,21,15,6
2019,216357,20,2,12,6,6
2019,216357,30,0,17,9,8
2019,216357,30,1,2,1,1
2019,216357,30,3,15,8,7
2019,216357,40,0,7,3,4
2019,216357,40,3,2,1,1
2019,216357,40,4,2,2,0
2019,216357,40,5,3,0,3
2019,216357,42,0,7,3,4
2019,216357,42,3,2,1,1
2019,216357,42,4,2,2,0
2019,216357,42,5,3,0,3
2019,216366,0,0,305,107,198
2019,216366,10,0,305,107,198
2019,216366,10,1,38,24,14
2019,216366,10,2,87,32,55
2019,216366,10,3,147,44,103
2019,216366,10,4,30,6,24
2019,216366,10,5,3,1,2
2019,216366,20,0,41,25,16
2019,216366,20,1,20,14,6
2019,216366,20,2,21,11,10
2019,216366,30,0,32,19,13
2019,216366,30,1,2,1,1
2019,216366,30,2,3,1,2
2019,216366,30,3,27,17,10
2019,216366,40,0,232,63,169
2019,216366,40,1,16,9,7
2019,216366,40,2,63,20,43
2019,216366,40,3,120,27,93
2019,216366,40,4,30,6,24
2019,216366,40,5,3,1,2
2019,216366,41,0,110,28,82
2019,216366,41,1,7,5,2
2019,216366,41,2,34,11,23
2019,216366,41,3,63,10,53
2019,216366,41,4,6,2,4
2019,216366,42,0,120,35,85
2019,216366,42,1,9,4,5
2019,216366,42,2,29,9,20
2019,216366,42,3,57,17,40
2019,216366,42,4,22,4,18
2019,216366,42,5,3,1,2
2019,216366,43,0,2,0,2
2019,216366,43,4,2,0,2
2019,216366,44,0,110,28,82
2019,216366,44,1,7,5,2
2019,216366,44,2,34,11,23
2019,216366,44,3,63,10,53
2019,216366,44,4,6,2,4
2019,216436,0,0,17,17,0
2019,216436,10,0,17,17,0
2019,216436,10,4,17,17,0
2019,216436,40,0,17,17,0
2019,216436,40,4,17,17,0
2019,216436,41,0,17,17,0
2019,216436,41,4,17,17,0
2019,216436,45,0,17,17,0
2019,216436,45,4,17,17,0
2019,216445,0,0,14,14,0
2019,216445,10,0,14,14,0
2019,216445,10,4,14,14,0
2019,216445,40,0,14,14,0
2019,216445,40,4,14,14,0
2019,216445,41,0,14,14,0
2019,216445,41,4,14,14,0
2019,216445,45,0,14,14,0
2019,216445,45,4,14,14,0
2019,216454,0,0,12,9,3
2019,216454,10,0,12,9,3
2019,216454,10,4,12,9,3
2019,216454,40,0,12,9,3
2019,216454,40,4,12,9,3
2019,216454,41,0,12,9,3
2019,216454,41,4,12,9,3
2019,216454,45,0,12,9,3
2019,216454,45,4,12,9,3
2019,216463,0,0,10,8,2
2019,216463,10,0,10,8,2
2019,216463,10,1,4,2,2
2019,216463,10,2,4,4,0
2019,216463,10,3,2,2,0
2019,216463,40,0,10,8,2
2019,216463,40,1,4,2,2
2019,216463,40,2,4,4,0
2019,216463,40,3,2,2,0
2019,216463,41,0,10,8,2
2019,216463,41,1,4,2,2
2019,216463,41,2,4,4,0
2019,216463,41,3,2,2,0
2019,216463,44,0,9,7,2
2019,216463,44,1,3,1,2
2019,216463,44,2,4,4,0
2019,216463,44,3,2,2,0
2019,216463,45,0,1,1,0
2019,216463,45,1,1,1,0
2019,216524,0,0,125,51,74
2019,216524,10,0,125,51,74
2019,216524,10,1,25,17,8
2019,216524,10,2,39,17,22
2019,216524,10,3,50,16,34
2019,216524,10,4,11,1,10
2019,216524,20,0,64,34,30
2019,216524,20,1,25,17,8
2019,216524,20,2,39,17,22
2019,216524,30,0,34,9,25
2019,216524,30,3,34,9,25
2019,216524,40,0,27,8,19
2019,216524,40,3,16,7,9
2019,216524,40,4,11,1,10
2019,216524,41,0,17,7,10
2019,216524,41,3,10,6,4
2019,216524,41,4,7,1,6
2019,216524,42,0,10,1,9
2019,216524,42,3,6,1,5
2019,216524,42,4,4,0,4
2019,216524,44,0,17,7,10
2019,216524,44,3,10,6,4
2019,216524,44,4,7,1,6
2019,216542,0,0,25,14,11
2019,216542,10,0,25,14,11
2019,216542,10,1,7,4,3
2019,216542,10,2,6,5,1
2019,216542,10,3,12,5,7
2019,216542,40,0,25,14,11
2019,216542,40,1,7,4,3
2019,216542,40,2,6,5,1
2019,216542,40,3,12,5,7
2019,216542,42,0,24,13,11
2019,216542,42,1,6,3,3
2019,216542,42,2,6,5,1
2019,216542,42,3,12,5,7
2019,216542,43,0,1,1,0
2019,216542,43,1,1,1,0
2019,216551,0,0,14,8,6
2019,216551,10,0,14,8,6
2019,216551,10,1,3,1,2
2019,216551,10,2,1,1,0
2019,216551,10,3,9,6,3
2019,216551,10,4,1,0,1
2019,216551,40,0,14,8,6
2019,216551,40,1,3,1,2
2019,216551,40,2,1,1,0
2019,216551,40,3,9,6,3
2019,216551,40,4,1,0,1
2019,216551,42,0,14,8,6
2019,216551,42,1,3,1,2
2019,216551,42,2,1,1,0
2019,216551,42,3,9,6,3
2019,216551,42,4,1,0,1
2019,216597,0,0,704,398,306
2019,216597,10,0,704,398,306
2019,216597,10,1,197,143,54
2019,216597,10,2,195,110,85
2019,216597,10,3,215,104,111
2019,216597,10,4,97,41,56
2019,216597,20,0,355,230,125
2019,216597,20,1,161,118,43
2019,216597,20,2,179,102,77
2019,216597,20,3,15,10,5
2019,216597,30,0,111,56,55
2019,216597,30,2,4,2,2
2019,216597,30,3,107,54,53
2019,216597,40,0,238,112,126
2019,216597,40,1,36,25,11
2019,216597,40,2,12,6,6
2019,216597,40,3,93,40,53
2019,216597,40,4,97,41,56
2019,216597,41,0,182,84,98
2019,216597,41,1,32,22,10
2019,216597,41,2,9,3,6
2019,216597,41,3,87,39,48
2019,216597,41,4,54,20,34
2019,216597,42,0,52,26,26
2019,216597,42,1,4,3,1
2019,216597,42,2,3,3,0
2019,216597,42,3,6,1,5
2019,216597,42,4,39,19,20
2019,216597,43,0,4,2,2
2019,216597,43,4,4,2,2
2019,216597,44,0,182,84,98
2019,216597,44,1,32,22,10
2019,216597,44,2,9,3,6
2019,216597,44,3,87,39,48
2019,216597,44,4,54,20,34
2019,216667,0,0,113,54,59
2019,216667,10,0,113,54,59
2019,216667,10,1,44,24,20
2019,216667,10,2,36,18,18
2019,216667,10,3,26,10,16
2019,216667,10,4,7,2,5
2019,216667,20,0,79,42,37
2019,216667,20,1,44,24,20
2019,216667,20,2,35,18,17
2019,216667,30,0,13,8,5
2019,216667,30,3,13,8,5
2019,216667,40,0,21,4,17
2019,216667,40,2,1,0,1
2019,216667,40,3,13,2,11
2019,216667,40,4,7,2,5
2019,216667,41,0,21,4,17
2019,216667,41,2,1,0,1
2019,216667,41,3,13,2,11
2019,216667,41,4,7,2,5
2019,216667,44,0,21,4,17
2019,216667,44,2,1,0,1
2019,216667,44,3,13,2,11
2019,216667,44,4,7,2,5
2019,216694,0,0,81,37,44
2019,216694,10,0,81,37,44
2019,216694,10,1,22,14,8
2019,216694,10,2,17,9,8
2019,216694,10,3,23,10,13
2019,216694,10,4,19,4,15
2019,216694,20,0,37,22,15
2019,216694,20,1,19,12,7
2019,216694,20,2,14,7,7
2019,216694,20,3,4,3,1
2019,216694,30,0,19,8,11
2019,216694,30,1,1,1,0
2019,216694,30,2,3,2,1
2019,216694,30,3,13,5,8
2019,216694,30,4,2,0,2
2019,216694,40,0,25,7,18
2019,216694,40,1,2,1,1
2019,216694,40,3,6,2,4
2019,216694,40,4,17,4,13
2019,216694,42,0,25,7,18
2019,216694,42,1,2,1,1
2019,216694,42,3,6,2,4
2019,216694,42,4,17,4,13
2019,216764,0,0,695,317,378
2019,216764,10,0,695,317,378
2019,216764,10,1,210,102,108
2019,216764,10,2,223,101,122
2019,216764,10,3,163,73,90
2019,216764,10,4,99,41,58
2019,216764,20,0,437,204,233
2019,216764,20,1,208,100,108
2019,216764,20,2,212,95,117
2019,216764,20,3,15,7,8
2019,216764,20,4,2,2,0
2019,216764,30,0,171,77,94
2019,216764,30,1,2,2,0
2019,216764,30,2,11,6,5
2019,216764,30,3,141,62,79
2019,216764,30,4,17,7,10
2019,216764,40,0,87,36,51
2019,216764,40,3,7,4,3
2019,216764,40,4,80,32,48
2019,216764,42,0,87,36,51
2019,216764,42,3,7,4,3
2019,216764,42,4,80,32,48
2019,216782,0,0,15,2,13
2019,216782,50,0,15,2,13
2019,216807,0,0,81,36,45
2019,216807,10,0,81,36,45
2019,216807,10,1,24,12,12
2019,216807,10,2,29,12,17
2019,216807,10,3,17,7,10
2019,216807,10,5,11,5,6
2019,216807,20,0,51,22,29
2019,216807,20,1,24,12,12
2019,216807,20,2,25,9,16
2019,216807,20,3,2,1,1
2019,216807,30,0,16,7,9
2019,216807,30,2,4,3,1
2019,216807,30,3,12,4,8
2019,216807,40,0,14,7,7
2019,216807,40,3,3,2,1
2019,216807,40,5,11,5,6
2019,216807,42,0,14,7,7
2019,216807,42,3,3,2,1
2019,216807,42,5,11,5,6
2019,216816,0,0,17,16,1
2019,216816,10,0,17,16,1
2019,216816,10,1,8,8,0
2019,216816,10,2,5,5,0
2019,216816,10,3,3,3,0
2019,216816,10,5,1,0,1
2019,216816,20,0,5,5,0
2019,216816,20,1,4,4,0
2019,216816,20,2,1,1,0
2019,216816,40,0,12,11,1
2019,216816,40,1,4,4,0
2019,216816,40,2,4,4,0
2019,216816,40,3,3,3,0
2019,216816,40,5,1,0,1
2019,216816,41,0,12,11,1
2019,216816,41,1,4,4,0
2019,216816,41,2,4,4,0
2019,216816,41,3,3,3,0
2019,216816,41,5,1,0,1
2019,216816,44,0,12,11,1
2019,216816,44,1,4,4,0
2019,216816,44,2,4,4,0
2019,216816,44,3,3,3,0
2019,216816,44,5,1,0,1
2019,216825,0,0,80,39,41
2019,216825,10,0,80,39,41
2019,216825,10,1,9,3,6
2019,216825,10,2,11,8,3
2019,216825,10,3,53,25,28
2019,216825,10,4,7,3,4
2019,216825,40,0,80,39,41
2019,216825,40,1,9,3,6
2019,216825,40,2,11,8,3
2019,216825,40,3,53,25,28
2019,216825,40,4,7,3,4
2019,216825,42,0,80,39,41
2019,216825,42,1,9,3,6
2019,216825,42,2,11,8,3
2019,216825,42,3,53,25,28
2019,216825,42,4,7,3,4
2019,216852,0,0,275,119,156
2019,216852,10,0,275,119,156
2019,216852,10,1,82,44,38
2019,216852,10,2,96,41,55
2019,216852,10,3,69,28,41
2019,216852,10,4,14,1,13
2019,216852,10,5,14,5,9
2019,216852,20,0,166,81,85
2019,216852,20,1,81,43,38
2019,216852,20,2,85,38,47
2019,216852,30,0,51,17,34
2019,216852,30,2,5,1,4
2019,216852,30,3,46,16,30
2019,216852,40,0,58,21,37
2019,216852,40,1,1,1,0
2019,216852,40,2,6,2,4
2019,216852,40,3,23,12,11
2019,216852,40,4,14,1,13
2019,216852,40,5,14,5,9
2019,216852,41,0,15,4,11
2019,216852,41,2,3,2,1
2019,216852,41,3,2,1,1
2019,216852,41,4,7,0,7
2019,216852,41,5,3,1,2
2019,216852,42,0,43,17,26
2019,216852,42,1,1,1,0
2019,216852,42,2,3,0,3
2019,216852,42,3,21,11,10
2019,216852,42,4,7,1,6
2019,216852,42,5,11,4,7
2019,216852,44,0,15,4,11
2019,216852,44,2,3,2,1
2019,216852,44,3,2,1,1
2019,216852,44,4,7,0,7
2019,216852,44,5,3,1,2
2019,216931,0,0,196,102,94
2019,216931,10,0,196,102,94
2019,216931,10,1,33,25,8
2019,216931,10,2,69,34,35
2019,216931,10,3,72,36,36
2019,216931,10,4,2,1,1
2019,216931,10,6,20,6,14
2019,216931,20,0,101,59,42
2019,216931,20,1,33,25,8
2019,216931,20,2,68,34,34
2019,216931,30,0,68,32,36
2019,216931,30,3,68,32,36
2019,216931,40,0,27,11,16
2019,216931,40,2,1,0,1
2019,216931,40,3,4,4,0
2019,216931,40,4,2,1,1
2019,216931,40,6,20,6,14
2019,216931,42,0,27,11,16
2019,216931,42,2,1,0,1
2019,216931,42,3,4,4,0
2019,216931,42,4,2,1,1
2019,216931,42,6,20,6,14
2019,216940,0,0,20,17,3
2019,216940,10,0,20,17,3
2019,216940,10,2,6,6,0
2019,216940,10,4,14,11,3
2019,216940,40,0,20,17,3
2019,216940,40,2,6,6,0
2019,216940,40,4,14,11,3
2019,216940,41,0,6,4,2
2019,216940,41,2,3,3,0
2019,216940,41,4,3,1,2
2019,216940,42,0,14,13,1
2019,216940,42,2,3,3,0
2019,216940,42,4,11,10,1
2019,216940,44,0,6,4,2
2019,216940,44,2,3,3,0
2019,216940,44,4,3,1,2
2019,217013,0,0,48,20,28
2019,217013,10,0,48,20,28
2019,217013,10,1,10,5,5
2019,217013,10,2,16,10,6
2019,217013,10,3,14,2,12
2019,217013,10,4,2,1,1
2019,217013,10,5,6,2,4
2019,217013,20,0,25,14,11
2019,217013,20,1,10,5,5
2019,217013,20,2,15,9,6
2019,217013,30,0,10,3,7
2019,217013,30,2,1,1,0
2019,217013,30,3,9,2,7
2019,217013,40,0,13,3,10
2019,217013,40,3,5,0,5
2019,217013,40,4,2,1,1
2019,217013,40,5,6,2,4
2019,217013,41,0,2,1,1
2019,217013,41,3,1,0,1
2019,217013,41,4,1,1,0
2019,217013,42,0,11,2,9
2019,217013,42,3,4,0,4
2019,217013,42,4,1,0,1
2019,217013,42,5,6,2,4
2019,217013,44,0,2,1,1
2019,217013,44,3,1,0,1
2019,217013,44,4,1,1,0
2019,217059,0,0,176,90,86
2019,217059,10,0,176,90,86
2019,217059,10,1,18,12,6
2019,217059,10,2,72,38,34
2019,217059,10,3,59,26,33
2019,217059,10,4,27,14,13
2019,217059,20,0,102,59,43
2019,217059,20,1,16,11,5
2019,217059,20,2,68,35,33
2019,217059,20,3,18,13,5
2019,217059,30,0,46,17,29
2019,217059,30,1,1,1,0
2019,217059,30,2,4,3,1
2019,217059,30,3,41,13,28
2019,217059,40,0,28,14,14
2019,217059,40,1,1,0,1
2019,217059,40,4,27,14,13
2019,217059,42,0,28,14,14
2019,217059,42,1,1,0,1
2019,217059,42,4,27,14,13
2019,217077,0,0,42,22,20
2019,217077,50,0,42,22,20
2019,217156,0,0,938,588,350
2019,217156,10,0,905,572,333
2019,217156,10,1,411,306,105
2019,217156,10,2,158,94,64
2019,217156,10,3,154,94,60
2019,217156,10,5,76,29,47
2019,217156,10,6,106,49,57
2019,217156,20,0,550,389,161
2019,217156,20,1,400,298,102
2019,217156,20,2,150,91,59
2019,217156,30,0,147,93,54
2019,217156,30,2,4,2,2
2019,217156,30,3,143,91,52
2019,217156,40,0,208,90,118
2019,217156,40,1,11,8,3
2019,217156,40,2,4,1,3
2019,217156,40,3,11,3,8
2019,217156,40,5,76,29,47
2019,217156,40,6,106,49,57
2019,217156,41,0,157,68,89
2019,217156,41,1,11,8,3
2019,217156,41,2,4,1,3
2019,217156,41,3,11,3,8
2019,217156,41,5,76,29,47
2019,217156,41,6,55,27,28
2019,217156,42,0,37,16,21
2019,217156,42,6,37,16,21
2019,217156,43,0,14,6,8
2019,217156,43,6,14,6,8
2019,217156,44,0,157,68,89
2019,217156,44,1,11,8,3
2019,217156,44,2,4,1,3
2019,217156,44,3,11,3,8
2019,217156,44,5,76,29,47
2019,217156,44,6,55,27,28
2019,217156,50,0,33,16,17
2019,217165,0,0,176,103,73
2019,217165,10,0,176,103,73
2019,217165,10,1,74,48,26
2019,217165,10,2,27,19,8
2019,217165,10,3,22,7,15
2019,217165,10,5,53,29,24
2019,217165,20,0,98,64,34
2019,217165,20,1,74,48,26
2019,217165,20,2,24,16,8
2019,217165,30,0,25,10,15
2019,217165,30,2,3,3,0
2019,217165,30,3,22,7,15
2019,217165,40,0,53,29,24
2019,217165,40,5,53,29,24
2019,217165,41,0,33,16,17
2019,217165,41,5,33,16,17
2019,217165,42,0,20,13,7
2019,217165,42,5,20,13,7
2019,217165,44,0,33,16,17
2019,217165,44,5,33,16,17
2019,217235,0,0,279,153,126
2019,217235,10,0,279,153,126
2019,217235,10,1,58,30,28
2019,217235,10,2,141,74,67
2019,217235,10,3,59,34,25
2019,217235,10,4,18,13,5
2019,217235,10,5,3,2,1
2019,217235,40,0,279,153,126
2019,217235,40,1,58,30,28
2019,217235,40,2,141,74,67
2019,217235,40,3,59,34,25
2019,217235,40,4,18,13,5
2019,217235,40,5,3,2,1
2019,217235,41,0,36,19,17
2019,217235,41,1,16,11,5
2019,217235,41,2,20,8,12
2019,217235,42,0,243,134,109
2019,217235,42,1,42,19,23
2019,217235,42,2,121,66,55
2019,217235,42,3,59,34,25
2019,217235,42,4,18,13,5
2019,217235,42,5,3,2,1
2019,217235,44,0,36,19,17
2019,217235,44,1,16,11,5
2019,217235,44,2,20,8,12
2019,217305,0,0,122,70,52
2019,217305,10,0,122,70,52
2019,217305,10,1,17,10,7
2019,217305,10,2,35,20,15
2019,217305,10,3,46,27,19
2019,217305,10,4,24,13,11
2019,217305,40,0,122,70,52
2019,217305,40,1,17,10,7
2019,217305,40,2,35,20,15
2019,217305,40,3,46,27,19
2019,217305,40,4,24,13,11
2019,217305,42,0,122,70,52
2019,217305,42,1,17,10,7
2019,217305,42,2,35,20,15
2019,217305,42,3,46,27,19
2019,217305,42,4,24,13,11
2019,217402,0,0,298,176,122
2019,217402,10,0,298,176,122
2019,217402,10,1,68,49,19
2019,217402,10,2,98,53,45
2019,217402,10,3,117,66,51
2019,217402,10,4,14,7,7
2019,217402,10,5,1,1,0
2019,217402,20,0,185,111,74
2019,217402,20,1,68,49,19
2019,217402,20,2,87,45,42
2019,217402,20,3,30,17,13
2019,217402,30,0,68,35,33
2019,217402,30,2,11,8,3
2019,217402,30,3,57,27,30
2019,217402,40,0,45,30,15
2019,217402,40,3,30,22,8
2019,217402,40,4,14,7,7
2019,217402,40,5,1,1,0
2019,217402,42,0,44,29,15
2019,217402,42,3,30,22,8
2019,217402,42,4,13,6,7
2019,217402,42,5,1,1,0
2019,217402,43,0,1,1,0
2019,217402,43,4,1,1,0
2019,217420,0,0,331,122,209
2019,217420,10,0,331,122,209
2019,217420,10,1,119,51,68
2019,217420,10,2,110,41,69
2019,217420,10,3,102,30,72
2019,217420,20,0,236,94,142
2019,217420,20,1,119,51,68
2019,217420,20,2,110,41,69
2019,217420,20,3,7,2,5
2019,217420,30,0,65,23,42
2019,217420,30,3,65,23,42
2019,217420,40,0,30,5,25
2019,217420,40,3,30,5,25
2019,217420,41,0,27,5,22
2019,217420,41,3,27,5,22
2019,217420,42,0,3,0,3
2019,217420,42,3,3,0,3
2019,217420,44,0,27,5,22
2019,217420,44,3,27,5,22
2019,217475,0,0,302,109,193
2019,217475,10,0,302,109,193
2019,217475,10,1,105,32,73
2019,217475,10,2,69,26,43
2019,217475,10,3,126,51,75
2019,217475,10,4,2,0,2
2019,217475,20,0,210,73,137
2019,217475,20,1,105,32,73
2019,217475,20,2,69,26,43
2019,217475,20,3,36,15,21
2019,217475,30,0,90,36,54
2019,217475,30,3,90,36,54
2019,217475,40,0,2,0,2
2019,217475,40,4,2,0,2
2019,217475,41,0,2,0,2
2019,217475,41,4,2,0,2
2019,217475,44,0,2,0,2
2019,217475,44,4,2,0,2
2019,217484,0,0,764,377,387
2019,217484,10,0,764,377,387
2019,217484,10,1,277,167,110
2019,217484,10,2,157,77,80
2019,217484,10,3,174,74,100
2019,217484,10,5,156,59,97
2019,217484,20,0,400,234,166
2019,217484,20,1,264,163,101
2019,217484,20,2,136,71,65
2019,217484,30,0,159,70,89
2019,217484,30,2,4,2,2
2019,217484,30,3,155,68,87
2019,217484,40,0,205,73,132
2019,217484,40,1,13,4,9
2019,217484,40,2,17,4,13
2019,217484,40,3,19,6,13
2019,217484,40,5,156,59,97
2019,217484,41,0,125,44,81
2019,217484,41,1,12,3,9
2019,217484,41,2,17,4,13
2019,217484,41,3,16,5,11
2019,217484,41,5,80,32,48
2019,217484,42,0,78,28,50
2019,217484,42,3,3,1,2
2019,217484,42,5,75,27,48
2019,217484,43,0,2,1,1
2019,217484,43,1,1,1,0
2019,217484,43,5,1,0,1
2019,217484,44,0,125,44,81
2019,217484,44,1,12,3,9
2019,217484,44,2,17,4,13
2019,217484,44,3,16,5,11
2019,217484,44,5,80,32,48
2019,217493,0,0,196,107,89
2019,217493,10,0,196,107,89
2019,217493,10,1,72,40,32
2019,217493,10,2,54,30,24
2019,217493,10,3,65,33,32
2019,217493,10,6,5,4,1
2019,217493,40,0,196,107,89
2019,217493,40,1,72,40,32
2019,217493,40,2,54,30,24
2019,217493,40,3,65,33,32
2019,217493,40,6,5,4,1
2019,217493,41,0,170,96,74
2019,217493,41,1,72,40,32
2019,217493,41,2,54,30,24
2019,217493,41,3,44,26,18
2019,217493,42,0,26,11,15
2019,217493,42,3,21,7,14
2019,217493,42,6,5,4,1
2019,217493,44,0,170,96,74
2019,217493,44,1,72,40,32
2019,217493,44,2,54,30,24
2019,217493,44,3,44,26,18
2019,217518,0,0,209,114,95
2019,217518,10,0,209,114,95
2019,217518,10,1,107,62,45
2019,217518,10,2,59,29,30
2019,217518,10,3,40,23,17
2019,217518,10,5,3,0,3
2019,217518,20,0,164,89,75
2019,217518,20,1,107,62,45
2019,217518,20,2,57,27,30
2019,217518,30,0,38,22,16
2019,217518,30,2,1,1,0
2019,217518,30,3,37,21,16
2019,217518,40,0,7,3,4
2019,217518,40,2,1,1,0
2019,217518,40,3,3,2,1
2019,217518,40,5,3,0,3
2019,217518,41,0,7,3,4
2019,217518,41,2,1,1,0
2019,217518,41,3,3,2,1
2019,217518,41,5,3,0,3
2019,217518,44,0,7,3,4
2019,217518,44,2,1,1,0
2019,217518,44,3,3,2,1
2019,217518,44,5,3,0,3
2019,217536,0,0,118,46,72
2019,217536,10,0,118,46,72
2019,217536,10,1,30,17,13
2019,217536,10,2,35,17,18
2019,217536,10,3,32,5,27
2019,217536,10,5,21,7,14
2019,217536,20,0,65,34,31
2019,217536,20,1,30,17,13
2019,217536,20,2,35,17,18
2019,217536,30,0,27,5,22
2019,217536,30,3,27,5,22
2019,217536,40,0,26,7,19
2019,217536,40,3,5,0,5
2019,217536,40,5,21,7,14
2019,217536,41,0,5,2,3
2019,217536,41,5,5,2,3
2019,217536,42,0,21,5,16
2019,217536,42,3,5,0,5
2019,217536,42,5,16,5,11
2019,217536,44,0,5,2,3
2019,217536,44,5,5,2,3
2019,217606,0,0,5,5,0
2019,217606,10,0,5,5,0
2019,217606,10,1,3,3,0
2019,217606,10,2,1,1,0
2019,217606,10,3,1,1,0
2019,217606,40,0,5,5,0
2019,217606,40,1,3,3,0
2019,217606,40,2,1,1,0
2019,217606,40,3,1,1,0
2019,217606,41,0,5,5,0
2019,217606,41,1,3,3,0
2019,217606,41,2,1,1,0
2019,217606,41,3,1,1,0
2019,217606,45,0,5,5,0
2019,217606,45,1,3,3,0
2019,217606,45,2,1,1,0
2019,217606,45,3,1,1,0
2019,217615,0,0,53,26,27
2019,217615,10,0,53,26,27
2019,217615,10,6,53,26,27
2019,217615,40,0,53,26,27
2019,217615,40,6,53,26,27
2019,217615,41,0,53,26,27
2019,217615,41,6,53,26,27
2019,217615,45,0,53,26,27
2019,217615,45,6,53,26,27
2019,217624,0,0,40,25,15
2019,217624,10,0,40,25,15
2019,217624,10,2,11,6,5
2019,217624,10,3,20,13,7
2019,217624,10,4,9,6,3
2019,217624,20,0,4,2,2
2019,217624,20,2,4,2,2
2019,217624,30,0,25,17,8
2019,217624,30,2,6,3,3
2019,217624,30,3,18,13,5
2019,217624,30,4,1,1,0
2019,217624,40,0,11,6,5
2019,217624,40,2,1,1,0
2019,217624,40,3,2,0,2
2019,217624,40,4,8,5,3
2019,217624,42,0,11,6,5
2019,217624,42,2,1,1,0
2019,217624,42,3,2,0,2
2019,217624,42,4,8,5,3
2019,217633,0,0,159,72,87
2019,217633,10,0,159,72,87
2019,217633,10,1,19,14,5
2019,217633,10,2,38,23,15
2019,217633,10,3,69,24,45
2019,217633,10,4,24,9,15
2019,217633,10,5,9,2,7
2019,217633,20,0,40,25,15
2019,217633,20,1,14,10,4
2019,217633,20,2,24,15,9
2019,217633,20,3,2,0,2
2019,217633,30,0,32,17,15
2019,217633,30,1,3,3,0
2019,217633,30,2,8,4,4
2019,217633,30,3,21,10,11
2019,217633,40,0,87,30,57
2019,217633,40,1,2,1,1
2019,217633,40,2,6,4,2
2019,217633,40,3,46,14,32
2019,217633,40,4,24,9,15
2019,217633,40,5,9,2,7
2019,217633,41,0,4,2,2
2019,217633,41,1,1,0,1
2019,217633,41,2,2,1,1
2019,217633,41,3,1,1,0
2019,217633,42,0,83,28,55
2019,217633,42,1,1,1,0
2019,217633,42,2,4,3,1
2019,217633,42,3,45,13,32
2019,217633,42,4,24,9,15
2019,217633,42,5,9,2,7
2019,217633,44,0,4,2,2
2019,217633,44,1,1,0,1
2019,217633,44,2,2,1,1
2019,217633,44,3,1,1,0
2019,217688,0,0,220,116,104
2019,217688,10,0,187,89,98
2019,217688,10,1,41,23,18
2019,217688,10,2,46,32,14
2019,217688,10,3,80,31,49
2019,217688,10,4,20,3,17
2019,217688,20,0,30,15,15
2019,217688,20,1,28,13,15
2019,217688,20,2,2,2,0
2019,217688,30,0,103,61,42
2019,217688,30,1,13,10,3
2019,217688,30,2,43,30,13
2019,217688,30,3,47,21,26
2019,217688,40,0,54,13,41
2019,217688,40,2,1,0,1
2019,217688,40,3,33,10,23
2019,217688,40,4,20,3,17
2019,217688,41,0,19,7,12
2019,217688,41,2,1,0,1
2019,217688,41,3,18,7,11
2019,217688,42,0,35,6,29
2019,217688,42,3,15,3,12
2019,217688,42,4,20,3,17
2019,217688,44,0,19,7,12
2019,217688,44,2,1,0,1
2019,217688,44,3,18,7,11
2019,217688,50,0,33,27,6
2019,217712,0,0,50,19,31
2019,217712,10,0,50,19,31
2019,217712,10,6,50,19,31
2019,217712,40,0,50,19,31
2019,217712,40,6,50,19,31
2019,217712,41,0,50,19,31
2019,217712,41,6,50,19,31
2019,217712,45,0,50,19,31
2019,217712,45,6,50,19,31
2019,217721,0,0,84,44,40
2019,217721,10,0,84,44,40
2019,217721,10,1,13,9,4
2019,217721,10,2,31,19,12
2019,217721,10,3,14,7,7
2019,217721,10,4,26,9,17
2019,217721,20,0,38,24,14
2019,217721,20,1,10,7,3
2019,217721,20,2,27,17,10
2019,217721,20,3,1,0,1
2019,217721,30,0,16,8,8
2019,217721,30,1,2,1,1
2019,217721,30,2,3,1,2
2019,217721,30,3,11,6,5
2019,217721,40,0,30,12,18
2019,217721,40,1,1,1,0
2019,217721,40,2,1,1,0
2019,217721,40,3,2,1,1
2019,217721,40,4,26,9,17
2019,217721,42,0,30,12,18
2019,217721,42,1,1,1,0
2019,217721,42,2,1,1,0
2019,217721,42,3,2,1,1
2019,217721,42,4,26,9,17
2019,217749,0,0,167,102,65
2019,217749,10,0,167,102,65
2019,217749,10,1,51,39,12
2019,217749,10,2,44,26,18
2019,217749,10,3,64,34,30
2019,217749,10,4,5,2,3
2019,217749,10,6,3,1,2
2019,217749,40,0,167,102,65
2019,217749,40,1,51,39,12
2019,217749,40,2,44,26,18
2019,217749,40,3,64,34,30
2019,217749,40,4,5,2,3
2019,217749,40,6,3,1,2
2019,217749,42,0,167,102,65
2019,217749,42,1,51,39,12
2019,217749,42,2,44,26,18
2019,217749,42,3,64,34,30
2019,217749,42,4,5,2,3
2019,217749,42,6,3,1,2
2019,217776,0,0,51,30,21
2019,217776,10,0,51,30,21
2019,217776,10,1,14,11,3
2019,217776,10,2,20,11,9
2019,217776,10,3,17,8,9
2019,217776,20,0,9,8,1
2019,217776,20,1,9,8,1
2019,217776,30,0,42,22,20
2019,217776,30,1,5,3,2
2019,217776,30,2,20,11,9
2019,217776,30,3,17,8,9
2019,217819,0,0,526,280,246
2019,217819,10,0,526,280,246
2019,217819,10,1,153,96,57
2019,217819,10,2,187,105,82
2019,217819,10,3,127,61,66
2019,217819,10,4,59,18,41
2019,217819,20,0,330,196,134
2019,217819,20,1,150,95,55
2019,217819,20,2,179,101,78
2019,217819,20,3,1,0,1
2019,217819,30,0,111,53,58
2019,217819,30,1,3,1,2
2019,217819,30,2,2,1,1
2019,217819,30,3,105,50,55
2019,217819,30,4,1,1,0
2019,217819,40,0,85,31,54
2019,217819,40,2,6,3,3
2019,217819,40,3,21,11,10
2019,217819,40,4,58,17,41
2019,217819,41,0,50,14,36
2019,217819,41,4,50,14,36
2019,217819,42,0,35,17,18
2019,217819,42,2,6,3,3
2019,217819,42,3,21,11,10
2019,217819,42,4,8,3,5
2019,217819,44,0,50,14,36
2019,217819,44,4,50,14,36
2019,217837,0,0,18,10,8
2019,217837,10,0,18,10,8
2019,217837,10,6,18,10,8
2019,217837,40,0,18,10,8
2019,217837,40,6,18,10,8
2019,217837,41,0,18,10,8
2019,217837,41,6,18,10,8
2019,217837,45,0,18,10,8
2019,217837,45,6,18,10,8
2019,217864,0,0,204,130,74
2019,217864,10,0,204,130,74
2019,217864,10,1,67,53,14
2019,217864,10,2,67,34,33
2019,217864,10,3,51,32,19
2019,217864,10,4,19,11,8
2019,217864,20,0,117,79,38
2019,217864,20,1,65,51,14
2019,217864,20,2,51,27,24
2019,217864,20,3,1,1,0
2019,217864,30,0,64,37,27
2019,217864,30,1,1,1,0
2019,217864,30,2,16,7,9
2019,217864,30,3,47,29,18
2019,217864,40,0,23,14,9
2019,217864,40,1,1,1,0
2019,217864,40,3,3,2,1
2019,217864,40,4,19,11,8
2019,217864,41,0,11,6,5
2019,217864,41,1,1,1,0
2019,217864,41,3,1,1,0
2019,217864,41,4,9,4,5
2019,217864,42,0,12,8,4
2019,217864,42,3,2,1,1
2019,217864,42,4,10,7,3
2019,217864,44,0,11,6,5
2019,217864,44,1,1,1,0
2019,217864,44,3,1,1,0
2019,217864,44,4,9,4,5
2019,217873,0,0,122,69,53
2019,217873,10,0,122,69,53
2019,217873,10,1,17,11,6
2019,217873,10,2,39,23,16
2019,217873,10,3,50,28,22
2019,217873,10,4,16,7,9
2019,217873,20,0,49,30,19
2019,217873,20,1,13,9,4
2019,217873,20,2,31,18,13
2019,217873,20,3,5,3,2
2019,217873,30,0,55,33,22
2019,217873,30,1,4,2,2
2019,217873,30,2,8,5,3
2019,217873,30,3,40,23,17
2019,217873,30,4,3,3,0
2019,217873,40,0,18,6,12
2019,217873,40,3,5,2,3
2019,217873,40,4,13,4,9
2019,217873,42,0,18,6,12
2019,217873,42,3,5,2,3
2019,217873,42,4,13,4,9
2019,217882,0,0,1351,814,537
2019,217882,10,0,1351,814,537
2019,217882,10,1,355,275,80
2019,217882,10,2,318,202,116
2019,217882,10,3,278,161,117
2019,217882,10,4,2,1,1
2019,217882,10,5,345,148,197
2019,217882,10,6,53,27,26
2019,217882,20,0,654,467,187
2019,217882,20,1,354,274,80
2019,217882,20,2,300,193,107
2019,217882,30,0,296,170,126
2019,217882,30,2,18,9,9
2019,217882,30,3,278,161,117
2019,217882,40,0,401,177,224
2019,217882,40,1,1,1,0
2019,217882,40,4,2,1,1
2019,217882,40,5,345,148,197
2019,217882,40,6,53,27,26
2019,217882,41,0,158,75,83
2019,217882,41,5,158,75,83
2019,217882,42,0,241,101,140
2019,217882,42,1,1,1,0
2019,217882,42,4,2,1,1
2019,217882,42,5,186,73,113
2019,217882,42,6,52,26,26
2019,217882,43,0,2,1,1
2019,217882,43,5,1,0,1
2019,217882,43,6,1,1,0
2019,217882,44,0,158,75,83
2019,217882,44,5,158,75,83
2019,217891,0,0,10,9,1
2019,217891,10,0,10,9,1
2019,217891,10,1,10,9,1
2019,217891,40,0,10,9,1
2019,217891,40,1,10,9,1
2019,217891,43,0,10,9,1
2019,217891,43,1,10,9,1
2019,217907,0,0,68,35,33
2019,217907,10,0,68,35,33
2019,217907,10,1,18,9,9
2019,217907,10,2,20,10,10
2019,217907,10,3,27,13,14
2019,217907,10,5,3,3,0
2019,217907,20,0,42,20,22
2019,217907,20,1,18,9,9
2019,217907,20,2,20,10,10
2019,217907,20,3,4,1,3
2019,217907,30,0,16,9,7
2019,217907,30,3,16,9,7
2019,217907,40,0,10,6,4
2019,217907,40,3,7,3,4
2019,217907,40,5,3,3,0
2019,217907,42,0,10,6,4
2019,217907,42,3,7,3,4
2019,217907,42,5,3,3,0
2019,217925,0,0,38,28,10
2019,217925,10,0,38,28,10
2019,217925,10,1,20,16,4
2019,217925,10,2,18,12,6
2019,217925,40,0,38,28,10
2019,217925,40,1,20,16,4
2019,217925,40,2,18,12,6
2019,217925,41,0,27,21,6
2019,217925,41,1,20,16,4
2019,217925,41,2,7,5,2
2019,217925,42,0,11,7,4
2019,217925,42,2,11,7,4
2019,217925,44,0,27,21,6
2019,217925,44,1,20,16,4
2019,217925,44,2,7,5,2
2019,217934,0,0,54,14,40
2019,217934,10,0,54,14,40
2019,217934,10,1,11,2,9
2019,217934,10,2,12,5,7
2019,217934,10,3,12,2,10
2019,217934,10,5,15,4,11
2019,217934,10,6,4,1,3
2019,217934,20,0,22,5,17
2019,217934,20,1,11,2,9
2019,217934,20,2,10,3,7
2019,217934,20,6,1,0,1
2019,217934,30,0,17,5,12
2019,217934,30,2,2,2,0
2019,217934,30,3,12,2,10
2019,217934,30,6,3,1,2
2019,217934,40,0,15,4,11
2019,217934,40,5,15,4,11
2019,217934,42,0,15,4,11
2019,217934,42,5,15,4,11
2019,217961,0,0,81,27,54
2019,217961,10,0,81,27,54
2019,217961,10,1,19,12,7
2019,217961,10,2,28,7,21
2019,217961,10,3,30,7,23
2019,217961,10,4,2,1,1
2019,217961,10,5,2,0,2
2019,217961,20,0,48,20,28
2019,217961,20,1,19,12,7
2019,217961,20,2,28,7,21
2019,217961,20,3,1,1,0
2019,217961,30,0,29,6,23
2019,217961,30,3,29,6,23
2019,217961,40,0,4,1,3
2019,217961,40,4,2,1,1
2019,217961,40,5,2,0,2
2019,217961,42,0,4,1,3
2019,217961,42,4,2,1,1
2019,217961,42,5,2,0,2
2019,217989,0,0,23,12,11
2019,217989,10,0,23,12,11
2019,217989,10,6,23,12,11
2019,217989,40,0,23,12,11
2019,217989,40,6,23,12,11
2019,217989,41,0,23,12,11
2019,217989,41,6,23,12,11
2019,217989,44,0,1,1,0
2019,217989,44,6,1,1,0
2019,217989,45,0,22,11,11
2019,217989,45,6,22,11,11
2019,217998,0,0,41,21,20
2019,217998,10,0,41,21,20
2019,217998,10,1,12,11,1
2019,217998,10,2,9,3,6
2019,217998,10,3,12,3,9
2019,217998,10,4,5,2,3
2019,217998,10,6,3,2,1
2019,217998,20,0,15,10,5
2019,217998,20,1,11,10,1
2019,217998,20,2,3,0,3
2019,217998,20,3,1,0,1
2019,217998,30,0,13,5,8
2019,217998,30,1,1,1,0
2019,217998,30,2,4,2,2
2019,217998,30,3,8,2,6
2019,217998,40,0,13,6,7
2019,217998,40,2,2,1,1
2019,217998,40,3,3,1,2
2019,217998,40,4,5,2,3
2019,217998,40,6,3,2,1
2019,217998,42,0,13,6,7
2019,217998,42,2,2,1,1
2019,217998,42,3,3,1,2
2019,217998,42,4,5,2,3
2019,217998,42,6,3,2,1
2019,218025,0,0,91,47,44
2019,218025,10,0,91,47,44
2019,218025,10,6,91,47,44
2019,218025,40,0,91,47,44
2019,218025,40,6,91,47,44
2019,218025,41,0,91,47,44
2019,218025,41,6,91,47,44
2019,218025,45,0,91,47,44
2019,218025,45,6,91,47,44
2019,218061,0,0,214,102,112
2019,218061,10,0,214,102,112
2019,218061,10,1,66,45,21
2019,218061,10,2,53,20,33
2019,218061,10,3,79,33,46
2019,218061,10,4,16,4,12
2019,218061,20,0,119,65,54
2019,218061,20,1,65,44,21
2019,218061,20,2,53,20,33
2019,218061,20,3,1,1,0
2019,218061,30,0,69,29,40
2019,218061,30,3,67,29,38
2019,218061,30,4,2,0,2
2019,218061,40,0,26,8,18
2019,218061,40,1,1,1,0
2019,218061,40,3,11,3,8
2019,218061,40,4,14,4,10
2019,218061,42,0,26,8,18
2019,218061,42,1,1,1,0
2019,218061,42,3,11,3,8
2019,218061,42,4,14,4,10
2019,218070,0,0,270,151,119
2019,218070,10,0,270,151,119
2019,218070,10,1,109,76,33
2019,218070,10,2,70,37,33
2019,218070,10,3,68,29,39
2019,218070,10,4,4,2,2
2019,218070,10,5,15,5,10
2019,218070,10,6,4,2,2
2019,218070,20,0,169,107,62
2019,218070,20,1,104,73,31
2019,218070,20,2,64,34,30
2019,218070,20,3,1,0,1
2019,218070,30,0,60,26,34
2019,218070,30,1,3,1,2
2019,218070,30,2,6,3,3
2019,218070,30,3,51,22,29
2019,218070,40,0,41,18,23
2019,218070,40,1,2,2,0
2019,218070,40,3,16,7,9
2019,218070,40,4,4,2,2
2019,218070,40,5,15,5,10
2019,218070,40,6,4,2,2
2019,218070,42,0,41,18,23
2019,218070,42,1,2,2,0
2019,218070,42,3,16,7,9
2019,218070,42,4,4,2,2
2019,218070,42,5,15,5,10
2019,218070,42,6,4,2,2
2019,218113,0,0,326,140,186
2019,218113,10,0,326,140,186
2019,218113,10,6,326,140,186
2019,218113,40,0,326,140,186
2019,218113,40,6,326,140,186
2019,218113,41,0,326,140,186
2019,218113,41,6,326,140,186
2019,218113,45,0,326,140,186
2019,218113,45,6,326,140,186
2019,218140,0,0,165,81,84
2019,218140,10,0,165,81,84
2019,218140,10,6,165,81,84
2019,218140,40,0,165,81,84
2019,218140,40,6,165,81,84
2019,218140,41,0,165,81,84
2019,218140,41,6,165,81,84
2019,218140,45,0,165,81,84
2019,218140,45,6,165,81,84
2019,218229,0,0,140,63,77
2019,218229,10,0,140,63,77
2019,218229,10,1,19,12,7
2019,218229,10,2,32,20,12
2019,218229,10,3,55,24,31
2019,218229,10,4,6,0,6
2019,218229,10,5,27,6,21
2019,218229,10,6,1,1,0
2019,218229,20,0,56,34,22
2019,218229,20,1,19,12,7
2019,218229,20,2,30,18,12
2019,218229,20,3,6,4,2
2019,218229,20,5,1,0,1
2019,218229,30,0,49,20,29
2019,218229,30,2,2,2,0
2019,218229,30,3,42,16,26
2019,218229,30,5,4,1,3
2019,218229,30,6,1,1,0
2019,218229,40,0,35,9,26
2019,218229,40,3,7,4,3
2019,218229,40,4,6,0,6
2019,218229,40,5,22,5,17
2019,218229,41,0,1,1,0
2019,218229,41,5,1,1,0
2019,218229,42,0,7,3,4
2019,218229,42,3,3,2,1
2019,218229,42,4,1,0,1
2019,218229,42,5,3,1,2
2019,218229,43,0,27,5,22
2019,218229,43,3,4,2,2
2019,218229,43,4,5,0,5
2019,218229,43,5,18,3,15
2019,218229,45,0,1,1,0
2019,218229,45,5,1,1,0
2019,218238,0,0,93,43,50
2019,218238,10,0,93,43,50
2019,218238,10,1,27,14,13
2019,218238,10,2,26,13,13
2019,218238,10,3,21,10,11
2019,218238,10,5,19,6,13
2019,218238,20,0,48,24,24
2019,218238,20,1,27,14,13
2019,218238,20,2,13,8,5
2019,218238,20,3,8,2,6
2019,218238,30,0,26,13,13
2019,218238,30,2,13,5,8
2019,218238,30,3,13,8,5
2019,218238,40,0,19,6,13
2019,218238,40,5,19,6,13
2019,218238,42,0,19,6,13
2019,218238,42,5,19,6,13
2019,218335,0,0,202,77,125
2019,218335,10,0,199,77,122
2019,218335,10,1,60,33,27
2019,218335,10,2,60,23,37
2019,218335,10,3,46,13,33
2019,218335,10,4,33,8,25
2019,218335,20,0,32,18,14
2019,218335,20,1,31,18,13
2019,218335,20,2,1,0,1
2019,218335,30,0,119,45,74
2019,218335,30,1,23,14,9
2019,218335,30,2,46,18,28
2019,218335,30,3,34,11,23
2019,218335,30,4,16,2,14
2019,218335,40,0,48,14,34
2019,218335,40,1,6,1,5
2019,218335,40,2,13,5,8
2019,218335,40,3,12,2,10
2019,218335,40,4,17,6,11
2019,218335,42,0,48,14,34
2019,218335,42,1,6,1,5
2019,218335,42,2,13,5,8
2019,218335,42,3,12,2,10
2019,218335,42,4,17,6,11
2019,218335,50,0,3,0,3
2019,218353,0,0,219,98,121
2019,218353,10,0,219,98,121
2019,218353,10,6,219,98,121
2019,218353,40,0,219,98,121
2019,218353,40,6,219,98,121
2019,218353,41,0,219,98,121
2019,218353,41,6,219,98,121
2019,218353,45,0,219,98,121
2019,218353,45,6,219,98,121
2019,218399,0,0,36,18,18
2019,218399,10,0,36,18,18
2019,218399,10,1,10,7,3
2019,218399,10,2,8,3,5
2019,218399,10,3,14,5,9
2019,218399,10,4,4,3,1
2019,218399,40,0,36,18,18
2019,218399,40,1,10,7,3
2019,218399,40,2,8,3,5
2019,218399,40,3,14,5,9
2019,218399,40,4,4,3,1
2019,218399,41,0,1,1,0
2019,218399,41,1,1,1,0
2019,218399,42,0,35,17,18
2019,218399,42,1,9,6,3
2019,218399,42,2,8,3,5
2019,218399,42,3,14,5,9
2019,218399,42,4,4,3,1
2019,218399,44,0,1,1,0
2019,218399,44,1,1,1,0
2019,218414,0,0,68,31,37
2019,218414,10,0,64,31,33
2019,218414,10,1,15,11,4
2019,218414,10,2,18,6,12
2019,218414,10,3,31,14,17
2019,218414,20,0,35,18,17
2019,218414,20,1,14,11,3
2019,218414,20,2,17,5,12
2019,218414,20,3,4,2,2
2019,218414,30,0,21,9,12
2019,218414,30,2,1,1,0
2019,218414,30,3,20,8,12
2019,218414,40,0,8,4,4
2019,218414,40,1,1,0,1
2019,218414,40,3,7,4,3
2019,218414,41,0,1,0,1
2019,218414,41,1,1,0,1
2019,218414,42,0,7,4,3
2019,218414,42,3,7,4,3
2019,218414,44,0,1,0,1
2019,218414,44,1,1,0,1
2019,218414,50,0,4,0,4
2019,218441,0,0,157,89,68
2019,218441,10,0,157,89,68
2019,218441,10,1,48,32,16
2019,218441,10,2,27,18,9
2019,218441,10,3,37,20,17
2019,218441,10,4,45,19,26
2019,218441,40,0,157,89,68
2019,218441,40,1,48,32,16
2019,218441,40,2,27,18,9
2019,218441,40,3,37,20,17
2019,218441,40,4,45,19,26
2019,218441,42,0,157,89,68
2019,218441,42,1,48,32,16
2019,218441,42,2,27,18,9
2019,218441,42,3,37,20,17
2019,218441,42,4,45,19,26
2019,218487,0,0,70,22,48
2019,218487,10,0,70,22,48
2019,218487,10,6,70,22,48
2019,218487,40,0,70,22,48
2019,218487,40,6,70,22,48
2019,218487,41,0,70,22,48
2019,218487,41,6,70,22,48
2019,218487,45,0,70,22,48
2019,218487,45,6,70,22,48
2019,218520,0,0,112,52,60
2019,218520,10,0,112,52,60
2019,218520,10,6,112,52,60
2019,218520,40,0,112,52,60
2019,218520,40,6,112,52,60
2019,218520,41,0,112,52,60
2019,218520,41,6,112,52,60
2019,218520,45,0,112,52,60
2019,218520,45,6,112,52,60
2019,218539,0,0,104,61,43
2019,218539,10,0,104,61,43
2019,218539,10,1,44,31,13
2019,218539,10,2,29,16,13
2019,218539,10,3,30,13,17
2019,218539,10,4,1,1,0
2019,218539,20,0,63,43,20
2019,218539,20,1,43,30,13
2019,218539,20,2,20,13,7
2019,218539,30,0,24,10,14
2019,218539,30,2,6,2,4
2019,218539,30,3,18,8,10
2019,218539,40,0,17,8,9
2019,218539,40,1,1,1,0
2019,218539,40,2,3,1,2
2019,218539,40,3,12,5,7
2019,218539,40,4,1,1,0
2019,218539,42,0,17,8,9
2019,218539,42,1,1,1,0
2019,218539,42,2,3,1,2
2019,218539,42,3,12,5,7
2019,218539,42,4,1,1,0
2019,218645,0,0,161,83,78
2019,218645,10,0,161,83,78
2019,218645,10,1,31,23,8
2019,218645,10,2,47,21,26
2019,218645,10,3,53,22,31
2019,218645,10,4,30,17,13
2019,218645,20,0,74,40,34
2019,218645,20,1,30,22,8
2019,218645,20,2,43,17,26
2019,218645,20,3,1,1,0
2019,218645,30,0,54,25,29
2019,218645,30,2,4,4,0
2019,218645,30,3,50,21,29
2019,218645,40,0,33,18,15
2019,218645,40,1,1,1,0
2019,218645,40,3,2,0,2
2019,218645,40,4,30,17,13
2019,218645,41,0,10,6,4
2019,218645,41,3,1,0,1
2019,218645,41,4,9,6,3
2019,218645,42,0,23,12,11
2019,218645,42,1,1,1,0
2019,218645,42,3,1,0,1
2019,218645,42,4,21,11,10
2019,218645,44,0,10,6,4
2019,218645,44,3,1,0,1
2019,218645,44,4,9,6,3
2019,218654,0,0,93,40,53
2019,218654,10,0,93,40,53
2019,218654,10,1,11,8,3
2019,218654,10,2,24,12,12
2019,218654,10,3,34,13,21
2019,218654,10,4,24,7,17
2019,218654,20,0,29,18,11
2019,218654,20,1,10,7,3
2019,218654,20,2,19,11,8
2019,218654,30,0,35,12,23
2019,218654,30,2,5,1,4
2019,218654,30,3,30,11,19
2019,218654,40,0,29,10,19
2019,218654,40,1,1,1,0
2019,218654,40,3,4,2,2
2019,218654,40,4,24,7,17
2019,218654,42,0,29,10,19
2019,218654,42,1,1,1,0
2019,218654,42,3,4,2,2
2019,218654,42,4,24,7,17
2019,218663,0,0,1689,938,751
2019,218663,10,0,1689,938,751
2019,218663,10,1,468,332,136
2019,218663,10,2,511,287,224
2019,218663,10,3,457,211,246
2019,218663,10,4,218,92,126
2019,218663,10,5,30,16,14
2019,218663,10,6,5,0,5
2019,218663,20,0,808,510,298
2019,218663,20,1,430,303,127
2019,218663,20,2,378,207,171
2019,218663,30,0,306,164,142
2019,218663,30,2,27,20,7
2019,218663,30,3,279,144,135
2019,218663,40,0,575,264,311
2019,218663,40,1,38,29,9
2019,218663,40,2,106,60,46
2019,218663,40,3,178,67,111
2019,218663,40,4,218,92,126
2019,218663,40,5,30,16,14
2019,218663,40,6,5,0,5
2019,218663,41,0,190,92,98
2019,218663,41,1,11,9,2
2019,218663,41,2,25,15,10
2019,218663,41,3,36,17,19
2019,218663,41,4,110,49,61
2019,218663,41,5,5,2,3
2019,218663,41,6,3,0,3
2019,218663,42,0,383,171,212
2019,218663,42,1,27,20,7
2019,218663,42,2,81,45,36
2019,218663,42,3,140,49,91
2019,218663,42,4,108,43,65
2019,218663,42,5,25,14,11
2019,218663,42,6,2,0,2
2019,218663,43,0,2,1,1
2019,218663,43,3,2,1,1
2019,218663,44,0,190,92,98
2019,218663,44,1,11,9,2
2019,218663,44,2,25,15,10
2019,218663,44,3,36,17,19
2019,218663,44,4,110,49,61
2019,218663,44,5,5,2,3
2019,218663,44,6,3,0,3
2019,218672,0,0,52,28,24
2019,218672,10,0,52,28,24
2019,218672,10,1,7,3,4
2019,218672,10,2,17,10,7
2019,218672,10,3,10,4,6
2019,218672,10,4,18,11,7
2019,218672,20,0,24,13,11
2019,218672,20,1,7,3,4
2019,218672,20,2,17,10,7
2019,218672,30,0,10,4,6
2019,218672,30,3,10,4,6
2019,218672,40,0,18,11,7
2019,218672,40,4,18,11,7
2019,218672,41,0,13,7,6
2019,218672,41,4,13,7,6
2019,218672,42,0,5,4,1
2019,218672,42,4,5,4,1
2019,218672,44,0,13,7,6
2019,218672,44,4,13,7,6
2019,218681,0,0,24,16,8
2019,218681,10,0,24,16,8
2019,218681,10,1,4,3,1
2019,218681,10,2,5,4,1
2019,218681,10,3,9,5,4
2019,218681,10,4,6,4,2
2019,218681,20,0,9,7,2
2019,218681,20,1,4,3,1
2019,218681,20,2,5,4,1
2019,218681,30,0,9,5,4
2019,218681,30,3,9,5,4
2019,218681,40,0,6,4,2
2019,218681,40,4,6,4,2
2019,218681,42,0,6,4,2
2019,218681,42,4,6,4,2
2019,218690,0,0,37,16,21
2019,218690,10,0,37,16,21
2019,218690,10,1,12,7,5
2019,218690,10,2,1,1,0
2019,218690,10,3,8,3,5
2019,218690,10,4,16,5,11
2019,218690,20,0,14,9,5
2019,218690,20,1,12,7,5
2019,218690,20,2,1,1,0
2019,218690,20,3,1,1,0
2019,218690,30,0,7,2,5
2019,218690,30,3,7,2,5
2019,218690,40,0,16,5,11
2019,218690,40,4,16,5,11
2019,218690,41,0,5,3,2
2019,218690,41,4,5,3,2
2019,218690,42,0,11,2,9
2019,218690,42,4,11,2,9
2019,218690,44,0,5,3,2
2019,218690,44,4,5,3,2
2019,218706,0,0,13,6,7
2019,218706,10,0,13,6,7
2019,218706,10,2,3,2,1
2019,218706,10,3,7,2,5
2019,218706,10,4,3,2,1
2019,218706,20,0,3,2,1
2019,218706,20,2,3,2,1
2019,218706,30,0,7,2,5
2019,218706,30,3,7,2,5
2019,218706,40,0,3,2,1
2019,218706,40,4,3,2,1
2019,218706,41,0,1,1,0
2019,218706,41,4,1,1,0
2019,218706,42,0,2,1,1
2019,218706,42,4,2,1,1
2019,218706,44,0,1,1,0
2019,218706,44,4,1,1,0
2019,218724,0,0,488,265,223
2019,218724,10,0,488,265,223
2019,218724,10,1,102,71,31
2019,218724,10,2,112,68,44
2019,218724,10,3,123,58,65
2019,218724,10,4,6,4,2
2019,218724,10,5,145,64,81
2019,218724,20,0,206,134,72
2019,218724,20,1,102,71,31
2019,218724,20,2,103,63,40
2019,218724,20,3,1,0,1
2019,218724,30,0,118,54,64
2019,218724,30,2,9,5,4
2019,218724,30,3,109,49,60
2019,218724,40,0,164,77,87
2019,218724,40,3,13,9,4
2019,218724,40,4,6,4,2
2019,218724,40,5,145,64,81
2019,218724,42,0,164,77,87
2019,218724,42,3,13,9,4
2019,218724,42,4,6,4,2
2019,218724,42,5,145,64,81
2019,218733,0,0,135,72,63
2019,218733,10,0,135,72,63
2019,218733,10,1,34,22,12
2019,218733,10,2,34,17,17
2019,218733,10,3,42,21,21
2019,218733,10,4,25,12,13
2019,218733,20,0,67,40,27
2019,218733,20,1,34,22,12
2019,218733,20,2,31,16,15
2019,218733,20,3,2,2,0
2019,218733,30,0,32,16,16
2019,218733,30,2,3,1,2
2019,218733,30,3,29,15,14
2019,218733,40,0,36,16,20
2019,218733,40,3,11,4,7
2019,218733,40,4,25,12,13
2019,218733,42,0,36,16,20
2019,218733,42,3,11,4,7
2019,218733,42,4,25,12,13
2019,218742,0,0,240,99,141
2019,218742,10,0,240,99,141
2019,218742,10,1,42,22,20
2019,218742,10,2,56,28,28
2019,218742,10,3,68,27,41
2019,218742,10,4,74,22,52
2019,218742,20,0,96,51,45
2019,218742,20,1,42,22,20
2019,218742,20,2,53,28,25
2019,218742,20,3,1,1,0
2019,218742,30,0,69,26,43
2019,218742,30,2,3,0,3
2019,218742,30,3,66,26,40
2019,218742,40,0,75,22,53
2019,218742,40,3,1,0,1
2019,218742,40,4,74,22,52
2019,218742,41,0,35,11,24
2019,218742,41,3,1,0,1
2019,218742,41,4,34,11,23
2019,218742,42,0,40,11,29
2019,218742,42,4,40,11,29
2019,218742,44,0,35,11,24
2019,218742,44,3,1,0,1
2019,218742,44,4,34,11,23
2019,218751,0,0,38,15,23
2019,218751,10,0,38,15,23
2019,218751,10,1,8,3,5
2019,218751,10,2,5,1,4
2019,218751,10,3,15,6,9
2019,218751,10,4,10,5,5
2019,218751,40,0,38,15,23
2019,218751,40,1,8,3,5
2019,218751,40,2,5,1,4
2019,218751,40,3,15,6,9
2019,218751,40,4,10,5,5
2019,218751,43,0,38,15,23
2019,218751,43,1,8,3,5
2019,218751,43,2,5,1,4
2019,218751,43,3,15,6,9
2019,218751,43,4,10,5,5
2019,218821,0,0,33,15,18
2019,218821,10,0,33,15,18
2019,218821,10,6,33,15,18
2019,218821,20,0,10,6,4
2019,218821,20,6,10,6,4
2019,218821,30,0,8,5,3
2019,218821,30,6,8,5,3
2019,218821,40,0,15,4,11
2019,218821,40,6,15,4,11
2019,218821,42,0,15,4,11
2019,218821,42,6,15,4,11
2019,218830,0,0,119,54,65
2019,218830,10,0,119,54,65
2019,218830,10,6,119,54,65
2019,218830,40,0,119,54,65
2019,218830,40,6,119,54,65
2019,218830,41,0,119,54,65
2019,218830,41,6,119,54,65
2019,218830,45,0,119,54,65
2019,218830,45,6,119,54,65
2019,218858,0,0,94,38,56
2019,218858,10,0,94,38,56
2019,218858,10,6,94,38,56
2019,218858,40,0,94,38,56
2019,218858,40,6,94,38,56
2019,218858,41,0,94,38,56
2019,218858,41,6,94,38,56
2019,218858,45,0,94,38,56
2019,218858,45,6,94,38,56
2019,218885,0,0,145,60,85
2019,218885,10,0,145,60,85
2019,218885,10,6,145,60,85
2019,218885,40,0,145,60,85
2019,218885,40,6,145,60,85
2019,218885,41,0,145,60,85
2019,218885,41,6,145,60,85
2019,218885,45,0,145,60,85
2019,218885,45,6,145,60,85
2019,218894,0,0,256,110,146
2019,218894,10,0,256,110,146
2019,218894,10,6,256,110,146
2019,218894,40,0,256,110,146
2019,218894,40,6,256,110,146
2019,218894,41,0,256,110,146
2019,218894,41,6,256,110,146
2019,218894,45,0,256,110,146
2019,218894,45,6,256,110,146
2019,218919,0,0,27,13,14
2019,218919,10,0,27,13,14
2019,218919,10,1,2,2,0
2019,218919,10,2,4,2,2
2019,218919,10,3,17,6,11
2019,218919,10,4,4,3,1
2019,218919,30,0,27,13,14
2019,218919,30,1,2,2,0
2019,218919,30,2,4,2,2
2019,218919,30,3,17,6,11
2019,218919,30,4,4,3,1
2019,218955,0,0,23,10,13
2019,218955,10,0,23,10,13
2019,218955,10,6,23,10,13
2019,218955,40,0,23,10,13
2019,218955,40,6,23,10,13
2019,218955,41,0,23,10,13
2019,218955,41,6,23,10,13
2019,218955,45,0,23,10,13
2019,218955,45,6,23,10,13
2019,218964,0,0,288,130,158
2019,218964,10,0,288,130,158
2019,218964,10,1,76,43,33
2019,218964,10,2,75,37,38
2019,218964,10,3,97,37,60
2019,218964,10,4,40,13,27
2019,218964,20,0,134,71,63
2019,218964,20,1,71,40,31
2019,218964,20,2,58,29,29
2019,218964,20,3,5,2,3
2019,218964,30,0,91,37,54
2019,218964,30,1,3,1,2
2019,218964,30,2,14,7,7
2019,218964,30,3,74,29,45
2019,218964,40,0,63,22,41
2019,218964,40,1,2,2,0
2019,218964,40,2,3,1,2
2019,218964,40,3,18,6,12
2019,218964,40,4,40,13,27
2019,218964,41,0,19,6,13
2019,218964,41,2,3,1,2
2019,218964,41,3,3,0,3
2019,218964,41,4,13,5,8
2019,218964,42,0,44,16,28
2019,218964,42,1,2,2,0
2019,218964,42,3,15,6,9
2019,218964,42,4,27,8,19
2019,218964,44,0,19,6,13
2019,218964,44,2,3,1,2
2019,218964,44,3,3,0,3
2019,218964,44,4,13,5,8
2019,218973,0,0,143,77,66
2019,218973,10,0,143,77,66
2019,218973,10,1,53,33,20
2019,218973,10,2,42,24,18
2019,218973,10,3,34,15,19
2019,218973,10,4,14,5,9
2019,218973,20,0,103,61,42
2019,218973,20,1,52,32,20
2019,218973,20,2,41,23,18
2019,218973,20,3,10,6,4
2019,218973,30,0,24,9,15
2019,218973,30,3,24,9,15
2019,218973,40,0,16,7,9
2019,218973,40,1,1,1,0
2019,218973,40,2,1,1,0
2019,218973,40,4,14,5,9
2019,218973,42,0,16,7,9
2019,218973,42,1,1,1,0
2019,218973,42,2,1,1,0
2019,218973,42,4,14,5,9
2019,218991,0,0,117,52,65
2019,218991,10,0,117,52,65
2019,218991,10,6,117,52,65
2019,218991,40,0,117,52,65
2019,218991,40,6,117,52,65
2019,218991,41,0,117,52,65
2019,218991,41,6,117,52,65
2019,218991,45,0,117,52,65
2019,218991,45,6,117,52,65
2019,219000,0,0,148,71,77
2019,219000,10,0,148,71,77
2019,219000,10,1,30,23,7
2019,219000,10,2,42,21,21
2019,219000,10,3,67,26,41
2019,219000,10,4,9,1,8
2019,219000,20,0,71,45,26
2019,219000,20,1,30,23,7
2019,219000,20,2,39,20,19
2019,219000,20,3,2,2,0
2019,219000,30,0,33,14,19
2019,219000,30,3,33,14,19
2019,219000,40,0,44,12,32
2019,219000,40,2,3,1,2
2019,219000,40,3,32,10,22
2019,219000,40,4,9,1,8
2019,219000,42,0,44,12,32
2019,219000,42,2,3,1,2
2019,219000,42,3,32,10,22
2019,219000,42,4,9,1,8
2019,219046,0,0,127,72,55
2019,219046,10,0,127,72,55
2019,219046,10,1,27,20,7
2019,219046,10,2,30,15,15
2019,219046,10,3,43,25,18
2019,219046,10,4,23,11,12
2019,219046,10,5,4,1,3
2019,219046,20,0,56,34,22
2019,219046,20,1,27,20,7
2019,219046,20,2,28,14,14
2019,219046,20,3,1,0,1
2019,219046,30,0,37,23,14
2019,219046,30,2,2,1,1
2019,219046,30,3,35,22,13
2019,219046,40,0,34,15,19
2019,219046,40,3,7,3,4
2019,219046,40,4,23,11,12
2019,219046,40,5,4,1,3
2019,219046,42,0,34,15,19
2019,219046,42,3,7,3,4
2019,219046,42,4,23,11,12
2019,219046,42,5,4,1,3
2019,219082,0,0,105,72,33
2019,219082,10,0,105,72,33
2019,219082,10,1,20,17,3
2019,219082,10,2,25,15,10
2019,219082,10,3,30,24,6
2019,219082,10,4,25,14,11
2019,219082,10,5,5,2,3
2019,219082,20,0,41,29,12
2019,219082,20,1,19,16,3
2019,219082,20,2,22,13,9
2019,219082,30,0,32,25,7
2019,219082,30,1,1,1,0
2019,219082,30,2,3,2,1
2019,219082,30,3,28,22,6
2019,219082,40,0,32,18,14
2019,219082,40,3,2,2,0
2019,219082,40,4,25,14,11
2019,219082,40,5,5,2,3
2019,219082,42,0,32,18,14
2019,219082,42,3,2,2,0
2019,219082,42,4,25,14,11
2019,219082,42,5,5,2,3
2019,219091,0,0,49,23,26
2019,219091,10,0,49,23,26
2019,219091,10,1,10,8,2
2019,219091,10,2,17,8,9
2019,219091,10,3,17,4,13
2019,219091,10,4,5,3,2
2019,219091,20,0,23,13,10
2019,219091,20,1,10,8,2
2019,219091,20,2,13,5,8
2019,219091,30,0,14,5,9
2019,219091,30,2,1,1,0
2019,219091,30,3,13,4,9
2019,219091,40,0,12,5,7
2019,219091,40,2,3,2,1
2019,219091,40,3,4,0,4
2019,219091,40,4,5,3,2
2019,219091,42,0,12,5,7
2019,219091,42,2,3,2,1
2019,219091,42,3,4,0,4
2019,219091,42,4,5,3,2
2019,219143,0,0,108,65,43
2019,219143,10,0,103,61,42
2019,219143,10,4,103,61,42
2019,219143,40,0,103,61,42
2019,219143,40,4,103,61,42
2019,219143,42,0,103,61,42
2019,219143,42,4,103,61,42
2019,219143,50,0,5,4,1
2019,219189,0,0,67,40,27
2019,219189,10,0,67,40,27
2019,219189,10,4,67,40,27
2019,219189,40,0,67,40,27
2019,219189,40,4,67,40,27
2019,219189,42,0,67,40,27
2019,219189,42,4,67,40,27
2019,219198,0,0,45,20,25
2019,219198,10,0,45,20,25
2019,219198,10,1,8,6,2
2019,219198,10,2,11,7,4
2019,219198,10,3,22,5,17
2019,219198,10,4,4,2,2
2019,219198,20,0,20,12,8
2019,219198,20,1,8,6,2
2019,219198,20,2,9,6,3
2019,219198,20,3,3,0,3
2019,219198,30,0,16,4,12
2019,219198,30,2,1,1,0
2019,219198,30,3,15,3,12
2019,219198,40,0,9,4,5
2019,219198,40,2,1,0,1
2019,219198,40,3,4,2,2
2019,219198,40,4,4,2,2
2019,219198,42,0,9,4,5
2019,219198,42,2,1,0,1
2019,219198,42,3,4,2,2
2019,219198,42,4,4,2,2
2019,219204,0,0,1,0,1
2019,219204,50,0,1,0,1
2019,219259,0,0,91,46,45
2019,219259,10,0,88,46,42
2019,219259,10,1,25,15,10
2019,219259,10,2,20,13,7
2019,219259,10,3,27,12,15
2019,219259,10,4,14,4,10
2019,219259,10,5,2,2,0
2019,219259,20,0,44,27,17
2019,219259,20,1,25,15,10
2019,219259,20,2,19,12,7
2019,219259,30,0,27,12,15
2019,219259,30,2,1,1,0
2019,219259,30,3,26,11,15
2019,219259,40,0,17,7,10
2019,219259,40,3,1,1,0
2019,219259,40,4,14,4,10
2019,219259,40,5,2,2,0
2019,219259,42,0,17,7,10
2019,219259,42,3,1,1,0
2019,219259,42,4,14,4,10
2019,219259,42,5,2,2,0
2019,219259,50,0,3,0,3
2019,219277,0,0,59,27,32
2019,219277,10,0,59,27,32
2019,219277,10,1,2,2,0
2019,219277,10,2,8,3,5
2019,219277,10,3,49,22,27
2019,219277,40,0,59,27,32
2019,219277,40,1,2,2,0
2019,219277,40,2,8,3,5
2019,219277,40,3,49,22,27
2019,219277,41,0,10,5,5
2019,219277,41,1,2,2,0
2019,219277,41,2,8,3,5
2019,219277,42,0,49,22,27
2019,219277,42,3,49,22,27
2019,219277,44,0,10,5,5
2019,219277,44,1,2,2,0
2019,219277,44,2,8,3,5
2019,219295,0,0,35,8,27
2019,219295,10,0,35,8,27
2019,219295,10,1,4,3,1
2019,219295,10,2,4,2,2
2019,219295,10,3,9,2,7
2019,219295,10,4,17,1,16
2019,219295,10,5,1,0,1
2019,219295,20,0,5,3,2
2019,219295,20,1,4,3,1
2019,219295,20,2,1,0,1
2019,219295,30,0,5,2,3
2019,219295,30,2,2,2,0
2019,219295,30,3,2,0,2
2019,219295,30,4,1,0,1
2019,219295,40,0,25,3,22
2019,219295,40,2,1,0,1
2019,219295,40,3,7,2,5
2019,219295,40,4,16,1,15
2019,219295,40,5,1,0,1
2019,219295,42,0,25,3,22
2019,219295,42,2,1,0,1
2019,219295,42,3,7,2,5
2019,219295,42,4,16,1,15
2019,219295,42,5,1,0,1
2019,219347,0,0,154,117,37
2019,219347,10,0,154,117,37
2019,219347,10,1,36,33,3
2019,219347,10,2,42,33,9
2019,219347,10,3,46,35,11
2019,219347,10,4,9,4,5
2019,219347,10,5,21,12,9
2019,219347,20,0,76,65,11
2019,219347,20,1,34,31,3
2019,219347,20,2,41,33,8
2019,219347,20,3,1,1,0
2019,219347,30,0,38,28,10
2019,219347,30,2,1,0,1
2019,219347,30,3,37,28,9
2019,219347,40,0,40,24,16
2019,219347,40,1,2,2,0
2019,219347,40,3,8,6,2
2019,219347,40,4,9,4,5
2019,219347,40,5,21,12,9
2019,219347,42,0,40,24,16
2019,219347,42,1,2,2,0
2019,219347,42,3,8,6,2
2019,219347,42,4,9,4,5
2019,219347,42,5,21,12,9
2019,219356,0,0,512,279,233
2019,219356,10,0,512,279,233
2019,219356,10,1,127,89,38
2019,219356,10,2,103,71,32
2019,219356,10,3,112,60,52
2019,219356,10,4,97,39,58
2019,219356,10,5,73,20,53
2019,219356,20,0,207,148,59
2019,219356,20,1,114,82,32
2019,219356,20,2,93,66,27
2019,219356,30,0,102,57,45
2019,219356,30,1,1,1,0
2019,219356,30,2,3,2,1
2019,219356,30,3,98,54,44
2019,219356,40,0,203,74,129
2019,219356,40,1,12,6,6
2019,219356,40,2,7,3,4
2019,219356,40,3,14,6,8
2019,219356,40,4,97,39,58
2019,219356,40,5,73,20,53
2019,219356,42,0,203,74,129
2019,219356,42,1,12,6,6
2019,219356,42,2,7,3,4
2019,219356,42,3,14,6,8
2019,219356,42,4,97,39,58
2019,219356,42,5,73,20,53
2019,219374,0,0,18,8,10
2019,219374,10,0,18,8,10
2019,219374,10,4,18,8,10
2019,219374,40,0,18,8,10
2019,219374,40,4,18,8,10
2019,219374,42,0,18,8,10
2019,219374,42,4,18,8,10
2019,219383,0,0,57,34,23
2019,219383,10,0,57,34,23
2019,219383,10,1,11,6,5
2019,219383,10,2,25,16,9
2019,219383,10,3,19,10,9
2019,219383,10,4,2,2,0
2019,219383,20,0,36,22,14
2019,219383,20,1,11,6,5
2019,219383,20,2,25,16,9
2019,219383,30,0,8,5,3
2019,219383,30,3,8,5,3
2019,219383,40,0,13,7,6
2019,219383,40,3,11,5,6
2019,219383,40,4,2,2,0
2019,219383,41,0,11,5,6
2019,219383,41,3,11,5,6
2019,219383,42,0,2,2,0
2019,219383,42,4,2,2,0
2019,219383,44,0,11,5,6
2019,219383,44,3,11,5,6
2019,219408,0,0,13,8,5
2019,219408,10,0,13,8,5
2019,219408,10,4,13,8,5
2019,219408,40,0,13,8,5
2019,219408,40,4,13,8,5
2019,219408,41,0,2,1,1
2019,219408,41,4,2,1,1
2019,219408,42,0,11,7,4
2019,219408,42,4,11,7,4
2019,219408,45,0,2,1,1
2019,219408,45,4,2,1,1
2019,219426,0,0,93,42,51
2019,219426,10,0,78,37,41
2019,219426,10,4,78,37,41
2019,219426,40,0,78,37,41
2019,219426,40,4,78,37,41
2019,219426,41,0,78,37,41
2019,219426,41,4,78,37,41
2019,219426,45,0,78,37,41
2019,219426,45,4,78,37,41
2019,219426,50,0,15,5,10
2019,219471,0,0,448,222,226
2019,219471,10,0,428,211,217
2019,219471,10,1,77,58,19
2019,219471,10,2,95,56,39
2019,219471,10,3,118,61,57
2019,219471,10,4,96,21,75
2019,219471,10,5,41,15,26
2019,219471,10,6,1,0,1
2019,219471,20,0,159,111,48
2019,219471,20,1,75,58,17
2019,219471,20,2,84,53,31
2019,219471,30,0,105,54,51
2019,219471,30,2,4,0,4
2019,219471,30,3,100,53,47
2019,219471,30,5,1,1,0
2019,219471,40,0,164,46,118
2019,219471,40,1,2,0,2
2019,219471,40,2,7,3,4
2019,219471,40,3,18,8,10
2019,219471,40,4,96,21,75
2019,219471,40,5,40,14,26
2019,219471,40,6,1,0,1
2019,219471,42,0,164,46,118
2019,219471,42,1,2,0,2
2019,219471,42,2,7,3,4
2019,219471,42,3,18,8,10
2019,219471,42,4,96,21,75
2019,219471,42,5,40,14,26
2019,219471,42,6,1,0,1
2019,219471,50,0,20,11,9
2019,219480,0,0,46,25,21
2019,219480,10,0,46,25,21
2019,219480,10,4,46,25,21
2019,219480,40,0,46,25,21
2019,219480,40,4,46,25,21
2019,219480,42,0,46,25,21
2019,219480,42,4,46,25,21
2019,219505,0,0,3,1,2
2019,219505,10,0,3,1,2
2019,219505,10,6,3,1,2
2019,219505,40,0,3,1,2
2019,219505,40,6,3,1,2
2019,219505,41,0,3,1,2
2019,219505,41,6,3,1,2
2019,219505,45,0,3,1,2
2019,219505,45,6,3,1,2
2019,219602,0,0,385,195,190
2019,219602,10,0,385,195,190
2019,219602,10,1,142,88,54
2019,219602,10,2,102,48,54
2019,219602,10,3,99,41,58
2019,219602,10,4,42,18,24
2019,219602,20,0,231,123,108
2019,219602,20,1,141,87,54
2019,219602,20,2,72,32,40
2019,219602,20,3,9,2,7
2019,219602,20,4,9,2,7
2019,219602,30,0,109,51,58
2019,219602,30,1,1,1,0
2019,219602,30,2,29,16,13
2019,219602,30,3,76,33,43
2019,219602,30,4,3,1,2
2019,219602,40,0,45,21,24
2019,219602,40,2,1,0,1
2019,219602,40,3,14,6,8
2019,219602,40,4,30,15,15
2019,219602,41,0,5,1,4
2019,219602,41,3,1,1,0
2019,219602,41,4,4,0,4
2019,219602,42,0,40,20,20
2019,219602,42,2,1,0,1
2019,219602,42,3,13,5,8
2019,219602,42,4,26,15,11
2019,219602,44,0,5,1,4
2019,219602,44,3,1,1,0
2019,219602,44,4,4,0,4
2019,219639,0,0,70,15,55
2019,219639,10,0,70,15,55
2019,219639,10,1,5,1,4
2019,219639,10,2,15,1,14
2019,219639,10,3,41,11,30
2019,219639,10,4,2,0,2
2019,219639,10,6,7,2,5
2019,219639,40,0,70,15,55
2019,219639,40,1,5,1,4
2019,219639,40,2,15,1,14
2019,219639,40,3,41,11,30
2019,219639,40,4,2,0,2
2019,219639,40,6,7,2,5
2019,219639,41,0,70,15,55
2019,219639,41,1,5,1,4
2019,219639,41,2,15,1,14
2019,219639,41,3,41,11,30
2019,219639,41,4,2,0,2
2019,219639,41,6,7,2,5
2019,219639,45,0,70,15,55
2019,219639,45,1,5,1,4
2019,219639,45,2,15,1,14
2019,219639,45,3,41,11,30
2019,219639,45,4,2,0,2
2019,219639,45,6,7,2,5
2019,219709,0,0,377,191,186
2019,219709,10,0,377,191,186
2019,219709,10,1,110,73,37
2019,219709,10,2,128,57,71
2019,219709,10,3,103,43,60
2019,219709,10,4,36,18,18
2019,219709,20,0,231,126,105
2019,219709,20,1,105,69,36
2019,219709,20,2,123,56,67
2019,219709,20,3,3,1,2
2019,219709,30,0,106,45,61
2019,219709,30,1,2,1,1
2019,219709,30,2,3,1,2
2019,219709,30,3,94,40,54
2019,219709,30,4,7,3,4
2019,219709,40,0,40,20,20
2019,219709,40,1,3,3,0
2019,219709,40,2,2,0,2
2019,219709,40,3,6,2,4
2019,219709,40,4,29,15,14
2019,219709,42,0,40,20,20
2019,219709,42,1,3,3,0
2019,219709,42,2,2,0,2
2019,219709,42,3,6,2,4
2019,219709,42,4,29,15,14
2019,219718,0,0,160,89,71
2019,219718,10,0,160,89,71
2019,219718,10,1,23,15,8
2019,219718,10,2,31,17,14
2019,219718,10,3,30,16,14
2019,219718,10,4,9,3,6
2019,219718,10,5,67,38,29
2019,219718,20,0,46,29,17
2019,219718,20,1,22,15,7
2019,219718,20,2,24,14,10
2019,219718,40,0,114,60,54
2019,219718,40,1,1,0,1
2019,219718,40,2,7,3,4
2019,219718,40,3,30,16,14
2019,219718,40,4,9,3,6
2019,219718,40,5,67,38,29
2019,219718,42,0,114,60,54
2019,219718,42,1,1,0,1
2019,219718,42,2,7,3,4
2019,219718,42,3,30,16,14
2019,219718,42,4,9,3,6
2019,219718,42,5,67,38,29
2019,219790,0,0,43,31,12
2019,219790,10,0,43,31,12
2019,219790,10,1,20,18,2
2019,219790,10,2,11,7,4
2019,219790,10,3,8,5,3
2019,219790,10,4,4,1,3
2019,219790,40,0,43,31,12
2019,219790,40,1,20,18,2
2019,219790,40,2,11,7,4
2019,219790,40,3,8,5,3
2019,219790,40,4,4,1,3
2019,219790,42,0,43,31,12
2019,219790,42,1,20,18,2
2019,219790,42,2,11,7,4
2019,219790,42,3,8,5,3
2019,219790,42,4,4,1,3
2019,219806,0,0,120,60,60
2019,219806,10,0,120,60,60
2019,219806,10,1,34,21,13
2019,219806,10,2,41,18,23
2019,219806,10,3,44,20,24
2019,219806,10,4,1,1,0
2019,219806,20,0,63,32,31
2019,219806,20,1,34,21,13
2019,219806,20,2,28,11,17
2019,219806,20,3,1,0,1
2019,219806,30,0,44,21,23
2019,219806,30,2,11,6,5
2019,219806,30,3,33,15,18
2019,219806,40,0,13,7,6
2019,219806,40,2,2,1,1
2019,219806,40,3,10,5,5
2019,219806,40,4,1,1,0
2019,219806,42,0,13,7,6
2019,219806,42,2,2,1,1
2019,219806,42,3,10,5,5
2019,219806,42,4,1,1,0
2019,219824,0,0,243,108,135
2019,219824,10,0,243,108,135
2019,219824,10,1,30,11,19
2019,219824,10,2,50,20,30
2019,219824,10,3,49,21,28
2019,219824,10,4,114,56,58
2019,219824,20,0,90,36,54
2019,219824,20,1,29,11,18
2019,219824,20,2,44,17,27
2019,219824,20,3,14,6,8
2019,219824,20,4,3,2,1
2019,219824,30,0,86,36,50
2019,219824,30,2,6,3,3
2019,219824,30,3,24,9,15
2019,219824,30,4,56,24,32
2019,219824,40,0,67,36,31
2019,219824,40,1,1,0,1
2019,219824,40,3,11,6,5
2019,219824,40,4,55,30,25
2019,219824,42,0,67,36,31
2019,219824,42,1,1,0,1
2019,219824,42,3,11,6,5
2019,219824,42,4,55,30,25
2019,219833,0,0,109,69,40
2019,219833,10,0,109,69,40
2019,219833,10,1,35,25,10
2019,219833,10,2,43,27,16
2019,219833,10,3,26,15,11
2019,219833,10,4,5,2,3
2019,219833,20,0,68,49,19
2019,219833,20,1,35,25,10
2019,219833,20,2,32,23,9
2019,219833,20,3,1,1,0
2019,219833,30,0,14,10,4
2019,219833,30,2,1,1,0
2019,219833,30,3,13,9,4
2019,219833,40,0,27,10,17
2019,219833,40,2,10,3,7
2019,219833,40,3,12,5,7
2019,219833,40,4,5,2,3
2019,219833,41,0,4,1,3
2019,219833,41,2,2,0,2
2019,219833,41,4,2,1,1
2019,219833,42,0,22,9,13
2019,219833,42,2,8,3,5
2019,219833,42,3,11,5,6
2019,219833,42,4,3,1,2
2019,219833,43,0,1,0,1
2019,219833,43,3,1,0,1
2019,219833,44,0,2,0,2
2019,219833,44,2,2,0,2
2019,219833,45,0,2,1,1
2019,219833,45,4,2,1,1
2019,219842,0,0,8,6,2
2019,219842,10,0,8,6,2
2019,219842,10,1,6,5,1
2019,219842,10,2,1,0,1
2019,219842,10,3,1,1,0
2019,219842,20,0,6,5,1
2019,219842,20,1,6,5,1
2019,219842,40,0,2,1,1
2019,219842,40,2,1,0,1
2019,219842,40,3,1,1,0
2019,219842,43,0,2,1,1
2019,219842,43,2,1,0,1
2019,219842,43,3,1,1,0
2019,219879,0,0,78,36,42
2019,219879,10,0,78,36,42
2019,219879,10,1,8,5,3
2019,219879,10,2,32,13,19
2019,219879,10,3,11,5,6
2019,219879,10,4,27,13,14
2019,219879,20,0,39,16,23
2019,219879,20,1,8,5,3
2019,219879,20,2,27,9,18
2019,219879,20,3,3,2,1
2019,219879,20,4,1,0,1
2019,219879,30,0,30,14,16
2019,219879,30,2,1,1,0
2019,219879,30,3,8,3,5
2019,219879,30,4,21,10,11
2019,219879,40,0,9,6,3
2019,219879,40,2,4,3,1
2019,219879,40,4,5,3,2
2019,219879,41,0,9,6,3
2019,219879,41,2,4,3,1
2019,219879,41,4,5,3,2
2019,219879,44,0,9,6,3
2019,219879,44,2,4,3,1
2019,219879,44,4,5,3,2
2019,219888,0,0,115,44,71
2019,219888,10,0,115,44,71
2019,219888,10,1,19,5,14
2019,219888,10,2,43,22,21
2019,219888,10,3,27,9,18
2019,219888,10,4,26,8,18
2019,219888,20,0,65,25,40
2019,219888,20,1,19,5,14
2019,219888,20,2,38,18,20
2019,219888,20,3,8,2,6
2019,219888,30,0,23,12,11
2019,219888,30,2,5,4,1
2019,219888,30,3,14,6,8
2019,219888,30,4,4,2,2
2019,219888,40,0,27,7,20
2019,219888,40,3,5,1,4
2019,219888,40,4,22,6,16
2019,219888,42,0,25,6,19
2019,219888,42,3,5,1,4
2019,219888,42,4,20,5,15
2019,219888,43,0,2,1,1
2019,219888,43,4,2,1,1
2019,219903,0,0,35,11,24
2019,219903,10,0,35,11,24
2019,219903,10,4,35,11,24
2019,219903,40,0,35,11,24
2019,219903,40,4,35,11,24
2019,219903,41,0,35,11,24
2019,219903,41,4,35,11,24
2019,219903,45,0,35,11,24
2019,219903,45,4,35,11,24
2019,219949,0,0,95,41,54
2019,219949,10,0,95,41,54
2019,219949,10,1,12,11,1
2019,219949,10,2,17,7,10
2019,219949,10,3,37,10,27
2019,219949,10,4,29,13,16
2019,219949,40,0,95,41,54
2019,219949,40,1,12,11,1
2019,219949,40,2,17,7,10
2019,219949,40,3,37,10,27
2019,219949,40,4,29,13,16
2019,219949,41,0,5,2,3
2019,219949,41,1,2,1,1
2019,219949,41,2,3,1,2
2019,219949,42,0,90,39,51
2019,219949,42,1,10,10,0
2019,219949,42,2,14,6,8
2019,219949,42,3,37,10,27
2019,219949,42,4,29,13,16
2019,219949,44,0,5,2,3
2019,219949,44,1,2,1,1
2019,219949,44,2,3,1,2
2019,219976,0,0,235,133,102
2019,219976,10,0,235,133,102
2019,219976,10,1,61,47,14
2019,219976,10,2,71,44,27
2019,219976,10,3,84,36,48
2019,219976,10,4,15,5,10
2019,219976,10,5,4,1,3
2019,219976,20,0,66,48,18
2019,219976,20,1,48,38,10
2019,219976,20,2,18,10,8
2019,219976,30,0,103,57,46
2019,219976,30,1,10,7,3
2019,219976,30,2,42,27,15
2019,219976,30,3,50,22,28
2019,219976,30,4,1,1,0
2019,219976,40,0,66,28,38
2019,219976,40,1,3,2,1
2019,219976,40,2,11,7,4
2019,219976,40,3,34,14,20
2019,219976,40,4,14,4,10
2019,219976,40,5,4,1,3
2019,219976,42,0,66,28,38
2019,219976,42,1,3,2,1
2019,219976,42,2,11,7,4
2019,219976,42,3,34,14,20
2019,219976,42,4,14,4,10
2019,219976,42,5,4,1,3
2019,220057,0,0,52,20,32
2019,220057,10,0,52,20,32
2019,220057,10,1,5,4,1
2019,220057,10,2,26,8,18
2019,220057,10,3,6,2,4
2019,220057,10,4,14,5,9
2019,220057,10,6,1,1,0
2019,220057,20,0,29,11,18
2019,220057,20,1,5,4,1
2019,220057,20,2,24,7,17
2019,220057,30,0,20,7,13
2019,220057,30,2,2,1,1
2019,220057,30,3,6,2,4
2019,220057,30,4,12,4,8
2019,220057,40,0,3,2,1
2019,220057,40,4,2,1,1
2019,220057,40,6,1,1,0
2019,220057,42,0,3,2,1
2019,220057,42,4,2,1,1
2019,220057,42,6,1,1,0
2019,220075,0,0,802,412,390
2019,220075,10,0,802,412,390
2019,220075,10,1,228,155,73
2019,220075,10,2,212,119,93
2019,220075,10,3,256,100,156
2019,220075,10,4,38,5,33
2019,220075,10,5,65,32,33
2019,220075,10,6,3,1,2
2019,220075,20,0,383,242,141
2019,220075,20,1,204,142,62
2019,220075,20,2,161,93,68
2019,220075,20,3,17,6,11
2019,220075,20,4,1,1,0
2019,220075,30,0,149,62,87
2019,220075,30,2,8,4,4
2019,220075,30,3,141,58,83
2019,220075,40,0,270,108,162
2019,220075,40,1,24,13,11
2019,220075,40,2,43,22,21
2019,220075,40,3,98,36,62
2019,220075,40,4,37,4,33
2019,220075,40,5,65,32,33
2019,220075,40,6,3,1,2
2019,220075,42,0,269,107,162
2019,220075,42,1,24,13,11
2019,220075,42,2,43,22,21
2019,220075,42,3,97,35,62
2019,220075,42,4,37,4,33
2019,220075,42,5,65,32,33
2019,220075,42,6,3,1,2
2019,220075,43,0,1,1,0
2019,220075,43,3,1,1,0
2019,220118,0,0,17,2,15
2019,220118,50,0,17,2,15
2019,220181,0,0,58,29,29
2019,220181,10,0,58,29,29
2019,220181,10,1,9,6,3
2019,220181,10,2,26,12,14
2019,220181,10,3,13,8,5
2019,220181,10,4,10,3,7
2019,220181,20,0,26,15,11
2019,220181,20,1,7,5,2
2019,220181,20,2,19,10,9
2019,220181,30,0,17,9,8
2019,220181,30,2,6,2,4
2019,220181,30,3,11,7,4
2019,220181,40,0,15,5,10
2019,220181,40,1,2,1,1
2019,220181,40,2,1,0,1
2019,220181,40,3,2,1,1
2019,220181,40,4,10,3,7
2019,220181,42,0,15,5,10
2019,220181,42,1,2,1,1
2019,220181,42,2,1,0,1
2019,220181,42,3,2,1,1
2019,220181,42,4,10,3,7
2019,220206,0,0,17,12,5
2019,220206,10,0,17,12,5
2019,220206,10,1,6,3,3
2019,220206,10,2,2,2,0
2019,220206,10,3,2,0,2
2019,220206,10,4,7,7,0
2019,220206,40,0,17,12,5
2019,220206,40,1,6,3,3
2019,220206,40,2,2,2,0
2019,220206,40,3,2,0,2
2019,220206,40,4,7,7,0
2019,220206,43,0,17,12,5
2019,220206,43,1,6,3,3
2019,220206,43,2,2,2,0
2019,220206,43,3,2,0,2
2019,220206,43,4,7,7,0
2019,220215,0,0,99,62,37
2019,220215,10,0,99,62,37
2019,220215,10,1,20,16,4
2019,220215,10,2,29,21,8
2019,220215,10,3,35,18,17
2019,220215,10,4,15,7,8
2019,220215,20,0,54,40,14
2019,220215,20,1,19,15,4
2019,220215,20,2,25,18,7
2019,220215,20,3,10,7,3
2019,220215,30,0,26,14,12
2019,220215,30,1,1,1,0
2019,220215,30,2,4,3,1
2019,220215,30,3,18,8,10
2019,220215,30,4,3,2,1
2019,220215,40,0,19,8,11
2019,220215,40,3,7,3,4
2019,220215,40,4,12,5,7
2019,220215,42,0,19,8,11
2019,220215,42,3,7,3,4
2019,220215,42,4,12,5,7
2019,220400,0,0,95,36,59
2019,220400,10,0,95,36,59
2019,220400,10,1,11,5,6
2019,220400,10,2,56,17,39
2019,220400,10,3,23,10,13
2019,220400,10,4,5,4,1
2019,220400,20,0,49,18,31
2019,220400,20,1,11,5,6
2019,220400,20,2,38,13,25
2019,220400,30,0,14,2,12
2019,220400,30,2,12,1,11
2019,220400,30,3,2,1,1
2019,220400,40,0,32,16,16
2019,220400,40,2,6,3,3
2019,220400,40,3,21,9,12
2019,220400,40,4,5,4,1
2019,220400,42,0,32,16,16
2019,220400,42,2,6,3,3
2019,220400,42,3,21,9,12
2019,220400,42,4,5,4,1
2019,220473,0,0,41,28,13
2019,220473,10,0,41,28,13
2019,220473,10,1,26,17,9
2019,220473,10,2,10,9,1
2019,220473,10,3,5,2,3
2019,220473,40,0,41,28,13
2019,220473,40,1,26,17,9
2019,220473,40,2,10,9,1
2019,220473,40,3,5,2,3
2019,220473,42,0,41,28,13
2019,220473,42,1,26,17,9
2019,220473,42,2,10,9,1
2019,220473,42,3,5,2,3
2019,220516,0,0,83,30,53
2019,220516,10,0,83,30,53
2019,220516,10,1,11,7,4
2019,220516,10,2,28,11,17
2019,220516,10,3,37,11,26
2019,220516,10,4,7,1,6
2019,220516,40,0,83,30,53
2019,220516,40,1,11,7,4
2019,220516,40,2,28,11,17
2019,220516,40,3,37,11,26
2019,220516,40,4,7,1,6
2019,220516,41,0,44,23,21
2019,220516,41,1,11,7,4
2019,220516,41,2,23,11,12
2019,220516,41,3,9,4,5
2019,220516,41,4,1,1,0
2019,220516,42,0,39,7,32
2019,220516,42,2,5,0,5
2019,220516,42,3,28,7,21
2019,220516,42,4,6,0,6
2019,220516,44,0,44,23,21
2019,220516,44,1,11,7,4
2019,220516,44,2,23,11,12
2019,220516,44,3,9,4,5
2019,220516,44,4,1,1,0
2019,220552,0,0,206,59,147
2019,220552,10,0,206,59,147
2019,220552,10,1,19,11,8
2019,220552,10,2,32,6,26
2019,220552,10,3,86,22,64
2019,220552,10,4,37,9,28
2019,220552,10,6,32,11,21
2019,220552,40,0,206,59,147
2019,220552,40,1,19,11,8
2019,220552,40,2,32,6,26
2019,220552,40,3,86,22,64
2019,220552,40,4,37,9,28
2019,220552,40,6,32,11,21
2019,220552,41,0,206,59,147
2019,220552,41,1,19,11,8
2019,220552,41,2,32,6,26
2019,220552,41,3,86,22,64
2019,220552,41,4,37,9,28
2019,220552,41,6,32,11,21
2019,220552,45,0,206,59,147
2019,220552,45,1,19,11,8
2019,220552,45,2,32,6,26
2019,220552,45,3,86,22,64
2019,220552,45,4,37,9,28
2019,220552,45,6,32,11,21
2019,220598,0,0,61,40,21
2019,220598,10,0,61,40,21
2019,220598,10,1,1,1,0
2019,220598,10,2,10,6,4
2019,220598,10,3,41,27,14
2019,220598,10,4,9,6,3
2019,220598,20,0,9,6,3
2019,220598,20,1,1,1,0
2019,220598,20,2,8,5,3
2019,220598,30,0,23,16,7
2019,220598,30,2,2,1,1
2019,220598,30,3,21,15,6
2019,220598,40,0,29,18,11
2019,220598,40,3,20,12,8
2019,220598,40,4,9,6,3
2019,220598,42,0,29,18,11
2019,220598,42,3,20,12,8
2019,220598,42,4,9,6,3
2019,220604,0,0,45,23,22
2019,220604,10,0,45,23,22
2019,220604,10,1,8,5,3
2019,220604,10,2,7,4,3
2019,220604,10,3,21,11,10
2019,220604,10,4,9,3,6
2019,220604,20,0,19,11,8
2019,220604,20,1,8,5,3
2019,220604,20,2,5,2,3
2019,220604,20,3,6,4,2
2019,220604,30,0,8,2,6
2019,220604,30,2,1,1,0
2019,220604,30,3,7,1,6
2019,220604,40,0,18,10,8
2019,220604,40,2,1,1,0
2019,220604,40,3,8,6,2
2019,220604,40,4,9,3,6
2019,220604,42,0,18,10,8
2019,220604,42,2,1,1,0
2019,220604,42,3,8,6,2
2019,220604,42,4,9,3,6
2019,220613,0,0,188,109,79
2019,220613,10,0,188,109,79
2019,220613,10,1,58,43,15
2019,220613,10,2,58,42,16
2019,220613,10,3,42,17,25
2019,220613,10,5,30,7,23
2019,220613,20,0,108,79,29
2019,220613,20,1,56,41,15
2019,220613,20,2,48,36,12
2019,220613,20,3,4,2,2
2019,220613,30,0,50,22,28
2019,220613,30,1,2,2,0
2019,220613,30,2,9,5,4
2019,220613,30,3,36,14,22
2019,220613,30,5,3,1,2
2019,220613,40,0,30,8,22
2019,220613,40,2,1,1,0
2019,220613,40,3,2,1,1
2019,220613,40,5,27,6,21
2019,220613,42,0,30,8,22
2019,220613,42,2,1,1,0
2019,220613,42,3,2,1,1
2019,220613,42,5,27,6,21
2019,220631,0,0,299,128,171
2019,220631,10,0,292,125,167
2019,220631,10,1,24,15,9
2019,220631,10,2,60,32,28
2019,220631,10,3,143,65,78
2019,220631,10,4,54,6,48
2019,220631,10,5,11,7,4
2019,220631,20,0,7,6,1
2019,220631,20,1,5,4,1
2019,220631,20,2,1,1,0
2019,220631,20,3,1,1,0
2019,220631,40,0,285,119,166
2019,220631,40,1,19,11,8
2019,220631,40,2,59,31,28
2019,220631,40,3,142,64,78
2019,220631,40,4,54,6,48
2019,220631,40,5,11,7,4
2019,220631,42,0,262,113,149
2019,220631,42,1,18,10,8
2019,220631,42,2,56,30,26
2019,220631,42,3,130,61,69
2019,220631,42,4,48,6,42
2019,220631,42,5,10,6,4
2019,220631,43,0,23,6,17
2019,220631,43,1,1,1,0
2019,220631,43,2,3,1,2
2019,220631,43,3,12,3,9
2019,220631,43,4,6,0,6
2019,220631,43,5,1,1,0
2019,220631,50,0,7,3,4
2019,220701,0,0,46,23,23
2019,220701,10,0,46,23,23
2019,220701,10,1,11,6,5
2019,220701,10,2,7,4,3
2019,220701,10,3,17,7,10
2019,220701,10,4,11,6,5
2019,220701,20,0,15,7,8
2019,220701,20,1,9,5,4
2019,220701,20,2,5,2,3
2019,220701,20,3,1,0,1
2019,220701,30,0,20,9,11
2019,220701,30,1,2,1,1
2019,220701,30,2,1,1,0
2019,220701,30,3,16,7,9
2019,220701,30,4,1,0,1
2019,220701,40,0,11,7,4
2019,220701,40,2,1,1,0
2019,220701,40,4,10,6,4
2019,220701,42,0,1,1,0
2019,220701,42,2,1,1,0
2019,220701,43,0,10,6,4
2019,220701,43,4,10,6,4
2019,220710,0,0,75,37,38
2019,220710,10,0,75,37,38
2019,220710,10,1,19,10,9
2019,220710,10,2,24,12,12
2019,220710,10,3,18,9,9
2019,220710,10,5,14,6,8
2019,220710,20,0,43,23,20
2019,220710,20,1,19,10,9
2019,220710,20,2,22,12,10
2019,220710,20,3,2,1,1
2019,220710,30,0,17,8,9
2019,220710,30,2,2,0,2
2019,220710,30,3,15,8,7
2019,220710,40,0,15,6,9
2019,220710,40,3,1,0,1
2019,220710,40,5,14,6,8
2019,220710,41,0,2,0,2
2019,220710,41,5,2,0,2
2019,220710,42,0,13,6,7
2019,220710,42,3,1,0,1
2019,220710,42,5,12,6,6
2019,220710,44,0,2,0,2
2019,220710,44,5,2,0,2
2019,220792,0,0,184,96,88
2019,220792,10,0,184,96,88
2019,220792,10,1,45,25,20
2019,220792,10,2,56,26,30
2019,220792,10,3,72,39,33
2019,220792,10,4,11,6,5
2019,220792,20,0,34,20,14
2019,220792,20,1,31,19,12
2019,220792,20,2,3,1,2
2019,220792,30,0,27,12,15
2019,220792,30,1,5,2,3
2019,220792,30,2,17,8,9
2019,220792,30,3,5,2,3
2019,220792,40,0,123,64,59
2019,220792,40,1,9,4,5
2019,220792,40,2,36,17,19
2019,220792,40,3,67,37,30
2019,220792,40,4,11,6,5
2019,220792,42,0,123,64,59
2019,220792,42,1,9,4,5
2019,220792,42,2,36,17,19
2019,220792,42,3,67,37,30
2019,220792,42,4,11,6,5
2019,220808,0,0,5,3,2
2019,220808,10,0,5,3,2
2019,220808,10,1,2,1,1
2019,220808,10,2,2,1,1
2019,220808,10,4,1,1,0
2019,220808,40,0,5,3,2
2019,220808,40,1,2,1,1
2019,220808,40,2,2,1,1
2019,220808,40,4,1,1,0
2019,220808,42,0,5,3,2
2019,220808,42,1,2,1,1
2019,220808,42,2,2,1,1
2019,220808,42,4,1,1,0
2019,220862,0,0,887,463,424
2019,220862,10,0,887,463,424
2019,220862,10,1,198,139,59
2019,220862,10,2,263,146,117
2019,220862,10,3,245,103,142
2019,220862,10,4,181,75,106
2019,220862,20,0,427,276,151
2019,220862,20,1,188,138,50
2019,220862,20,2,236,137,99
2019,220862,20,3,3,1,2
2019,220862,30,0,182,96,86
2019,220862,30,1,1,1,0
2019,220862,30,2,5,4,1
2019,220862,30,3,176,91,85
2019,220862,40,0,278,91,187
2019,220862,40,1,9,0,9
2019,220862,40,2,22,5,17
2019,220862,40,3,66,11,55
2019,220862,40,4,181,75,106
2019,220862,41,0,100,17,83
2019,220862,41,1,8,0,8
2019,220862,41,2,22,5,17
2019,220862,41,3,41,2,39
2019,220862,41,4,29,10,19
2019,220862,42,0,177,74,103
2019,220862,42,1,1,0,1
2019,220862,42,3,25,9,16
2019,220862,42,4,151,65,86
2019,220862,43,0,1,0,1
2019,220862,43,4,1,0,1
2019,220862,45,0,100,17,83
2019,220862,45,1,8,0,8
2019,220862,45,2,22,5,17
2019,220862,45,3,41,2,39
2019,220862,45,4,29,10,19
2019,220871,0,0,8,5,3
2019,220871,10,0,8,5,3
2019,220871,10,1,5,3,2
2019,220871,10,2,2,1,1
2019,220871,10,3,1,1,0
2019,220871,20,0,7,4,3
2019,220871,20,1,5,3,2
2019,220871,20,2,2,1,1
2019,220871,30,0,1,1,0
2019,220871,30,3,1,1,0
2019,220978,0,0,952,487,465
2019,220978,10,0,952,487,465
2019,220978,10,1,322,193,129
2019,220978,10,2,224,119,105
2019,220978,10,3,194,96,98
2019,220978,10,4,52,16,36
2019,220978,10,5,160,63,97
2019,220978,20,0,521,300,221
2019,220978,20,1,318,190,128
2019,220978,20,2,202,109,93
2019,220978,20,3,1,1,0
2019,220978,30,0,191,96,95
2019,220978,30,2,16,7,9
2019,220978,30,3,175,89,86
2019,220978,40,0,240,91,149
2019,220978,40,1,4,3,1
2019,220978,40,2,6,3,3
2019,220978,40,3,18,6,12
2019,220978,40,4,52,16,36
2019,220978,40,5,160,63,97
2019,220978,41,0,78,28,50
2019,220978,41,1,4,3,1
2019,220978,41,2,6,3,3
2019,220978,41,3,16,6,10
2019,220978,41,4,51,16,35
2019,220978,41,5,1,0,1
2019,220978,42,0,153,61,92
2019,220978,42,3,2,0,2
2019,220978,42,4,1,0,1
2019,220978,42,5,150,61,89
2019,220978,43,0,9,2,7
2019,220978,43,5,9,2,7
2019,220978,44,0,3,1,2
2019,220978,44,3,2,1,1
2019,220978,44,5,1,0,1
2019,220978,45,0,75,27,48
2019,220978,45,1,4,3,1
2019,220978,45,2,6,3,3
2019,220978,45,3,14,5,9
2019,220978,45,4,51,16,35
2019,220996,0,0,6,3,3
2019,220996,10,0,6,3,3
2019,220996,10,1,6,3,3
2019,220996,40,0,6,3,3
2019,220996,40,1,6,3,3
2019,220996,41,0,6,3,3
2019,220996,41,1,6,3,3
2019,220996,44,0,6,3,3
2019,220996,44,1,6,3,3
2019,221096,0,0,129,62,67
2019,221096,10,0,129,62,67
2019,221096,10,1,7,3,4
2019,221096,10,2,40,17,23
2019,221096,10,3,23,6,17
2019,221096,10,4,59,36,23
2019,221096,20,0,47,20,27
2019,221096,20,1,7,3,4
2019,221096,20,2,38,17,21
2019,221096,20,3,2,0,2
2019,221096,30,0,69,34,35
2019,221096,30,2,2,0,2
2019,221096,30,3,21,6,15
2019,221096,30,4,46,28,18
2019,221096,40,0,13,8,5
2019,221096,40,4,13,8,5
2019,221096,42,0,11,6,5
2019,221096,42,4,11,6,5
2019,221096,43,0,2,2,0
2019,221096,43,4,2,2,0
2019,221148,0,0,55,55,0
2019,221148,10,0,55,55,0
2019,221148,10,4,55,55,0
2019,221148,40,0,55,55,0
2019,221148,40,4,55,55,0
2019,221148,41,0,55,55,0
2019,221148,41,4,55,55,0
2019,221148,45,0,55,55,0
2019,221148,45,4,55,55,0
2019,221184,0,0,159,71,88
2019,221184,10,0,159,71,88
2019,221184,10,1,6,3,3
2019,221184,10,2,53,25,28
2019,221184,10,3,43,15,28
2019,221184,10,4,57,28,29
2019,221184,20,0,32,15,17
2019,221184,20,1,5,3,2
2019,221184,20,2,22,9,13
2019,221184,20,3,5,3,2
2019,221184,30,0,7,5,2
2019,221184,30,2,7,5,2
2019,221184,40,0,120,51,69
2019,221184,40,1,1,0,1
2019,221184,40,2,24,11,13
2019,221184,40,3,38,12,26
2019,221184,40,4,57,28,29
2019,221184,41,0,18,6,12
2019,221184,41,3,1,1,0
2019,221184,41,4,17,5,12
2019,221184,42,0,85,33,52
2019,221184,42,1,1,0,1
2019,221184,42,2,24,11,13
2019,221184,42,3,36,11,25
2019,221184,42,4,24,11,13
2019,221184,43,0,17,12,5
2019,221184,43,3,1,0,1
2019,221184,43,4,16,12,4
2019,221184,44,0,18,6,12
2019,221184,44,3,1,1,0
2019,221184,44,4,17,5,12
2019,221351,0,0,185,94,91
2019,221351,10,0,185,94,91
2019,221351,10,1,35,27,8
2019,221351,10,2,70,32,38
2019,221351,10,3,76,35,41
2019,221351,10,4,4,0,4
2019,221351,20,0,101,59,42
2019,221351,20,1,35,27,8
2019,221351,20,2,66,32,34
2019,221351,30,0,54,26,28
2019,221351,30,3,54,26,28
2019,221351,40,0,30,9,21
2019,221351,40,2,4,0,4
2019,221351,40,3,22,9,13
2019,221351,40,4,4,0,4
2019,221351,42,0,30,9,21
2019,221351,42,2,4,0,4
2019,221351,42,3,22,9,13
2019,221351,42,4,4,0,4
2019,221397,0,0,115,46,69
2019,221397,10,0,115,46,69
2019,221397,10,1,19,11,8
2019,221397,10,2,53,25,28
2019,221397,10,3,37,6,31
2019,221397,10,4,6,4,2
2019,221397,20,0,76,38,38
2019,221397,20,1,19,11,8
2019,221397,20,2,51,25,26
2019,221397,20,3,4,0,4
2019,221397,20,4,2,2,0
2019,221397,30,0,31,6,25
2019,221397,30,2,2,0,2
2019,221397,30,3,27,5,22
2019,221397,30,4,2,1,1
2019,221397,40,0,8,2,6
2019,221397,40,3,6,1,5
2019,221397,40,4,2,1,1
2019,221397,41,0,8,2,6
2019,221397,41,3,6,1,5
2019,221397,41,4,2,1,1
2019,221397,44,0,1,0,1
2019,221397,44,3,1,0,1
2019,221397,45,0,7,2,5
2019,221397,45,3,5,1,4
2019,221397,45,4,2,1,1
2019,221485,0,0,196,84,112
2019,221485,10,0,196,84,112
2019,221485,10,1,17,5,12
2019,221485,10,2,71,32,39
2019,221485,10,3,53,25,28
2019,221485,10,4,55,22,33
2019,221485,20,0,80,34,46
2019,221485,20,1,17,5,12
2019,221485,20,2,52,23,29
2019,221485,20,3,8,4,4
2019,221485,20,4,3,2,1
2019,221485,30,0,18,7,11
2019,221485,30,2,4,2,2
2019,221485,30,3,8,4,4
2019,221485,30,4,6,1,5
2019,221485,40,0,98,43,55
2019,221485,40,2,15,7,8
2019,221485,40,3,37,17,20
2019,221485,40,4,46,19,27
2019,221485,42,0,98,43,55
2019,221485,42,2,15,7,8
2019,221485,42,3,37,17,20
2019,221485,42,4,46,19,27
2019,221519,0,0,179,99,80
2019,221519,10,0,179,99,80
2019,221519,10,1,64,37,27
2019,221519,10,2,38,24,14
2019,221519,10,3,72,36,36
2019,221519,10,4,5,2,3
2019,221519,20,0,98,59,39
2019,221519,20,1,62,36,26
2019,221519,20,2,36,23,13
2019,221519,30,0,47,23,24
2019,221519,30,3,46,22,24
2019,221519,30,4,1,1,0
2019,221519,40,0,34,17,17
2019,221519,40,1,2,1,1
2019,221519,40,2,2,1,1
2019,221519,40,3,26,14,12
2019,221519,40,4,4,1,3
2019,221519,41,0,5,1,4
2019,221519,41,2,1,0,1
2019,221519,41,3,2,0,2
2019,221519,41,4,2,1,1
2019,221519,42,0,28,15,13
2019,221519,42,1,2,1,1
2019,221519,42,2,1,1,0
2019,221519,42,3,23,13,10
2019,221519,42,4,2,0,2
2019,221519,43,0,1,1,0
2019,221519,43,3,1,1,0
2019,221519,44,0,5,1,4
2019,221519,44,2,1,0,1
2019,221519,44,3,2,0,2
2019,221519,44,4,2,1,1
2019,221643,0,0,232,90,142
2019,221643,10,0,232,90,142
2019,221643,10,1,31,15,16
2019,221643,10,2,136,47,89
2019,221643,10,3,28,11,17
2019,221643,10,4,37,17,20
2019,221643,20,0,160,61,99
2019,221643,20,1,31,15,16
2019,221643,20,2,124,45,79
2019,221643,20,3,5,1,4
2019,221643,30,0,63,23,40
2019,221643,30,2,12,2,10
2019,221643,30,3,20,8,12
2019,221643,30,4,31,13,18
2019,221643,40,0,9,6,3
2019,221643,40,3,3,2,1
2019,221643,40,4,6,4,2
2019,221643,42,0,9,6,3
2019,221643,42,3,3,2,1
2019,221643,42,4,6,4,2
2019,221661,0,0,139,63,76
2019,221661,10,0,138,63,75
2019,221661,10,1,55,28,27
2019,221661,10,2,60,30,30
2019,221661,10,3,23,5,18
2019,221661,40,0,138,63,75
2019,221661,40,1,55,28,27
2019,221661,40,2,60,30,30
2019,221661,40,3,23,5,18
2019,221661,42,0,138,63,75
2019,221661,42,1,55,28,27
2019,221661,42,2,60,30,30
2019,221661,42,3,23,5,18
2019,221661,50,0,1,0,1
2019,221670,0,0,57,23,34
2019,221670,10,0,57,23,34
2019,221670,10,1,14,10,4
2019,221670,10,2,20,6,14
2019,221670,10,3,14,4,10
2019,221670,10,4,9,3,6
2019,221670,40,0,57,23,34
2019,221670,40,1,14,10,4
2019,221670,40,2,20,6,14
2019,221670,40,3,14,4,10
2019,221670,40,4,9,3,6
2019,221670,41,0,57,23,34
2019,221670,41,1,14,10,4
2019,221670,41,2,20,6,14
2019,221670,41,3,14,4,10
2019,221670,41,4,9,3,6
2019,221670,45,0,57,23,34
2019,221670,45,1,14,10,4
2019,221670,45,2,20,6,14
2019,221670,45,3,14,4,10
2019,221670,45,4,9,3,6
2019,221731,0,0,66,32,34
2019,221731,10,0,66,32,34
2019,221731,10,1,15,8,7
2019,221731,10,2,12,8,4
2019,221731,10,3,38,16,22
2019,221731,10,4,1,0,1
2019,221731,20,0,21,11,10
2019,221731,20,1,15,8,7
2019,221731,20,2,5,3,2
2019,221731,20,3,1,0,1
2019,221731,30,0,19,11,8
2019,221731,30,2,3,3,0
2019,221731,30,3,16,8,8
2019,221731,40,0,26,10,16
2019,221731,40,2,4,2,2
2019,221731,40,3,21,8,13
2019,221731,40,4,1,0,1
2019,221731,42,0,26,10,16
2019,221731,42,2,4,2,2
2019,221731,42,3,21,8,13
2019,221731,42,4,1,0,1
2019,221740,0,0,507,263,244
2019,221740,10,0,507,263,244
2019,221740,10,1,133,84,49
2019,221740,10,2,97,56,41
2019,221740,10,3,143,63,80
2019,221740,10,5,134,60,74
2019,221740,20,0,212,127,85
2019,221740,20,1,131,82,49
2019,221740,20,2,79,43,36
2019,221740,20,3,2,2,0
2019,221740,30,0,133,64,69
2019,221740,30,1,1,1,0
2019,221740,30,2,12,10,2
2019,221740,30,3,120,53,67
2019,221740,40,0,162,72,90
2019,221740,40,1,1,1,0
2019,221740,40,2,6,3,3
2019,221740,40,3,21,8,13
2019,221740,40,5,134,60,74
2019,221740,42,0,162,72,90
2019,221740,42,1,1,1,0
2019,221740,42,2,6,3,3
2019,221740,42,3,21,8,13
2019,221740,42,5,134,60,74
2019,221759,0,0,1625,892,733
2019,221759,10,0,1625,892,733
2019,221759,10,1,521,362,159
2019,221759,10,2,392,215,177
2019,221759,10,3,343,164,179
2019,221759,10,4,30,6,24
2019,221759,10,5,333,142,191
2019,221759,10,6,6,3,3
2019,221759,20,0,843,553,290
2019,221759,20,1,503,354,149
2019,221759,20,2,338,198,140
2019,221759,20,3,2,1,1
2019,221759,30,0,289,160,129
2019,221759,30,1,5,4,1
2019,221759,30,2,22,13,9
2019,221759,30,3,262,143,119
2019,221759,40,0,493,179,314
2019,221759,40,1,13,4,9
2019,221759,40,2,32,4,28
2019,221759,40,3,79,20,59
2019,221759,40,4,30,6,24
2019,221759,40,5,333,142,191
2019,221759,40,6,6,3,3
2019,221759,41,0,478,172,306
2019,221759,41,1,13,4,9
2019,221759,41,2,32,4,28
2019,221759,41,3,78,20,58
2019,221759,41,4,30,6,24
2019,221759,41,5,324,138,186
2019,221759,41,6,1,0,1
2019,221759,43,0,15,7,8
2019,221759,43,3,1,0,1
2019,221759,43,5,9,4,5
2019,221759,43,6,5,3,2
2019,221759,45,0,478,172,306
2019,221759,45,1,13,4,9
2019,221759,45,2,32,4,28
2019,221759,45,3,78,20,58
2019,221759,45,4,30,6,24
2019,221759,45,5,324,138,186
2019,221759,45,6,1,0,1
2019,221768,0,0,285,157,128
2019,221768,10,0,285,157,128
2019,221768,10,1,82,57,25
2019,221768,10,2,78,43,35
2019,221768,10,3,45,23,22
2019,221768,10,4,8,6,2
2019,221768,10,5,72,28,44
2019,221768,20,0,158,98,60
2019,221768,20,1,82,57,25
2019,221768,20,2,65,35,30
2019,221768,20,3,5,1,4
2019,221768,20,4,6,5,1
2019,221768,30,0,52,30,22
2019,221768,30,2,13,8,5
2019,221768,30,3,39,22,17
2019,221768,40,0,75,29,46
2019,221768,40,3,1,0,1
2019,221768,40,4,2,1,1
2019,221768,40,5,72,28,44
2019,221768,42,0,75,29,46
2019,221768,42,3,1,0,1
2019,221768,42,4,2,1,1
2019,221768,42,5,72,28,44
2019,221838,0,0,320,176,144
2019,221838,10,0,320,176,144
2019,221838,10,1,102,67,35
2019,221838,10,2,100,51,49
2019,221838,10,3,92,42,50
2019,221838,10,4,6,6,0
2019,221838,10,6,20,10,10
2019,221838,20,0,209,125,84
2019,221838,20,1,100,67,33
2019,221838,20,2,84,44,40
2019,221838,20,3,23,12,11
2019,221838,20,4,2,2,0
2019,221838,30,0,91,40,51
2019,221838,30,1,2,0,2
2019,221838,30,2,16,7,9
2019,221838,30,3,69,30,39
2019,221838,30,4,2,2,0
2019,221838,30,6,2,1,1
2019,221838,40,0,20,11,9
2019,221838,40,4,2,2,0
2019,221838,40,6,18,9,9
2019,221838,41,0,2,2,0
2019,221838,41,6,2,2,0
2019,221838,42,0,11,5,6
2019,221838,42,6,11,5,6
2019,221838,43,0,7,4,3
2019,221838,43,4,2,2,0
2019,221838,43,6,5,2,3
2019,221838,44,0,1,1,0
2019,221838,44,6,1,1,0
2019,221838,45,0,1,1,0
2019,221838,45,6,1,1,0
2019,221847,0,0,425,250,175
2019,221847,10,0,425,250,175
2019,221847,10,1,132,99,33
2019,221847,10,2,106,62,44
2019,221847,10,3,83,45,38
2019,221847,10,4,58,26,32
2019,221847,10,5,46,18,28
2019,221847,20,0,268,175,93
2019,221847,20,1,132,99,33
2019,221847,20,2,104,60,44
2019,221847,20,3,13,5,8
2019,221847,20,4,19,11,8
2019,221847,30,0,72,42,30
2019,221847,30,2,2,2,0
2019,221847,30,3,70,40,30
2019,221847,40,0,85,33,52
2019,221847,40,4,39,15,24
2019,221847,40,5,46,18,28
2019,221847,41,0,46,17,29
2019,221847,41,4,1,0,1
2019,221847,41,5,45,17,28
2019,221847,42,0,39,16,23
2019,221847,42,4,38,15,23
2019,221847,42,5,1,1,0
2019,221847,44,0,46,17,29
2019,221847,44,4,1,0,1
2019,221847,44,5,45,17,28
2019,221892,0,0,95,57,38
2019,221892,10,0,95,57,38
2019,221892,10,1,33,25,8
2019,221892,10,2,34,20,14
2019,221892,10,3,26,11,15
2019,221892,10,4,2,1,1
2019,221892,20,0,27,21,6
2019,221892,20,1,22,17,5
2019,221892,20,2,5,4,1
2019,221892,30,0,68,36,32
2019,221892,30,1,11,8,3
2019,221892,30,2,29,16,13
2019,221892,30,3,26,11,15
2019,221892,30,4,2,1,1
2019,221908,0,0,127,60,67
2019,221908,10,0,127,60,67
2019,221908,10,1,10,6,4
2019,221908,10,2,62,31,31
2019,221908,10,3,23,9,14
2019,221908,10,4,32,14,18
2019,221908,20,0,56,28,28
2019,221908,20,1,10,6,4
2019,221908,20,2,46,22,24
2019,221908,30,0,14,5,9
2019,221908,30,2,12,5,7
2019,221908,30,3,2,0,2
2019,221908,40,0,57,27,30
2019,221908,40,2,4,4,0
2019,221908,40,3,21,9,12
2019,221908,40,4,32,14,18
2019,221908,42,0,57,27,30
2019,221908,42,2,4,4,0
2019,221908,42,3,21,9,12
2019,221908,42,4,32,14,18
2019,221953,0,0,76,40,36
2019,221953,10,0,73,38,35
2019,221953,10,1,6,3,3
2019,221953,10,2,24,13,11
2019,221953,10,3,35,17,18
2019,221953,10,4,8,5,3
2019,221953,40,0,73,38,35
2019,221953,40,1,6,3,3
2019,221953,40,2,24,13,11
2019,221953,40,3,35,17,18
2019,221953,40,4,8,5,3
2019,221953,41,0,33,18,15
2019,221953,41,1,5,3,2
2019,221953,41,2,21,11,10
2019,221953,41,3,7,4,3
2019,221953,42,0,40,20,20
2019,221953,42,1,1,0,1
2019,221953,42,2,3,2,1
2019,221953,42,3,28,13,15
2019,221953,42,4,8,5,3
2019,221953,44,0,33,18,15
2019,221953,44,1,5,3,2
2019,221953,44,2,21,11,10
2019,221953,44,3,7,4,3
2019,221953,50,0,3,2,1
2019,221971,0,0,234,119,115
2019,221971,10,0,215,115,100
2019,221971,10,1,88,59,29
2019,221971,10,2,55,25,30
2019,221971,10,3,72,31,41
2019,221971,20,0,99,68,31
2019,221971,20,1,78,53,25
2019,221971,20,2,21,15,6
2019,221971,30,0,107,42,65
2019,221971,30,1,8,4,4
2019,221971,30,2,31,9,22
2019,221971,30,3,68,29,39
2019,221971,40,0,9,5,4
2019,221971,40,1,2,2,0
2019,221971,40,2,3,1,2
2019,221971,40,3,4,2,2
2019,221971,41,0,8,5,3
2019,221971,41,1,2,2,0
2019,221971,41,2,3,1,2
2019,221971,41,3,3,2,1
2019,221971,42,0,1,0,1
2019,221971,42,3,1,0,1
2019,221971,44,0,8,5,3
2019,221971,44,1,2,2,0
2019,221971,44,2,3,1,2
2019,221971,44,3,3,2,1
2019,221971,50,0,19,4,15
2019,221999,0,0,1283,691,592
2019,221999,10,0,1283,691,592
2019,221999,10,1,477,347,130
2019,221999,10,2,282,154,128
2019,221999,10,3,280,116,164
2019,221999,10,4,51,8,43
2019,221999,10,5,180,64,116
2019,221999,10,6,13,2,11
2019,221999,20,0,628,442,186
2019,221999,20,1,423,319,104
2019,221999,20,2,205,123,82
2019,221999,30,0,188,93,95
2019,221999,30,2,6,3,3
2019,221999,30,3,182,90,92
2019,221999,40,0,467,156,311
2019,221999,40,1,54,28,26
2019,221999,40,2,71,28,43
2019,221999,40,3,98,26,72
2019,221999,40,4,51,8,43
2019,221999,40,5,180,64,116
2019,221999,40,6,13,2,11
2019,221999,41,0,347,126,221
2019,221999,41,1,49,24,25
2019,221999,41,2,63,24,39
2019,221999,41,3,80,25,55
2019,221999,41,4,6,1,5
2019,221999,41,5,136,50,86
2019,221999,41,6,13,2,11
2019,221999,42,0,97,27,70
2019,221999,42,1,3,3,0
2019,221999,42,2,4,2,2
2019,221999,42,3,10,1,9
2019,221999,42,4,44,7,37
2019,221999,42,5,36,14,22
2019,221999,43,0,23,3,20
2019,221999,43,1,2,1,1
2019,221999,43,2,4,2,2
2019,221999,43,3,8,0,8
2019,221999,43,4,1,0,1
2019,221999,43,5,8,0,8
2019,221999,44,0,347,126,221
2019,221999,44,1,49,24,25
2019,221999,44,2,63,24,39
2019,221999,44,3,80,25,55
2019,221999,44,4,6,1,5
2019,221999,44,5,136,50,86
2019,221999,44,6,13,2,11
2019,222053,0,0,189,87,102
2019,222053,10,0,189,87,102
2019,222053,10,1,22,14,8
2019,222053,10,2,74,32,42
2019,222053,10,3,38,13,25
2019,222053,10,4,55,28,27
2019,222053,20,0,88,43,45
2019,222053,20,1,21,14,7
2019,222053,20,2,64,29,35
2019,222053,20,3,2,0,2
2019,222053,20,4,1,0,1
2019,222053,30,0,34,12,22
2019,222053,30,2,2,0,2
2019,222053,30,3,18,6,12
2019,222053,30,4,14,6,8
2019,222053,40,0,67,32,35
2019,222053,40,1,1,0,1
2019,222053,40,2,8,3,5
2019,222053,40,3,18,7,11
2019,222053,40,4,40,22,18
2019,222053,42,0,19,10,9
2019,222053,42,1,1,0,1
2019,222053,42,2,2,1,1
2019,222053,42,3,3,1,2
2019,222053,42,4,13,8,5
2019,222053,43,0,48,22,26
2019,222053,43,2,6,2,4
2019,222053,43,3,15,6,9
2019,222053,43,4,27,14,13
2019,222062,0,0,165,67,98
2019,222062,10,0,165,67,98
2019,222062,10,1,26,14,12
2019,222062,10,2,67,21,46
2019,222062,10,3,40,18,22
2019,222062,10,4,32,14,18
2019,222062,20,0,49,17,32
2019,222062,20,1,20,8,12
2019,222062,20,2,28,9,19
2019,222062,20,3,1,0,1
2019,222062,30,0,22,9,13
2019,222062,30,1,4,4,0
2019,222062,30,2,18,5,13
2019,222062,40,0,94,41,53
2019,222062,40,1,2,2,0
2019,222062,40,2,21,7,14
2019,222062,40,3,39,18,21
2019,222062,40,4,32,14,18
2019,222062,42,0,94,41,53
2019,222062,42,1,2,2,0
2019,222062,42,2,21,7,14
2019,222062,42,3,39,18,21
2019,222062,42,4,32,14,18
2019,222105,0,0,18,17,1
2019,222105,10,0,18,17,1
2019,222105,10,4,18,17,1
2019,222105,40,0,18,17,1
2019,222105,40,4,18,17,1
2019,222105,41,0,18,17,1
2019,222105,41,4,18,17,1
2019,222105,45,0,18,17,1
2019,222105,45,4,18,17,1
2019,222178,0,0,265,154,111
2019,222178,10,0,265,154,111
2019,222178,10,1,59,48,11
2019,222178,10,2,78,52,26
2019,222178,10,3,58,30,28
2019,222178,10,4,34,10,24
2019,222178,10,6,36,14,22
2019,222178,20,0,131,96,35
2019,222178,20,1,58,48,10
2019,222178,20,2,68,45,23
2019,222178,20,3,5,3,2
2019,222178,30,0,43,26,17
2019,222178,30,2,2,2,0
2019,222178,30,3,38,23,15
2019,222178,30,6,3,1,2
2019,222178,40,0,91,32,59
2019,222178,40,1,1,0,1
2019,222178,40,2,8,5,3
2019,222178,40,3,15,4,11
2019,222178,40,4,34,10,24
2019,222178,40,6,33,13,20
2019,222178,42,0,91,32,59
2019,222178,42,1,1,0,1
2019,222178,42,2,8,5,3
2019,222178,42,3,15,4,11
2019,222178,42,4,34,10,24
2019,222178,42,6,33,13,20
2019,222567,0,0,112,51,61
2019,222567,10,0,105,46,59
2019,222567,10,6,105,46,59
2019,222567,20,0,61,28,33
2019,222567,20,6,61,28,33
2019,222567,30,0,44,18,26
2019,222567,30,6,44,18,26
2019,222567,50,0,7,5,2
2019,222576,0,0,193,76,117
2019,222576,10,0,193,76,117
2019,222576,10,1,24,11,13
2019,222576,10,2,14,5,9
2019,222576,10,3,33,10,23
2019,222576,10,4,122,50,72
2019,222576,20,0,53,19,34
2019,222576,20,1,23,11,12
2019,222576,20,2,10,3,7
2019,222576,20,3,13,3,10
2019,222576,20,4,7,2,5
2019,222576,30,0,139,56,83
2019,222576,30,1,1,0,1
2019,222576,30,2,4,2,2
2019,222576,30,3,20,7,13
2019,222576,30,4,114,47,67
2019,222576,40,0,1,1,0
2019,222576,40,4,1,1,0
2019,222576,42,0,1,1,0
2019,222576,42,4,1,1,0
2019,222628,0,0,19,10,9
2019,222628,10,0,19,10,9
2019,222628,10,1,15,8,7
2019,222628,10,2,2,1,1
2019,222628,10,3,2,1,1
2019,222628,40,0,19,10,9
2019,222628,40,1,15,8,7
2019,222628,40,2,2,1,1
2019,222628,40,3,2,1,1
2019,222628,41,0,2,1,1
2019,222628,41,3,2,1,1
2019,222628,42,0,17,9,8
2019,222628,42,1,15,8,7
2019,222628,42,2,2,1,1
2019,222628,45,0,2,1,1
2019,222628,45,3,2,1,1
2019,222822,0,0,103,38,65
2019,222822,10,0,103,38,65
2019,222822,10,6,103,38,65
2019,222822,40,0,103,38,65
2019,222822,40,6,103,38,65
2019,222822,42,0,103,38,65
2019,222822,42,6,103,38,65
2019,222831,0,0,309,164,145
2019,222831,10,0,309,164,145
2019,222831,10,1,74,46,28
2019,222831,10,2,59,34,25
2019,222831,10,3,71,41,30
2019,222831,10,4,76,37,39
2019,222831,10,5,1,0,1
2019,222831,10,6,28,6,22
2019,222831,20,0,135,81,54
2019,222831,20,1,74,46,28
2019,222831,20,2,59,34,25
2019,222831,20,3,2,1,1
2019,222831,30,0,68,39,29
2019,222831,30,3,68,39,29
2019,222831,40,0,106,44,62
2019,222831,40,3,1,1,0
2019,222831,40,4,76,37,39
2019,222831,40,5,1,0,1
2019,222831,40,6,28,6,22
2019,222831,41,0,99,41,58
2019,222831,41,4,71,35,36
2019,222831,41,6,28,6,22
2019,222831,42,0,7,3,4
2019,222831,42,3,1,1,0
2019,222831,42,4,5,2,3
2019,222831,42,5,1,0,1
2019,222831,45,0,99,41,58
2019,222831,45,4,71,35,36
2019,222831,45,6,28,6,22
2019,222877,0,0,11,7,4
2019,222877,10,0,11,7,4
2019,222877,10,4,11,7,4
2019,222877,40,0,11,7,4
2019,222877,40,4,11,7,4
2019,222877,41,0,11,7,4
2019,222877,41,4,11,7,4
2019,222877,45,0,11,7,4
2019,222877,45,4,11,7,4
2019,222938,0,0,8,7,1
2019,222938,10,0,8,7,1
2019,222938,10,4,8,7,1
2019,222938,40,0,8,7,1
2019,222938,40,4,8,7,1
2019,222938,41,0,8,7,1
2019,222938,41,4,8,7,1
2019,222938,45,0,8,7,1
2019,222938,45,4,8,7,1
2019,222983,0,0,101,60,41
2019,222983,10,0,101,60,41
2019,222983,10,1,29,20,9
2019,222983,10,2,38,25,13
2019,222983,10,3,30,15,15
2019,222983,10,4,4,0,4
2019,222983,20,0,67,45,22
2019,222983,20,1,29,20,9
2019,222983,20,2,38,25,13
2019,222983,30,0,25,14,11
2019,222983,30,3,25,14,11
2019,222983,40,0,9,1,8
2019,222983,40,3,5,1,4
2019,222983,40,4,4,0,4
2019,222983,42,0,9,1,8
2019,222983,42,3,5,1,4
2019,222983,42,4,4,0,4
2019,222992,0,0,598,259,339
2019,222992,10,0,598,259,339
2019,222992,10,1,325,158,167
2019,222992,10,2,152,49,103
2019,222992,10,3,50,24,26
2019,222992,10,4,5,3,2
2019,222992,10,6,66,25,41
2019,222992,40,0,598,259,339
2019,222992,40,1,325,158,167
2019,222992,40,2,152,49,103
2019,222992,40,3,50,24,26
2019,222992,40,4,5,3,2
2019,222992,40,6,66,25,41
2019,222992,42,0,598,259,339
2019,222992,42,1,325,158,167
2019,222992,42,2,152,49,103
2019,222992,42,3,50,24,26
2019,222992,42,4,5,3,2
2019,222992,42,6,66,25,41
2019,223001,0,0,19,11,8
2019,223001,10,0,19,11,8
2019,223001,10,1,9,5,4
2019,223001,10,2,4,3,1
2019,223001,10,3,3,2,1
2019,223001,10,4,1,0,1
2019,223001,10,6,2,1,1
2019,223001,20,0,9,5,4
2019,223001,20,1,8,5,3
2019,223001,20,2,1,0,1
2019,223001,30,0,6,4,2
2019,223001,30,2,2,2,0
2019,223001,30,3,3,2,1
2019,223001,30,4,1,0,1
2019,223001,40,0,4,2,2
2019,223001,40,1,1,0,1
2019,223001,40,2,1,1,0
2019,223001,40,6,2,1,1
2019,223001,41,0,1,0,1
2019,223001,41,6,1,0,1
2019,223001,42,0,3,2,1
2019,223001,42,1,1,0,1
2019,223001,42,2,1,1,0
2019,223001,42,6,1,1,0
2019,223001,45,0,1,0,1
2019,223001,45,6,1,0,1
2019,223083,0,0,33,2,31
2019,223083,50,0,33,2,31
2019,223223,0,0,3092,1390,1702
2019,223223,10,0,3092,1390,1702
2019,223223,10,1,320,241,79
2019,223223,10,2,579,302,277
2019,223223,10,3,1596,699,897
2019,223223,10,4,597,148,449
2019,223223,20,0,421,293,128
2019,223223,20,1,245,190,55
2019,223223,20,2,176,103,73
2019,223223,30,0,444,235,209
2019,223223,30,2,72,23,49
2019,223223,30,3,372,212,160
2019,223223,40,0,2227,862,1365
2019,223223,40,1,75,51,24
2019,223223,40,2,331,176,155
2019,223223,40,3,1224,487,737
2019,223223,40,4,597,148,449
2019,223223,42,0,2227,862,1365
2019,223223,42,1,75,51,24
2019,223223,42,2,331,176,155
2019,223223,42,3,1224,487,737
2019,223223,42,4,597,148,449
2019,223232,0,0,1144,643,501
2019,223232,10,0,1144,643,501
2019,223232,10,1,294,230,64
2019,223232,10,2,293,175,118
2019,223232,10,3,230,101,129
2019,223232,10,4,6,0,6
2019,223232,10,5,321,137,184
2019,223232,20,0,524,379,145
2019,223232,20,1,281,225,56
2019,223232,20,2,243,154,89
2019,223232,30,0,178,90,88
2019,223232,30,2,17,12,5
2019,223232,30,3,161,78,83
2019,223232,40,0,442,174,268
2019,223232,40,1,13,5,8
2019,223232,40,2,33,9,24
2019,223232,40,3,69,23,46
2019,223232,40,4,6,0,6
2019,223232,40,5,321,137,184
2019,223232,42,0,442,174,268
2019,223232,42,1,13,5,8
2019,223232,42,2,33,9,24
2019,223232,42,3,69,23,46
2019,223232,42,4,6,0,6
2019,223232,42,5,321,137,184
2019,223320,0,0,51,18,33
2019,223320,10,0,51,18,33
2019,223320,10,1,12,5,7
2019,223320,10,2,8,4,4
2019,223320,10,3,9,3,6
2019,223320,10,4,22,6,16
2019,223320,40,0,51,18,33
2019,223320,40,1,12,5,7
2019,223320,40,2,8,4,4
2019,223320,40,3,9,3,6
2019,223320,40,4,22,6,16
2019,223320,42,0,51,18,33
2019,223320,42,1,12,5,7
2019,223320,42,2,8,4,4
2019,223320,42,3,9,3,6
2019,223320,42,4,22,6,16
2019,223427,0,0,419,207,212
2019,223427,10,0,419,207,212
2019,223427,10,6,419,207,212
2019,223427,40,0,419,207,212
2019,223427,40,6,419,207,212
2019,223427,41,0,280,135,145
2019,223427,41,6,280,135,145
2019,223427,43,0,139,72,67
2019,223427,43,6,139,72,67
2019,223427,44,0,280,135,145
2019,223427,44,6,280,135,145
2019,223463,0,0,22,14,8
2019,223463,50,0,22,14,8
2019,223472,0,0,9,1,8
2019,223472,10,0,9,1,8
2019,223472,10,4,9,1,8
2019,223472,40,0,9,1,8
2019,223472,40,4,9,1,8
2019,223472,42,0,9,1,8
2019,223472,42,4,9,1,8
2019,223506,0,0,100,60,40
2019,223506,10,0,100,60,40
2019,223506,10,1,16,10,6
2019,223506,10,2,17,10,7
2019,223506,10,3,36,19,17
2019,223506,10,4,31,21,10
2019,223506,20,0,39,22,17
2019,223506,20,1,15,9,6
2019,223506,20,2,12,7,5
2019,223506,20,3,12,6,6
2019,223506,40,0,61,38,23
2019,223506,40,1,1,1,0
2019,223506,40,2,5,3,2
2019,223506,40,3,24,13,11
2019,223506,40,4,31,21,10
2019,223506,41,0,20,12,8
2019,223506,41,2,3,2,1
2019,223506,41,3,7,4,3
2019,223506,41,4,10,6,4
2019,223506,42,0,37,25,12
2019,223506,42,1,1,1,0
2019,223506,42,2,2,1,1
2019,223506,42,3,17,9,8
2019,223506,42,4,17,14,3
2019,223506,43,0,4,1,3
2019,223506,43,4,4,1,3
2019,223506,44,0,20,12,8
2019,223506,44,2,3,2,1
2019,223506,44,3,7,4,3
2019,223506,44,4,10,6,4
2019,223524,0,0,137,62,75
2019,223524,10,0,137,62,75
2019,223524,10,6,137,62,75
2019,223524,40,0,137,62,75
2019,223524,40,6,137,62,75
2019,223524,42,0,137,62,75
2019,223524,42,6,137,62,75
2019,223773,0,0,77,41,36
2019,223773,10,0,77,41,36
2019,223773,10,6,77,41,36
2019,223773,40,0,77,41,36
2019,223773,40,6,77,41,36
2019,223773,42,0,77,41,36
2019,223773,42,6,77,41,36
2019,223816,0,0,202,109,93
2019,223816,10,0,163,78,85
2019,223816,10,1,163,78,85
2019,223816,40,0,163,78,85
2019,223816,40,1,163,78,85
2019,223816,42,0,163,78,85
2019,223816,42,1,163,78,85
2019,223816,50,0,39,31,8
2019,223898,0,0,87,44,43
2019,223898,10,0,87,44,43
2019,223898,10,1,75,36,39
2019,223898,10,4,12,8,4
2019,223898,20,0,21,11,10
2019,223898,20,1,20,11,9
2019,223898,20,4,1,0,1
2019,223898,30,0,2,1,1
2019,223898,30,1,1,1,0
2019,223898,30,4,1,0,1
2019,223898,40,0,64,32,32
2019,223898,40,1,54,24,30
2019,223898,40,4,10,8,2
2019,223898,42,0,64,32,32
2019,223898,42,1,54,24,30
2019,223898,42,4,10,8,2
2019,223922,0,0,42,20,22
2019,223922,10,0,42,20,22
2019,223922,10,1,1,1,0
2019,223922,10,2,2,2,0
2019,223922,10,3,4,1,3
2019,223922,10,4,35,16,19
2019,223922,40,0,42,20,22
2019,223922,40,1,1,1,0
2019,223922,40,2,2,2,0
2019,223922,40,3,4,1,3
2019,223922,40,4,35,16,19
2019,223922,42,0,12,1,11
2019,223922,42,4,12,1,11
2019,223922,43,0,30,19,11
2019,223922,43,1,1,1,0
2019,223922,43,2,2,2,0
2019,223922,43,3,4,1,3
2019,223922,43,4,23,15,8
2019,224004,0,0,53,25,28
2019,224004,10,0,53,25,28
2019,224004,10,1,9,6,3
2019,224004,10,2,22,12,10
2019,224004,10,3,18,7,11
2019,224004,10,4,4,0,4
2019,224004,20,0,8,6,2
2019,224004,20,1,7,5,2
2019,224004,20,2,1,1,0
2019,224004,30,0,44,19,25
2019,224004,30,1,2,1,1
2019,224004,30,2,21,11,10
2019,224004,30,3,18,7,11
2019,224004,30,4,3,0,3
2019,224004,40,0,1,0,1
2019,224004,40,4,1,0,1
2019,224004,42,0,1,0,1
2019,224004,42,4,1,0,1
2019,224110,0,0,153,59,94
2019,224110,10,0,153,59,94
2019,224110,10,6,153,59,94
2019,224110,40,0,153,59,94
2019,224110,40,6,153,59,94
2019,224110,42,0,153,59,94
2019,224110,42,6,153,59,94
2019,224147,0,0,431,207,224
2019,224147,10,0,415,201,214
2019,224147,10,1,78,55,23
2019,224147,10,2,106,60,46
2019,224147,10,3,211,81,130
2019,224147,10,4,8,2,6
2019,224147,10,5,9,3,6
2019,224147,10,6,3,0,3
2019,224147,20,0,164,102,62
2019,224147,20,1,75,53,22
2019,224147,20,2,87,49,38
2019,224147,20,3,2,0,2
2019,224147,30,0,129,60,69
2019,224147,30,2,8,5,3
2019,224147,30,3,121,55,66
2019,224147,40,0,122,39,83
2019,224147,40,1,3,2,1
2019,224147,40,2,11,6,5
2019,224147,40,3,88,26,62
2019,224147,40,4,8,2,6
2019,224147,40,5,9,3,6
2019,224147,40,6,3,0,3
2019,224147,42,0,118,37,81
2019,224147,42,1,3,2,1
2019,224147,42,2,11,6,5
2019,224147,42,3,88,26,62
2019,224147,42,4,8,2,6
2019,224147,42,5,5,1,4
2019,224147,42,6,3,0,3
2019,224147,43,0,4,2,2
2019,224147,43,5,4,2,2
2019,224147,50,0,16,6,10
2019,224226,0,0,127,77,50
2019,224226,10,0,127,77,50
2019,224226,10,1,57,33,24
2019,224226,10,2,18,12,6
2019,224226,10,3,52,32,20
2019,224226,40,0,127,77,50
2019,224226,40,1,57,33,24
2019,224226,40,2,18,12,6
2019,224226,40,3,52,32,20
2019,224226,42,0,127,77,50
2019,224226,42,1,57,33,24
2019,224226,42,2,18,12,6
2019,224226,42,3,52,32,20
2019,224244,0,0,7,4,3
2019,224244,10,0,7,4,3
2019,224244,10,1,2,2,0
2019,224244,10,2,4,2,2
2019,224244,10,4,1,0,1
2019,224244,40,0,7,4,3
2019,224244,40,1,2,2,0
2019,224244,40,2,4,2,2
2019,224244,40,4,1,0,1
2019,224244,41,0,6,4,2
2019,224244,41,1,2,2,0
2019,224244,41,2,4,2,2
2019,224244,42,0,1,0,1
2019,224244,42,4,1,0,1
2019,224244,44,0,6,4,2
2019,224244,44,1,2,2,0
2019,224244,44,2,4,2,2
2019,224305,0,0,55,48,7
2019,224305,10,0,55,48,7
2019,224305,10,1,36,34,2
2019,224305,10,2,9,7,2
2019,224305,10,3,10,7,3
2019,224305,20,0,35,33,2
2019,224305,20,1,35,33,2
2019,224305,30,0,20,15,5
2019,224305,30,1,1,1,0
2019,224305,30,2,9,7,2
2019,224305,30,3,10,7,3
2019,224323,0,0,144,88,56
2019,224323,10,0,144,88,56
2019,224323,10,1,20,17,3
2019,224323,10,2,63,41,22
2019,224323,10,3,31,17,14
2019,224323,10,4,30,13,17
2019,224323,20,0,84,60,24
2019,224323,20,1,19,16,3
2019,224323,20,2,60,40,20
2019,224323,20,3,5,4,1
2019,224323,30,0,30,15,15
2019,224323,30,1,1,1,0
2019,224323,30,2,3,1,2
2019,224323,30,3,26,13,13
2019,224323,40,0,30,13,17
2019,224323,40,4,30,13,17
2019,224323,42,0,30,13,17
2019,224323,42,4,30,13,17
2019,224350,0,0,337,172,165
2019,224350,10,0,313,159,154
2019,224350,10,1,91,54,37
2019,224350,10,2,76,39,37
2019,224350,10,3,42,14,28
2019,224350,10,4,104,52,52
2019,224350,20,0,198,102,96
2019,224350,20,1,91,54,37
2019,224350,20,2,74,38,36
2019,224350,20,3,33,10,23
2019,224350,30,0,56,23,33
2019,224350,30,2,2,1,1
2019,224350,30,3,9,4,5
2019,224350,30,4,45,18,27
2019,224350,40,0,59,34,25
2019,224350,40,4,59,34,25
2019,224350,42,0,15,6,9
2019,224350,42,4,15,6,9
2019,224350,43,0,44,28,16
2019,224350,43,4,44,28,16
2019,224350,50,0,24,13,11
2019,224527,0,0,73,46,27
2019,224527,10,0,73,46,27
2019,224527,10,1,26,21,5
2019,224527,10,2,8,5,3
2019,224527,10,3,39,20,19
2019,224527,20,0,1,1,0
2019,224527,20,1,1,1,0
2019,224527,40,0,72,45,27
2019,224527,40,1,25,20,5
2019,224527,40,2,8,5,3
2019,224527,40,3,39,20,19
2019,224527,41,0,28,22,6
2019,224527,41,1,23,18,5
2019,224527,41,2,5,4,1
2019,224527,42,0,44,23,21
2019,224527,42,1,2,2,0
2019,224527,42,2,3,1,2
2019,224527,42,3,39,20,19
2019,224527,44,0,28,22,6
2019,224527,44,1,23,18,5
2019,224527,44,2,5,4,1
2019,224545,0,0,86,45,41
2019,224545,10,0,86,45,41
2019,224545,10,1,18,14,4
2019,224545,10,2,21,15,6
2019,224545,10,3,31,13,18
2019,224545,10,4,15,2,13
2019,224545,10,5,1,1,0
2019,224545,20,0,30,22,8
2019,224545,20,1,16,12,4
2019,224545,20,2,14,10,4
2019,224545,30,0,32,18,14
2019,224545,30,1,2,2,0
2019,224545,30,2,7,5,2
2019,224545,30,3,23,11,12
2019,224545,40,0,24,5,19
2019,224545,40,3,8,2,6
2019,224545,40,4,15,2,13
2019,224545,40,5,1,1,0
2019,224545,42,0,24,5,19
2019,224545,42,3,8,2,6
2019,224545,42,4,15,2,13
2019,224545,42,5,1,1,0
2019,224554,0,0,394,214,180
2019,224554,10,0,394,214,180
2019,224554,10,1,73,50,23
2019,224554,10,2,124,78,46
2019,224554,10,3,140,64,76
2019,224554,10,4,44,14,30
2019,224554,10,5,13,8,5
2019,224554,20,0,146,95,51
2019,224554,20,1,72,49,23
2019,224554,20,2,73,46,27
2019,224554,20,4,1,0,1
2019,224554,30,0,127,69,58
2019,224554,30,2,42,28,14
2019,224554,30,3,83,41,42
2019,224554,30,4,2,0,2
2019,224554,40,0,121,50,71
2019,224554,40,1,1,1,0
2019,224554,40,2,9,4,5
2019,224554,40,3,57,23,34
2019,224554,40,4,41,14,27
2019,224554,40,5,13,8,5
2019,224554,42,0,121,50,71
2019,224554,42,1,1,1,0
2019,224554,42,2,9,4,5
2019,224554,42,3,57,23,34
2019,224554,42,4,41,14,27
2019,224554,42,5,13,8,5
2019,224572,0,0,144,78,66
2019,224572,10,0,144,78,66
2019,224572,10,6,144,78,66
2019,224572,40,0,144,78,66
2019,224572,40,6,144,78,66
2019,224572,42,0,144,78,66
2019,224572,42,6,144,78,66
2019,224615,0,0,148,49,99
2019,224615,10,0,148,49,99
2019,224615,10,6,148,49,99
2019,224615,40,0,148,49,99
2019,224615,40,6,148,49,99
2019,224615,42,0,148,49,99
2019,224615,42,6,148,49,99
2019,224642,0,0,436,198,238
2019,224642,10,0,436,198,238
2019,224642,10,1,172,81,91
2019,224642,10,2,47,18,29
2019,224642,10,3,143,63,80
2019,224642,10,5,66,34,32
2019,224642,10,6,8,2,6
2019,224642,20,0,220,99,121
2019,224642,20,1,172,81,91
2019,224642,20,2,47,18,29
2019,224642,20,6,1,0,1
2019,224642,30,0,145,65,80
2019,224642,30,3,143,63,80
2019,224642,30,6,2,2,0
2019,224642,40,0,71,34,37
2019,224642,40,5,66,34,32
2019,224642,40,6,5,0,5
2019,224642,42,0,5,3,2
2019,224642,42,5,5,3,2
2019,224642,43,0,66,31,35
2019,224642,43,5,61,31,30
2019,224642,43,6,5,0,5
2019,224660,0,0,24,17,7
2019,224660,10,0,24,17,7
2019,224660,10,4,24,17,7
2019,224660,40,0,24,17,7
2019,224660,40,4,24,17,7
2019,224660,41,0,24,17,7
2019,224660,41,4,24,17,7
2019,224660,45,0,24,17,7
2019,224660,45,4,24,17,7
2019,224679,0,0,59,47,12
2019,224679,10,0,59,47,12
2019,224679,10,4,59,47,12
2019,224679,40,0,59,47,12
2019,224679,40,4,59,47,12
2019,224679,41,0,59,47,12
2019,224679,41,4,59,47,12
2019,224679,45,0,59,47,12
2019,224679,45,4,59,47,12
2019,224712,0,0,16,7,9
2019,224712,10,0,16,7,9
2019,224712,10,1,4,3,1
2019,224712,10,2,5,3,2
2019,224712,10,3,7,1,6
2019,224712,20,0,5,5,0
2019,224712,20,1,3,3,0
2019,224712,20,2,2,2,0
2019,224712,40,0,11,2,9
2019,224712,40,1,1,0,1
2019,224712,40,2,3,1,2
2019,224712,40,3,7,1,6
2019,224712,41,0,10,2,8
2019,224712,41,2,3,1,2
2019,224712,41,3,7,1,6
2019,224712,42,0,1,0,1
2019,224712,42,1,1,0,1
2019,224712,44,0,10,2,8
2019,224712,44,2,3,1,2
2019,224712,44,3,7,1,6
2019,224776,0,0,5,3,2
2019,224776,10,0,5,3,2
2019,224776,10,4,5,3,2
2019,224776,40,0,5,3,2
2019,224776,40,4,5,3,2
2019,224776,41,0,5,3,2
2019,224776,41,4,5,3,2
2019,224776,45,0,5,3,2
2019,224776,45,4,5,3,2
2019,224891,0,0,41,17,24
2019,224891,10,0,41,17,24
2019,224891,10,1,8,5,3
2019,224891,10,2,1,0,1
2019,224891,10,3,11,2,9
2019,224891,10,4,16,8,8
2019,224891,10,6,5,2,3
2019,224891,40,0,41,17,24
2019,224891,40,1,8,5,3
2019,224891,40,2,1,0,1
2019,224891,40,3,11,2,9
2019,224891,40,4,16,8,8
2019,224891,40,6,5,2,3
2019,224891,41,0,14,4,10
2019,224891,41,1,7,4,3
2019,224891,41,2,1,0,1
2019,224891,41,4,6,0,6
2019,224891,42,0,27,13,14
2019,224891,42,1,1,1,0
2019,224891,42,3,11,2,9
2019,224891,42,4,10,8,2
2019,224891,42,6,5,2,3
2019,224891,44,0,8,4,4
2019,224891,44,1,7,4,3
2019,224891,44,2,1,0,1
2019,224891,45,0,6,0,6
2019,224891,45,4,6,0,6
2019,224961,0,0,61,29,32
2019,224961,10,0,60,29,31
2019,224961,10,1,2,2,0
2019,224961,10,2,8,5,3
2019,224961,10,3,6,3,3
2019,224961,10,4,44,19,25
2019,224961,20,0,17,11,6
2019,224961,20,1,2,2,0
2019,224961,20,2,6,4,2
2019,224961,20,3,4,2,2
2019,224961,20,4,5,3,2
2019,224961,30,0,43,18,25
2019,224961,30,2,2,1,1
2019,224961,30,3,2,1,1
2019,224961,30,4,39,16,23
2019,224961,50,0,1,0,1
2019,225070,0,0,117,43,74
2019,225070,10,0,114,42,72
2019,225070,10,1,114,42,72
2019,225070,40,0,114,42,72
2019,225070,40,1,114,42,72
2019,225070,42,0,114,42,72
2019,225070,42,1,114,42,72
2019,225070,50,0,3,1,2
2019,225201,0,0,28,17,11
2019,225201,10,0,25,14,11
2019,225201,10,4,25,14,11
2019,225201,40,0,25,14,11
2019,225201,40,4,25,14,11
2019,225201,41,0,25,14,11
2019,225201,41,4,25,14,11
2019,225201,45,0,25,14,11
2019,225201,45,4,25,14,11
2019,225201,50,0,3,3,0
2019,225247,0,0,106,63,43
2019,225247,10,0,106,63,43
2019,225247,10,1,44,31,13
2019,225247,10,2,31,17,14
2019,225247,10,3,28,14,14
2019,225247,10,4,3,1,2
2019,225247,20,0,70,45,25
2019,225247,20,1,43,30,13
2019,225247,20,2,25,15,10
2019,225247,20,3,2,0,2
2019,225247,30,0,18,7,11
2019,225247,30,2,2,0,2
2019,225247,30,3,15,6,9
2019,225247,30,4,1,1,0
2019,225247,40,0,18,11,7
2019,225247,40,1,1,1,0
2019,225247,40,2,4,2,2
2019,225247,40,3,11,8,3
2019,225247,40,4,2,0,2
2019,225247,42,0,18,11,7
2019,225247,42,1,1,1,0
2019,225247,42,2,4,2,2
2019,225247,42,3,11,8,3
2019,225247,42,4,2,0,2
2019,225308,0,0,163,87,76
2019,225308,10,0,163,87,76
2019,225308,10,4,163,87,76
2019,225308,40,0,163,87,76
2019,225308,40,4,163,87,76
2019,225308,42,0,39,28,11
2019,225308,42,4,39,28,11
2019,225308,43,0,124,59,65
2019,225308,43,4,124,59,65
2019,225371,0,0,93,46,47
2019,225371,10,0,93,46,47
2019,225371,10,6,93,46,47
2019,225371,40,0,93,46,47
2019,225371,40,6,93,46,47
2019,225371,42,0,93,46,47
2019,225371,42,6,93,46,47
2019,225399,0,0,138,80,58
2019,225399,10,0,138,80,58
2019,225399,10,1,36,23,13
2019,225399,10,2,40,24,16
2019,225399,10,3,60,32,28
2019,225399,10,4,2,1,1
2019,225399,40,0,138,80,58
2019,225399,40,1,36,23,13
2019,225399,40,2,40,24,16
2019,225399,40,3,60,32,28
2019,225399,40,4,2,1,1
2019,225399,41,0,92,56,36
2019,225399,41,1,36,23,13
2019,225399,41,2,30,20,10
2019,225399,41,3,26,13,13
2019,225399,42,0,46,24,22
2019,225399,42,2,10,4,6
2019,225399,42,3,34,19,15
2019,225399,42,4,2,1,1
2019,225399,44,0,92,56,36
2019,225399,44,1,36,23,13
2019,225399,44,2,30,20,10
2019,225399,44,3,26,13,13
2019,225414,0,0,279,146,133
2019,225414,10,0,278,145,133
2019,225414,10,1,60,36,24
2019,225414,10,2,95,55,40
2019,225414,10,3,80,41,39
2019,225414,10,5,31,10,21
2019,225414,10,6,12,3,9
2019,225414,20,0,153,90,63
2019,225414,20,1,60,36,24
2019,225414,20,2,93,54,39
2019,225414,30,0,82,42,40
2019,225414,30,2,2,1,1
2019,225414,30,3,80,41,39
2019,225414,40,0,43,13,30
2019,225414,40,5,31,10,21
2019,225414,40,6,12,3,9
2019,225414,42,0,43,13,30
2019,225414,42,5,31,10,21
2019,225414,42,6,12,3,9
2019,225414,50,0,1,1,0
2019,225423,0,0,873,423,450
2019,225423,10,0,873,423,450
2019,225423,10,4,873,423,450
2019,225423,40,0,873,423,450
2019,225423,40,4,873,423,450
2019,225423,42,0,873,423,450
2019,225423,42,4,873,423,450
2019,225432,0,0,357,190,167
2019,225432,10,0,357,190,167
2019,225432,10,1,61,40,21
2019,225432,10,2,115,60,55
2019,225432,10,3,75,38,37
2019,225432,10,5,95,44,51
2019,225432,10,6,11,8,3
2019,225432,20,0,169,94,75
2019,225432,20,1,60,39,21
2019,225432,20,2,109,55,54
2019,225432,30,0,82,44,38
2019,225432,30,1,1,1,0
2019,225432,30,2,6,5,1
2019,225432,30,3,75,38,37
2019,225432,40,0,106,52,54
2019,225432,40,5,95,44,51
2019,225432,40,6,11,8,3
2019,225432,42,0,101,49,52
2019,225432,42,5,94,43,51
2019,225432,42,6,7,6,1
2019,225432,43,0,5,3,2
2019,225432,43,5,1,1,0
2019,225432,43,6,4,2,2
2019,225502,0,0,132,70,62
2019,225502,10,0,129,70,59
2019,225502,10,1,29,19,10
2019,225502,10,2,40,21,19
2019,225502,10,3,43,22,21
2019,225502,10,5,12,6,6
2019,225502,10,6,5,2,3
2019,225502,20,0,66,39,27
2019,225502,20,1,29,19,10
2019,225502,20,2,37,20,17
2019,225502,30,0,46,23,23
2019,225502,30,2,3,1,2
2019,225502,30,3,43,22,21
2019,225502,40,0,17,8,9
2019,225502,40,5,12,6,6
2019,225502,40,6,5,2,3
2019,225502,42,0,17,8,9
2019,225502,42,5,12,6,6
2019,225502,42,6,5,2,3
2019,225502,50,0,3,0,3
2019,225511,0,0,1523,887,636
2019,225511,10,0,1362,831,531
2019,225511,10,1,440,335,105
2019,225511,10,2,355,207,148
2019,225511,10,3,232,129,103
2019,225511,10,5,91,42,49
2019,225511,10,6,244,118,126
2019,225511,20,0,780,532,248
2019,225511,20,1,437,333,104
2019,225511,20,2,343,199,144
2019,225511,30,0,247,139,108
2019,225511,30,1,3,2,1
2019,225511,30,2,12,8,4
2019,225511,30,3,232,129,103
2019,225511,40,0,335,160,175
2019,225511,40,5,91,42,49
2019,225511,40,6,244,118,126
2019,225511,41,0,25,11,14
2019,225511,41,6,25,11,14
2019,225511,42,0,279,132,147
2019,225511,42,5,61,25,36
2019,225511,42,6,218,107,111
2019,225511,43,0,31,17,14
2019,225511,43,5,30,17,13
2019,225511,43,6,1,0,1
2019,225511,44,0,25,11,14
2019,225511,44,6,25,11,14
2019,225511,50,0,161,56,105
2019,225520,0,0,118,57,61
2019,225520,10,0,118,57,61
2019,225520,10,1,8,4,4
2019,225520,10,2,28,12,16
2019,225520,10,3,25,14,11
2019,225520,10,4,57,27,30
2019,225520,40,0,118,57,61
2019,225520,40,1,8,4,4
2019,225520,40,2,28,12,16
2019,225520,40,3,25,14,11
2019,225520,40,4,57,27,30
2019,225520,42,0,118,57,61
2019,225520,42,1,8,4,4
2019,225520,42,2,28,12,16
2019,225520,42,3,25,14,11
2019,225520,42,4,57,27,30
2019,225548,0,0,64,40,24
2019,225548,10,0,64,40,24
2019,225548,10,1,19,14,5
2019,225548,10,2,20,14,6
2019,225548,10,3,15,7,8
2019,225548,10,4,10,5,5
2019,225548,20,0,2,1,1
2019,225548,20,1,2,1,1
2019,225548,40,0,62,39,23
2019,225548,40,1,17,13,4
2019,225548,40,2,20,14,6
2019,225548,40,3,15,7,8
2019,225548,40,4,10,5,5
2019,225548,41,0,38,27,11
2019,225548,41,1,14,12,2
2019,225548,41,2,16,12,4
2019,225548,41,3,8,3,5
2019,225548,42,0,24,12,12
2019,225548,42,1,3,1,2
2019,225548,42,2,4,2,2
2019,225548,42,3,7,4,3
2019,225548,42,4,10,5,5
2019,225548,44,0,38,27,11
2019,225548,44,1,14,12,2
2019,225548,44,2,16,12,4
2019,225548,44,3,8,3,5
2019,225575,0,0,43,24,19
2019,225575,10,0,43,24,19
2019,225575,10,1,11,5,6
2019,225575,10,2,10,4,6
2019,225575,10,3,16,11,5
2019,225575,10,4,5,3,2
2019,225575,10,5,1,1,0
2019,225575,20,0,15,7,8
2019,225575,20,1,9,3,6
2019,225575,20,2,6,4,2
2019,225575,30,0,20,12,8
2019,225575,30,1,1,1,0
2019,225575,30,2,4,0,4
2019,225575,30,3,15,11,4
2019,225575,40,0,8,5,3
2019,225575,40,1,1,1,0
2019,225575,40,3,1,0,1
2019,225575,40,4,5,3,2
2019,225575,40,5,1,1,0
2019,225575,42,0,8,5,3
2019,225575,42,1,1,1,0
2019,225575,42,3,1,0,1
2019,225575,42,4,5,3,2
2019,225575,42,5,1,1,0
2019,225627,0,0,347,161,186
2019,225627,10,0,347,161,186
2019,225627,10,1,80,39,41
2019,225627,10,2,105,51,54
2019,225627,10,3,124,59,65
2019,225627,10,4,37,12,25
2019,225627,10,5,1,0,1
2019,225627,20,0,152,68,84
2019,225627,20,1,68,31,37
2019,225627,20,2,84,37,47
2019,225627,30,0,90,45,45
2019,225627,30,1,3,3,0
2019,225627,30,2,6,5,1
2019,225627,30,3,80,37,43
2019,225627,30,4,1,0,1
2019,225627,40,0,105,48,57
2019,225627,40,1,9,5,4
2019,225627,40,2,15,9,6
2019,225627,40,3,44,22,22
2019,225627,40,4,36,12,24
2019,225627,40,5,1,0,1
2019,225627,42,0,105,48,57
2019,225627,42,1,9,5,4
2019,225627,42,2,15,9,6
2019,225627,42,3,44,22,22
2019,225627,42,4,36,12,24
2019,225627,42,5,1,0,1
2019,225876,0,0,8,3,5
2019,225876,10,0,8,3,5
2019,225876,10,4,8,3,5
2019,225876,40,0,8,3,5
2019,225876,40,4,8,3,5
2019,225876,41,0,8,3,5
2019,225876,41,4,8,3,5
2019,225876,45,0,8,3,5
2019,225876,45,4,8,3,5
2019,225885,0,0,34,19,15
2019,225885,10,0,34,19,15
2019,225885,10,1,5,4,1
2019,225885,10,2,3,2,1
2019,225885,10,3,21,11,10
2019,225885,10,4,5,2,3
2019,225885,20,0,5,4,1
2019,225885,20,1,5,4,1
2019,225885,40,0,29,15,14
2019,225885,40,2,3,2,1
2019,225885,40,3,21,11,10
2019,225885,40,4,5,2,3
2019,225885,42,0,29,15,14
2019,225885,42,2,3,2,1
2019,225885,42,3,21,11,10
2019,225885,42,4,5,2,3
2019,226019,0,0,146,64,82
2019,226019,10,0,146,64,82
2019,226019,10,4,146,64,82
2019,226019,40,0,146,64,82
2019,226019,40,4,146,64,82
2019,226019,42,0,32,16,16
2019,226019,42,4,32,16,16
2019,226019,43,0,114,48,66
2019,226019,43,4,114,48,66
2019,226091,0,0,454,238,216
2019,226091,10,0,454,238,216
2019,226091,10,1,93,63,30
2019,226091,10,2,107,66,41
2019,226091,10,3,110,57,53
2019,226091,10,4,144,52,92
2019,226091,20,0,205,131,74
2019,226091,20,1,92,62,30
2019,226091,20,2,100,62,38
2019,226091,20,3,13,7,6
2019,226091,30,0,102,53,49
2019,226091,30,1,1,1,0
2019,226091,30,2,6,3,3
2019,226091,30,3,82,44,38
2019,226091,30,4,13,5,8
2019,226091,40,0,147,54,93
2019,226091,40,2,1,1,0
2019,226091,40,3,15,6,9
2019,226091,40,4,131,47,84
2019,226091,42,0,82,26,56
2019,226091,42,2,1,1,0
2019,226091,42,3,11,5,6
2019,226091,42,4,70,20,50
2019,226091,43,0,65,28,37
2019,226091,43,3,4,1,3
2019,226091,43,4,61,27,34
2019,226107,0,0,44,17,27
2019,226107,10,0,44,17,27
2019,226107,10,1,2,1,1
2019,226107,10,2,1,0,1
2019,226107,10,3,6,4,2
2019,226107,10,4,34,11,23
2019,226107,10,5,1,1,0
2019,226107,20,0,13,6,7
2019,226107,20,1,2,1,1
2019,226107,20,2,1,0,1
2019,226107,20,3,4,3,1
2019,226107,20,4,6,2,4
2019,226107,30,0,6,2,4
2019,226107,30,3,2,1,1
2019,226107,30,4,4,1,3
2019,226107,40,0,25,9,16
2019,226107,40,4,24,8,16
2019,226107,40,5,1,1,0
2019,226107,42,0,24,8,16
2019,226107,42,4,24,8,16
2019,226107,43,0,1,1,0
2019,226107,43,5,1,1,0
2019,226116,0,0,61,23,38
2019,226116,10,0,61,23,38
2019,226116,10,1,2,0,2
2019,226116,10,2,2,1,1
2019,226116,10,3,3,1,2
2019,226116,10,4,53,20,33
2019,226116,10,6,1,1,0
2019,226116,20,0,25,7,18
2019,226116,20,1,2,0,2
2019,226116,20,2,2,1,1
2019,226116,20,3,2,0,2
2019,226116,20,4,19,6,13
2019,226116,30,0,29,11,18
2019,226116,30,3,1,1,0
2019,226116,30,4,27,9,18
2019,226116,30,6,1,1,0
2019,226116,40,0,7,5,2
2019,226116,40,4,7,5,2
2019,226116,42,0,7,5,2
2019,226116,42,4,7,5,2
2019,226134,0,0,187,104,83
2019,226134,10,0,187,104,83
2019,226134,10,1,120,68,52
2019,226134,10,2,11,7,4
2019,226134,10,3,34,17,17
2019,226134,10,4,22,12,10
2019,226134,20,0,131,75,56
2019,226134,20,1,120,68,52
2019,226134,20,2,11,7,4
2019,226134,30,0,37,18,19
2019,226134,30,3,34,17,17
2019,226134,30,4,3,1,2
2019,226134,40,0,19,11,8
2019,226134,40,4,19,11,8
2019,226134,42,0,18,10,8
2019,226134,42,4,18,10,8
2019,226134,43,0,1,1,0
2019,226134,43,4,1,1,0
2019,226152,0,0,226,116,110
2019,226152,10,0,226,116,110
2019,226152,10,1,26,21,5
2019,226152,10,2,54,32,22
2019,226152,10,3,113,50,63
2019,226152,10,4,23,9,14
2019,226152,10,5,10,4,6
2019,226152,20,0,66,45,21
2019,226152,20,1,25,20,5
2019,226152,20,2,40,24,16
2019,226152,20,3,1,1,0
2019,226152,30,0,69,39,30
2019,226152,30,2,8,5,3
2019,226152,30,3,61,34,27
2019,226152,40,0,91,32,59
2019,226152,40,1,1,1,0
2019,226152,40,2,6,3,3
2019,226152,40,3,51,15,36
2019,226152,40,4,23,9,14
2019,226152,40,5,10,4,6
2019,226152,42,0,91,32,59
2019,226152,42,1,1,1,0
2019,226152,42,2,6,3,3
2019,226152,42,3,51,15,36
2019,226152,42,4,23,9,14
2019,226152,42,5,10,4,6
2019,226204,0,0,167,84,83
2019,226204,10,0,167,84,83
2019,226204,10,6,167,84,83
2019,226204,40,0,167,84,83
2019,226204,40,6,167,84,83
2019,226204,41,0,88,47,41
2019,226204,41,6,88,47,41
2019,226204,42,0,30,7,23
2019,226204,42,6,30,7,23
2019,226204,43,0,49,30,19
2019,226204,43,6,49,30,19
2019,226204,44,0,88,47,41
2019,226204,44,6,88,47,41
2019,226231,0,0,116,91,25
2019,226231,10,0,89,70,19
2019,226231,10,1,31,25,6
2019,226231,10,2,29,20,9
2019,226231,10,3,23,19,4
2019,226231,10,4,3,3,0
2019,226231,10,5,2,2,0
2019,226231,10,6,1,1,0
2019,226231,20,0,46,38,8
2019,226231,20,1,26,23,3
2019,226231,20,2,18,13,5
2019,226231,20,3,2,2,0
2019,226231,30,0,37,27,10
2019,226231,30,1,4,2,2
2019,226231,30,2,11,7,4
2019,226231,30,3,21,17,4
2019,226231,30,4,1,1,0
2019,226231,40,0,6,5,1
2019,226231,40,1,1,0,1
2019,226231,40,4,2,2,0
2019,226231,40,5,2,2,0
2019,226231,40,6,1,1,0
2019,226231,42,0,6,5,1
2019,226231,42,1,1,0,1
2019,226231,42,4,2,2,0
2019,226231,42,5,2,2,0
2019,226231,42,6,1,1,0
2019,226231,50,0,27,21,6
2019,226277,0,0,56,55,1
2019,226277,10,0,56,55,1
2019,226277,10,4,56,55,1
2019,226277,40,0,56,55,1
2019,226277,40,4,56,55,1
2019,226277,41,0,56,55,1
2019,226277,41,4,56,55,1
2019,226277,45,0,56,55,1
2019,226277,45,4,56,55,1
2019,226383,0,0,96,51,45
2019,226383,10,0,96,51,45
2019,226383,10,1,34,21,13
2019,226383,10,2,25,16,9
2019,226383,10,3,31,12,19
2019,226383,10,4,1,0,1
2019,226383,10,5,2,1,1
2019,226383,10,6,3,1,2
2019,226383,20,0,57,31,26
2019,226383,20,1,32,20,12
2019,226383,20,2,19,10,9
2019,226383,20,3,6,1,5
2019,226383,30,0,34,18,16
2019,226383,30,1,2,1,1
2019,226383,30,2,6,6,0
2019,226383,30,3,25,11,14
2019,226383,30,4,1,0,1
2019,226383,40,0,5,2,3
2019,226383,40,5,2,1,1
2019,226383,40,6,3,1,2
2019,226383,42,0,5,2,3
2019,226383,42,5,2,1,1
2019,226383,42,6,3,1,2
2019,226408,0,0,115,55,60
2019,226408,10,0,115,55,60
2019,226408,10,1,18,13,5
2019,226408,10,2,28,17,11
2019,226408,10,3,69,25,44
2019,226408,20,0,45,26,19
2019,226408,20,1,15,12,3
2019,226408,20,2,20,12,8
2019,226408,20,3,10,2,8
2019,226408,30,0,31,14,17
2019,226408,30,1,3,1,2
2019,226408,30,2,5,3,2
2019,226408,30,3,23,10,13
2019,226408,40,0,39,15,24
2019,226408,40,2,3,2,1
2019,226408,40,3,36,13,23
2019,226408,41,0,15,7,8
2019,226408,41,2,3,2,1
2019,226408,41,3,12,5,7
2019,226408,42,0,24,8,16
2019,226408,42,3,24,8,16
2019,226408,44,0,11,5,6
2019,226408,44,2,3,2,1
2019,226408,44,3,8,3,5
2019,226408,45,0,4,2,2
2019,226408,45,3,4,2,2
2019,226471,0,0,165,70,95
2019,226471,10,0,165,70,95
2019,226471,10,1,49,23,26
2019,226471,10,2,38,16,22
2019,226471,10,3,66,26,40
2019,226471,10,4,12,5,7
2019,226471,20,0,64,33,31
2019,226471,20,1,45,22,23
2019,226471,20,2,19,11,8
2019,226471,30,0,66,26,40
2019,226471,30,1,4,1,3
2019,226471,30,2,16,4,12
2019,226471,30,3,46,21,25
2019,226471,40,0,35,11,24
2019,226471,40,2,3,1,2
2019,226471,40,3,20,5,15
2019,226471,40,4,12,5,7
2019,226471,42,0,35,11,24
2019,226471,42,2,3,1,2
2019,226471,42,3,20,5,15
2019,226471,42,4,12,5,7
2019,226578,0,0,215,70,145
2019,226578,10,0,215,70,145
2019,226578,10,1,118,42,76
2019,226578,10,2,41,11,30
2019,226578,10,3,48,16,32
2019,226578,10,4,8,1,7
2019,226578,20,0,118,42,76
2019,226578,20,1,118,42,76
2019,226578,30,0,41,11,30
2019,226578,30,2,41,11,30
2019,226578,40,0,56,17,39
2019,226578,40,3,48,16,32
2019,226578,40,4,8,1,7
2019,226578,42,0,48,16,32
2019,226578,42,3,48,16,32
2019,226578,43,0,8,1,7
2019,226578,43,4,8,1,7
2019,226587,0,0,81,46,35
2019,226587,10,0,81,46,35
2019,226587,10,1,28,19,9
2019,226587,10,2,18,12,6
2019,226587,10,3,15,10,5
2019,226587,10,4,20,5,15
2019,226587,20,0,45,30,15
2019,226587,20,1,28,19,9
2019,226587,20,2,17,11,6
2019,226587,30,0,11,8,3
2019,226587,30,2,1,1,0
2019,226587,30,3,9,7,2
2019,226587,30,4,1,0,1
2019,226587,40,0,25,8,17
2019,226587,40,3,6,3,3
2019,226587,40,4,19,5,14
2019,226587,42,0,25,8,17
2019,226587,42,3,6,3,3
2019,226587,42,4,19,5,14
2019,226806,0,0,135,61,74
2019,226806,10,0,135,61,74
2019,226806,10,1,42,20,22
2019,226806,10,2,46,25,21
2019,226806,10,3,16,6,10
2019,226806,10,4,31,10,21
2019,226806,40,0,135,61,74
2019,226806,40,1,42,20,22
2019,226806,40,2,46,25,21
2019,226806,40,3,16,6,10
2019,226806,40,4,31,10,21
2019,226806,42,0,135,61,74
2019,226806,42,1,42,20,22
2019,226806,42,2,46,25,21
2019,226806,42,3,16,6,10
2019,226806,42,4,31,10,21
2019,226833,0,0,241,118,123
2019,226833,10,0,241,118,123
2019,226833,10,1,48,32,16
2019,226833,10,2,74,38,36
2019,226833,10,3,92,35,57
2019,226833,10,4,21,8,13
2019,226833,10,5,5,4,1
2019,226833,10,6,1,1,0
2019,226833,20,0,122,69,53
2019,226833,20,1,48,32,16
2019,226833,20,2,70,35,35
2019,226833,20,3,4,2,2
2019,226833,30,0,45,26,19
2019,226833,30,2,3,2,1
2019,226833,30,3,42,24,18
2019,226833,40,0,74,23,51
2019,226833,40,2,1,1,0
2019,226833,40,3,46,9,37
2019,226833,40,4,21,8,13
2019,226833,40,5,5,4,1
2019,226833,40,6,1,1,0
2019,226833,42,0,71,22,49
2019,226833,42,2,1,1,0
2019,226833,42,3,44,9,35
2019,226833,42,4,21,8,13
2019,226833,42,5,5,4,1
2019,226833,43,0,3,1,2
2019,226833,43,3,2,0,2
2019,226833,43,6,1,1,0
2019,226879,0,0,6,4,2
2019,226879,10,0,6,4,2
2019,226879,10,1,6,4,2
2019,226879,40,0,6,4,2
2019,226879,40,1,6,4,2
2019,226879,43,0,6,4,2
2019,226879,43,1,6,4,2
2019,226903,0,0,101,55,46
2019,226903,10,0,101,55,46
2019,226903,10,4,101,55,46
2019,226903,40,0,101,55,46
2019,226903,40,4,101,55,46
2019,226903,41,0,101,55,46
2019,226903,41,4,101,55,46
2019,226903,45,0,101,55,46
2019,226903,45,4,101,55,46
2019,226930,0,0,104,58,46
2019,226930,10,0,104,58,46
2019,226930,10,6,104,58,46
2019,226930,40,0,104,58,46
2019,226930,40,6,104,58,46
2019,226930,42,0,104,58,46
2019,226930,42,6,104,58,46
2019,227146,0,0,122,37,85
2019,227146,10,0,120,35,85
2019,227146,10,1,19,8,11
2019,227146,10,2,85,23,62
2019,227146,10,3,16,4,12
2019,227146,40,0,120,35,85
2019,227146,40,1,19,8,11
2019,227146,40,2,85,23,62
2019,227146,40,3,16,4,12
2019,227146,42,0,120,35,85
2019,227146,42,1,19,8,11
2019,227146,42,2,85,23,62
2019,227146,42,3,16,4,12
2019,227146,50,0,2,2,0
2019,227182,0,0,921,415,506
2019,227182,10,0,921,415,506
2019,227182,10,1,649,296,353
2019,227182,10,2,169,62,107
2019,227182,10,3,45,13,32
2019,227182,10,4,58,44,14
2019,227182,40,0,921,415,506
2019,227182,40,1,649,296,353
2019,227182,40,2,169,62,107
2019,227182,40,3,45,13,32
2019,227182,40,4,58,44,14
2019,227182,41,0,699,317,382
2019,227182,41,1,643,293,350
2019,227182,41,2,55,24,31
2019,227182,41,3,1,0,1
2019,227182,42,0,222,98,124
2019,227182,42,1,6,3,3
2019,227182,42,2,114,38,76
2019,227182,42,3,44,13,31
2019,227182,42,4,58,44,14
2019,227182,44,0,699,317,382
2019,227182,44,1,643,293,350
2019,227182,44,2,55,24,31
2019,227182,44,3,1,0,1
2019,227191,0,0,117,62,55
2019,227191,10,0,117,62,55
2019,227191,10,6,117,62,55
2019,227191,40,0,117,62,55
2019,227191,40,6,117,62,55
2019,227191,42,0,117,62,55
2019,227191,42,6,117,62,55
2019,227216,0,0,1162,619,543
2019,227216,10,0,1157,616,541
2019,227216,10,1,324,226,98
2019,227216,10,2,265,153,112
2019,227216,10,3,196,99,97
2019,227216,10,4,73,23,50
2019,227216,10,5,296,113,183
2019,227216,10,6,3,2,1
2019,227216,20,0,583,377,206
2019,227216,20,1,324,226,98
2019,227216,20,2,258,150,108
2019,227216,20,3,1,1,0
2019,227216,30,0,202,101,101
2019,227216,30,2,7,3,4
2019,227216,30,3,195,98,97
2019,227216,40,0,372,138,234
2019,227216,40,4,73,23,50
2019,227216,40,5,296,113,183
2019,227216,40,6,3,2,1
2019,227216,41,0,254,96,158
2019,227216,41,5,254,96,158
2019,227216,42,0,42,17,25
2019,227216,42,5,42,17,25
2019,227216,43,0,76,25,51
2019,227216,43,4,73,23,50
2019,227216,43,6,3,2,1
2019,227216,44,0,254,96,158
2019,227216,44,5,254,96,158
2019,227216,50,0,5,3,2
2019,227225,0,0,66,28,38
2019,227225,10,0,66,28,38
2019,227225,10,1,35,18,17
2019,227225,10,2,8,2,6
2019,227225,10,3,6,2,4
2019,227225,10,4,17,6,11
2019,227225,40,0,66,28,38
2019,227225,40,1,35,18,17
2019,227225,40,2,8,2,6
2019,227225,40,3,6,2,4
2019,227225,40,4,17,6,11
2019,227225,42,0,66,28,38
2019,227225,42,1,35,18,17
2019,227225,42,2,8,2,6
2019,227225,42,3,6,2,4
2019,227225,42,4,17,6,11
2019,227289,0,0,28,14,14
2019,227289,10,0,21,13,8
2019,227289,10,1,9,8,1
2019,227289,10,2,4,3,1
2019,227289,10,3,3,1,2
2019,227289,10,4,5,1,4
2019,227289,40,0,21,13,8
2019,227289,40,1,9,8,1
2019,227289,40,2,4,3,1
2019,227289,40,3,3,1,2
2019,227289,40,4,5,1,4
2019,227289,41,0,15,11,4
2019,227289,41,1,8,7,1
2019,227289,41,2,4,3,1
2019,227289,41,3,2,1,1
2019,227289,41,4,1,0,1
2019,227289,42,0,6,2,4
2019,227289,42,1,1,1,0
2019,227289,42,3,1,0,1
2019,227289,42,4,4,1,3
2019,227289,44,0,15,11,4
2019,227289,44,1,8,7,1
2019,227289,44,2,4,3,1
2019,227289,44,3,2,1,1
2019,227289,44,4,1,0,1
2019,227289,50,0,7,1,6
2019,227304,0,0,133,64,69
2019,227304,10,0,133,64,69
2019,227304,10,1,11,10,1
2019,227304,10,2,44,23,21
2019,227304,10,3,25,11,14
2019,227304,10,4,53,20,33
2019,227304,20,0,7,4,3
2019,227304,20,1,4,3,1
2019,227304,20,3,1,0,1
2019,227304,20,4,2,1,1
2019,227304,40,0,126,60,66
2019,227304,40,1,7,7,0
2019,227304,40,2,44,23,21
2019,227304,40,3,24,11,13
2019,227304,40,4,51,19,32
2019,227304,42,0,126,60,66
2019,227304,42,1,7,7,0
2019,227304,42,2,44,23,21
2019,227304,42,3,24,11,13
2019,227304,42,4,51,19,32
2019,227331,0,0,108,42,66
2019,227331,10,0,108,42,66
2019,227331,10,1,25,7,18
2019,227331,10,2,28,8,20
2019,227331,10,3,52,25,27
2019,227331,10,4,2,1,1
2019,227331,10,5,1,1,0
2019,227331,20,0,37,9,28
2019,227331,20,1,23,7,16
2019,227331,20,2,14,2,12
2019,227331,30,0,34,13,21
2019,227331,30,2,1,0,1
2019,227331,30,3,32,13,19
2019,227331,30,4,1,0,1
2019,227331,40,0,37,20,17
2019,227331,40,1,2,0,2
2019,227331,40,2,13,6,7
2019,227331,40,3,20,12,8
2019,227331,40,4,1,1,0
2019,227331,40,5,1,1,0
2019,227331,42,0,36,19,17
2019,227331,42,1,2,0,2
2019,227331,42,2,13,6,7
2019,227331,42,3,20,12,8
2019,227331,42,4,1,1,0
2019,227331,43,0,1,1,0
2019,227331,43,5,1,1,0
2019,227368,0,0,1273,728,545
2019,227368,10,0,1273,728,545
2019,227368,10,1,252,185,67
2019,227368,10,2,261,165,96
2019,227368,10,3,288,166,122
2019,227368,10,5,472,212,260
2019,227368,20,0,470,323,147
2019,227368,20,1,246,181,65
2019,227368,20,2,224,142,82
2019,227368,30,0,235,135,100
2019,227368,30,2,20,12,8
2019,227368,30,3,215,123,92
2019,227368,40,0,568,270,298
2019,227368,40,1,6,4,2
2019,227368,40,2,17,11,6
2019,227368,40,3,73,43,30
2019,227368,40,5,472,212,260
2019,227368,41,0,422,195,227
2019,227368,41,1,6,4,2
2019,227368,41,2,17,11,6
2019,227368,41,3,72,42,30
2019,227368,41,5,327,138,189
2019,227368,42,0,146,75,71
2019,227368,42,3,1,1,0
2019,227368,42,5,145,74,71
2019,227368,44,0,422,195,227
2019,227368,44,1,6,4,2
2019,227368,44,2,17,11,6
2019,227368,44,3,72,42,30
2019,227368,44,5,327,138,189
2019,227377,0,0,100,50,50
2019,227377,10,0,99,49,50
2019,227377,10,6,99,49,50
2019,227377,40,0,99,49,50
2019,227377,40,6,99,49,50
2019,227377,42,0,98,48,50
2019,227377,42,6,98,48,50
2019,227377,43,0,1,1,0
2019,227377,43,6,1,1,0
2019,227377,50,0,1,1,0
2019,227386,0,0,73,30,43
2019,227386,10,0,73,30,43
2019,227386,10,1,55,23,32
2019,227386,10,4,18,7,11
2019,227386,40,0,73,30,43
2019,227386,40,1,55,23,32
2019,227386,40,4,18,7,11
2019,227386,42,0,73,30,43
2019,227386,42,1,55,23,32
2019,227386,42,4,18,7,11
2019,227401,0,0,83,42,41
2019,227401,10,0,83,42,41
2019,227401,10,6,83,42,41
2019,227401,40,0,83,42,41
2019,227401,40,6,83,42,41
2019,227401,42,0,83,42,41
2019,227401,42,6,83,42,41
2019,227429,0,0,12,6,6
2019,227429,10,0,12,6,6
2019,227429,10,2,7,4,3
2019,227429,10,5,5,2,3
2019,227429,40,0,12,6,6
2019,227429,40,2,7,4,3
2019,227429,40,5,5,2,3
2019,227429,42,0,12,6,6
2019,227429,42,2,7,4,3
2019,227429,42,5,5,2,3
2019,227526,0,0,423,242,181
2019,227526,10,0,411,237,174
2019,227526,10,1,77,58,19
2019,227526,10,2,64,43,21
2019,227526,10,3,94,49,45
2019,227526,10,4,1,1,0
2019,227526,10,5,175,86,89
2019,227526,20,0,139,99,40
2019,227526,20,1,76,57,19
2019,227526,20,2,63,42,21
2019,227526,30,0,97,52,45
2019,227526,30,1,1,1,0
2019,227526,30,2,1,1,0
2019,227526,30,3,94,49,45
2019,227526,30,4,1,1,0
2019,227526,40,0,175,86,89
2019,227526,40,5,175,86,89
2019,227526,42,0,8,5,3
2019,227526,42,5,8,5,3
2019,227526,43,0,167,81,86
2019,227526,43,5,167,81,86
2019,227526,50,0,12,5,7
2019,227687,0,0,42,19,23
2019,227687,10,0,41,18,23
2019,227687,10,1,7,6,1
2019,227687,10,2,2,1,1
2019,227687,10,3,2,0,2
2019,227687,10,4,30,11,19
2019,227687,20,0,2,2,0
2019,227687,20,1,2,2,0
2019,227687,40,0,39,16,23
2019,227687,40,1,5,4,1
2019,227687,40,2,2,1,1
2019,227687,40,3,2,0,2
2019,227687,40,4,30,11,19
2019,227687,41,0,1,1,0
2019,227687,41,1,1,1,0
2019,227687,42,0,38,15,23
2019,227687,42,1,4,3,1
2019,227687,42,2,2,1,1
2019,227687,42,3,2,0,2
2019,227687,42,4,30,11,19
2019,227687,44,0,1,1,0
2019,227687,44,1,1,1,0
2019,227687,50,0,1,1,0
2019,227757,0,0,694,452,242
2019,227757,10,0,694,452,242
2019,227757,10,1,315,241,74
2019,227757,10,2,111,67,44
2019,227757,10,3,114,69,45
2019,227757,10,4,19,12,7
2019,227757,10,5,132,60,72
2019,227757,10,6,3,3,0
2019,227757,20,0,425,308,117
2019,227757,20,1,315,241,74
2019,227757,20,2,110,67,43
2019,227757,30,0,114,69,45
2019,227757,30,3,114,69,45
2019,227757,40,0,155,75,80
2019,227757,40,2,1,0,1
2019,227757,40,4,19,12,7
2019,227757,40,5,132,60,72
2019,227757,40,6,3,3,0
2019,227757,41,0,125,58,67
2019,227757,41,4,13,6,7
2019,227757,41,5,110,50,60
2019,227757,41,6,2,2,0
2019,227757,42,0,30,17,13
2019,227757,42,2,1,0,1
2019,227757,42,4,6,6,0
2019,227757,42,5,22,10,12
2019,227757,42,6,1,1,0
2019,227757,44,0,125,58,67
2019,227757,44,4,13,6,7
2019,227757,44,5,110,50,60
2019,227757,44,6,2,2,0
2019,227766,0,0,185,89,96
2019,227766,10,0,185,89,96
2019,227766,10,6,185,89,96
2019,227766,40,0,185,89,96
2019,227766,40,6,185,89,96
2019,227766,42,0,185,89,96
2019,227766,42,6,185,89,96
2019,227845,0,0,176,83,93
2019,227845,10,0,176,83,93
2019,227845,10,1,40,19,21
2019,227845,10,2,68,29,39
2019,227845,10,3,58,31,27
2019,227845,10,4,8,4,4
2019,227845,10,5,2,0,2
2019,227845,20,0,83,36,47
2019,227845,20,1,39,19,20
2019,227845,20,2,44,17,27
2019,227845,30,0,68,34,34
2019,227845,30,1,1,0,1
2019,227845,30,2,24,12,12
2019,227845,30,3,43,22,21
2019,227845,40,0,25,13,12
2019,227845,40,3,15,9,6
2019,227845,40,4,8,4,4
2019,227845,40,5,2,0,2
2019,227845,42,0,25,13,12
2019,227845,42,3,15,9,6
2019,227845,42,4,8,4,4
2019,227845,42,5,2,0,2
2019,227854,0,0,217,125,92
2019,227854,10,0,180,98,82
2019,227854,10,1,11,6,5
2019,227854,10,2,25,12,13
2019,227854,10,3,50,24,26
2019,227854,10,4,94,56,38
2019,227854,20,0,67,34,33
2019,227854,20,1,11,6,5
2019,227854,20,2,19,10,9
2019,227854,20,3,19,11,8
2019,227854,20,4,18,7,11
2019,227854,30,0,5,5,0
2019,227854,30,3,2,2,0
2019,227854,30,4,3,3,0
2019,227854,40,0,108,59,49
2019,227854,40,2,6,2,4
2019,227854,40,3,29,11,18
2019,227854,40,4,73,46,27
2019,227854,42,0,108,59,49
2019,227854,42,2,6,2,4
2019,227854,42,3,29,11,18
2019,227854,42,4,73,46,27
2019,227854,50,0,37,27,10
2019,227863,0,0,151,83,68
2019,227863,10,0,151,83,68
2019,227863,10,1,35,19,16
2019,227863,10,2,50,31,19
2019,227863,10,3,45,24,21
2019,227863,10,4,18,8,10
2019,227863,10,6,3,1,2
2019,227863,20,0,75,44,31
2019,227863,20,1,29,17,12
2019,227863,20,2,43,26,17
2019,227863,20,3,3,1,2
2019,227863,30,0,22,13,9
2019,227863,30,2,6,4,2
2019,227863,30,3,16,9,7
2019,227863,40,0,54,26,28
2019,227863,40,1,6,2,4
2019,227863,40,2,1,1,0
2019,227863,40,3,26,14,12
2019,227863,40,4,18,8,10
2019,227863,40,6,3,1,2
2019,227863,42,0,54,26,28
2019,227863,42,1,6,2,4
2019,227863,42,2,1,1,0
2019,227863,42,3,26,14,12
2019,227863,42,4,18,8,10
2019,227863,42,6,3,1,2
2019,227881,0,0,781,408,373
2019,227881,10,0,781,408,373
2019,227881,10,1,176,115,61
2019,227881,10,2,188,110,78
2019,227881,10,3,186,89,97
2019,227881,10,4,1,0,1
2019,227881,10,5,230,94,136
2019,227881,20,0,351,213,138
2019,227881,20,1,175,114,61
2019,227881,20,2,173,99,74
2019,227881,20,3,2,0,2
2019,227881,20,4,1,0,1
2019,227881,30,0,200,101,99
2019,227881,30,1,1,1,0
2019,227881,30,2,15,11,4
2019,227881,30,3,184,89,95
2019,227881,40,0,230,94,136
2019,227881,40,5,230,94,136
2019,227881,42,0,152,61,91
2019,227881,42,5,152,61,91
2019,227881,43,0,78,33,45
2019,227881,43,5,78,33,45
2019,227924,0,0,296,137,159
2019,227924,10,0,262,125,137
2019,227924,10,1,84,38,46
2019,227924,10,2,42,21,21
2019,227924,10,3,56,23,33
2019,227924,10,4,80,43,37
2019,227924,20,0,178,85,93
2019,227924,20,1,83,38,45
2019,227924,20,2,38,21,17
2019,227924,20,3,35,16,19
2019,227924,20,4,22,10,12
2019,227924,30,0,2,2,0
2019,227924,30,3,1,1,0
2019,227924,30,4,1,1,0
2019,227924,40,0,82,38,44
2019,227924,40,1,1,0,1
2019,227924,40,2,4,0,4
2019,227924,40,3,20,6,14
2019,227924,40,4,57,32,25
2019,227924,42,0,82,38,44
2019,227924,42,1,1,0,1
2019,227924,42,2,4,0,4
2019,227924,42,3,20,6,14
2019,227924,42,4,57,32,25
2019,227924,50,0,34,12,22
2019,227979,0,0,534,245,289
2019,227979,10,0,534,245,289
2019,227979,10,6,534,245,289
2019,227979,40,0,534,245,289
2019,227979,40,6,534,245,289
2019,227979,42,0,534,245,289
2019,227979,42,6,534,245,289
2019,228042,0,0,61,35,26
2019,228042,10,0,61,35,26
2019,228042,10,1,10,5,5
2019,228042,10,2,15,7,8
2019,228042,10,3,24,20,4
2019,228042,10,4,12,3,9
2019,228042,20,0,15,8,7
2019,228042,20,1,9,5,4
2019,228042,20,2,6,3,3
2019,228042,30,0,25,17,8
2019,228042,30,1,1,0,1
2019,228042,30,2,9,4,5
2019,228042,30,3,15,13,2
2019,228042,40,0,21,10,11
2019,228042,40,3,9,7,2
2019,228042,40,4,12,3,9
2019,228042,42,0,21,10,11
2019,228042,42,3,9,7,2
2019,228042,42,4,12,3,9
2019,228149,0,0,221,131,90
2019,228149,10,0,221,131,90
2019,228149,10,1,87,56,31
2019,228149,10,2,60,40,20
2019,228149,10,3,46,24,22
2019,228149,10,4,24,11,13
2019,228149,10,5,4,0,4
2019,228149,20,0,137,93,44
2019,228149,20,1,77,53,24
2019,228149,20,2,58,38,20
2019,228149,20,3,2,2,0
2019,228149,30,0,36,17,19
2019,228149,30,2,1,1,0
2019,228149,30,3,35,16,19
2019,228149,40,0,48,21,27
2019,228149,40,1,10,3,7
2019,228149,40,2,1,1,0
2019,228149,40,3,9,6,3
2019,228149,40,4,24,11,13
2019,228149,40,5,4,0,4
2019,228149,41,0,11,3,8
2019,228149,41,1,9,2,7
2019,228149,41,4,2,1,1
2019,228149,42,0,37,18,19
2019,228149,42,1,1,1,0
2019,228149,42,2,1,1,0
2019,228149,42,3,9,6,3
2019,228149,42,4,22,10,12
2019,228149,42,5,4,0,4
2019,228149,44,0,11,3,8
2019,228149,44,1,9,2,7
2019,228149,44,4,2,1,1
2019,228158,0,0,261,126,135
2019,228158,10,0,261,126,135
2019,228158,10,1,54,30,24
2019,228158,10,2,42,23,19
2019,228158,10,3,79,35,44
2019,228158,10,4,86,38,48
2019,228158,20,0,175,94,81
2019,228158,20,1,54,30,24
2019,228158,20,2,41,23,18
2019,228158,20,3,60,28,32
2019,228158,20,4,20,13,7
2019,228158,30,0,84,31,53
2019,228158,30,2,1,0,1
2019,228158,30,3,19,7,12
2019,228158,30,4,64,24,40
2019,228158,40,0,2,1,1
2019,228158,40,4,2,1,1
2019,228158,42,0,2,1,1
2019,228158,42,4,2,1,1
2019,228194,0,0,53,31,22
2019,228194,10,0,53,31,22
2019,228194,10,1,47,29,18
2019,228194,10,2,5,1,4
2019,228194,10,3,1,1,0
2019,228194,20,0,47,29,18
2019,228194,20,1,47,29,18
2019,228194,30,0,1,1,0
2019,228194,30,3,1,1,0
2019,228194,40,0,5,1,4
2019,228194,40,2,5,1,4
2019,228194,42,0,5,1,4
2019,228194,42,2,5,1,4
2019,228246,0,0,754,451,303
2019,228246,10,0,754,451,303
2019,228246,10,1,209,165,44
2019,228246,10,2,167,111,56
2019,228246,10,3,103,45,58
2019,228246,10,4,123,68,55
2019,228246,10,5,145,58,87
2019,228246,10,6,7,4,3
2019,228246,20,0,375,274,101
2019,228246,20,1,209,165,44
2019,228246,20,2,165,109,56
2019,228246,20,3,1,0,1
2019,228246,30,0,104,47,57
2019,228246,30,2,2,2,0
2019,228246,30,3,102,45,57
2019,228246,40,0,275,130,145
2019,228246,40,4,123,68,55
2019,228246,40,5,145,58,87
2019,228246,40,6,7,4,3
2019,228246,41,0,201,91,110
2019,228246,41,4,89,46,43
2019,228246,41,5,107,42,65
2019,228246,41,6,5,3,2
2019,228246,42,0,73,39,34
2019,228246,42,4,34,22,12
2019,228246,42,5,37,16,21
2019,228246,42,6,2,1,1
2019,228246,43,0,1,0,1
2019,228246,43,5,1,0,1
2019,228246,44,0,201,91,110
2019,228246,44,4,89,46,43
2019,228246,44,5,107,42,65
2019,228246,44,6,5,3,2
2019,228316,0,0,134,66,68
2019,228316,10,0,130,62,68
2019,228316,10,1,11,6,5
2019,228316,10,2,1,1,0
2019,228316,10,3,9,5,4
2019,228316,10,4,108,49,59
2019,228316,10,6,1,1,0
2019,228316,20,0,24,14,10
2019,228316,20,1,11,6,5
2019,228316,20,2,1,1,0
2019,228316,20,3,4,2,2
2019,228316,20,4,8,5,3
2019,228316,30,0,18,10,8
2019,228316,30,3,4,3,1
2019,228316,30,4,13,6,7
2019,228316,30,6,1,1,0
2019,228316,40,0,88,38,50
2019,228316,40,3,1,0,1
2019,228316,40,4,87,38,49
2019,228316,42,0,88,38,50
2019,228316,42,3,1,0,1
2019,228316,42,4,87,38,49
2019,228316,50,0,4,4,0
2019,228325,0,0,73,46,27
2019,228325,10,0,73,46,27
2019,228325,10,1,21,15,6
2019,228325,10,2,10,5,5
2019,228325,10,3,21,14,7
2019,228325,10,4,21,12,9
2019,228325,40,0,73,46,27
2019,228325,40,1,21,15,6
2019,228325,40,2,10,5,5
2019,228325,40,3,21,14,7
2019,228325,40,4,21,12,9
2019,228325,41,0,9,8,1
2019,228325,41,1,2,1,1
2019,228325,41,2,2,2,0
2019,228325,41,3,3,3,0
2019,228325,41,4,2,2,0
2019,228325,42,0,63,37,26
2019,228325,42,1,19,14,5
2019,228325,42,2,8,3,5
2019,228325,42,3,17,10,7
2019,228325,42,4,19,10,9
2019,228325,43,0,1,1,0
2019,228325,43,3,1,1,0
2019,228325,45,0,9,8,1
2019,228325,45,1,2,1,1
2019,228325,45,2,2,2,0
2019,228325,45,3,3,3,0
2019,228325,45,4,2,2,0
2019,228343,0,0,112,51,61
2019,228343,10,0,112,51,61
2019,228343,10,1,40,16,24
2019,228343,10,2,36,21,15
2019,228343,10,3,14,7,7
2019,228343,10,4,22,7,15
2019,228343,20,0,76,37,39
2019,228343,20,1,40,16,24
2019,228343,20,2,36,21,15
2019,228343,30,0,14,7,7
2019,228343,30,3,14,7,7
2019,228343,40,0,22,7,15
2019,228343,40,4,22,7,15
2019,228343,41,0,16,5,11
2019,228343,41,4,16,5,11
2019,228343,42,0,6,2,4
2019,228343,42,4,6,2,4
2019,228343,44,0,8,0,8
2019,228343,44,4,8,0,8
2019,228343,45,0,8,5,3
2019,228343,45,4,8,5,3
2019,228431,0,0,535,266,269
2019,228431,10,0,535,266,269
2019,228431,10,1,113,79,34
2019,228431,10,2,141,81,60
2019,228431,10,3,134,68,66
2019,228431,10,4,52,8,44
2019,228431,10,5,80,24,56
2019,228431,10,6,15,6,9
2019,228431,20,0,269,166,103
2019,228431,20,1,113,79,34
2019,228431,20,2,133,77,56
2019,228431,20,3,18,9,9
2019,228431,20,4,3,1,2
2019,228431,20,5,2,0,2
2019,228431,30,0,122,59,63
2019,228431,30,2,8,4,4
2019,228431,30,3,101,52,49
2019,228431,30,4,10,2,8
2019,228431,30,6,3,1,2
2019,228431,40,0,144,41,103
2019,228431,40,3,15,7,8
2019,228431,40,4,39,5,34
2019,228431,40,5,78,24,54
2019,228431,40,6,12,5,7
2019,228431,42,0,47,10,37
2019,228431,42,4,18,3,15
2019,228431,42,5,29,7,22
2019,228431,43,0,97,31,66
2019,228431,43,3,15,7,8
2019,228431,43,4,21,2,19
2019,228431,43,5,49,17,32
2019,228431,43,6,12,5,7
2019,228459,0,0,1346,667,679
2019,228459,10,0,1346,667,679
2019,228459,10,1,263,166,97
2019,228459,10,2,289,143,146
2019,228459,10,3,254,114,140
2019,228459,10,5,521,233,288
2019,228459,10,6,19,11,8
2019,228459,20,0,518,295,223
2019,228459,20,1,253,159,94
2019,228459,20,2,261,133,128
2019,228459,20,3,4,3,1
2019,228459,30,0,226,102,124
2019,228459,30,1,2,1,1
2019,228459,30,2,8,4,4
2019,228459,30,3,216,97,119
2019,228459,40,0,602,270,332
2019,228459,40,1,8,6,2
2019,228459,40,2,20,6,14
2019,228459,40,3,34,14,20
2019,228459,40,5,521,233,288
2019,228459,40,6,19,11,8
2019,228459,41,0,289,110,179
2019,228459,41,1,2,1,1
2019,228459,41,2,13,2,11
2019,228459,41,3,17,4,13
2019,228459,41,5,238,92,146
2019,228459,41,6,19,11,8
2019,228459,42,0,313,160,153
2019,228459,42,1,6,5,1
2019,228459,42,2,7,4,3
2019,228459,42,3,17,10,7
2019,228459,42,5,283,141,142
2019,228459,44,0,289,110,179
2019,228459,44,1,2,1,1
2019,228459,44,2,13,2,11
2019,228459,44,3,17,4,13
2019,228459,44,5,238,92,146
2019,228459,44,6,19,11,8
2019,228468,0,0,47,29,18
2019,228468,10,0,47,29,18
2019,228468,10,1,12,12,0
2019,228468,10,2,13,8,5
2019,228468,10,3,22,9,13
2019,228468,40,0,47,29,18
2019,228468,40,1,12,12,0
2019,228468,40,2,13,8,5
2019,228468,40,3,22,9,13
2019,228468,41,0,14,13,1
2019,228468,41,1,11,11,0
2019,228468,41,2,3,2,1
2019,228468,42,0,33,16,17
2019,228468,42,1,1,1,0
2019,228468,42,2,10,6,4
2019,228468,42,3,22,9,13
2019,228468,45,0,14,13,1
2019,228468,45,1,11,11,0
2019,228468,45,2,3,2,1
2019,228486,0,0,8,5,3
2019,228486,10,0,8,5,3
2019,228486,10,2,8,5,3
2019,228486,40,0,8,5,3
2019,228486,40,2,8,5,3
2019,228486,42,0,8,5,3
2019,228486,42,2,8,5,3
2019,228501,0,0,109,59,50
2019,228501,10,0,109,59,50
2019,228501,10,1,29,18,11
2019,228501,10,2,15,9,6
2019,228501,10,3,34,19,15
2019,228501,10,4,4,1,3
2019,228501,10,5,18,6,12
2019,228501,10,6,9,6,3
2019,228501,20,0,40,24,16
2019,228501,20,1,29,18,11
2019,228501,20,2,11,6,5
2019,228501,30,0,44,27,17
2019,228501,30,2,4,3,1
2019,228501,30,3,31,19,12
2019,228501,30,4,4,1,3
2019,228501,30,6,5,4,1
2019,228501,40,0,25,8,17
2019,228501,40,3,3,0,3
2019,228501,40,5,18,6,12
2019,228501,40,6,4,2,2
2019,228501,41,0,1,1,0
2019,228501,41,5,1,1,0
2019,228501,42,0,18,5,13
2019,228501,42,3,3,0,3
2019,228501,42,5,14,4,10
2019,228501,42,6,1,1,0
2019,228501,43,0,6,2,4
2019,228501,43,5,3,1,2
2019,228501,43,6,3,1,2
2019,228501,45,0,1,1,0
2019,228501,45,5,1,1,0
2019,228529,0,0,432,224,208
2019,228529,10,0,430,224,206
2019,228529,10,1,78,54,24
2019,228529,10,2,93,52,41
2019,228529,10,3,169,84,85
2019,228529,10,4,89,33,56
2019,228529,10,5,1,1,0
2019,228529,20,0,158,101,57
2019,228529,20,1,74,52,22
2019,228529,20,2,84,49,35
2019,228529,30,0,145,74,71
2019,228529,30,1,3,1,2
2019,228529,30,2,6,3,3
2019,228529,30,3,135,70,65
2019,228529,30,4,1,0,1
2019,228529,40,0,127,49,78
2019,228529,40,1,1,1,0
2019,228529,40,2,3,0,3
2019,228529,40,3,34,14,20
2019,228529,40,4,88,33,55
2019,228529,40,5,1,1,0
2019,228529,41,0,38,15,23
2019,228529,41,1,1,1,0
2019,228529,41,2,3,0,3
2019,228529,41,3,34,14,20
2019,228529,42,0,89,34,55
2019,228529,42,4,88,33,55
2019,228529,42,5,1,1,0
2019,228529,45,0,38,15,23
2019,228529,45,1,1,1,0
2019,228529,45,2,3,0,3
2019,228529,45,3,34,14,20
2019,228529,50,0,2,0,2
2019,228547,0,0,763,336,427
2019,228547,10,0,763,336,427
2019,228547,10,1,122,62,60
2019,228547,10,2,140,65,75
2019,228547,10,3,153,49,104
2019,228547,10,4,348,160,188
2019,228547,20,0,312,132,180
2019,228547,20,1,121,61,60
2019,228547,20,2,89,40,49
2019,228547,20,3,101,30,71
2019,228547,20,4,1,1,0
2019,228547,30,0,424,192,232
2019,228547,30,1,1,1,0
2019,228547,30,2,51,25,26
2019,228547,30,3,52,19,33
2019,228547,30,4,320,147,173
2019,228547,40,0,27,12,15
2019,228547,40,4,27,12,15
2019,228547,42,0,16,7,9
2019,228547,42,4,16,7,9
2019,228547,43,0,11,5,6
2019,228547,43,4,11,5,6
2019,228608,0,0,129,55,74
2019,228608,10,0,129,55,74
2019,228608,10,1,55,26,29
2019,228608,10,2,25,10,15
2019,228608,10,3,45,17,28
2019,228608,10,4,3,2,1
2019,228608,10,6,1,0,1
2019,228608,20,0,78,38,40
2019,228608,20,1,50,25,25
2019,228608,20,2,21,9,12
2019,228608,20,3,5,3,2
2019,228608,20,4,2,1,1
2019,228608,30,0,50,17,33
2019,228608,30,1,5,1,4
2019,228608,30,2,4,1,3
2019,228608,30,3,40,14,26
2019,228608,30,4,1,1,0
2019,228608,40,0,1,0,1
2019,228608,40,6,1,0,1
2019,228608,42,0,1,0,1
2019,228608,42,6,1,0,1
2019,228635,0,0,1725,969,756
2019,228635,10,0,1725,969,756
2019,228635,10,1,376,276,100
2019,228635,10,2,375,230,145
2019,228635,10,3,929,439,490
2019,228635,10,4,45,24,21
2019,228635,20,0,146,115,31
2019,228635,20,1,126,101,25
2019,228635,20,2,20,14,6
2019,228635,30,0,35,23,12
2019,228635,30,2,2,1,1
2019,228635,30,3,33,22,11
2019,228635,40,0,1544,831,713
2019,228635,40,1,250,175,75
2019,228635,40,2,353,215,138
2019,228635,40,3,896,417,479
2019,228635,40,4,45,24,21
2019,228635,42,0,1544,831,713
2019,228635,42,1,250,175,75
2019,228635,42,2,353,215,138
2019,228635,42,3,896,417,479
2019,228635,42,4,45,24,21
2019,228644,0,0,836,460,376
2019,228644,10,0,836,460,376
2019,228644,10,1,224,171,53
2019,228644,10,2,210,115,95
2019,228644,10,3,338,150,188
2019,228644,10,4,20,9,11
2019,228644,10,5,1,0,1
2019,228644,10,6,43,15,28
2019,228644,20,0,224,153,71
2019,228644,20,1,158,122,36
2019,228644,20,2,65,31,34
2019,228644,20,3,1,0,1
2019,228644,30,0,69,38,31
2019,228644,30,1,1,1,0
2019,228644,30,2,12,8,4
2019,228644,30,3,56,29,27
2019,228644,40,0,543,269,274
2019,228644,40,1,65,48,17
2019,228644,40,2,133,76,57
2019,228644,40,3,281,121,160
2019,228644,40,4,20,9,11
2019,228644,40,5,1,0,1
2019,228644,40,6,43,15,28
2019,228644,42,0,540,268,272
2019,228644,42,1,65,48,17
2019,228644,42,2,133,76,57
2019,228644,42,3,278,120,158
2019,228644,42,4,20,9,11
2019,228644,42,5,1,0,1
2019,228644,42,6,43,15,28
2019,228644,43,0,3,1,2
2019,228644,43,3,3,1,2
2019,228653,0,0,562,290,272
2019,228653,10,0,562,290,272
2019,228653,10,1,194,129,65
2019,228653,10,2,144,71,73
2019,228653,10,3,220,88,132
2019,228653,10,4,3,1,2
2019,228653,10,6,1,1,0
2019,228653,20,0,185,120,65
2019,228653,20,1,145,101,44
2019,228653,20,2,40,19,21
2019,228653,30,0,64,36,28
2019,228653,30,1,3,2,1
2019,228653,30,2,23,15,8
2019,228653,30,3,38,19,19
2019,228653,40,0,313,134,179
2019,228653,40,1,46,26,20
2019,228653,40,2,81,37,44
2019,228653,40,3,182,69,113
2019,228653,40,4,3,1,2
2019,228653,40,6,1,1,0
2019,228653,42,0,313,134,179
2019,228653,42,1,46,26,20
2019,228653,42,2,81,37,44
2019,228653,42,3,182,69,113
2019,228653,42,4,3,1,2
2019,228653,42,6,1,1,0
2019,228699,0,0,99,38,61
2019,228699,10,0,99,38,61
2019,228699,10,1,22,10,12
2019,228699,10,2,30,8,22
2019,228699,10,3,21,4,17
2019,228699,10,4,15,10,5
2019,228699,10,6,11,6,5
2019,228699,20,0,35,13,22
2019,228699,20,1,18,8,10
2019,228699,20,2,17,5,12
2019,228699,40,0,64,25,39
2019,228699,40,1,4,2,2
2019,228699,40,2,13,3,10
2019,228699,40,3,21,4,17
2019,228699,40,4,15,10,5
2019,228699,40,6,11,6,5
2019,228699,41,0,11,6,5
2019,228699,41,6,11,6,5
2019,228699,42,0,53,19,34
2019,228699,42,1,4,2,2
2019,228699,42,2,13,3,10
2019,228699,42,3,21,4,17
2019,228699,42,4,15,10,5
2019,228699,45,0,11,6,5
2019,228699,45,6,11,6,5
2019,228705,0,0,406,254,152
2019,228705,10,0,320,208,112
2019,228705,10,1,103,80,23
2019,228705,10,2,84,54,30
2019,228705,10,3,71,44,27
2019,228705,10,5,32,14,18
2019,228705,10,6,30,16,14
2019,228705,20,0,189,135,54
2019,228705,20,1,99,76,23
2019,228705,20,2,79,50,29
2019,228705,20,3,9,7,2
2019,228705,20,6,2,2,0
2019,228705,30,0,56,34,22
2019,228705,30,2,5,4,1
2019,228705,30,3,50,30,20
2019,228705,30,6,1,0,1
2019,228705,40,0,75,39,36
2019,228705,40,1,4,4,0
2019,228705,40,3,12,7,5
2019,228705,40,5,32,14,18
2019,228705,40,6,27,14,13
2019,228705,41,0,10,4,6
2019,228705,41,6,10,4,6
2019,228705,42,0,50,26,24
2019,228705,42,1,4,4,0
2019,228705,42,3,12,7,5
2019,228705,42,5,31,13,18
2019,228705,42,6,3,2,1
2019,228705,43,0,15,9,6
2019,228705,43,5,1,1,0
2019,228705,43,6,14,8,6
2019,228705,44,0,9,4,5
2019,228705,44,6,9,4,5
2019,228705,45,0,1,0,1
2019,228705,45,6,1,0,1
2019,228705,50,0,86,46,40
2019,228723,0,0,3253,2064,1189
2019,228723,10,0,3253,2064,1189
2019,228723,10,1,1157,925,232
2019,228723,10,2,710,430,280
2019,228723,10,3,668,354,314
2019,228723,10,4,464,230,234
2019,228723,10,5,254,125,129
2019,228723,20,0,1585,1173,412
2019,228723,20,1,1018,809,209
2019,228723,20,2,563,361,202
2019,228723,20,3,2,1,1
2019,228723,20,4,2,2,0
2019,228723,30,0,494,292,202
2019,228723,30,1,7,7,0
2019,228723,30,2,41,21,20
2019,228723,30,3,446,264,182
2019,228723,40,0,1174,599,575
2019,228723,40,1,132,109,23
2019,228723,40,2,106,48,58
2019,228723,40,3,220,89,131
2019,228723,40,4,462,228,234
2019,228723,40,5,254,125,129
2019,228723,41,0,265,122,143
2019,228723,41,1,38,24,14
2019,228723,41,2,32,12,20
2019,228723,41,3,54,20,34
2019,228723,41,4,103,54,49
2019,228723,41,5,38,12,26
2019,228723,42,0,908,476,432
2019,228723,42,1,93,84,9
2019,228723,42,2,74,36,38
2019,228723,42,3,166,69,97
2019,228723,42,4,359,174,185
2019,228723,42,5,216,113,103
2019,228723,43,0,1,1,0
2019,228723,43,1,1,1,0
2019,228723,44,0,265,122,143
2019,228723,44,1,38,24,14
2019,228723,44,2,32,12,20
2019,228723,44,3,54,20,34
2019,228723,44,4,103,54,49
2019,228723,44,5,38,12,26
2019,228769,0,0,1091,590,501
2019,228769,10,0,1091,590,501
2019,228769,10,1,228,188,40
2019,228769,10,2,223,140,83
2019,228769,10,3,142,66,76
2019,228769,10,5,170,92,78
2019,228769,10,6,328,104,224
2019,228769,20,0,451,328,123
2019,228769,20,1,228,188,40
2019,228769,20,2,223,140,83
2019,228769,30,0,142,66,76
2019,228769,30,3,142,66,76
2019,228769,40,0,498,196,302
2019,228769,40,5,170,92,78
2019,228769,40,6,328,104,224
2019,228769,42,0,170,92,78
2019,228769,42,5,170,92,78
2019,228769,43,0,328,104,224
2019,228769,43,6,328,104,224
2019,228778,0,0,2700,1544,1156
2019,228778,10,0,2700,1544,1156
2019,228778,10,1,951,691,260
2019,228778,10,2,502,286,216
2019,228778,10,3,344,176,168
2019,228778,10,4,44,20,24
2019,228778,10,5,859,371,488
2019,228778,20,0,1439,970,469
2019,228778,20,1,949,690,259
2019,228778,20,2,490,280,210
2019,228778,30,0,356,182,174
2019,228778,30,1,2,1,1
2019,228778,30,2,12,6,6
2019,228778,30,3,342,175,167
2019,228778,40,0,905,392,513
2019,228778,40,3,2,1,1
2019,228778,40,4,44,20,24
2019,228778,40,5,859,371,488
2019,228778,41,0,379,184,195
2019,228778,41,3,1,0,1
2019,228778,41,4,10,8,2
2019,228778,41,5,368,176,192
2019,228778,42,0,460,180,280
2019,228778,42,3,1,1,0
2019,228778,42,4,27,9,18
2019,228778,42,5,432,170,262
2019,228778,43,0,66,28,38
2019,228778,43,4,7,3,4
2019,228778,43,5,59,25,34
2019,228778,44,0,379,184,195
2019,228778,44,3,1,0,1
2019,228778,44,4,10,8,2
2019,228778,44,5,368,176,192
2019,228787,0,0,898,606,292
2019,228787,10,0,898,606,292
2019,228787,10,1,258,214,44
2019,228787,10,2,152,111,41
2019,228787,10,3,122,83,39
2019,228787,10,5,366,198,168
2019,228787,20,0,404,320,84
2019,228787,20,1,257,213,44
2019,228787,20,2,147,107,40
2019,228787,30,0,128,88,40
2019,228787,30,1,1,1,0
2019,228787,30,2,5,4,1
2019,228787,30,3,122,83,39
2019,228787,40,0,366,198,168
2019,228787,40,5,366,198,168
2019,228787,42,0,364,197,167
2019,228787,42,5,364,197,167
2019,228787,43,0,2,1,1
2019,228787,43,5,2,1,1
2019,228796,0,0,774,439,335
2019,228796,10,0,774,439,335
2019,228796,10,1,160,124,36
2019,228796,10,2,183,128,55
2019,228796,10,3,146,79,67
2019,228796,10,5,285,108,177
2019,228796,20,0,337,246,91
2019,228796,20,1,160,124,36
2019,228796,20,2,177,122,55
2019,228796,30,0,152,85,67
2019,228796,30,2,6,6,0
2019,228796,30,3,146,79,67
2019,228796,40,0,285,108,177
2019,228796,40,5,285,108,177
2019,228796,42,0,282,106,176
2019,228796,42,5,282,106,176
2019,228796,43,0,3,2,1
2019,228796,43,5,3,2,1
2019,228802,0,0,347,158,189
2019,228802,10,0,347,158,189
2019,228802,10,1,61,46,15
2019,228802,10,2,86,45,41
2019,228802,10,3,73,34,39
2019,228802,10,4,74,11,63
2019,228802,10,5,53,22,31
2019,228802,20,0,139,87,52
2019,228802,20,1,60,45,15
2019,228802,20,2,79,42,37
2019,228802,30,0,78,36,42
2019,228802,30,2,5,2,3
2019,228802,30,3,73,34,39
2019,228802,40,0,130,35,95
2019,228802,40,1,1,1,0
2019,228802,40,2,2,1,1
2019,228802,40,4,74,11,63
2019,228802,40,5,53,22,31
2019,228802,42,0,126,35,91
2019,228802,42,1,1,1,0
2019,228802,42,2,2,1,1
2019,228802,42,4,72,11,61
2019,228802,42,5,51,22,29
2019,228802,43,0,4,0,4
2019,228802,43,4,2,0,2
2019,228802,43,5,2,0,2
2019,228866,0,0,26,16,10
2019,228866,10,0,26,16,10
2019,228866,10,1,7,4,3
2019,228866,10,2,6,4,2
2019,228866,10,3,10,8,2
2019,228866,10,4,3,0,3
2019,228866,40,0,26,16,10
2019,228866,40,1,7,4,3
2019,228866,40,2,6,4,2
2019,228866,40,3,10,8,2
2019,228866,40,4,3,0,3
2019,228866,42,0,26,16,10
2019,228866,42,1,7,4,3
2019,228866,42,2,6,4,2
2019,228866,42,3,10,8,2
2019,228866,42,4,3,0,3
2019,228875,0,0,740,374,366
2019,228875,10,0,737,373,364
2019,228875,10,1,199,133,66
2019,228875,10,2,227,119,108
2019,228875,10,3,166,68,98
2019,228875,10,4,94,37,57
2019,228875,10,5,51,16,35
2019,228875,20,0,346,212,134
2019,228875,20,1,171,119,52
2019,228875,20,2,173,93,80
2019,228875,20,3,2,0,2
2019,228875,30,0,120,57,63
2019,228875,30,2,6,3,3
2019,228875,30,3,114,54,60
2019,228875,40,0,271,104,167
2019,228875,40,1,28,14,14
2019,228875,40,2,48,23,25
2019,228875,40,3,50,14,36
2019,228875,40,4,94,37,57
2019,228875,40,5,51,16,35
2019,228875,41,0,89,38,51
2019,228875,41,1,14,4,10
2019,228875,41,2,23,12,11
2019,228875,41,3,8,7,1
2019,228875,41,4,44,15,29
2019,228875,42,0,178,64,114
2019,228875,42,1,14,10,4
2019,228875,42,2,25,11,14
2019,228875,42,3,42,7,35
2019,228875,42,4,50,22,28
2019,228875,42,5,47,14,33
2019,228875,43,0,4,2,2
2019,228875,43,5,4,2,2
2019,228875,44,0,89,38,51
2019,228875,44,1,14,4,10
2019,228875,44,2,23,12,11
2019,228875,44,3,8,7,1
2019,228875,44,4,44,15,29
2019,228875,50,0,3,1,2
2019,228884,0,0,34,19,15
2019,228884,10,0,34,19,15
2019,228884,10,1,2,1,1
2019,228884,10,2,11,7,4
2019,228884,10,3,9,6,3
2019,228884,10,4,12,5,7
2019,228884,30,0,34,19,15
2019,228884,30,1,2,1,1
2019,228884,30,2,11,7,4
2019,228884,30,3,9,6,3
2019,228884,30,4,12,5,7
2019,228909,0,0,240,112,128
2019,228909,10,0,240,112,128
2019,228909,10,1,55,44,11
2019,228909,10,2,62,32,30
2019,228909,10,3,111,35,76
2019,228909,10,4,12,1,11
2019,228909,20,0,68,50,18
2019,228909,20,1,46,37,9
2019,228909,20,2,22,13,9
2019,228909,30,0,33,12,21
2019,228909,30,2,13,5,8
2019,228909,30,3,20,7,13
2019,228909,40,0,139,50,89
2019,228909,40,1,9,7,2
2019,228909,40,2,27,14,13
2019,228909,40,3,91,28,63
2019,228909,40,4,12,1,11
2019,228909,42,0,139,50,89
2019,228909,42,1,9,7,2
2019,228909,42,2,27,14,13
2019,228909,42,3,91,28,63
2019,228909,42,4,12,1,11
2019,228981,0,0,85,38,47
2019,228981,10,0,85,38,47
2019,228981,10,1,25,14,11
2019,228981,10,2,26,11,15
2019,228981,10,3,25,12,13
2019,228981,10,4,3,0,3
2019,228981,10,5,6,1,5
2019,228981,20,0,45,24,21
2019,228981,20,1,25,14,11
2019,228981,20,2,19,9,10
2019,228981,20,3,1,1,0
2019,228981,30,0,27,9,18
2019,228981,30,2,7,2,5
2019,228981,30,3,17,7,10
2019,228981,30,4,3,0,3
2019,228981,40,0,13,5,8
2019,228981,40,3,7,4,3
2019,228981,40,5,6,1,5
2019,228981,42,0,13,5,8
2019,228981,42,3,7,4,3
2019,228981,42,5,6,1,5
2019,229018,0,0,173,103,70
2019,229018,10,0,173,103,70
2019,229018,10,1,35,26,9
2019,229018,10,2,39,27,12
2019,229018,10,3,38,22,16
2019,229018,10,5,61,28,33
2019,229018,20,0,69,49,20
2019,229018,20,1,34,25,9
2019,229018,20,2,35,24,11
2019,229018,30,0,43,26,17
2019,229018,30,1,1,1,0
2019,229018,30,2,4,3,1
2019,229018,30,3,38,22,16
2019,229018,40,0,61,28,33
2019,229018,40,5,61,28,33
2019,229018,42,0,61,28,33
2019,229018,42,5,61,28,33
2019,229027,0,0,959,574,385
2019,229027,10,0,959,574,385
2019,229027,10,1,249,191,58
2019,229027,10,2,223,143,80
2019,229027,10,3,209,113,96
2019,229027,10,4,1,1,0
2019,229027,10,5,272,124,148
2019,229027,10,6,5,2,3
2019,229027,20,0,435,306,129
2019,229027,20,1,242,186,56
2019,229027,20,2,193,120,73
2019,229027,30,0,176,95,81
2019,229027,30,2,11,10,1
2019,229027,30,3,165,85,80
2019,229027,40,0,348,173,175
2019,229027,40,1,7,5,2
2019,229027,40,2,19,13,6
2019,229027,40,3,44,28,16
2019,229027,40,4,1,1,0
2019,229027,40,5,272,124,148
2019,229027,40,6,5,2,3
2019,229027,41,0,113,74,39
2019,229027,41,1,5,3,2
2019,229027,41,2,17,12,5
2019,229027,41,3,23,20,3
2019,229027,41,5,68,39,29
2019,229027,42,0,235,99,136
2019,229027,42,1,2,2,0
2019,229027,42,2,2,1,1
2019,229027,42,3,21,8,13
2019,229027,42,4,1,1,0
2019,229027,42,5,204,85,119
2019,229027,42,6,5,2,3
2019,229027,44,0,113,74,39
2019,229027,44,1,5,3,2
2019,229027,44,2,17,12,5
2019,229027,44,3,23,20,3
2019,229027,44,5,68,39,29
2019,229063,0,0,433,214,219
2019,229063,10,0,433,214,219
2019,229063,10,1,126,77,49
2019,229063,10,2,91,44,47
2019,229063,10,3,26,9,17
2019,229063,10,4,10,6,4
2019,229063,10,6,180,78,102
2019,229063,20,0,220,124,96
2019,229063,20,1,126,77,49
2019,229063,20,2,89,44,45
2019,229063,20,3,5,3,2
2019,229063,30,0,23,6,17
2019,229063,30,2,2,0,2
2019,229063,30,3,21,6,15
2019,229063,40,0,190,84,106
2019,229063,40,4,10,6,4
2019,229063,40,6,180,78,102
2019,229063,42,0,184,83,101
2019,229063,42,4,10,6,4
2019,229063,42,6,174,77,97
2019,229063,43,0,6,1,5
2019,229063,43,6,6,1,5
2019,229115,0,0,1690,1007,683
2019,229115,10,0,1690,1007,683
2019,229115,10,1,392,296,96
2019,229115,10,2,371,251,120
2019,229115,10,3,307,169,138
2019,229115,10,4,46,20,26
2019,229115,10,5,574,271,303
2019,229115,20,0,783,551,232
2019,229115,20,1,391,295,96
2019,229115,20,2,353,237,116
2019,229115,20,3,3,3,0
2019,229115,20,4,36,16,20
2019,229115,30,0,333,185,148
2019,229115,30,1,1,1,0
2019,229115,30,2,18,14,4
2019,229115,30,3,304,166,138
2019,229115,30,4,10,4,6
2019,229115,40,0,574,271,303
2019,229115,40,5,574,271,303
2019,229115,42,0,234,129,105
2019,229115,42,5,234,129,105
2019,229115,43,0,340,142,198
2019,229115,43,5,340,142,198
2019,229160,0,0,119,59,60
2019,229160,10,0,119,59,60
2019,229160,10,1,30,19,11
2019,229160,10,2,48,19,29
2019,229160,10,3,33,17,16
2019,229160,10,4,8,4,4
2019,229160,20,0,74,38,36
2019,229160,20,1,29,18,11
2019,229160,20,2,43,19,24
2019,229160,20,3,2,1,1
2019,229160,30,0,26,11,15
2019,229160,30,2,3,0,3
2019,229160,30,3,21,10,11
2019,229160,30,4,2,1,1
2019,229160,40,0,19,10,9
2019,229160,40,1,1,1,0
2019,229160,40,2,2,0,2
2019,229160,40,3,10,6,4
2019,229160,40,4,6,3,3
2019,229160,42,0,11,5,6
2019,229160,42,1,1,1,0
2019,229160,42,2,2,0,2
2019,229160,42,3,8,4,4
2019,229160,43,0,8,5,3
2019,229160,43,3,2,2,0
2019,229160,43,4,6,3,3
2019,229179,0,0,457,113,344
2019,229179,10,0,457,113,344
2019,229179,10,1,131,38,93
2019,229179,10,2,147,32,115
2019,229179,10,3,156,37,119
2019,229179,10,4,4,0,4
2019,229179,10,5,19,6,13
2019,229179,20,0,216,64,152
2019,229179,20,1,117,36,81
2019,229179,20,2,96,28,68
2019,229179,20,3,3,0,3
2019,229179,30,0,112,32,80
2019,229179,30,1,2,0,2
2019,229179,30,2,12,1,11
2019,229179,30,3,98,31,67
2019,229179,40,0,129,17,112
2019,229179,40,1,12,2,10
2019,229179,40,2,39,3,36
2019,229179,40,3,55,6,49
2019,229179,40,4,4,0,4
2019,229179,40,5,19,6,13
2019,229179,42,0,129,17,112
2019,229179,42,1,12,2,10
2019,229179,42,2,39,3,36
2019,229179,42,3,55,6,49
2019,229179,42,4,4,0,4
2019,229179,42,5,19,6,13
2019,229267,0,0,263,148,115
2019,229267,10,0,263,148,115
2019,229267,10,1,92,55,37
2019,229267,10,2,86,53,33
2019,229267,10,3,70,36,34
2019,229267,10,4,6,2,4
2019,229267,10,5,9,2,7
2019,229267,20,0,171,102,69
2019,229267,20,1,88,51,37
2019,229267,20,2,83,51,32
2019,229267,30,0,50,24,26
2019,229267,30,3,50,24,26
2019,229267,40,0,42,22,20
2019,229267,40,1,4,4,0
2019,229267,40,2,3,2,1
2019,229267,40,3,20,12,8
2019,229267,40,4,6,2,4
2019,229267,40,5,9,2,7
2019,229267,42,0,42,22,20
2019,229267,42,1,4,4,0
2019,229267,42,2,3,2,1
2019,229267,42,3,20,12,8
2019,229267,42,4,6,2,4
2019,229267,42,5,9,2,7
2019,229300,0,0,1761,933,828
2019,229300,10,0,1750,932,818
2019,229300,10,1,316,211,105
2019,229300,10,2,401,214,187
2019,229300,10,3,954,482,472
2019,229300,10,4,68,24,44
2019,229300,10,6,11,1,10
2019,229300,20,0,253,164,89
2019,229300,20,1,175,119,56
2019,229300,20,2,78,45,33
2019,229300,30,0,142,85,57
2019,229300,30,1,14,12,2
2019,229300,30,2,36,17,19
2019,229300,30,3,92,56,36
2019,229300,40,0,1355,683,672
2019,229300,40,1,127,80,47
2019,229300,40,2,287,152,135
2019,229300,40,3,862,426,436
2019,229300,40,4,68,24,44
2019,229300,40,6,11,1,10
2019,229300,42,0,1355,683,672
2019,229300,42,1,127,80,47
2019,229300,42,2,287,152,135
2019,229300,42,3,862,426,436
2019,229300,42,4,68,24,44
2019,229300,42,6,11,1,10
2019,229300,50,0,11,1,10
2019,229337,0,0,746,352,394
2019,229337,10,0,746,352,394
2019,229337,10,1,162,107,55
2019,229337,10,2,216,108,108
2019,229337,10,3,293,117,176
2019,229337,10,4,41,7,34
2019,229337,10,6,34,13,21
2019,229337,20,0,142,91,51
2019,229337,20,1,99,71,28
2019,229337,20,2,43,20,23
2019,229337,30,0,58,38,20
2019,229337,30,1,3,3,0
2019,229337,30,2,15,10,5
2019,229337,30,3,40,25,15
2019,229337,40,0,546,223,323
2019,229337,40,1,60,33,27
2019,229337,40,2,158,78,80
2019,229337,40,3,253,92,161
2019,229337,40,4,41,7,34
2019,229337,40,6,34,13,21
2019,229337,42,0,546,223,323
2019,229337,42,1,60,33,27
2019,229337,42,2,158,78,80
2019,229337,42,3,253,92,161
2019,229337,42,4,41,7,34
2019,229337,42,6,34,13,21
2019,229355,0,0,321,142,179
2019,229355,10,0,321,142,179
2019,229355,10,1,321,142,179
2019,229355,40,0,321,142,179
2019,229355,40,1,321,142,179
2019,229355,41,0,193,89,104
2019,229355,41,1,193,89,104
2019,229355,42,0,128,53,75
2019,229355,42,1,128,53,75
2019,229355,44,0,193,89,104
2019,229355,44,1,193,89,104
2019,229504,0,0,85,35,50
2019,229504,10,0,85,35,50
2019,229504,10,6,85,35,50
2019,229504,40,0,85,35,50
2019,229504,40,6,85,35,50
2019,229504,42,0,85,35,50
2019,229504,42,6,85,35,50
2019,229540,0,0,87,36,51
2019,229540,10,0,87,36,51
2019,229540,10,1,27,10,17
2019,229540,10,2,29,9,20
2019,229540,10,3,10,6,4
2019,229540,10,4,20,10,10
2019,229540,10,6,1,1,0
2019,229540,20,0,62,25,37
2019,229540,20,1,27,10,17
2019,229540,20,2,23,8,15
2019,229540,20,3,3,2,1
2019,229540,20,4,9,5,4
2019,229540,30,0,24,10,14
2019,229540,30,2,6,1,5
2019,229540,30,3,7,4,3
2019,229540,30,4,10,4,6
2019,229540,30,6,1,1,0
2019,229540,40,0,1,1,0
2019,229540,40,4,1,1,0
2019,229540,42,0,1,1,0
2019,229540,42,4,1,1,0
2019,229780,0,0,140,92,48
2019,229780,10,0,140,92,48
2019,229780,10,1,38,32,6
2019,229780,10,2,44,30,14
2019,229780,10,3,58,30,28
2019,229780,40,0,140,92,48
2019,229780,40,1,38,32,6
2019,229780,40,2,44,30,14
2019,229780,40,3,58,30,28
2019,229780,42,0,140,92,48
2019,229780,42,1,38,32,6
2019,229780,42,2,44,30,14
2019,229780,42,3,58,30,28
2019,229799,0,0,135,48,87
2019,229799,10,0,135,48,87
2019,229799,10,6,135,48,87
2019,229799,40,0,135,48,87
2019,229799,40,6,135,48,87
2019,229799,42,0,135,48,87
2019,229799,42,6,135,48,87
2019,229814,0,0,337,181,156
2019,229814,10,0,337,181,156
2019,229814,10,1,64,41,23
2019,229814,10,2,74,46,28
2019,229814,10,3,101,57,44
2019,229814,10,4,93,35,58
2019,229814,10,5,5,2,3
2019,229814,20,0,135,86,49
2019,229814,20,1,62,40,22
2019,229814,20,2,72,45,27
2019,229814,20,3,1,1,0
2019,229814,30,0,93,54,39
2019,229814,30,1,1,1,0
2019,229814,30,2,1,1,0
2019,229814,30,3,91,52,39
2019,229814,40,0,109,41,68
2019,229814,40,1,1,0,1
2019,229814,40,2,1,0,1
2019,229814,40,3,9,4,5
2019,229814,40,4,93,35,58
2019,229814,40,5,5,2,3
2019,229814,42,0,109,41,68
2019,229814,42,1,1,0,1
2019,229814,42,2,1,0,1
2019,229814,42,3,9,4,5
2019,229814,42,4,93,35,58
2019,229814,42,5,5,2,3
2019,229832,0,0,36,19,17
2019,229832,10,0,36,19,17
2019,229832,10,2,1,0,1
2019,229832,10,3,13,8,5
2019,229832,10,4,22,11,11
2019,229832,40,0,36,19,17
2019,229832,40,2,1,0,1
2019,229832,40,3,13,8,5
2019,229832,40,4,22,11,11
2019,229832,42,0,36,19,17
2019,229832,42,2,1,0,1
2019,229832,42,3,13,8,5
2019,229832,42,4,22,11,11
2019,229841,0,0,183,75,108
2019,229841,10,0,183,75,108
2019,229841,10,6,183,75,108
2019,229841,40,0,183,75,108
2019,229841,40,6,183,75,108
2019,229841,41,0,58,14,44
2019,229841,41,6,58,14,44
2019,229841,42,0,125,61,64
2019,229841,42,6,125,61,64
2019,229841,44,0,58,14,44
2019,229841,44,6,58,14,44
2019,229887,0,0,41,23,18
2019,229887,10,0,41,23,18
2019,229887,10,1,2,2,0
2019,229887,10,2,7,5,2
2019,229887,10,3,21,13,8
2019,229887,10,4,11,3,8
2019,229887,40,0,41,23,18
2019,229887,40,1,2,2,0
2019,229887,40,2,7,5,2
2019,229887,40,3,21,13,8
2019,229887,40,4,11,3,8
2019,229887,42,0,41,23,18
2019,229887,42,1,2,2,0
2019,229887,42,2,7,5,2
2019,229887,42,3,21,13,8
2019,229887,42,4,11,3,8
2019,230038,0,0,1268,1004,264
2019,230038,10,0,1268,1004,264
2019,230038,10,1,423,375,48
2019,230038,10,2,505,399,106
2019,230038,10,3,326,222,104
2019,230038,10,4,14,8,6
2019,230038,20,0,851,710,141
2019,230038,20,1,414,367,47
2019,230038,20,2,432,338,94
2019,230038,20,3,5,5,0
2019,230038,30,0,362,255,107
2019,230038,30,1,5,4,1
2019,230038,30,2,59,49,10
2019,230038,30,3,298,202,96
2019,230038,40,0,55,39,16
2019,230038,40,1,4,4,0
2019,230038,40,2,14,12,2
2019,230038,40,3,23,15,8
2019,230038,40,4,14,8,6
2019,230038,42,0,55,39,16
2019,230038,42,1,4,4,0
2019,230038,42,2,14,12,2
2019,230038,42,3,23,15,8
2019,230038,42,4,14,8,6
2019,230047,0,0,130,102,28
2019,230047,10,0,130,102,28
2019,230047,10,1,29,22,7
2019,230047,10,2,42,37,5
2019,230047,10,3,55,39,16
2019,230047,10,6,4,4,0
2019,230047,40,0,130,102,28
2019,230047,40,1,29,22,7
2019,230047,40,2,42,37,5
2019,230047,40,3,55,39,16
2019,230047,40,6,4,4,0
2019,230047,42,0,130,102,28
2019,230047,42,1,29,22,7
2019,230047,42,2,42,37,5
2019,230047,42,3,55,39,16
2019,230047,42,6,4,4,0
2019,230171,0,0,229,128,101
2019,230171,10,0,226,128,98
2019,230171,10,1,39,27,12
2019,230171,10,2,52,27,25
2019,230171,10,3,108,62,46
2019,230171,10,4,27,12,15
2019,230171,20,0,95,55,40
2019,230171,20,1,39,27,12
2019,230171,20,2,46,23,23
2019,230171,20,3,9,4,5
2019,230171,20,4,1,1,0
2019,230171,30,0,97,57,40
2019,230171,30,2,6,4,2
2019,230171,30,3,90,52,38
2019,230171,30,4,1,1,0
2019,230171,40,0,34,16,18
2019,230171,40,3,9,6,3
2019,230171,40,4,25,10,15
2019,230171,41,0,22,10,12
2019,230171,41,3,6,4,2
2019,230171,41,4,16,6,10
2019,230171,42,0,10,5,5
2019,230171,42,3,3,2,1
2019,230171,42,4,7,3,4
2019,230171,43,0,2,1,1
2019,230171,43,4,2,1,1
2019,230171,44,0,4,2,2
2019,230171,44,3,2,1,1
2019,230171,44,4,2,1,1
2019,230171,45,0,18,8,10
2019,230171,45,3,4,3,1
2019,230171,45,4,14,5,9
2019,230171,50,0,3,0,3
2019,230366,0,0,8,0,8
2019,230366,10,0,8,0,8
2019,230366,10,6,8,0,8
2019,230366,40,0,8,0,8
2019,230366,40,6,8,0,8
2019,230366,42,0,8,0,8
2019,230366,42,6,8,0,8
2019,230418,0,0,17,11,6
2019,230418,10,0,17,11,6
2019,230418,10,6,17,11,6
2019,230418,40,0,17,11,6
2019,230418,40,6,17,11,6
2019,230418,41,0,17,11,6
2019,230418,41,6,17,11,6
2019,230418,45,0,17,11,6
2019,230418,45,6,17,11,6
2019,230597,0,0,153,99,54
2019,230597,10,0,153,99,54
2019,230597,10,1,16,13,3
2019,230597,10,2,37,22,15
2019,230597,10,3,45,32,13
2019,230597,10,4,55,32,23
2019,230597,20,0,58,38,20
2019,230597,20,1,16,13,3
2019,230597,20,2,26,15,11
2019,230597,20,3,12,8,4
2019,230597,20,4,4,2,2
2019,230597,30,0,75,46,29
2019,230597,30,2,11,7,4
2019,230597,30,3,33,24,9
2019,230597,30,4,31,15,16
2019,230597,40,0,20,15,5
2019,230597,40,4,20,15,5
2019,230597,41,0,20,15,5
2019,230597,41,4,20,15,5
2019,230597,44,0,20,15,5
2019,230597,44,4,20,15,5
2019,230603,0,0,334,216,118
2019,230603,10,0,334,216,118
2019,230603,10,1,54,49,5
2019,230603,10,2,77,50,27
2019,230603,10,3,109,58,51
2019,230603,10,5,31,17,14
2019,230603,10,6,63,42,21
2019,230603,20,0,123,92,31
2019,230603,20,1,54,49,5
2019,230603,20,2,67,42,25
2019,230603,20,3,2,1,1
2019,230603,30,0,113,72,41
2019,230603,30,2,7,7,0
2019,230603,30,3,75,44,31
2019,230603,30,5,2,2,0
2019,230603,30,6,29,19,10
2019,230603,40,0,98,52,46
2019,230603,40,2,3,1,2
2019,230603,40,3,32,13,19
2019,230603,40,5,29,15,14
2019,230603,40,6,34,23,11
2019,230603,41,0,2,1,1
2019,230603,41,3,1,1,0
2019,230603,41,5,1,0,1
2019,230603,42,0,89,45,44
2019,230603,42,2,3,1,2
2019,230603,42,3,29,10,19
2019,230603,42,5,25,13,12
2019,230603,42,6,32,21,11
2019,230603,43,0,7,6,1
2019,230603,43,3,2,2,0
2019,230603,43,5,3,2,1
2019,230603,43,6,2,2,0
2019,230603,44,0,2,1,1
2019,230603,44,3,1,1,0
2019,230603,44,5,1,0,1
2019,230621,0,0,8,2,6
2019,230621,10,0,8,2,6
2019,230621,10,6,8,2,6
2019,230621,40,0,8,2,6
2019,230621,40,6,8,2,6
2019,230621,41,0,8,2,6
2019,230621,41,6,8,2,6
2019,230621,45,0,8,2,6
2019,230621,45,6,8,2,6
2019,230728,0,0,1010,617,393
2019,230728,10,0,1010,617,393
2019,230728,10,1,253,189,64
2019,230728,10,2,268,183,85
2019,230728,10,3,327,162,165
2019,230728,10,4,30,13,17
2019,230728,10,5,132,70,62
2019,230728,20,0,486,353,133
2019,230728,20,1,245,183,62
2019,230728,20,2,240,169,71
2019,230728,20,4,1,1,0
2019,230728,30,0,226,121,105
2019,230728,30,2,1,0,1
2019,230728,30,3,222,119,103
2019,230728,30,4,3,2,1
2019,230728,40,0,298,143,155
2019,230728,40,1,8,6,2
2019,230728,40,2,27,14,13
2019,230728,40,3,105,43,62
2019,230728,40,4,26,10,16
2019,230728,40,5,132,70,62
2019,230728,42,0,298,143,155
2019,230728,42,1,8,6,2
2019,230728,42,2,27,14,13
2019,230728,42,3,105,43,62
2019,230728,42,4,26,10,16
2019,230728,42,5,132,70,62
2019,230737,0,0,752,492,260
2019,230737,10,0,752,492,260
2019,230737,10,1,123,82,41
2019,230737,10,2,273,190,83
2019,230737,10,3,200,119,81
2019,230737,10,5,156,101,55
2019,230737,20,0,382,260,122
2019,230737,20,1,121,81,40
2019,230737,20,2,261,179,82
2019,230737,30,0,214,131,83
2019,230737,30,1,2,1,1
2019,230737,30,2,12,11,1
2019,230737,30,3,200,119,81
2019,230737,40,0,156,101,55
2019,230737,40,5,156,101,55
2019,230737,41,0,99,66,33
2019,230737,41,5,99,66,33
2019,230737,42,0,57,35,22
2019,230737,42,5,57,35,22
2019,230737,44,0,99,66,33
2019,230737,44,5,99,66,33
2019,230746,0,0,349,201,148
2019,230746,10,0,349,201,148
2019,230746,10,1,57,35,22
2019,230746,10,2,129,75,54
2019,230746,10,3,142,81,61
2019,230746,10,4,16,9,7
2019,230746,10,5,5,1,4
2019,230746,20,0,198,118,80
2019,230746,20,1,57,35,22
2019,230746,20,2,129,75,54
2019,230746,20,3,12,8,4
2019,230746,30,0,130,73,57
2019,230746,30,3,130,73,57
2019,230746,40,0,21,10,11
2019,230746,40,4,16,9,7
2019,230746,40,5,5,1,4
2019,230746,41,0,17,8,9
2019,230746,41,4,13,7,6
2019,230746,41,5,4,1,3
2019,230746,42,0,1,0,1
2019,230746,42,4,1,0,1
2019,230746,43,0,3,2,1
2019,230746,43,4,2,2,0
2019,230746,43,5,1,0,1
2019,230746,45,0,17,8,9
2019,230746,45,4,13,7,6
2019,230746,45,5,4,1,3
2019,230764,0,0,2334,1417,917
2019,230764,10,0,2224,1369,855
2019,230764,10,1,773,551,222
2019,230764,10,2,535,314,221
2019,230764,10,3,591,324,267
2019,230764,10,4,26,11,15
2019,230764,10,5,299,169,130
2019,230764,20,0,1093,750,343
2019,230764,20,1,699,510,189
2019,230764,20,2,392,239,153
2019,230764,20,3,2,1,1
2019,230764,30,0,525,311,214
2019,230764,30,1,26,16,10
2019,230764,30,2,59,32,27
2019,230764,30,3,433,257,176
2019,230764,30,4,7,6,1
2019,230764,40,0,606,308,298
2019,230764,40,1,48,25,23
2019,230764,40,2,84,43,41
2019,230764,40,3,156,66,90
2019,230764,40,4,19,5,14
2019,230764,40,5,299,169,130
2019,230764,42,0,499,254,245
2019,230764,42,1,44,25,19
2019,230764,42,2,81,41,40
2019,230764,42,3,145,62,83
2019,230764,42,4,16,4,12
2019,230764,42,5,213,122,91
2019,230764,43,0,107,54,53
2019,230764,43,1,4,0,4
2019,230764,43,2,3,2,1
2019,230764,43,3,11,4,7
2019,230764,43,4,3,1,2
2019,230764,43,5,86,47,39
2019,230764,50,0,110,48,62
2019,230782,0,0,565,308,257
2019,230782,10,0,565,308,257
2019,230782,10,1,116,84,32
2019,230782,10,2,87,48,39
2019,230782,10,3,227,119,108
2019,230782,10,4,131,54,77
2019,230782,10,5,3,2,1
2019,230782,10,6,1,1,0
2019,230782,20,0,290,176,114
2019,230782,20,1,116,84,32
2019,230782,20,2,85,47,38
2019,230782,20,3,85,43,42
2019,230782,20,4,4,2,2
2019,230782,30,0,141,73,68
2019,230782,30,2,2,1,1
2019,230782,30,3,130,67,63
2019,230782,30,4,9,5,4
2019,230782,40,0,134,59,75
2019,230782,40,3,12,9,3
2019,230782,40,4,118,47,71
2019,230782,40,5,3,2,1
2019,230782,40,6,1,1,0
2019,230782,42,0,134,59,75
2019,230782,42,3,12,9,3
2019,230782,42,4,118,47,71
2019,230782,42,5,3,2,1
2019,230782,42,6,1,1,0
2019,230807,0,0,149,75,74
2019,230807,10,0,149,75,74
2019,230807,10,1,50,24,26
2019,230807,10,2,49,28,21
2019,230807,10,3,49,23,26
2019,230807,10,4,1,0,1
2019,230807,40,0,149,75,74
2019,230807,40,1,50,24,26
2019,230807,40,2,49,28,21
2019,230807,40,3,49,23,26
2019,230807,40,4,1,0,1
2019,230807,41,0,143,73,70
2019,230807,41,1,50,24,26
2019,230807,41,2,49,28,21
2019,230807,41,3,44,21,23
2019,230807,42,0,5,2,3
2019,230807,42,3,5,2,3
2019,230807,43,0,1,0,1
2019,230807,43,4,1,0,1
2019,230807,44,0,143,73,70
2019,230807,44,1,50,24,26
2019,230807,44,2,49,28,21
2019,230807,44,3,44,21,23
2019,230816,0,0,58,28,30
2019,230816,10,0,58,28,30
2019,230816,10,6,58,28,30
2019,230816,40,0,58,28,30
2019,230816,40,6,58,28,30
2019,230816,41,0,58,28,30
2019,230816,41,6,58,28,30
2019,230816,44,0,58,28,30
2019,230816,44,6,58,28,30
2019,230834,0,0,79,39,40
2019,230834,10,0,79,39,40
2019,230834,10,1,30,16,14
2019,230834,10,2,24,14,10
2019,230834,10,3,25,9,16
2019,230834,20,0,53,29,24
2019,230834,20,1,30,16,14
2019,230834,20,2,23,13,10
2019,230834,30,0,22,9,13
2019,230834,30,2,1,1,0
2019,230834,30,3,21,8,13
2019,230834,40,0,4,1,3
2019,230834,40,3,4,1,3
2019,230834,42,0,4,1,3
2019,230834,42,3,4,1,3
2019,230852,0,0,116,71,45
2019,230852,10,0,116,71,45
2019,230852,10,1,25,16,9
2019,230852,10,2,43,22,21
2019,230852,10,3,39,26,13
2019,230852,10,4,9,7,2
2019,230852,40,0,116,71,45
2019,230852,40,1,25,16,9
2019,230852,40,2,43,22,21
2019,230852,40,3,39,26,13
2019,230852,40,4,9,7,2
2019,230852,41,0,107,64,43
2019,230852,41,1,25,16,9
2019,230852,41,2,43,22,21
2019,230852,41,3,39,26,13
2019,230852,42,0,9,7,2
2019,230852,42,4,9,7,2
2019,230852,44,0,107,64,43
2019,230852,44,1,25,16,9
2019,230852,44,2,43,22,21
2019,230852,44,3,39,26,13
2019,230889,0,0,9,4,5
2019,230889,10,0,9,4,5
2019,230889,10,6,9,4,5
2019,230889,40,0,9,4,5
2019,230889,40,6,9,4,5
2019,230889,41,0,9,4,5
2019,230889,41,6,9,4,5
2019,230889,44,0,9,4,5
2019,230889,44,6,9,4,5
2019,230913,0,0,81,47,34
2019,230913,10,0,81,47,34
2019,230913,10,1,35,21,14
2019,230913,10,2,21,15,6
2019,230913,10,3,25,11,14
2019,230913,20,0,56,35,21
2019,230913,20,1,34,20,14
2019,230913,20,2,20,15,5
2019,230913,20,3,2,0,2
2019,230913,30,0,19,11,8
2019,230913,30,2,1,0,1
2019,230913,30,3,18,11,7
2019,230913,40,0,6,1,5
2019,230913,40,1,1,1,0
2019,230913,40,3,5,0,5
2019,230913,42,0,6,1,5
2019,230913,42,1,1,1,0
2019,230913,42,3,5,0,5
2019,230940,0,0,31,15,16
2019,230940,10,0,31,15,16
2019,230940,10,1,26,11,15
2019,230940,10,6,5,4,1
2019,230940,20,0,19,9,10
2019,230940,20,1,19,9,10
2019,230940,30,0,7,2,5
2019,230940,30,1,7,2,5
2019,230940,40,0,5,4,1
2019,230940,40,6,5,4,1
2019,230940,43,0,5,4,1
2019,230940,43,6,5,4,1
2019,230959,0,0,310,168,142
2019,230959,10,0,310,168,142
2019,230959,10,1,119,78,41
2019,230959,10,2,58,29,29
2019,230959,10,3,88,37,51
2019,230959,10,4,1,0,1
2019,230959,10,5,7,1,6
2019,230959,10,6,37,23,14
2019,230959,20,0,175,106,69
2019,230959,20,1,119,78,41
2019,230959,20,2,56,28,28
2019,230959,30,0,70,31,39
2019,230959,30,3,69,31,38
2019,230959,30,4,1,0,1
2019,230959,40,0,65,31,34
2019,230959,40,2,2,1,1
2019,230959,40,3,19,6,13
2019,230959,40,5,7,1,6
2019,230959,40,6,37,23,14
2019,230959,41,0,51,26,25
2019,230959,41,2,2,1,1
2019,230959,41,3,13,5,8
2019,230959,41,5,5,1,4
2019,230959,41,6,31,19,12
2019,230959,42,0,12,4,8
2019,230959,42,3,5,1,4
2019,230959,42,5,2,0,2
2019,230959,42,6,5,3,2
2019,230959,43,0,2,1,1
2019,230959,43,3,1,0,1
2019,230959,43,6,1,1,0
2019,230959,44,0,51,26,25
2019,230959,44,2,2,1,1
2019,230959,44,3,13,5,8
2019,230959,44,5,5,1,4
2019,230959,44,6,31,19,12
2019,230995,0,0,160,93,67
2019,230995,10,0,160,93,67
2019,230995,10,1,40,29,11
2019,230995,10,2,50,33,17
2019,230995,10,3,26,14,12
2019,230995,10,4,1,0,1
2019,230995,10,5,37,14,23
2019,230995,10,6,6,3,3
2019,230995,20,0,82,55,27
2019,230995,20,1,36,26,10
2019,230995,20,2,46,29,17
2019,230995,30,0,31,17,14
2019,230995,30,1,1,0,1
2019,230995,30,2,3,3,0
2019,230995,30,3,26,14,12
2019,230995,30,4,1,0,1
2019,230995,40,0,47,21,26
2019,230995,40,1,3,3,0
2019,230995,40,2,1,1,0
2019,230995,40,5,37,14,23
2019,230995,40,6,6,3,3
2019,230995,42,0,47,21,26
2019,230995,42,1,3,3,0
2019,230995,42,2,1,1,0
2019,230995,42,5,37,14,23
2019,230995,42,6,6,3,3
2019,231059,0,0,126,68,58
2019,231059,10,0,126,68,58
2019,231059,10,1,45,30,15
2019,231059,10,2,43,24,19
2019,231059,10,3,14,4,10
2019,231059,10,4,24,10,14
2019,231059,20,0,88,54,34
2019,231059,20,1,45,30,15
2019,231059,20,2,43,24,19
2019,231059,30,0,13,4,9
2019,231059,30,3,13,4,9
2019,231059,40,0,25,10,15
2019,231059,40,3,1,0,1
2019,231059,40,4,24,10,14
2019,231059,41,0,1,1,0
2019,231059,41,4,1,1,0
2019,231059,42,0,23,9,14
2019,231059,42,4,23,9,14
2019,231059,43,0,1,0,1
2019,231059,43,3,1,0,1
2019,231059,44,0,1,1,0
2019,231059,44,4,1,1,0
2019,231068,0,0,11,5,6
2019,231068,10,0,11,5,6
2019,231068,10,1,1,0,1
2019,231068,10,2,5,3,2
2019,231068,10,3,2,1,1
2019,231068,10,6,3,1,2
2019,231068,40,0,11,5,6
2019,231068,40,1,1,0,1
2019,231068,40,2,5,3,2
2019,231068,40,3,2,1,1
2019,231068,40,6,3,1,2
2019,231068,41,0,8,4,4
2019,231068,41,1,1,0,1
2019,231068,41,2,5,3,2
2019,231068,41,3,2,1,1
2019,231068,43,0,3,1,2
2019,231068,43,6,3,1,2
2019,231068,45,0,8,4,4
2019,231068,45,1,1,0,1
2019,231068,45,2,5,3,2
2019,231068,45,3,2,1,1
2019,231095,0,0,18,10,8
2019,231095,10,0,18,10,8
2019,231095,10,4,18,10,8
2019,231095,40,0,18,10,8
2019,231095,40,4,18,10,8
2019,231095,41,0,18,10,8
2019,231095,41,4,18,10,8
2019,231095,45,0,18,10,8
2019,231095,45,4,18,10,8
2019,231147,0,0,47,20,27
2019,231147,10,0,46,19,27
2019,231147,10,1,17,10,7
2019,231147,10,2,28,8,20
2019,231147,10,6,1,1,0
2019,231147,20,0,9,4,5
2019,231147,20,1,8,3,5
2019,231147,20,6,1,1,0
2019,231147,40,0,37,15,22
2019,231147,40,1,9,7,2
2019,231147,40,2,28,8,20
2019,231147,42,0,37,15,22
2019,231147,42,1,9,7,2
2019,231147,42,2,28,8,20
2019,231147,50,0,1,1,0
2019,231165,0,0,80,40,40
2019,231165,10,0,80,40,40
2019,231165,10,1,34,23,11
2019,231165,10,2,17,6,11
2019,231165,10,3,29,11,18
2019,231165,20,0,49,27,22
2019,231165,20,1,34,23,11
2019,231165,20,2,15,4,11
2019,231165,30,0,26,11,15
2019,231165,30,2,1,1,0
2019,231165,30,3,25,10,15
2019,231165,40,0,5,2,3
2019,231165,40,2,1,1,0
2019,231165,40,3,4,1,3
2019,231165,42,0,5,2,3
2019,231165,42,2,1,1,0
2019,231165,42,3,4,1,3
2019,231174,0,0,1226,700,526
2019,231174,10,0,1226,700,526
2019,231174,10,1,325,227,98
2019,231174,10,2,321,183,138
2019,231174,10,3,388,202,186
2019,231174,10,4,17,1,16
2019,231174,10,5,152,70,82
2019,231174,10,6,23,17,6
2019,231174,20,0,447,276,171
2019,231174,20,1,248,172,76
2019,231174,20,2,199,104,95
2019,231174,30,0,89,52,37
2019,231174,30,3,89,52,37
2019,231174,40,0,690,372,318
2019,231174,40,1,77,55,22
2019,231174,40,2,122,79,43
2019,231174,40,3,299,150,149
2019,231174,40,4,17,1,16
2019,231174,40,5,152,70,82
2019,231174,40,6,23,17,6
2019,231174,42,0,690,372,318
2019,231174,42,1,77,55,22
2019,231174,42,2,122,79,43
2019,231174,42,3,299,150,149
2019,231174,42,4,17,1,16
2019,231174,42,5,152,70,82
2019,231174,42,6,23,17,6
2019,231411,0,0,23,21,2
2019,231411,10,0,23,21,2
2019,231411,10,4,23,21,2
2019,231411,40,0,23,21,2
2019,231411,40,4,23,21,2
2019,231411,41,0,23,21,2
2019,231411,41,4,23,21,2
2019,231411,45,0,23,21,2
2019,231411,45,4,23,21,2
2019,231420,0,0,53,25,28
2019,231420,10,0,53,25,28
2019,231420,10,1,13,8,5
2019,231420,10,2,21,7,14
2019,231420,10,3,16,8,8
2019,231420,10,4,3,2,1
2019,231420,20,0,28,14,14
2019,231420,20,1,12,8,4
2019,231420,20,2,14,5,9
2019,231420,20,3,2,1,1
2019,231420,30,0,20,9,11
2019,231420,30,1,1,0,1
2019,231420,30,2,5,2,3
2019,231420,30,3,13,6,7
2019,231420,30,4,1,1,0
2019,231420,40,0,5,2,3
2019,231420,40,2,2,0,2
2019,231420,40,3,1,1,0
2019,231420,40,4,2,1,1
2019,231420,41,0,5,2,3
2019,231420,41,2,2,0,2
2019,231420,41,3,1,1,0
2019,231420,41,4,2,1,1
2019,231420,44,0,5,2,3
2019,231420,44,2,2,0,2
2019,231420,44,3,1,1,0
2019,231420,44,4,2,1,1
2019,231536,0,0,66,32,34
2019,231536,10,0,66,32,34
2019,231536,10,1,10,3,7
2019,231536,10,2,19,11,8
2019,231536,10,3,20,9,11
2019,231536,10,4,13,6,7
2019,231536,10,5,4,3,1
2019,231536,40,0,66,32,34
2019,231536,40,1,10,3,7
2019,231536,40,2,19,11,8
2019,231536,40,3,20,9,11
2019,231536,40,4,13,6,7
2019,231536,40,5,4,3,1
2019,231536,42,0,66,32,34
2019,231536,42,1,10,3,7
2019,231536,42,2,19,11,8
2019,231536,42,3,20,9,11
2019,231536,42,4,13,6,7
2019,231536,42,5,4,3,1
2019,231554,0,0,45,26,19
2019,231554,10,0,45,26,19
2019,231554,10,1,12,7,5
2019,231554,10,2,9,6,3
2019,231554,10,3,23,13,10
2019,231554,10,4,1,0,1
2019,231554,40,0,45,26,19
2019,231554,40,1,12,7,5
2019,231554,40,2,9,6,3
2019,231554,40,3,23,13,10
2019,231554,40,4,1,0,1
2019,231554,42,0,45,26,19
2019,231554,42,1,12,7,5
2019,231554,42,2,9,6,3
2019,231554,42,3,23,13,10
2019,231554,42,4,1,0,1
2019,231581,0,0,116,56,60
2019,231581,10,0,116,56,60
2019,231581,10,1,14,11,3
2019,231581,10,2,47,25,22
2019,231581,10,3,29,10,19
2019,231581,10,4,26,10,16
2019,231581,20,0,55,35,20
2019,231581,20,1,14,11,3
2019,231581,20,2,39,23,16
2019,231581,20,3,1,0,1
2019,231581,20,4,1,1,0
2019,231581,30,0,35,12,23
2019,231581,30,2,8,2,6
2019,231581,30,3,26,9,17
2019,231581,30,4,1,1,0
2019,231581,40,0,26,9,17
2019,231581,40,3,2,1,1
2019,231581,40,4,24,8,16
2019,231581,42,0,26,9,17
2019,231581,42,3,2,1,1
2019,231581,42,4,24,8,16
2019,231624,0,0,716,415,301
2019,231624,10,0,716,415,301
2019,231624,10,1,260,172,88
2019,231624,10,2,190,109,81
2019,231624,10,3,164,94,70
2019,231624,10,4,23,8,15
2019,231624,10,5,79,32,47
2019,231624,20,0,416,262,154
2019,231624,20,1,249,165,84
2019,231624,20,2,167,97,70
2019,231624,30,0,112,70,42
2019,231624,30,1,1,1,0
2019,231624,30,2,5,2,3
2019,231624,30,3,106,67,39
2019,231624,40,0,188,83,105
2019,231624,40,1,10,6,4
2019,231624,40,2,18,10,8
2019,231624,40,3,58,27,31
2019,231624,40,4,23,8,15
2019,231624,40,5,79,32,47
2019,231624,41,0,88,33,55
2019,231624,41,1,2,2,0
2019,231624,41,2,7,2,5
2019,231624,41,3,16,8,8
2019,231624,41,4,3,1,2
2019,231624,41,5,60,20,40
2019,231624,42,0,89,47,42
2019,231624,42,1,8,4,4
2019,231624,42,2,10,7,3
2019,231624,42,3,40,19,21
2019,231624,42,4,12,5,7
2019,231624,42,5,19,12,7
2019,231624,43,0,11,3,8
2019,231624,43,2,1,1,0
2019,231624,43,3,2,0,2
2019,231624,43,4,8,2,6
2019,231624,44,0,41,18,23
2019,231624,44,1,1,1,0
2019,231624,44,3,14,8,6
2019,231624,44,4,1,0,1
2019,231624,44,5,25,9,16
2019,231624,45,0,47,15,32
2019,231624,45,1,1,1,0
2019,231624,45,2,7,2,5
2019,231624,45,3,2,0,2
2019,231624,45,4,2,1,1
2019,231624,45,5,35,11,24
2019,231651,0,0,138,95,43
2019,231651,10,0,138,95,43
2019,231651,10,1,45,37,8
2019,231651,10,2,42,27,15
2019,231651,10,3,34,21,13
2019,231651,10,4,4,2,2
2019,231651,10,5,13,8,5
2019,231651,20,0,70,51,19
2019,231651,20,1,40,33,7
2019,231651,20,2,30,18,12
2019,231651,30,0,40,29,11
2019,231651,30,1,2,2,0
2019,231651,30,2,8,7,1
2019,231651,30,3,30,20,10
2019,231651,40,0,28,15,13
2019,231651,40,1,3,2,1
2019,231651,40,2,4,2,2
2019,231651,40,3,4,1,3
2019,231651,40,4,4,2,2
2019,231651,40,5,13,8,5
2019,231651,41,0,6,5,1
2019,231651,41,2,2,1,1
2019,231651,41,5,4,4,0
2019,231651,42,0,22,10,12
2019,231651,42,1,3,2,1
2019,231651,42,2,2,1,1
2019,231651,42,3,4,1,3
2019,231651,42,4,4,2,2
2019,231651,42,5,9,4,5
2019,231651,44,0,6,5,1
2019,231651,44,2,2,1,1
2019,231651,44,5,4,4,0
2019,231697,0,0,59,31,28
2019,231697,10,0,59,31,28
2019,231697,10,1,20,10,10
2019,231697,10,2,16,10,6
2019,231697,10,3,13,8,5
2019,231697,10,4,9,3,6
2019,231697,10,5,1,0,1
2019,231697,40,0,59,31,28
2019,231697,40,1,20,10,10
2019,231697,40,2,16,10,6
2019,231697,40,3,13,8,5
2019,231697,40,4,9,3,6
2019,231697,40,5,1,0,1
2019,231697,42,0,59,31,28
2019,231697,42,1,20,10,10
2019,231697,42,2,16,10,6
2019,231697,42,3,13,8,5
2019,231697,42,4,9,3,6
2019,231697,42,5,1,0,1
2019,231712,0,0,289,164,125
2019,231712,10,0,287,162,125
2019,231712,10,1,49,36,13
2019,231712,10,2,88,44,44
2019,231712,10,3,76,48,28
2019,231712,10,4,18,9,9
2019,231712,10,5,56,25,31
2019,231712,20,0,137,80,57
2019,231712,20,1,49,36,13
2019,231712,20,2,88,44,44
2019,231712,30,0,73,46,27
2019,231712,30,3,73,46,27
2019,231712,40,0,77,36,41
2019,231712,40,3,3,2,1
2019,231712,40,4,18,9,9
2019,231712,40,5,56,25,31
2019,231712,41,0,39,16,23
2019,231712,41,4,8,3,5
2019,231712,41,5,31,13,18
2019,231712,42,0,38,20,18
2019,231712,42,3,3,2,1
2019,231712,42,4,10,6,4
2019,231712,42,5,25,12,13
2019,231712,44,0,39,16,23
2019,231712,44,4,8,3,5
2019,231712,44,5,31,13,18
2019,231712,50,0,2,2,0
2019,231785,0,0,39,10,29
2019,231785,10,0,39,10,29
2019,231785,10,4,39,10,29
2019,231785,40,0,39,10,29
2019,231785,40,4,39,10,29
2019,231785,41,0,39,10,29
2019,231785,41,4,39,10,29
2019,231785,45,0,39,10,29
2019,231785,45,4,39,10,29
2019,231873,0,0,17,7,10
2019,231873,10,0,17,7,10
2019,231873,10,2,7,2,5
2019,231873,10,3,4,2,2
2019,231873,10,4,6,3,3
2019,231873,40,0,17,7,10
2019,231873,40,2,7,2,5
2019,231873,40,3,4,2,2
2019,231873,40,4,6,3,3
2019,231873,42,0,17,7,10
2019,231873,42,2,7,2,5
2019,231873,42,3,4,2,2
2019,231873,42,4,6,3,3
2019,231882,0,0,46,26,20
2019,231882,10,0,46,26,20
2019,231882,10,1,7,6,1
2019,231882,10,2,16,7,9
2019,231882,10,3,11,4,7
2019,231882,10,4,12,9,3
2019,231882,40,0,46,26,20
2019,231882,40,1,7,6,1
2019,231882,40,2,16,7,9
2019,231882,40,3,11,4,7
2019,231882,40,4,12,9,3
2019,231882,42,0,46,26,20
2019,231882,42,1,7,6,1
2019,231882,42,2,16,7,9
2019,231882,42,3,11,4,7
2019,231882,42,4,12,9,3
2019,231970,0,0,251,133,118
2019,231970,10,0,251,133,118
2019,231970,10,1,68,46,22
2019,231970,10,2,71,38,33
2019,231970,10,3,92,43,49
2019,231970,10,4,20,6,14
2019,231970,20,0,17,14,3
2019,231970,20,1,16,13,3
2019,231970,20,2,1,1,0
2019,231970,30,0,79,45,34
2019,231970,30,1,45,29,16
2019,231970,30,2,34,16,18
2019,231970,40,0,155,74,81
2019,231970,40,1,7,4,3
2019,231970,40,2,36,21,15
2019,231970,40,3,92,43,49
2019,231970,40,4,20,6,14
2019,231970,41,0,155,74,81
2019,231970,41,1,7,4,3
2019,231970,41,2,36,21,15
2019,231970,41,3,92,43,49
2019,231970,41,4,20,6,14
2019,231970,44,0,155,74,81
2019,231970,44,1,7,4,3
2019,231970,44,2,36,21,15
2019,231970,44,3,92,43,49
2019,231970,44,4,20,6,14
2019,232016,0,0,2,1,1
2019,232016,50,0,2,1,1
2019,232025,0,0,98,41,57
2019,232025,10,0,98,41,57
2019,232025,10,1,25,17,8
2019,232025,10,2,27,11,16
2019,232025,10,3,37,12,25
2019,232025,10,4,9,1,8
2019,232025,20,0,41,22,19
2019,232025,20,1,21,14,7
2019,232025,20,2,19,7,12
2019,232025,20,3,1,1,0
2019,232025,30,0,23,7,16
2019,232025,30,1,3,2,1
2019,232025,30,2,5,2,3
2019,232025,30,3,15,3,12
2019,232025,40,0,34,12,22
2019,232025,40,1,1,1,0
2019,232025,40,2,3,2,1
2019,232025,40,3,21,8,13
2019,232025,40,4,9,1,8
2019,232025,41,0,6,4,2
2019,232025,41,3,5,4,1
2019,232025,41,4,1,0,1
2019,232025,42,0,28,8,20
2019,232025,42,1,1,1,0
2019,232025,42,2,3,2,1
2019,232025,42,3,16,4,12
2019,232025,42,4,8,1,7
2019,232025,44,0,6,4,2
2019,232025,44,3,5,4,1
2019,232025,44,4,1,0,1
2019,232043,0,0,89,41,48
2019,232043,10,0,89,41,48
2019,232043,10,1,19,10,9
2019,232043,10,2,18,9,9
2019,232043,10,3,37,16,21
2019,232043,10,4,13,4,9
2019,232043,10,5,2,2,0
2019,232043,20,0,34,18,16
2019,232043,20,1,17,9,8
2019,232043,20,2,17,9,8
2019,232043,30,0,26,13,13
2019,232043,30,2,1,0,1
2019,232043,30,3,25,13,12
2019,232043,40,0,29,10,19
2019,232043,40,1,2,1,1
2019,232043,40,3,12,3,9
2019,232043,40,4,13,4,9
2019,232043,40,5,2,2,0
2019,232043,41,0,6,2,4
2019,232043,41,1,1,1,0
2019,232043,41,3,4,0,4
2019,232043,41,4,1,1,0
2019,232043,42,0,23,8,15
2019,232043,42,1,1,0,1
2019,232043,42,3,8,3,5
2019,232043,42,4,12,3,9
2019,232043,42,5,2,2,0
2019,232043,44,0,6,2,4
2019,232043,44,1,1,1,0
2019,232043,44,3,4,0,4
2019,232043,44,4,1,1,0
2019,232052,0,0,15,7,8
2019,232052,10,0,15,7,8
2019,232052,10,1,1,0,1
2019,232052,10,2,5,2,3
2019,232052,10,3,5,3,2
2019,232052,10,4,4,2,2
2019,232052,40,0,15,7,8
2019,232052,40,1,1,0,1
2019,232052,40,2,5,2,3
2019,232052,40,3,5,3,2
2019,232052,40,4,4,2,2
2019,232052,42,0,15,7,8
2019,232052,42,1,1,0,1
2019,232052,42,2,5,2,3
2019,232052,42,3,5,3,2
2019,232052,42,4,4,2,2
2019,232089,0,0,58,28,30
2019,232089,10,0,58,28,30
2019,232089,10,1,7,2,5
2019,232089,10,2,24,13,11
2019,232089,10,3,23,11,12
2019,232089,10,4,4,2,2
2019,232089,20,0,33,16,17
2019,232089,20,1,7,2,5
2019,232089,20,2,24,13,11
2019,232089,20,3,2,1,1
2019,232089,30,0,11,7,4
2019,232089,30,3,11,7,4
2019,232089,40,0,14,5,9
2019,232089,40,3,10,3,7
2019,232089,40,4,4,2,2
2019,232089,42,0,14,5,9
2019,232089,42,3,10,3,7
2019,232089,42,4,4,2,2
2019,232186,0,0,1397,773,624
2019,232186,10,0,1397,773,624
2019,232186,10,1,386,270,116
2019,232186,10,2,459,248,211
2019,232186,10,3,446,208,238
2019,232186,10,4,106,47,59
2019,232186,20,0,685,444,241
2019,232186,20,1,347,251,96
2019,232186,20,2,338,193,145
2019,232186,30,0,228,126,102
2019,232186,30,1,1,1,0
2019,232186,30,2,10,5,5
2019,232186,30,3,217,120,97
2019,232186,40,0,484,203,281
2019,232186,40,1,38,18,20
2019,232186,40,2,111,50,61
2019,232186,40,3,229,88,141
2019,232186,40,4,106,47,59
2019,232186,41,0,258,115,143
2019,232186,41,1,32,16,16
2019,232186,41,2,93,44,49
2019,232186,41,3,98,41,57
2019,232186,41,4,35,14,21
2019,232186,42,0,222,86,136
2019,232186,42,1,5,2,3
2019,232186,42,2,17,5,12
2019,232186,42,3,130,47,83
2019,232186,42,4,70,32,38
2019,232186,43,0,4,2,2
2019,232186,43,1,1,0,1
2019,232186,43,2,1,1,0
2019,232186,43,3,1,0,1
2019,232186,43,4,1,1,0
2019,232186,44,0,258,115,143
2019,232186,44,1,32,16,16
2019,232186,44,2,93,44,49
2019,232186,44,3,98,41,57
2019,232186,44,4,35,14,21
2019,232195,0,0,92,27,65
2019,232195,10,0,92,27,65
2019,232195,10,1,11,2,9
2019,232195,10,2,19,4,15
2019,232195,10,3,37,15,22
2019,232195,10,4,23,6,17
2019,232195,10,5,2,0,2
2019,232195,40,0,92,27,65
2019,232195,40,1,11,2,9
2019,232195,40,2,19,4,15
2019,232195,40,3,37,15,22
2019,232195,40,4,23,6,17
2019,232195,40,5,2,0,2
2019,232195,42,0,92,27,65
2019,232195,42,1,11,2,9
2019,232195,42,2,19,4,15
2019,232195,42,3,37,15,22
2019,232195,42,4,23,6,17
2019,232195,42,5,2,0,2
2019,232256,0,0,103,70,33
2019,232256,10,0,103,70,33
2019,232256,10,1,34,27,7
2019,232256,10,2,25,16,9
2019,232256,10,3,23,13,10
2019,232256,10,5,21,14,7
2019,232256,20,0,59,43,16
2019,232256,20,1,34,27,7
2019,232256,20,2,25,16,9
2019,232256,30,0,23,13,10
2019,232256,30,3,23,13,10
2019,232256,40,0,21,14,7
2019,232256,40,5,21,14,7
2019,232256,42,0,21,14,7
2019,232256,42,5,21,14,7
2019,232265,0,0,269,139,130
2019,232265,10,0,252,131,121
2019,232265,10,1,35,24,11
2019,232265,10,2,61,27,34
2019,232265,10,3,121,66,55
2019,232265,10,4,17,7,10
2019,232265,10,5,3,1,2
2019,232265,10,6,15,6,9
2019,232265,20,0,60,34,26
2019,232265,20,1,32,21,11
2019,232265,20,2,25,10,15
2019,232265,20,3,3,3,0
2019,232265,30,0,36,13,23
2019,232265,30,1,1,1,0
2019,232265,30,2,13,6,7
2019,232265,30,3,22,6,16
2019,232265,40,0,156,84,72
2019,232265,40,1,2,2,0
2019,232265,40,2,23,11,12
2019,232265,40,3,96,57,39
2019,232265,40,4,17,7,10
2019,232265,40,5,3,1,2
2019,232265,40,6,15,6,9
2019,232265,41,0,1,1,0
2019,232265,41,1,1,1,0
2019,232265,42,0,155,83,72
2019,232265,42,1,1,1,0
2019,232265,42,2,23,11,12
2019,232265,42,3,96,57,39
2019,232265,42,4,17,7,10
2019,232265,42,5,3,1,2
2019,232265,42,6,15,6,9
2019,232265,44,0,1,1,0
2019,232265,44,1,1,1,0
2019,232265,50,0,17,8,9
2019,232308,0,0,85,36,49
2019,232308,10,0,83,36,47
2019,232308,10,1,23,8,15
2019,232308,10,2,24,12,12
2019,232308,10,3,26,11,15
2019,232308,10,4,8,4,4
2019,232308,10,5,1,0,1
2019,232308,10,6,1,1,0
2019,232308,20,0,41,17,24
2019,232308,20,1,21,8,13
2019,232308,20,2,20,9,11
2019,232308,30,0,11,4,7
2019,232308,30,2,2,1,1
2019,232308,30,3,9,3,6
2019,232308,40,0,31,15,16
2019,232308,40,1,2,0,2
2019,232308,40,2,2,2,0
2019,232308,40,3,17,8,9
2019,232308,40,4,8,4,4
2019,232308,40,5,1,0,1
2019,232308,40,6,1,1,0
2019,232308,41,0,13,4,9
2019,232308,41,1,2,0,2
2019,232308,41,2,1,1,0
2019,232308,41,3,9,2,7
2019,232308,41,4,1,1,0
2019,232308,42,0,18,11,7
2019,232308,42,2,1,1,0
2019,232308,42,3,8,6,2
2019,232308,42,4,7,3,4
2019,232308,42,5,1,0,1
2019,232308,42,6,1,1,0
2019,232308,44,0,13,4,9
2019,232308,44,1,2,0,2
2019,232308,44,2,1,1,0
2019,232308,44,3,9,2,7
2019,232308,44,4,1,1,0
2019,232308,50,0,2,0,2
2019,232414,0,0,116,51,65
2019,232414,10,0,116,51,65
2019,232414,10,1,29,14,15
2019,232414,10,2,40,18,22
2019,232414,10,3,30,9,21
2019,232414,10,4,17,10,7
2019,232414,40,0,116,51,65
2019,232414,40,1,29,14,15
2019,232414,40,2,40,18,22
2019,232414,40,3,30,9,21
2019,232414,40,4,17,10,7
2019,232414,42,0,116,51,65
2019,232414,42,1,29,14,15
2019,232414,42,2,40,18,22
2019,232414,42,3,30,9,21
2019,232414,42,4,17,10,7
2019,232423,0,0,1070,531,539
2019,232423,10,0,1070,531,539
2019,232423,10,1,359,213,146
2019,232423,10,2,290,150,140
2019,232423,10,3,256,106,150
2019,232423,10,4,165,62,103
2019,232423,20,0,624,347,277
2019,232423,20,1,357,211,146
2019,232423,20,2,267,136,131
2019,232423,30,0,202,90,112
2019,232423,30,2,7,4,3
2019,232423,30,3,194,86,108
2019,232423,30,4,1,0,1
2019,232423,40,0,244,94,150
2019,232423,40,1,2,2,0
2019,232423,40,2,16,10,6
2019,232423,40,3,62,20,42
2019,232423,40,4,164,62,102
2019,232423,42,0,244,94,150
2019,232423,42,1,2,2,0
2019,232423,42,2,16,10,6
2019,232423,42,3,62,20,42
2019,232423,42,4,164,62,102
2019,232450,0,0,114,46,68
2019,232450,10,0,114,46,68
2019,232450,10,1,26,11,15
2019,232450,10,2,29,8,21
2019,232450,10,3,24,7,17
2019,232450,10,4,34,19,15
2019,232450,10,5,1,1,0
2019,232450,40,0,114,46,68
2019,232450,40,1,26,11,15
2019,232450,40,2,29,8,21
2019,232450,40,3,24,7,17
2019,232450,40,4,34,19,15
2019,232450,40,5,1,1,0
2019,232450,42,0,114,46,68
2019,232450,42,1,26,11,15
2019,232450,42,2,29,8,21
2019,232450,42,3,24,7,17
2019,232450,42,4,34,19,15
2019,232450,42,5,1,1,0
2019,232557,0,0,1072,649,423
2019,232557,10,0,1072,649,423
2019,232557,10,1,193,156,37
2019,232557,10,2,200,127,73
2019,232557,10,3,652,351,301
2019,232557,10,4,27,15,12
2019,232557,20,0,12,10,2
2019,232557,20,1,12,10,2
2019,232557,30,0,2,2,0
2019,232557,30,1,1,1,0
2019,232557,30,2,1,1,0
2019,232557,40,0,1058,637,421
2019,232557,40,1,180,145,35
2019,232557,40,2,199,126,73
2019,232557,40,3,652,351,301
2019,232557,40,4,27,15,12
2019,232557,42,0,1058,637,421
2019,232557,42,1,180,145,35
2019,232557,42,2,199,126,73
2019,232557,42,3,652,351,301
2019,232557,42,4,27,15,12
2019,232566,0,0,267,129,138
2019,232566,10,0,262,129,133
2019,232566,10,1,52,30,22
2019,232566,10,2,78,40,38
2019,232566,10,3,95,41,54
2019,232566,10,4,1,1,0
2019,232566,10,5,36,17,19
2019,232566,20,0,128,69,59
2019,232566,20,1,51,30,21
2019,232566,20,2,77,39,38
2019,232566,30,0,94,40,54
2019,232566,30,1,1,0,1
2019,232566,30,2,1,1,0
2019,232566,30,3,91,38,53
2019,232566,30,4,1,1,0
2019,232566,40,0,40,20,20
2019,232566,40,3,4,3,1
2019,232566,40,5,36,17,19
2019,232566,41,0,6,1,5
2019,232566,41,5,6,1,5
2019,232566,42,0,34,19,15
2019,232566,42,3,4,3,1
2019,232566,42,5,30,16,14
2019,232566,44,0,6,1,5
2019,232566,44,5,6,1,5
2019,232566,50,0,5,0,5
2019,232575,0,0,71,25,46
2019,232575,10,0,71,25,46
2019,232575,10,1,17,6,11
2019,232575,10,2,24,9,15
2019,232575,10,3,22,6,16
2019,232575,10,4,8,4,4
2019,232575,40,0,71,25,46
2019,232575,40,1,17,6,11
2019,232575,40,2,24,9,15
2019,232575,40,3,22,6,16
2019,232575,40,4,8,4,4
2019,232575,42,0,71,25,46
2019,232575,42,1,17,6,11
2019,232575,42,2,24,9,15
2019,232575,42,3,22,6,16
2019,232575,42,4,8,4,4
2019,232609,0,0,186,87,99
2019,232609,10,0,186,87,99
2019,232609,10,1,48,30,18
2019,232609,10,2,54,22,32
2019,232609,10,3,77,31,46
2019,232609,10,4,7,4,3
2019,232609,20,0,92,46,46
2019,232609,20,1,46,28,18
2019,232609,20,2,45,17,28
2019,232609,20,3,1,1,0
2019,232609,30,0,38,19,19
2019,232609,30,2,2,2,0
2019,232609,30,3,36,17,19
2019,232609,40,0,56,22,34
2019,232609,40,1,2,2,0
2019,232609,40,2,7,3,4
2019,232609,40,3,40,13,27
2019,232609,40,4,7,4,3
2019,232609,42,0,56,22,34
2019,232609,42,1,2,2,0
2019,232609,42,2,7,3,4
2019,232609,42,3,40,13,27
2019,232609,42,4,7,4,3
2019,232618,0,0,30,0,30
2019,232618,10,0,30,0,30
2019,232618,10,4,30,0,30
2019,232618,40,0,30,0,30
2019,232618,40,4,30,0,30
2019,232618,42,0,8,0,8
2019,232618,42,4,8,0,8
2019,232618,43,0,22,0,22
2019,232618,43,4,22,0,22
2019,232672,0,0,97,27,70
2019,232672,10,0,97,27,70
2019,232672,10,1,17,4,13
2019,232672,10,2,32,10,22
2019,232672,10,3,44,12,32
2019,232672,10,4,4,1,3
2019,232672,20,0,36,11,25
2019,232672,20,1,16,4,12
2019,232672,20,2,19,6,13
2019,232672,20,3,1,1,0
2019,232672,30,0,6,0,6
2019,232672,30,2,1,0,1
2019,232672,30,3,5,0,5
2019,232672,40,0,55,16,39
2019,232672,40,1,1,0,1
2019,232672,40,2,12,4,8
2019,232672,40,3,38,11,27
2019,232672,40,4,4,1,3
2019,232672,41,0,55,16,39
2019,232672,41,1,1,0,1
2019,232672,41,2,12,4,8
2019,232672,41,3,38,11,27
2019,232672,41,4,4,1,3
2019,232672,44,0,55,16,39
2019,232672,44,1,1,0,1
2019,232672,44,2,12,4,8
2019,232672,44,3,38,11,27
2019,232672,44,4,4,1,3
2019,232681,0,0,255,127,128
2019,232681,10,0,255,127,128
2019,232681,10,1,90,46,44
2019,232681,10,2,80,43,37
2019,232681,10,3,52,18,34
2019,232681,10,4,5,3,2
2019,232681,10,5,28,17,11
2019,232681,20,0,169,88,81
2019,232681,20,1,90,46,44
2019,232681,20,2,79,42,37
2019,232681,30,0,47,16,31
2019,232681,30,2,1,1,0
2019,232681,30,3,46,15,31
2019,232681,40,0,39,23,16
2019,232681,40,3,6,3,3
2019,232681,40,4,5,3,2
2019,232681,40,5,28,17,11
2019,232681,43,0,39,23,16
2019,232681,43,3,6,3,3
2019,232681,43,4,5,3,2
2019,232681,43,5,28,17,11
2019,232706,0,0,165,41,124
2019,232706,10,0,165,41,124
2019,232706,10,1,46,9,37
2019,232706,10,2,46,19,27
2019,232706,10,3,47,7,40
2019,232706,10,4,25,6,19
2019,232706,10,6,1,0,1
2019,232706,20,0,85,25,60
2019,232706,20,1,45,8,37
2019,232706,20,2,40,17,23
2019,232706,30,0,51,8,43
2019,232706,30,2,5,1,4
2019,232706,30,3,46,7,39
2019,232706,40,0,29,8,21
2019,232706,40,1,1,1,0
2019,232706,40,2,1,1,0
2019,232706,40,3,1,0,1
2019,232706,40,4,25,6,19
2019,232706,40,6,1,0,1
2019,232706,42,0,29,8,21
2019,232706,42,1,1,1,0
2019,232706,42,2,1,1,0
2019,232706,42,3,1,0,1
2019,232706,42,4,25,6,19
2019,232706,42,6,1,0,1
2019,232788,0,0,42,25,17
2019,232788,10,0,42,25,17
2019,232788,10,1,6,4,2
2019,232788,10,2,11,4,7
2019,232788,10,3,13,8,5
2019,232788,10,4,12,9,3
2019,232788,40,0,42,25,17
2019,232788,40,1,6,4,2
2019,232788,40,2,11,4,7
2019,232788,40,3,13,8,5
2019,232788,40,4,12,9,3
2019,232788,42,0,42,25,17
2019,232788,42,1,6,4,2
2019,232788,42,2,11,4,7
2019,232788,42,3,13,8,5
2019,232788,42,4,12,9,3
2019,232797,0,0,14,4,10
2019,232797,50,0,14,4,10
2019,232867,0,0,48,25,23
2019,232867,10,0,48,25,23
2019,232867,10,1,19,8,11
2019,232867,10,2,9,7,2
2019,232867,10,3,13,7,6
2019,232867,10,4,7,3,4
2019,232867,40,0,48,25,23
2019,232867,40,1,19,8,11
2019,232867,40,2,9,7,2
2019,232867,40,3,13,7,6
2019,232867,40,4,7,3,4
2019,232867,42,0,48,25,23
2019,232867,42,1,19,8,11
2019,232867,42,2,9,7,2
2019,232867,42,3,13,7,6
2019,232867,42,4,7,3,4
2019,232885,0,0,34,2,32
2019,232885,10,0,34,2,32
2019,232885,10,1,3,0,3
2019,232885,10,2,10,0,10
2019,232885,10,3,16,2,14
2019,232885,10,4,4,0,4
2019,232885,10,5,1,0,1
2019,232885,40,0,34,2,32
2019,232885,40,1,3,0,3
2019,232885,40,2,10,0,10
2019,232885,40,3,16,2,14
2019,232885,40,4,4,0,4
2019,232885,40,5,1,0,1
2019,232885,42,0,34,2,32
2019,232885,42,1,3,0,3
2019,232885,42,2,10,0,10
2019,232885,42,3,16,2,14
2019,232885,42,4,4,0,4
2019,232885,42,5,1,0,1
2019,232937,0,0,248,131,117
2019,232937,10,0,248,131,117
2019,232937,10,1,73,47,26
2019,232937,10,2,68,29,39
2019,232937,10,3,83,45,38
2019,232937,10,4,24,10,14
2019,232937,20,0,110,66,44
2019,232937,20,1,55,38,17
2019,232937,20,2,21,11,10
2019,232937,20,3,34,17,17
2019,232937,30,0,24,9,15
2019,232937,30,1,9,3,6
2019,232937,30,2,14,5,9
2019,232937,30,3,1,1,0
2019,232937,40,0,114,56,58
2019,232937,40,1,9,6,3
2019,232937,40,2,33,13,20
2019,232937,40,3,48,27,21
2019,232937,40,4,24,10,14
2019,232937,42,0,21,11,10
2019,232937,42,1,2,1,1
2019,232937,42,2,4,3,1
2019,232937,42,3,7,3,4
2019,232937,42,4,8,4,4
2019,232937,43,0,93,45,48
2019,232937,43,1,7,5,2
2019,232937,43,2,29,10,19
2019,232937,43,3,41,24,17
2019,232937,43,4,16,6,10
2019,232946,0,0,639,268,371
2019,232946,10,0,639,268,371
2019,232946,10,1,179,84,95
2019,232946,10,2,209,87,122
2019,232946,10,3,143,52,91
2019,232946,10,4,98,41,57
2019,232946,10,5,10,4,6
2019,232946,40,0,639,268,371
2019,232946,40,1,179,84,95
2019,232946,40,2,209,87,122
2019,232946,40,3,143,52,91
2019,232946,40,4,98,41,57
2019,232946,40,5,10,4,6
2019,232946,42,0,639,268,371
2019,232946,42,1,179,84,95
2019,232946,42,2,209,87,122
2019,232946,42,3,143,52,91
2019,232946,42,4,98,41,57
2019,232946,42,5,10,4,6
2019,232982,0,0,868,471,397
2019,232982,10,0,868,471,397
2019,232982,10,1,208,156,52
2019,232982,10,2,218,134,84
2019,232982,10,3,200,97,103
2019,232982,10,4,8,2,6
2019,232982,10,5,234,82,152
2019,232982,20,0,410,280,130
2019,232982,20,1,205,155,50
2019,232982,20,2,205,125,80
2019,232982,30,0,184,93,91
2019,232982,30,1,1,1,0
2019,232982,30,2,10,7,3
2019,232982,30,3,172,85,87
2019,232982,30,4,1,0,1
2019,232982,40,0,274,98,176
2019,232982,40,1,2,0,2
2019,232982,40,2,3,2,1
2019,232982,40,3,28,12,16
2019,232982,40,4,7,2,5
2019,232982,40,5,234,82,152
2019,232982,42,0,274,98,176
2019,232982,42,1,2,0,2
2019,232982,42,2,3,2,1
2019,232982,42,3,28,12,16
2019,232982,42,4,7,2,5
2019,232982,42,5,234,82,152
2019,233019,0,0,45,22,23
2019,233019,10,0,45,22,23
2019,233019,10,1,5,3,2
2019,233019,10,2,16,4,12
2019,233019,10,3,11,6,5
2019,233019,10,4,13,9,4
2019,233019,40,0,45,22,23
2019,233019,40,1,5,3,2
2019,233019,40,2,16,4,12
2019,233019,40,3,11,6,5
2019,233019,40,4,13,9,4
2019,233019,41,0,31,13,18
2019,233019,41,1,4,3,1
2019,233019,41,2,15,4,11
2019,233019,41,3,8,4,4
2019,233019,41,4,4,2,2
2019,233019,42,0,14,9,5
2019,233019,42,1,1,0,1
2019,233019,42,2,1,0,1
2019,233019,42,3,3,2,1
2019,233019,42,4,9,7,2
2019,233019,44,0,31,13,18
2019,233019,44,1,4,3,1
2019,233019,44,2,15,4,11
2019,233019,44,3,8,4,4
2019,233019,44,4,4,2,2
2019,233037,0,0,19,6,13
2019,233037,10,0,19,6,13
2019,233037,10,2,7,4,3
2019,233037,10,3,8,1,7
2019,233037,10,4,4,1,3
2019,233037,40,0,19,6,13
2019,233037,40,2,7,4,3
2019,233037,40,3,8,1,7
2019,233037,40,4,4,1,3
2019,233037,42,0,19,6,13
2019,233037,42,2,7,4,3
2019,233037,42,3,8,1,7
2019,233037,42,4,4,1,3
2019,233082,0,0,11,0,11
2019,233082,10,0,11,0,11
2019,233082,10,2,6,0,6
2019,233082,10,4,5,0,5
2019,233082,40,0,11,0,11
2019,233082,40,2,6,0,6
2019,233082,40,4,5,0,5
2019,233082,41,0,11,0,11
2019,233082,41,2,6,0,6
2019,233082,41,4,5,0,5
2019,233082,45,0,11,0,11
2019,233082,45,2,6,0,6
2019,233082,45,4,5,0,5
2019,233116,0,0,75,32,43
2019,233116,10,0,75,32,43
2019,233116,10,1,20,9,11
2019,233116,10,2,31,13,18
2019,233116,10,3,12,4,8
2019,233116,10,4,12,6,6
2019,233116,40,0,75,32,43
2019,233116,40,1,20,9,11
2019,233116,40,2,31,13,18
2019,233116,40,3,12,4,8
2019,233116,40,4,12,6,6
2019,233116,42,0,75,32,43
2019,233116,42,1,20,9,11
2019,233116,42,2,31,13,18
2019,233116,42,3,12,4,8
2019,233116,42,4,12,6,6
2019,233277,0,0,535,238,297
2019,233277,10,0,535,238,297
2019,233277,10,1,171,95,76
2019,233277,10,2,123,61,62
2019,233277,10,3,160,54,106
2019,233277,10,4,81,28,53
2019,233277,20,0,272,145,127
2019,233277,20,1,166,93,73
2019,233277,20,2,103,49,54
2019,233277,20,3,3,3,0
2019,233277,30,0,127,48,79
2019,233277,30,1,3,1,2
2019,233277,30,2,14,7,7
2019,233277,30,3,104,39,65
2019,233277,30,4,6,1,5
2019,233277,40,0,136,45,91
2019,233277,40,1,2,1,1
2019,233277,40,2,6,5,1
2019,233277,40,3,53,12,41
2019,233277,40,4,75,27,48
2019,233277,42,0,136,45,91
2019,233277,42,1,2,1,1
2019,233277,42,2,6,5,1
2019,233277,42,3,53,12,41
2019,233277,42,4,75,27,48
2019,233295,0,0,110,50,60
2019,233295,10,0,110,50,60
2019,233295,10,1,47,29,18
2019,233295,10,2,27,11,16
2019,233295,10,3,22,8,14
2019,233295,10,4,14,2,12
2019,233295,20,0,71,40,31
2019,233295,20,1,46,29,17
2019,233295,20,2,25,11,14
2019,233295,30,0,25,8,17
2019,233295,30,1,1,0,1
2019,233295,30,2,2,0,2
2019,233295,30,3,22,8,14
2019,233295,40,0,14,2,12
2019,233295,40,4,14,2,12
2019,233295,42,0,14,2,12
2019,233295,42,4,14,2,12
2019,233301,0,0,69,27,42
2019,233301,10,0,69,27,42
2019,233301,10,1,31,14,17
2019,233301,10,2,16,7,9
2019,233301,10,3,19,6,13
2019,233301,10,4,3,0,3
2019,233301,20,0,46,21,25
2019,233301,20,1,31,14,17
2019,233301,20,2,15,7,8
2019,233301,30,0,19,6,13
2019,233301,30,3,19,6,13
2019,233301,40,0,4,0,4
2019,233301,40,2,1,0,1
2019,233301,40,4,3,0,3
2019,233301,41,0,4,0,4
2019,233301,41,2,1,0,1
2019,233301,41,4,3,0,3
2019,233301,44,0,4,0,4
2019,233301,44,2,1,0,1
2019,233301,44,4,3,0,3
2019,233310,0,0,29,8,21
2019,233310,10,0,29,8,21
2019,233310,10,1,5,3,2
2019,233310,10,2,9,2,7
2019,233310,10,3,10,3,7
2019,233310,10,4,5,0,5
2019,233310,40,0,29,8,21
2019,233310,40,1,5,3,2
2019,233310,40,2,9,2,7
2019,233310,40,3,10,3,7
2019,233310,40,4,5,0,5
2019,233310,42,0,29,8,21
2019,233310,42,1,5,3,2
2019,233310,42,2,9,2,7
2019,233310,42,3,10,3,7
2019,233310,42,4,5,0,5
2019,233329,0,0,6,0,6
2019,233329,10,0,6,0,6
2019,233329,10,4,6,0,6
2019,233329,40,0,6,0,6
2019,233329,40,4,6,0,6
2019,233329,41,0,6,0,6
2019,233329,41,4,6,0,6
2019,233329,45,0,6,0,6
2019,233329,45,4,6,0,6
2019,233338,0,0,36,16,20
2019,233338,10,0,36,16,20
2019,233338,10,1,10,4,6
2019,233338,10,2,7,4,3
2019,233338,10,3,14,6,8
2019,233338,10,4,5,2,3
2019,233338,20,0,14,5,9
2019,233338,20,1,9,3,6
2019,233338,20,2,5,2,3
2019,233338,40,0,22,11,11
2019,233338,40,1,1,1,0
2019,233338,40,2,2,2,0
2019,233338,40,3,14,6,8
2019,233338,40,4,5,2,3
2019,233338,42,0,22,11,11
2019,233338,42,1,1,1,0
2019,233338,42,2,2,2,0
2019,233338,42,3,14,6,8
2019,233338,42,4,5,2,3
2019,233356,0,0,29,2,27
2019,233356,10,0,29,2,27
2019,233356,10,1,1,0,1
2019,233356,10,2,2,1,1
2019,233356,10,3,18,0,18
2019,233356,10,4,8,1,7
2019,233356,40,0,29,2,27
2019,233356,40,1,1,0,1
2019,233356,40,2,2,1,1
2019,233356,40,3,18,0,18
2019,233356,40,4,8,1,7
2019,233356,41,0,1,0,1
2019,233356,41,4,1,0,1
2019,233356,43,0,28,2,26
2019,233356,43,1,1,0,1
2019,233356,43,2,2,1,1
2019,233356,43,3,18,0,18
2019,233356,43,4,7,1,6
2019,233356,45,0,1,0,1
2019,233356,45,4,1,0,1
2019,233374,0,0,419,230,189
2019,233374,10,0,419,230,189
2019,233374,10,1,126,81,45
2019,233374,10,2,133,70,63
2019,233374,10,3,71,37,34
2019,233374,10,4,1,0,1
2019,233374,10,6,88,42,46
2019,233374,20,0,238,143,95
2019,233374,20,1,111,75,36
2019,233374,20,2,126,68,58
2019,233374,20,3,1,0,1
2019,233374,30,0,72,37,35
2019,233374,30,2,3,1,2
2019,233374,30,3,66,34,32
2019,233374,30,6,3,2,1
2019,233374,40,0,109,50,59
2019,233374,40,1,15,6,9
2019,233374,40,2,4,1,3
2019,233374,40,3,4,3,1
2019,233374,40,4,1,0,1
2019,233374,40,6,85,40,45
2019,233374,41,0,45,16,29
2019,233374,41,1,11,3,8
2019,233374,41,2,2,0,2
2019,233374,41,3,1,0,1
2019,233374,41,6,31,13,18
2019,233374,42,0,47,26,21
2019,233374,42,1,4,3,1
2019,233374,42,2,2,1,1
2019,233374,42,3,2,2,0
2019,233374,42,4,1,0,1
2019,233374,42,6,38,20,18
2019,233374,43,0,17,8,9
2019,233374,43,3,1,1,0
2019,233374,43,6,16,7,9
2019,233374,44,0,1,0,1
2019,233374,44,3,1,0,1
2019,233374,45,0,44,16,28
2019,233374,45,1,11,3,8
2019,233374,45,2,2,0,2
2019,233374,45,6,31,13,18
2019,233408,0,0,24,0,24
2019,233408,10,0,24,0,24
2019,233408,10,4,24,0,24
2019,233408,40,0,24,0,24
2019,233408,40,4,24,0,24
2019,233408,41,0,24,0,24
2019,233408,41,4,24,0,24
2019,233408,45,0,24,0,24
2019,233408,45,4,24,0,24
2019,233426,0,0,165,75,90
2019,233426,10,0,165,75,90
2019,233426,10,1,48,27,21
2019,233426,10,2,56,29,27
2019,233426,10,3,28,10,18
2019,233426,10,6,33,9,24
2019,233426,20,0,104,56,48
2019,233426,20,1,48,27,21
2019,233426,20,2,56,29,27
2019,233426,30,0,28,10,18
2019,233426,30,3,28,10,18
2019,233426,40,0,33,9,24
2019,233426,40,6,33,9,24
2019,233426,42,0,33,9,24
2019,233426,42,6,33,9,24
2019,233541,0,0,267,109,158
2019,233541,10,0,267,109,158
2019,233541,10,1,56,25,31
2019,233541,10,2,91,41,50
2019,233541,10,3,96,36,60
2019,233541,10,4,3,1,2
2019,233541,10,5,19,4,15
2019,233541,10,6,2,2,0
2019,233541,40,0,267,109,158
2019,233541,40,1,56,25,31
2019,233541,40,2,91,41,50
2019,233541,40,3,96,36,60
2019,233541,40,4,3,1,2
2019,233541,40,5,19,4,15
2019,233541,40,6,2,2,0
2019,233541,42,0,267,109,158
2019,233541,42,1,56,25,31
2019,233541,42,2,91,41,50
2019,233541,42,3,96,36,60
2019,233541,42,4,3,1,2
2019,233541,42,5,19,4,15
2019,233541,42,6,2,2,0
2019,233611,0,0,72,51,21
2019,233611,10,0,71,50,21
2019,233611,10,1,19,11,8
2019,233611,10,2,11,11,0
2019,233611,10,3,22,14,8
2019,233611,10,4,7,5,2
2019,233611,10,5,12,9,3
2019,233611,40,0,71,50,21
2019,233611,40,1,19,11,8
2019,233611,40,2,11,11,0
2019,233611,40,3,22,14,8
2019,233611,40,4,7,5,2
2019,233611,40,5,12,9,3
2019,233611,42,0,34,25,9
2019,233611,42,1,5,4,1
2019,233611,42,2,5,5,0
2019,233611,42,3,19,13,6
2019,233611,42,4,5,3,2
2019,233611,43,0,37,25,12
2019,233611,43,1,14,7,7
2019,233611,43,2,6,6,0
2019,233611,43,3,3,1,2
2019,233611,43,4,2,2,0
2019,233611,43,5,12,9,3
2019,233611,50,0,1,1,0
2019,233639,0,0,54,25,29
2019,233639,10,0,54,25,29
2019,233639,10,1,11,2,9
2019,233639,10,2,16,7,9
2019,233639,10,3,14,8,6
2019,233639,10,4,10,7,3
2019,233639,10,5,3,1,2
2019,233639,40,0,54,25,29
2019,233639,40,1,11,2,9
2019,233639,40,2,16,7,9
2019,233639,40,3,14,8,6
2019,233639,40,4,10,7,3
2019,233639,40,5,3,1,2
2019,233639,42,0,54,25,29
2019,233639,42,1,11,2,9
2019,233639,42,2,16,7,9
2019,233639,42,3,14,8,6
2019,233639,42,4,10,7,3
2019,233639,42,5,3,1,2
2019,233648,0,0,39,14,25
2019,233648,10,0,39,14,25
2019,233648,10,1,4,1,3
2019,233648,10,2,11,5,6
2019,233648,10,3,11,5,6
2019,233648,10,4,13,3,10
2019,233648,40,0,39,14,25
2019,233648,40,1,4,1,3
2019,233648,40,2,11,5,6
2019,233648,40,3,11,5,6
2019,233648,40,4,13,3,10
2019,233648,42,0,39,14,25
2019,233648,42,1,4,1,3
2019,233648,42,2,11,5,6
2019,233648,42,3,11,5,6
2019,233648,42,4,13,3,10
2019,233684,0,0,11,7,4
2019,233684,10,0,11,7,4
2019,233684,10,6,11,7,4
2019,233684,40,0,11,7,4
2019,233684,40,6,11,7,4
2019,233684,41,0,11,7,4
2019,233684,41,6,11,7,4
2019,233684,45,0,11,7,4
2019,233684,45,6,11,7,4
2019,233718,0,0,43,22,21
2019,233718,10,0,43,22,21
2019,233718,10,1,12,9,3
2019,233718,10,2,7,2,5
2019,233718,10,3,17,9,8
2019,233718,10,4,6,2,4
2019,233718,10,5,1,0,1
2019,233718,20,0,18,11,7
2019,233718,20,1,12,9,3
2019,233718,20,2,6,2,4
2019,233718,30,0,10,6,4
2019,233718,30,2,1,0,1
2019,233718,30,3,9,6,3
2019,233718,40,0,15,5,10
2019,233718,40,3,8,3,5
2019,233718,40,4,6,2,4
2019,233718,40,5,1,0,1
2019,233718,41,0,11,4,7
2019,233718,41,3,5,2,3
2019,233718,41,4,6,2,4
2019,233718,42,0,4,1,3
2019,233718,42,3,3,1,2
2019,233718,42,5,1,0,1
2019,233718,44,0,11,4,7
2019,233718,44,3,5,2,3
2019,233718,44,4,6,2,4
2019,233754,0,0,109,41,68
2019,233754,10,0,109,41,68
2019,233754,10,1,15,5,10
2019,233754,10,2,32,12,20
2019,233754,10,3,36,12,24
2019,233754,10,4,25,12,13
2019,233754,10,5,1,0,1
2019,233754,40,0,109,41,68
2019,233754,40,1,15,5,10
2019,233754,40,2,32,12,20
2019,233754,40,3,36,12,24
2019,233754,40,4,25,12,13
2019,233754,40,5,1,0,1
2019,233754,42,0,109,41,68
2019,233754,42,1,15,5,10
2019,233754,42,2,32,12,20
2019,233754,42,3,36,12,24
2019,233754,42,4,25,12,13
2019,233754,42,5,1,0,1
2019,233772,0,0,290,140,150
2019,233772,10,0,290,140,150
2019,233772,10,1,63,32,31
2019,233772,10,2,89,45,44
2019,233772,10,3,64,29,35
2019,233772,10,4,69,31,38
2019,233772,10,5,5,3,2
2019,233772,40,0,290,140,150
2019,233772,40,1,63,32,31
2019,233772,40,2,89,45,44
2019,233772,40,3,64,29,35
2019,233772,40,4,69,31,38
2019,233772,40,5,5,3,2
2019,233772,42,0,290,140,150
2019,233772,42,1,63,32,31
2019,233772,42,2,89,45,44
2019,233772,42,3,64,29,35
2019,233772,42,4,69,31,38
2019,233772,42,5,5,3,2
2019,233842,0,0,22,13,9
2019,233842,10,0,22,13,9
2019,233842,10,1,10,7,3
2019,233842,10,2,5,3,2
2019,233842,10,3,6,3,3
2019,233842,10,4,1,0,1
2019,233842,20,0,12,8,4
2019,233842,20,1,9,6,3
2019,233842,20,2,3,2,1
2019,233842,30,0,4,1,3
2019,233842,30,3,3,1,2
2019,233842,30,4,1,0,1
2019,233842,40,0,6,4,2
2019,233842,40,1,1,1,0
2019,233842,40,2,2,1,1
2019,233842,40,3,3,2,1
2019,233842,41,0,6,4,2
2019,233842,41,1,1,1,0
2019,233842,41,2,2,1,1
2019,233842,41,3,3,2,1
2019,233842,44,0,1,1,0
2019,233842,44,3,1,1,0
2019,233842,45,0,5,3,2
2019,233842,45,1,1,1,0
2019,233842,45,2,2,1,1
2019,233842,45,3,2,1,1
2019,233897,0,0,103,54,49
2019,233897,10,0,103,54,49
2019,233897,10,1,28,18,10
2019,233897,10,2,24,15,9
2019,233897,10,3,25,13,12
2019,233897,10,4,26,8,18
2019,233897,20,0,53,35,18
2019,233897,20,1,28,18,10
2019,233897,20,2,22,14,8
2019,233897,20,3,3,3,0
2019,233897,30,0,24,11,13
2019,233897,30,2,2,1,1
2019,233897,30,3,22,10,12
2019,233897,40,0,26,8,18
2019,233897,40,4,26,8,18
2019,233897,42,0,26,8,18
2019,233897,42,4,26,8,18
2019,233903,0,0,47,15,32
2019,233903,10,0,47,15,32
2019,233903,10,1,5,1,4
2019,233903,10,2,18,3,15
2019,233903,10,3,14,4,10
2019,233903,10,4,10,7,3
2019,233903,40,0,47,15,32
2019,233903,40,1,5,1,4
2019,233903,40,2,18,3,15
2019,233903,40,3,14,4,10
2019,233903,40,4,10,7,3
2019,233903,42,0,47,15,32
2019,233903,42,1,5,1,4
2019,233903,42,2,18,3,15
2019,233903,42,3,14,4,10
2019,233903,42,4,10,7,3
2019,233921,0,0,2088,1332,756
2019,233921,10,0,2088,1332,756
2019,233921,10,1,605,490,115
2019,233921,10,2,550,341,209
2019,233921,10,3,590,330,260
2019,233921,10,4,302,143,159
2019,233921,10,5,3,2,1
2019,233921,10,6,38,26,12
2019,233921,20,0,1044,755,289
2019,233921,20,1,574,464,110
2019,233921,20,2,470,291,179
2019,233921,30,0,446,264,182
2019,233921,30,2,22,16,6
2019,233921,30,3,424,248,176
2019,233921,40,0,598,313,285
2019,233921,40,1,31,26,5
2019,233921,40,2,58,34,24
2019,233921,40,3,166,82,84
2019,233921,40,4,302,143,159
2019,233921,40,5,3,2,1
2019,233921,40,6,38,26,12
2019,233921,42,0,598,313,285
2019,233921,42,1,31,26,5
2019,233921,42,2,58,34,24
2019,233921,42,3,166,82,84
2019,233921,42,4,302,143,159
2019,233921,42,5,3,2,1
2019,233921,42,6,38,26,12
2019,233949,0,0,77,32,45
2019,233949,10,0,77,32,45
2019,233949,10,1,14,6,8
2019,233949,10,2,24,9,15
2019,233949,10,3,24,8,16
2019,233949,10,4,15,9,6
2019,233949,40,0,77,32,45
2019,233949,40,1,14,6,8
2019,233949,40,2,24,9,15
2019,233949,40,3,24,8,16
2019,233949,40,4,15,9,6
2019,233949,42,0,77,32,45
2019,233949,42,1,14,6,8
2019,233949,42,2,24,9,15
2019,233949,42,3,24,8,16
2019,233949,42,4,15,9,6
2019,234030,0,0,2184,1201,983
2019,234030,10,0,2182,1199,983
2019,234030,10,1,427,316,111
2019,234030,10,2,623,329,294
2019,234030,10,3,910,455,455
2019,234030,10,4,222,99,123
2019,234030,20,0,653,422,231
2019,234030,20,1,330,252,78
2019,234030,20,2,322,170,152
2019,234030,20,3,1,0,1
2019,234030,30,0,283,154,129
2019,234030,30,1,14,7,7
2019,234030,30,2,19,11,8
2019,234030,30,3,250,136,114
2019,234030,40,0,1246,623,623
2019,234030,40,1,83,57,26
2019,234030,40,2,282,148,134
2019,234030,40,3,659,319,340
2019,234030,40,4,222,99,123
2019,234030,42,0,1246,623,623
2019,234030,42,1,83,57,26
2019,234030,42,2,282,148,134
2019,234030,42,3,659,319,340
2019,234030,42,4,222,99,123
2019,234030,50,0,2,2,0
2019,234076,0,0,2407,1465,942
2019,234076,10,0,2407,1465,942
2019,234076,10,1,771,580,191
2019,234076,10,2,703,421,282
2019,234076,10,3,775,405,370
2019,234076,10,4,49,26,23
2019,234076,10,5,109,33,76
2019,234076,20,0,1036,745,291
2019,234076,20,1,669,512,157
2019,234076,20,2,367,233,134
2019,234076,30,0,418,252,166
2019,234076,30,2,78,51,27
2019,234076,30,3,340,201,139
2019,234076,40,0,953,468,485
2019,234076,40,1,102,68,34
2019,234076,40,2,258,137,121
2019,234076,40,3,435,204,231
2019,234076,40,4,49,26,23
2019,234076,40,5,109,33,76
2019,234076,41,0,801,402,399
2019,234076,41,1,98,65,33
2019,234076,41,2,252,134,118
2019,234076,41,3,395,181,214
2019,234076,41,4,9,4,5
2019,234076,41,5,47,18,29
2019,234076,42,0,117,52,65
2019,234076,42,1,1,1,0
2019,234076,42,2,3,2,1
2019,234076,42,3,31,17,14
2019,234076,42,4,36,20,16
2019,234076,42,5,46,12,34
2019,234076,43,0,35,14,21
2019,234076,43,1,3,2,1
2019,234076,43,2,3,1,2
2019,234076,43,3,9,6,3
2019,234076,43,4,4,2,2
2019,234076,43,5,16,3,13
2019,234076,44,0,801,402,399
2019,234076,44,1,98,65,33
2019,234076,44,2,252,134,118
2019,234076,44,3,395,181,214
2019,234076,44,4,9,4,5
2019,234076,44,5,47,18,29
2019,234085,0,0,143,98,45
2019,234085,10,0,143,98,45
2019,234085,10,1,67,56,11
2019,234085,10,2,28,16,12
2019,234085,10,3,43,23,20
2019,234085,10,4,4,2,2
2019,234085,10,5,1,1,0
2019,234085,20,0,81,64,17
2019,234085,20,1,63,53,10
2019,234085,20,2,18,11,7
2019,234085,30,0,46,22,24
2019,234085,30,1,1,1,0
2019,234085,30,2,9,4,5
2019,234085,30,3,36,17,19
2019,234085,40,0,16,12,4
2019,234085,40,1,3,2,1
2019,234085,40,2,1,1,0
2019,234085,40,3,7,6,1
2019,234085,40,4,4,2,2
2019,234085,40,5,1,1,0
2019,234085,41,0,8,6,2
2019,234085,41,1,2,1,1
2019,234085,41,2,1,1,0
2019,234085,41,3,5,4,1
2019,234085,42,0,8,6,2
2019,234085,42,1,1,1,0
2019,234085,42,3,2,2,0
2019,234085,42,4,4,2,2
2019,234085,42,5,1,1,0
2019,234085,44,0,8,6,2
2019,234085,44,1,2,1,1
2019,234085,44,2,1,1,0
2019,234085,44,3,5,4,1
2019,234137,0,0,5,5,0
2019,234137,10,0,5,5,0
2019,234137,10,1,4,4,0
2019,234137,10,4,1,1,0
2019,234137,40,0,5,5,0
2019,234137,40,1,4,4,0
2019,234137,40,4,1,1,0
2019,234137,41,0,5,5,0
2019,234137,41,1,4,4,0
2019,234137,41,4,1,1,0
2019,234137,45,0,5,5,0
2019,234137,45,1,4,4,0
2019,234137,45,4,1,1,0
2019,234155,0,0,262,135,127
2019,234155,10,0,262,135,127
2019,234155,10,1,57,36,21
2019,234155,10,2,81,46,35
2019,234155,10,3,81,36,45
2019,234155,10,4,43,17,26
2019,234155,20,0,120,71,49
2019,234155,20,1,53,33,20
2019,234155,20,2,65,38,27
2019,234155,20,3,2,0,2
2019,234155,30,0,48,19,29
2019,234155,30,2,11,4,7
2019,234155,30,3,36,14,22
2019,234155,30,4,1,1,0
2019,234155,40,0,94,45,49
2019,234155,40,1,4,3,1
2019,234155,40,2,5,4,1
2019,234155,40,3,43,22,21
2019,234155,40,4,42,16,26
2019,234155,42,0,94,45,49
2019,234155,42,1,4,3,1
2019,234155,42,2,5,4,1
2019,234155,42,3,43,22,21
2019,234155,42,4,42,16,26
2019,234164,0,0,74,33,41
2019,234164,10,0,69,33,36
2019,234164,10,1,11,7,4
2019,234164,10,2,25,13,12
2019,234164,10,3,26,11,15
2019,234164,10,4,7,2,5
2019,234164,20,0,17,10,7
2019,234164,20,1,10,7,3
2019,234164,20,2,6,3,3
2019,234164,20,3,1,0,1
2019,234164,40,0,52,23,29
2019,234164,40,1,1,0,1
2019,234164,40,2,19,10,9
2019,234164,40,3,25,11,14
2019,234164,40,4,7,2,5
2019,234164,42,0,52,23,29
2019,234164,42,1,1,0,1
2019,234164,42,2,19,10,9
2019,234164,42,3,25,11,14
2019,234164,42,4,7,2,5
2019,234164,50,0,5,0,5
2019,234173,0,0,90,46,44
2019,234173,10,0,90,46,44
2019,234173,10,1,41,22,19
2019,234173,10,2,27,13,14
2019,234173,10,3,17,9,8
2019,234173,10,4,5,2,3
2019,234173,20,0,68,35,33
2019,234173,20,1,41,22,19
2019,234173,20,2,27,13,14
2019,234173,30,0,17,9,8
2019,234173,30,3,17,9,8
2019,234173,40,0,5,2,3
2019,234173,40,4,5,2,3
2019,234173,42,0,5,2,3
2019,234173,42,4,5,2,3
2019,234207,0,0,251,144,107
2019,234207,10,0,251,144,107
2019,234207,10,1,116,80,36
2019,234207,10,2,55,27,28
2019,234207,10,3,67,34,33
2019,234207,10,4,12,2,10
2019,234207,10,5,1,1,0
2019,234207,20,0,159,100,59
2019,234207,20,1,109,74,35
2019,234207,20,2,50,26,24
2019,234207,30,0,50,27,23
2019,234207,30,2,4,1,3
2019,234207,30,3,46,26,20
2019,234207,40,0,42,17,25
2019,234207,40,1,7,6,1
2019,234207,40,2,1,0,1
2019,234207,40,3,21,8,13
2019,234207,40,4,12,2,10
2019,234207,40,5,1,1,0
2019,234207,41,0,13,3,10
2019,234207,41,3,3,1,2
2019,234207,41,4,10,2,8
2019,234207,42,0,29,14,15
2019,234207,42,1,7,6,1
2019,234207,42,2,1,0,1
2019,234207,42,3,18,7,11
2019,234207,42,4,2,0,2
2019,234207,42,5,1,1,0
2019,234207,44,0,13,3,10
2019,234207,44,3,3,1,2
2019,234207,44,4,10,2,8
2019,234377,0,0,29,10,19
2019,234377,10,0,29,10,19
2019,234377,10,1,3,1,2
2019,234377,10,2,9,3,6
2019,234377,10,3,12,3,9
2019,234377,10,4,5,3,2
2019,234377,40,0,29,10,19
2019,234377,40,1,3,1,2
2019,234377,40,2,9,3,6
2019,234377,40,3,12,3,9
2019,234377,40,4,5,3,2
2019,234377,42,0,29,10,19
2019,234377,42,1,3,1,2
2019,234377,42,2,9,3,6
2019,234377,42,3,12,3,9
2019,234377,42,4,5,3,2
2019,234669,0,0,196,86,110
2019,234669,10,0,196,86,110
2019,234669,10,1,39,16,23
2019,234669,10,2,113,53,60
2019,234669,10,3,37,16,21
2019,234669,10,6,7,1,6
2019,234669,20,0,147,65,82
2019,234669,20,1,39,16,23
2019,234669,20,2,108,49,59
2019,234669,30,0,37,16,21
2019,234669,30,2,1,1,0
2019,234669,30,3,36,15,21
2019,234669,40,0,12,5,7
2019,234669,40,2,4,3,1
2019,234669,40,3,1,1,0
2019,234669,40,6,7,1,6
2019,234669,42,0,11,5,6
2019,234669,42,2,4,3,1
2019,234669,42,3,1,1,0
2019,234669,42,6,6,1,5
2019,234669,43,0,1,0,1
2019,234669,43,6,1,0,1
2019,234696,0,0,62,30,32
2019,234696,10,0,62,30,32
2019,234696,10,6,62,30,32
2019,234696,20,0,36,18,18
2019,234696,20,6,36,18,18
2019,234696,30,0,12,5,7
2019,234696,30,6,12,5,7
2019,234696,40,0,14,7,7
2019,234696,40,6,14,7,7
2019,234696,42,0,14,7,7
2019,234696,42,6,14,7,7
2019,234711,0,0,44,28,16
2019,234711,10,0,44,28,16
2019,234711,10,4,44,28,16
2019,234711,20,0,31,22,9
2019,234711,20,4,31,22,9
2019,234711,30,0,11,4,7
2019,234711,30,4,11,4,7
2019,234711,40,0,2,2,0
2019,234711,40,4,2,2,0
2019,234711,42,0,2,2,0
2019,234711,42,4,2,2,0
2019,234827,0,0,457,235,222
2019,234827,10,0,397,206,191
2019,234827,10,1,91,57,34
2019,234827,10,2,88,51,37
2019,234827,10,3,85,40,45
2019,234827,10,4,17,6,11
2019,234827,10,5,116,52,64
2019,234827,20,0,171,104,67
2019,234827,20,1,88,54,34
2019,234827,20,2,82,49,33
2019,234827,20,3,1,1,0
2019,234827,30,0,92,42,50
2019,234827,30,2,6,2,4
2019,234827,30,3,83,39,44
2019,234827,30,5,3,1,2
2019,234827,40,0,134,60,74
2019,234827,40,1,3,3,0
2019,234827,40,3,1,0,1
2019,234827,40,4,17,6,11
2019,234827,40,5,113,51,62
2019,234827,42,0,117,54,63
2019,234827,42,1,3,3,0
2019,234827,42,3,1,0,1
2019,234827,42,5,113,51,62
2019,234827,43,0,17,6,11
2019,234827,43,4,17,6,11
2019,234827,50,0,60,29,31
2019,234845,0,0,74,31,43
2019,234845,10,0,74,31,43
2019,234845,10,6,74,31,43
2019,234845,20,0,40,17,23
2019,234845,20,6,40,17,23
2019,234845,30,0,17,9,8
2019,234845,30,6,17,9,8
2019,234845,40,0,17,5,12
2019,234845,40,6,17,5,12
2019,234845,42,0,16,5,11
2019,234845,42,6,16,5,11
2019,234845,43,0,1,0,1
2019,234845,43,6,1,0,1
2019,234915,0,0,31,14,17
2019,234915,10,0,31,14,17
2019,234915,10,6,31,14,17
2019,234915,40,0,31,14,17
2019,234915,40,6,31,14,17
2019,234915,41,0,31,14,17
2019,234915,41,6,31,14,17
2019,234915,45,0,31,14,17
2019,234915,45,6,31,14,17
2019,234933,0,0,183,72,111
2019,234933,10,0,183,72,111
2019,234933,10,4,183,72,111
2019,234933,20,0,131,52,79
2019,234933,20,4,131,52,79
2019,234933,30,0,27,10,17
2019,234933,30,4,27,10,17
2019,234933,40,0,25,10,15
2019,234933,40,4,25,10,15
2019,234933,42,0,25,10,15
2019,234933,42,4,25,10,15
2019,234951,0,0,95,48,47
2019,234951,10,0,95,48,47
2019,234951,10,4,88,45,43
2019,234951,10,6,7,3,4
2019,234951,20,0,58,25,33
2019,234951,20,4,54,23,31
2019,234951,20,6,4,2,2
2019,234951,30,0,27,15,12
2019,234951,30,4,26,15,11
2019,234951,30,6,1,0,1
2019,234951,40,0,10,8,2
2019,234951,40,4,8,7,1
2019,234951,40,6,2,1,1
2019,234951,42,0,7,5,2
2019,234951,42,4,6,5,1
2019,234951,42,6,1,0,1
2019,234951,43,0,3,3,0
2019,234951,43,4,2,2,0
2019,234951,43,6,1,1,0
2019,234979,0,0,136,61,75
2019,234979,10,0,136,61,75
2019,234979,10,6,136,61,75
2019,234979,20,0,79,40,39
2019,234979,20,6,79,40,39
2019,234979,30,0,43,17,26
2019,234979,30,6,43,17,26
2019,234979,40,0,14,4,10
2019,234979,40,6,14,4,10
2019,234979,41,0,2,0,2
2019,234979,41,6,2,0,2
2019,234979,42,0,11,4,7
2019,234979,42,6,11,4,7
2019,234979,43,0,1,0,1
2019,234979,43,6,1,0,1
2019,234979,44,0,2,0,2
2019,234979,44,6,2,0,2
2019,235024,0,0,52,21,31
2019,235024,10,0,52,21,31
2019,235024,10,1,26,11,15
2019,235024,10,2,11,3,8
2019,235024,10,3,15,7,8
2019,235024,40,0,52,21,31
2019,235024,40,1,26,11,15
2019,235024,40,2,11,3,8
2019,235024,40,3,15,7,8
2019,235024,41,0,46,19,27
2019,235024,41,1,26,11,15
2019,235024,41,2,10,3,7
2019,235024,41,3,10,5,5
2019,235024,42,0,6,2,4
2019,235024,42,2,1,0,1
2019,235024,42,3,5,2,3
2019,235024,44,0,46,19,27
2019,235024,44,1,26,11,15
2019,235024,44,2,10,3,7
2019,235024,44,3,10,5,5
2019,235097,0,0,460,236,224
2019,235097,10,0,460,236,224
2019,235097,10,1,154,96,58
2019,235097,10,2,66,34,32
2019,235097,10,3,90,38,52
2019,235097,10,5,150,68,82
2019,235097,20,0,220,130,90
2019,235097,20,1,154,96,58
2019,235097,20,2,66,34,32
2019,235097,30,0,90,38,52
2019,235097,30,3,90,38,52
2019,235097,40,0,150,68,82
2019,235097,40,5,150,68,82
2019,235097,41,0,58,28,30
2019,235097,41,5,58,28,30
2019,235097,42,0,92,40,52
2019,235097,42,5,92,40,52
2019,235097,44,0,58,28,30
2019,235097,44,5,58,28,30
2019,235103,0,0,120,53,67
2019,235103,10,0,120,53,67
2019,235103,10,6,120,53,67
2019,235103,20,0,97,45,52
2019,235103,20,6,97,45,52
2019,235103,30,0,13,7,6
2019,235103,30,6,13,7,6
2019,235103,40,0,10,1,9
2019,235103,40,6,10,1,9
2019,235103,42,0,10,1,9
2019,235103,42,6,10,1,9
2019,235149,0,0,135,59,76
2019,235149,10,0,135,59,76
2019,235149,10,6,135,59,76
2019,235149,20,0,85,38,47
2019,235149,20,6,85,38,47
2019,235149,30,0,36,15,21
2019,235149,30,6,36,15,21
2019,235149,40,0,14,6,8
2019,235149,40,6,14,6,8
2019,235149,42,0,14,6,8
2019,235149,42,6,14,6,8
2019,235167,0,0,127,54,73
2019,235167,10,0,127,54,73
2019,235167,10,6,127,54,73
2019,235167,40,0,127,54,73
2019,235167,40,6,127,54,73
2019,235167,41,0,114,49,65
2019,235167,41,6,114,49,65
2019,235167,43,0,13,5,8
2019,235167,43,6,13,5,8
2019,235167,44,0,114,49,65
2019,235167,44,6,114,49,65
2019,235237,0,0,85,32,53
2019,235237,10,0,85,32,53
2019,235237,10,6,85,32,53
2019,235237,20,0,57,23,34
2019,235237,20,6,57,23,34
2019,235237,30,0,19,7,12
2019,235237,30,6,19,7,12
2019,235237,40,0,9,2,7
2019,235237,40,6,9,2,7
2019,235237,42,0,9,2,7
2019,235237,42,6,9,2,7
2019,235316,0,0,454,252,202
2019,235316,10,0,454,252,202
2019,235316,10,1,120,79,41
2019,235316,10,2,144,76,68
2019,235316,10,3,165,87,78
2019,235316,10,5,25,10,15
2019,235316,20,0,227,143,84
2019,235316,20,1,120,79,41
2019,235316,20,2,104,61,43
2019,235316,20,3,3,3,0
2019,235316,30,0,128,62,66
2019,235316,30,2,25,10,15
2019,235316,30,3,103,52,51
2019,235316,40,0,99,47,52
2019,235316,40,2,15,5,10
2019,235316,40,3,59,32,27
2019,235316,40,5,25,10,15
2019,235316,41,0,44,18,26
2019,235316,41,2,15,5,10
2019,235316,41,3,23,11,12
2019,235316,41,5,6,2,4
2019,235316,42,0,55,29,26
2019,235316,42,3,36,21,15
2019,235316,42,5,19,8,11
2019,235316,44,0,44,18,26
2019,235316,44,2,15,5,10
2019,235316,44,3,23,11,12
2019,235316,44,5,6,2,4
2019,235334,0,0,57,31,26
2019,235334,10,0,57,31,26
2019,235334,10,3,56,31,25
2019,235334,10,6,1,0,1
2019,235334,20,0,35,19,16
2019,235334,20,3,35,19,16
2019,235334,30,0,13,8,5
2019,235334,30,3,13,8,5
2019,235334,40,0,9,4,5
2019,235334,40,3,8,4,4
2019,235334,40,6,1,0,1
2019,235334,42,0,8,3,5
2019,235334,42,3,7,3,4
2019,235334,42,6,1,0,1
2019,235334,43,0,1,1,0
2019,235334,43,3,1,1,0
2019,235343,0,0,168,88,80
2019,235343,10,0,162,85,77
2019,235343,10,4,162,85,77
2019,235343,20,0,99,49,50
2019,235343,20,4,99,49,50
2019,235343,30,0,57,33,24
2019,235343,30,4,57,33,24
2019,235343,40,0,6,3,3
2019,235343,40,4,6,3,3
2019,235343,42,0,6,3,3
2019,235343,42,4,6,3,3
2019,235343,50,0,6,3,3
2019,235422,0,0,67,31,36
2019,235422,10,0,67,31,36
2019,235422,10,1,8,5,3
2019,235422,10,2,25,15,10
2019,235422,10,3,28,10,18
2019,235422,10,4,6,1,5
2019,235422,40,0,67,31,36
2019,235422,40,1,8,5,3
2019,235422,40,2,25,15,10
2019,235422,40,3,28,10,18
2019,235422,40,4,6,1,5
2019,235422,41,0,14,9,5
2019,235422,41,1,4,3,1
2019,235422,41,2,8,5,3
2019,235422,41,3,2,1,1
2019,235422,42,0,53,22,31
2019,235422,42,1,4,2,2
2019,235422,42,2,17,10,7
2019,235422,42,3,26,9,17
2019,235422,42,4,6,1,5
2019,235422,44,0,14,9,5
2019,235422,44,1,4,3,1
2019,235422,44,2,8,5,3
2019,235422,44,3,2,1,1
2019,235431,0,0,158,62,96
2019,235431,10,0,158,62,96
2019,235431,10,6,158,62,96
2019,235431,20,0,96,43,53
2019,235431,20,6,96,43,53
2019,235431,30,0,30,6,24
2019,235431,30,6,30,6,24
2019,235431,40,0,32,13,19
2019,235431,40,6,32,13,19
2019,235431,42,0,32,13,19
2019,235431,42,6,32,13,19
2019,235547,0,0,28,6,22
2019,235547,10,0,28,6,22
2019,235547,10,1,4,3,1
2019,235547,10,2,11,2,9
2019,235547,10,3,13,1,12
2019,235547,40,0,28,6,22
2019,235547,40,1,4,3,1
2019,235547,40,2,11,2,9
2019,235547,40,3,13,1,12
2019,235547,41,0,6,3,3
2019,235547,41,1,1,1,0
2019,235547,41,2,4,2,2
2019,235547,41,3,1,0,1
2019,235547,42,0,22,3,19
2019,235547,42,1,3,2,1
2019,235547,42,2,7,0,7
2019,235547,42,3,12,1,11
2019,235547,44,0,6,3,3
2019,235547,44,1,1,1,0
2019,235547,44,2,4,2,2
2019,235547,44,3,1,0,1
2019,235671,0,0,91,51,40
2019,235671,10,0,91,51,40
2019,235671,10,4,86,49,37
2019,235671,10,6,5,2,3
2019,235671,20,0,68,40,28
2019,235671,20,4,65,38,27
2019,235671,20,6,3,2,1
2019,235671,30,0,13,7,6
2019,235671,30,4,11,7,4
2019,235671,30,6,2,0,2
2019,235671,40,0,10,4,6
2019,235671,40,4,10,4,6
2019,235671,42,0,10,4,6
2019,235671,42,4,10,4,6
2019,235699,0,0,81,30,51
2019,235699,10,0,81,30,51
2019,235699,10,6,81,30,51
2019,235699,20,0,35,12,23
2019,235699,20,6,35,12,23
2019,235699,30,0,19,7,12
2019,235699,30,6,19,7,12
2019,235699,40,0,27,11,16
2019,235699,40,6,27,11,16
2019,235699,42,0,27,11,16
2019,235699,42,6,27,11,16
2019,235750,0,0,74,32,42
2019,235750,10,0,74,32,42
2019,235750,10,6,74,32,42
2019,235750,20,0,54,28,26
2019,235750,20,6,54,28,26
2019,235750,30,0,9,1,8
2019,235750,30,6,9,1,8
2019,235750,40,0,11,3,8
2019,235750,40,6,11,3,8
2019,235750,42,0,11,3,8
2019,235750,42,6,11,3,8
2019,236072,0,0,95,38,57
2019,236072,10,0,95,38,57
2019,236072,10,6,95,38,57
2019,236072,20,0,66,29,37
2019,236072,20,6,66,29,37
2019,236072,40,0,29,9,20
2019,236072,40,6,29,9,20
2019,236072,42,0,22,7,15
2019,236072,42,6,22,7,15
2019,236072,43,0,7,2,5
2019,236072,43,6,7,2,5
2019,236133,0,0,56,29,27
2019,236133,10,0,56,29,27
2019,236133,10,1,12,8,4
2019,236133,10,2,19,11,8
2019,236133,10,3,23,9,14
2019,236133,10,4,2,1,1
2019,236133,20,0,22,13,9
2019,236133,20,1,12,8,4
2019,236133,20,2,10,5,5
2019,236133,30,0,32,15,17
2019,236133,30,2,9,6,3
2019,236133,30,3,23,9,14
2019,236133,40,0,2,1,1
2019,236133,40,4,2,1,1
2019,236133,42,0,2,1,1
2019,236133,42,4,2,1,1
2019,236188,0,0,136,60,76
2019,236188,10,0,136,60,76
2019,236188,10,6,136,60,76
2019,236188,20,0,99,46,53
2019,236188,20,6,99,46,53
2019,236188,30,0,28,12,16
2019,236188,30,6,28,12,16
2019,236188,40,0,9,2,7
2019,236188,40,6,9,2,7
2019,236188,42,0,6,1,5
2019,236188,42,6,6,1,5
2019,236188,43,0,3,1,2
2019,236188,43,6,3,1,2
2019,236212,0,0,49,43,6
2019,236212,10,0,49,43,6
2019,236212,10,4,49,43,6
2019,236212,40,0,49,43,6
2019,236212,40,4,49,43,6
2019,236212,41,0,49,43,6
2019,236212,41,4,49,43,6
2019,236212,45,0,49,43,6
2019,236212,45,4,49,43,6
2019,236230,0,0,214,98,116
2019,236230,10,0,214,98,116
2019,236230,10,1,43,28,15
2019,236230,10,2,76,29,47
2019,236230,10,3,82,41,41
2019,236230,10,4,13,0,13
2019,236230,20,0,123,57,66
2019,236230,20,1,43,28,15
2019,236230,20,2,75,28,47
2019,236230,20,3,5,1,4
2019,236230,30,0,52,24,28
2019,236230,30,2,1,1,0
2019,236230,30,3,51,23,28
2019,236230,40,0,39,17,22
2019,236230,40,3,26,17,9
2019,236230,40,4,13,0,13
2019,236230,41,0,1,0,1
2019,236230,41,3,1,0,1
2019,236230,42,0,37,17,20
2019,236230,42,3,25,17,8
2019,236230,42,4,12,0,12
2019,236230,43,0,1,0,1
2019,236230,43,4,1,0,1
2019,236230,44,0,1,0,1
2019,236230,44,3,1,0,1
2019,236258,0,0,46,25,21
2019,236258,10,0,46,25,21
2019,236258,10,6,46,25,21
2019,236258,20,0,24,14,10
2019,236258,20,6,24,14,10
2019,236258,30,0,10,4,6
2019,236258,30,6,10,4,6
2019,236258,40,0,12,7,5
2019,236258,40,6,12,7,5
2019,236258,42,0,12,7,5
2019,236258,42,6,12,7,5
2019,236328,0,0,237,115,122
2019,236328,10,0,237,115,122
2019,236328,10,1,115,65,50
2019,236328,10,2,40,21,19
2019,236328,10,3,63,22,41
2019,236328,10,4,19,7,12
2019,236328,20,0,142,80,62
2019,236328,20,1,112,63,49
2019,236328,20,2,30,17,13
2019,236328,30,0,42,18,24
2019,236328,30,1,1,0,1
2019,236328,30,2,7,4,3
2019,236328,30,3,34,14,20
2019,236328,40,0,53,17,36
2019,236328,40,1,2,2,0
2019,236328,40,2,3,0,3
2019,236328,40,3,29,8,21
2019,236328,40,4,19,7,12
2019,236328,41,0,4,0,4
2019,236328,41,3,4,0,4
2019,236328,42,0,49,17,32
2019,236328,42,1,2,2,0
2019,236328,42,2,3,0,3
2019,236328,42,3,25,8,17
2019,236328,42,4,19,7,12
2019,236328,44,0,4,0,4
2019,236328,44,3,4,0,4
2019,236382,0,0,67,37,30
2019,236382,10,0,67,37,30
2019,236382,10,4,67,37,30
2019,236382,20,0,33,17,16
2019,236382,20,4,33,17,16
2019,236382,30,0,22,12,10
2019,236382,30,4,22,12,10
2019,236382,40,0,12,8,4
2019,236382,40,4,12,8,4
2019,236382,42,0,8,4,4
2019,236382,42,4,8,4,4
2019,236382,43,0,4,4,0
2019,236382,43,4,4,4,0
2019,236452,0,0,96,51,45
2019,236452,10,0,96,51,45
2019,236452,10,1,17,10,7
2019,236452,10,2,23,10,13
2019,236452,10,3,41,23,18
2019,236452,10,4,14,8,6
2019,236452,10,5,1,0,1
2019,236452,20,0,38,20,18
2019,236452,20,1,17,10,7
2019,236452,20,2,21,10,11
2019,236452,30,0,40,20,20
2019,236452,30,2,2,0,2
2019,236452,30,3,38,20,18
2019,236452,40,0,18,11,7
2019,236452,40,3,3,3,0
2019,236452,40,4,14,8,6
2019,236452,40,5,1,0,1
2019,236452,42,0,18,11,7
2019,236452,42,3,3,3,0
2019,236452,42,4,14,8,6
2019,236452,42,5,1,0,1
2019,236504,0,0,69,37,32
2019,236504,10,0,69,37,32
2019,236504,10,4,2,1,1
2019,236504,10,6,67,36,31
2019,236504,20,0,53,30,23
2019,236504,20,4,2,1,1
2019,236504,20,6,51,29,22
2019,236504,40,0,16,7,9
2019,236504,40,6,16,7,9
2019,236504,42,0,13,6,7
2019,236504,42,6,13,6,7
2019,236504,43,0,3,1,2
2019,236504,43,6,3,1,2
2019,236513,0,0,164,71,93
2019,236513,10,0,164,71,93
2019,236513,10,6,164,71,93
2019,236513,20,0,110,50,60
2019,236513,20,6,110,50,60
2019,236513,40,0,54,21,33
2019,236513,40,6,54,21,33
2019,236513,42,0,42,15,27
2019,236513,42,6,42,15,27
2019,236513,43,0,12,6,6
2019,236513,43,6,12,6,6
2019,236577,0,0,202,106,96
2019,236577,10,0,202,106,96
2019,236577,10,1,64,40,24
2019,236577,10,2,61,31,30
2019,236577,10,3,65,31,34
2019,236577,10,4,12,4,8
2019,236577,20,0,113,64,49
2019,236577,20,1,62,38,24
2019,236577,20,2,50,26,24
2019,236577,20,3,1,0,1
2019,236577,30,0,51,25,26
2019,236577,30,2,7,4,3
2019,236577,30,3,43,20,23
2019,236577,30,4,1,1,0
2019,236577,40,0,38,17,21
2019,236577,40,1,2,2,0
2019,236577,40,2,4,1,3
2019,236577,40,3,21,11,10
2019,236577,40,4,11,3,8
2019,236577,41,0,26,12,14
2019,236577,41,1,1,1,0
2019,236577,41,2,2,0,2
2019,236577,41,3,15,8,7
2019,236577,41,4,8,3,5
2019,236577,42,0,12,5,7
2019,236577,42,1,1,1,0
2019,236577,42,2,2,1,1
2019,236577,42,3,6,3,3
2019,236577,42,4,3,0,3
2019,236577,44,0,26,12,14
2019,236577,44,1,1,1,0
2019,236577,44,2,2,0,2
2019,236577,44,3,15,8,7
2019,236577,44,4,8,3,5
2019,236595,0,0,522,240,282
2019,236595,10,0,522,240,282
2019,236595,10,1,100,58,42
2019,236595,10,2,167,87,80
2019,236595,10,3,97,33,64
2019,236595,10,4,113,44,69
2019,236595,10,5,34,12,22
2019,236595,10,6,11,6,5
2019,236595,20,0,253,141,112
2019,236595,20,1,91,53,38
2019,236595,20,2,160,86,74
2019,236595,20,3,2,2,0
2019,236595,30,0,73,26,47
2019,236595,30,2,2,0,2
2019,236595,30,3,71,26,45
2019,236595,40,0,196,73,123
2019,236595,40,1,9,5,4
2019,236595,40,2,5,1,4
2019,236595,40,3,24,5,19
2019,236595,40,4,113,44,69
2019,236595,40,5,34,12,22
2019,236595,40,6,11,6,5
2019,236595,42,0,196,73,123
2019,236595,42,1,9,5,4
2019,236595,42,2,5,1,4
2019,236595,42,3,24,5,19
2019,236595,42,4,113,44,69
2019,236595,42,5,34,12,22
2019,236595,42,6,11,6,5
2019,236610,0,0,129,49,80
2019,236610,10,0,129,49,80
2019,236610,10,6,129,49,80
2019,236610,20,0,101,40,61
2019,236610,20,6,101,40,61
2019,236610,30,0,18,8,10
2019,236610,30,6,18,8,10
2019,236610,40,0,10,1,9
2019,236610,40,6,10,1,9
2019,236610,42,0,10,1,9
2019,236610,42,6,10,1,9
2019,236638,0,0,97,41,56
2019,236638,10,0,97,41,56
2019,236638,10,6,97,41,56
2019,236638,20,0,76,31,45
2019,236638,20,6,76,31,45
2019,236638,30,0,14,7,7
2019,236638,30,6,14,7,7
2019,236638,40,0,7,3,4
2019,236638,40,6,7,3,4
2019,236638,42,0,7,3,4
2019,236638,42,6,7,3,4
2019,236656,0,0,96,46,50
2019,236656,10,0,96,46,50
2019,236656,10,6,96,46,50
2019,236656,20,0,43,20,23
2019,236656,20,6,43,20,23
2019,236656,30,0,50,25,25
2019,236656,30,6,50,25,25
2019,236656,40,0,3,1,2
2019,236656,40,6,3,1,2
2019,236656,42,0,3,1,2
2019,236656,42,6,3,1,2
2019,236692,0,0,201,100,101
2019,236692,10,0,201,100,101
2019,236692,10,4,201,100,101
2019,236692,20,0,144,77,67
2019,236692,20,4,144,77,67
2019,236692,30,0,31,12,19
2019,236692,30,4,31,12,19
2019,236692,40,0,26,11,15
2019,236692,40,4,26,11,15
2019,236692,42,0,26,11,15
2019,236692,42,4,26,11,15
2019,236708,0,0,138,66,72
2019,236708,10,0,138,66,72
2019,236708,10,4,138,66,72
2019,236708,20,0,105,52,53
2019,236708,20,4,105,52,53
2019,236708,30,0,16,6,10
2019,236708,30,4,16,6,10
2019,236708,40,0,17,8,9
2019,236708,40,4,17,8,9
2019,236708,42,0,17,8,9
2019,236708,42,4,17,8,9
2019,236753,0,0,143,66,77
2019,236753,10,0,143,66,77
2019,236753,10,4,143,66,77
2019,236753,20,0,101,49,52
2019,236753,20,4,101,49,52
2019,236753,30,0,20,10,10
2019,236753,30,4,20,10,10
2019,236753,40,0,22,7,15
2019,236753,40,4,22,7,15
2019,236753,42,0,22,7,15
2019,236753,42,4,22,7,15
2019,236887,0,0,119,69,50
2019,236887,10,0,119,69,50
2019,236887,10,6,119,69,50
2019,236887,20,0,64,31,33
2019,236887,20,6,64,31,33
2019,236887,30,0,15,9,6
2019,236887,30,6,15,9,6
2019,236887,40,0,40,29,11
2019,236887,40,6,40,29,11
2019,236887,42,0,37,26,11
2019,236887,42,6,37,26,11
2019,236887,43,0,3,3,0
2019,236887,43,6,3,3,0
2019,236896,0,0,91,51,40
2019,236896,10,0,91,51,40
2019,236896,10,1,38,22,16
2019,236896,10,2,21,13,8
2019,236896,10,3,27,12,15
2019,236896,10,4,5,4,1
2019,236896,20,0,52,33,19
2019,236896,20,1,35,22,13
2019,236896,20,2,13,8,5
2019,236896,20,3,4,3,1
2019,236896,30,0,29,13,16
2019,236896,30,1,2,0,2
2019,236896,30,2,7,5,2
2019,236896,30,3,19,8,11
2019,236896,30,4,1,0,1
2019,236896,40,0,10,5,5
2019,236896,40,1,1,0,1
2019,236896,40,2,1,0,1
2019,236896,40,3,4,1,3
2019,236896,40,4,4,4,0
2019,236896,42,0,10,5,5
2019,236896,42,1,1,0,1
2019,236896,42,2,1,0,1
2019,236896,42,3,4,1,3
2019,236896,42,4,4,4,0
2019,236939,0,0,1332,752,580
2019,236939,10,0,1332,752,580
2019,236939,10,1,338,247,91
2019,236939,10,2,294,181,113
2019,236939,10,3,202,105,97
2019,236939,10,4,196,72,124
2019,236939,10,6,302,147,155
2019,236939,20,0,619,422,197
2019,236939,20,1,336,246,90
2019,236939,20,2,283,176,107
2019,236939,30,0,215,111,104
2019,236939,30,1,2,1,1
2019,236939,30,2,11,5,6
2019,236939,30,3,202,105,97
2019,236939,40,0,498,219,279
2019,236939,40,4,196,72,124
2019,236939,40,6,302,147,155
2019,236939,41,0,208,99,109
2019,236939,41,4,40,14,26
2019,236939,41,6,168,85,83
2019,236939,42,0,277,115,162
2019,236939,42,4,147,56,91
2019,236939,42,6,130,59,71
2019,236939,43,0,13,5,8
2019,236939,43,4,9,2,7
2019,236939,43,6,4,3,1
2019,236939,44,0,190,86,104
2019,236939,44,4,39,13,26
2019,236939,44,6,151,73,78
2019,236939,45,0,18,13,5
2019,236939,45,4,1,1,0
2019,236939,45,6,17,12,5
2019,236948,0,0,4403,2396,2007
2019,236948,10,0,4377,2385,1992
2019,236948,10,1,1490,1003,487
2019,236948,10,2,1009,573,436
2019,236948,10,3,1009,475,534
2019,236948,10,4,207,119,88
2019,236948,10,5,662,215,447
2019,236948,20,0,2237,1424,813
2019,236948,20,1,1384,940,444
2019,236948,20,2,853,484,369
2019,236948,30,0,673,315,358
2019,236948,30,1,1,0,1
2019,236948,30,2,4,1,3
2019,236948,30,3,668,314,354
2019,236948,40,0,1467,646,821
2019,236948,40,1,105,63,42
2019,236948,40,2,152,88,64
2019,236948,40,3,341,161,180
2019,236948,40,4,207,119,88
2019,236948,40,5,662,215,447
2019,236948,41,0,547,262,285
2019,236948,41,1,53,24,29
2019,236948,41,2,78,51,27
2019,236948,41,3,76,44,32
2019,236948,41,5,340,143,197
2019,236948,42,0,920,384,536
2019,236948,42,1,52,39,13
2019,236948,42,2,74,37,37
2019,236948,42,3,265,117,148
2019,236948,42,4,207,119,88
2019,236948,42,5,322,72,250
2019,236948,44,0,547,262,285
2019,236948,44,1,53,24,29
2019,236948,44,2,78,51,27
2019,236948,44,3,76,44,32
2019,236948,44,5,340,143,197
2019,236948,50,0,26,11,15
2019,236975,0,0,85,40,45
2019,236975,10,0,85,40,45
2019,236975,10,6,85,40,45
2019,236975,20,0,59,32,27
2019,236975,20,6,59,32,27
2019,236975,30,0,20,6,14
2019,236975,30,6,20,6,14
2019,236975,40,0,6,2,4
2019,236975,40,6,6,2,4
2019,236975,42,0,6,2,4
2019,236975,42,6,6,2,4
2019,237011,0,0,664,351,313
2019,237011,10,0,664,351,313
2019,237011,10,1,215,138,77
2019,237011,10,2,168,83,85
2019,237011,10,3,159,80,79
2019,237011,10,4,122,50,72
2019,237011,20,0,379,220,159
2019,237011,20,1,215,138,77
2019,237011,20,2,164,82,82
2019,237011,30,0,163,81,82
2019,237011,30,2,4,1,3
2019,237011,30,3,159,80,79
2019,237011,40,0,122,50,72
2019,237011,40,4,122,50,72
2019,237011,41,0,67,29,38
2019,237011,41,4,67,29,38
2019,237011,42,0,55,21,34
2019,237011,42,4,55,21,34
2019,237011,44,0,67,29,38
2019,237011,44,4,67,29,38
2019,237039,0,0,88,33,55
2019,237039,10,0,88,33,55
2019,237039,10,1,22,7,15
2019,237039,10,2,14,4,10
2019,237039,10,3,21,9,12
2019,237039,10,4,19,8,11
2019,237039,10,6,12,5,7
2019,237039,20,0,66,24,42
2019,237039,20,1,22,7,15
2019,237039,20,2,14,4,10
2019,237039,20,3,21,9,12
2019,237039,20,6,9,4,5
2019,237039,30,0,19,8,11
2019,237039,30,4,19,8,11
2019,237039,40,0,3,1,2
2019,237039,40,6,3,1,2
2019,237039,42,0,3,1,2
2019,237039,42,6,3,1,2
2019,237057,0,0,196,103,93
2019,237057,10,0,196,103,93
2019,237057,10,1,40,27,13
2019,237057,10,2,54,25,29
2019,237057,10,3,56,27,29
2019,237057,10,4,21,9,12
2019,237057,10,5,25,15,10
2019,237057,20,0,94,53,41
2019,237057,20,1,40,27,13
2019,237057,20,2,52,25,27
2019,237057,20,3,2,1,1
2019,237057,30,0,33,16,17
2019,237057,30,3,33,16,17
2019,237057,40,0,69,34,35
2019,237057,40,2,2,0,2
2019,237057,40,3,21,10,11
2019,237057,40,4,21,9,12
2019,237057,40,5,25,15,10
2019,237057,41,0,44,22,22
2019,237057,41,2,1,0,1
2019,237057,41,3,4,1,3
2019,237057,41,4,17,7,10
2019,237057,41,5,22,14,8
2019,237057,42,0,25,12,13
2019,237057,42,2,1,0,1
2019,237057,42,3,17,9,8
2019,237057,42,4,4,2,2
2019,237057,42,5,3,1,2
2019,237057,44,0,23,13,10
2019,237057,44,2,1,0,1
2019,237057,44,4,1,0,1
2019,237057,44,5,21,13,8
2019,237057,45,0,21,9,12
2019,237057,45,3,4,1,3
2019,237057,45,4,16,7,9
2019,237057,45,5,1,1,0
2019,237066,0,0,187,104,83
2019,237066,10,0,153,86,67
2019,237066,10,1,48,34,14
2019,237066,10,2,53,25,28
2019,237066,10,3,41,21,20
2019,237066,10,4,11,6,5
2019,237066,20,0,82,50,32
2019,237066,20,1,40,29,11
2019,237066,20,2,41,20,21
2019,237066,20,3,1,1,0
2019,237066,30,0,29,13,16
2019,237066,30,1,2,2,0
2019,237066,30,2,5,2,3
2019,237066,30,3,22,9,13
2019,237066,40,0,42,23,19
2019,237066,40,1,6,3,3
2019,237066,40,2,7,3,4
2019,237066,40,3,18,11,7
2019,237066,40,4,11,6,5
2019,237066,42,0,42,23,19
2019,237066,42,1,6,3,3
2019,237066,42,2,7,3,4
2019,237066,42,3,18,11,7
2019,237066,42,4,11,6,5
2019,237066,50,0,34,18,16
2019,237109,0,0,137,63,74
2019,237109,10,0,137,63,74
2019,237109,10,4,136,63,73
2019,237109,10,6,1,0,1
2019,237109,20,0,70,31,39
2019,237109,20,4,69,31,38
2019,237109,20,6,1,0,1
2019,237109,30,0,6,2,4
2019,237109,30,4,6,2,4
2019,237109,40,0,61,30,31
2019,237109,40,4,61,30,31
2019,237109,42,0,60,30,30
2019,237109,42,4,60,30,30
2019,237109,43,0,1,0,1
2019,237109,43,4,1,0,1
2019,237118,0,0,56,28,28
2019,237118,10,0,56,28,28
2019,237118,10,1,3,3,0
2019,237118,10,2,12,5,7
2019,237118,10,3,40,20,20
2019,237118,10,4,1,0,1
2019,237118,20,0,19,9,10
2019,237118,20,1,3,3,0
2019,237118,20,2,8,3,5
2019,237118,20,3,8,3,5
2019,237118,30,0,37,19,18
2019,237118,30,2,4,2,2
2019,237118,30,3,32,17,15
2019,237118,30,4,1,0,1
2019,237136,0,0,14,8,6
2019,237136,10,0,14,8,6
2019,237136,10,1,4,2,2
2019,237136,10,2,1,0,1
2019,237136,10,3,6,5,1
2019,237136,10,4,3,1,2
2019,237136,40,0,14,8,6
2019,237136,40,1,4,2,2
2019,237136,40,2,1,0,1
2019,237136,40,3,6,5,1
2019,237136,40,4,3,1,2
2019,237136,42,0,14,8,6
2019,237136,42,1,4,2,2
2019,237136,42,2,1,0,1
2019,237136,42,3,6,5,1
2019,237136,42,4,3,1,2
2019,237181,0,0,46,27,19
2019,237181,10,0,46,27,19
2019,237181,10,1,22,11,11
2019,237181,10,2,9,7,2
2019,237181,10,3,15,9,6
2019,237181,20,0,33,20,13
2019,237181,20,1,20,11,9
2019,237181,20,2,6,5,1
2019,237181,20,3,7,4,3
2019,237181,30,0,7,3,4
2019,237181,30,2,1,0,1
2019,237181,30,3,6,3,3
2019,237181,40,0,6,4,2
2019,237181,40,1,2,0,2
2019,237181,40,2,2,2,0
2019,237181,40,3,2,2,0
2019,237181,42,0,6,4,2
2019,237181,42,1,2,0,2
2019,237181,42,2,2,2,0
2019,237181,42,3,2,2,0
2019,237215,0,0,70,36,34
2019,237215,10,0,70,36,34
2019,237215,10,1,18,12,6
2019,237215,10,2,20,13,7
2019,237215,10,3,22,8,14
2019,237215,10,4,8,3,5
2019,237215,10,5,1,0,1
2019,237215,10,6,1,0,1
2019,237215,20,0,37,23,14
2019,237215,20,1,18,12,6
2019,237215,20,2,16,11,5
2019,237215,20,3,3,0,3
2019,237215,30,0,17,9,8
2019,237215,30,2,3,2,1
2019,237215,30,3,14,7,7
2019,237215,40,0,16,4,12
2019,237215,40,2,1,0,1
2019,237215,40,3,5,1,4
2019,237215,40,4,8,3,5
2019,237215,40,5,1,0,1
2019,237215,40,6,1,0,1
2019,237215,42,0,16,4,12
2019,237215,42,2,1,0,1
2019,237215,42,3,5,1,4
2019,237215,42,4,8,3,5
2019,237215,42,5,1,0,1
2019,237215,42,6,1,0,1
2019,237312,0,0,112,43,69
2019,237312,10,0,112,43,69
2019,237312,10,1,8,4,4
2019,237312,10,2,25,14,11
2019,237312,10,3,66,22,44
2019,237312,10,4,13,3,10
2019,237312,40,0,112,43,69
2019,237312,40,1,8,4,4
2019,237312,40,2,25,14,11
2019,237312,40,3,66,22,44
2019,237312,40,4,13,3,10
2019,237312,41,0,72,27,45
2019,237312,41,1,7,3,4
2019,237312,41,2,20,11,9
2019,237312,41,3,38,11,27
2019,237312,41,4,7,2,5
2019,237312,42,0,36,12,24
2019,237312,42,1,1,1,0
2019,237312,42,2,4,2,2
2019,237312,42,3,25,8,17
2019,237312,42,4,6,1,5
2019,237312,43,0,4,4,0
2019,237312,43,2,1,1,0
2019,237312,43,3,3,3,0
2019,237312,44,0,72,27,45
2019,237312,44,1,7,3,4
2019,237312,44,2,20,11,9
2019,237312,44,3,38,11,27
2019,237312,44,4,7,2,5
2019,237330,0,0,104,56,48
2019,237330,10,0,104,56,48
2019,237330,10,1,33,18,15
2019,237330,10,2,20,10,10
2019,237330,10,3,32,18,14
2019,237330,10,4,19,10,9
2019,237330,20,0,50,27,23
2019,237330,20,1,33,18,15
2019,237330,20,2,16,9,7
2019,237330,20,3,1,0,1
2019,237330,30,0,23,11,12
2019,237330,30,2,4,1,3
2019,237330,30,3,19,10,9
2019,237330,40,0,31,18,13
2019,237330,40,3,12,8,4
2019,237330,40,4,19,10,9
2019,237330,42,0,31,18,13
2019,237330,42,3,12,8,4
2019,237330,42,4,19,10,9
2019,237358,0,0,44,17,27
2019,237358,10,0,44,17,27
2019,237358,10,1,14,5,9
2019,237358,10,2,9,4,5
2019,237358,10,3,16,6,10
2019,237358,10,4,5,2,3
2019,237358,20,0,18,6,12
2019,237358,20,1,13,5,8
2019,237358,20,2,5,1,4
2019,237358,30,0,1,0,1
2019,237358,30,3,1,0,1
2019,237358,40,0,25,11,14
2019,237358,40,1,1,0,1
2019,237358,40,2,4,3,1
2019,237358,40,3,15,6,9
2019,237358,40,4,5,2,3
2019,237358,41,0,10,5,5
2019,237358,41,2,2,2,0
2019,237358,41,3,7,3,4
2019,237358,41,4,1,0,1
2019,237358,42,0,15,6,9
2019,237358,42,1,1,0,1
2019,237358,42,2,2,1,1
2019,237358,42,3,8,3,5
2019,237358,42,4,4,2,2
2019,237358,44,0,10,5,5
2019,237358,44,2,2,2,0
2019,237358,44,3,7,3,4
2019,237358,44,4,1,0,1
2019,237367,0,0,157,79,78
2019,237367,10,0,141,74,67
2019,237367,10,1,48,28,20
2019,237367,10,2,33,18,15
2019,237367,10,3,51,24,27
2019,237367,10,4,9,4,5
2019,237367,20,0,82,44,38
2019,237367,20,1,47,27,20
2019,237367,20,2,27,13,14
2019,237367,20,3,8,4,4
2019,237367,30,0,32,16,16
2019,237367,30,2,5,4,1
2019,237367,30,3,25,11,14
2019,237367,30,4,2,1,1
2019,237367,40,0,27,14,13
2019,237367,40,1,1,1,0
2019,237367,40,2,1,1,0
2019,237367,40,3,18,9,9
2019,237367,40,4,7,3,4
2019,237367,42,0,27,14,13
2019,237367,42,1,1,1,0
2019,237367,42,2,1,1,0
2019,237367,42,3,18,9,9
2019,237367,42,4,7,3,4
2019,237367,50,0,16,5,11
2019,237385,0,0,59,37,22
2019,237385,10,0,59,37,22
2019,237385,10,1,10,8,2
2019,237385,10,2,20,13,7
2019,237385,10,3,19,12,7
2019,237385,10,5,10,4,6
2019,237385,20,0,29,21,8
2019,237385,20,1,10,8,2
2019,237385,20,2,19,13,6
2019,237385,30,0,20,12,8
2019,237385,30,2,1,0,1
2019,237385,30,3,19,12,7
2019,237385,40,0,10,4,6
2019,237385,40,5,10,4,6
2019,237385,42,0,10,4,6
2019,237385,42,5,10,4,6
2019,237437,0,0,12,3,9
2019,237437,50,0,12,3,9
2019,237525,0,0,834,467,367
2019,237525,10,0,834,467,367
2019,237525,10,1,245,161,84
2019,237525,10,2,208,119,89
2019,237525,10,3,306,165,141
2019,237525,10,4,75,22,53
2019,237525,20,0,394,236,158
2019,237525,20,1,232,151,81
2019,237525,20,2,160,85,75
2019,237525,20,3,2,0,2
2019,237525,30,0,172,89,83
2019,237525,30,1,4,4,0
2019,237525,30,2,12,5,7
2019,237525,30,3,156,80,76
2019,237525,40,0,268,142,126
2019,237525,40,1,9,6,3
2019,237525,40,2,36,29,7
2019,237525,40,3,148,85,63
2019,237525,40,4,75,22,53
2019,237525,41,0,78,31,47
2019,237525,41,1,1,0,1
2019,237525,41,3,13,11,2
2019,237525,41,4,64,20,44
2019,237525,42,0,190,111,79
2019,237525,42,1,8,6,2
2019,237525,42,2,36,29,7
2019,237525,42,3,135,74,61
2019,237525,42,4,11,2,9
2019,237525,44,0,78,31,47
2019,237525,44,1,1,0,1
2019,237525,44,3,13,11,2
2019,237525,44,4,64,20,44
2019,237640,0,0,13,7,6
2019,237640,10,0,13,7,6
2019,237640,10,1,4,3,1
2019,237640,10,2,1,0,1
2019,237640,10,3,7,4,3
2019,237640,10,4,1,0,1
2019,237640,20,0,1,0,1
2019,237640,20,1,1,0,1
2019,237640,40,0,12,7,5
2019,237640,40,1,3,3,0
2019,237640,40,2,1,0,1
2019,237640,40,3,7,4,3
2019,237640,40,4,1,0,1
2019,237640,42,0,12,7,5
2019,237640,42,1,3,3,0
2019,237640,42,2,1,0,1
2019,237640,42,3,7,4,3
2019,237640,42,4,1,0,1
2019,237686,0,0,76,34,42
2019,237686,10,0,76,34,42
2019,237686,10,1,19,12,7
2019,237686,10,2,17,6,11
2019,237686,10,3,19,13,6
2019,237686,10,4,21,3,18
2019,237686,20,0,13,8,5
2019,237686,20,1,13,8,5
2019,237686,40,0,63,26,37
2019,237686,40,1,6,4,2
2019,237686,40,2,17,6,11
2019,237686,40,3,19,13,6
2019,237686,40,4,21,3,18
2019,237686,41,0,18,9,9
2019,237686,41,1,4,4,0
2019,237686,41,2,11,2,9
2019,237686,41,3,3,3,0
2019,237686,42,0,45,17,28
2019,237686,42,1,2,0,2
2019,237686,42,2,6,4,2
2019,237686,42,3,16,10,6
2019,237686,42,4,21,3,18
2019,237686,44,0,18,9,9
2019,237686,44,1,4,4,0
2019,237686,44,2,11,2,9
2019,237686,44,3,3,3,0
2019,237701,0,0,53,23,30
2019,237701,10,0,53,23,30
2019,237701,10,1,9,6,3
2019,237701,10,2,9,4,5
2019,237701,10,3,11,5,6
2019,237701,10,4,23,7,16
2019,237701,10,6,1,1,0
2019,237701,20,0,19,10,9
2019,237701,20,1,9,6,3
2019,237701,20,2,8,3,5
2019,237701,20,3,1,0,1
2019,237701,20,6,1,1,0
2019,237701,30,0,26,10,16
2019,237701,30,3,9,5,4
2019,237701,30,4,17,5,12
2019,237701,40,0,8,3,5
2019,237701,40,2,1,1,0
2019,237701,40,3,1,0,1
2019,237701,40,4,6,2,4
2019,237701,42,0,8,3,5
2019,237701,42,2,1,1,0
2019,237701,42,3,1,0,1
2019,237701,42,4,6,2,4
2019,237783,0,0,32,17,15
2019,237783,10,0,32,17,15
2019,237783,10,1,12,7,5
2019,237783,10,2,13,7,6
2019,237783,10,3,7,3,4
2019,237783,40,0,32,17,15
2019,237783,40,1,12,7,5
2019,237783,40,2,13,7,6
2019,237783,40,3,7,3,4
2019,237783,41,0,32,17,15
2019,237783,41,1,12,7,5
2019,237783,41,2,13,7,6
2019,237783,41,3,7,3,4
2019,237783,45,0,32,17,15
2019,237783,45,1,12,7,5
2019,237783,45,2,13,7,6
2019,237783,45,3,7,3,4
2019,237792,0,0,143,72,71
2019,237792,10,0,143,72,71
2019,237792,10,1,36,21,15
2019,237792,10,2,52,25,27
2019,237792,10,3,33,17,16
2019,237792,10,5,19,9,10
2019,237792,10,6,3,0,3
2019,237792,20,0,86,46,40
2019,237792,20,1,36,21,15
2019,237792,20,2,49,24,25
2019,237792,20,3,1,1,0
2019,237792,30,0,33,17,16
2019,237792,30,2,3,1,2
2019,237792,30,3,29,15,14
2019,237792,30,5,1,1,0
2019,237792,40,0,24,9,15
2019,237792,40,3,3,1,2
2019,237792,40,5,18,8,10
2019,237792,40,6,3,0,3
2019,237792,41,0,2,1,1
2019,237792,41,3,1,0,1
2019,237792,41,5,1,1,0
2019,237792,42,0,22,8,14
2019,237792,42,3,2,1,1
2019,237792,42,5,17,7,10
2019,237792,42,6,3,0,3
2019,237792,44,0,2,1,1
2019,237792,44,3,1,0,1
2019,237792,44,5,1,1,0
2019,237817,0,0,58,23,35
2019,237817,10,0,58,23,35
2019,237817,10,1,11,4,7
2019,237817,10,2,11,2,9
2019,237817,10,3,12,7,5
2019,237817,10,4,24,10,14
2019,237817,20,0,5,2,3
2019,237817,20,1,3,1,2
2019,237817,20,2,1,1,0
2019,237817,20,3,1,0,1
2019,237817,40,0,53,21,32
2019,237817,40,1,8,3,5
2019,237817,40,2,10,1,9
2019,237817,40,3,11,7,4
2019,237817,40,4,24,10,14
2019,237817,42,0,53,21,32
2019,237817,42,1,8,3,5
2019,237817,42,2,10,1,9
2019,237817,42,3,11,7,4
2019,237817,42,4,24,10,14
2019,237880,0,0,57,26,31
2019,237880,10,0,57,26,31
2019,237880,10,1,14,8,6
2019,237880,10,2,17,5,12
2019,237880,10,3,23,11,12
2019,237880,10,4,1,0,1
2019,237880,10,6,2,2,0
2019,237880,20,0,29,11,18
2019,237880,20,1,13,7,6
2019,237880,20,2,14,4,10
2019,237880,20,3,2,0,2
2019,237880,30,0,19,10,9
2019,237880,30,2,1,1,0
2019,237880,30,3,17,9,8
2019,237880,30,4,1,0,1
2019,237880,40,0,9,5,4
2019,237880,40,1,1,1,0
2019,237880,40,2,2,0,2
2019,237880,40,3,4,2,2
2019,237880,40,6,2,2,0
2019,237880,41,0,9,5,4
2019,237880,41,1,1,1,0
2019,237880,41,2,2,0,2
2019,237880,41,3,4,2,2
2019,237880,41,6,2,2,0
2019,237880,45,0,9,5,4
2019,237880,45,1,1,1,0
2019,237880,45,2,2,0,2
2019,237880,45,3,4,2,2
2019,237880,45,6,2,2,0
2019,237899,0,0,118,72,46
2019,237899,10,0,118,72,46
2019,237899,10,1,27,19,8
2019,237899,10,2,33,20,13
2019,237899,10,3,38,26,12
2019,237899,10,4,16,6,10
2019,237899,10,6,4,1,3
2019,237899,20,0,32,15,17
2019,237899,20,1,17,9,8
2019,237899,20,2,11,4,7
2019,237899,20,3,4,2,2
2019,237899,30,0,30,22,8
2019,237899,30,1,6,6,0
2019,237899,30,2,15,11,4
2019,237899,30,3,8,5,3
2019,237899,30,6,1,0,1
2019,237899,40,0,56,35,21
2019,237899,40,1,4,4,0
2019,237899,40,2,7,5,2
2019,237899,40,3,26,19,7
2019,237899,40,4,16,6,10
2019,237899,40,6,3,1,2
2019,237899,42,0,49,29,20
2019,237899,42,1,4,4,0
2019,237899,42,2,7,5,2
2019,237899,42,3,19,13,6
2019,237899,42,4,16,6,10
2019,237899,42,6,3,1,2
2019,237899,43,0,7,6,1
2019,237899,43,3,7,6,1
2019,237932,0,0,144,74,70
2019,237932,10,0,144,74,70
2019,237932,10,1,34,21,13
2019,237932,10,2,39,23,16
2019,237932,10,3,47,19,28
2019,237932,10,4,21,9,12
2019,237932,10,5,3,2,1
2019,237932,20,0,61,36,25
2019,237932,20,1,34,21,13
2019,237932,20,2,26,15,11
2019,237932,20,3,1,0,1
2019,237932,30,0,34,17,17
2019,237932,30,2,10,7,3
2019,237932,30,3,24,10,14
2019,237932,40,0,49,21,28
2019,237932,40,2,3,1,2
2019,237932,40,3,22,9,13
2019,237932,40,4,21,9,12
2019,237932,40,5,3,2,1
2019,237932,42,0,49,21,28
2019,237932,42,2,3,1,2
2019,237932,42,3,22,9,13
2019,237932,42,4,21,9,12
2019,237932,42,5,3,2,1
2019,237950,0,0,87,54,33
2019,237950,10,0,87,54,33
2019,237950,10,1,15,11,4
2019,237950,10,2,20,13,7
2019,237950,10,3,44,29,15
2019,237950,10,4,7,0,7
2019,237950,10,6,1,1,0
2019,237950,20,0,34,22,12
2019,237950,20,1,15,11,4
2019,237950,20,2,17,10,7
2019,237950,20,3,1,0,1
2019,237950,20,6,1,1,0
2019,237950,30,0,35,27,8
2019,237950,30,2,3,3,0
2019,237950,30,3,32,24,8
2019,237950,40,0,18,5,13
2019,237950,40,3,11,5,6
2019,237950,40,4,7,0,7
2019,237950,42,0,18,5,13
2019,237950,42,3,11,5,6
2019,237950,42,4,7,0,7
2019,237969,0,0,65,29,36
2019,237969,10,0,65,29,36
2019,237969,10,1,6,3,3
2019,237969,10,2,25,8,17
2019,237969,10,3,32,16,16
2019,237969,10,4,2,2,0
2019,237969,20,0,36,14,22
2019,237969,20,1,6,3,3
2019,237969,20,2,25,8,17
2019,237969,20,3,5,3,2
2019,237969,30,0,17,8,9
2019,237969,30,3,17,8,9
2019,237969,40,0,12,7,5
2019,237969,40,3,10,5,5
2019,237969,40,4,2,2,0
2019,237969,42,0,12,7,5
2019,237969,42,3,10,5,5
2019,237969,42,4,2,2,0
2019,237987,0,0,5,1,4
2019,237987,50,0,5,1,4
2019,237996,0,0,12,0,12
2019,237996,50,0,12,0,12
2019,238014,0,0,48,19,29
2019,238014,10,0,48,19,29
2019,238014,10,1,7,3,4
2019,238014,10,2,5,2,3
2019,238014,10,3,12,6,6
2019,238014,10,4,24,8,16
2019,238014,20,0,4,1,3
2019,238014,20,1,4,1,3
2019,238014,40,0,44,18,26
2019,238014,40,1,3,2,1
2019,238014,40,2,5,2,3
2019,238014,40,3,12,6,6
2019,238014,40,4,24,8,16
2019,238014,42,0,44,18,26
2019,238014,42,1,3,2,1
2019,238014,42,2,5,2,3
2019,238014,42,3,12,6,6
2019,238014,42,4,24,8,16
2019,238032,0,0,1359,761,598
2019,238032,10,0,1359,761,598
2019,238032,10,1,389,281,108
2019,238032,10,2,413,223,190
2019,238032,10,3,420,193,227
2019,238032,10,4,72,25,47
2019,238032,10,5,1,1,0
2019,238032,10,6,64,38,26
2019,238032,20,0,663,440,223
2019,238032,20,1,327,240,87
2019,238032,20,2,272,163,109
2019,238032,20,3,1,0,1
2019,238032,20,6,63,37,26
2019,238032,30,0,260,154,106
2019,238032,30,1,17,15,2
2019,238032,30,2,27,15,12
2019,238032,30,3,215,123,92
2019,238032,30,6,1,1,0
2019,238032,40,0,436,167,269
2019,238032,40,1,45,26,19
2019,238032,40,2,114,45,69
2019,238032,40,3,204,70,134
2019,238032,40,4,72,25,47
2019,238032,40,5,1,1,0
2019,238032,42,0,436,167,269
2019,238032,42,1,45,26,19
2019,238032,42,2,114,45,69
2019,238032,42,3,204,70,134
2019,238032,42,4,72,25,47
2019,238032,42,5,1,1,0
2019,238078,0,0,33,14,19
2019,238078,10,0,33,14,19
2019,238078,10,1,6,5,1
2019,238078,10,2,11,5,6
2019,238078,10,3,14,4,10
2019,238078,10,4,2,0,2
2019,238078,20,0,20,8,12
2019,238078,20,1,5,4,1
2019,238078,20,2,10,4,6
2019,238078,20,3,5,0,5
2019,238078,30,0,3,2,1
2019,238078,30,3,2,2,0
2019,238078,30,4,1,0,1
2019,238078,40,0,10,4,6
2019,238078,40,1,1,1,0
2019,238078,40,2,1,1,0
2019,238078,40,3,7,2,5
2019,238078,40,4,1,0,1
2019,238078,41,0,6,3,3
2019,238078,41,1,1,1,0
2019,238078,41,3,4,2,2
2019,238078,41,4,1,0,1
2019,238078,42,0,4,1,3
2019,238078,42,2,1,1,0
2019,238078,42,3,3,0,3
2019,238078,44,0,6,3,3
2019,238078,44,1,1,1,0
2019,238078,44,3,4,2,2
2019,238078,44,4,1,0,1
2019,238193,0,0,88,19,69
2019,238193,10,0,88,19,69
2019,238193,10,1,28,7,21
2019,238193,10,2,21,5,16
2019,238193,10,3,39,7,32
2019,238193,20,0,42,12,30
2019,238193,20,1,27,7,20
2019,238193,20,2,13,4,9
2019,238193,20,3,2,1,1
2019,238193,30,0,39,7,32
2019,238193,30,1,1,0,1
2019,238193,30,2,8,1,7
2019,238193,30,3,30,6,24
2019,238193,40,0,7,0,7
2019,238193,40,3,7,0,7
2019,238193,42,0,7,0,7
2019,238193,42,3,7,0,7
2019,238263,0,0,442,204,238
2019,238263,10,0,442,204,238
2019,238263,10,4,442,204,238
2019,238263,40,0,442,204,238
2019,238263,40,4,442,204,238
2019,238263,42,0,442,204,238
2019,238263,42,4,442,204,238
2019,238324,0,0,19,2,17
2019,238324,10,0,19,2,17
2019,238324,10,3,8,1,7
2019,238324,10,4,11,1,10
2019,238324,40,0,19,2,17
2019,238324,40,3,8,1,7
2019,238324,40,4,11,1,10
2019,238324,42,0,19,2,17
2019,238324,42,3,8,1,7
2019,238324,42,4,11,1,10
2019,238333,0,0,96,42,54
2019,238333,10,0,96,42,54
2019,238333,10,1,34,18,16
2019,238333,10,2,33,11,22
2019,238333,10,3,27,12,15
2019,238333,10,6,2,1,1
2019,238333,20,0,63,28,35
2019,238333,20,1,34,18,16
2019,238333,20,2,29,10,19
2019,238333,30,0,16,8,8
2019,238333,30,2,1,1,0
2019,238333,30,3,15,7,8
2019,238333,40,0,17,6,11
2019,238333,40,2,3,0,3
2019,238333,40,3,12,5,7
2019,238333,40,6,2,1,1
2019,238333,41,0,9,2,7
2019,238333,41,2,3,0,3
2019,238333,41,3,4,1,3
2019,238333,41,6,2,1,1
2019,238333,42,0,8,4,4
2019,238333,42,3,8,4,4
2019,238333,44,0,9,2,7
2019,238333,44,2,3,0,3
2019,238333,44,3,4,1,3
2019,238333,44,6,2,1,1
2019,238397,0,0,84,39,45
2019,238397,10,0,84,39,45
2019,238397,10,4,84,39,45
2019,238397,40,0,84,39,45
2019,238397,40,4,84,39,45
2019,238397,42,0,84,39,45
2019,238397,42,4,84,39,45
2019,238430,0,0,74,27,47
2019,238430,10,0,74,27,47
2019,238430,10,1,9,4,5
2019,238430,10,2,13,6,7
2019,238430,10,3,51,17,34
2019,238430,10,4,1,0,1
2019,238430,20,0,36,18,18
2019,238430,20,1,8,4,4
2019,238430,20,2,13,6,7
2019,238430,20,3,15,8,7
2019,238430,30,0,8,3,5
2019,238430,30,1,1,0,1
2019,238430,30,3,7,3,4
2019,238430,40,0,30,6,24
2019,238430,40,3,29,6,23
2019,238430,40,4,1,0,1
2019,238430,42,0,30,6,24
2019,238430,42,3,29,6,23
2019,238430,42,4,1,0,1
2019,238458,0,0,139,49,90
2019,238458,10,0,139,49,90
2019,238458,10,1,18,9,9
2019,238458,10,2,34,12,22
2019,238458,10,3,45,14,31
2019,238458,10,5,42,14,28
2019,238458,20,0,43,19,24
2019,238458,20,1,16,7,9
2019,238458,20,2,26,11,15
2019,238458,20,3,1,1,0
2019,238458,30,0,19,9,10
2019,238458,30,3,19,9,10
2019,238458,40,0,77,21,56
2019,238458,40,1,2,2,0
2019,238458,40,2,8,1,7
2019,238458,40,3,25,4,21
2019,238458,40,5,42,14,28
2019,238458,41,0,62,19,43
2019,238458,41,1,2,2,0
2019,238458,41,2,7,1,6
2019,238458,41,3,21,4,17
2019,238458,41,5,32,12,20
2019,238458,42,0,15,2,13
2019,238458,42,2,1,0,1
2019,238458,42,3,4,0,4
2019,238458,42,5,10,2,8
2019,238458,44,0,62,19,43
2019,238458,44,1,2,2,0
2019,238458,44,2,7,1,6
2019,238458,44,3,21,4,17
2019,238458,44,5,32,12,20
2019,238476,0,0,172,98,74
2019,238476,10,0,172,98,74
2019,238476,10,1,42,31,11
2019,238476,10,2,57,34,23
2019,238476,10,3,72,32,40
2019,238476,10,5,1,1,0
2019,238476,20,0,83,58,25
2019,238476,20,1,40,30,10
2019,238476,20,2,43,28,15
2019,238476,30,0,36,13,23
2019,238476,30,2,3,2,1
2019,238476,30,3,33,11,22
2019,238476,40,0,53,27,26
2019,238476,40,1,2,1,1
2019,238476,40,2,11,4,7
2019,238476,40,3,39,21,18
2019,238476,40,5,1,1,0
2019,238476,41,0,49,25,24
2019,238476,41,1,2,1,1
2019,238476,41,2,11,4,7
2019,238476,41,3,35,19,16
2019,238476,41,5,1,1,0
2019,238476,42,0,4,2,2
2019,238476,42,3,4,2,2
2019,238476,44,0,49,25,24
2019,238476,44,1,2,1,1
2019,238476,44,2,11,4,7
2019,238476,44,3,35,19,16
2019,238476,44,5,1,1,0
2019,238573,0,0,11,1,10
2019,238573,10,0,11,1,10
2019,238573,10,1,1,0,1
2019,238573,10,2,4,1,3
2019,238573,10,3,6,0,6
2019,238573,40,0,11,1,10
2019,238573,40,1,1,0,1
2019,238573,40,2,4,1,3
2019,238573,40,3,6,0,6
2019,238573,42,0,11,1,10
2019,238573,42,1,1,0,1
2019,238573,42,2,4,1,3
2019,238573,42,3,6,0,6
2019,238616,0,0,237,91,146
2019,238616,10,0,237,91,146
2019,238616,10,1,58,18,40
2019,238616,10,2,80,42,38
2019,238616,10,3,94,30,64
2019,238616,10,4,5,1,4
2019,238616,40,0,237,91,146
2019,238616,40,1,58,18,40
2019,238616,40,2,80,42,38
2019,238616,40,3,94,30,64
2019,238616,40,4,5,1,4
2019,238616,41,0,226,89,137
2019,238616,41,1,58,18,40
2019,238616,41,2,80,42,38
2019,238616,41,3,88,29,59
2019,238616,42,0,5,1,4
2019,238616,42,4,5,1,4
2019,238616,43,0,6,1,5
2019,238616,43,3,6,1,5
2019,238616,44,0,226,89,137
2019,238616,44,1,58,18,40
2019,238616,44,2,80,42,38
2019,238616,44,3,88,29,59
2019,238661,0,0,144,50,94
2019,238661,10,0,144,50,94
2019,238661,10,1,25,14,11
2019,238661,10,2,42,14,28
2019,238661,10,3,18,4,14
2019,238661,10,4,6,0,6
2019,238661,10,5,53,18,35
2019,238661,20,0,58,25,33
2019,238661,20,1,25,14,11
2019,238661,20,2,33,11,22
2019,238661,30,0,23,6,17
2019,238661,30,2,9,3,6
2019,238661,30,3,14,3,11
2019,238661,40,0,63,19,44
2019,238661,40,3,4,1,3
2019,238661,40,4,6,0,6
2019,238661,40,5,53,18,35
2019,238661,42,0,56,19,37
2019,238661,42,3,4,1,3
2019,238661,42,4,3,0,3
2019,238661,42,5,49,18,31
2019,238661,43,0,7,0,7
2019,238661,43,4,3,0,3
2019,238661,43,5,4,0,4
2019,238722,0,0,311,176,135
2019,238722,10,0,311,176,135
2019,238722,10,6,311,176,135
2019,238722,40,0,311,176,135
2019,238722,40,6,311,176,135
2019,238722,41,0,311,176,135
2019,238722,41,6,311,176,135
2019,238722,44,0,311,176,135
2019,238722,44,6,311,176,135
2019,238759,0,0,225,99,126
2019,238759,10,0,225,99,126
2019,238759,10,6,225,99,126
2019,238759,40,0,225,99,126
2019,238759,40,6,225,99,126
2019,238759,42,0,225,99,126
2019,238759,42,6,225,99,126
2019,238980,0,0,41,22,19
2019,238980,10,0,41,22,19
2019,238980,10,1,9,7,2
2019,238980,10,2,14,9,5
2019,238980,10,3,12,5,7
2019,238980,10,4,6,1,5
2019,238980,20,0,21,14,7
2019,238980,20,1,9,7,2
2019,238980,20,2,12,7,5
2019,238980,30,0,9,6,3
2019,238980,30,2,1,1,0
2019,238980,30,3,8,5,3
2019,238980,40,0,11,2,9
2019,238980,40,2,1,1,0
2019,238980,40,3,4,0,4
2019,238980,40,4,6,1,5
2019,238980,42,0,10,2,8
2019,238980,42,2,1,1,0
2019,238980,42,3,4,0,4
2019,238980,42,4,5,1,4
2019,238980,43,0,1,0,1
2019,238980,43,4,1,0,1
2019,239008,0,0,109,50,59
2019,239008,10,0,109,50,59
2019,239008,10,4,109,50,59
2019,239008,40,0,109,50,59
2019,239008,40,4,109,50,59
2019,239008,42,0,109,50,59
2019,239008,42,4,109,50,59
2019,239017,0,0,176,95,81
2019,239017,10,0,176,95,81
2019,239017,10,1,38,29,9
2019,239017,10,2,69,38,31
2019,239017,10,3,50,20,30
2019,239017,10,4,19,8,11
2019,239017,20,0,106,67,39
2019,239017,20,1,38,29,9
2019,239017,20,2,68,38,30
2019,239017,30,0,40,15,25
2019,239017,30,2,1,0,1
2019,239017,30,3,39,15,24
2019,239017,40,0,30,13,17
2019,239017,40,3,11,5,6
2019,239017,40,4,19,8,11
2019,239017,41,0,22,8,14
2019,239017,41,3,8,3,5
2019,239017,41,4,14,5,9
2019,239017,42,0,8,5,3
2019,239017,42,3,3,2,1
2019,239017,42,4,5,3,2
2019,239017,44,0,20,8,12
2019,239017,44,3,7,3,4
2019,239017,44,4,13,5,8
2019,239017,45,0,2,0,2
2019,239017,45,3,1,0,1
2019,239017,45,4,1,0,1
2019,239071,0,0,37,25,12
2019,239071,10,0,37,25,12
2019,239071,10,1,13,11,2
2019,239071,10,2,19,12,7
2019,239071,10,3,5,2,3
2019,239071,40,0,37,25,12
2019,239071,40,1,13,11,2
2019,239071,40,2,19,12,7
2019,239071,40,3,5,2,3
2019,239071,42,0,37,25,12
2019,239071,42,1,13,11,2
2019,239071,42,2,19,12,7
2019,239071,42,3,5,2,3
2019,239080,0,0,72,25,47
2019,239080,10,0,71,25,46
2019,239080,10,1,11,6,5
2019,239080,10,2,20,6,14
2019,239080,10,3,37,11,26
2019,239080,10,4,3,2,1
2019,239080,20,0,21,12,9
2019,239080,20,1,10,6,4
2019,239080,20,2,9,5,4
2019,239080,20,3,2,1,1
2019,239080,30,0,24,8,16
2019,239080,30,1,1,0,1
2019,239080,30,2,3,1,2
2019,239080,30,3,20,7,13
2019,239080,40,0,26,5,21
2019,239080,40,2,8,0,8
2019,239080,40,3,15,3,12
2019,239080,40,4,3,2,1
2019,239080,42,0,26,5,21
2019,239080,42,2,8,0,8
2019,239080,42,3,15,3,12
2019,239080,42,4,3,2,1
2019,239080,50,0,1,0,1
2019,239105,0,0,696,376,320
2019,239105,10,0,696,376,320
2019,239105,10,1,153,108,45
2019,239105,10,2,214,109,105
2019,239105,10,3,228,114,114
2019,239105,10,4,47,18,29
2019,239105,10,5,4,3,1
2019,239105,10,6,50,24,26
2019,239105,20,0,294,184,110
2019,239105,20,1,130,96,34
2019,239105,20,2,164,88,76
2019,239105,30,0,161,82,79
2019,239105,30,2,6,3,3
2019,239105,30,3,155,79,76
2019,239105,40,0,241,110,131
2019,239105,40,1,23,12,11
2019,239105,40,2,44,18,26
2019,239105,40,3,73,35,38
2019,239105,40,4,47,18,29
2019,239105,40,5,4,3,1
2019,239105,40,6,50,24,26
2019,239105,42,0,241,110,131
2019,239105,42,1,23,12,11
2019,239105,42,2,44,18,26
2019,239105,42,3,73,35,38
2019,239105,42,4,47,18,29
2019,239105,42,5,4,3,1
2019,239105,42,6,50,24,26
2019,239169,0,0,1739,1065,674
2019,239169,10,0,1739,1065,674
2019,239169,10,1,394,287,107
2019,239169,10,2,374,223,151
2019,239169,10,3,743,417,326
2019,239169,10,4,165,101,64
2019,239169,10,5,63,37,26
2019,239169,20,0,159,119,40
2019,239169,20,1,156,117,39
2019,239169,20,2,3,2,1
2019,239169,30,0,929,566,363
2019,239169,30,1,210,149,61
2019,239169,30,2,315,186,129
2019,239169,30,3,403,230,173
2019,239169,30,4,1,1,0
2019,239169,40,0,651,380,271
2019,239169,40,1,28,21,7
2019,239169,40,2,56,35,21
2019,239169,40,3,340,187,153
2019,239169,40,4,164,100,64
2019,239169,40,5,63,37,26
2019,239169,41,0,569,330,239
2019,239169,41,1,28,21,7
2019,239169,41,2,56,35,21
2019,239169,41,3,340,187,153
2019,239169,41,4,82,50,32
2019,239169,41,5,63,37,26
2019,239169,42,0,82,50,32
2019,239169,42,4,82,50,32
2019,239169,44,0,569,330,239
2019,239169,44,1,28,21,7
2019,239169,44,2,56,35,21
2019,239169,44,3,340,187,153
2019,239169,44,4,82,50,32
2019,239169,44,5,63,37,26
2019,239220,0,0,85,40,45
2019,239220,10,0,85,40,45
2019,239220,10,4,85,40,45
2019,239220,40,0,85,40,45
2019,239220,40,4,85,40,45
2019,239220,43,0,85,40,45
2019,239220,43,4,85,40,45
2019,239248,0,0,521,248,273
2019,239248,10,0,521,248,273
2019,239248,10,6,521,248,273
2019,239248,40,0,521,248,273
2019,239248,40,6,521,248,273
2019,239248,42,0,521,248,273
2019,239248,42,6,521,248,273
2019,239309,0,0,52,31,21
2019,239309,10,0,51,30,21
2019,239309,10,1,22,14,8
2019,239309,10,2,4,4,0
2019,239309,10,3,5,1,4
2019,239309,10,4,20,11,9
2019,239309,40,0,51,30,21
2019,239309,40,1,22,14,8
2019,239309,40,2,4,4,0
2019,239309,40,3,5,1,4
2019,239309,40,4,20,11,9
2019,239309,41,0,6,2,4
2019,239309,41,1,3,2,1
2019,239309,41,3,3,0,3
2019,239309,42,0,45,28,17
2019,239309,42,1,19,12,7
2019,239309,42,2,4,4,0
2019,239309,42,3,2,1,1
2019,239309,42,4,20,11,9
2019,239309,44,0,6,2,4
2019,239309,44,1,3,2,1
2019,239309,44,3,3,0,3
2019,239309,50,0,1,1,0
2019,239318,0,0,157,104,53
2019,239318,10,0,157,104,53
2019,239318,10,1,41,30,11
2019,239318,10,2,47,32,15
2019,239318,10,3,49,32,17
2019,239318,10,4,20,10,10
2019,239318,40,0,157,104,53
2019,239318,40,1,41,30,11
2019,239318,40,2,47,32,15
2019,239318,40,3,49,32,17
2019,239318,40,4,20,10,10
2019,239318,41,0,137,94,43
2019,239318,41,1,41,30,11
2019,239318,41,2,47,32,15
2019,239318,41,3,49,32,17
2019,239318,42,0,20,10,10
2019,239318,42,4,20,10,10
2019,239318,44,0,137,94,43
2019,239318,44,1,41,30,11
2019,239318,44,2,47,32,15
2019,239318,44,3,49,32,17
2019,239372,0,0,142,64,78
2019,239372,10,0,142,64,78
2019,239372,10,4,142,64,78
2019,239372,40,0,142,64,78
2019,239372,40,4,142,64,78
2019,239372,42,0,142,64,78
2019,239372,42,4,142,64,78
2019,239390,0,0,61,7,54
2019,239390,10,0,61,7,54
2019,239390,10,1,8,1,7
2019,239390,10,2,20,2,18
2019,239390,10,3,27,3,24
2019,239390,10,4,5,1,4
2019,239390,10,6,1,0,1
2019,239390,20,0,28,3,25
2019,239390,20,1,7,1,6
2019,239390,20,2,18,2,16
2019,239390,20,3,3,0,3
2019,239390,30,0,19,3,16
2019,239390,30,1,1,0,1
2019,239390,30,2,2,0,2
2019,239390,30,3,16,3,13
2019,239390,40,0,14,1,13
2019,239390,40,3,8,0,8
2019,239390,40,4,5,1,4
2019,239390,40,6,1,0,1
2019,239390,42,0,14,1,13
2019,239390,42,3,8,0,8
2019,239390,42,4,5,1,4
2019,239390,42,6,1,0,1
2019,239424,0,0,7,6,1
2019,239424,10,0,7,6,1
2019,239424,10,1,2,2,0
2019,239424,10,2,1,1,0
2019,239424,10,3,4,3,1
2019,239424,20,0,2,2,0
2019,239424,20,1,2,2,0
2019,239424,30,0,5,4,1
2019,239424,30,2,1,1,0
2019,239424,30,3,4,3,1
2019,239442,0,0,50,27,23
2019,239442,10,0,50,27,23
2019,239442,10,4,50,27,23
2019,239442,40,0,50,27,23
2019,239442,40,4,50,27,23
2019,239442,42,0,50,27,23
2019,239442,42,4,50,27,23
2019,239460,0,0,137,65,72
2019,239460,10,0,137,65,72
2019,239460,10,4,137,65,72
2019,239460,40,0,137,65,72
2019,239460,40,4,137,65,72
2019,239460,42,0,136,65,71
2019,239460,42,4,136,65,71
2019,239460,43,0,1,0,1
2019,239460,43,4,1,0,1
2019,239488,0,0,264,135,129
2019,239488,10,0,264,135,129
2019,239488,10,6,264,135,129
2019,239488,40,0,264,135,129
2019,239488,40,6,264,135,129
2019,239488,42,0,264,135,129
2019,239488,42,6,264,135,129
2019,239512,0,0,48,27,21
2019,239512,10,0,47,27,20
2019,239512,10,1,13,10,3
2019,239512,10,2,12,7,5
2019,239512,10,3,18,10,8
2019,239512,10,4,4,0,4
2019,239512,20,0,25,17,8
2019,239512,20,1,13,10,3
2019,239512,20,2,12,7,5
2019,239512,30,0,15,8,7
2019,239512,30,3,15,8,7
2019,239512,40,0,7,2,5
2019,239512,40,3,3,2,1
2019,239512,40,4,4,0,4
2019,239512,42,0,7,2,5
2019,239512,42,3,3,2,1
2019,239512,42,4,4,0,4
2019,239512,50,0,1,0,1
2019,239628,0,0,57,33,24
2019,239628,10,0,57,33,24
2019,239628,10,1,14,7,7
2019,239628,10,2,25,18,7
2019,239628,10,3,15,6,9
2019,239628,10,4,3,2,1
2019,239628,20,0,35,22,13
2019,239628,20,1,14,7,7
2019,239628,20,2,21,15,6
2019,239628,30,0,20,10,10
2019,239628,30,2,4,3,1
2019,239628,30,3,15,6,9
2019,239628,30,4,1,1,0
2019,239628,40,0,2,1,1
2019,239628,40,4,2,1,1
2019,239628,42,0,2,1,1
2019,239628,42,4,2,1,1
2019,239637,0,0,10,10,0
2019,239637,10,0,10,10,0
2019,239637,10,1,2,2,0
2019,239637,10,3,7,7,0
2019,239637,10,4,1,1,0
2019,239637,40,0,10,10,0
2019,239637,40,1,2,2,0
2019,239637,40,3,7,7,0
2019,239637,40,4,1,1,0
2019,239637,41,0,10,10,0
2019,239637,41,1,2,2,0
2019,239637,41,3,7,7,0
2019,239637,41,4,1,1,0
2019,239637,44,0,10,10,0
2019,239637,44,1,2,2,0
2019,239637,44,3,7,7,0
2019,239637,44,4,1,1,0
2019,239716,0,0,138,74,64
2019,239716,10,0,133,74,59
2019,239716,10,1,27,20,7
2019,239716,10,2,41,22,19
2019,239716,10,3,61,30,31
2019,239716,10,4,4,2,2
2019,239716,20,0,78,47,31
2019,239716,20,1,27,20,7
2019,239716,20,2,38,21,17
2019,239716,20,3,13,6,7
2019,239716,30,0,42,22,20
2019,239716,30,2,2,1,1
2019,239716,30,3,40,21,19
2019,239716,40,0,13,5,8
2019,239716,40,2,1,0,1
2019,239716,40,3,8,3,5
2019,239716,40,4,4,2,2
2019,239716,42,0,12,5,7
2019,239716,42,2,1,0,1
2019,239716,42,3,7,3,4
2019,239716,42,4,4,2,2
2019,239716,43,0,1,0,1
2019,239716,43,3,1,0,1
2019,239716,50,0,5,0,5
2019,239743,0,0,16,5,11
2019,239743,10,0,16,5,11
2019,239743,10,1,1,1,0
2019,239743,10,2,7,0,7
2019,239743,10,3,6,4,2
2019,239743,10,4,2,0,2
2019,239743,40,0,16,5,11
2019,239743,40,1,1,1,0
2019,239743,40,2,7,0,7
2019,239743,40,3,6,4,2
2019,239743,40,4,2,0,2
2019,239743,42,0,16,5,11
2019,239743,42,1,1,1,0
2019,239743,42,2,7,0,7
2019,239743,42,3,6,4,2
2019,239743,42,4,2,0,2
2019,239910,0,0,78,37,41
2019,239910,10,0,78,37,41
2019,239910,10,4,78,37,41
2019,239910,40,0,78,37,41
2019,239910,40,4,78,37,41
2019,239910,42,0,78,37,41
2019,239910,42,4,78,37,41
2019,240107,0,0,105,41,64
2019,240107,10,0,105,41,64
2019,240107,10,1,23,10,13
2019,240107,10,2,34,16,18
2019,240107,10,3,44,14,30
2019,240107,10,4,4,1,3
2019,240107,20,0,58,24,34
2019,240107,20,1,23,10,13
2019,240107,20,2,31,14,17
2019,240107,20,3,4,0,4
2019,240107,30,0,29,8,21
2019,240107,30,2,2,1,1
2019,240107,30,3,27,7,20
2019,240107,40,0,18,9,9
2019,240107,40,2,1,1,0
2019,240107,40,3,13,7,6
2019,240107,40,4,4,1,3
2019,240107,42,0,18,9,9
2019,240107,42,2,1,1,0
2019,240107,42,3,13,7,6
2019,240107,42,4,4,1,3
2019,240116,0,0,218,103,115
2019,240116,10,0,218,103,115
2019,240116,10,6,218,103,115
2019,240116,40,0,218,103,115
2019,240116,40,6,218,103,115
2019,240116,42,0,215,101,114
2019,240116,42,6,215,101,114
2019,240116,43,0,3,2,1
2019,240116,43,6,3,2,1
2019,240125,0,0,192,89,103
2019,240125,10,0,192,89,103
2019,240125,10,4,189,86,103
2019,240125,10,6,3,3,0
2019,240125,40,0,192,89,103
2019,240125,40,4,189,86,103
2019,240125,40,6,3,3,0
2019,240125,42,0,192,89,103
2019,240125,42,4,189,86,103
2019,240125,42,6,3,3,0
2019,240170,0,0,187,80,107
2019,240170,10,0,187,80,107
2019,240170,10,4,187,80,107
2019,240170,40,0,187,80,107
2019,240170,40,4,187,80,107
2019,240170,42,0,187,80,107
2019,240170,42,4,187,80,107
2019,240189,0,0,514,259,255
2019,240189,10,0,514,259,255
2019,240189,10,1,105,61,44
2019,240189,10,2,153,76,77
2019,240189,10,3,124,61,63
2019,240189,10,5,132,61,71
2019,240189,20,0,255,134,121
2019,240189,20,1,105,61,44
2019,240189,20,2,150,73,77
2019,240189,30,0,117,61,56
2019,240189,30,2,3,3,0
2019,240189,30,3,114,58,56
2019,240189,40,0,142,64,78
2019,240189,40,3,10,3,7
2019,240189,40,5,132,61,71
2019,240189,41,0,124,55,69
2019,240189,41,3,10,3,7
2019,240189,41,5,114,52,62
2019,240189,42,0,15,8,7
2019,240189,42,5,15,8,7
2019,240189,43,0,3,1,2
2019,240189,43,5,3,1,2
2019,240189,44,0,40,19,21
2019,240189,44,5,40,19,21
2019,240189,45,0,84,36,48
2019,240189,45,3,10,3,7
2019,240189,45,5,74,33,41
2019,240198,0,0,158,59,99
2019,240198,10,0,158,59,99
2019,240198,10,4,158,59,99
2019,240198,40,0,158,59,99
2019,240198,40,4,158,59,99
2019,240198,42,0,158,59,99
2019,240198,42,4,158,59,99
2019,240268,0,0,420,205,215
2019,240268,10,0,420,205,215
2019,240268,10,1,148,93,55
2019,240268,10,2,108,49,59
2019,240268,10,3,92,34,58
2019,240268,10,4,8,0,8
2019,240268,10,5,64,29,35
2019,240268,20,0,242,138,104
2019,240268,20,1,148,93,55
2019,240268,20,2,90,43,47
2019,240268,20,3,4,2,2
2019,240268,30,0,91,35,56
2019,240268,30,2,15,6,9
2019,240268,30,3,76,29,47
2019,240268,40,0,87,32,55
2019,240268,40,2,3,0,3
2019,240268,40,3,12,3,9
2019,240268,40,4,8,0,8
2019,240268,40,5,64,29,35
2019,240268,41,0,71,24,47
2019,240268,41,2,3,0,3
2019,240268,41,3,11,3,8
2019,240268,41,4,6,0,6
2019,240268,41,5,51,21,30
2019,240268,42,0,14,7,7
2019,240268,42,3,1,0,1
2019,240268,42,4,2,0,2
2019,240268,42,5,11,7,4
2019,240268,43,0,2,1,1
2019,240268,43,5,2,1,1
2019,240268,44,0,34,13,21
2019,240268,44,3,1,0,1
2019,240268,44,4,4,0,4
2019,240268,44,5,29,13,16
2019,240268,45,0,37,11,26
2019,240268,45,2,3,0,3
2019,240268,45,3,10,3,7
2019,240268,45,4,2,0,2
2019,240268,45,5,22,8,14
2019,240277,0,0,241,122,119
2019,240277,10,0,241,122,119
2019,240277,10,1,43,25,18
2019,240277,10,2,88,49,39
2019,240277,10,3,50,29,21
2019,240277,10,4,3,0,3
2019,240277,10,5,57,19,38
2019,240277,20,0,127,72,55
2019,240277,20,1,43,25,18
2019,240277,20,2,84,47,37
2019,240277,30,0,54,30,24
2019,240277,30,2,4,2,2
2019,240277,30,3,49,28,21
2019,240277,30,4,1,0,1
2019,240277,40,0,60,20,40
2019,240277,40,3,1,1,0
2019,240277,40,4,2,0,2
2019,240277,40,5,57,19,38
2019,240277,41,0,50,14,36
2019,240277,41,3,1,1,0
2019,240277,41,4,2,0,2
2019,240277,41,5,47,13,34
2019,240277,42,0,9,5,4
2019,240277,42,5,9,5,4
2019,240277,43,0,1,1,0
2019,240277,43,5,1,1,0
2019,240277,44,0,10,3,7
2019,240277,44,5,10,3,7
2019,240277,45,0,40,11,29
2019,240277,45,3,1,1,0
2019,240277,45,4,2,0,2
2019,240277,45,5,37,10,27
2019,240329,0,0,500,258,242
2019,240329,10,0,500,258,242
2019,240329,10,1,101,62,39
2019,240329,10,2,124,57,67
2019,240329,10,3,146,73,73
2019,240329,10,5,129,66,63
2019,240329,20,0,205,111,94
2019,240329,20,1,100,61,39
2019,240329,20,2,90,41,49
2019,240329,20,3,15,9,6
2019,240329,30,0,148,79,69
2019,240329,30,2,30,15,15
2019,240329,30,3,118,64,54
2019,240329,40,0,147,68,79
2019,240329,40,1,1,1,0
2019,240329,40,2,4,1,3
2019,240329,40,3,13,0,13
2019,240329,40,5,129,66,63
2019,240329,41,0,121,54,67
2019,240329,41,1,1,1,0
2019,240329,41,2,4,1,3
2019,240329,41,3,10,0,10
2019,240329,41,5,106,52,54
2019,240329,42,0,25,14,11
2019,240329,42,3,3,0,3
2019,240329,42,5,22,14,8
2019,240329,43,0,1,0,1
2019,240329,43,5,1,0,1
2019,240329,44,0,81,37,44
2019,240329,44,2,1,0,1
2019,240329,44,3,8,0,8
2019,240329,44,5,72,37,35
2019,240329,45,0,40,17,23
2019,240329,45,1,1,1,0
2019,240329,45,2,3,1,2
2019,240329,45,3,2,0,2
2019,240329,45,5,34,15,19
2019,240338,0,0,63,37,26
2019,240338,10,0,63,37,26
2019,240338,10,1,18,12,6
2019,240338,10,2,14,8,6
2019,240338,10,3,23,15,8
2019,240338,10,4,3,1,2
2019,240338,10,5,5,1,4
2019,240338,40,0,63,37,26
2019,240338,40,1,18,12,6
2019,240338,40,2,14,8,6
2019,240338,40,3,23,15,8
2019,240338,40,4,3,1,2
2019,240338,40,5,5,1,4
2019,240338,41,0,63,37,26
2019,240338,41,1,18,12,6
2019,240338,41,2,14,8,6
2019,240338,41,3,23,15,8
2019,240338,41,4,3,1,2
2019,240338,41,5,5,1,4
2019,240338,45,0,63,37,26
2019,240338,45,1,18,12,6
2019,240338,45,2,14,8,6
2019,240338,45,3,23,15,8
2019,240338,45,4,3,1,2
2019,240338,45,5,5,1,4
2019,240365,0,0,419,219,200
2019,240365,10,0,419,219,200
2019,240365,10,1,132,81,51
2019,240365,10,2,125,68,57
2019,240365,10,3,68,32,36
2019,240365,10,5,94,38,56
2019,240365,20,0,252,147,105
2019,240365,20,1,132,81,51
2019,240365,20,2,120,66,54
2019,240365,30,0,64,33,31
2019,240365,30,2,4,2,2
2019,240365,30,3,60,31,29
2019,240365,40,0,103,39,64
2019,240365,40,2,1,0,1
2019,240365,40,3,8,1,7
2019,240365,40,5,94,38,56
2019,240365,41,0,99,36,63
2019,240365,41,2,1,0,1
2019,240365,41,3,8,1,7
2019,240365,41,5,90,35,55
2019,240365,42,0,4,3,1
2019,240365,42,5,4,3,1
2019,240365,44,0,69,23,46
2019,240365,44,2,1,0,1
2019,240365,44,3,1,0,1
2019,240365,44,5,67,23,44
2019,240365,45,0,30,13,17
2019,240365,45,3,7,1,6
2019,240365,45,5,23,12,11
2019,240374,0,0,162,84,78
2019,240374,10,0,160,84,76
2019,240374,10,1,22,15,7
2019,240374,10,2,58,35,23
2019,240374,10,3,41,18,23
2019,240374,10,5,39,16,23
2019,240374,20,0,68,42,26
2019,240374,20,1,22,15,7
2019,240374,20,2,46,27,19
2019,240374,30,0,37,18,19
2019,240374,30,2,11,7,4
2019,240374,30,3,26,11,15
2019,240374,40,0,55,24,31
2019,240374,40,2,1,1,0
2019,240374,40,3,15,7,8
2019,240374,40,5,39,16,23
2019,240374,41,0,50,20,30
2019,240374,41,2,1,1,0
2019,240374,41,3,12,5,7
2019,240374,41,5,37,14,23
2019,240374,42,0,5,4,1
2019,240374,42,3,3,2,1
2019,240374,42,5,2,2,0
2019,240374,44,0,8,4,4
2019,240374,44,3,2,2,0
2019,240374,44,5,6,2,4
2019,240374,45,0,42,16,26
2019,240374,45,2,1,1,0
2019,240374,45,3,10,3,7
2019,240374,45,5,31,12,19
2019,240374,50,0,2,0,2
2019,240392,0,0,44,10,34
2019,240392,10,0,44,10,34
2019,240392,10,1,16,4,12
2019,240392,10,2,8,4,4
2019,240392,10,3,20,2,18
2019,240392,40,0,44,10,34
2019,240392,40,1,16,4,12
2019,240392,40,2,8,4,4
2019,240392,40,3,20,2,18
2019,240392,41,0,44,10,34
2019,240392,41,1,16,4,12
2019,240392,41,2,8,4,4
2019,240392,41,3,20,2,18
2019,240392,45,0,44,10,34
2019,240392,45,1,16,4,12
2019,240392,45,2,8,4,4
2019,240392,45,3,20,2,18
2019,240417,0,0,334,183,151
2019,240417,10,0,334,183,151
2019,240417,10,1,101,52,49
2019,240417,10,2,65,39,26
2019,240417,10,3,94,52,42
2019,240417,10,5,74,40,34
2019,240417,20,0,168,93,75
2019,240417,20,1,99,51,48
2019,240417,20,2,64,38,26
2019,240417,20,3,5,4,1
2019,240417,30,0,78,44,34
2019,240417,30,2,1,1,0
2019,240417,30,3,77,43,34
2019,240417,40,0,88,46,42
2019,240417,40,1,2,1,1
2019,240417,40,3,12,5,7
2019,240417,40,5,74,40,34
2019,240417,41,0,72,41,31
2019,240417,41,1,2,1,1
2019,240417,41,3,11,5,6
2019,240417,41,5,59,35,24
2019,240417,42,0,10,3,7
2019,240417,42,3,1,0,1
2019,240417,42,5,9,3,6
2019,240417,43,0,6,2,4
2019,240417,43,5,6,2,4
2019,240417,44,0,55,32,23
2019,240417,44,1,2,1,1
2019,240417,44,5,53,31,22
2019,240417,45,0,17,9,8
2019,240417,45,3,11,5,6
2019,240417,45,5,6,4,2
2019,240426,0,0,111,53,58
2019,240426,10,0,111,53,58
2019,240426,10,1,31,21,10
2019,240426,10,2,29,12,17
2019,240426,10,3,21,12,9
2019,240426,10,4,1,0,1
2019,240426,10,5,29,8,21
2019,240426,20,0,55,31,24
2019,240426,20,1,31,21,10
2019,240426,20,2,22,8,14
2019,240426,20,3,2,2,0
2019,240426,30,0,26,14,12
2019,240426,30,2,7,4,3
2019,240426,30,3,18,10,8
2019,240426,30,4,1,0,1
2019,240426,40,0,30,8,22
2019,240426,40,3,1,0,1
2019,240426,40,5,29,8,21
2019,240426,41,0,28,8,20
2019,240426,41,3,1,0,1
2019,240426,41,5,27,8,19
2019,240426,42,0,2,0,2
2019,240426,42,5,2,0,2
2019,240426,44,0,1,0,1
2019,240426,44,5,1,0,1
2019,240426,45,0,27,8,19
2019,240426,45,3,1,0,1
2019,240426,45,5,26,8,18
2019,240444,0,0,3588,2119,1469
2019,240444,10,0,3579,2117,1462
2019,240444,10,1,1509,998,511
2019,240444,10,2,796,451,345
2019,240444,10,3,994,532,462
2019,240444,10,4,159,72,87
2019,240444,10,5,121,64,57
2019,240444,20,0,1505,999,506
2019,240444,20,1,1111,772,339
2019,240444,20,2,394,227,167
2019,240444,30,0,444,241,203
2019,240444,30,3,444,241,203
2019,240444,40,0,1630,877,753
2019,240444,40,1,398,226,172
2019,240444,40,2,402,224,178
2019,240444,40,3,550,291,259
2019,240444,40,4,159,72,87
2019,240444,40,5,121,64,57
2019,240444,41,0,1530,820,710
2019,240444,41,1,387,221,166
2019,240444,41,2,390,220,170
2019,240444,41,3,535,286,249
2019,240444,41,4,109,36,73
2019,240444,41,5,109,57,52
2019,240444,42,0,91,51,40
2019,240444,42,1,10,4,6
2019,240444,42,2,11,3,8
2019,240444,42,3,13,5,8
2019,240444,42,4,49,35,14
2019,240444,42,5,8,4,4
2019,240444,43,0,9,6,3
2019,240444,43,1,1,1,0
2019,240444,43,2,1,1,0
2019,240444,43,3,2,0,2
2019,240444,43,4,1,1,0
2019,240444,43,5,4,3,1
2019,240444,44,0,74,41,33
2019,240444,44,1,9,4,5
2019,240444,44,2,3,3,0
2019,240444,44,3,35,25,10
2019,240444,44,4,20,7,13
2019,240444,44,5,7,2,5
2019,240444,45,0,1456,779,677
2019,240444,45,1,378,217,161
2019,240444,45,2,387,217,170
2019,240444,45,3,500,261,239
2019,240444,45,4,89,29,60
2019,240444,45,5,102,55,47
2019,240444,50,0,9,2,7
2019,240453,0,0,1056,547,509
2019,240453,10,0,1056,547,509
2019,240453,10,1,249,165,84
2019,240453,10,2,382,206,176
2019,240453,10,3,177,73,104
2019,240453,10,4,28,4,24
2019,240453,10,5,220,99,121
2019,240453,20,0,557,349,208
2019,240453,20,1,226,154,72
2019,240453,20,2,330,194,136
2019,240453,20,3,1,1,0
2019,240453,30,0,115,50,65
2019,240453,30,2,25,9,16
2019,240453,30,3,90,41,49
2019,240453,40,0,384,148,236
2019,240453,40,1,23,11,12
2019,240453,40,2,27,3,24
2019,240453,40,3,86,31,55
2019,240453,40,4,28,4,24
2019,240453,40,5,220,99,121
2019,240453,41,0,360,134,226
2019,240453,41,1,22,10,12
2019,240453,41,2,27,3,24
2019,240453,41,3,76,23,53
2019,240453,41,4,24,4,20
2019,240453,41,5,211,94,117
2019,240453,42,0,19,11,8
2019,240453,42,3,10,8,2
2019,240453,42,4,4,0,4
2019,240453,42,5,5,3,2
2019,240453,43,0,5,3,2
2019,240453,43,1,1,1,0
2019,240453,43,5,4,2,2
2019,240453,44,0,136,63,73
2019,240453,44,1,2,1,1
2019,240453,44,2,1,1,0
2019,240453,44,3,20,6,14
2019,240453,44,4,13,1,12
2019,240453,44,5,100,54,46
2019,240453,45,0,224,71,153
2019,240453,45,1,20,9,11
2019,240453,45,2,26,2,24
2019,240453,45,3,56,17,39
2019,240453,45,4,11,3,8
2019,240453,45,5,111,40,71
2019,240462,0,0,324,199,125
2019,240462,10,0,324,199,125
2019,240462,10,1,86,53,33
2019,240462,10,2,74,45,29
2019,240462,10,3,78,55,23
2019,240462,10,5,86,46,40
2019,240462,20,0,159,98,61
2019,240462,20,1,85,53,32
2019,240462,20,2,74,45,29
2019,240462,30,0,77,55,22
2019,240462,30,3,77,55,22
2019,240462,40,0,88,46,42
2019,240462,40,1,1,0,1
2019,240462,40,3,1,0,1
2019,240462,40,5,86,46,40
2019,240462,41,0,77,36,41
2019,240462,41,1,1,0,1
2019,240462,41,3,1,0,1
2019,240462,41,5,75,36,39
2019,240462,42,0,11,10,1
2019,240462,42,5,11,10,1
2019,240462,44,0,71,34,37
2019,240462,44,5,71,34,37
2019,240462,45,0,6,2,4
2019,240462,45,1,1,0,1
2019,240462,45,3,1,0,1
2019,240462,45,5,4,2,2
2019,240471,0,0,224,127,97
2019,240471,10,0,224,127,97
2019,240471,10,1,100,67,33
2019,240471,10,2,33,15,18
2019,240471,10,3,64,33,31
2019,240471,10,5,27,12,15
2019,240471,20,0,129,81,48
2019,240471,20,1,98,66,32
2019,240471,20,2,31,15,16
2019,240471,30,0,50,29,21
2019,240471,30,3,50,29,21
2019,240471,40,0,45,17,28
2019,240471,40,1,2,1,1
2019,240471,40,2,2,0,2
2019,240471,40,3,14,4,10
2019,240471,40,5,27,12,15
2019,240471,41,0,42,16,26
2019,240471,41,1,2,1,1
2019,240471,41,2,2,0,2
2019,240471,41,3,11,3,8
2019,240471,41,5,27,12,15
2019,240471,42,0,2,0,2
2019,240471,42,3,2,0,2
2019,240471,43,0,1,1,0
2019,240471,43,3,1,1,0
2019,240471,44,0,20,8,12
2019,240471,44,3,3,2,1
2019,240471,44,5,17,6,11
2019,240471,45,0,22,8,14
2019,240471,45,1,2,1,1
2019,240471,45,2,2,0,2
2019,240471,45,3,8,1,7
2019,240471,45,5,10,6,4
2019,240480,0,0,343,188,155
2019,240480,10,0,343,188,155
2019,240480,10,1,135,81,54
2019,240480,10,2,87,53,34
2019,240480,10,3,79,41,38
2019,240480,10,4,1,0,1
2019,240480,10,5,41,13,28
2019,240480,20,0,219,133,86
2019,240480,20,1,134,80,54
2019,240480,20,2,84,53,31
2019,240480,20,3,1,0,1
2019,240480,30,0,73,38,35
2019,240480,30,2,1,0,1
2019,240480,30,3,72,38,34
2019,240480,40,0,51,17,34
2019,240480,40,1,1,1,0
2019,240480,40,2,2,0,2
2019,240480,40,3,6,3,3
2019,240480,40,4,1,0,1
2019,240480,40,5,41,13,28
2019,240480,41,0,49,17,32
2019,240480,41,1,1,1,0
2019,240480,41,2,2,0,2
2019,240480,41,3,6,3,3
2019,240480,41,4,1,0,1
2019,240480,41,5,39,13,26
2019,240480,42,0,1,0,1
2019,240480,42,5,1,0,1
2019,240480,43,0,1,0,1
2019,240480,43,5,1,0,1
2019,240480,44,0,27,9,18
2019,240480,44,5,27,9,18
2019,240480,45,0,22,8,14
2019,240480,45,1,1,1,0
2019,240480,45,2,2,0,2
2019,240480,45,3,6,3,3
2019,240480,45,4,1,0,1
2019,240480,45,5,12,4,8
2019,240505,0,0,132,74,58
2019,240505,10,0,132,74,58
2019,240505,10,4,132,74,58
2019,240505,20,0,104,61,43
2019,240505,20,4,104,61,43
2019,240505,30,0,25,13,12
2019,240505,30,4,25,13,12
2019,240505,40,0,3,0,3
2019,240505,40,4,3,0,3
2019,240505,42,0,3,0,3
2019,240505,42,4,3,0,3
2019,240514,0,0,61,27,34
2019,240514,10,0,58,25,33
2019,240514,10,1,26,15,11
2019,240514,10,2,9,2,7
2019,240514,10,3,4,1,3
2019,240514,10,4,19,7,12
2019,240514,20,0,37,18,19
2019,240514,20,1,24,15,9
2019,240514,20,2,9,2,7
2019,240514,20,3,4,1,3
2019,240514,30,0,18,7,11
2019,240514,30,4,18,7,11
2019,240514,40,0,3,0,3
2019,240514,40,1,2,0,2
2019,240514,40,4,1,0,1
2019,240514,42,0,3,0,3
2019,240514,42,1,2,0,2
2019,240514,42,4,1,0,1
2019,240514,50,0,3,2,1
2019,240596,0,0,35,16,19
2019,240596,10,0,33,15,18
2019,240596,10,1,9,5,4
2019,240596,10,2,13,6,7
2019,240596,10,3,11,4,7
2019,240596,20,0,19,9,10
2019,240596,20,1,9,5,4
2019,240596,20,2,9,3,6
2019,240596,20,3,1,1,0
2019,240596,30,0,14,6,8
2019,240596,30,2,4,3,1
2019,240596,30,3,10,3,7
2019,240596,50,0,2,1,1
2019,240620,0,0,118,51,67
2019,240620,10,0,118,51,67
2019,240620,10,6,118,51,67
2019,240620,40,0,118,51,67
2019,240620,40,6,118,51,67
2019,240620,41,0,48,24,24
2019,240620,41,6,48,24,24
2019,240620,42,0,60,23,37
2019,240620,42,6,60,23,37
2019,240620,43,0,10,4,6
2019,240620,43,6,10,4,6
2019,240620,45,0,48,24,24
2019,240620,45,6,48,24,24
2019,240657,0,0,59,34,25
2019,240657,10,0,59,34,25
2019,240657,10,1,2,1,1
2019,240657,10,2,14,8,6
2019,240657,10,3,26,18,8
2019,240657,10,4,17,7,10
2019,240657,20,0,35,22,13
2019,240657,20,1,2,1,1
2019,240657,20,2,14,8,6
2019,240657,20,3,19,13,6
2019,240657,30,0,15,11,4
2019,240657,30,3,5,5,0
2019,240657,30,4,10,6,4
2019,240657,40,0,9,1,8
2019,240657,40,3,2,0,2
2019,240657,40,4,7,1,6
2019,240657,42,0,9,1,8
2019,240657,42,3,2,0,2
2019,240657,42,4,7,1,6
2019,240666,0,0,107,51,56
2019,240666,10,0,100,48,52
2019,240666,10,4,100,48,52
2019,240666,20,0,54,33,21
2019,240666,20,4,54,33,21
2019,240666,30,0,40,14,26
2019,240666,30,4,40,14,26
2019,240666,40,0,6,1,5
2019,240666,40,4,6,1,5
2019,240666,42,0,6,1,5
2019,240666,42,4,6,1,5
2019,240666,50,0,7,3,4
2019,240693,0,0,77,39,38
2019,240693,10,0,77,39,38
2019,240693,10,1,12,8,4
2019,240693,10,2,22,7,15
2019,240693,10,3,20,10,10
2019,240693,10,4,23,14,9
2019,240693,40,0,77,39,38
2019,240693,40,1,12,8,4
2019,240693,40,2,22,7,15
2019,240693,40,3,20,10,10
2019,240693,40,4,23,14,9
2019,240693,42,0,77,39,38
2019,240693,42,1,12,8,4
2019,240693,42,2,22,7,15
2019,240693,42,3,20,10,10
2019,240693,42,4,23,14,9
2019,240718,0,0,18,18,0
2019,240718,10,0,18,18,0
2019,240718,10,4,18,18,0
2019,240718,40,0,18,18,0
2019,240718,40,4,18,18,0
2019,240718,41,0,18,18,0
2019,240718,41,4,18,18,0
2019,240718,45,0,18,18,0
2019,240718,45,4,18,18,0
2019,240727,0,0,721,418,303
2019,240727,10,0,721,418,303
2019,240727,10,1,196,143,53
2019,240727,10,2,189,110,79
2019,240727,10,3,149,81,68
2019,240727,10,4,21,16,5
2019,240727,10,5,166,68,98
2019,240727,20,0,376,250,126
2019,240727,20,1,195,142,53
2019,240727,20,2,181,108,73
2019,240727,30,0,157,83,74
2019,240727,30,2,8,2,6
2019,240727,30,3,149,81,68
2019,240727,40,0,188,85,103
2019,240727,40,1,1,1,0
2019,240727,40,4,21,16,5
2019,240727,40,5,166,68,98
2019,240727,41,0,77,34,43
2019,240727,41,5,77,34,43
2019,240727,42,0,111,51,60
2019,240727,42,1,1,1,0
2019,240727,42,4,21,16,5
2019,240727,42,5,89,34,55
2019,240727,44,0,77,34,43
2019,240727,44,5,77,34,43
2019,240736,0,0,91,39,52
2019,240736,10,0,91,39,52
2019,240736,10,4,91,39,52
2019,240736,20,0,42,19,23
2019,240736,20,4,42,19,23
2019,240736,30,0,9,4,5
2019,240736,30,4,9,4,5
2019,240736,40,0,40,16,24
2019,240736,40,4,40,16,24
2019,240736,42,0,9,6,3
2019,240736,42,4,9,6,3
2019,240736,43,0,31,10,21
2019,240736,43,4,31,10,21
2019,240745,0,0,56,24,32
2019,240745,10,0,56,24,32
2019,240745,10,1,4,0,4
2019,240745,10,2,12,3,9
2019,240745,10,3,15,7,8
2019,240745,10,4,20,12,8
2019,240745,10,5,5,2,3
2019,240745,20,0,49,22,27
2019,240745,20,1,4,0,4
2019,240745,20,2,12,3,9
2019,240745,20,3,15,7,8
2019,240745,20,4,14,10,4
2019,240745,20,5,4,2,2
2019,240745,30,0,1,0,1
2019,240745,30,4,1,0,1
2019,240745,40,0,6,2,4
2019,240745,40,4,5,2,3
2019,240745,40,5,1,0,1
2019,240745,42,0,6,2,4
2019,240745,42,4,5,2,3
2019,240745,42,5,1,0,1
2019,240754,0,0,144,79,65
2019,240754,10,0,144,79,65
2019,240754,10,1,38,22,16
2019,240754,10,2,40,19,21
2019,240754,10,3,41,24,17
2019,240754,10,4,25,14,11
2019,240754,20,0,68,35,33
2019,240754,20,1,38,22,16
2019,240754,20,2,27,11,16
2019,240754,20,3,3,2,1
2019,240754,30,0,40,24,16
2019,240754,30,2,12,7,5
2019,240754,30,3,28,17,11
2019,240754,40,0,36,20,16
2019,240754,40,2,1,1,0
2019,240754,40,3,10,5,5
2019,240754,40,4,25,14,11
2019,240754,41,0,20,9,11
2019,240754,41,3,5,2,3
2019,240754,41,4,15,7,8
2019,240754,42,0,12,8,4
2019,240754,42,2,1,1,0
2019,240754,42,3,5,3,2
2019,240754,42,4,6,4,2
2019,240754,43,0,4,3,1
2019,240754,43,4,4,3,1
2019,240754,44,0,20,9,11
2019,240754,44,3,5,2,3
2019,240754,44,4,15,7,8
2019,240790,0,0,30,13,17
2019,240790,10,0,30,13,17
2019,240790,10,1,1,1,0
2019,240790,10,2,6,2,4
2019,240790,10,3,16,7,9
2019,240790,10,4,7,3,4
2019,240790,40,0,30,13,17
2019,240790,40,1,1,1,0
2019,240790,40,2,6,2,4
2019,240790,40,3,16,7,9
2019,240790,40,4,7,3,4
2019,240790,41,0,30,13,17
2019,240790,41,1,1,1,0
2019,240790,41,2,6,2,4
2019,240790,41,3,16,7,9
2019,240790,41,4,7,3,4
2019,240790,44,0,30,13,17
2019,240790,44,1,1,1,0
2019,240790,44,2,6,2,4
2019,240790,44,3,16,7,9
2019,240790,44,4,7,3,4
2019,241100,0,0,10,4,6
2019,241100,10,0,10,4,6
2019,241100,10,1,1,1,0
2019,241100,10,2,2,0,2
2019,241100,10,3,6,3,3
2019,241100,10,4,1,0,1
2019,241100,20,0,10,4,6
2019,241100,20,1,1,1,0
2019,241100,20,2,2,0,2
2019,241100,20,3,6,3,3
2019,241100,20,4,1,0,1
2019,241128,0,0,8,4,4
2019,241128,10,0,8,4,4
2019,241128,10,2,4,1,3
2019,241128,10,3,1,0,1
2019,241128,10,4,3,3,0
2019,241128,20,0,8,4,4
2019,241128,20,2,4,1,3
2019,241128,20,3,1,0,1
2019,241128,20,4,3,3,0
2019,241191,0,0,39,21,18
2019,241191,10,0,39,21,18
2019,241191,10,1,1,0,1
2019,241191,10,2,8,4,4
2019,241191,10,3,19,10,9
2019,241191,10,4,3,2,1
2019,241191,10,6,8,5,3
2019,241191,20,0,18,9,9
2019,241191,20,1,1,0,1
2019,241191,20,2,8,4,4
2019,241191,20,3,9,5,4
2019,241191,30,0,13,7,6
2019,241191,30,3,10,5,5
2019,241191,30,4,3,2,1
2019,241191,40,0,8,5,3
2019,241191,40,6,8,5,3
2019,241191,43,0,8,5,3
2019,241191,43,6,8,5,3
2019,241216,0,0,61,34,27
2019,241216,10,0,61,34,27
2019,241216,10,1,61,34,27
2019,241216,40,0,61,34,27
2019,241216,40,1,61,34,27
2019,241216,41,0,18,10,8
2019,241216,41,1,18,10,8
2019,241216,42,0,6,5,1
2019,241216,42,1,6,5,1
2019,241216,43,0,37,19,18
2019,241216,43,1,37,19,18
2019,241216,44,0,18,10,8
2019,241216,44,1,18,10,8
2019,241225,0,0,32,8,24
2019,241225,10,0,24,6,18
2019,241225,10,1,1,1,0
2019,241225,10,2,13,3,10
2019,241225,10,3,5,2,3
2019,241225,10,4,5,0,5
2019,241225,40,0,24,6,18
2019,241225,40,1,1,1,0
2019,241225,40,2,13,3,10
2019,241225,40,3,5,2,3
2019,241225,40,4,5,0,5
2019,241225,42,0,24,6,18
2019,241225,42,1,1,1,0
2019,241225,42,2,13,3,10
2019,241225,42,3,5,2,3
2019,241225,42,4,5,0,5
2019,241225,50,0,8,2,6
2019,241304,0,0,33,13,20
2019,241304,10,0,33,13,20
2019,241304,10,1,4,2,2
2019,241304,10,4,29,11,18
2019,241304,40,0,33,13,20
2019,241304,40,1,4,2,2
2019,241304,40,4,29,11,18
2019,241304,42,0,29,11,18
2019,241304,42,4,29,11,18
2019,241304,43,0,4,2,2
2019,241304,43,1,4,2,2
2019,241331,0,0,27,13,14
2019,241331,10,0,27,13,14
2019,241331,10,1,7,6,1
2019,241331,10,2,14,6,8
2019,241331,10,3,6,1,5
2019,241331,40,0,27,13,14
2019,241331,40,1,7,6,1
2019,241331,40,2,14,6,8
2019,241331,40,3,6,1,5
2019,241331,41,0,23,11,12
2019,241331,41,1,7,6,1
2019,241331,41,2,13,5,8
2019,241331,41,3,3,0,3
2019,241331,42,0,4,2,2
2019,241331,42,2,1,1,0
2019,241331,42,3,3,1,2
2019,241331,44,0,23,11,12
2019,241331,44,1,7,6,1
2019,241331,44,2,13,5,8
2019,241331,44,3,3,0,3
2019,241377,0,0,30,16,14
2019,241377,10,0,30,16,14
2019,241377,10,1,1,1,0
2019,241377,10,2,1,0,1
2019,241377,10,3,5,2,3
2019,241377,10,4,23,13,10
2019,241377,40,0,30,16,14
2019,241377,40,1,1,1,0
2019,241377,40,2,1,0,1
2019,241377,40,3,5,2,3
2019,241377,40,4,23,13,10
2019,241377,42,0,30,16,14
2019,241377,42,1,1,1,0
2019,241377,42,2,1,0,1
2019,241377,42,3,5,2,3
2019,241377,42,4,23,13,10
2019,241386,0,0,7,4,3
2019,241386,10,0,7,4,3
2019,241386,10,3,2,1,1
2019,241386,10,4,5,3,2
2019,241386,40,0,7,4,3
2019,241386,40,3,2,1,1
2019,241386,40,4,5,3,2
2019,241386,42,0,7,4,3
2019,241386,42,3,2,1,1
2019,241386,42,4,5,3,2
2019,241395,0,0,21,9,12
2019,241395,10,0,21,9,12
2019,241395,10,1,2,1,1
2019,241395,10,2,7,2,5
2019,241395,10,3,2,2,0
2019,241395,10,4,3,1,2
2019,241395,10,6,7,3,4
2019,241395,40,0,21,9,12
2019,241395,40,1,2,1,1
2019,241395,40,2,7,2,5
2019,241395,40,3,2,2,0
2019,241395,40,4,3,1,2
2019,241395,40,6,7,3,4
2019,241395,41,0,8,4,4
2019,241395,41,1,2,1,1
2019,241395,41,2,5,2,3
2019,241395,41,3,1,1,0
2019,241395,42,0,6,2,4
2019,241395,42,2,2,0,2
2019,241395,42,3,1,1,0
2019,241395,42,4,3,1,2
2019,241395,43,0,7,3,4
2019,241395,43,6,7,3,4
2019,241395,45,0,8,4,4
2019,241395,45,1,2,1,1
2019,241395,45,2,5,2,3
2019,241395,45,3,1,1,0
2019,241410,0,0,225,95,130
2019,241410,10,0,225,95,130
2019,241410,10,1,42,23,19
2019,241410,10,2,63,27,36
2019,241410,10,3,75,34,41
2019,241410,10,4,20,3,17
2019,241410,10,6,25,8,17
2019,241410,40,0,225,95,130
2019,241410,40,1,42,23,19
2019,241410,40,2,63,27,36
2019,241410,40,3,75,34,41
2019,241410,40,4,20,3,17
2019,241410,40,6,25,8,17
2019,241410,41,0,157,71,86
2019,241410,41,1,40,23,17
2019,241410,41,2,62,27,35
2019,241410,41,3,54,20,34
2019,241410,41,4,1,1,0
2019,241410,42,0,50,18,32
2019,241410,42,1,2,0,2
2019,241410,42,2,1,0,1
2019,241410,42,3,21,14,7
2019,241410,42,4,19,2,17
2019,241410,42,6,7,2,5
2019,241410,43,0,18,6,12
2019,241410,43,6,18,6,12
2019,241410,45,0,157,71,86
2019,241410,45,1,40,23,17
2019,241410,45,2,62,27,35
2019,241410,45,3,54,20,34
2019,241410,45,4,1,1,0
2019,241517,0,0,3,2,1
2019,241517,10,0,3,2,1
2019,241517,10,1,3,2,1
2019,241517,20,0,3,2,1
2019,241517,20,1,3,2,1
2019,241614,0,0,18,11,7
2019,241614,10,0,18,11,7
2019,241614,10,1,1,0,1
2019,241614,10,4,17,11,6
2019,241614,20,0,2,0,2
2019,241614,20,1,1,0,1
2019,241614,20,4,1,0,1
2019,241614,40,0,16,11,5
2019,241614,40,4,16,11,5
2019,241614,41,0,1,1,0
2019,241614,41,4,1,1,0
2019,241614,43,0,15,10,5
2019,241614,43,4,15,10,5
2019,241614,44,0,1,1,0
2019,241614,44,4,1,1,0
2019,241720,0,0,22,9,13
2019,241720,10,0,21,9,12
2019,241720,10,1,1,1,0
2019,241720,10,2,2,1,1
2019,241720,10,3,4,2,2
2019,241720,10,4,14,5,9
2019,241720,20,0,21,9,12
2019,241720,20,1,1,1,0
2019,241720,20,2,2,1,1
2019,241720,20,3,4,2,2
2019,241720,20,4,14,5,9
2019,241720,50,0,1,0,1
2019,241739,0,0,170,47,123
2019,241739,10,0,170,47,123
2019,241739,10,1,18,6,12
2019,241739,10,2,23,8,15
2019,241739,10,3,55,16,39
2019,241739,10,4,74,17,57
2019,241739,20,0,9,1,8
2019,241739,20,1,5,0,5
2019,241739,20,2,4,1,3
2019,241739,40,0,161,46,115
2019,241739,40,1,13,6,7
2019,241739,40,2,19,7,12
2019,241739,40,3,55,16,39
2019,241739,40,4,74,17,57
2019,241739,41,0,71,29,42
2019,241739,41,1,10,6,4
2019,241739,41,2,18,7,11
2019,241739,41,3,34,13,21
2019,241739,41,4,9,3,6
2019,241739,42,0,90,17,73
2019,241739,42,1,3,0,3
2019,241739,42,2,1,0,1
2019,241739,42,3,21,3,18
2019,241739,42,4,65,14,51
2019,241739,44,0,71,29,42
2019,241739,44,1,10,6,4
2019,241739,44,2,18,7,11
2019,241739,44,3,34,13,21
2019,241739,44,4,9,3,6
2019,241766,0,0,45,33,12
2019,241766,10,0,45,33,12
2019,241766,10,1,9,4,5
2019,241766,10,2,15,12,3
2019,241766,10,3,9,9,0
2019,241766,10,4,3,2,1
2019,241766,10,6,9,6,3
2019,241766,20,0,34,25,9
2019,241766,20,1,9,4,5
2019,241766,20,2,15,12,3
2019,241766,20,3,7,7,0
2019,241766,20,4,3,2,1
2019,241766,30,0,2,2,0
2019,241766,30,3,2,2,0
2019,241766,40,0,9,6,3
2019,241766,40,6,9,6,3
2019,241766,42,0,9,6,3
2019,241766,42,6,9,6,3
2019,241836,0,0,30,8,22
2019,241836,10,0,30,8,22
2019,241836,10,4,30,8,22
2019,241836,40,0,30,8,22
2019,241836,40,4,30,8,22
2019,241836,41,0,30,8,22
2019,241836,41,4,30,8,22
2019,241836,45,0,30,8,22
2019,241836,45,4,30,8,22
2019,241951,0,0,24,14,10
2019,241951,10,0,24,14,10
2019,241951,10,1,3,2,1
2019,241951,10,2,1,0,1
2019,241951,10,4,7,5,2
2019,241951,10,6,13,7,6
2019,241951,20,0,11,7,4
2019,241951,20,1,3,2,1
2019,241951,20,2,1,0,1
2019,241951,20,4,7,5,2
2019,241951,40,0,13,7,6
2019,241951,40,6,13,7,6
2019,241951,43,0,13,7,6
2019,241951,43,6,13,7,6
2019,242042,0,0,47,17,30
2019,242042,10,0,47,17,30
2019,242042,10,1,47,17,30
2019,242042,20,0,23,6,17
2019,242042,20,1,23,6,17
2019,242042,30,0,23,11,12
2019,242042,30,1,23,11,12
2019,242042,40,0,1,0,1
2019,242042,40,1,1,0,1
2019,242042,43,0,1,0,1
2019,242042,43,1,1,0,1
2019,242112,0,0,17,5,12
2019,242112,10,0,17,5,12
2019,242112,10,1,17,5,12
2019,242112,20,0,17,5,12
2019,242112,20,1,17,5,12
2019,242121,0,0,27,10,17
2019,242121,10,0,27,10,17
2019,242121,10,1,27,10,17
2019,242121,40,0,27,10,17
2019,242121,40,1,27,10,17
2019,242121,42,0,3,1,2
2019,242121,42,1,3,1,2
2019,242121,43,0,24,9,15
2019,242121,43,1,24,9,15
2019,242130,0,0,7,2,5
2019,242130,10,0,7,2,5
2019,242130,10,4,7,2,5
2019,242130,40,0,7,2,5
2019,242130,40,4,7,2,5
2019,242130,43,0,7,2,5
2019,242130,43,4,7,2,5
2019,242149,0,0,10,3,7
2019,242149,10,0,10,3,7
2019,242149,10,4,10,3,7
2019,242149,40,0,10,3,7
2019,242149,40,4,10,3,7
2019,242149,43,0,10,3,7
2019,242149,43,4,10,3,7
2019,242422,0,0,140,67,73
2019,242422,10,0,140,67,73
2019,242422,10,1,140,67,73
2019,242422,40,0,140,67,73
2019,242422,40,1,140,67,73
2019,242422,43,0,140,67,73
2019,242422,43,1,140,67,73
2019,242556,0,0,35,20,15
2019,242556,10,0,35,20,15
2019,242556,10,1,35,20,15
2019,242556,20,0,14,8,6
2019,242556,20,1,14,8,6
2019,242556,40,0,21,12,9
2019,242556,40,1,21,12,9
2019,242556,42,0,21,12,9
2019,242556,42,1,21,12,9
2019,242565,0,0,32,13,19
2019,242565,10,0,32,13,19
2019,242565,10,1,32,13,19
2019,242565,40,0,32,13,19
2019,242565,40,1,32,13,19
2019,242565,41,0,32,13,19
2019,242565,41,1,32,13,19
2019,242565,45,0,32,13,19
2019,242565,45,1,32,13,19
2019,242583,0,0,33,15,18
2019,242583,10,0,33,15,18
2019,242583,10,1,33,15,18
2019,242583,20,0,15,7,8
2019,242583,20,1,15,7,8
2019,242583,30,0,18,8,10
2019,242583,30,1,18,8,10
2019,242617,0,0,96,42,54
2019,242617,10,0,96,42,54
2019,242617,10,1,24,13,11
2019,242617,10,2,41,18,23
2019,242617,10,3,29,11,18
2019,242617,10,4,2,0,2
2019,242617,20,0,78,35,43
2019,242617,20,1,24,13,11
2019,242617,20,2,38,17,21
2019,242617,20,3,16,5,11
2019,242617,30,0,14,6,8
2019,242617,30,2,2,0,2
2019,242617,30,3,12,6,6
2019,242617,40,0,4,1,3
2019,242617,40,2,1,1,0
2019,242617,40,3,1,0,1
2019,242617,40,4,2,0,2
2019,242617,42,0,4,1,3
2019,242617,42,2,1,1,0
2019,242617,42,3,1,0,1
2019,242617,42,4,2,0,2
2019,242626,0,0,79,31,48
2019,242626,10,0,79,31,48
2019,242626,10,1,10,1,9
2019,242626,10,2,23,7,16
2019,242626,10,3,35,21,14
2019,242626,10,4,11,2,9
2019,242626,20,0,52,22,30
2019,242626,20,1,10,1,9
2019,242626,20,2,20,7,13
2019,242626,20,3,22,14,8
2019,242626,30,0,15,6,9
2019,242626,30,2,2,0,2
2019,242626,30,3,9,6,3
2019,242626,30,4,4,0,4
2019,242626,40,0,12,3,9
2019,242626,40,2,1,0,1
2019,242626,40,3,4,1,3
2019,242626,40,4,7,2,5
2019,242626,42,0,9,3,6
2019,242626,42,2,1,0,1
2019,242626,42,3,3,1,2
2019,242626,42,4,5,2,3
2019,242626,43,0,3,0,3
2019,242626,43,3,1,0,1
2019,242626,43,4,2,0,2
2019,242635,0,0,75,34,41
2019,242635,10,0,75,34,41
2019,242635,10,1,20,10,10
2019,242635,10,2,13,7,6
2019,242635,10,3,30,12,18
2019,242635,10,4,12,5,7
2019,242635,20,0,47,23,24
2019,242635,20,1,20,10,10
2019,242635,20,2,11,7,4
2019,242635,20,3,16,6,10
2019,242635,30,0,15,3,12
2019,242635,30,2,2,0,2
2019,242635,30,3,7,2,5
2019,242635,30,4,6,1,5
2019,242635,40,0,13,8,5
2019,242635,40,3,7,4,3
2019,242635,40,4,6,4,2
2019,242635,42,0,9,6,3
2019,242635,42,3,4,3,1
2019,242635,42,4,5,3,2
2019,242635,43,0,4,2,2
2019,242635,43,3,3,1,2
2019,242635,43,4,1,1,0
2019,242644,0,0,30,11,19
2019,242644,10,0,30,11,19
2019,242644,10,1,1,1,0
2019,242644,10,2,6,2,4
2019,242644,10,3,15,5,10
2019,242644,10,4,8,3,5
2019,242644,20,0,11,3,8
2019,242644,20,1,1,1,0
2019,242644,20,2,4,1,3
2019,242644,20,3,6,1,5
2019,242644,30,0,8,3,5
2019,242644,30,2,2,1,1
2019,242644,30,3,3,1,2
2019,242644,30,4,3,1,2
2019,242644,40,0,11,5,6
2019,242644,40,3,6,3,3
2019,242644,40,4,5,2,3
2019,242644,42,0,9,4,5
2019,242644,42,3,5,2,3
2019,242644,42,4,4,2,2
2019,242644,43,0,2,1,1
2019,242644,43,3,1,1,0
2019,242644,43,4,1,0,1
2019,242653,0,0,184,86,98
2019,242653,10,0,184,86,98
2019,242653,10,1,54,28,26
2019,242653,10,2,63,30,33
2019,242653,10,3,53,24,29
2019,242653,10,4,14,4,10
2019,242653,20,0,126,63,63
2019,242653,20,1,52,27,25
2019,242653,20,2,57,27,30
2019,242653,20,3,17,9,8
2019,242653,30,0,22,7,15
2019,242653,30,1,1,0,1
2019,242653,30,2,5,2,3
2019,242653,30,3,15,5,10
2019,242653,30,4,1,0,1
2019,242653,40,0,36,16,20
2019,242653,40,1,1,1,0
2019,242653,40,2,1,1,0
2019,242653,40,3,21,10,11
2019,242653,40,4,13,4,9
2019,242653,42,0,36,16,20
2019,242653,42,1,1,1,0
2019,242653,42,2,1,1,0
2019,242653,42,3,21,10,11
2019,242653,42,4,13,4,9
2019,242662,0,0,100,40,60
2019,242662,10,0,100,40,60
2019,242662,10,1,15,7,8
2019,242662,10,2,35,21,14
2019,242662,10,3,37,8,29
2019,242662,10,4,13,4,9
2019,242662,20,0,57,26,31
2019,242662,20,1,14,6,8
2019,242662,20,2,26,14,12
2019,242662,20,3,17,6,11
2019,242662,30,0,32,12,20
2019,242662,30,1,1,1,0
2019,242662,30,2,9,7,2
2019,242662,30,3,15,2,13
2019,242662,30,4,7,2,5
2019,242662,40,0,11,2,9
2019,242662,40,3,5,0,5
2019,242662,40,4,6,2,4
2019,242662,42,0,1,0,1
2019,242662,42,3,1,0,1
2019,242662,43,0,10,2,8
2019,242662,43,3,4,0,4
2019,242662,43,4,6,2,4
2019,242680,0,0,41,17,24
2019,242680,10,0,41,17,24
2019,242680,10,1,4,3,1
2019,242680,10,2,12,6,6
2019,242680,10,3,24,8,16
2019,242680,10,4,1,0,1
2019,242680,20,0,32,16,16
2019,242680,20,1,4,3,1
2019,242680,20,2,11,6,5
2019,242680,20,3,17,7,10
2019,242680,30,0,7,0,7
2019,242680,30,2,1,0,1
2019,242680,30,3,5,0,5
2019,242680,30,4,1,0,1
2019,242680,40,0,2,1,1
2019,242680,40,3,2,1,1
2019,242680,42,0,2,1,1
2019,242680,42,3,2,1,1
2019,242699,0,0,30,10,20
2019,242699,10,0,30,10,20
2019,242699,10,1,1,1,0
2019,242699,10,2,6,1,5
2019,242699,10,3,18,8,10
2019,242699,10,4,5,0,5
2019,242699,20,0,19,6,13
2019,242699,20,1,1,1,0
2019,242699,20,2,6,1,5
2019,242699,20,3,12,4,8
2019,242699,30,0,7,4,3
2019,242699,30,3,5,4,1
2019,242699,30,4,2,0,2
2019,242699,40,0,4,0,4
2019,242699,40,3,1,0,1
2019,242699,40,4,3,0,3
2019,242699,42,0,4,0,4
2019,242699,42,3,1,0,1
2019,242699,42,4,3,0,3
2019,242705,0,0,90,53,37
2019,242705,10,0,90,53,37
2019,242705,10,1,14,12,2
2019,242705,10,2,26,14,12
2019,242705,10,3,36,20,16
2019,242705,10,4,14,7,7
2019,242705,20,0,53,33,20
2019,242705,20,1,13,11,2
2019,242705,20,2,19,11,8
2019,242705,20,3,21,11,10
2019,242705,30,0,26,15,11
2019,242705,30,1,1,1,0
2019,242705,30,2,7,3,4
2019,242705,30,3,12,7,5
2019,242705,30,4,6,4,2
2019,242705,40,0,11,5,6
2019,242705,40,3,3,2,1
2019,242705,40,4,8,3,5
2019,242705,41,0,1,1,0
2019,242705,41,4,1,1,0
2019,242705,42,0,10,4,6
2019,242705,42,3,3,2,1
2019,242705,42,4,7,2,5
2019,242705,44,0,1,1,0
2019,242705,44,4,1,1,0
2019,242723,0,0,24,15,9
2019,242723,10,0,24,15,9
2019,242723,10,1,15,9,6
2019,242723,10,2,6,4,2
2019,242723,10,3,3,2,1
2019,242723,20,0,19,11,8
2019,242723,20,1,15,9,6
2019,242723,20,2,4,2,2
2019,242723,30,0,5,4,1
2019,242723,30,2,2,2,0
2019,242723,30,3,3,2,1
2019,242972,0,0,162,36,126
2019,242972,10,0,162,36,126
2019,242972,10,1,6,4,2
2019,242972,10,2,56,19,37
2019,242972,10,4,100,13,87
2019,242972,20,0,80,27,53
2019,242972,20,1,6,4,2
2019,242972,20,2,56,19,37
2019,242972,20,4,18,4,14
2019,242972,40,0,82,9,73
2019,242972,40,4,82,9,73
2019,242972,42,0,5,0,5
2019,242972,42,4,5,0,5
2019,242972,43,0,77,9,68
2019,242972,43,4,77,9,68
2019,243081,0,0,108,41,67
2019,243081,10,0,108,41,67
2019,243081,10,1,31,14,17
2019,243081,10,2,18,7,11
2019,243081,10,3,53,18,35
2019,243081,10,4,6,2,4
2019,243081,40,0,108,41,67
2019,243081,40,1,31,14,17
2019,243081,40,2,18,7,11
2019,243081,40,3,53,18,35
2019,243081,40,4,6,2,4
2019,243081,41,0,108,41,67
2019,243081,41,1,31,14,17
2019,243081,41,2,18,7,11
2019,243081,41,3,53,18,35
2019,243081,41,4,6,2,4
2019,243081,44,0,10,2,8
2019,243081,44,1,1,0,1
2019,243081,44,3,4,1,3
2019,243081,44,4,5,1,4
2019,243081,45,0,98,39,59
2019,243081,45,1,30,14,16
2019,243081,45,2,18,7,11
2019,243081,45,3,49,17,32
2019,243081,45,4,1,1,0
2019,243106,0,0,94,46,48
2019,243106,10,0,94,46,48
2019,243106,10,1,43,22,21
2019,243106,10,2,22,12,10
2019,243106,10,3,18,6,12
2019,243106,10,4,11,6,5
2019,243106,20,0,74,37,37
2019,243106,20,1,43,22,21
2019,243106,20,2,21,11,10
2019,243106,20,3,8,2,6
2019,243106,20,4,2,2,0
2019,243106,30,0,1,1,0
2019,243106,30,2,1,1,0
2019,243106,40,0,19,8,11
2019,243106,40,3,10,4,6
2019,243106,40,4,9,4,5
2019,243106,43,0,19,8,11
2019,243106,43,3,10,4,6
2019,243106,43,4,9,4,5
2019,243115,0,0,170,80,90
2019,243115,10,0,170,80,90
2019,243115,10,1,86,42,44
2019,243115,10,2,40,16,24
2019,243115,10,3,23,14,9
2019,243115,10,4,21,8,13
2019,243115,20,0,127,62,65
2019,243115,20,1,72,34,38
2019,243115,20,2,34,13,21
2019,243115,20,3,18,12,6
2019,243115,20,4,3,3,0
2019,243115,30,0,6,3,3
2019,243115,30,2,2,1,1
2019,243115,30,3,3,2,1
2019,243115,30,4,1,0,1
2019,243115,40,0,37,15,22
2019,243115,40,1,14,8,6
2019,243115,40,2,4,2,2
2019,243115,40,3,2,0,2
2019,243115,40,4,17,5,12
2019,243115,42,0,35,15,20
2019,243115,42,1,14,8,6
2019,243115,42,2,4,2,2
2019,243115,42,3,2,0,2
2019,243115,42,4,15,5,10
2019,243115,43,0,2,0,2
2019,243115,43,4,2,0,2
2019,243133,0,0,148,73,75
2019,243133,10,0,148,73,75
2019,243133,10,1,41,23,18
2019,243133,10,2,32,13,19
2019,243133,10,3,45,19,26
2019,243133,10,4,20,14,6
2019,243133,10,6,10,4,6
2019,243133,20,0,97,47,50
2019,243133,20,1,41,23,18
2019,243133,20,2,30,13,17
2019,243133,20,3,21,9,12
2019,243133,20,6,5,2,3
2019,243133,30,0,7,2,5
2019,243133,30,2,2,0,2
2019,243133,30,3,4,2,2
2019,243133,30,6,1,0,1
2019,243133,40,0,44,24,20
2019,243133,40,3,20,8,12
2019,243133,40,4,20,14,6
2019,243133,40,6,4,2,2
2019,243133,43,0,44,24,20
2019,243133,43,3,20,8,12
2019,243133,43,4,20,14,6
2019,243133,43,6,4,2,2
2019,243142,0,0,89,46,43
2019,243142,10,0,89,46,43
2019,243142,10,1,26,15,11
2019,243142,10,2,21,10,11
2019,243142,10,3,20,9,11
2019,243142,10,4,22,12,10
2019,243142,20,0,60,32,28
2019,243142,20,1,26,15,11
2019,243142,20,2,21,10,11
2019,243142,20,3,11,5,6
2019,243142,20,4,2,2,0
2019,243142,30,0,9,5,4
2019,243142,30,3,5,3,2
2019,243142,30,4,4,2,2
2019,243142,40,0,20,9,11
2019,243142,40,3,4,1,3
2019,243142,40,4,16,8,8
2019,243142,42,0,20,9,11
2019,243142,42,3,4,1,3
2019,243142,42,4,16,8,8
2019,243151,0,0,125,63,62
2019,243151,10,0,125,63,62
2019,243151,10,1,35,18,17
2019,243151,10,2,49,21,28
2019,243151,10,3,33,20,13
2019,243151,10,4,8,4,4
2019,243151,20,0,68,39,29
2019,243151,20,1,34,18,16
2019,243151,20,2,8,5,3
2019,243151,20,3,26,16,10
2019,243151,30,0,14,7,7
2019,243151,30,2,7,3,4
2019,243151,30,3,7,4,3
2019,243151,40,0,43,17,26
2019,243151,40,1,1,0,1
2019,243151,40,2,34,13,21
2019,243151,40,4,8,4,4
2019,243151,43,0,43,17,26
2019,243151,43,1,1,0,1
2019,243151,43,2,34,13,21
2019,243151,43,4,8,4,4
2019,243179,0,0,152,73,79
2019,243179,10,0,152,73,79
2019,243179,10,1,78,40,38
2019,243179,10,2,33,14,19
2019,243179,10,3,29,16,13
2019,243179,10,4,12,3,9
2019,243179,20,0,121,61,60
2019,243179,20,1,78,40,38
2019,243179,20,2,33,14,19
2019,243179,20,3,10,7,3
2019,243179,30,0,7,2,5
2019,243179,30,3,6,2,4
2019,243179,30,4,1,0,1
2019,243179,40,0,24,10,14
2019,243179,40,3,13,7,6
2019,243179,40,4,11,3,8
2019,243179,42,0,5,5,0
2019,243179,42,3,5,5,0
2019,243179,43,0,19,5,14
2019,243179,43,3,8,2,6
2019,243179,43,4,11,3,8
2019,243188,0,0,43,23,20
2019,243188,10,0,43,23,20
2019,243188,10,1,15,9,6
2019,243188,10,2,6,3,3
2019,243188,10,3,12,6,6
2019,243188,10,4,10,5,5
2019,243188,20,0,28,16,12
2019,243188,20,1,15,9,6
2019,243188,20,2,5,2,3
2019,243188,20,3,7,4,3
2019,243188,20,4,1,1,0
2019,243188,30,0,2,2,0
2019,243188,30,2,1,1,0
2019,243188,30,3,1,1,0
2019,243188,40,0,13,5,8
2019,243188,40,3,4,1,3
2019,243188,40,4,9,4,5
2019,243188,43,0,13,5,8
2019,243188,43,3,4,1,3
2019,243188,43,4,9,4,5
2019,243197,0,0,483,304,179
2019,243197,10,0,483,304,179
2019,243197,10,1,318,213,105
2019,243197,10,2,90,53,37
2019,243197,10,3,75,38,37
2019,243197,20,0,390,255,135
2019,243197,20,1,313,210,103
2019,243197,20,2,71,41,30
2019,243197,20,3,6,4,2
2019,243197,30,0,31,18,13
2019,243197,30,1,1,0,1
2019,243197,30,2,19,12,7
2019,243197,30,3,11,6,5
2019,243197,40,0,62,31,31
2019,243197,40,1,4,3,1
2019,243197,40,3,58,28,30
2019,243197,42,0,62,31,31
2019,243197,42,1,4,3,1
2019,243197,42,3,58,28,30
2019,243203,0,0,640,247,393
2019,243203,10,0,640,247,393
2019,243203,10,1,272,120,152
2019,243203,10,2,132,51,81
2019,243203,10,3,128,54,74
2019,243203,10,4,22,6,16
2019,243203,10,6,86,16,70
2019,243203,20,0,375,156,219
2019,243203,20,1,241,105,136
2019,243203,20,2,84,33,51
2019,243203,20,3,30,13,17
2019,243203,20,4,5,1,4
2019,243203,20,6,15,4,11
2019,243203,30,0,69,28,41
2019,243203,30,1,15,6,9
2019,243203,30,2,16,6,10
2019,243203,30,3,27,12,15
2019,243203,30,4,4,1,3
2019,243203,30,6,7,3,4
2019,243203,40,0,196,63,133
2019,243203,40,1,16,9,7
2019,243203,40,2,32,12,20
2019,243203,40,3,71,29,42
2019,243203,40,4,13,4,9
2019,243203,40,6,64,9,55
2019,243203,42,0,196,63,133
2019,243203,42,1,16,9,7
2019,243203,42,2,32,12,20
2019,243203,42,3,71,29,42
2019,243203,42,4,13,4,9
2019,243203,42,6,64,9,55
2019,243212,0,0,72,29,43
2019,243212,10,0,72,29,43
2019,243212,10,1,25,10,15
2019,243212,10,2,21,8,13
2019,243212,10,3,17,4,13
2019,243212,10,4,9,7,2
2019,243212,20,0,58,25,33
2019,243212,20,1,25,10,15
2019,243212,20,2,18,6,12
2019,243212,20,3,10,4,6
2019,243212,20,4,5,5,0
2019,243212,30,0,5,2,3
2019,243212,30,2,3,2,1
2019,243212,30,3,2,0,2
2019,243212,40,0,9,2,7
2019,243212,40,3,5,0,5
2019,243212,40,4,4,2,2
2019,243212,42,0,7,1,6
2019,243212,42,3,4,0,4
2019,243212,42,4,3,1,2
2019,243212,43,0,2,1,1
2019,243212,43,3,1,0,1
2019,243212,43,4,1,1,0
2019,243221,0,0,723,390,333
2019,243221,10,0,723,390,333
2019,243221,10,1,416,236,180
2019,243221,10,2,98,45,53
2019,243221,10,3,136,72,64
2019,243221,10,4,71,36,35
2019,243221,10,6,2,1,1
2019,243221,20,0,551,299,252
2019,243221,20,1,413,236,177
2019,243221,20,2,96,45,51
2019,243221,20,3,35,14,21
2019,243221,20,4,6,3,3
2019,243221,20,6,1,1,0
2019,243221,30,0,24,13,11
2019,243221,30,2,2,0,2
2019,243221,30,3,22,13,9
2019,243221,40,0,148,78,70
2019,243221,40,1,3,0,3
2019,243221,40,3,79,45,34
2019,243221,40,4,65,33,32
2019,243221,40,6,1,0,1
2019,243221,42,0,24,14,10
2019,243221,42,1,1,0,1
2019,243221,42,3,11,7,4
2019,243221,42,4,11,7,4
2019,243221,42,6,1,0,1
2019,243221,43,0,124,64,60
2019,243221,43,1,2,0,2
2019,243221,43,3,68,38,30
2019,243221,43,4,54,26,28
2019,243346,0,0,132,57,75
2019,243346,10,0,132,57,75
2019,243346,10,1,15,6,9
2019,243346,10,2,21,7,14
2019,243346,10,3,42,19,23
2019,243346,10,4,54,25,29
2019,243346,20,0,9,5,4
2019,243346,20,1,3,1,2
2019,243346,20,2,3,2,1
2019,243346,20,3,3,2,1
2019,243346,40,0,123,52,71
2019,243346,40,1,12,5,7
2019,243346,40,2,18,5,13
2019,243346,40,3,39,17,22
2019,243346,40,4,54,25,29
2019,243346,41,0,78,35,43
2019,243346,41,1,12,5,7
2019,243346,41,2,18,5,13
2019,243346,41,3,26,10,16
2019,243346,41,4,22,15,7
2019,243346,42,0,45,17,28
2019,243346,42,3,13,7,6
2019,243346,42,4,32,10,22
2019,243346,44,0,78,35,43
2019,243346,44,1,12,5,7
2019,243346,44,2,18,5,13
2019,243346,44,3,26,10,16
2019,243346,44,4,22,15,7
2019,243443,0,0,72,23,49
2019,243443,10,0,61,19,42
2019,243443,10,1,30,10,20
2019,243443,10,2,6,0,6
2019,243443,10,3,15,7,8
2019,243443,10,4,10,2,8
2019,243443,20,0,57,18,39
2019,243443,20,1,30,10,20
2019,243443,20,2,6,0,6
2019,243443,20,3,14,6,8
2019,243443,20,4,7,2,5
2019,243443,40,0,4,1,3
2019,243443,40,3,1,1,0
2019,243443,40,4,3,0,3
2019,243443,42,0,4,1,3
2019,243443,42,3,1,1,0
2019,243443,42,4,3,0,3
2019,243443,50,0,11,4,7
2019,243498,0,0,7,4,3
2019,243498,10,0,5,3,2
2019,243498,10,1,5,3,2
2019,243498,40,0,5,3,2
2019,243498,40,1,5,3,2
2019,243498,41,0,5,3,2
2019,243498,41,1,5,3,2
2019,243498,44,0,5,3,2
2019,243498,44,1,5,3,2
2019,243498,50,0,2,1,1
2019,243568,0,0,44,18,26
2019,243568,10,0,44,18,26
2019,243568,10,1,15,8,7
2019,243568,10,2,13,5,8
2019,243568,10,3,14,4,10
2019,243568,10,4,2,1,1
2019,243568,40,0,44,18,26
2019,243568,40,1,15,8,7
2019,243568,40,2,13,5,8
2019,243568,40,3,14,4,10
2019,243568,40,4,2,1,1
2019,243568,41,0,44,18,26
2019,243568,41,1,15,8,7
2019,243568,41,2,13,5,8
2019,243568,41,3,14,4,10
2019,243568,41,4,2,1,1
2019,243568,44,0,44,18,26
2019,243568,44,1,15,8,7
2019,243568,44,2,13,5,8
2019,243568,44,3,14,4,10
2019,243568,44,4,2,1,1
2019,243577,0,0,133,88,45
2019,243577,10,0,133,88,45
2019,243577,10,1,36,27,9
2019,243577,10,2,77,49,28
2019,243577,10,3,16,10,6
2019,243577,10,4,4,2,2
2019,243577,40,0,133,88,45
2019,243577,40,1,36,27,9
2019,243577,40,2,77,49,28
2019,243577,40,3,16,10,6
2019,243577,40,4,4,2,2
2019,243577,41,0,133,88,45
2019,243577,41,1,36,27,9
2019,243577,41,2,77,49,28
2019,243577,41,3,16,10,6
2019,243577,41,4,4,2,2
2019,243577,44,0,133,88,45
2019,243577,44,1,36,27,9
2019,243577,44,2,77,49,28
2019,243577,44,3,16,10,6
2019,243577,44,4,4,2,2
2019,243586,0,0,38,19,19
2019,243586,10,0,38,19,19
2019,243586,10,1,4,3,1
2019,243586,10,2,5,4,1
2019,243586,10,3,22,10,12
2019,243586,10,4,3,1,2
2019,243586,10,6,4,1,3
2019,243586,40,0,38,19,19
2019,243586,40,1,4,3,1
2019,243586,40,2,5,4,1
2019,243586,40,3,22,10,12
2019,243586,40,4,3,1,2
2019,243586,40,6,4,1,3
2019,243586,41,0,30,17,13
2019,243586,41,1,4,3,1
2019,243586,41,2,5,4,1
2019,243586,41,3,20,10,10
2019,243586,41,4,1,0,1
2019,243586,42,0,4,1,3
2019,243586,42,3,2,0,2
2019,243586,42,4,2,1,1
2019,243586,43,0,4,1,3
2019,243586,43,6,4,1,3
2019,243586,45,0,30,17,13
2019,243586,45,1,4,3,1
2019,243586,45,2,5,4,1
2019,243586,45,3,20,10,10
2019,243586,45,4,1,0,1
2019,243601,0,0,201,85,116
2019,243601,10,0,201,85,116
2019,243601,10,1,32,17,15
2019,243601,10,2,32,10,22
2019,243601,10,3,77,37,40
2019,243601,10,4,56,20,36
2019,243601,10,6,4,1,3
2019,243601,20,0,21,8,13
2019,243601,20,1,12,4,8
2019,243601,20,2,8,3,5
2019,243601,20,3,1,1,0
2019,243601,40,0,180,77,103
2019,243601,40,1,20,13,7
2019,243601,40,2,24,7,17
2019,243601,40,3,76,36,40
2019,243601,40,4,56,20,36
2019,243601,40,6,4,1,3
2019,243601,41,0,108,50,58
2019,243601,41,1,20,13,7
2019,243601,41,2,23,7,16
2019,243601,41,3,50,23,27
2019,243601,41,4,15,7,8
2019,243601,42,0,72,27,45
2019,243601,42,2,1,0,1
2019,243601,42,3,26,13,13
2019,243601,42,4,41,13,28
2019,243601,42,6,4,1,3
2019,243601,44,0,108,50,58
2019,243601,44,1,20,13,7
2019,243601,44,2,23,7,16
2019,243601,44,3,50,23,27
2019,243601,44,4,15,7,8
2019,243638,0,0,99,61,38
2019,243638,10,0,99,61,38
2019,243638,10,1,43,28,15
2019,243638,10,2,12,9,3
2019,243638,10,3,17,11,6
2019,243638,10,4,27,13,14
2019,243638,40,0,99,61,38
2019,243638,40,1,43,28,15
2019,243638,40,2,12,9,3
2019,243638,40,3,17,11,6
2019,243638,40,4,27,13,14
2019,243638,41,0,99,61,38
2019,243638,41,1,43,28,15
2019,243638,41,2,12,9,3
2019,243638,41,3,17,11,6
2019,243638,41,4,27,13,14
2019,243638,44,0,99,61,38
2019,243638,44,1,43,28,15
2019,243638,44,2,12,9,3
2019,243638,44,3,17,11,6
2019,243638,44,4,27,13,14
2019,243647,0,0,30,14,16
2019,243647,10,0,30,14,16
2019,243647,10,2,13,5,8
2019,243647,10,4,17,9,8
2019,243647,40,0,30,14,16
2019,243647,40,2,13,5,8
2019,243647,40,4,17,9,8
2019,243647,41,0,29,13,16
2019,243647,41,2,13,5,8
2019,243647,41,4,16,8,8
2019,243647,42,0,1,1,0
2019,243647,42,4,1,1,0
2019,243647,44,0,29,13,16
2019,243647,44,2,13,5,8
2019,243647,44,4,16,8,8
2019,243665,0,0,96,44,52
2019,243665,10,0,96,44,52
2019,243665,10,1,17,12,5
2019,243665,10,2,24,16,8
2019,243665,10,3,43,13,30
2019,243665,10,4,12,3,9
2019,243665,20,0,34,25,9
2019,243665,20,1,14,11,3
2019,243665,20,2,16,12,4
2019,243665,20,3,4,2,2
2019,243665,30,0,19,7,12
2019,243665,30,2,3,1,2
2019,243665,30,3,16,6,10
2019,243665,40,0,43,12,31
2019,243665,40,1,3,1,2
2019,243665,40,2,5,3,2
2019,243665,40,3,23,5,18
2019,243665,40,4,12,3,9
2019,243665,41,0,18,6,12
2019,243665,41,1,2,0,2
2019,243665,41,2,3,2,1
2019,243665,41,3,9,2,7
2019,243665,41,4,4,2,2
2019,243665,42,0,24,6,18
2019,243665,42,1,1,1,0
2019,243665,42,2,2,1,1
2019,243665,42,3,14,3,11
2019,243665,42,4,7,1,6
2019,243665,43,0,1,0,1
2019,243665,43,4,1,0,1
2019,243665,44,0,17,6,11
2019,243665,44,1,2,0,2
2019,243665,44,2,3,2,1
2019,243665,44,3,8,2,6
2019,243665,44,4,4,2,2
2019,243665,45,0,1,0,1
2019,243665,45,3,1,0,1
2019,243744,0,0,3639,2175,1464
2019,243744,10,0,2108,1475,633
2019,243744,10,1,1240,950,290
2019,243744,10,2,428,267,161
2019,243744,10,3,440,258,182
2019,243744,20,0,1148,871,277
2019,243744,20,1,915,717,198
2019,243744,20,2,233,154,79
2019,243744,30,0,354,211,143
2019,243744,30,1,7,5,2
2019,243744,30,2,38,22,16
2019,243744,30,3,309,184,125
2019,243744,40,0,606,393,213
2019,243744,40,1,318,228,90
2019,243744,40,2,157,91,66
2019,243744,40,3,131,74,57
2019,243744,41,0,606,393,213
2019,243744,41,1,318,228,90
2019,243744,41,2,157,91,66
2019,243744,41,3,131,74,57
2019,243744,44,0,606,393,213
2019,243744,44,1,318,228,90
2019,243744,44,2,157,91,66
2019,243744,44,3,131,74,57
2019,243744,50,0,1531,700,831
2019,243780,0,0,2044,1372,672
2019,243780,10,0,1832,1277,555
2019,243780,10,1,811,640,171
2019,243780,10,2,476,303,173
2019,243780,10,3,539,329,210
2019,243780,10,4,6,5,1
2019,243780,20,0,1265,925,340
2019,243780,20,1,799,629,170
2019,243780,20,2,465,295,170
2019,243780,20,3,1,1,0
2019,243780,30,0,486,306,180
2019,243780,30,1,3,3,0
2019,243780,30,2,10,8,2
2019,243780,30,3,473,295,178
2019,243780,40,0,81,46,35
2019,243780,40,1,9,8,1
2019,243780,40,2,1,0,1
2019,243780,40,3,65,33,32
2019,243780,40,4,6,5,1
2019,243780,41,0,40,24,16
2019,243780,41,1,1,1,0
2019,243780,41,3,39,23,16
2019,243780,42,0,35,18,17
2019,243780,42,1,3,3,0
2019,243780,42,2,1,0,1
2019,243780,42,3,25,10,15
2019,243780,42,4,6,5,1
2019,243780,43,0,6,4,2
2019,243780,43,1,5,4,1
2019,243780,43,3,1,0,1
2019,243780,44,0,39,24,15
2019,243780,44,1,1,1,0
2019,243780,44,3,38,23,15
2019,243780,45,0,1,0,1
2019,243780,45,3,1,0,1
2019,243780,50,0,212,95,117
2019,243823,0,0,69,38,31
2019,243823,10,0,66,38,28
2019,243823,10,1,12,8,4
2019,243823,10,2,9,5,4
2019,243823,10,3,26,16,10
2019,243823,10,4,19,9,10
2019,243823,40,0,66,38,28
2019,243823,40,1,12,8,4
2019,243823,40,2,9,5,4
2019,243823,40,3,26,16,10
2019,243823,40,4,19,9,10
2019,243823,41,0,19,9,10
2019,243823,41,4,19,9,10
2019,243823,42,0,47,29,18
2019,243823,42,1,12,8,4
2019,243823,42,2,9,5,4
2019,243823,42,3,26,16,10
2019,243823,45,0,19,9,10
2019,243823,45,4,19,9,10
2019,243823,50,0,3,0,3
2019,243832,0,0,40,15,25
2019,243832,10,0,40,15,25
2019,243832,10,4,40,15,25
2019,243832,40,0,40,15,25
2019,243832,40,4,40,15,25
2019,243832,42,0,40,15,25
2019,243832,42,4,40,15,25
2019,243841,0,0,16,8,8
2019,243841,10,0,16,8,8
2019,243841,10,4,16,8,8
2019,243841,40,0,16,8,8
2019,243841,40,4,16,8,8
2019,243841,43,0,16,8,8
2019,243841,43,4,16,8,8
2019,244233,0,0,5,3,2
2019,244233,10,0,5,3,2
2019,244233,10,4,5,3,2
2019,244233,40,0,5,3,2
2019,244233,40,4,5,3,2
2019,244233,41,0,5,3,2
2019,244233,41,4,5,3,2
2019,244233,45,0,5,3,2
2019,244233,45,4,5,3,2
2019,244437,0,0,463,185,278
2019,244437,10,0,457,184,273
2019,244437,10,1,41,23,18
2019,244437,10,2,145,70,75
2019,244437,10,3,127,41,86
2019,244437,10,4,73,23,50
2019,244437,10,5,70,27,43
2019,244437,10,6,1,0,1
2019,244437,20,0,247,109,138
2019,244437,20,1,41,23,18
2019,244437,20,2,144,69,75
2019,244437,20,3,62,17,45
2019,244437,30,0,87,31,56
2019,244437,30,2,1,1,0
2019,244437,30,3,64,24,40
2019,244437,30,4,21,5,16
2019,244437,30,5,1,1,0
2019,244437,40,0,123,44,79
2019,244437,40,3,1,0,1
2019,244437,40,4,52,18,34
2019,244437,40,5,69,26,43
2019,244437,40,6,1,0,1
2019,244437,41,0,2,1,1
2019,244437,41,4,2,1,1
2019,244437,42,0,121,43,78
2019,244437,42,3,1,0,1
2019,244437,42,4,50,17,33
2019,244437,42,5,69,26,43
2019,244437,42,6,1,0,1
2019,244437,45,0,2,1,1
2019,244437,45,4,2,1,1
2019,244437,50,0,6,1,5
2019,244446,0,0,79,41,38
2019,244446,10,0,79,41,38
2019,244446,10,6,79,41,38
2019,244446,40,0,79,41,38
2019,244446,40,6,79,41,38
2019,244446,41,0,79,41,38
2019,244446,41,6,79,41,38
2019,244446,44,0,79,41,38
2019,244446,44,6,79,41,38
2019,245625,0,0,23,8,15
2019,245625,10,0,16,6,10
2019,245625,10,1,6,3,3
2019,245625,10,2,6,3,3
2019,245625,10,3,4,0,4
2019,245625,20,0,16,6,10
2019,245625,20,1,6,3,3
2019,245625,20,2,6,3,3
2019,245625,20,3,4,0,4
2019,245625,50,0,7,2,5
2019,245652,0,0,35,26,9
2019,245652,10,0,35,26,9
2019,245652,10,6,35,26,9
2019,245652,20,0,30,24,6
2019,245652,20,6,30,24,6
2019,245652,30,0,5,2,3
2019,245652,30,6,5,2,3
2019,245838,0,0,29,13,16
2019,245838,50,0,29,13,16
2019,245847,0,0,12,3,9
2019,245847,50,0,12,3,9
2019,245865,0,0,58,20,38
2019,245865,50,0,58,20,38
2019,245883,0,0,50,13,37
2019,245883,50,0,50,13,37
2019,245953,0,0,32,17,15
2019,245953,10,0,32,17,15
2019,245953,10,1,8,4,4
2019,245953,10,2,12,8,4
2019,245953,10,3,11,4,7
2019,245953,10,4,1,1,0
2019,245953,40,0,32,17,15
2019,245953,40,1,8,4,4
2019,245953,40,2,12,8,4
2019,245953,40,3,11,4,7
2019,245953,40,4,1,1,0
2019,245953,42,0,32,17,15
2019,245953,42,1,8,4,4
2019,245953,42,2,12,8,4
2019,245953,42,3,11,4,7
2019,245953,42,4,1,1,0
2019,245962,0,0,11,6,5
2019,245962,10,0,11,6,5
2019,245962,10,4,11,6,5
2019,245962,40,0,11,6,5
2019,245962,40,4,11,6,5
2019,245962,41,0,11,6,5
2019,245962,41,4,11,6,5
2019,245962,45,0,11,6,5
2019,245962,45,4,11,6,5
2019,246354,0,0,149,75,74
2019,246354,10,0,105,53,52
2019,246354,10,1,25,13,12
2019,246354,10,2,14,6,8
2019,246354,10,3,26,17,9
2019,246354,10,4,40,17,23
2019,246354,20,0,63,32,31
2019,246354,20,1,25,13,12
2019,246354,20,2,13,6,7
2019,246354,20,3,16,10,6
2019,246354,20,4,9,3,6
2019,246354,40,0,42,21,21
2019,246354,40,2,1,0,1
2019,246354,40,3,10,7,3
2019,246354,40,4,31,14,17
2019,246354,42,0,42,21,21
2019,246354,42,2,1,0,1
2019,246354,42,3,10,7,3
2019,246354,42,4,31,14,17
2019,246354,50,0,44,22,22
2019,246813,0,0,101,40,61
2019,246813,10,0,101,40,61
2019,246813,10,6,101,40,61
2019,246813,40,0,101,40,61
2019,246813,40,6,101,40,61
2019,246813,41,0,101,40,61
2019,246813,41,6,101,40,61
2019,246813,45,0,101,40,61
2019,246813,45,6,101,40,61
2019,247065,0,0,18,2,16
2019,247065,10,0,18,2,16
2019,247065,10,4,18,2,16
2019,247065,40,0,18,2,16
2019,247065,40,4,18,2,16
2019,247065,41,0,18,2,16
2019,247065,41,4,18,2,16
2019,247065,44,0,18,2,16
2019,247065,44,4,18,2,16
2019,247603,0,0,28,13,15
2019,247603,10,0,24,10,14
2019,247603,10,1,5,2,3
2019,247603,10,2,7,4,3
2019,247603,10,3,8,2,6
2019,247603,10,4,4,2,2
2019,247603,20,0,21,8,13
2019,247603,20,1,5,2,3
2019,247603,20,2,7,4,3
2019,247603,20,3,8,2,6
2019,247603,20,4,1,0,1
2019,247603,30,0,3,2,1
2019,247603,30,4,3,2,1
2019,247603,50,0,4,3,1
2019,247649,0,0,68,30,38
2019,247649,10,0,68,30,38
2019,247649,10,1,8,3,5
2019,247649,10,2,39,15,24
2019,247649,10,3,21,12,9
2019,247649,40,0,68,30,38
2019,247649,40,1,8,3,5
2019,247649,40,2,39,15,24
2019,247649,40,3,21,12,9
2019,247649,41,0,68,30,38
2019,247649,41,1,8,3,5
2019,247649,41,2,39,15,24
2019,247649,41,3,21,12,9
2019,247649,45,0,68,30,38
2019,247649,45,1,8,3,5
2019,247649,45,2,39,15,24
2019,247649,45,3,21,12,9
2019,247834,0,0,468,194,274
2019,247834,10,0,468,194,274
2019,247834,10,6,468,194,274
2019,247834,40,0,468,194,274
2019,247834,40,6,468,194,274
2019,247834,41,0,325,137,188
2019,247834,41,6,325,137,188
2019,247834,42,0,143,57,86
2019,247834,42,6,143,57,86
2019,247834,44,0,325,137,188
2019,247834,44,6,325,137,188
2019,247940,0,0,79,41,38
2019,247940,10,0,79,41,38
2019,247940,10,1,32,18,14
2019,247940,10,2,27,13,14
2019,247940,10,3,8,6,2
2019,247940,10,4,12,4,8
2019,247940,20,0,24,13,11
2019,247940,20,1,19,11,8
2019,247940,20,2,5,2,3
2019,247940,30,0,2,1,1
2019,247940,30,2,1,1,0
2019,247940,30,3,1,0,1
2019,247940,40,0,53,27,26
2019,247940,40,1,13,7,6
2019,247940,40,2,21,10,11
2019,247940,40,3,7,6,1
2019,247940,40,4,12,4,8
2019,247940,42,0,11,7,4
2019,247940,42,1,3,2,1
2019,247940,42,2,3,3,0
2019,247940,42,3,3,2,1
2019,247940,42,4,2,0,2
2019,247940,43,0,42,20,22
2019,247940,43,1,10,5,5
2019,247940,43,2,18,7,11
2019,247940,43,3,4,4,0
2019,247940,43,4,10,4,6
2019,248934,0,0,428,174,254
2019,248934,10,0,421,167,254
2019,248934,10,1,21,12,9
2019,248934,10,2,176,111,65
2019,248934,10,4,224,44,180
2019,248934,40,0,421,167,254
2019,248934,40,1,21,12,9
2019,248934,40,2,176,111,65
2019,248934,40,4,224,44,180
2019,248934,41,0,421,167,254
2019,248934,41,1,21,12,9
2019,248934,41,2,176,111,65
2019,248934,41,4,224,44,180
2019,248934,45,0,421,167,254
2019,248934,45,1,21,12,9
2019,248934,45,2,176,111,65
2019,248934,45,4,224,44,180
2019,248934,50,0,7,7,0
2019,250027,0,0,20,10,10
2019,250027,10,0,20,10,10
2019,250027,10,4,20,10,10
2019,250027,40,0,20,10,10
2019,250027,40,4,20,10,10
2019,250027,41,0,20,10,10
2019,250027,41,4,20,10,10
2019,250027,45,0,20,10,10
2019,250027,45,4,20,10,10
2019,251260,0,0,95,41,54
2019,251260,10,0,95,41,54
2019,251260,10,6,95,41,54
2019,251260,20,0,71,30,41
2019,251260,20,6,71,30,41
2019,251260,30,0,19,9,10
2019,251260,30,6,19,9,10
2019,251260,40,0,5,2,3
2019,251260,40,6,5,2,3
2019,251260,42,0,5,2,3
2019,251260,42,6,5,2,3
2019,251312,0,0,20,5,15
2019,251312,10,0,20,5,15
2019,251312,10,2,1,0,1
2019,251312,10,3,13,4,9
2019,251312,10,4,6,1,5
2019,251312,40,0,20,5,15
2019,251312,40,2,1,0,1
2019,251312,40,3,13,4,9
2019,251312,40,4,6,1,5
2019,251312,41,0,20,5,15
2019,251312,41,2,1,0,1
2019,251312,41,3,13,4,9
2019,251312,41,4,6,1,5
2019,251312,45,0,20,5,15
2019,251312,45,2,1,0,1
2019,251312,45,3,13,4,9
2019,251312,45,4,6,1,5
2019,260372,0,0,14,7,7
2019,260372,10,0,14,7,7
2019,260372,10,4,14,7,7
2019,260372,40,0,14,7,7
2019,260372,40,4,14,7,7
2019,260372,41,0,14,7,7
2019,260372,41,4,14,7,7
2019,260372,45,0,14,7,7
2019,260372,45,4,14,7,7
2019,260691,0,0,55,14,41
2019,260691,10,0,55,14,41
2019,260691,10,4,55,14,41
2019,260691,40,0,55,14,41
2019,260691,40,4,55,14,41
2019,260691,41,0,55,14,41
2019,260691,41,4,55,14,41
2019,260691,45,0,55,14,41
2019,260691,45,4,55,14,41
2019,260789,0,0,17,5,12
2019,260789,10,0,17,5,12
2019,260789,10,4,17,5,12
2019,260789,40,0,17,5,12
2019,260789,40,4,17,5,12
2019,260789,41,0,17,5,12
2019,260789,41,4,17,5,12
2019,260789,45,0,17,5,12
2019,260789,45,4,17,5,12
2019,260813,0,0,9,2,7
2019,260813,10,0,9,2,7
2019,260813,10,4,9,2,7
2019,260813,40,0,9,2,7
2019,260813,40,4,9,2,7
2019,260813,42,0,9,2,7
2019,260813,42,4,9,2,7
2019,260992,0,0,14,1,13
2019,260992,10,0,14,1,13
2019,260992,10,2,4,1,3
2019,260992,10,3,2,0,2
2019,260992,10,4,8,0,8
2019,260992,40,0,14,1,13
2019,260992,40,2,4,1,3
2019,260992,40,3,2,0,2
2019,260992,40,4,8,0,8
2019,260992,41,0,14,1,13
2019,260992,41,2,4,1,3
2019,260992,41,3,2,0,2
2019,260992,41,4,8,0,8
2019,260992,45,0,14,1,13
2019,260992,45,2,4,1,3
2019,260992,45,3,2,0,2
2019,260992,45,4,8,0,8
2019,262031,0,0,104,38,66
2019,262031,10,0,104,38,66
2019,262031,10,1,34,12,22
2019,262031,10,2,23,12,11
2019,262031,10,3,21,7,14
2019,262031,10,4,26,7,19
2019,262031,20,0,64,25,39
2019,262031,20,1,34,12,22
2019,262031,20,2,19,8,11
2019,262031,20,3,8,5,3
2019,262031,20,4,3,0,3
2019,262031,30,0,31,9,22
2019,262031,30,2,3,3,0
2019,262031,30,3,12,2,10
2019,262031,30,4,16,4,12
2019,262031,40,0,9,4,5
2019,262031,40,2,1,1,0
2019,262031,40,3,1,0,1
2019,262031,40,4,7,3,4
2019,262031,42,0,5,2,3
2019,262031,42,2,1,1,0
2019,262031,42,4,4,1,3
2019,262031,43,0,4,2,2
2019,262031,43,3,1,0,1
2019,262031,43,4,3,2,1
2019,262086,0,0,91,27,64
2019,262086,10,0,91,27,64
2019,262086,10,1,15,7,8
2019,262086,10,2,32,12,20
2019,262086,10,3,44,8,36
2019,262086,40,0,91,27,64
2019,262086,40,1,15,7,8
2019,262086,40,2,32,12,20
2019,262086,40,3,44,8,36
2019,262086,41,0,43,16,27
2019,262086,41,1,13,6,7
2019,262086,41,2,22,8,14
2019,262086,41,3,8,2,6
2019,262086,42,0,48,11,37
2019,262086,42,1,2,1,1
2019,262086,42,2,10,4,6
2019,262086,42,3,36,6,30
2019,262086,44,0,43,16,27
2019,262086,44,1,13,6,7
2019,262086,44,2,22,8,14
2019,262086,44,3,8,2,6
2019,262129,0,0,105,49,56
2019,262129,10,0,105,49,56
2019,262129,10,1,32,19,13
2019,262129,10,2,25,7,18
2019,262129,10,3,41,22,19
2019,262129,10,4,4,0,4
2019,262129,10,6,3,1,2
2019,262129,20,0,55,24,31
2019,262129,20,1,30,17,13
2019,262129,20,2,25,7,18
2019,262129,30,0,35,21,14
2019,262129,30,1,2,2,0
2019,262129,30,3,33,19,14
2019,262129,40,0,15,4,11
2019,262129,40,3,8,3,5
2019,262129,40,4,4,0,4
2019,262129,40,6,3,1,2
2019,262129,42,0,15,4,11
2019,262129,42,3,8,3,5
2019,262129,42,4,4,0,4
2019,262129,42,6,3,1,2
2019,363439,0,0,3,2,1
2019,363439,10,0,3,2,1
2019,363439,10,4,3,2,1
2019,363439,40,0,3,2,1
2019,363439,40,4,3,2,1
2019,363439,41,0,3,2,1
2019,363439,41,4,3,2,1
2019,363439,45,0,3,2,1
2019,363439,45,4,3,2,1
2019,363633,0,0,25,9,16
2019,363633,10,0,25,9,16
2019,363633,10,4,25,9,16
2019,363633,40,0,25,9,16
2019,363633,40,4,25,9,16
2019,363633,42,0,3,2,1
2019,363633,42,4,3,2,1
2019,363633,43,0,22,7,15
2019,363633,43,4,22,7,15
2019,363721,0,0,23,6,17
2019,363721,10,0,21,6,15
2019,363721,10,1,14,4,10
2019,363721,10,2,3,0,3
2019,363721,10,3,4,2,2
2019,363721,20,0,14,4,10
2019,363721,20,1,14,4,10
2019,363721,30,0,5,1,4
2019,363721,30,2,3,0,3
2019,363721,30,3,2,1,1
2019,363721,40,0,2,1,1
2019,363721,40,3,2,1,1
2019,363721,42,0,2,1,1
2019,363721,42,3,2,1,1
2019,363721,50,0,2,0,2
2019,363907,0,0,20,7,13
2019,363907,10,0,20,7,13
2019,363907,10,1,1,1,0
2019,363907,10,3,6,3,3
2019,363907,10,4,13,3,10
2019,363907,40,0,20,7,13
2019,363907,40,1,1,1,0
2019,363907,40,3,6,3,3
2019,363907,40,4,13,3,10
2019,363907,42,0,20,7,13
2019,363907,42,1,1,1,0
2019,363907,42,3,6,3,3
2019,363907,42,4,13,3,10
2019,363916,0,0,5,2,3
2019,363916,10,0,5,2,3
2019,363916,10,4,5,2,3
2019,363916,40,0,5,2,3
2019,363916,40,4,5,2,3
2019,363916,42,0,5,2,3
2019,363916,42,4,5,2,3
2019,363934,0,0,30,18,12
2019,363934,10,0,26,17,9
2019,363934,10,1,26,17,9
2019,363934,40,0,26,17,9
2019,363934,40,1,26,17,9
2019,363934,41,0,26,17,9
2019,363934,41,1,26,17,9
2019,363934,45,0,26,17,9
2019,363934,45,1,26,17,9
2019,363934,50,0,4,1,3
2019,364016,0,0,114,52,62
2019,364016,10,0,114,52,62
2019,364016,10,6,114,52,62
2019,364016,20,0,70,38,32
2019,364016,20,6,70,38,32
2019,364016,30,0,37,11,26
2019,364016,30,6,37,11,26
2019,364016,40,0,7,3,4
2019,364016,40,6,7,3,4
2019,364016,42,0,5,2,3
2019,364016,42,6,5,2,3
2019,364016,43,0,2,1,1
2019,364016,43,6,2,1,1
2019,364025,0,0,141,57,84
2019,364025,10,0,141,57,84
2019,364025,10,6,141,57,84
2019,364025,20,0,76,31,45
2019,364025,20,6,76,31,45
2019,364025,30,0,55,21,34
2019,364025,30,6,55,21,34
2019,364025,40,0,10,5,5
2019,364025,40,6,10,5,5
2019,364025,42,0,9,4,5
2019,364025,42,6,9,4,5
2019,364025,43,0,1,1,0
2019,364025,43,6,1,1,0
2019,365204,0,0,101,30,71
2019,365204,50,0,101,30,71
2019,366003,0,0,13,7,6
2019,366003,10,0,13,7,6
2019,366003,10,1,11,7,4
2019,366003,10,4,2,0,2
2019,366003,40,0,13,7,6
2019,366003,40,1,11,7,4
2019,366003,40,4,2,0,2
2019,366003,41,0,12,7,5
2019,366003,41,1,10,7,3
2019,366003,41,4,2,0,2
2019,366003,43,0,1,0,1
2019,366003,43,1,1,0,1
2019,366003,45,0,12,7,5
2019,366003,45,1,10,7,3
2019,366003,45,4,2,0,2
2019,366252,0,0,280,196,84
2019,366252,10,0,280,196,84
2019,366252,10,1,11,10,1
2019,366252,10,2,47,30,17
2019,366252,10,3,88,57,31
2019,366252,10,4,125,94,31
2019,366252,10,5,9,5,4
2019,366252,40,0,280,196,84
2019,366252,40,1,11,10,1
2019,366252,40,2,47,30,17
2019,366252,40,3,88,57,31
2019,366252,40,4,125,94,31
2019,366252,40,5,9,5,4
2019,366252,42,0,280,196,84
2019,366252,42,1,11,10,1
2019,366252,42,2,47,30,17
2019,366252,42,3,88,57,31
2019,366252,42,4,125,94,31
2019,366252,42,5,9,5,4
2019,366270,0,0,15,1,14
2019,366270,10,0,15,1,14
2019,366270,10,6,15,1,14
2019,366270,40,0,15,1,14
2019,366270,40,6,15,1,14
2019,366270,41,0,15,1,14
2019,366270,41,6,15,1,14
2019,366270,45,0,15,1,14
2019,366270,45,6,15,1,14
2019,366289,0,0,2,1,1
2019,366289,10,0,2,1,1
2019,366289,10,4,2,1,1
2019,366289,40,0,2,1,1
2019,366289,40,4,2,1,1
2019,366289,41,0,2,1,1
2019,366289,41,4,2,1,1
2019,366289,45,0,2,1,1
2019,366289,45,4,2,1,1
2019,366340,0,0,9,5,4
2019,366340,10,0,9,5,4
2019,366340,10,4,9,5,4
2019,366340,40,0,9,5,4
2019,366340,40,4,9,5,4
2019,366340,42,0,9,5,4
2019,366340,42,4,9,5,4
2019,366368,0,0,6,4,2
2019,366368,10,0,6,4,2
2019,366368,10,1,6,4,2
2019,366368,40,0,6,4,2
2019,366368,40,1,6,4,2
2019,366368,41,0,5,3,2
2019,366368,41,1,5,3,2
2019,366368,42,0,1,1,0
2019,366368,42,1,1,1,0
2019,366368,44,0,5,3,2
2019,366368,44,1,5,3,2
2019,366395,0,0,324,169,155
2019,366395,10,0,324,169,155
2019,366395,10,1,156,77,79
2019,366395,10,2,84,47,37
2019,366395,10,3,65,33,32
2019,366395,10,4,19,12,7
2019,366395,20,0,198,104,94
2019,366395,20,1,140,67,73
2019,366395,20,2,40,25,15
2019,366395,20,3,18,12,6
2019,366395,30,0,126,65,61
2019,366395,30,1,16,10,6
2019,366395,30,2,44,22,22
2019,366395,30,3,47,21,26
2019,366395,30,4,19,12,7
2019,366401,0,0,130,60,70
2019,366401,10,0,130,60,70
2019,366401,10,4,130,60,70
2019,366401,20,0,76,33,43
2019,366401,20,4,76,33,43
2019,366401,30,0,47,25,22
2019,366401,30,4,47,25,22
2019,366401,40,0,7,2,5
2019,366401,40,4,7,2,5
2019,366401,43,0,7,2,5
2019,366401,43,4,7,2,5
2019,366465,0,0,66,26,40
2019,366465,50,0,66,26,40
2019,366535,0,0,16,5,11
2019,366535,50,0,16,5,11
2019,366553,0,0,36,4,32
2019,366553,10,0,36,4,32
2019,366553,10,4,36,4,32
2019,366553,40,0,36,4,32
2019,366553,40,4,36,4,32
2019,366553,41,0,36,4,32
2019,366553,41,4,36,4,32
2019,366553,45,0,36,4,32
2019,366553,45,4,36,4,32
2019,366711,0,0,392,174,218
2019,366711,10,0,392,174,218
2019,366711,10,1,111,55,56
2019,366711,10,2,81,45,36
2019,366711,10,3,90,41,49
2019,366711,10,5,109,32,77
2019,366711,10,6,1,1,0
2019,366711,20,0,188,96,92
2019,366711,20,1,111,55,56
2019,366711,20,2,76,40,36
2019,366711,20,6,1,1,0
2019,366711,30,0,95,46,49
2019,366711,30,2,5,5,0
2019,366711,30,3,90,41,49
2019,366711,40,0,109,32,77
2019,366711,40,5,109,32,77
2019,366711,41,0,73,22,51
2019,366711,41,5,73,22,51
2019,366711,42,0,32,8,24
2019,366711,42,5,32,8,24
2019,366711,43,0,4,2,2
2019,366711,43,5,4,2,2
2019,366711,44,0,73,22,51
2019,366711,44,5,73,22,51
2019,367112,0,0,6,1,5
2019,367112,10,0,6,1,5
2019,367112,10,4,6,1,5
2019,367112,40,0,6,1,5
2019,367112,40,4,6,1,5
2019,367112,41,0,6,1,5
2019,367112,41,4,6,1,5
2019,367112,45,0,6,1,5
2019,367112,45,4,6,1,5
2019,367459,0,0,156,69,87
2019,367459,10,0,156,69,87
2019,367459,10,1,34,15,19
2019,367459,10,2,11,4,7
2019,367459,10,3,4,1,3
2019,367459,10,4,3,2,1
2019,367459,10,6,104,47,57
2019,367459,40,0,156,69,87
2019,367459,40,1,34,15,19
2019,367459,40,2,11,4,7
2019,367459,40,3,4,1,3
2019,367459,40,4,3,2,1
2019,367459,40,6,104,47,57
2019,367459,42,0,150,66,84
2019,367459,42,1,34,15,19
2019,367459,42,2,11,4,7
2019,367459,42,3,4,1,3
2019,367459,42,4,3,2,1
2019,367459,42,6,98,44,54
2019,367459,43,0,6,3,3
2019,367459,43,6,6,3,3
2019,367884,0,0,26,13,13
2019,367884,10,0,26,13,13
2019,367884,10,1,10,4,6
2019,367884,10,2,6,3,3
2019,367884,10,3,10,6,4
2019,367884,40,0,26,13,13
2019,367884,40,1,10,4,6
2019,367884,40,2,6,3,3
2019,367884,40,3,10,6,4
2019,367884,41,0,18,11,7
2019,367884,41,1,7,4,3
2019,367884,41,2,3,2,1
2019,367884,41,3,8,5,3
2019,367884,42,0,2,0,2
2019,367884,42,1,2,0,2
2019,367884,43,0,6,2,4
2019,367884,43,1,1,0,1
2019,367884,43,2,3,1,2
2019,367884,43,3,2,1,1
2019,367884,44,0,18,11,7
2019,367884,44,1,7,4,3
2019,367884,44,2,3,2,1
2019,367884,44,3,8,5,3
2019,367954,0,0,166,50,116
2019,367954,10,0,166,50,116
2019,367954,10,1,6,3,3
2019,367954,10,2,18,6,12
2019,367954,10,3,99,30,69
2019,367954,10,4,42,11,31
2019,367954,10,5,1,0,1
2019,367954,40,0,166,50,116
2019,367954,40,1,6,3,3
2019,367954,40,2,18,6,12
2019,367954,40,3,99,30,69
2019,367954,40,4,42,11,31
2019,367954,40,5,1,0,1
2019,367954,41,0,166,50,116
2019,367954,41,1,6,3,3
2019,367954,41,2,18,6,12
2019,367954,41,3,99,30,69
2019,367954,41,4,42,11,31
2019,367954,41,5,1,0,1
2019,367954,45,0,166,50,116
2019,367954,45,1,6,3,3
2019,367954,45,2,18,6,12
2019,367954,45,3,99,30,69
2019,367954,45,4,42,11,31
2019,367954,45,5,1,0,1
2019,368443,0,0,20,6,14
2019,368443,10,0,20,6,14
2019,368443,10,4,20,6,14
2019,368443,40,0,20,6,14
2019,368443,40,4,20,6,14
2019,368443,41,0,20,6,14
2019,368443,41,4,20,6,14
2019,368443,45,0,20,6,14
2019,368443,45,4,20,6,14
2019,368452,0,0,4,4,0
2019,368452,10,0,4,4,0
2019,368452,10,4,4,4,0
2019,368452,40,0,4,4,0
2019,368452,40,4,4,4,0
2019,368452,43,0,4,4,0
2019,368452,43,4,4,4,0
2019,368629,0,0,25,3,22
2019,368629,10,0,25,3,22
2019,368629,10,4,25,3,22
2019,368629,40,0,25,3,22
2019,368629,40,4,25,3,22
2019,368629,41,0,25,3,22
2019,368629,41,4,25,3,22
2019,368629,45,0,25,3,22
2019,368629,45,4,25,3,22
2019,368911,0,0,71,22,49
2019,368911,10,0,71,22,49
2019,368911,10,4,71,22,49
2019,368911,40,0,71,22,49
2019,368911,40,4,71,22,49
2019,368911,41,0,71,22,49
2019,368911,41,4,71,22,49
2019,368911,45,0,71,22,49
2019,368911,45,4,71,22,49
2019,369002,0,0,13,9,4
2019,369002,10,0,13,9,4
2019,369002,10,1,6,4,2
2019,369002,10,2,3,2,1
2019,369002,10,3,4,3,1
2019,369002,20,0,6,4,2
2019,369002,20,1,6,4,2
2019,369002,30,0,7,5,2
2019,369002,30,2,3,2,1
2019,369002,30,3,4,3,1
2019,369516,0,0,9,4,5
2019,369516,50,0,9,4,5
2019,369659,0,0,5,4,1
2019,369659,10,0,5,4,1
2019,369659,10,6,5,4,1
2019,369659,40,0,5,4,1
2019,369659,40,6,5,4,1
2019,369659,42,0,5,4,1
2019,369659,42,6,5,4,1
2019,369668,0,0,20,13,7
2019,369668,10,0,20,13,7
2019,369668,10,4,20,13,7
2019,369668,40,0,20,13,7
2019,369668,40,4,20,13,7
2019,369668,41,0,20,13,7
2019,369668,41,4,20,13,7
2019,369668,44,0,20,13,7
2019,369668,44,4,20,13,7
2019,371964,0,0,10,6,4
2019,371964,10,0,10,6,4
2019,371964,10,6,10,6,4
2019,371964,40,0,10,6,4
2019,371964,40,6,10,6,4
2019,371964,41,0,10,6,4
2019,371964,41,6,10,6,4
2019,371964,45,0,10,6,4
2019,371964,45,6,10,6,4
2019,372073,0,0,3,1,2
2019,372073,10,0,3,1,2
2019,372073,10,4,3,1,2
2019,372073,40,0,3,1,2
2019,372073,40,4,3,1,2
2019,372073,41,0,3,1,2
2019,372073,41,4,3,1,2
2019,372073,45,0,3,1,2
2019,372073,45,4,3,1,2
2019,372329,0,0,19,4,15
2019,372329,10,0,19,4,15
2019,372329,10,6,19,4,15
2019,372329,40,0,19,4,15
2019,372329,40,6,19,4,15
2019,372329,41,0,19,4,15
2019,372329,41,6,19,4,15
2019,372329,44,0,19,4,15
2019,372329,44,6,19,4,15
2019,372921,0,0,10,4,6
2019,372921,10,0,10,4,6
2019,372921,10,4,10,4,6
2019,372921,40,0,10,4,6
2019,372921,40,4,10,4,6
2019,372921,41,0,10,4,6
2019,372921,41,4,10,4,6
2019,372921,44,0,10,4,6
2019,372921,44,4,10,4,6
2019,372958,0,0,15,9,6
2019,372958,50,0,15,9,6
2019,374024,0,0,17,4,13
2019,374024,10,0,17,4,13
2019,374024,10,4,17,4,13
2019,374024,40,0,17,4,13
2019,374024,40,4,17,4,13
2019,374024,41,0,17,4,13
2019,374024,41,4,17,4,13
2019,374024,45,0,17,4,13
2019,374024,45,4,17,4,13
2019,375416,0,0,28,10,18
2019,375416,50,0,28,10,18
2019,376224,0,0,2,0,2
2019,376224,10,0,2,0,2
2019,376224,10,1,2,0,2
2019,376224,20,0,2,0,2
2019,376224,20,1,2,0,2
2019,376321,0,0,47,9,38
2019,376321,10,0,36,6,30
2019,376321,10,1,36,6,30
2019,376321,40,0,36,6,30
2019,376321,40,1,36,6,30
2019,376321,41,0,36,6,30
2019,376321,41,1,36,6,30
2019,376321,44,0,36,6,30
2019,376321,44,1,36,6,30
2019,376321,50,0,11,3,8
2019,376385,0,0,17,10,7
2019,376385,10,0,17,10,7
2019,376385,10,1,17,10,7
2019,376385,40,0,17,10,7
2019,376385,40,1,17,10,7
2019,376385,43,0,17,10,7
2019,376385,43,1,17,10,7
2019,376695,0,0,57,36,21
2019,376695,10,0,57,36,21
2019,376695,10,4,57,36,21
2019,376695,40,0,57,36,21
2019,376695,40,4,57,36,21
2019,376695,41,0,53,34,19
2019,376695,41,4,53,34,19
2019,376695,42,0,3,2,1
2019,376695,42,4,3,2,1
2019,376695,43,0,1,0,1
2019,376695,43,4,1,0,1
2019,376695,44,0,53,34,19
2019,376695,44,4,53,34,19
2019,377111,0,0,22,17,5
2019,377111,50,0,22,17,5
2019,377218,0,0,8,8,0
2019,377218,50,0,8,8,0
2019,377342,0,0,2,0,2
2019,377342,50,0,2,0,2
2019,377449,0,0,9,2,7
2019,377449,50,0,9,2,7
2019,377458,0,0,18,9,9
2019,377458,50,0,18,9,9
2019,377555,0,0,215,107,108
2019,377555,10,0,215,107,108
2019,377555,10,1,31,19,12
2019,377555,10,2,53,29,24
2019,377555,10,3,57,25,32
2019,377555,10,5,74,34,40
2019,377555,20,0,84,48,36
2019,377555,20,1,31,19,12
2019,377555,20,2,53,29,24
2019,377555,30,0,56,25,31
2019,377555,30,3,56,25,31
2019,377555,40,0,75,34,41
2019,377555,40,3,1,0,1
2019,377555,40,5,74,34,40
2019,377555,41,0,69,32,37
2019,377555,41,5,69,32,37
2019,377555,42,0,6,2,4
2019,377555,42,3,1,0,1
2019,377555,42,5,5,2,3
2019,377555,44,0,69,32,37
2019,377555,44,5,69,32,37
2019,377564,0,0,271,123,148
2019,377564,10,0,271,123,148
2019,377564,10,1,47,28,19
2019,377564,10,2,73,37,36
2019,377564,10,3,63,24,39
2019,377564,10,5,88,34,54
2019,377564,20,0,120,65,55
2019,377564,20,1,47,28,19
2019,377564,20,2,73,37,36
2019,377564,30,0,63,24,39
2019,377564,30,3,63,24,39
2019,377564,40,0,88,34,54
2019,377564,40,5,88,34,54
2019,377564,41,0,71,30,41
2019,377564,41,5,71,30,41
2019,377564,42,0,17,4,13
2019,377564,42,5,17,4,13
2019,377564,44,0,71,30,41
2019,377564,44,5,71,30,41
2019,377661,0,0,1,0,1
2019,377661,10,0,1,0,1
2019,377661,10,4,1,0,1
2019,377661,40,0,1,0,1
2019,377661,40,4,1,0,1
2019,377661,41,0,1,0,1
2019,377661,41,4,1,0,1
2019,377661,45,0,1,0,1
2019,377661,45,4,1,0,1
2019,378105,0,0,4,0,4
2019,378105,10,0,4,0,4
2019,378105,10,4,4,0,4
2019,378105,40,0,4,0,4
2019,378105,40,4,4,0,4
2019,378105,41,0,4,0,4
2019,378105,41,4,4,0,4
2019,378105,45,0,4,0,4
2019,378105,45,4,4,0,4
2019,378576,0,0,13,10,3
2019,378576,10,0,13,10,3
2019,378576,10,4,13,10,3
2019,378576,40,0,13,10,3
2019,378576,40,4,13,10,3
2019,378576,42,0,7,4,3
2019,378576,42,4,7,4,3
2019,378576,43,0,6,6,0
2019,378576,43,4,6,6,0
2019,380359,0,0,15,8,7
2019,380359,10,0,15,8,7
2019,380359,10,6,15,8,7
2019,380359,40,0,15,8,7
2019,380359,40,6,15,8,7
2019,380359,42,0,15,8,7
2019,380359,42,6,15,8,7
2019,380368,0,0,24,13,11
2019,380368,10,0,24,13,11
2019,380368,10,4,24,13,11
2019,380368,20,0,17,11,6
2019,380368,20,4,17,11,6
2019,380368,30,0,7,2,5
2019,380368,30,4,7,2,5
2019,380377,0,0,26,10,16
2019,380377,10,0,26,10,16
2019,380377,10,6,26,10,16
2019,380377,40,0,26,10,16
2019,380377,40,6,26,10,16
2019,380377,42,0,26,10,16
2019,380377,42,6,26,10,16
2019,380438,0,0,28,4,24
2019,380438,10,0,28,4,24
2019,380438,10,4,28,4,24
2019,380438,40,0,28,4,24
2019,380438,40,4,28,4,24
2019,380438,41,0,18,0,18
2019,380438,41,4,18,0,18
2019,380438,43,0,10,4,6
2019,380438,43,4,10,4,6
2019,380438,45,0,18,0,18
2019,380438,45,4,18,0,18
2019,381459,0,0,6,6,0
2019,381459,10,0,6,6,0
2019,381459,10,1,4,4,0
2019,381459,10,2,1,1,0
2019,381459,10,3,1,1,0
2019,381459,40,0,6,6,0
2019,381459,40,1,4,4,0
2019,381459,40,2,1,1,0
2019,381459,40,3,1,1,0
2019,381459,42,0,6,6,0
2019,381459,42,1,4,4,0
2019,381459,42,2,1,1,0
2019,381459,42,3,1,1,0
2019,382957,0,0,17,4,13
2019,382957,10,0,17,4,13
2019,382957,10,4,17,4,13
2019,382957,40,0,17,4,13
2019,382957,40,4,17,4,13
2019,382957,41,0,17,4,13
2019,382957,41,4,17,4,13
2019,382957,45,0,17,4,13
2019,382957,45,4,17,4,13
2019,383084,0,0,18,7,11
2019,383084,10,0,18,7,11
2019,383084,10,4,18,7,11
2019,383084,20,0,14,5,9
2019,383084,20,4,14,5,9
2019,383084,30,0,4,2,2
2019,383084,30,4,4,2,2
2019,383190,0,0,88,35,53
2019,383190,10,0,88,35,53
2019,383190,10,1,11,4,7
2019,383190,10,2,13,6,7
2019,383190,10,3,26,12,14
2019,383190,10,4,38,13,25
2019,383190,20,0,47,20,27
2019,383190,20,1,11,4,7
2019,383190,20,2,13,6,7
2019,383190,20,3,23,10,13
2019,383190,30,0,36,11,25
2019,383190,30,3,1,0,1
2019,383190,30,4,35,11,24
2019,383190,40,0,5,4,1
2019,383190,40,3,2,2,0
2019,383190,40,4,3,2,1
2019,383190,42,0,5,4,1
2019,383190,42,3,2,2,0
2019,383190,42,4,3,2,1
2019,383996,0,0,6,4,2
2019,383996,10,0,6,4,2
2019,383996,10,1,4,2,2
2019,383996,10,2,2,2,0
2019,383996,20,0,4,2,2
2019,383996,20,1,3,1,2
2019,383996,20,2,1,1,0
2019,383996,30,0,2,2,0
2019,383996,30,1,1,1,0
2019,383996,30,2,1,1,0
2019,384254,0,0,54,23,31
2019,384254,10,0,37,17,20
2019,384254,10,1,2,1,1
2019,384254,10,2,9,6,3
2019,384254,10,3,12,3,9
2019,384254,10,4,14,7,7
2019,384254,40,0,37,17,20
2019,384254,40,1,2,1,1
2019,384254,40,2,9,6,3
2019,384254,40,3,12,3,9
2019,384254,40,4,14,7,7
2019,384254,41,0,17,10,7
2019,384254,41,1,2,1,1
2019,384254,41,2,8,6,2
2019,384254,41,3,4,1,3
2019,384254,41,4,3,2,1
2019,384254,42,0,20,7,13
2019,384254,42,2,1,0,1
2019,384254,42,3,8,2,6
2019,384254,42,4,11,5,6
2019,384254,44,0,17,10,7
2019,384254,44,1,2,1,1
2019,384254,44,2,8,6,2
2019,384254,44,3,4,1,3
2019,384254,44,4,3,2,1
2019,384254,50,0,17,6,11
2019,384333,0,0,103,42,61
2019,384333,10,0,103,42,61
2019,384333,10,6,103,42,61
2019,384333,20,0,57,23,34
2019,384333,20,6,57,23,34
2019,384333,30,0,30,13,17
2019,384333,30,6,30,13,17
2019,384333,40,0,16,6,10
2019,384333,40,6,16,6,10
2019,384333,42,0,12,3,9
2019,384333,42,6,12,3,9
2019,384333,43,0,4,3,1
2019,384333,43,6,4,3,1
2019,384342,0,0,83,37,46
2019,384342,10,0,83,37,46
2019,384342,10,1,48,23,25
2019,384342,10,2,13,5,8
2019,384342,10,3,7,2,5
2019,384342,10,4,14,6,8
2019,384342,10,6,1,1,0
2019,384342,20,0,68,30,38
2019,384342,20,1,48,23,25
2019,384342,20,2,13,5,8
2019,384342,20,3,7,2,5
2019,384342,30,0,14,6,8
2019,384342,30,4,14,6,8
2019,384342,40,0,1,1,0
2019,384342,40,6,1,1,0
2019,384342,42,0,1,1,0
2019,384342,42,6,1,1,0
2019,384412,0,0,1,1,0
2019,384412,10,0,1,1,0
2019,384412,10,1,1,1,0
2019,384412,40,0,1,1,0
2019,384412,40,1,1,1,0
2019,384412,41,0,1,1,0
2019,384412,41,1,1,1,0
2019,384412,45,0,1,1,0
2019,384412,45,1,1,1,0
2019,385415,0,0,47,19,28
2019,385415,10,0,43,18,25
2019,385415,10,1,9,5,4
2019,385415,10,2,21,9,12
2019,385415,10,3,11,3,8
2019,385415,10,4,2,1,1
2019,385415,20,0,1,1,0
2019,385415,20,1,1,1,0
2019,385415,30,0,1,1,0
2019,385415,30,2,1,1,0
2019,385415,40,0,41,16,25
2019,385415,40,1,8,4,4
2019,385415,40,2,20,8,12
2019,385415,40,3,11,3,8
2019,385415,40,4,2,1,1
2019,385415,41,0,39,15,24
2019,385415,41,1,8,4,4
2019,385415,41,2,20,8,12
2019,385415,41,3,11,3,8
2019,385415,42,0,2,1,1
2019,385415,42,4,2,1,1
2019,385415,44,0,31,11,20
2019,385415,44,2,20,8,12
2019,385415,44,3,11,3,8
2019,385415,45,0,8,4,4
2019,385415,45,1,8,4,4
2019,385415,50,0,4,1,3
2019,385503,0,0,11,0,11
2019,385503,50,0,11,0,11
2019,385619,0,0,48,33,15
2019,385619,10,0,48,33,15
2019,385619,10,4,48,33,15
2019,385619,40,0,48,33,15
2019,385619,40,4,48,33,15
2019,385619,41,0,48,33,15
2019,385619,41,4,48,33,15
2019,385619,45,0,48,33,15
2019,385619,45,4,48,33,15
2019,386153,0,0,3,0,3
2019,386153,10,0,3,0,3
2019,386153,10,4,3,0,3
2019,386153,40,0,3,0,3
2019,386153,40,4,3,0,3
2019,386153,42,0,1,0,1
2019,386153,42,4,1,0,1
2019,386153,43,0,2,0,2
2019,386153,43,4,2,0,2
2019,386472,0,0,19,3,16
2019,386472,10,0,19,3,16
2019,386472,10,1,2,1,1
2019,386472,10,2,4,0,4
2019,386472,10,3,11,2,9
2019,386472,10,4,2,0,2
2019,386472,40,0,19,3,16
2019,386472,40,1,2,1,1
2019,386472,40,2,4,0,4
2019,386472,40,3,11,2,9
2019,386472,40,4,2,0,2
2019,386472,41,0,19,3,16
2019,386472,41,1,2,1,1
2019,386472,41,2,4,0,4
2019,386472,41,3,11,2,9
2019,386472,41,4,2,0,2
2019,386472,45,0,19,3,16
2019,386472,45,1,2,1,1
2019,386472,45,2,4,0,4
2019,386472,45,3,11,2,9
2019,386472,45,4,2,0,2
2019,388520,0,0,18,15,3
2019,388520,10,0,18,15,3
2019,388520,10,1,14,12,2
2019,388520,10,2,1,1,0
2019,388520,10,3,3,2,1
2019,388520,40,0,18,15,3
2019,388520,40,1,14,12,2
2019,388520,40,2,1,1,0
2019,388520,40,3,3,2,1
2019,388520,42,0,18,15,3
2019,388520,42,1,14,12,2
2019,388520,42,2,1,1,0
2019,388520,42,3,3,2,1
2019,392257,0,0,43,14,29
2019,392257,10,0,43,14,29
2019,392257,10,4,43,14,29
2019,392257,40,0,43,14,29
2019,392257,40,4,43,14,29
2019,392257,41,0,43,14,29
2019,392257,41,4,43,14,29
2019,392257,45,0,43,14,29
2019,392257,45,4,43,14,29
2019,392415,0,0,5,1,4
2019,392415,10,0,5,1,4
2019,392415,10,4,5,1,4
2019,392415,40,0,5,1,4
2019,392415,40,4,5,1,4
2019,392415,41,0,5,1,4
2019,392415,41,4,5,1,4
2019,392415,45,0,5,1,4
2019,392415,45,4,5,1,4
2019,392840,0,0,12,7,5
2019,392840,10,0,12,7,5
2019,392840,10,1,3,1,2
2019,392840,10,2,6,3,3
2019,392840,10,3,2,2,0
2019,392840,10,4,1,1,0
2019,392840,40,0,12,7,5
2019,392840,40,1,3,1,2
2019,392840,40,2,6,3,3
2019,392840,40,3,2,2,0
2019,392840,40,4,1,1,0
2019,392840,43,0,12,7,5
2019,392840,43,1,3,1,2
2019,392840,43,2,6,3,3
2019,392840,43,3,2,2,0
2019,392840,43,4,1,1,0
2019,395362,0,0,29,15,14
2019,395362,10,0,29,15,14
2019,395362,10,4,29,15,14
2019,395362,20,0,24,14,10
2019,395362,20,4,24,14,10
2019,395362,30,0,4,1,3
2019,395362,30,4,4,1,3
2019,395362,40,0,1,0,1
2019,395362,40,4,1,0,1
2019,395362,42,0,1,0,1
2019,395362,42,4,1,0,1
2019,399212,0,0,122,43,79
2019,399212,10,0,122,43,79
2019,399212,10,4,122,43,79
2019,399212,20,0,49,25,24
2019,399212,20,4,49,25,24
2019,399212,30,0,56,15,41
2019,399212,30,4,56,15,41
2019,399212,40,0,17,3,14
2019,399212,40,4,17,3,14
2019,399212,42,0,1,0,1
2019,399212,42,4,1,0,1
2019,399212,43,0,16,3,13
2019,399212,43,4,16,3,13
2019,399869,0,0,12,10,2
2019,399869,10,0,11,9,2
2019,399869,10,1,1,1,0
2019,399869,10,2,1,1,0
2019,399869,10,3,2,1,1
2019,399869,10,4,4,4,0
2019,399869,10,5,3,2,1
2019,399869,40,0,11,9,2
2019,399869,40,1,1,1,0
2019,399869,40,2,1,1,0
2019,399869,40,3,2,1,1
2019,399869,40,4,4,4,0
2019,399869,40,5,3,2,1
2019,399869,41,0,11,9,2
2019,399869,41,1,1,1,0
2019,399869,41,2,1,1,0
2019,399869,41,3,2,1,1
2019,399869,41,4,4,4,0
2019,399869,41,5,3,2,1
2019,399869,45,0,11,9,2
2019,399869,45,1,1,1,0
2019,399869,45,2,1,1,0
2019,399869,45,3,2,1,1
2019,399869,45,4,4,4,0
2019,399869,45,5,3,2,1
2019,399869,50,0,1,1,0
2019,399911,0,0,54,29,25
2019,399911,10,0,54,29,25
2019,399911,10,1,15,12,3
2019,399911,10,2,24,11,13
2019,399911,10,3,11,4,7
2019,399911,10,4,3,1,2
2019,399911,10,5,1,1,0
2019,399911,20,0,39,23,16
2019,399911,20,1,15,12,3
2019,399911,20,2,24,11,13
2019,399911,30,0,8,2,6
2019,399911,30,3,8,2,6
2019,399911,40,0,7,4,3
2019,399911,40,3,3,2,1
2019,399911,40,4,3,1,2
2019,399911,40,5,1,1,0
2019,399911,41,0,3,3,0
2019,399911,41,3,2,2,0
2019,399911,41,5,1,1,0
2019,399911,42,0,4,1,3
2019,399911,42,3,1,0,1
2019,399911,42,4,3,1,2
2019,399911,44,0,3,3,0
2019,399911,44,3,2,2,0
2019,399911,44,5,1,1,0
2019,401223,0,0,5,3,2
2019,401223,10,0,5,3,2
2019,401223,10,2,4,2,2
2019,401223,10,3,1,1,0
2019,401223,40,0,5,3,2
2019,401223,40,2,4,2,2
2019,401223,40,3,1,1,0
2019,401223,42,0,5,3,2
2019,401223,42,2,4,2,2
2019,401223,42,3,1,1,0
2019,403469,0,0,7,2,5
2019,403469,10,0,7,2,5
2019,403469,10,2,2,0,2
2019,403469,10,3,2,1,1
2019,403469,10,4,3,1,2
2019,403469,20,0,5,1,4
2019,403469,20,2,2,0,2
2019,403469,20,3,2,1,1
2019,403469,20,4,1,0,1
2019,403469,30,0,2,1,1
2019,403469,30,4,2,1,1
2019,403478,0,0,12,5,7
2019,403478,10,0,12,5,7
2019,403478,10,1,2,0,2
2019,403478,10,2,1,0,1
2019,403478,10,3,4,2,2
2019,403478,10,4,5,3,2
2019,403478,20,0,10,3,7
2019,403478,20,1,2,0,2
2019,403478,20,2,1,0,1
2019,403478,20,3,4,2,2
2019,403478,20,4,3,1,2
2019,403478,30,0,2,2,0
2019,403478,30,4,2,2,0
2019,403487,0,0,31,24,7
2019,403487,10,0,31,24,7
2019,403487,10,1,3,2,1
2019,403487,10,2,3,3,0
2019,403487,10,3,8,6,2
2019,403487,10,4,17,13,4
2019,403487,20,0,23,20,3
2019,403487,20,1,3,2,1
2019,403487,20,2,3,3,0
2019,403487,20,3,8,6,2
2019,403487,20,4,9,9,0
2019,403487,30,0,8,4,4
2019,403487,30,4,8,4,4
2019,404055,0,0,7,2,5
2019,404055,10,0,7,2,5
2019,404055,10,4,7,2,5
2019,404055,40,0,7,2,5
2019,404055,40,4,7,2,5
2019,404055,41,0,7,2,5
2019,404055,41,4,7,2,5
2019,404055,45,0,7,2,5
2019,404055,45,4,7,2,5
2019,404222,0,0,18,9,9
2019,404222,10,0,18,9,9
2019,404222,10,1,3,2,1
2019,404222,10,2,2,1,1
2019,404222,10,3,11,5,6
2019,404222,10,4,2,1,1
2019,404222,20,0,8,5,3
2019,404222,20,1,3,2,1
2019,404222,20,2,1,1,0
2019,404222,20,3,4,2,2
2019,404222,30,0,8,4,4
2019,404222,30,2,1,0,1
2019,404222,30,3,6,3,3
2019,404222,30,4,1,1,0
2019,404222,40,0,2,0,2
2019,404222,40,3,1,0,1
2019,404222,40,4,1,0,1
2019,404222,42,0,2,0,2
2019,404222,42,3,1,0,1
2019,404222,42,4,1,0,1
2019,404426,0,0,40,21,19
2019,404426,10,0,40,21,19
2019,404426,10,6,40,21,19
2019,404426,40,0,40,21,19
2019,404426,40,6,40,21,19
2019,404426,42,0,40,21,19
2019,404426,42,6,40,21,19
2019,404806,0,0,7,2,5
2019,404806,10,0,7,2,5
2019,404806,10,1,7,2,5
2019,404806,40,0,7,2,5
2019,404806,40,1,7,2,5
2019,404806,42,0,7,2,5
2019,404806,42,1,7,2,5
2019,404912,0,0,40,7,33
2019,404912,10,0,40,7,33
2019,404912,10,4,40,7,33
2019,404912,40,0,40,7,33
2019,404912,40,4,40,7,33
2019,404912,41,0,40,7,33
2019,404912,41,4,40,7,33
2019,404912,45,0,40,7,33
2019,404912,45,4,40,7,33
2019,404994,0,0,158,72,86
2019,404994,10,0,154,70,84
2019,404994,10,2,8,2,6
2019,404994,10,3,38,20,18
2019,404994,10,4,108,48,60
2019,404994,40,0,154,70,84
2019,404994,40,2,8,2,6
2019,404994,40,3,38,20,18
2019,404994,40,4,108,48,60
2019,404994,41,0,40,16,24
2019,404994,41,2,3,0,3
2019,404994,41,3,19,9,10
2019,404994,41,4,18,7,11
2019,404994,43,0,114,54,60
2019,404994,43,2,5,2,3
2019,404994,43,3,19,11,8
2019,404994,43,4,90,41,49
2019,404994,45,0,40,16,24
2019,404994,45,2,3,0,3
2019,404994,45,3,19,9,10
2019,404994,45,4,18,7,11
2019,404994,50,0,4,2,2
2019,405058,0,0,6,6,0
2019,405058,10,0,6,6,0
2019,405058,10,4,6,6,0
2019,405058,40,0,6,6,0
2019,405058,40,4,6,6,0
2019,405058,42,0,6,6,0
2019,405058,42,4,6,6,0
2019,405872,0,0,78,21,57
2019,405872,10,0,78,21,57
2019,405872,10,1,10,1,9
2019,405872,10,2,22,9,13
2019,405872,10,3,32,6,26
2019,405872,10,4,10,2,8
2019,405872,10,5,4,3,1
2019,405872,40,0,78,21,57
2019,405872,40,1,10,1,9
2019,405872,40,2,22,9,13
2019,405872,40,3,32,6,26
2019,405872,40,4,10,2,8
2019,405872,40,5,4,3,1
2019,405872,41,0,54,14,40
2019,405872,41,1,10,1,9
2019,405872,41,2,22,9,13
2019,405872,41,3,21,3,18
2019,405872,41,5,1,1,0
2019,405872,42,0,23,7,16
2019,405872,42,3,11,3,8
2019,405872,42,4,9,2,7
2019,405872,42,5,3,2,1
2019,405872,43,0,1,0,1
2019,405872,43,4,1,0,1
2019,405872,44,0,54,14,40
2019,405872,44,1,10,1,9
2019,405872,44,2,22,9,13
2019,405872,44,3,21,3,18
2019,405872,44,5,1,1,0
2019,406024,0,0,66,13,53
2019,406024,10,0,66,13,53
2019,406024,10,3,6,1,5
2019,406024,10,4,60,12,48
2019,406024,40,0,66,13,53
2019,406024,40,3,6,1,5
2019,406024,40,4,60,12,48
2019,406024,41,0,66,13,53
2019,406024,41,3,6,1,5
2019,406024,41,4,60,12,48
2019,406024,45,0,66,13,53
2019,406024,45,3,6,1,5
2019,406024,45,4,60,12,48
2019,406033,0,0,73,9,64
2019,406033,10,0,73,9,64
2019,406033,10,2,1,1,0
2019,406033,10,3,7,0,7
2019,406033,10,4,65,8,57
2019,406033,40,0,73,9,64
2019,406033,40,2,1,1,0
2019,406033,40,3,7,0,7
2019,406033,40,4,65,8,57
2019,406033,41,0,73,9,64
2019,406033,41,2,1,1,0
2019,406033,41,3,7,0,7
2019,406033,41,4,65,8,57
2019,406033,45,0,73,9,64
2019,406033,45,2,1,1,0
2019,406033,45,3,7,0,7
2019,406033,45,4,65,8,57
2019,406547,0,0,3,2,1
2019,406547,10,0,3,2,1
2019,406547,10,4,3,2,1
2019,406547,40,0,3,2,1
2019,406547,40,4,3,2,1
2019,406547,41,0,3,2,1
2019,406547,41,4,3,2,1
2019,406547,45,0,3,2,1
2019,406547,45,4,3,2,1
2019,407009,0,0,291,110,181
2019,407009,10,0,291,110,181
2019,407009,10,1,50,30,20
2019,407009,10,2,76,36,40
2019,407009,10,3,75,17,58
2019,407009,10,4,47,14,33
2019,407009,10,5,43,13,30
2019,407009,20,0,113,60,53
2019,407009,20,1,48,28,20
2019,407009,20,2,65,32,33
2019,407009,30,0,40,12,28
2019,407009,30,2,2,0,2
2019,407009,30,3,38,12,26
2019,407009,40,0,138,38,100
2019,407009,40,1,2,2,0
2019,407009,40,2,9,4,5
2019,407009,40,3,37,5,32
2019,407009,40,4,47,14,33
2019,407009,40,5,43,13,30
2019,407009,41,0,13,6,7
2019,407009,41,1,1,1,0
2019,407009,41,2,4,1,3
2019,407009,41,3,1,0,1
2019,407009,41,5,7,4,3
2019,407009,42,0,125,32,93
2019,407009,42,1,1,1,0
2019,407009,42,2,5,3,2
2019,407009,42,3,36,5,31
2019,407009,42,4,47,14,33
2019,407009,42,5,36,9,27
2019,407009,44,0,13,6,7
2019,407009,44,1,1,1,0
2019,407009,44,2,4,1,3
2019,407009,44,3,1,0,1
2019,407009,44,5,7,4,3
2019,407629,0,0,172,101,71
2019,407629,10,0,165,96,69
2019,407629,10,1,32,25,7
2019,407629,10,2,31,16,15
2019,407629,10,3,98,54,44
2019,407629,10,4,4,1,3
2019,407629,40,0,165,96,69
2019,407629,40,1,32,25,7
2019,407629,40,2,31,16,15
2019,407629,40,3,98,54,44
2019,407629,40,4,4,1,3
2019,407629,41,0,165,96,69
2019,407629,41,1,32,25,7
2019,407629,41,2,31,16,15
2019,407629,41,3,98,54,44
2019,407629,41,4,4,1,3
2019,407629,44,0,165,96,69
2019,407629,44,1,32,25,7
2019,407629,44,2,31,16,15
2019,407629,44,3,98,54,44
2019,407629,44,4,4,1,3
2019,407629,50,0,7,5,2
2019,408729,0,0,8,2,6
2019,408729,10,0,8,2,6
2019,408729,10,4,8,2,6
2019,408729,40,0,8,2,6
2019,408729,40,4,8,2,6
2019,408729,41,0,8,2,6
2019,408729,41,4,8,2,6
2019,408729,45,0,8,2,6
2019,408729,45,4,8,2,6
2019,408844,0,0,104,47,57
2019,408844,10,0,104,47,57
2019,408844,10,4,104,47,57
2019,408844,40,0,104,47,57
2019,408844,40,4,104,47,57
2019,408844,43,0,104,47,57
2019,408844,43,4,104,47,57
2019,409254,0,0,22,3,19
2019,409254,10,0,22,3,19
2019,409254,10,1,4,0,4
2019,409254,10,2,7,2,5
2019,409254,10,3,4,1,3
2019,409254,10,4,7,0,7
2019,409254,20,0,8,2,6
2019,409254,20,1,3,0,3
2019,409254,20,2,5,2,3
2019,409254,30,0,2,1,1
2019,409254,30,3,2,1,1
2019,409254,40,0,12,0,12
2019,409254,40,1,1,0,1
2019,409254,40,2,2,0,2
2019,409254,40,3,2,0,2
2019,409254,40,4,7,0,7
2019,409254,41,0,12,0,12
2019,409254,41,1,1,0,1
2019,409254,41,2,2,0,2
2019,409254,41,3,2,0,2
2019,409254,41,4,7,0,7
2019,409254,44,0,12,0,12
2019,409254,44,1,1,0,1
2019,409254,44,2,2,0,2
2019,409254,44,3,2,0,2
2019,409254,44,4,7,0,7
2019,409315,0,0,639,380,259
2019,409315,10,0,639,380,259
2019,409315,10,1,9,5,4
2019,409315,10,2,32,19,13
2019,409315,10,3,43,26,17
2019,409315,10,4,442,249,193
2019,409315,10,5,113,81,32
2019,409315,40,0,639,380,259
2019,409315,40,1,9,5,4
2019,409315,40,2,32,19,13
2019,409315,40,3,43,26,17
2019,409315,40,4,442,249,193
2019,409315,40,5,113,81,32
2019,409315,42,0,619,367,252
2019,409315,42,1,9,5,4
2019,409315,42,2,32,19,13
2019,409315,42,3,43,26,17
2019,409315,42,4,442,249,193
2019,409315,42,5,93,68,25
2019,409315,43,0,20,13,7
2019,409315,43,5,20,13,7
2019,409616,0,0,22,7,15
2019,409616,10,0,22,7,15
2019,409616,10,1,17,6,11
2019,409616,10,2,3,1,2
2019,409616,10,3,2,0,2
2019,409616,20,0,13,6,7
2019,409616,20,1,13,6,7
2019,409616,30,0,2,1,1
2019,409616,30,2,2,1,1
2019,409616,40,0,7,0,7
2019,409616,40,1,4,0,4
2019,409616,40,2,1,0,1
2019,409616,40,3,2,0,2
2019,409616,41,0,7,0,7
2019,409616,41,1,4,0,4
2019,409616,41,2,1,0,1
2019,409616,41,3,2,0,2
2019,409616,44,0,7,0,7
2019,409616,44,1,4,0,4
2019,409616,44,2,1,0,1
2019,409616,44,3,2,0,2
2019,409698,0,0,227,105,122
2019,409698,10,0,227,105,122
2019,409698,10,1,62,34,28
2019,409698,10,2,35,15,20
2019,409698,10,3,79,33,46
2019,409698,10,5,51,23,28
2019,409698,20,0,93,47,46
2019,409698,20,1,62,34,28
2019,409698,20,2,31,13,18
2019,409698,30,0,83,35,48
2019,409698,30,2,4,2,2
2019,409698,30,3,79,33,46
2019,409698,40,0,51,23,28
2019,409698,40,5,51,23,28
2019,409698,41,0,21,8,13
2019,409698,41,5,21,8,13
2019,409698,42,0,24,11,13
2019,409698,42,5,24,11,13
2019,409698,43,0,6,4,2
2019,409698,43,5,6,4,2
2019,409698,44,0,21,8,13
2019,409698,44,5,21,8,13
2019,412173,0,0,16,5,11
2019,412173,10,0,16,5,11
2019,412173,10,6,16,5,11
2019,412173,40,0,16,5,11
2019,412173,40,6,16,5,11
2019,412173,41,0,16,5,11
2019,412173,41,6,16,5,11
2019,412173,45,0,16,5,11
2019,412173,45,6,16,5,11
2019,412599,0,0,32,15,17
2019,412599,50,0,32,15,17
2019,413413,0,0,216,69,147
2019,413413,10,0,216,69,147
2019,413413,10,6,216,69,147
2019,413413,40,0,216,69,147
2019,413413,40,6,216,69,147
2019,413413,42,0,216,69,147
2019,413413,42,6,216,69,147
2019,413617,0,0,16,8,8
2019,413617,10,0,16,8,8
2019,413617,10,4,16,8,8
2019,413617,40,0,16,8,8
2019,413617,40,4,16,8,8
2019,413617,42,0,16,8,8
2019,413617,42,4,16,8,8
2019,413626,0,0,16,8,8
2019,413626,10,0,16,8,8
2019,413626,10,4,16,8,8
2019,413626,40,0,16,8,8
2019,413626,40,4,16,8,8
2019,413626,42,0,16,8,8
2019,413626,42,4,16,8,8
2019,413680,0,0,22,21,1
2019,413680,50,0,22,21,1
2019,413802,0,0,8,3,5
2019,413802,50,0,8,3,5
2019,414461,0,0,84,73,11
2019,414461,10,0,84,73,11
2019,414461,10,1,43,32,11
2019,414461,10,4,41,41,0
2019,414461,40,0,84,73,11
2019,414461,40,1,43,32,11
2019,414461,40,4,41,41,0
2019,414461,41,0,84,73,11
2019,414461,41,1,43,32,11
2019,414461,41,4,41,41,0
2019,414461,44,0,84,73,11
2019,414461,44,1,43,32,11
2019,414461,44,4,41,41,0
2019,414595,0,0,8,2,6
2019,414595,10,0,8,2,6
2019,414595,10,4,8,2,6
2019,414595,40,0,8,2,6
2019,414595,40,4,8,2,6
2019,414595,42,0,5,1,4
2019,414595,42,4,5,1,4
2019,414595,43,0,3,1,2
2019,414595,43,4,3,1,2
2019,414823,0,0,46,31,15
2019,414823,10,0,46,31,15
2019,414823,10,1,11,6,5
2019,414823,10,2,13,8,5
2019,414823,10,3,11,8,3
2019,414823,10,4,11,9,2
2019,414823,40,0,46,31,15
2019,414823,40,1,11,6,5
2019,414823,40,2,13,8,5
2019,414823,40,3,11,8,3
2019,414823,40,4,11,9,2
2019,414823,41,0,2,2,0
2019,414823,41,1,1,1,0
2019,414823,41,2,1,1,0
2019,414823,42,0,44,29,15
2019,414823,42,1,10,5,5
2019,414823,42,2,12,7,5
2019,414823,42,3,11,8,3
2019,414823,42,4,11,9,2
2019,414823,44,0,2,2,0
2019,414823,44,1,1,1,0
2019,414823,44,2,1,1,0
2019,414911,0,0,26,10,16
2019,414911,10,0,26,10,16
2019,414911,10,1,6,2,4
2019,414911,10,2,9,5,4
2019,414911,10,3,6,2,4
2019,414911,10,4,3,0,3
2019,414911,10,5,2,1,1
2019,414911,20,0,15,6,9
2019,414911,20,1,6,2,4
2019,414911,20,2,7,3,4
2019,414911,20,3,1,1,0
2019,414911,20,4,1,0,1
2019,414911,30,0,7,2,5
2019,414911,30,2,2,2,0
2019,414911,30,3,4,0,4
2019,414911,30,4,1,0,1
2019,414911,40,0,4,2,2
2019,414911,40,3,1,1,0
2019,414911,40,4,1,0,1
2019,414911,40,5,2,1,1
2019,414911,41,0,3,1,2
2019,414911,41,3,1,1,0
2019,414911,41,4,1,0,1
2019,414911,41,5,1,0,1
2019,414911,42,0,1,1,0
2019,414911,42,5,1,1,0
2019,414911,45,0,3,1,2
2019,414911,45,3,1,1,0
2019,414911,45,4,1,0,1
2019,414911,45,5,1,0,1
2019,414966,0,0,13,5,8
2019,414966,10,0,13,5,8
2019,414966,10,1,4,3,1
2019,414966,10,2,4,1,3
2019,414966,10,3,4,1,3
2019,414966,10,4,1,0,1
2019,414966,20,0,8,4,4
2019,414966,20,1,4,3,1
2019,414966,20,2,4,1,3
2019,414966,30,0,4,1,3
2019,414966,30,3,4,1,3
2019,414966,40,0,1,0,1
2019,414966,40,4,1,0,1
2019,414966,42,0,1,0,1
2019,414966,42,4,1,0,1
2019,416801,0,0,23,11,12
2019,416801,10,0,23,11,12
2019,416801,10,1,1,1,0
2019,416801,10,5,22,10,12
2019,416801,20,0,1,1,0
2019,416801,20,1,1,1,0
2019,416801,40,0,22,10,12
2019,416801,40,5,22,10,12
2019,416801,42,0,22,10,12
2019,416801,42,5,22,10,12
2019,417327,0,0,5,1,4
2019,417327,10,0,5,1,4
2019,417327,10,4,5,1,4
2019,417327,40,0,5,1,4
2019,417327,40,4,5,1,4
2019,417327,41,0,5,1,4
2019,417327,41,4,5,1,4
2019,417327,45,0,5,1,4
2019,417327,45,4,5,1,4
2019,417734,0,0,18,2,16
2019,417734,10,0,18,2,16
2019,417734,10,2,1,1,0
2019,417734,10,3,6,1,5
2019,417734,10,4,11,0,11
2019,417734,40,0,18,2,16
2019,417734,40,2,1,1,0
2019,417734,40,3,6,1,5
2019,417734,40,4,11,0,11
2019,417734,42,0,18,2,16
2019,417734,42,2,1,1,0
2019,417734,42,3,6,1,5
2019,417734,42,4,11,0,11
2019,418126,0,0,7,4,3
2019,418126,10,0,7,4,3
2019,418126,10,4,7,4,3
2019,418126,40,0,7,4,3
2019,418126,40,4,7,4,3
2019,418126,41,0,7,4,3
2019,418126,41,4,7,4,3
2019,418126,45,0,7,4,3
2019,418126,45,4,7,4,3
2019,418533,0,0,81,49,32
2019,418533,50,0,81,49,32
2019,419244,0,0,5,5,0
2019,419244,10,0,5,5,0
2019,419244,10,6,5,5,0
2019,419244,40,0,5,5,0
2019,419244,40,6,5,5,0
2019,419244,41,0,5,5,0
2019,419244,41,6,5,5,0
2019,419244,45,0,5,5,0
2019,419244,45,6,5,5,0
2019,420024,0,0,6,3,3
2019,420024,50,0,6,3,3
2019,420246,0,0,16,6,10
2019,420246,10,0,16,6,10
2019,420246,10,1,9,6,3
2019,420246,10,2,1,0,1
2019,420246,10,3,6,0,6
2019,420246,40,0,16,6,10
2019,420246,40,1,9,6,3
2019,420246,40,2,1,0,1
2019,420246,40,3,6,0,6
2019,420246,42,0,16,6,10
2019,420246,42,1,9,6,3
2019,420246,42,2,1,0,1
2019,420246,42,3,6,0,6
2019,420370,0,0,9,4,5
2019,420370,10,0,9,4,5
2019,420370,10,4,9,4,5
2019,420370,40,0,9,4,5
2019,420370,40,4,9,4,5
2019,420370,41,0,9,4,5
2019,420370,41,4,9,4,5
2019,420370,45,0,9,4,5
2019,420370,45,4,9,4,5
2019,420398,0,0,191,94,97
2019,420398,10,0,174,85,89
2019,420398,10,1,40,23,17
2019,420398,10,2,28,11,17
2019,420398,10,3,43,20,23
2019,420398,10,4,63,31,32
2019,420398,20,0,102,54,48
2019,420398,20,1,40,23,17
2019,420398,20,2,26,11,15
2019,420398,20,3,13,5,8
2019,420398,20,4,23,15,8
2019,420398,40,0,72,31,41
2019,420398,40,2,2,0,2
2019,420398,40,3,30,15,15
2019,420398,40,4,40,16,24
2019,420398,42,0,72,31,41
2019,420398,42,2,2,0,2
2019,420398,42,3,30,15,15
2019,420398,42,4,40,16,24
2019,420398,50,0,17,9,8
2019,420431,0,0,62,25,37
2019,420431,50,0,62,25,37
2019,420440,0,0,17,9,8
2019,420440,10,0,17,9,8
2019,420440,10,4,17,9,8
2019,420440,40,0,17,9,8
2019,420440,40,4,17,9,8
2019,420440,42,0,17,9,8
2019,420440,42,4,17,9,8
2019,420538,0,0,42,17,25
2019,420538,10,0,42,17,25
2019,420538,10,3,6,3,3
2019,420538,10,4,36,14,22
2019,420538,40,0,42,17,25
2019,420538,40,3,6,3,3
2019,420538,40,4,36,14,22
2019,420538,42,0,42,17,25
2019,420538,42,3,6,3,3
2019,420538,42,4,36,14,22
2019,420556,0,0,21,8,13
2019,420556,10,0,21,8,13
2019,420556,10,4,21,8,13
2019,420556,40,0,21,8,13
2019,420556,40,4,21,8,13
2019,420556,42,0,21,8,13
2019,420556,42,4,21,8,13
2019,420574,0,0,181,103,78
2019,420574,10,0,181,103,78
2019,420574,10,1,22,17,5
2019,420574,10,2,52,33,19
2019,420574,10,3,35,21,14
2019,420574,10,4,35,12,23
2019,420574,10,5,36,20,16
2019,420574,10,6,1,0,1
2019,420574,20,0,63,43,20
2019,420574,20,1,18,14,4
2019,420574,20,2,45,29,16
2019,420574,30,0,29,20,9
2019,420574,30,2,2,2,0
2019,420574,30,3,27,18,9
2019,420574,40,0,89,40,49
2019,420574,40,1,4,3,1
2019,420574,40,2,5,2,3
2019,420574,40,3,8,3,5
2019,420574,40,4,35,12,23
2019,420574,40,5,36,20,16
2019,420574,40,6,1,0,1
2019,420574,41,0,8,3,5
2019,420574,41,1,3,2,1
2019,420574,41,3,1,0,1
2019,420574,41,5,4,1,3
2019,420574,42,0,80,37,43
2019,420574,42,1,1,1,0
2019,420574,42,2,5,2,3
2019,420574,42,3,7,3,4
2019,420574,42,4,35,12,23
2019,420574,42,5,32,19,13
2019,420574,43,0,1,0,1
2019,420574,43,6,1,0,1
2019,420574,44,0,8,3,5
2019,420574,44,1,3,2,1
2019,420574,44,3,1,0,1
2019,420574,44,5,4,1,3
2019,420723,0,0,10,8,2
2019,420723,10,0,10,8,2
2019,420723,10,6,10,8,2
2019,420723,40,0,10,8,2
2019,420723,40,6,10,8,2
2019,420723,42,0,10,8,2
2019,420723,42,6,10,8,2
2019,421708,0,0,4,0,4
2019,421708,10,0,4,0,4
2019,421708,10,4,4,0,4
2019,421708,40,0,4,0,4
2019,421708,40,4,4,0,4
2019,421708,41,0,4,0,4
2019,421708,41,4,4,0,4
2019,421708,45,0,4,0,4
2019,421708,45,4,4,0,4
2019,421832,0,0,15,8,7
2019,421832,10,0,15,8,7
2019,421832,10,4,15,8,7
2019,421832,40,0,15,8,7
2019,421832,40,4,15,8,7
2019,421832,42,0,15,8,7
2019,421832,42,4,15,8,7
2019,421841,0,0,5,3,2
2019,421841,10,0,5,3,2
2019,421841,10,6,5,3,2
2019,421841,40,0,5,3,2
2019,421841,40,6,5,3,2
2019,421841,43,0,5,3,2
2019,421841,43,6,5,3,2
2019,421878,0,0,15,7,8
2019,421878,10,0,15,7,8
2019,421878,10,4,14,6,8
2019,421878,10,6,1,1,0
2019,421878,40,0,15,7,8
2019,421878,40,4,14,6,8
2019,421878,40,6,1,1,0
2019,421878,41,0,1,1,0
2019,421878,41,6,1,1,0
2019,421878,42,0,14,6,8
2019,421878,42,4,14,6,8
2019,421878,45,0,1,1,0
2019,421878,45,6,1,1,0
2019,422695,0,0,5,3,2
2019,422695,10,0,5,3,2
2019,422695,10,6,5,3,2
2019,422695,40,0,5,3,2
2019,422695,40,6,5,3,2
2019,422695,41,0,5,3,2
2019,422695,41,6,5,3,2
2019,422695,45,0,5,3,2
2019,422695,45,6,5,3,2
2019,423643,0,0,297,142,155
2019,423643,10,0,288,140,148
2019,423643,10,1,40,25,15
2019,423643,10,2,75,34,41
2019,423643,10,3,170,78,92
2019,423643,10,4,3,3,0
2019,423643,20,0,76,46,30
2019,423643,20,1,30,20,10
2019,423643,20,2,46,26,20
2019,423643,30,0,55,21,34
2019,423643,30,1,4,3,1
2019,423643,30,2,5,2,3
2019,423643,30,3,46,16,30
2019,423643,40,0,157,73,84
2019,423643,40,1,6,2,4
2019,423643,40,2,24,6,18
2019,423643,40,3,124,62,62
2019,423643,40,4,3,3,0
2019,423643,41,0,157,73,84
2019,423643,41,1,6,2,4
2019,423643,41,2,24,6,18
2019,423643,41,3,124,62,62
2019,423643,41,4,3,3,0
2019,423643,44,0,157,73,84
2019,423643,44,1,6,2,4
2019,423643,44,2,24,6,18
2019,423643,44,3,124,62,62
2019,423643,44,4,3,3,0
2019,423643,50,0,9,2,7
2019,423652,0,0,10,5,5
2019,423652,10,0,10,5,5
2019,423652,10,4,10,5,5
2019,423652,40,0,10,5,5
2019,423652,40,4,10,5,5
2019,423652,41,0,10,5,5
2019,423652,41,4,10,5,5
2019,423652,45,0,10,5,5
2019,423652,45,4,10,5,5
2019,426314,0,0,125,77,48
2019,426314,10,0,125,77,48
2019,426314,10,1,3,3,0
2019,426314,10,2,26,19,7
2019,426314,10,3,68,37,31
2019,426314,10,4,28,18,10
2019,426314,20,0,14,10,4
2019,426314,20,1,2,2,0
2019,426314,20,2,12,8,4
2019,426314,30,0,30,12,18
2019,426314,30,2,4,3,1
2019,426314,30,3,26,9,17
2019,426314,40,0,81,55,26
2019,426314,40,1,1,1,0
2019,426314,40,2,10,8,2
2019,426314,40,3,42,28,14
2019,426314,40,4,28,18,10
2019,426314,42,0,81,55,26
2019,426314,42,1,1,1,0
2019,426314,42,2,10,8,2
2019,426314,42,3,42,28,14
2019,426314,42,4,28,18,10
2019,427982,0,0,10,8,2
2019,427982,50,0,10,8,2
2019,428170,0,0,55,7,48
2019,428170,10,0,55,7,48
2019,428170,10,4,55,7,48
2019,428170,40,0,55,7,48
2019,428170,40,4,55,7,48
2019,428170,41,0,55,7,48
2019,428170,41,4,55,7,48
2019,428170,45,0,55,7,48
2019,428170,45,4,55,7,48
2019,428392,0,0,35,17,18
2019,428392,10,0,35,17,18
2019,428392,10,6,35,17,18
2019,428392,40,0,35,17,18
2019,428392,40,6,35,17,18
2019,428392,41,0,35,17,18
2019,428392,41,6,35,17,18
2019,428392,44,0,35,17,18
2019,428392,44,6,35,17,18
2019,429085,0,0,8,5,3
2019,429085,10,0,8,5,3
2019,429085,10,1,2,1,1
2019,429085,10,3,2,1,1
2019,429085,10,4,2,2,0
2019,429085,10,5,2,1,1
2019,429085,40,0,8,5,3
2019,429085,40,1,2,1,1
2019,429085,40,3,2,1,1
2019,429085,40,4,2,2,0
2019,429085,40,5,2,1,1
2019,429085,42,0,8,5,3
2019,429085,42,1,2,1,1
2019,429085,42,3,2,1,1
2019,429085,42,4,2,2,0
2019,429085,42,5,2,1,1
2019,429094,0,0,10,6,4
2019,429094,10,0,10,6,4
2019,429094,10,1,8,6,2
2019,429094,10,3,1,0,1
2019,429094,10,4,1,0,1
2019,429094,40,0,10,6,4
2019,429094,40,1,8,6,2
2019,429094,40,3,1,0,1
2019,429094,40,4,1,0,1
2019,429094,41,0,10,6,4
2019,429094,41,1,8,6,2
2019,429094,41,3,1,0,1
2019,429094,41,4,1,0,1
2019,429094,44,0,10,6,4
2019,429094,44,1,8,6,2
2019,429094,44,3,1,0,1
2019,429094,44,4,1,0,1
2019,430184,0,0,5,3,2
2019,430184,10,0,5,3,2
2019,430184,10,6,5,3,2
2019,430184,40,0,5,3,2
2019,430184,40,6,5,3,2
2019,430184,41,0,5,3,2
2019,430184,41,6,5,3,2
2019,430184,45,0,5,3,2
2019,430184,45,6,5,3,2
2019,430670,0,0,41,25,16
2019,430670,10,0,41,25,16
2019,430670,10,1,1,1,0
2019,430670,10,2,8,7,1
2019,430670,10,3,23,13,10
2019,430670,10,4,9,4,5
2019,430670,20,0,11,6,5
2019,430670,20,2,5,5,0
2019,430670,20,3,5,1,4
2019,430670,20,4,1,0,1
2019,430670,30,0,10,3,7
2019,430670,30,2,1,0,1
2019,430670,30,3,3,0,3
2019,430670,30,4,6,3,3
2019,430670,40,0,20,16,4
2019,430670,40,1,1,1,0
2019,430670,40,2,2,2,0
2019,430670,40,3,15,12,3
2019,430670,40,4,2,1,1
2019,430670,42,0,18,14,4
2019,430670,42,1,1,1,0
2019,430670,42,2,2,2,0
2019,430670,42,3,13,10,3
2019,430670,42,4,2,1,1
2019,430670,43,0,2,2,0
2019,430670,43,3,2,2,0
2019,430704,0,0,8,5,3
2019,430704,10,0,8,5,3
2019,430704,10,4,8,5,3
2019,430704,40,0,8,5,3
2019,430704,40,4,8,5,3
2019,430704,41,0,7,4,3
2019,430704,41,4,7,4,3
2019,430704,43,0,1,1,0
2019,430704,43,4,1,1,0
2019,430704,44,0,7,4,3
2019,430704,44,4,7,4,3
2019,430795,0,0,12,5,7
2019,430795,10,0,11,5,6
2019,430795,10,4,11,5,6
2019,430795,40,0,11,5,6
2019,430795,40,4,11,5,6
2019,430795,42,0,11,5,6
2019,430795,42,4,11,5,6
2019,430795,50,0,1,0,1
2019,430935,0,0,12,7,5
2019,430935,10,0,10,6,4
2019,430935,10,1,10,6,4
2019,430935,40,0,10,6,4
2019,430935,40,1,10,6,4
2019,430935,41,0,7,4,3
2019,430935,41,1,7,4,3
2019,430935,42,0,3,2,1
2019,430935,42,1,3,2,1
2019,430935,44,0,5,3,2
2019,430935,44,1,5,3,2
2019,430935,45,0,2,1,1
2019,430935,45,1,2,1,1
2019,430935,50,0,2,1,1
2019,431141,0,0,73,25,48
2019,431141,10,0,73,25,48
2019,431141,10,4,73,25,48
2019,431141,40,0,73,25,48
2019,431141,40,4,73,25,48
2019,431141,41,0,73,25,48
2019,431141,41,4,73,25,48
2019,431141,45,0,73,25,48
2019,431141,45,4,73,25,48
2019,431929,0,0,10,1,9
2019,431929,10,0,10,1,9
2019,431929,10,1,10,1,9
2019,431929,40,0,10,1,9
2019,431929,40,1,10,1,9
2019,431929,42,0,10,1,9
2019,431929,42,1,10,1,9
2019,431983,0,0,5,5,0
2019,431983,10,0,5,5,0
2019,431983,10,4,5,5,0
2019,431983,40,0,5,5,0
2019,431983,40,4,5,5,0
2019,431983,42,0,5,5,0
2019,431983,42,4,5,5,0
2019,432348,0,0,18,11,7
2019,432348,10,0,18,11,7
2019,432348,10,1,2,1,1
2019,432348,10,2,1,1,0
2019,432348,10,3,9,6,3
2019,432348,10,6,6,3,3
2019,432348,20,0,3,2,1
2019,432348,20,1,2,1,1
2019,432348,20,2,1,1,0
2019,432348,30,0,2,2,0
2019,432348,30,3,2,2,0
2019,432348,40,0,13,7,6
2019,432348,40,3,7,4,3
2019,432348,40,6,6,3,3
2019,432348,41,0,8,5,3
2019,432348,41,3,7,4,3
2019,432348,41,6,1,1,0
2019,432348,42,0,1,0,1
2019,432348,42,6,1,0,1
2019,432348,43,0,4,2,2
2019,432348,43,6,4,2,2
2019,432348,44,0,8,5,3
2019,432348,44,3,7,4,3
2019,432348,44,6,1,1,0
2019,432384,0,0,16,8,8
2019,432384,10,0,16,8,8
2019,432384,10,4,16,8,8
2019,432384,40,0,16,8,8
2019,432384,40,4,16,8,8
2019,432384,41,0,16,8,8
2019,432384,41,4,16,8,8
2019,432384,45,0,16,8,8
2019,432384,45,4,16,8,8
2019,432524,0,0,6,5,1
2019,432524,10,0,6,5,1
2019,432524,10,1,6,5,1
2019,432524,40,0,6,5,1
2019,432524,40,1,6,5,1
2019,432524,42,0,6,5,1
2019,432524,42,1,6,5,1
2019,433004,0,0,25,11,14
2019,433004,10,0,25,11,14
2019,433004,10,1,3,3,0
2019,433004,10,2,4,3,1
2019,433004,10,3,10,4,6
2019,433004,10,4,8,1,7
2019,433004,40,0,25,11,14
2019,433004,40,1,3,3,0
2019,433004,40,2,4,3,1
2019,433004,40,3,10,4,6
2019,433004,40,4,8,1,7
2019,433004,41,0,25,11,14
2019,433004,41,1,3,3,0
2019,433004,41,2,4,3,1
2019,433004,41,3,10,4,6
2019,433004,41,4,8,1,7
2019,433004,44,0,25,11,14
2019,433004,44,1,3,3,0
2019,433004,44,2,4,3,1
2019,433004,44,3,10,4,6
2019,433004,44,4,8,1,7
2019,433013,0,0,15,6,9
2019,433013,10,0,15,6,9
2019,433013,10,4,15,6,9
2019,433013,40,0,15,6,9
2019,433013,40,4,15,6,9
2019,433013,41,0,15,6,9
2019,433013,41,4,15,6,9
2019,433013,45,0,15,6,9
2019,433013,45,4,15,6,9
2019,433174,0,0,28,2,26
2019,433174,10,0,28,2,26
2019,433174,10,6,28,2,26
2019,433174,40,0,28,2,26
2019,433174,40,6,28,2,26
2019,433174,41,0,28,2,26
2019,433174,41,6,28,2,26
2019,433174,45,0,28,2,26
2019,433174,45,6,28,2,26
2019,433387,0,0,2919,730,2189
2019,433387,10,0,2919,730,2189
2019,433387,10,6,2919,730,2189
2019,433387,40,0,2919,730,2189
2019,433387,40,6,2919,730,2189
2019,433387,41,0,2919,730,2189
2019,433387,41,6,2919,730,2189
2019,433387,45,0,2919,730,2189
2019,433387,45,6,2919,730,2189
2019,433420,0,0,31,28,3
2019,433420,10,0,31,28,3
2019,433420,10,4,31,28,3
2019,433420,40,0,31,28,3
2019,433420,40,4,31,28,3
2019,433420,41,0,31,28,3
2019,433420,41,4,31,28,3
2019,433420,45,0,31,28,3
2019,433420,45,4,31,28,3
2019,433536,0,0,5,1,4
2019,433536,10,0,5,1,4
2019,433536,10,1,3,1,2
2019,433536,10,3,1,0,1
2019,433536,10,4,1,0,1
2019,433536,40,0,5,1,4
2019,433536,40,1,3,1,2
2019,433536,40,3,1,0,1
2019,433536,40,4,1,0,1
2019,433536,41,0,5,1,4
2019,433536,41,1,3,1,2
2019,433536,41,3,1,0,1
2019,433536,41,4,1,0,1
2019,433536,45,0,5,1,4
2019,433536,45,1,3,1,2
2019,433536,45,3,1,0,1
2019,433536,45,4,1,0,1
2019,433660,0,0,507,284,223
2019,433660,10,0,507,284,223
2019,433660,10,1,91,65,26
2019,433660,10,2,130,89,41
2019,433660,10,3,151,73,78
2019,433660,10,4,134,57,77
2019,433660,10,5,1,0,1
2019,433660,20,0,4,1,3
2019,433660,20,1,3,1,2
2019,433660,20,2,1,0,1
2019,433660,40,0,503,283,220
2019,433660,40,1,88,64,24
2019,433660,40,2,129,89,40
2019,433660,40,3,151,73,78
2019,433660,40,4,134,57,77
2019,433660,40,5,1,0,1
2019,433660,41,0,486,278,208
2019,433660,41,1,87,63,24
2019,433660,41,2,129,89,40
2019,433660,41,3,145,71,74
2019,433660,41,4,124,55,69
2019,433660,41,5,1,0,1
2019,433660,42,0,17,5,12
2019,433660,42,1,1,1,0
2019,433660,42,3,6,2,4
2019,433660,42,4,10,2,8
2019,433660,44,0,486,278,208
2019,433660,44,1,87,63,24
2019,433660,44,2,129,89,40
2019,433660,44,3,145,71,74
2019,433660,44,4,124,55,69
2019,433660,44,5,1,0,1
2019,434016,0,0,7,3,4
2019,434016,10,0,7,3,4
2019,434016,10,4,7,3,4
2019,434016,40,0,7,3,4
2019,434016,40,4,7,3,4
2019,434016,42,0,7,3,4
2019,434016,42,4,7,3,4
2019,434061,0,0,155,79,76
2019,434061,10,0,155,79,76
2019,434061,10,1,11,3,8
2019,434061,10,2,8,4,4
2019,434061,10,3,19,12,7
2019,434061,10,4,116,59,57
2019,434061,10,6,1,1,0
2019,434061,20,0,6,5,1
2019,434061,20,1,1,1,0
2019,434061,20,2,1,1,0
2019,434061,20,3,1,1,0
2019,434061,20,4,3,2,1
2019,434061,40,0,149,74,75
2019,434061,40,1,10,2,8
2019,434061,40,2,7,3,4
2019,434061,40,3,18,11,7
2019,434061,40,4,113,57,56
2019,434061,40,6,1,1,0
2019,434061,42,0,149,74,75
2019,434061,42,1,10,2,8
2019,434061,42,2,7,3,4
2019,434061,42,3,18,11,7
2019,434061,42,4,113,57,56
2019,434061,42,6,1,1,0
2019,434140,0,0,32,6,26
2019,434140,10,0,32,6,26
2019,434140,10,4,32,6,26
2019,434140,40,0,32,6,26
2019,434140,40,4,32,6,26
2019,434140,41,0,32,6,26
2019,434140,41,4,32,6,26
2019,434140,45,0,32,6,26
2019,434140,45,4,32,6,26
2019,434159,0,0,8,5,3
2019,434159,10,0,8,5,3
2019,434159,10,4,8,5,3
2019,434159,40,0,8,5,3
2019,434159,40,4,8,5,3
2019,434159,41,0,8,5,3
2019,434159,41,4,8,5,3
2019,434159,45,0,8,5,3
2019,434159,45,4,8,5,3
2019,434584,0,0,12,7,5
2019,434584,10,0,12,7,5
2019,434584,10,2,2,1,1
2019,434584,10,3,8,4,4
2019,434584,10,4,2,2,0
2019,434584,40,0,12,7,5
2019,434584,40,2,2,1,1
2019,434584,40,3,8,4,4
2019,434584,40,4,2,2,0
2019,434584,42,0,12,7,5
2019,434584,42,2,2,1,1
2019,434584,42,3,8,4,4
2019,434584,42,4,2,2,0
2019,434672,0,0,410,165,245
2019,434672,10,0,410,165,245
2019,434672,10,1,60,20,40
2019,434672,10,2,131,52,79
2019,434672,10,3,177,68,109
2019,434672,10,4,42,25,17
2019,434672,20,0,31,16,15
2019,434672,20,1,19,9,10
2019,434672,20,2,10,6,4
2019,434672,20,3,2,1,1
2019,434672,40,0,379,149,230
2019,434672,40,1,41,11,30
2019,434672,40,2,121,46,75
2019,434672,40,3,175,67,108
2019,434672,40,4,42,25,17
2019,434672,41,0,308,115,193
2019,434672,41,1,41,11,30
2019,434672,41,2,120,46,74
2019,434672,41,3,140,53,87
2019,434672,41,4,7,5,2
2019,434672,42,0,67,32,35
2019,434672,42,2,1,0,1
2019,434672,42,3,33,13,20
2019,434672,42,4,33,19,14
2019,434672,43,0,4,2,2
2019,434672,43,3,2,1,1
2019,434672,43,4,2,1,1
2019,434672,44,0,308,115,193
2019,434672,44,1,41,11,30
2019,434672,44,2,120,46,74
2019,434672,44,3,140,53,87
2019,434672,44,4,7,5,2
2019,434715,0,0,8,4,4
2019,434715,10,0,8,4,4
2019,434715,10,1,8,4,4
2019,434715,20,0,2,2,0
2019,434715,20,1,2,2,0
2019,434715,30,0,1,0,1
2019,434715,30,1,1,0,1
2019,434715,40,0,5,2,3
2019,434715,40,1,5,2,3
2019,434715,41,0,4,1,3
2019,434715,41,1,4,1,3
2019,434715,42,0,1,1,0
2019,434715,42,1,1,1,0
2019,434715,44,0,4,1,3
2019,434715,44,1,4,1,3
2019,434751,0,0,2,1,1
2019,434751,10,0,2,1,1
2019,434751,10,4,2,1,1
2019,434751,40,0,2,1,1
2019,434751,40,4,2,1,1
2019,434751,42,0,2,1,1
2019,434751,42,4,2,1,1
2019,434821,0,0,30,1,29
2019,434821,10,0,30,1,29
2019,434821,10,4,30,1,29
2019,434821,40,0,30,1,29
2019,434821,40,4,30,1,29
2019,434821,42,0,30,1,29
2019,434821,42,4,30,1,29
2019,434900,0,0,27,12,15
2019,434900,10,0,27,12,15
2019,434900,10,1,27,12,15
2019,434900,40,0,27,12,15
2019,434900,40,1,27,12,15
2019,434900,41,0,27,12,15
2019,434900,41,1,27,12,15
2019,434900,44,0,27,12,15
2019,434900,44,1,27,12,15
2019,435000,0,0,389,217,172
2019,435000,10,0,389,217,172
2019,435000,10,1,46,36,10
2019,435000,10,2,86,55,31
2019,435000,10,3,187,108,79
2019,435000,10,4,70,18,52
2019,435000,20,0,77,59,18
2019,435000,20,1,28,26,2
2019,435000,20,2,37,27,10
2019,435000,20,3,11,5,6
2019,435000,20,4,1,1,0
2019,435000,30,0,43,29,14
2019,435000,30,1,1,0,1
2019,435000,30,2,1,1,0
2019,435000,30,3,41,28,13
2019,435000,40,0,269,129,140
2019,435000,40,1,17,10,7
2019,435000,40,2,48,27,21
2019,435000,40,3,135,75,60
2019,435000,40,4,69,17,52
2019,435000,42,0,269,129,140
2019,435000,42,1,17,10,7
2019,435000,42,2,48,27,21
2019,435000,42,3,135,75,60
2019,435000,42,4,69,17,52
2019,436304,0,0,58,22,36
2019,436304,10,0,58,22,36
2019,436304,10,1,4,1,3
2019,436304,10,2,7,1,6
2019,436304,10,3,9,3,6
2019,436304,10,4,37,16,21
2019,436304,10,6,1,1,0
2019,436304,40,0,58,22,36
2019,436304,40,1,4,1,3
2019,436304,40,2,7,1,6
2019,436304,40,3,9,3,6
2019,436304,40,4,37,16,21
2019,436304,40,6,1,1,0
2019,436304,42,0,52,19,33
2019,436304,42,1,4,1,3
2019,436304,42,2,7,1,6
2019,436304,42,3,9,3,6
2019,436304,42,4,31,13,18
2019,436304,42,6,1,1,0
2019,436304,43,0,6,3,3
2019,436304,43,4,6,3,3
2019,436429,0,0,152,111,41
2019,436429,10,0,152,111,41
2019,436429,10,4,152,111,41
2019,436429,40,0,152,111,41
2019,436429,40,4,152,111,41
2019,436429,41,0,152,111,41
2019,436429,41,4,152,111,41
2019,436429,45,0,152,111,41
2019,436429,45,4,152,111,41
2019,437097,0,0,69,59,10
2019,437097,10,0,69,59,10
2019,437097,10,1,2,2,0
2019,437097,10,4,25,18,7
2019,437097,10,5,40,38,2
2019,437097,10,6,2,1,1
2019,437097,40,0,69,59,10
2019,437097,40,1,2,2,0
2019,437097,40,4,25,18,7
2019,437097,40,5,40,38,2
2019,437097,40,6,2,1,1
2019,437097,41,0,29,21,8
2019,437097,41,1,2,2,0
2019,437097,41,4,25,18,7
2019,437097,41,6,2,1,1
2019,437097,42,0,40,38,2
2019,437097,42,5,40,38,2
2019,437097,44,0,27,19,8
2019,437097,44,4,25,18,7
2019,437097,44,6,2,1,1
2019,437097,45,0,2,2,0
2019,437097,45,1,2,2,0
2019,437103,0,0,147,69,78
2019,437103,10,0,147,69,78
2019,437103,10,1,14,5,9
2019,437103,10,2,41,13,28
2019,437103,10,3,37,18,19
2019,437103,10,4,53,31,22
2019,437103,10,6,2,2,0
2019,437103,40,0,147,69,78
2019,437103,40,1,14,5,9
2019,437103,40,2,41,13,28
2019,437103,40,3,37,18,19
2019,437103,40,4,53,31,22
2019,437103,40,6,2,2,0
2019,437103,42,0,147,69,78
2019,437103,42,1,14,5,9
2019,437103,42,2,41,13,28
2019,437103,42,3,37,18,19
2019,437103,42,4,53,31,22
2019,437103,42,6,2,2,0
2019,437635,0,0,22,3,19
2019,437635,10,0,22,3,19
2019,437635,10,4,22,3,19
2019,437635,40,0,22,3,19
2019,437635,40,4,22,3,19
2019,437635,41,0,22,3,19
2019,437635,41,4,22,3,19
2019,437635,45,0,22,3,19
2019,437635,45,4,22,3,19
2019,437732,0,0,11,2,9
2019,437732,10,0,11,2,9
2019,437732,10,4,11,2,9
2019,437732,40,0,11,2,9
2019,437732,40,4,11,2,9
2019,437732,41,0,1,1,0
2019,437732,41,4,1,1,0
2019,437732,42,0,10,1,9
2019,437732,42,4,10,1,9
2019,437732,45,0,1,1,0
2019,437732,45,4,1,1,0
2019,437769,0,0,2,0,2
2019,437769,10,0,2,0,2
2019,437769,10,4,2,0,2
2019,437769,40,0,2,0,2
2019,437769,40,4,2,0,2
2019,437769,41,0,2,0,2
2019,437769,41,4,2,0,2
2019,437769,45,0,2,0,2
2019,437769,45,4,2,0,2
2019,438151,0,0,4,1,3
2019,438151,10,0,4,1,3
2019,438151,10,6,4,1,3
2019,438151,40,0,4,1,3
2019,438151,40,6,4,1,3
2019,438151,41,0,4,1,3
2019,438151,41,6,4,1,3
2019,438151,45,0,4,1,3
2019,438151,45,6,4,1,3
2019,438179,0,0,5,1,4
2019,438179,10,0,5,1,4
2019,438179,10,4,5,1,4
2019,438179,40,0,5,1,4
2019,438179,40,4,5,1,4
2019,438179,41,0,5,1,4
2019,438179,41,4,5,1,4
2019,438179,45,0,5,1,4
2019,438179,45,4,5,1,4
2019,438221,0,0,5,2,3
2019,438221,10,0,5,2,3
2019,438221,10,4,5,2,3
2019,438221,40,0,5,2,3
2019,438221,40,4,5,2,3
2019,438221,41,0,5,2,3
2019,438221,41,4,5,2,3
2019,438221,45,0,5,2,3
2019,438221,45,4,5,2,3
2019,438498,0,0,67,28,39
2019,438498,50,0,67,28,39
2019,438504,0,0,30,30,0
2019,438504,50,0,30,30,0
2019,438586,0,0,6,5,1
2019,438586,50,0,6,5,1
2019,438708,0,0,12,5,7
2019,438708,10,0,12,5,7
2019,438708,10,2,3,1,2
2019,438708,10,3,3,2,1
2019,438708,10,4,6,2,4
2019,438708,40,0,12,5,7
2019,438708,40,2,3,1,2
2019,438708,40,3,3,2,1
2019,438708,40,4,6,2,4
2019,438708,42,0,12,5,7
2019,438708,42,2,3,1,2
2019,438708,42,3,3,2,1
2019,438708,42,4,6,2,4
2019,439118,0,0,9,0,9
2019,439118,10,0,9,0,9
2019,439118,10,4,9,0,9
2019,439118,40,0,9,0,9
2019,439118,40,4,9,0,9
2019,439118,41,0,9,0,9
2019,439118,41,4,9,0,9
2019,439118,45,0,9,0,9
2019,439118,45,4,9,0,9
2019,439145,0,0,53,23,30
2019,439145,10,0,53,23,30
2019,439145,10,6,53,23,30
2019,439145,20,0,36,19,17
2019,439145,20,6,36,19,17
2019,439145,30,0,17,4,13
2019,439145,30,6,17,4,13
2019,439190,0,0,47,20,27
2019,439190,10,0,47,20,27
2019,439190,10,6,47,20,27
2019,439190,20,0,40,19,21
2019,439190,20,6,40,19,21
2019,439190,30,0,7,1,6
2019,439190,30,6,7,1,6
2019,439288,0,0,47,23,24
2019,439288,10,0,47,23,24
2019,439288,10,1,6,1,5
2019,439288,10,2,21,14,7
2019,439288,10,3,10,5,5
2019,439288,10,4,6,2,4
2019,439288,10,5,4,1,3
2019,439288,40,0,47,23,24
2019,439288,40,1,6,1,5
2019,439288,40,2,21,14,7
2019,439288,40,3,10,5,5
2019,439288,40,4,6,2,4
2019,439288,40,5,4,1,3
2019,439288,41,0,16,10,6
2019,439288,41,1,3,1,2
2019,439288,41,2,11,8,3
2019,439288,41,3,2,1,1
2019,439288,42,0,31,13,18
2019,439288,42,1,3,0,3
2019,439288,42,2,10,6,4
2019,439288,42,3,8,4,4
2019,439288,42,4,6,2,4
2019,439288,42,5,4,1,3
2019,439288,44,0,16,10,6
2019,439288,44,1,3,1,2
2019,439288,44,2,11,8,3
2019,439288,44,3,2,1,1
2019,439367,0,0,26,11,15
2019,439367,10,0,26,11,15
2019,439367,10,4,26,11,15
2019,439367,40,0,26,11,15
2019,439367,40,4,26,11,15
2019,439367,41,0,26,11,15
2019,439367,41,4,26,11,15
2019,439367,45,0,26,11,15
2019,439367,45,4,26,11,15
2019,439446,0,0,6,2,4
2019,439446,10,0,6,2,4
2019,439446,10,4,6,2,4
2019,439446,40,0,6,2,4
2019,439446,40,4,6,2,4
2019,439446,41,0,6,2,4
2019,439446,41,4,6,2,4
2019,439446,44,0,6,2,4
2019,439446,44,4,6,2,4
2019,439570,0,0,28,7,21
2019,439570,10,0,28,7,21
2019,439570,10,4,28,7,21
2019,439570,40,0,28,7,21
2019,439570,40,4,28,7,21
2019,439570,41,0,28,7,21
2019,439570,41,4,28,7,21
2019,439570,44,0,28,7,21
2019,439570,44,4,28,7,21
2019,439701,0,0,12,10,2
2019,439701,10,0,12,10,2
2019,439701,10,1,6,6,0
2019,439701,10,2,3,2,1
2019,439701,10,3,3,2,1
2019,439701,40,0,12,10,2
2019,439701,40,1,6,6,0
2019,439701,40,2,3,2,1
2019,439701,40,3,3,2,1
2019,439701,41,0,3,3,0
2019,439701,41,1,3,3,0
2019,439701,42,0,4,4,0
2019,439701,42,1,2,2,0
2019,439701,42,2,2,2,0
2019,439701,43,0,5,3,2
2019,439701,43,1,1,1,0
2019,439701,43,2,1,0,1
2019,439701,43,3,3,2,1
2019,439701,44,0,3,3,0
2019,439701,44,1,3,3,0
2019,439738,0,0,12,4,8
2019,439738,10,0,12,4,8
2019,439738,10,4,12,4,8
2019,439738,40,0,12,4,8
2019,439738,40,4,12,4,8
2019,439738,41,0,12,4,8
2019,439738,41,4,12,4,8
2019,439738,45,0,12,4,8
2019,439738,45,4,12,4,8
2019,439792,0,0,4,0,4
2019,439792,10,0,4,0,4
2019,439792,10,4,4,0,4
2019,439792,40,0,4,0,4
2019,439792,40,4,4,0,4
2019,439792,41,0,4,0,4
2019,439792,41,4,4,0,4
2019,439792,45,0,4,0,4
2019,439792,45,4,4,0,4
2019,439817,0,0,5,3,2
2019,439817,10,0,5,3,2
2019,439817,10,1,2,1,1
2019,439817,10,2,1,0,1
2019,439817,10,3,2,2,0
2019,439817,20,0,2,1,1
2019,439817,20,1,2,1,1
2019,439817,30,0,3,2,1
2019,439817,30,2,1,0,1
2019,439817,30,3,2,2,0
2019,440031,0,0,55,25,30
2019,440031,10,0,51,23,28
2019,440031,10,1,24,14,10
2019,440031,10,2,12,6,6
2019,440031,10,3,15,3,12
2019,440031,40,0,51,23,28
2019,440031,40,1,24,14,10
2019,440031,40,2,12,6,6
2019,440031,40,3,15,3,12
2019,440031,41,0,51,23,28
2019,440031,41,1,24,14,10
2019,440031,41,2,12,6,6
2019,440031,41,3,15,3,12
2019,440031,44,0,51,23,28
2019,440031,44,1,24,14,10
2019,440031,44,2,12,6,6
2019,440031,44,3,15,3,12
2019,440031,50,0,4,2,2
2019,440059,0,0,49,48,1
2019,440059,50,0,49,48,1
2019,440138,0,0,1,1,0
2019,440138,50,0,1,1,0
2019,440262,0,0,20,20,0
2019,440262,10,0,20,20,0
2019,440262,10,1,4,4,0
2019,440262,10,4,16,16,0
2019,440262,40,0,20,20,0
2019,440262,40,1,4,4,0
2019,440262,40,4,16,16,0
2019,440262,43,0,20,20,0
2019,440262,43,1,4,4,0
2019,440262,43,4,16,16,0
2019,440396,0,0,13,13,0
2019,440396,10,0,12,12,0
2019,440396,10,1,12,12,0
2019,440396,40,0,12,12,0
2019,440396,40,1,12,12,0
2019,440396,42,0,12,12,0
2019,440396,42,1,12,12,0
2019,440396,50,0,1,1,0
2019,440402,0,0,74,32,42
2019,440402,10,0,74,32,42
2019,440402,10,1,1,1,0
2019,440402,10,2,2,0,2
2019,440402,10,3,29,8,21
2019,440402,10,4,42,23,19
2019,440402,20,0,3,1,2
2019,440402,20,1,1,1,0
2019,440402,20,3,2,0,2
2019,440402,40,0,71,31,40
2019,440402,40,2,2,0,2
2019,440402,40,3,27,8,19
2019,440402,40,4,42,23,19
2019,440402,42,0,71,31,40
2019,440402,42,2,2,0,2
2019,440402,42,3,27,8,19
2019,440402,42,4,42,23,19
2019,440651,0,0,20,3,17
2019,440651,10,0,20,3,17
2019,440651,10,1,20,3,17
2019,440651,20,0,13,2,11
2019,440651,20,1,13,2,11
2019,440651,40,0,7,1,6
2019,440651,40,1,7,1,6
2019,440651,43,0,7,1,6
2019,440651,43,1,7,1,6
2019,440794,0,0,12,6,6
2019,440794,10,0,12,6,6
2019,440794,10,1,3,2,1
2019,440794,10,2,4,2,2
2019,440794,10,3,5,2,3
2019,440794,40,0,12,6,6
2019,440794,40,1,3,2,1
2019,440794,40,2,4,2,2
2019,440794,40,3,5,2,3
2019,440794,41,0,12,6,6
2019,440794,41,1,3,2,1
2019,440794,41,2,4,2,2
2019,440794,41,3,5,2,3
2019,440794,44,0,12,6,6
2019,440794,44,1,3,2,1
2019,440794,44,2,4,2,2
2019,440794,44,3,5,2,3
2019,440916,0,0,26,11,15
2019,440916,10,0,26,11,15
2019,440916,10,1,3,2,1
2019,440916,10,2,15,7,8
2019,440916,10,4,8,2,6
2019,440916,20,0,12,4,8
2019,440916,20,1,3,2,1
2019,440916,20,2,9,2,7
2019,440916,30,0,6,5,1
2019,440916,30,2,6,5,1
2019,440916,40,0,8,2,6
2019,440916,40,4,8,2,6
2019,440916,43,0,8,2,6
2019,440916,43,4,8,2,6
2019,441025,0,0,8,6,2
2019,441025,10,0,8,6,2
2019,441025,10,4,8,6,2
2019,441025,40,0,8,6,2
2019,441025,40,4,8,6,2
2019,441025,41,0,8,6,2
2019,441025,41,4,8,6,2
2019,441025,45,0,8,6,2
2019,441025,45,4,8,6,2
2019,441052,0,0,26,5,21
2019,441052,50,0,26,5,21
2019,441070,0,0,7,5,2
2019,441070,10,0,5,4,1
2019,441070,10,4,5,4,1
2019,441070,40,0,5,4,1
2019,441070,40,4,5,4,1
2019,441070,41,0,5,4,1
2019,441070,41,4,5,4,1
2019,441070,45,0,5,4,1
2019,441070,45,4,5,4,1
2019,441070,50,0,2,1,1
2019,441104,0,0,13,6,7
2019,441104,10,0,13,6,7
2019,441104,10,1,2,2,0
2019,441104,10,2,5,1,4
2019,441104,10,3,6,3,3
2019,441104,40,0,13,6,7
2019,441104,40,1,2,2,0
2019,441104,40,2,5,1,4
2019,441104,40,3,6,3,3
2019,441104,41,0,13,6,7
2019,441104,41,1,2,2,0
2019,441104,41,2,5,1,4
2019,441104,41,3,6,3,3
2019,441104,44,0,13,6,7
2019,441104,44,1,2,2,0
2019,441104,44,2,5,1,4
2019,441104,44,3,6,3,3
2019,441131,0,0,8,5,3
2019,441131,10,0,8,5,3
2019,441131,10,1,2,2,0
2019,441131,10,2,5,2,3
2019,441131,10,3,1,1,0
2019,441131,40,0,8,5,3
2019,441131,40,1,2,2,0
2019,441131,40,2,5,2,3
2019,441131,40,3,1,1,0
2019,441131,42,0,8,5,3
2019,441131,42,1,2,2,0
2019,441131,42,2,5,2,3
2019,441131,42,3,1,1,0
2019,441229,0,0,77,43,34
2019,441229,50,0,77,43,34
2019,441371,0,0,368,70,298
2019,441371,50,0,368,70,298
2019,441423,0,0,7,3,4
2019,441423,10,0,7,3,4
2019,441423,10,4,7,3,4
2019,441423,40,0,7,3,4
2019,441423,40,4,7,3,4
2019,441423,41,0,7,3,4
2019,441423,41,4,7,3,4
2019,441423,45,0,7,3,4
2019,441423,45,4,7,3,4
2019,441609,0,0,8,8,0
2019,441609,10,0,8,8,0
2019,441609,10,4,8,8,0
2019,441609,40,0,8,8,0
2019,441609,40,4,8,8,0
2019,441609,42,0,8,8,0
2019,441609,42,4,8,8,0
2019,441636,0,0,10,1,9
2019,441636,10,0,10,1,9
2019,441636,10,4,10,1,9
2019,441636,40,0,10,1,9
2019,441636,40,4,10,1,9
2019,441636,41,0,10,1,9
2019,441636,41,4,10,1,9
2019,441636,45,0,10,1,9
2019,441636,45,4,10,1,9
2019,441742,0,0,19,5,14
2019,441742,10,0,19,5,14
2019,441742,10,4,19,5,14
2019,441742,40,0,19,5,14
2019,441742,40,4,19,5,14
2019,441742,41,0,19,5,14
2019,441742,41,4,19,5,14
2019,441742,45,0,19,5,14
2019,441742,45,4,19,5,14
2019,441760,0,0,79,32,47
2019,441760,10,0,79,32,47
2019,441760,10,4,79,32,47
2019,441760,20,0,56,21,35
2019,441760,20,4,56,21,35
2019,441760,30,0,17,9,8
2019,441760,30,4,17,9,8
2019,441760,40,0,6,2,4
2019,441760,40,4,6,2,4
2019,441760,42,0,6,2,4
2019,441760,42,4,6,2,4
2019,441858,0,0,5,0,5
2019,441858,10,0,5,0,5
2019,441858,10,4,5,0,5
2019,441858,40,0,5,0,5
2019,441858,40,4,5,0,5
2019,441858,41,0,4,0,4
2019,441858,41,4,4,0,4
2019,441858,42,0,1,0,1
2019,441858,42,4,1,0,1
2019,441858,45,0,4,0,4
2019,441858,45,4,4,0,4
2019,441900,0,0,104,35,69
2019,441900,10,0,104,35,69
2019,441900,10,1,7,4,3
2019,441900,10,2,19,11,8
2019,441900,10,3,40,7,33
2019,441900,10,5,38,13,25
2019,441900,20,0,26,15,11
2019,441900,20,1,7,4,3
2019,441900,20,2,19,11,8
2019,441900,30,0,40,7,33
2019,441900,30,3,40,7,33
2019,441900,40,0,38,13,25
2019,441900,40,5,38,13,25
2019,441900,42,0,38,13,25
2019,441900,42,5,38,13,25
2019,441937,0,0,236,107,129
2019,441937,10,0,236,107,129
2019,441937,10,1,54,30,24
2019,441937,10,2,26,11,15
2019,441937,10,3,70,25,45
2019,441937,10,5,86,41,45
2019,441937,20,0,80,41,39
2019,441937,20,1,54,30,24
2019,441937,20,2,26,11,15
2019,441937,30,0,70,25,45
2019,441937,30,3,70,25,45
2019,441937,40,0,86,41,45
2019,441937,40,5,86,41,45
2019,441937,41,0,48,25,23
2019,441937,41,5,48,25,23
2019,441937,42,0,38,16,22
2019,441937,42,5,38,16,22
2019,441937,44,0,48,25,23
2019,441937,44,5,48,25,23
2019,441982,0,0,48,25,23
2019,441982,10,0,48,25,23
2019,441982,10,1,16,10,6
2019,441982,10,2,12,6,6
2019,441982,10,3,14,5,9
2019,441982,10,4,5,3,2
2019,441982,10,5,1,1,0
2019,441982,40,0,48,25,23
2019,441982,40,1,16,10,6
2019,441982,40,2,12,6,6
2019,441982,40,3,14,5,9
2019,441982,40,4,5,3,2
2019,441982,40,5,1,1,0
2019,441982,41,0,45,24,21
2019,441982,41,1,15,10,5
2019,441982,41,2,12,6,6
2019,441982,41,3,13,5,8
2019,441982,41,4,4,2,2
2019,441982,41,5,1,1,0
2019,441982,42,0,3,1,2
2019,441982,42,1,1,0,1
2019,441982,42,3,1,0,1
2019,441982,42,4,1,1,0
2019,441982,44,0,41,21,20
2019,441982,44,1,15,10,5
2019,441982,44,2,12,6,6
2019,441982,44,3,13,5,8
2019,441982,44,4,1,0,1
2019,441982,45,0,4,3,1
2019,441982,45,4,3,2,1
2019,441982,45,5,1,1,0
2019,442064,0,0,7,2,5
2019,442064,10,0,7,2,5
2019,442064,10,2,1,0,1
2019,442064,10,3,6,2,4
2019,442064,40,0,7,2,5
2019,442064,40,2,1,0,1
2019,442064,40,3,6,2,4
2019,442064,41,0,7,2,5
2019,442064,41,2,1,0,1
2019,442064,41,3,6,2,4
2019,442064,44,0,1,1,0
2019,442064,44,3,1,1,0
2019,442064,45,0,6,1,5
2019,442064,45,2,1,0,1
2019,442064,45,3,5,1,4
2019,442134,0,0,18,1,17
2019,442134,10,0,18,1,17
2019,442134,10,4,18,1,17
2019,442134,40,0,18,1,17
2019,442134,40,4,18,1,17
2019,442134,41,0,18,1,17
2019,442134,41,4,18,1,17
2019,442134,45,0,18,1,17
2019,442134,45,4,18,1,17
2019,442295,0,0,27,17,10
2019,442295,10,0,25,15,10
2019,442295,10,1,16,11,5
2019,442295,10,3,9,4,5
2019,442295,20,0,10,7,3
2019,442295,20,1,10,7,3
2019,442295,30,0,4,2,2
2019,442295,30,1,3,2,1
2019,442295,30,3,1,0,1
2019,442295,40,0,11,6,5
2019,442295,40,1,3,2,1
2019,442295,40,3,8,4,4
2019,442295,41,0,11,6,5
2019,442295,41,1,3,2,1
2019,442295,41,3,8,4,4
2019,442295,44,0,10,5,5
2019,442295,44,1,3,2,1
2019,442295,44,3,7,3,4
2019,442295,45,0,1,1,0
2019,442295,45,3,1,1,0
2019,442295,50,0,2,2,0
2019,442356,0,0,63,10,53
2019,442356,10,0,63,10,53
2019,442356,10,1,2,1,1
2019,442356,10,2,5,0,5
2019,442356,10,3,17,2,15
2019,442356,10,4,36,6,30
2019,442356,10,5,3,1,2
2019,442356,40,0,63,10,53
2019,442356,40,1,2,1,1
2019,442356,40,2,5,0,5
2019,442356,40,3,17,2,15
2019,442356,40,4,36,6,30
2019,442356,40,5,3,1,2
2019,442356,42,0,63,10,53
2019,442356,42,1,2,1,1
2019,442356,42,2,5,0,5
2019,442356,42,3,17,2,15
2019,442356,42,4,36,6,30
2019,442356,42,5,3,1,2
2019,442426,0,0,17,4,13
2019,442426,10,0,17,4,13
2019,442426,10,4,17,4,13
2019,442426,40,0,17,4,13
2019,442426,40,4,17,4,13
2019,442426,41,0,17,4,13
2019,442426,41,4,17,4,13
2019,442426,45,0,17,4,13
2019,442426,45,4,17,4,13
2019,442569,0,0,31,12,19
2019,442569,10,0,31,12,19
2019,442569,10,1,1,0,1
2019,442569,10,2,5,1,4
2019,442569,10,3,16,7,9
2019,442569,10,4,9,4,5
2019,442569,40,0,31,12,19
2019,442569,40,1,1,0,1
2019,442569,40,2,5,1,4
2019,442569,40,3,16,7,9
2019,442569,40,4,9,4,5
2019,442569,41,0,31,12,19
2019,442569,41,1,1,0,1
2019,442569,41,2,5,1,4
2019,442569,41,3,16,7,9
2019,442569,41,4,9,4,5
2019,442569,45,0,31,12,19
2019,442569,45,1,1,0,1
2019,442569,45,2,5,1,4
2019,442569,45,3,16,7,9
2019,442569,45,4,9,4,5
2019,442602,0,0,14,1,13
2019,442602,10,0,14,1,13
2019,442602,10,4,14,1,13
2019,442602,40,0,14,1,13
2019,442602,40,4,14,1,13
2019,442602,41,0,14,1,13
2019,442602,41,4,14,1,13
2019,442602,45,0,14,1,13
2019,442602,45,4,14,1,13
2019,442781,0,0,16,8,8
2019,442781,10,0,16,8,8
2019,442781,10,4,16,8,8
2019,442781,40,0,16,8,8
2019,442781,40,4,16,8,8
2019,442781,42,0,16,8,8
2019,442781,42,4,16,8,8
2019,442806,0,0,115,60,55
2019,442806,10,0,115,60,55
2019,442806,10,1,15,8,7
2019,442806,10,2,25,16,9
2019,442806,10,3,65,33,32
2019,442806,10,4,10,3,7
2019,442806,20,0,2,2,0
2019,442806,20,1,2,2,0
2019,442806,30,0,106,54,52
2019,442806,30,1,13,6,7
2019,442806,30,2,25,16,9
2019,442806,30,3,58,29,29
2019,442806,30,4,10,3,7
2019,442806,40,0,7,4,3
2019,442806,40,3,7,4,3
2019,442806,42,0,7,4,3
2019,442806,42,3,7,4,3
2019,442842,0,0,2,2,0
2019,442842,10,0,2,2,0
2019,442842,10,4,2,2,0
2019,442842,40,0,2,2,0
2019,442842,40,4,2,2,0
2019,442842,42,0,2,2,0
2019,442842,42,4,2,2,0
2019,442879,0,0,1,0,1
2019,442879,50,0,1,0,1
2019,442930,0,0,16,12,4
2019,442930,10,0,16,12,4
2019,442930,10,4,16,12,4
2019,442930,40,0,16,12,4
2019,442930,40,4,16,12,4
2019,442930,41,0,16,12,4
2019,442930,41,4,16,12,4
2019,442930,45,0,16,12,4
2019,442930,45,4,16,12,4
2019,443049,0,0,10,8,2
2019,443049,10,0,10,8,2
2019,443049,10,1,7,6,1
2019,443049,10,3,1,0,1
2019,443049,10,4,2,2,0
2019,443049,40,0,10,8,2
2019,443049,40,1,7,6,1
2019,443049,40,3,1,0,1
2019,443049,40,4,2,2,0
2019,443049,42,0,10,8,2
2019,443049,42,1,7,6,1
2019,443049,42,3,1,0,1
2019,443049,42,4,2,2,0
2019,443076,0,0,6,3,3
2019,443076,10,0,5,3,2
2019,443076,10,1,2,1,1
2019,443076,10,2,2,2,0
2019,443076,10,3,1,0,1
2019,443076,20,0,1,0,1
2019,443076,20,1,1,0,1
2019,443076,30,0,4,3,1
2019,443076,30,1,1,1,0
2019,443076,30,2,2,2,0
2019,443076,30,3,1,0,1
2019,443076,50,0,1,0,1
2019,443128,0,0,19,15,4
2019,443128,10,0,19,15,4
2019,443128,10,1,19,15,4
2019,443128,40,0,19,15,4
2019,443128,40,1,19,15,4
2019,443128,41,0,19,15,4
2019,443128,41,1,19,15,4
2019,443128,45,0,19,15,4
2019,443128,45,1,19,15,4
2019,443261,0,0,9,4,5
2019,443261,10,0,9,4,5
2019,443261,10,4,9,4,5
2019,443261,40,0,9,4,5
2019,443261,40,4,9,4,5
2019,443261,41,0,9,4,5
2019,443261,41,4,9,4,5
2019,443261,45,0,9,4,5
2019,443261,45,4,9,4,5
2019,443331,0,0,47,18,29
2019,443331,10,0,47,18,29
2019,443331,10,2,7,4,3
2019,443331,10,3,16,8,8
2019,443331,10,4,24,6,18
2019,443331,40,0,47,18,29
2019,443331,40,2,7,4,3
2019,443331,40,3,16,8,8
2019,443331,40,4,24,6,18
2019,443331,41,0,47,18,29
2019,443331,41,2,7,4,3
2019,443331,41,3,16,8,8
2019,443331,41,4,24,6,18
2019,443331,45,0,47,18,29
2019,443331,45,2,7,4,3
2019,443331,45,3,16,8,8
2019,443331,45,4,24,6,18
2019,443377,0,0,10,9,1
2019,443377,10,0,10,9,1
2019,443377,10,4,10,9,1
2019,443377,40,0,10,9,1
2019,443377,40,4,10,9,1
2019,443377,41,0,10,9,1
2019,443377,41,4,10,9,1
2019,443377,45,0,10,9,1
2019,443377,45,4,10,9,1
2019,443410,0,0,75,56,19
2019,443410,10,0,75,56,19
2019,443410,10,1,6,4,2
2019,443410,10,2,11,7,4
2019,443410,10,3,13,9,4
2019,443410,10,5,45,36,9
2019,443410,40,0,75,56,19
2019,443410,40,1,6,4,2
2019,443410,40,2,11,7,4
2019,443410,40,3,13,9,4
2019,443410,40,5,45,36,9
2019,443410,42,0,45,34,11
2019,443410,42,1,5,4,1
2019,443410,42,2,9,6,3
2019,443410,42,3,7,5,2
2019,443410,42,5,24,19,5
2019,443410,43,0,30,22,8
2019,443410,43,1,1,0,1
2019,443410,43,2,2,1,1
2019,443410,43,3,6,4,2
2019,443410,43,5,21,17,4
2019,443492,0,0,54,18,36
2019,443492,10,0,53,18,35
2019,443492,10,1,9,2,7
2019,443492,10,2,11,2,9
2019,443492,10,3,23,8,15
2019,443492,10,4,10,6,4
2019,443492,20,0,7,2,5
2019,443492,20,1,7,2,5
2019,443492,30,0,9,3,6
2019,443492,30,1,1,0,1
2019,443492,30,2,3,0,3
2019,443492,30,3,5,3,2
2019,443492,40,0,37,13,24
2019,443492,40,1,1,0,1
2019,443492,40,2,8,2,6
2019,443492,40,3,18,5,13
2019,443492,40,4,10,6,4
2019,443492,42,0,37,13,24
2019,443492,42,1,1,0,1
2019,443492,42,2,8,2,6
2019,443492,42,3,18,5,13
2019,443492,42,4,10,6,4
2019,443492,50,0,1,0,1
2019,443562,0,0,50,21,29
2019,443562,10,0,50,21,29
2019,443562,10,1,50,21,29
2019,443562,40,0,50,21,29
2019,443562,40,1,50,21,29
2019,443562,41,0,50,21,29
2019,443562,41,1,50,21,29
2019,443562,44,0,50,21,29
2019,443562,44,1,50,21,29
2019,443599,0,0,12,6,6
2019,443599,10,0,12,6,6
2019,443599,10,1,12,6,6
2019,443599,40,0,12,6,6
2019,443599,40,1,12,6,6
2019,443599,41,0,12,6,6
2019,443599,41,1,12,6,6
2019,443599,45,0,12,6,6
2019,443599,45,1,12,6,6
2019,443650,0,0,12,4,8
2019,443650,10,0,12,4,8
2019,443650,10,4,12,4,8
2019,443650,40,0,12,4,8
2019,443650,40,4,12,4,8
2019,443650,41,0,12,4,8
2019,443650,41,4,12,4,8
2019,443650,45,0,12,4,8
2019,443650,45,4,12,4,8
2019,443748,0,0,9,4,5
2019,443748,10,0,9,4,5
2019,443748,10,4,9,4,5
2019,443748,40,0,9,4,5
2019,443748,40,4,9,4,5
2019,443748,41,0,9,4,5
2019,443748,41,4,9,4,5
2019,443748,45,0,9,4,5
2019,443748,45,4,9,4,5
2019,443766,0,0,5,4,1
2019,443766,10,0,5,4,1
2019,443766,10,6,5,4,1
2019,443766,40,0,5,4,1
2019,443766,40,6,5,4,1
2019,443766,41,0,5,4,1
2019,443766,41,6,5,4,1
2019,443766,45,0,5,4,1
2019,443766,45,6,5,4,1
2019,443784,0,0,5,5,0
2019,443784,10,0,5,5,0
2019,443784,10,6,5,5,0
2019,443784,40,0,5,5,0
2019,443784,40,6,5,5,0
2019,443784,41,0,5,5,0
2019,443784,41,6,5,5,0
2019,443784,45,0,5,5,0
2019,443784,45,6,5,5,0
2019,444088,0,0,6,1,5
2019,444088,10,0,6,1,5
2019,444088,10,4,6,1,5
2019,444088,40,0,6,1,5
2019,444088,40,4,6,1,5
2019,444088,41,0,6,1,5
2019,444088,41,4,6,1,5
2019,444088,45,0,6,1,5
2019,444088,45,4,6,1,5
2019,444130,0,0,88,35,53
2019,444130,10,0,88,35,53
2019,444130,10,1,48,21,27
2019,444130,10,2,29,12,17
2019,444130,10,3,11,2,9
2019,444130,40,0,88,35,53
2019,444130,40,1,48,21,27
2019,444130,40,2,29,12,17
2019,444130,40,3,11,2,9
2019,444130,41,0,88,35,53
2019,444130,41,1,48,21,27
2019,444130,41,2,29,12,17
2019,444130,41,3,11,2,9
2019,444130,45,0,88,35,53
2019,444130,45,1,48,21,27
2019,444130,45,2,29,12,17
2019,444130,45,3,11,2,9
2019,444219,0,0,130,58,72
2019,444219,10,0,130,58,72
2019,444219,10,4,130,58,72
2019,444219,20,0,88,45,43
2019,444219,20,4,88,45,43
2019,444219,30,0,40,13,27
2019,444219,30,4,40,13,27
2019,444219,40,0,2,0,2
2019,444219,40,4,2,0,2
2019,444219,43,0,2,0,2
2019,444219,43,4,2,0,2
2019,444334,0,0,7,4,3
2019,444334,10,0,7,4,3
2019,444334,10,4,7,4,3
2019,444334,40,0,7,4,3
2019,444334,40,4,7,4,3
2019,444334,41,0,7,4,3
2019,444334,41,4,7,4,3
2019,444334,44,0,7,4,3
2019,444334,44,4,7,4,3
2019,444343,0,0,13,1,12
2019,444343,10,0,13,1,12
2019,444343,10,4,13,1,12
2019,444343,40,0,13,1,12
2019,444343,40,4,13,1,12
2019,444343,41,0,13,1,12
2019,444343,41,4,13,1,12
2019,444343,45,0,13,1,12
2019,444343,45,4,13,1,12
2019,444398,0,0,6,3,3
2019,444398,10,0,6,3,3
2019,444398,10,1,2,1,1
2019,444398,10,3,4,2,2
2019,444398,40,0,6,3,3
2019,444398,40,1,2,1,1
2019,444398,40,3,4,2,2
2019,444398,42,0,6,3,3
2019,444398,42,1,2,1,1
2019,444398,42,3,4,2,2
2019,444556,0,0,19,11,8
2019,444556,10,0,19,11,8
2019,444556,10,4,19,11,8
2019,444556,40,0,19,11,8
2019,444556,40,4,19,11,8
2019,444556,41,0,19,11,8
2019,444556,41,4,19,11,8
2019,444556,45,0,19,11,8
2019,444556,45,4,19,11,8
2019,444565,0,0,29,13,16
2019,444565,10,0,14,11,3
2019,444565,10,4,14,11,3
2019,444565,40,0,14,11,3
2019,444565,40,4,14,11,3
2019,444565,41,0,14,11,3
2019,444565,41,4,14,11,3
2019,444565,45,0,14,11,3
2019,444565,45,4,14,11,3
2019,444565,50,0,15,2,13
2019,444787,0,0,67,12,55
2019,444787,10,0,67,12,55
2019,444787,10,3,67,12,55
2019,444787,40,0,67,12,55
2019,444787,40,3,67,12,55
2019,444787,41,0,67,12,55
2019,444787,41,3,67,12,55
2019,444787,45,0,67,12,55
2019,444787,45,3,67,12,55
2019,444866,0,0,9,1,8
2019,444866,10,0,9,1,8
2019,444866,10,4,9,1,8
2019,444866,40,0,9,1,8
2019,444866,40,4,9,1,8
2019,444866,41,0,9,1,8
2019,444866,41,4,9,1,8
2019,444866,45,0,9,1,8
2019,444866,45,4,9,1,8
2019,444954,0,0,63,25,38
2019,444954,10,0,63,25,38
2019,444954,10,1,11,5,6
2019,444954,10,2,15,5,10
2019,444954,10,3,21,10,11
2019,444954,10,4,6,4,2
2019,444954,10,6,10,1,9
2019,444954,20,0,4,2,2
2019,444954,20,1,4,2,2
2019,444954,40,0,59,23,36
2019,444954,40,1,7,3,4
2019,444954,40,2,15,5,10
2019,444954,40,3,21,10,11
2019,444954,40,4,6,4,2
2019,444954,40,6,10,1,9
2019,444954,42,0,59,23,36
2019,444954,42,1,7,3,4
2019,444954,42,2,15,5,10
2019,444954,42,3,21,10,11
2019,444954,42,4,6,4,2
2019,444954,42,6,10,1,9
2019,445027,0,0,52,19,33
2019,445027,50,0,52,19,33
2019,445054,0,0,11,9,2
2019,445054,10,0,11,9,2
2019,445054,10,1,6,5,1
2019,445054,10,2,3,2,1
2019,445054,10,3,2,2,0
2019,445054,20,0,9,7,2
2019,445054,20,1,6,5,1
2019,445054,20,2,3,2,1
2019,445054,30,0,2,2,0
2019,445054,30,3,2,2,0
2019,445133,0,0,3,3,0
2019,445133,50,0,3,3,0
2019,445188,0,0,407,222,185
2019,445188,10,0,407,222,185
2019,445188,10,1,82,53,29
2019,445188,10,2,66,39,27
2019,445188,10,3,111,61,50
2019,445188,10,5,148,69,79
2019,445188,20,0,161,98,63
2019,445188,20,1,82,53,29
2019,445188,20,2,66,39,27
2019,445188,20,5,13,6,7
2019,445188,30,0,119,66,53
2019,445188,30,3,111,61,50
2019,445188,30,5,8,5,3
2019,445188,40,0,127,58,69
2019,445188,40,5,127,58,69
2019,445188,41,0,65,29,36
2019,445188,41,5,65,29,36
2019,445188,42,0,62,29,33
2019,445188,42,5,62,29,33
2019,445188,44,0,65,29,36
2019,445188,44,5,65,29,36
2019,445203,0,0,19,7,12
2019,445203,50,0,19,7,12
2019,445230,0,0,30,13,17
2019,445230,10,0,30,13,17
2019,445230,10,4,30,13,17
2019,445230,40,0,30,13,17
2019,445230,40,4,30,13,17
2019,445230,41,0,30,13,17
2019,445230,41,4,30,13,17
2019,445230,45,0,30,13,17
2019,445230,45,4,30,13,17
2019,445249,0,0,11,4,7
2019,445249,50,0,11,4,7
2019,445258,0,0,13,8,5
2019,445258,10,0,13,8,5
2019,445258,10,4,13,8,5
2019,445258,40,0,13,8,5
2019,445258,40,4,13,8,5
2019,445258,41,0,13,8,5
2019,445258,41,4,13,8,5
2019,445258,45,0,13,8,5
2019,445258,45,4,13,8,5
2019,445267,0,0,13,2,11
2019,445267,10,0,13,2,11
2019,445267,10,2,4,0,4
2019,445267,10,3,9,2,7
2019,445267,30,0,4,1,3
2019,445267,30,3,4,1,3
2019,445267,40,0,9,1,8
2019,445267,40,2,4,0,4
2019,445267,40,3,5,1,4
2019,445267,42,0,9,1,8
2019,445267,42,2,4,0,4
2019,445267,42,3,5,1,4
2019,445461,0,0,8,5,3
2019,445461,10,0,8,5,3
2019,445461,10,4,8,5,3
2019,445461,40,0,8,5,3
2019,445461,40,4,8,5,3
2019,445461,41,0,8,5,3
2019,445461,41,4,8,5,3
2019,445461,45,0,8,5,3
2019,445461,45,4,8,5,3
2019,445692,0,0,10,10,0
2019,445692,10,0,10,10,0
2019,445692,10,4,10,10,0
2019,445692,40,0,10,10,0
2019,445692,40,4,10,10,0
2019,445692,41,0,10,10,0
2019,445692,41,4,10,10,0
2019,445692,45,0,10,10,0
2019,445692,45,4,10,10,0
2019,445708,0,0,78,41,37
2019,445708,10,0,78,41,37
2019,445708,10,1,17,11,6
2019,445708,10,2,37,15,22
2019,445708,10,3,21,15,6
2019,445708,10,4,1,0,1
2019,445708,10,5,2,0,2
2019,445708,40,0,78,41,37
2019,445708,40,1,17,11,6
2019,445708,40,2,37,15,22
2019,445708,40,3,21,15,6
2019,445708,40,4,1,0,1
2019,445708,40,5,2,0,2
2019,445708,41,0,33,12,21
2019,445708,41,1,9,4,5
2019,445708,41,2,24,8,16
2019,445708,42,0,45,29,16
2019,445708,42,1,8,7,1
2019,445708,42,2,13,7,6
2019,445708,42,3,21,15,6
2019,445708,42,4,1,0,1
2019,445708,42,5,2,0,2
2019,445708,44,0,33,12,21
2019,445708,44,1,9,4,5
2019,445708,44,2,24,8,16
2019,445735,0,0,135,72,63
2019,445735,10,0,135,72,63
2019,445735,10,1,9,9,0
2019,445735,10,2,39,24,15
2019,445735,10,3,84,38,46
2019,445735,10,4,3,1,2
2019,445735,40,0,135,72,63
2019,445735,40,1,9,9,0
2019,445735,40,2,39,24,15
2019,445735,40,3,84,38,46
2019,445735,40,4,3,1,2
2019,445735,41,0,124,66,58
2019,445735,41,1,6,6,0
2019,445735,41,2,37,23,14
2019,445735,41,3,81,37,44
2019,445735,42,0,11,6,5
2019,445735,42,1,3,3,0
2019,445735,42,2,2,1,1
2019,445735,42,3,3,1,2
2019,445735,42,4,3,1,2
2019,445735,44,0,124,66,58
2019,445735,44,1,6,6,0
2019,445735,44,2,37,23,14
2019,445735,44,3,81,37,44
2019,445744,0,0,10,0,10
2019,445744,10,0,10,0,10
2019,445744,10,4,10,0,10
2019,445744,40,0,10,0,10
2019,445744,40,4,10,0,10
2019,445744,41,0,10,0,10
2019,445744,41,4,10,0,10
2019,445744,45,0,10,0,10
2019,445744,45,4,10,0,10
2019,445869,0,0,24,12,12
2019,445869,10,0,24,12,12
2019,445869,10,1,6,5,1
2019,445869,10,2,10,4,6
2019,445869,10,3,8,3,5
2019,445869,40,0,24,12,12
2019,445869,40,1,6,5,1
2019,445869,40,2,10,4,6
2019,445869,40,3,8,3,5
2019,445869,41,0,24,12,12
2019,445869,41,1,6,5,1
2019,445869,41,2,10,4,6
2019,445869,41,3,8,3,5
2019,445869,44,0,24,12,12
2019,445869,44,1,6,5,1
2019,445869,44,2,10,4,6
2019,445869,44,3,8,3,5
2019,445948,0,0,38,7,31
2019,445948,10,0,38,7,31
2019,445948,10,6,38,7,31
2019,445948,40,0,38,7,31
2019,445948,40,6,38,7,31
2019,445948,41,0,38,7,31
2019,445948,41,6,38,7,31
2019,445948,45,0,38,7,31
2019,445948,45,6,38,7,31
2019,446048,0,0,63,46,17
2019,446048,10,0,63,46,17
2019,446048,10,1,8,7,1
2019,446048,10,2,22,18,4
2019,446048,10,3,29,18,11
2019,446048,10,4,4,3,1
2019,446048,40,0,63,46,17
2019,446048,40,1,8,7,1
2019,446048,40,2,22,18,4
2019,446048,40,3,29,18,11
2019,446048,40,4,4,3,1
2019,446048,41,0,22,18,4
2019,446048,41,1,8,7,1
2019,446048,41,2,13,11,2
2019,446048,41,3,1,0,1
2019,446048,42,0,41,28,13
2019,446048,42,2,9,7,2
2019,446048,42,3,28,18,10
2019,446048,42,4,4,3,1
2019,446048,44,0,22,18,4
2019,446048,44,1,8,7,1
2019,446048,44,2,13,11,2
2019,446048,44,3,1,0,1
2019,446109,0,0,21,5,16
2019,446109,50,0,21,5,16
2019,446118,0,0,38,12,26
2019,446118,10,0,38,12,26
2019,446118,10,4,38,12,26
2019,446118,40,0,38,12,26
2019,446118,40,4,38,12,26
2019,446118,41,0,38,12,26
2019,446118,41,4,38,12,26
2019,446118,45,0,38,12,26
2019,446118,45,4,38,12,26
2019,446127,0,0,4,1,3
2019,446127,10,0,4,1,3
2019,446127,10,4,4,1,3
2019,446127,40,0,4,1,3
2019,446127,40,4,4,1,3
2019,446127,41,0,4,1,3
2019,446127,41,4,4,1,3
2019,446127,45,0,4,1,3
2019,446127,45,4,4,1,3
2019,446136,0,0,11,5,6
2019,446136,50,0,11,5,6
2019,446233,0,0,15,10,5
2019,446233,10,0,15,10,5
2019,446233,10,4,15,10,5
2019,446233,40,0,15,10,5
2019,446233,40,4,15,10,5
2019,446233,41,0,15,10,5
2019,446233,41,4,15,10,5
2019,446233,44,0,1,1,0
2019,446233,44,4,1,1,0
2019,446233,45,0,14,9,5
2019,446233,45,4,14,9,5
2019,446385,0,0,9,7,2
2019,446385,10,0,9,7,2
2019,446385,10,6,9,7,2
2019,446385,40,0,9,7,2
2019,446385,40,6,9,7,2
2019,446385,41,0,9,7,2
2019,446385,41,6,9,7,2
2019,446385,44,0,9,7,2
2019,446385,44,6,9,7,2
2019,446394,0,0,13,10,3
2019,446394,10,0,13,10,3
2019,446394,10,1,10,10,0
2019,446394,10,4,3,0,3
2019,446394,40,0,13,10,3
2019,446394,40,1,10,10,0
2019,446394,40,4,3,0,3
2019,446394,41,0,13,10,3
2019,446394,41,1,10,10,0
2019,446394,41,4,3,0,3
2019,446394,44,0,13,10,3
2019,446394,44,1,10,10,0
2019,446394,44,4,3,0,3
2019,446525,0,0,4,4,0
2019,446525,10,0,4,4,0
2019,446525,10,4,4,4,0
2019,446525,40,0,4,4,0
2019,446525,40,4,4,4,0
2019,446525,41,0,4,4,0
2019,446525,41,4,4,4,0
2019,446525,45,0,4,4,0
2019,446525,45,4,4,4,0
2019,446552,0,0,46,22,24
2019,446552,10,0,46,22,24
2019,446552,10,4,46,22,24
2019,446552,40,0,46,22,24
2019,446552,40,4,46,22,24
2019,446552,41,0,46,22,24
2019,446552,41,4,46,22,24
2019,446552,45,0,46,22,24
2019,446552,45,4,46,22,24
2019,446561,0,0,44,10,34
2019,446561,10,0,44,10,34
2019,446561,10,4,44,10,34
2019,446561,40,0,44,10,34
2019,446561,40,4,44,10,34
2019,446561,41,0,44,10,34
2019,446561,41,4,44,10,34
2019,446561,45,0,44,10,34
2019,446561,45,4,44,10,34
2019,446604,0,0,157,157,0
2019,446604,10,0,157,157,0
2019,446604,10,1,9,9,0
2019,446604,10,4,82,82,0
2019,446604,10,5,57,57,0
2019,446604,10,6,9,9,0
2019,446604,40,0,157,157,0
2019,446604,40,1,9,9,0
2019,446604,40,4,82,82,0
2019,446604,40,5,57,57,0
2019,446604,40,6,9,9,0
2019,446604,41,0,157,157,0
2019,446604,41,1,9,9,0
2019,446604,41,4,82,82,0
2019,446604,41,5,57,57,0
2019,446604,41,6,9,9,0
2019,446604,45,0,157,157,0
2019,446604,45,1,9,9,0
2019,446604,45,4,82,82,0
2019,446604,45,5,57,57,0
2019,446604,45,6,9,9,0
2019,446640,0,0,104,75,29
2019,446640,10,0,104,75,29
2019,446640,10,1,16,12,4
2019,446640,10,2,21,17,4
2019,446640,10,3,45,30,15
2019,446640,10,4,2,1,1
2019,446640,10,5,20,15,5
2019,446640,40,0,104,75,29
2019,446640,40,1,16,12,4
2019,446640,40,2,21,17,4
2019,446640,40,3,45,30,15
2019,446640,40,4,2,1,1
2019,446640,40,5,20,15,5
2019,446640,41,0,104,75,29
2019,446640,41,1,16,12,4
2019,446640,41,2,21,17,4
2019,446640,41,3,45,30,15
2019,446640,41,4,2,1,1
2019,446640,41,5,20,15,5
2019,446640,45,0,104,75,29
2019,446640,45,1,16,12,4
2019,446640,45,2,21,17,4
2019,446640,45,3,45,30,15
2019,446640,45,4,2,1,1
2019,446640,45,5,20,15,5
2019,446774,0,0,82,34,48
2019,446774,10,0,82,34,48
2019,446774,10,1,6,2,4
2019,446774,10,2,11,3,8
2019,446774,10,3,18,3,15
2019,446774,10,4,29,14,15
2019,446774,10,5,18,12,6
2019,446774,20,0,1,0,1
2019,446774,20,1,1,0,1
2019,446774,40,0,81,34,47
2019,446774,40,1,5,2,3
2019,446774,40,2,11,3,8
2019,446774,40,3,18,3,15
2019,446774,40,4,29,14,15
2019,446774,40,5,18,12,6
2019,446774,42,0,60,26,34
2019,446774,42,1,5,2,3
2019,446774,42,2,8,2,6
2019,446774,42,3,10,1,9
2019,446774,42,4,23,11,12
2019,446774,42,5,14,10,4
2019,446774,43,0,21,8,13
2019,446774,43,2,3,1,2
2019,446774,43,3,8,2,6
2019,446774,43,4,6,3,3
2019,446774,43,5,4,2,2
2019,447014,0,0,12,4,8
2019,447014,10,0,10,3,7
2019,447014,10,4,10,3,7
2019,447014,40,0,10,3,7
2019,447014,40,4,10,3,7
2019,447014,41,0,10,3,7
2019,447014,41,4,10,3,7
2019,447014,45,0,10,3,7
2019,447014,45,4,10,3,7
2019,447014,50,0,2,1,1
2019,447050,0,0,6,1,5
2019,447050,10,0,6,1,5
2019,447050,10,3,6,1,5
2019,447050,40,0,6,1,5
2019,447050,40,3,6,1,5
2019,447050,41,0,6,1,5
2019,447050,41,3,6,1,5
2019,447050,45,0,6,1,5
2019,447050,45,3,6,1,5
2019,447263,0,0,33,6,27
2019,447263,50,0,33,6,27
2019,447379,0,0,17,8,9
2019,447379,10,0,17,8,9
2019,447379,10,4,17,8,9
2019,447379,40,0,17,8,9
2019,447379,40,4,17,8,9
2019,447379,41,0,17,8,9
2019,447379,41,4,17,8,9
2019,447379,45,0,17,8,9
2019,447379,45,4,17,8,9
2019,447421,0,0,25,11,14
2019,447421,10,0,21,9,12
2019,447421,10,6,21,9,12
2019,447421,40,0,21,9,12
2019,447421,40,6,21,9,12
2019,447421,41,0,7,2,5
2019,447421,41,6,7,2,5
2019,447421,42,0,5,3,2
2019,447421,42,6,5,3,2
2019,447421,43,0,9,4,5
2019,447421,43,6,9,4,5
2019,447421,44,0,6,2,4
2019,447421,44,6,6,2,4
2019,447421,45,0,1,0,1
2019,447421,45,6,1,0,1
2019,447421,50,0,4,2,2
2019,447458,0,0,7,7,0
2019,447458,10,0,7,7,0
2019,447458,10,3,2,2,0
2019,447458,10,4,5,5,0
2019,447458,40,0,7,7,0
2019,447458,40,3,2,2,0
2019,447458,40,4,5,5,0
2019,447458,41,0,7,7,0
2019,447458,41,3,2,2,0
2019,447458,41,4,5,5,0
2019,447458,45,0,7,7,0
2019,447458,45,3,2,2,0
2019,447458,45,4,5,5,0
2019,447582,0,0,52,24,28
2019,447582,10,0,52,24,28
2019,447582,10,1,6,3,3
2019,447582,10,2,3,1,2
2019,447582,10,3,6,2,4
2019,447582,10,4,37,18,19
2019,447582,20,0,5,3,2
2019,447582,20,1,5,3,2
2019,447582,40,0,47,21,26
2019,447582,40,1,1,0,1
2019,447582,40,2,3,1,2
2019,447582,40,3,6,2,4
2019,447582,40,4,37,18,19
2019,447582,42,0,47,21,26
2019,447582,42,1,1,0,1
2019,447582,42,2,3,1,2
2019,447582,42,3,6,2,4
2019,447582,42,4,37,18,19
2019,447591,0,0,15,5,10
2019,447591,10,0,15,5,10
2019,447591,10,4,15,5,10
2019,447591,40,0,15,5,10
2019,447591,40,4,15,5,10
2019,447591,41,0,15,5,10
2019,447591,41,4,15,5,10
2019,447591,45,0,15,5,10
2019,447591,45,4,15,5,10
2019,447689,0,0,454,216,238
2019,447689,10,0,454,216,238
2019,447689,10,1,50,31,19
2019,447689,10,2,173,84,89
2019,447689,10,3,175,85,90
2019,447689,10,4,31,5,26
2019,447689,10,5,25,11,14
2019,447689,40,0,454,216,238
2019,447689,40,1,50,31,19
2019,447689,40,2,173,84,89
2019,447689,40,3,175,85,90
2019,447689,40,4,31,5,26
2019,447689,40,5,25,11,14
2019,447689,42,0,454,216,238
2019,447689,42,1,50,31,19
2019,447689,42,2,173,84,89
2019,447689,42,3,175,85,90
2019,447689,42,4,31,5,26
2019,447689,42,5,25,11,14
2019,447759,0,0,3,2,1
2019,447759,10,0,3,2,1
2019,447759,10,4,3,2,1
2019,447759,40,0,3,2,1
2019,447759,40,4,3,2,1
2019,447759,41,0,3,2,1
2019,447759,41,4,3,2,1
2019,447759,45,0,3,2,1
2019,447759,45,4,3,2,1
2019,447768,0,0,25,9,16
2019,447768,50,0,25,9,16
2019,447777,0,0,23,14,9
2019,447777,50,0,23,14,9
2019,447847,0,0,63,54,9
2019,447847,10,0,62,54,8
2019,447847,10,1,8,6,2
2019,447847,10,4,54,48,6
2019,447847,40,0,62,54,8
2019,447847,40,1,8,6,2
2019,447847,40,4,54,48,6
2019,447847,41,0,62,54,8
2019,447847,41,1,8,6,2
2019,447847,41,4,54,48,6
2019,447847,45,0,62,54,8
2019,447847,45,1,8,6,2
2019,447847,45,4,54,48,6
2019,447847,50,0,1,0,1
2019,447935,0,0,10,2,8
2019,447935,10,0,10,2,8
2019,447935,10,4,10,2,8
2019,447935,40,0,10,2,8
2019,447935,40,4,10,2,8
2019,447935,41,0,10,2,8
2019,447935,41,4,10,2,8
2019,447935,45,0,10,2,8
2019,447935,45,4,10,2,8
2019,447953,0,0,8,7,1
2019,447953,10,0,8,7,1
2019,447953,10,6,8,7,1
2019,447953,40,0,8,7,1
2019,447953,40,6,8,7,1
2019,447953,43,0,8,7,1
2019,447953,43,6,8,7,1
2019,447999,0,0,3,0,3
2019,447999,10,0,3,0,3
2019,447999,10,4,3,0,3
2019,447999,40,0,3,0,3
2019,447999,40,4,3,0,3
2019,447999,41,0,3,0,3
2019,447999,41,4,3,0,3
2019,447999,45,0,3,0,3
2019,447999,45,4,3,0,3
2019,448354,0,0,6,2,4
2019,448354,10,0,6,2,4
2019,448354,10,4,6,2,4
2019,448354,40,0,6,2,4
2019,448354,40,4,6,2,4
2019,448354,42,0,6,2,4
2019,448354,42,4,6,2,4
2019,448433,0,0,35,35,0
2019,448433,50,0,35,35,0
2019,448594,0,0,38,20,18
2019,448594,10,0,38,20,18
2019,448594,10,4,38,20,18
2019,448594,20,0,28,16,12
2019,448594,20,4,28,16,12
2019,448594,30,0,8,3,5
2019,448594,30,4,8,3,5
2019,448594,40,0,2,1,1
2019,448594,40,4,2,1,1
2019,448594,42,0,2,1,1
2019,448594,42,4,2,1,1
2019,448600,0,0,11,1,10
2019,448600,10,0,11,1,10
2019,448600,10,6,11,1,10
2019,448600,40,0,11,1,10
2019,448600,40,6,11,1,10
2019,448600,41,0,11,1,10
2019,448600,41,6,11,1,10
2019,448600,45,0,11,1,10
2019,448600,45,6,11,1,10
2019,448673,0,0,42,8,34
2019,448673,10,0,42,8,34
2019,448673,10,4,42,8,34
2019,448673,40,0,42,8,34
2019,448673,40,4,42,8,34
2019,448673,41,0,42,8,34
2019,448673,41,4,42,8,34
2019,448673,45,0,42,8,34
2019,448673,45,4,42,8,34
2019,448691,0,0,6,0,6
2019,448691,10,0,6,0,6
2019,448691,10,1,1,0,1
2019,448691,10,3,3,0,3
2019,448691,10,5,2,0,2
2019,448691,40,0,6,0,6
2019,448691,40,1,1,0,1
2019,448691,40,3,3,0,3
2019,448691,40,5,2,0,2
2019,448691,41,0,6,0,6
2019,448691,41,1,1,0,1
2019,448691,41,3,3,0,3
2019,448691,41,5,2,0,2
2019,448691,45,0,6,0,6
2019,448691,45,1,1,0,1
2019,448691,45,3,3,0,3
2019,448691,45,5,2,0,2
2019,448840,0,0,142,72,70
2019,448840,10,0,142,72,70
2019,448840,10,1,35,25,10
2019,448840,10,2,42,20,22
2019,448840,10,3,26,11,15
2019,448840,10,4,39,16,23
2019,448840,20,0,72,42,30
2019,448840,20,1,35,25,10
2019,448840,20,2,37,17,20
2019,448840,30,0,31,13,18
2019,448840,30,2,5,3,2
2019,448840,30,3,23,9,14
2019,448840,30,4,3,1,2
2019,448840,40,0,39,17,22
2019,448840,40,3,3,2,1
2019,448840,40,4,36,15,21
2019,448840,42,0,39,17,22
2019,448840,42,3,3,2,1
2019,448840,42,4,36,15,21
2019,448859,0,0,13,12,1
2019,448859,10,0,13,12,1
2019,448859,10,4,13,12,1
2019,448859,40,0,13,12,1
2019,448859,40,4,13,12,1
2019,448859,41,0,13,12,1
2019,448859,41,4,13,12,1
2019,448859,45,0,13,12,1
2019,448859,45,4,13,12,1
2019,448886,0,0,606,224,382
2019,448886,10,0,606,224,382
2019,448886,10,1,154,77,77
2019,448886,10,2,116,37,79
2019,448886,10,3,120,38,82
2019,448886,10,4,87,32,55
2019,448886,10,5,128,39,89
2019,448886,10,6,1,1,0
2019,448886,20,0,167,85,82
2019,448886,20,1,88,55,33
2019,448886,20,2,79,30,49
2019,448886,30,0,67,27,40
2019,448886,30,2,6,3,3
2019,448886,30,3,61,24,37
2019,448886,40,0,372,112,260
2019,448886,40,1,66,22,44
2019,448886,40,2,31,4,27
2019,448886,40,3,59,14,45
2019,448886,40,4,87,32,55
2019,448886,40,5,128,39,89
2019,448886,40,6,1,1,0
2019,448886,41,0,35,14,21
2019,448886,41,1,10,4,6
2019,448886,41,2,3,2,1
2019,448886,41,3,3,2,1
2019,448886,41,5,19,6,13
2019,448886,42,0,337,98,239
2019,448886,42,1,56,18,38
2019,448886,42,2,28,2,26
2019,448886,42,3,56,12,44
2019,448886,42,4,87,32,55
2019,448886,42,5,109,33,76
2019,448886,42,6,1,1,0
2019,448886,44,0,35,14,21
2019,448886,44,1,10,4,6
2019,448886,44,2,3,2,1
2019,448886,44,3,3,2,1
2019,448886,44,5,19,6,13
2019,449038,0,0,5,1,4
2019,449038,10,0,5,1,4
2019,449038,10,6,5,1,4
2019,449038,40,0,5,1,4
2019,449038,40,6,5,1,4
2019,449038,41,0,5,1,4
2019,449038,41,6,5,1,4
2019,449038,45,0,5,1,4
2019,449038,45,6,5,1,4
2019,449074,0,0,21,5,16
2019,449074,10,0,21,5,16
2019,449074,10,4,21,5,16
2019,449074,40,0,21,5,16
2019,449074,40,4,21,5,16
2019,449074,41,0,21,5,16
2019,449074,41,4,21,5,16
2019,449074,45,0,21,5,16
2019,449074,45,4,21,5,16
2019,449135,0,0,12,5,7
2019,449135,10,0,12,5,7
2019,449135,10,1,12,5,7
2019,449135,40,0,12,5,7
2019,449135,40,1,12,5,7
2019,449135,41,0,12,5,7
2019,449135,41,1,12,5,7
2019,449135,44,0,12,5,7
2019,449135,44,1,12,5,7
2019,449250,0,0,25,13,12
2019,449250,10,0,25,13,12
2019,449250,10,4,25,13,12
2019,449250,40,0,25,13,12
2019,449250,40,4,25,13,12
2019,449250,41,0,25,13,12
2019,449250,41,4,25,13,12
2019,449250,45,0,25,13,12
2019,449250,45,4,25,13,12
2019,449339,0,0,344,158,186
2019,449339,10,0,344,158,186
2019,449339,10,1,44,19,25
2019,449339,10,2,148,76,72
2019,449339,10,3,61,20,41
2019,449339,10,4,91,43,48
2019,449339,40,0,344,158,186
2019,449339,40,1,44,19,25
2019,449339,40,2,148,76,72
2019,449339,40,3,61,20,41
2019,449339,40,4,91,43,48
2019,449339,41,0,344,158,186
2019,449339,41,1,44,19,25
2019,449339,41,2,148,76,72
2019,449339,41,3,61,20,41
2019,449339,41,4,91,43,48
2019,449339,45,0,344,158,186
2019,449339,45,1,44,19,25
2019,449339,45,2,148,76,72
2019,449339,45,3,61,20,41
2019,449339,45,4,91,43,48
2019,449384,0,0,1,1,0
2019,449384,10,0,1,1,0
2019,449384,10,4,1,1,0
2019,449384,40,0,1,1,0
2019,449384,40,4,1,1,0
2019,449384,43,0,1,1,0
2019,449384,43,4,1,1,0
2019,449506,0,0,4,0,4
2019,449506,10,0,2,0,2
2019,449506,10,4,2,0,2
2019,449506,40,0,2,0,2
2019,449506,40,4,2,0,2
2019,449506,41,0,2,0,2
2019,449506,41,4,2,0,2
2019,449506,44,0,2,0,2
2019,449506,44,4,2,0,2
2019,449506,50,0,2,0,2
2019,449524,0,0,9,2,7
2019,449524,10,0,9,2,7
2019,449524,10,4,9,2,7
2019,449524,40,0,9,2,7
2019,449524,40,4,9,2,7
2019,449524,42,0,9,2,7
2019,449524,42,4,9,2,7
2019,449612,0,0,6,5,1
2019,449612,50,0,6,5,1
2019,449764,0,0,10,8,2
2019,449764,10,0,10,8,2
2019,449764,10,1,4,4,0
2019,449764,10,2,2,1,1
2019,449764,10,3,3,2,1
2019,449764,10,4,1,1,0
2019,449764,40,0,10,8,2
2019,449764,40,1,4,4,0
2019,449764,40,2,2,1,1
2019,449764,40,3,3,2,1
2019,449764,40,4,1,1,0
2019,449764,41,0,7,7,0
2019,449764,41,1,4,4,0
2019,449764,41,2,1,1,0
2019,449764,41,3,2,2,0
2019,449764,43,0,3,1,2
2019,449764,43,2,1,0,1
2019,449764,43,3,1,0,1
2019,449764,43,4,1,1,0
2019,449764,45,0,7,7,0
2019,449764,45,1,4,4,0
2019,449764,45,2,1,1,0
2019,449764,45,3,2,2,0
2019,449861,0,0,10,2,8
2019,449861,10,0,10,2,8
2019,449861,10,4,10,2,8
2019,449861,40,0,10,2,8
2019,449861,40,4,10,2,8
2019,449861,41,0,10,2,8
2019,449861,41,4,10,2,8
2019,449861,45,0,10,2,8
2019,449861,45,4,10,2,8
2019,449870,0,0,16,9,7
2019,449870,10,0,16,9,7
2019,449870,10,1,5,4,1
2019,449870,10,2,2,1,1
2019,449870,10,3,7,3,4
2019,449870,10,4,2,1,1
2019,449870,20,0,7,5,2
2019,449870,20,1,5,4,1
2019,449870,20,2,2,1,1
2019,449870,30,0,4,2,2
2019,449870,30,3,4,2,2
2019,449870,40,0,5,2,3
2019,449870,40,3,3,1,2
2019,449870,40,4,2,1,1
2019,449870,42,0,5,2,3
2019,449870,42,3,3,1,2
2019,449870,42,4,2,1,1
2019,449889,0,0,80,26,54
2019,449889,10,0,80,26,54
2019,449889,10,4,80,26,54
2019,449889,40,0,80,26,54
2019,449889,40,4,80,26,54
2019,449889,41,0,80,26,54
2019,449889,41,4,80,26,54
2019,449889,45,0,80,26,54
2019,449889,45,4,80,26,54
2019,449898,0,0,24,4,20
2019,449898,10,0,24,4,20
2019,449898,10,2,1,0,1
2019,449898,10,3,19,4,15
2019,449898,10,4,4,0,4
2019,449898,40,0,24,4,20
2019,449898,40,2,1,0,1
2019,449898,40,3,19,4,15
2019,449898,40,4,4,0,4
2019,449898,41,0,24,4,20
2019,449898,41,2,1,0,1
2019,449898,41,3,19,4,15
2019,449898,41,4,4,0,4
2019,449898,45,0,24,4,20
2019,449898,45,2,1,0,1
2019,449898,45,3,19,4,15
2019,449898,45,4,4,0,4
2019,449922,0,0,26,17,9
2019,449922,10,0,26,17,9
2019,449922,10,1,1,1,0
2019,449922,10,2,4,3,1
2019,449922,10,3,16,10,6
2019,449922,10,4,5,3,2
2019,449922,40,0,26,17,9
2019,449922,40,1,1,1,0
2019,449922,40,2,4,3,1
2019,449922,40,3,16,10,6
2019,449922,40,4,5,3,2
2019,449922,41,0,9,8,1
2019,449922,41,1,1,1,0
2019,449922,41,2,2,2,0
2019,449922,41,3,4,4,0
2019,449922,41,4,2,1,1
2019,449922,42,0,16,8,8
2019,449922,42,2,2,1,1
2019,449922,42,3,11,5,6
2019,449922,42,4,3,2,1
2019,449922,43,0,1,1,0
2019,449922,43,3,1,1,0
2019,449922,44,0,9,8,1
2019,449922,44,1,1,1,0
2019,449922,44,2,2,2,0
2019,449922,44,3,4,4,0
2019,449922,44,4,2,1,1
2019,449931,0,0,2,2,0
2019,449931,10,0,2,2,0
2019,449931,10,2,2,2,0
2019,449931,40,0,2,2,0
2019,449931,40,2,2,2,0
2019,449931,41,0,2,2,0
2019,449931,41,2,2,2,0
2019,449931,44,0,2,2,0
2019,449931,44,2,2,2,0
2019,450058,0,0,39,13,26
2019,450058,10,0,39,13,26
2019,450058,10,4,39,13,26
2019,450058,40,0,39,13,26
2019,450058,40,4,39,13,26
2019,450058,41,0,39,13,26
2019,450058,41,4,39,13,26
2019,450058,45,0,39,13,26
2019,450058,45,4,39,13,26
2019,450067,0,0,16,4,12
2019,450067,10,0,16,4,12
2019,450067,10,4,16,4,12
2019,450067,40,0,16,4,12
2019,450067,40,4,16,4,12
2019,450067,41,0,16,4,12
2019,450067,41,4,16,4,12
2019,450067,45,0,16,4,12
2019,450067,45,4,16,4,12
2019,450128,0,0,11,0,11
2019,450128,10,0,11,0,11
2019,450128,10,4,11,0,11
2019,450128,40,0,11,0,11
2019,450128,40,4,11,0,11
2019,450128,42,0,11,0,11
2019,450128,42,4,11,0,11
2019,450304,0,0,16,9,7
2019,450304,10,0,16,9,7
2019,450304,10,1,6,2,4
2019,450304,10,2,7,6,1
2019,450304,10,3,3,1,2
2019,450304,20,0,13,8,5
2019,450304,20,1,6,2,4
2019,450304,20,2,7,6,1
2019,450304,30,0,3,1,2
2019,450304,30,3,3,1,2
2019,450377,0,0,2,1,1
2019,450377,10,0,2,1,1
2019,450377,10,1,2,1,1
2019,450377,40,0,2,1,1
2019,450377,40,1,2,1,1
2019,450377,41,0,2,1,1
2019,450377,41,1,2,1,1
2019,450377,45,0,2,1,1
2019,450377,45,1,2,1,1
2019,450571,0,0,17,4,13
2019,450571,10,0,17,4,13
2019,450571,10,4,17,4,13
2019,450571,40,0,17,4,13
2019,450571,40,4,17,4,13
2019,450571,41,0,17,4,13
2019,450571,41,4,17,4,13
2019,450571,45,0,17,4,13
2019,450571,45,4,17,4,13
2019,450933,0,0,279,165,114
2019,450933,10,0,279,165,114
2019,450933,10,4,279,165,114
2019,450933,40,0,279,165,114
2019,450933,40,4,279,165,114
2019,450933,41,0,279,165,114
2019,450933,41,4,279,165,114
2019,450933,45,0,279,165,114
2019,450933,45,4,279,165,114
2019,450960,0,0,6,3,3
2019,450960,10,0,6,3,3
2019,450960,10,4,6,3,3
2019,450960,40,0,6,3,3
2019,450960,40,4,6,3,3
2019,450960,41,0,6,3,3
2019,450960,41,4,6,3,3
2019,450960,45,0,6,3,3
2019,450960,45,4,6,3,3
2019,450979,0,0,40,19,21
2019,450979,10,0,40,19,21
2019,450979,10,6,40,19,21
2019,450979,40,0,40,19,21
2019,450979,40,6,40,19,21
2019,450979,41,0,25,11,14
2019,450979,41,6,25,11,14
2019,450979,42,0,3,1,2
2019,450979,42,6,3,1,2
2019,450979,43,0,12,7,5
2019,450979,43,6,12,7,5
2019,450979,44,0,25,11,14
2019,450979,44,6,25,11,14
2019,451103,0,0,54,23,31
2019,451103,10,0,54,23,31
2019,451103,10,1,1,0,1
2019,451103,10,2,6,1,5
2019,451103,10,3,45,21,24
2019,451103,10,4,2,1,1
2019,451103,40,0,54,23,31
2019,451103,40,1,1,0,1
2019,451103,40,2,6,1,5
2019,451103,40,3,45,21,24
2019,451103,40,4,2,1,1
2019,451103,41,0,54,23,31
2019,451103,41,1,1,0,1
2019,451103,41,2,6,1,5
2019,451103,41,3,45,21,24
2019,451103,41,4,2,1,1
2019,451103,45,0,54,23,31
2019,451103,45,1,1,0,1
2019,451103,45,2,6,1,5
2019,451103,45,3,45,21,24
2019,451103,45,4,2,1,1
2019,451398,0,0,7,7,0
2019,451398,10,0,7,7,0
2019,451398,10,4,7,7,0
2019,451398,40,0,7,7,0
2019,451398,40,4,7,7,0
2019,451398,42,0,7,7,0
2019,451398,42,4,7,7,0
2019,451404,0,0,31,31,0
2019,451404,10,0,31,31,0
2019,451404,10,4,31,31,0
2019,451404,40,0,31,31,0
2019,451404,40,4,31,31,0
2019,451404,42,0,31,31,0
2019,451404,42,4,31,31,0
2019,451477,0,0,53,43,10
2019,451477,50,0,53,43,10
2019,451510,0,0,23,11,12
2019,451510,10,0,23,11,12
2019,451510,10,1,10,5,5
2019,451510,10,2,8,3,5
2019,451510,10,3,3,2,1
2019,451510,10,4,2,1,1
2019,451510,20,0,13,5,8
2019,451510,20,1,8,4,4
2019,451510,20,2,5,1,4
2019,451510,30,0,2,1,1
2019,451510,30,2,2,1,1
2019,451510,40,0,8,5,3
2019,451510,40,1,2,1,1
2019,451510,40,2,1,1,0
2019,451510,40,3,3,2,1
2019,451510,40,4,2,1,1
2019,451510,41,0,1,1,0
2019,451510,41,1,1,1,0
2019,451510,42,0,6,3,3
2019,451510,42,1,1,0,1
2019,451510,42,2,1,1,0
2019,451510,42,3,3,2,1
2019,451510,42,4,1,0,1
2019,451510,43,0,1,1,0
2019,451510,43,4,1,1,0
2019,451510,44,0,1,1,0
2019,451510,44,1,1,1,0
2019,451556,0,0,71,41,30
2019,451556,10,0,71,41,30
2019,451556,10,6,71,41,30
2019,451556,40,0,71,41,30
2019,451556,40,6,71,41,30
2019,451556,41,0,71,41,30
2019,451556,41,6,71,41,30
2019,451556,45,0,71,41,30
2019,451556,45,6,71,41,30
2019,451671,0,0,90,47,43
2019,451671,10,0,90,47,43
2019,451671,10,1,13,7,6
2019,451671,10,2,18,9,9
2019,451671,10,3,14,7,7
2019,451671,10,4,43,22,21
2019,451671,10,6,2,2,0
2019,451671,20,0,31,16,15
2019,451671,20,1,13,7,6
2019,451671,20,2,18,9,9
2019,451671,30,0,12,6,6
2019,451671,30,3,12,6,6
2019,451671,40,0,47,25,22
2019,451671,40,3,2,1,1
2019,451671,40,4,43,22,21
2019,451671,40,6,2,2,0
2019,451671,42,0,45,23,22
2019,451671,42,3,2,1,1
2019,451671,42,4,43,22,21
2019,451671,43,0,2,2,0
2019,451671,43,6,2,2,0
2019,451741,0,0,2,1,1
2019,451741,10,0,2,1,1
2019,451741,10,1,2,1,1
2019,451741,20,0,2,1,1
2019,451741,20,1,2,1,1
2019,451750,0,0,51,13,38
2019,451750,10,0,51,13,38
2019,451750,10,4,51,13,38
2019,451750,40,0,51,13,38
2019,451750,40,4,51,13,38
2019,451750,41,0,51,13,38
2019,451750,41,4,51,13,38
2019,451750,45,0,51,13,38
2019,451750,45,4,51,13,38
2019,451820,0,0,2,2,0
2019,451820,10,0,2,2,0
2019,451820,10,4,2,2,0
2019,451820,40,0,2,2,0
2019,451820,40,4,2,2,0
2019,451820,41,0,2,2,0
2019,451820,41,4,2,2,0
2019,451820,45,0,2,2,0
2019,451820,45,4,2,2,0
2019,451857,0,0,22,6,16
2019,451857,50,0,22,6,16
2019,451866,0,0,17,8,9
2019,451866,50,0,17,8,9
2019,451927,0,0,19,14,5
2019,451927,10,0,19,14,5
2019,451927,10,1,6,6,0
2019,451927,10,2,7,6,1
2019,451927,10,3,6,2,4
2019,451927,40,0,19,14,5
2019,451927,40,1,6,6,0
2019,451927,40,2,7,6,1
2019,451927,40,3,6,2,4
2019,451927,41,0,13,12,1
2019,451927,41,1,6,6,0
2019,451927,41,2,7,6,1
2019,451927,42,0,6,2,4
2019,451927,42,3,6,2,4
2019,451927,44,0,13,12,1
2019,451927,44,1,6,6,0
2019,451927,44,2,7,6,1
2019,452081,0,0,7,1,6
2019,452081,50,0,7,1,6
2019,452124,0,0,15,2,13
2019,452124,10,0,15,2,13
2019,452124,10,4,15,2,13
2019,452124,40,0,15,2,13
2019,452124,40,4,15,2,13
2019,452124,41,0,15,2,13
2019,452124,41,4,15,2,13
2019,452124,45,0,15,2,13
2019,452124,45,4,15,2,13
2019,452373,0,0,7,0,7
2019,452373,10,0,7,0,7
2019,452373,10,4,7,0,7
2019,452373,40,0,7,0,7
2019,452373,40,4,7,0,7
2019,452373,41,0,7,0,7
2019,452373,41,4,7,0,7
2019,452373,45,0,7,0,7
2019,452373,45,4,7,0,7
2019,452948,0,0,22,3,19
2019,452948,10,0,22,3,19
2019,452948,10,2,1,1,0
2019,452948,10,3,4,0,4
2019,452948,10,4,17,2,15
2019,452948,40,0,22,3,19
2019,452948,40,2,1,1,0
2019,452948,40,3,4,0,4
2019,452948,40,4,17,2,15
2019,452948,41,0,22,3,19
2019,452948,41,2,1,1,0
2019,452948,41,3,4,0,4
2019,452948,41,4,17,2,15
2019,452948,45,0,22,3,19
2019,452948,45,2,1,1,0
2019,452948,45,3,4,0,4
2019,452948,45,4,17,2,15
2019,453163,0,0,6,3,3
2019,453163,10,0,6,3,3
2019,453163,10,6,6,3,3
2019,453163,40,0,6,3,3
2019,453163,40,6,6,3,3
2019,453163,41,0,6,3,3
2019,453163,41,6,6,3,3
2019,453163,45,0,6,3,3
2019,453163,45,6,6,3,3
2019,453215,0,0,1,1,0
2019,453215,10,0,1,1,0
2019,453215,10,6,1,1,0
2019,453215,40,0,1,1,0
2019,453215,40,6,1,1,0
2019,453215,41,0,1,1,0
2019,453215,41,6,1,1,0
2019,453215,45,0,1,1,0
2019,453215,45,6,1,1,0
2019,454184,0,0,31,24,7
2019,454184,10,0,31,24,7
2019,454184,10,1,4,3,1
2019,454184,10,2,13,10,3
2019,454184,10,3,12,10,2
2019,454184,10,4,2,1,1
2019,454184,40,0,31,24,7
2019,454184,40,1,4,3,1
2019,454184,40,2,13,10,3
2019,454184,40,3,12,10,2
2019,454184,40,4,2,1,1
2019,454184,41,0,28,22,6
2019,454184,41,1,4,3,1
2019,454184,41,2,13,10,3
2019,454184,41,3,11,9,2
2019,454184,42,0,3,2,1
2019,454184,42,3,1,1,0
2019,454184,42,4,2,1,1
2019,454184,44,0,28,22,6
2019,454184,44,1,4,3,1
2019,454184,44,2,13,10,3
2019,454184,44,3,11,9,2
2019,454227,0,0,120,17,103
2019,454227,10,0,120,17,103
2019,454227,10,1,13,3,10
2019,454227,10,2,34,6,28
2019,454227,10,3,28,3,25
2019,454227,10,4,45,5,40
2019,454227,40,0,120,17,103
2019,454227,40,1,13,3,10
2019,454227,40,2,34,6,28
2019,454227,40,3,28,3,25
2019,454227,40,4,45,5,40
2019,454227,41,0,120,17,103
2019,454227,41,1,13,3,10
2019,454227,41,2,34,6,28
2019,454227,41,3,28,3,25
2019,454227,41,4,45,5,40
2019,454227,45,0,120,17,103
2019,454227,45,1,13,3,10
2019,454227,45,2,34,6,28
2019,454227,45,3,28,3,25
2019,454227,45,4,45,5,40
2019,454236,0,0,18,1,17
2019,454236,10,0,18,1,17
2019,454236,10,2,3,0,3
2019,454236,10,3,7,1,6
2019,454236,10,4,8,0,8
2019,454236,40,0,18,1,17
2019,454236,40,2,3,0,3
2019,454236,40,3,7,1,6
2019,454236,40,4,8,0,8
2019,454236,41,0,18,1,17
2019,454236,41,2,3,0,3
2019,454236,41,3,7,1,6
2019,454236,41,4,8,0,8
2019,454236,45,0,18,1,17
2019,454236,45,2,3,0,3
2019,454236,45,3,7,1,6
2019,454236,45,4,8,0,8
2019,454245,0,0,17,1,16
2019,454245,10,0,17,1,16
2019,454245,10,1,1,0,1
2019,454245,10,2,1,0,1
2019,454245,10,3,8,0,8
2019,454245,10,4,7,1,6
2019,454245,40,0,17,1,16
2019,454245,40,1,1,0,1
2019,454245,40,2,1,0,1
2019,454245,40,3,8,0,8
2019,454245,40,4,7,1,6
2019,454245,41,0,17,1,16
2019,454245,41,1,1,0,1
2019,454245,41,2,1,0,1
2019,454245,41,3,8,0,8
2019,454245,41,4,7,1,6
2019,454245,45,0,17,1,16
2019,454245,45,1,1,0,1
2019,454245,45,2,1,0,1
2019,454245,45,3,8,0,8
2019,454245,45,4,7,1,6
2019,454616,0,0,6,6,0
2019,454616,50,0,6,6,0
2019,454698,0,0,17,8,9
2019,454698,10,0,17,8,9
2019,454698,10,4,17,8,9
2019,454698,40,0,17,8,9
2019,454698,40,4,17,8,9
2019,454698,41,0,17,8,9
2019,454698,41,4,17,8,9
2019,454698,44,0,17,8,9
2019,454698,44,4,17,8,9
2019,454786,0,0,34,19,15
2019,454786,10,0,34,19,15
2019,454786,10,4,34,19,15
2019,454786,40,0,34,19,15
2019,454786,40,4,34,19,15
2019,454786,41,0,34,19,15
2019,454786,41,4,34,19,15
2019,454786,45,0,34,19,15
2019,454786,45,4,34,19,15
2019,454810,0,0,70,26,44
2019,454810,10,0,41,19,22
2019,454810,10,4,41,19,22
2019,454810,40,0,41,19,22
2019,454810,40,4,41,19,22
2019,454810,41,0,41,19,22
2019,454810,41,4,41,19,22
2019,454810,45,0,41,19,22
2019,454810,45,4,41,19,22
2019,454810,50,0,29,7,22
2019,454829,0,0,29,3,26
2019,454829,10,0,29,3,26
2019,454829,10,6,29,3,26
2019,454829,40,0,29,3,26
2019,454829,40,6,29,3,26
2019,454829,41,0,29,3,26
2019,454829,41,6,29,3,26
2019,454829,45,0,29,3,26
2019,454829,45,6,29,3,26
2019,454856,0,0,23,4,19
2019,454856,10,0,23,4,19
2019,454856,10,4,23,4,19
2019,454856,40,0,23,4,19
2019,454856,40,4,23,4,19
2019,454856,41,0,23,4,19
2019,454856,41,4,23,4,19
2019,454856,45,0,23,4,19
2019,454856,45,4,23,4,19
2019,454865,0,0,20,6,14
2019,454865,50,0,20,6,14
2019,455114,0,0,156,84,72
2019,455114,10,0,156,84,72
2019,455114,10,2,34,12,22
2019,455114,10,3,48,28,20
2019,455114,10,4,66,43,23
2019,455114,10,6,8,1,7
2019,455114,40,0,156,84,72
2019,455114,40,2,34,12,22
2019,455114,40,3,48,28,20
2019,455114,40,4,66,43,23
2019,455114,40,6,8,1,7
2019,455114,42,0,156,84,72
2019,455114,42,2,34,12,22
2019,455114,42,3,48,28,20
2019,455114,42,4,66,43,23
2019,455114,42,6,8,1,7
2019,455196,0,0,106,14,92
2019,455196,10,0,106,14,92
2019,455196,10,4,106,14,92
2019,455196,40,0,106,14,92
2019,455196,40,4,106,14,92
2019,455196,41,0,106,14,92
2019,455196,41,4,106,14,92
2019,455196,45,0,106,14,92
2019,455196,45,4,106,14,92
2019,455336,0,0,6,5,1
2019,455336,10,0,6,5,1
2019,455336,10,4,6,5,1
2019,455336,40,0,6,5,1
2019,455336,40,4,6,5,1
2019,455336,41,0,6,5,1
2019,455336,41,4,6,5,1
2019,455336,45,0,6,5,1
2019,455336,45,4,6,5,1
2019,455406,0,0,26,16,10
2019,455406,10,0,26,16,10
2019,455406,10,1,4,3,1
2019,455406,10,2,10,6,4
2019,455406,10,3,12,7,5
2019,455406,40,0,26,16,10
2019,455406,40,1,4,3,1
2019,455406,40,2,10,6,4
2019,455406,40,3,12,7,5
2019,455406,41,0,26,16,10
2019,455406,41,1,4,3,1
2019,455406,41,2,10,6,4
2019,455406,41,3,12,7,5
2019,455406,44,0,26,16,10
2019,455406,44,1,4,3,1
2019,455406,44,2,10,6,4
2019,455406,44,3,12,7,5
2019,455433,0,0,17,8,9
2019,455433,10,0,17,8,9
2019,455433,10,1,5,3,2
2019,455433,10,2,6,2,4
2019,455433,10,3,6,3,3
2019,455433,40,0,17,8,9
2019,455433,40,1,5,3,2
2019,455433,40,2,6,2,4
2019,455433,40,3,6,3,3
2019,455433,41,0,17,8,9
2019,455433,41,1,5,3,2
2019,455433,41,2,6,2,4
2019,455433,41,3,6,3,3
2019,455433,44,0,17,8,9
2019,455433,44,1,5,3,2
2019,455433,44,2,6,2,4
2019,455433,44,3,6,3,3
2019,455479,0,0,20,3,17
2019,455479,10,0,20,3,17
2019,455479,10,4,20,3,17
2019,455479,40,0,20,3,17
2019,455479,40,4,20,3,17
2019,455479,41,0,20,3,17
2019,455479,41,4,20,3,17
2019,455479,45,0,20,3,17
2019,455479,45,4,20,3,17
2019,455512,0,0,48,17,31
2019,455512,10,0,48,17,31
2019,455512,10,4,48,17,31
2019,455512,20,0,32,14,18
2019,455512,20,4,32,14,18
2019,455512,30,0,10,3,7
2019,455512,30,4,10,3,7
2019,455512,40,0,6,0,6
2019,455512,40,4,6,0,6
2019,455512,42,0,6,0,6
2019,455512,42,4,6,0,6
2019,455628,0,0,12,3,9
2019,455628,10,0,12,3,9
2019,455628,10,4,12,3,9
2019,455628,40,0,12,3,9
2019,455628,40,4,12,3,9
2019,455628,41,0,12,3,9
2019,455628,41,4,12,3,9
2019,455628,45,0,12,3,9
2019,455628,45,4,12,3,9
2019,455664,0,0,29,19,10
2019,455664,10,0,29,19,10
2019,455664,10,1,7,7,0
2019,455664,10,2,15,9,6
2019,455664,10,3,7,3,4
2019,455664,40,0,29,19,10
2019,455664,40,1,7,7,0
2019,455664,40,2,15,9,6
2019,455664,40,3,7,3,4
2019,455664,41,0,25,17,8
2019,455664,41,1,5,5,0
2019,455664,41,2,13,9,4
2019,455664,41,3,7,3,4
2019,455664,42,0,4,2,2
2019,455664,42,1,2,2,0
2019,455664,42,2,2,0,2
2019,455664,44,0,25,17,8
2019,455664,44,1,5,5,0
2019,455664,44,2,13,9,4
2019,455664,44,3,7,3,4
2019,455770,0,0,3,3,0
2019,455770,10,0,3,3,0
2019,455770,10,1,1,1,0
2019,455770,10,2,1,1,0
2019,455770,10,4,1,1,0
2019,455770,40,0,3,3,0
2019,455770,40,1,1,1,0
2019,455770,40,2,1,1,0
2019,455770,40,4,1,1,0
2019,455770,42,0,3,3,0
2019,455770,42,1,1,1,0
2019,455770,42,2,1,1,0
2019,455770,42,4,1,1,0
2019,455804,0,0,41,31,10
2019,455804,10,0,41,31,10
2019,455804,10,1,41,31,10
2019,455804,40,0,41,31,10
2019,455804,40,1,41,31,10
2019,455804,41,0,9,9,0
2019,455804,41,1,9,9,0
2019,455804,42,0,32,22,10
2019,455804,42,1,32,22,10
2019,455804,45,0,9,9,0
2019,455804,45,1,9,9,0
2019,455868,0,0,8,1,7
2019,455868,10,0,4,0,4
2019,455868,10,4,4,0,4
2019,455868,40,0,4,0,4
2019,455868,40,4,4,0,4
2019,455868,41,0,4,0,4
2019,455868,41,4,4,0,4
2019,455868,45,0,4,0,4
2019,455868,45,4,4,0,4
2019,455868,50,0,4,1,3
2019,455983,0,0,1,0,1
2019,455983,10,0,1,0,1
2019,455983,10,4,1,0,1
2019,455983,40,0,1,0,1
2019,455983,40,4,1,0,1
2019,455983,41,0,1,0,1
2019,455983,41,4,1,0,1
2019,455983,45,0,1,0,1
2019,455983,45,4,1,0,1
2019,456038,0,0,11,0,11
2019,456038,10,0,11,0,11
2019,456038,10,4,11,0,11
2019,456038,40,0,11,0,11
2019,456038,40,4,11,0,11
2019,456038,41,0,11,0,11
2019,456038,41,4,11,0,11
2019,456038,45,0,11,0,11
2019,456038,45,4,11,0,11
2019,456205,0,0,6,3,3
2019,456205,10,0,6,3,3
2019,456205,10,4,6,3,3
2019,456205,40,0,6,3,3
2019,456205,40,4,6,3,3
2019,456205,41,0,6,3,3
2019,456205,41,4,6,3,3
2019,456205,45,0,6,3,3
2019,456205,45,4,6,3,3
2019,456454,0,0,15,4,11
2019,456454,50,0,15,4,11
2019,456490,0,0,8,7,1
2019,456490,10,0,8,7,1
2019,456490,10,1,1,0,1
2019,456490,10,2,7,7,0
2019,456490,40,0,8,7,1
2019,456490,40,1,1,0,1
2019,456490,40,2,7,7,0
2019,456490,42,0,8,7,1
2019,456490,42,1,1,0,1
2019,456490,42,2,7,7,0
2019,456542,0,0,35,22,13
2019,456542,10,0,35,22,13
2019,456542,10,1,11,6,5
2019,456542,10,2,9,6,3
2019,456542,10,3,7,5,2
2019,456542,10,4,2,0,2
2019,456542,10,6,6,5,1
2019,456542,20,0,3,1,2
2019,456542,20,1,3,1,2
2019,456542,30,0,24,16,8
2019,456542,30,1,8,5,3
2019,456542,30,2,9,6,3
2019,456542,30,3,7,5,2
2019,456542,40,0,8,5,3
2019,456542,40,4,2,0,2
2019,456542,40,6,6,5,1
2019,456542,41,0,8,5,3
2019,456542,41,4,2,0,2
2019,456542,41,6,6,5,1
2019,456542,44,0,4,2,2
2019,456542,44,4,2,0,2
2019,456542,44,6,2,2,0
2019,456542,45,0,4,3,1
2019,456542,45,6,4,3,1
2019,456579,0,0,6,1,5
2019,456579,10,0,6,1,5
2019,456579,10,4,6,1,5
2019,456579,40,0,6,1,5
2019,456579,40,4,6,1,5
2019,456579,41,0,6,1,5
2019,456579,41,4,6,1,5
2019,456579,45,0,6,1,5
2019,456579,45,4,6,1,5
2019,456959,0,0,37,20,17
2019,456959,10,0,12,6,6
2019,456959,10,2,6,3,3
2019,456959,10,3,6,3,3
2019,456959,20,0,5,3,2
2019,456959,20,2,5,3,2
2019,456959,30,0,6,2,4
2019,456959,30,2,1,0,1
2019,456959,30,3,5,2,3
2019,456959,40,0,1,1,0
2019,456959,40,3,1,1,0
2019,456959,42,0,1,1,0
2019,456959,42,3,1,1,0
2019,456959,50,0,25,14,11
2019,457101,0,0,8,3,5
2019,457101,10,0,8,3,5
2019,457101,10,4,8,3,5
2019,457101,40,0,8,3,5
2019,457101,40,4,8,3,5
2019,457101,41,0,8,3,5
2019,457101,41,4,8,3,5
2019,457101,45,0,8,3,5
2019,457101,45,4,8,3,5
2019,457110,0,0,13,0,13
2019,457110,10,0,13,0,13
2019,457110,10,4,13,0,13
2019,457110,40,0,13,0,13
2019,457110,40,4,13,0,13
2019,457110,41,0,13,0,13
2019,457110,41,4,13,0,13
2019,457110,45,0,13,0,13
2019,457110,45,4,13,0,13
2019,457129,0,0,28,1,27
2019,457129,10,0,28,1,27
2019,457129,10,2,1,0,1
2019,457129,10,3,18,1,17
2019,457129,10,4,9,0,9
2019,457129,40,0,28,1,27
2019,457129,40,2,1,0,1
2019,457129,40,3,18,1,17
2019,457129,40,4,9,0,9
2019,457129,41,0,28,1,27
2019,457129,41,2,1,0,1
2019,457129,41,3,18,1,17
2019,457129,41,4,9,0,9
2019,457129,45,0,28,1,27
2019,457129,45,2,1,0,1
2019,457129,45,3,18,1,17
2019,457129,45,4,9,0,9
2019,457299,0,0,8,4,4
2019,457299,10,0,8,4,4
2019,457299,10,1,2,1,1
2019,457299,10,4,6,3,3
2019,457299,40,0,8,4,4
2019,457299,40,1,2,1,1
2019,457299,40,4,6,3,3
2019,457299,41,0,7,4,3
2019,457299,41,1,2,1,1
2019,457299,41,4,5,3,2
2019,457299,42,0,1,0,1
2019,457299,42,4,1,0,1
2019,457299,44,0,7,4,3
2019,457299,44,1,2,1,1
2019,457299,44,4,5,3,2
2019,457527,0,0,7,0,7
2019,457527,10,0,7,0,7
2019,457527,10,1,2,0,2
2019,457527,10,2,2,0,2
2019,457527,10,3,2,0,2
2019,457527,10,4,1,0,1
2019,457527,40,0,7,0,7
2019,457527,40,1,2,0,2
2019,457527,40,2,2,0,2
2019,457527,40,3,2,0,2
2019,457527,40,4,1,0,1
2019,457527,41,0,4,0,4
2019,457527,41,1,2,0,2
2019,457527,41,2,2,0,2
2019,457527,42,0,3,0,3
2019,457527,42,3,2,0,2
2019,457527,42,4,1,0,1
2019,457527,45,0,4,0,4
2019,457527,45,1,2,0,2
2019,457527,45,2,2,0,2
2019,457536,0,0,6,4,2
2019,457536,10,0,6,4,2
2019,457536,10,4,6,4,2
2019,457536,40,0,6,4,2
2019,457536,40,4,6,4,2
2019,457536,41,0,6,4,2
2019,457536,41,4,6,4,2
2019,457536,45,0,6,4,2
2019,457536,45,4,6,4,2
2019,458210,0,0,47,22,25
2019,458210,10,0,47,22,25
2019,458210,10,1,1,1,0
2019,458210,10,2,6,3,3
2019,458210,10,3,14,6,8
2019,458210,10,4,26,12,14
2019,458210,40,0,47,22,25
2019,458210,40,1,1,1,0
2019,458210,40,2,6,3,3
2019,458210,40,3,14,6,8
2019,458210,40,4,26,12,14
2019,458210,41,0,47,22,25
2019,458210,41,1,1,1,0
2019,458210,41,2,6,3,3
2019,458210,41,3,14,6,8
2019,458210,41,4,26,12,14
2019,458210,45,0,47,22,25
2019,458210,45,1,1,1,0
2019,458210,45,2,6,3,3
2019,458210,45,3,14,6,8
2019,458210,45,4,26,12,14
2019,458229,0,0,39,10,29
2019,458229,10,0,39,10,29
2019,458229,10,1,1,0,1
2019,458229,10,2,2,0,2
2019,458229,10,3,6,2,4
2019,458229,10,4,30,8,22
2019,458229,40,0,39,10,29
2019,458229,40,1,1,0,1
2019,458229,40,2,2,0,2
2019,458229,40,3,6,2,4
2019,458229,40,4,30,8,22
2019,458229,41,0,39,10,29
2019,458229,41,1,1,0,1
2019,458229,41,2,2,0,2
2019,458229,41,3,6,2,4
2019,458229,41,4,30,8,22
2019,458229,45,0,39,10,29
2019,458229,45,1,1,0,1
2019,458229,45,2,2,0,2
2019,458229,45,3,6,2,4
2019,458229,45,4,30,8,22
2019,458405,0,0,14,10,4
2019,458405,10,0,14,10,4
2019,458405,10,4,14,10,4
2019,458405,40,0,14,10,4
2019,458405,40,4,14,10,4
2019,458405,41,0,14,10,4
2019,458405,41,4,14,10,4
2019,458405,45,0,14,10,4
2019,458405,45,4,14,10,4
2019,458441,0,0,4,0,4
2019,458441,10,0,4,0,4
2019,458441,10,4,4,0,4
2019,458441,40,0,4,0,4
2019,458441,40,4,4,0,4
2019,458441,41,0,4,0,4
2019,458441,41,4,4,0,4
2019,458441,45,0,4,0,4
2019,458441,45,4,4,0,4
2019,458496,0,0,2,2,0
2019,458496,10,0,2,2,0
2019,458496,10,4,2,2,0
2019,458496,40,0,2,2,0
2019,458496,40,4,2,2,0
2019,458496,41,0,2,2,0
2019,458496,41,4,2,2,0
2019,458496,45,0,2,2,0
2019,458496,45,4,2,2,0
2019,458681,0,0,11,1,10
2019,458681,10,0,11,1,10
2019,458681,10,4,11,1,10
2019,458681,40,0,11,1,10
2019,458681,40,4,11,1,10
2019,458681,41,0,11,1,10
2019,458681,41,4,11,1,10
2019,458681,45,0,11,1,10
2019,458681,45,4,11,1,10
2019,458919,0,0,9,6,3
2019,458919,10,0,9,6,3
2019,458919,10,6,9,6,3
2019,458919,40,0,9,6,3
2019,458919,40,6,9,6,3
2019,458919,41,0,9,6,3
2019,458919,41,6,9,6,3
2019,458919,45,0,9,6,3
2019,458919,45,6,9,6,3
2019,458964,0,0,1,0,1
2019,458964,10,0,1,0,1
2019,458964,10,6,1,0,1
2019,458964,40,0,1,0,1
2019,458964,40,6,1,0,1
2019,458964,41,0,1,0,1
2019,458964,41,6,1,0,1
2019,458964,45,0,1,0,1
2019,458964,45,6,1,0,1
2019,458973,0,0,3,3,0
2019,458973,10,0,3,3,0
2019,458973,10,6,3,3,0
2019,458973,40,0,3,3,0
2019,458973,40,6,3,3,0
2019,458973,41,0,3,3,0
2019,458973,41,6,3,3,0
2019,458973,45,0,3,3,0
2019,458973,45,6,3,3,0
2019,458982,0,0,4,3,1
2019,458982,10,0,4,3,1
2019,458982,10,4,4,3,1
2019,458982,40,0,4,3,1
2019,458982,40,4,4,3,1
2019,458982,41,0,4,3,1
2019,458982,41,4,4,3,1
2019,458982,45,0,4,3,1
2019,458982,45,4,4,3,1
2019,459204,0,0,74,17,57
2019,459204,10,0,69,14,55
2019,459204,10,6,69,14,55
2019,459204,40,0,69,14,55
2019,459204,40,6,69,14,55
2019,459204,41,0,69,14,55
2019,459204,41,6,69,14,55
2019,459204,44,0,69,14,55
2019,459204,44,6,69,14,55
2019,459204,50,0,5,3,2
2019,459213,0,0,78,24,54
2019,459213,10,0,78,24,54
2019,459213,10,4,78,24,54
2019,459213,40,0,78,24,54
2019,459213,40,4,78,24,54
2019,459213,41,0,78,24,54
2019,459213,41,4,78,24,54
2019,459213,45,0,78,24,54
2019,459213,45,4,78,24,54
2019,459259,0,0,16,0,16
2019,459259,10,0,16,0,16
2019,459259,10,3,9,0,9
2019,459259,10,4,7,0,7
2019,459259,40,0,16,0,16
2019,459259,40,3,9,0,9
2019,459259,40,4,7,0,7
2019,459259,41,0,16,0,16
2019,459259,41,3,9,0,9
2019,459259,41,4,7,0,7
2019,459259,45,0,16,0,16
2019,459259,45,3,9,0,9
2019,459259,45,4,7,0,7
2019,459268,0,0,12,2,10
2019,459268,10,0,12,2,10
2019,459268,10,2,1,0,1
2019,459268,10,3,5,1,4
2019,459268,10,4,6,1,5
2019,459268,40,0,12,2,10
2019,459268,40,2,1,0,1
2019,459268,40,3,5,1,4
2019,459268,40,4,6,1,5
2019,459268,41,0,12,2,10
2019,459268,41,2,1,0,1
2019,459268,41,3,5,1,4
2019,459268,41,4,6,1,5
2019,459268,45,0,12,2,10
2019,459268,45,2,1,0,1
2019,459268,45,3,5,1,4
2019,459268,45,4,6,1,5
2019,459727,0,0,11,7,4
2019,459727,10,0,11,7,4
2019,459727,10,1,3,3,0
2019,459727,10,3,5,3,2
2019,459727,10,4,3,1,2
2019,459727,40,0,11,7,4
2019,459727,40,1,3,3,0
2019,459727,40,3,5,3,2
2019,459727,40,4,3,1,2
2019,459727,41,0,11,7,4
2019,459727,41,1,3,3,0
2019,459727,41,3,5,3,2
2019,459727,41,4,3,1,2
2019,459727,45,0,11,7,4
2019,459727,45,1,3,3,0
2019,459727,45,3,5,3,2
2019,459727,45,4,3,1,2
2019,459736,0,0,108,39,69
2019,459736,10,0,108,39,69
2019,459736,10,1,24,12,12
2019,459736,10,2,37,13,24
2019,459736,10,3,41,11,30
2019,459736,10,4,2,2,0
2019,459736,10,6,4,1,3
2019,459736,40,0,108,39,69
2019,459736,40,1,24,12,12
2019,459736,40,2,37,13,24
2019,459736,40,3,41,11,30
2019,459736,40,4,2,2,0
2019,459736,40,6,4,1,3
2019,459736,41,0,62,18,44
2019,459736,41,1,14,7,7
2019,459736,41,2,26,7,19
2019,459736,41,3,20,2,18
2019,459736,41,4,2,2,0
2019,459736,42,0,46,21,25
2019,459736,42,1,10,5,5
2019,459736,42,2,11,6,5
2019,459736,42,3,21,9,12
2019,459736,42,6,4,1,3
2019,459736,44,0,62,18,44
2019,459736,44,1,14,7,7
2019,459736,44,2,26,7,19
2019,459736,44,3,20,2,18
2019,459736,44,4,2,2,0
2019,459745,0,0,39,15,24
2019,459745,10,0,39,15,24
2019,459745,10,1,8,4,4
2019,459745,10,2,16,5,11
2019,459745,10,3,15,6,9
2019,459745,40,0,39,15,24
2019,459745,40,1,8,4,4
2019,459745,40,2,16,5,11
2019,459745,40,3,15,6,9
2019,459745,41,0,26,10,16
2019,459745,41,1,8,4,4
2019,459745,41,2,6,3,3
2019,459745,41,3,12,3,9
2019,459745,42,0,13,5,8
2019,459745,42,2,10,2,8
2019,459745,42,3,3,3,0
2019,459745,44,0,26,10,16
2019,459745,44,1,8,4,4
2019,459745,44,2,6,3,3
2019,459745,44,3,12,3,9
2019,459824,0,0,79,33,46
2019,459824,10,0,79,33,46
2019,459824,10,1,10,5,5
2019,459824,10,2,18,8,10
2019,459824,10,3,50,19,31
2019,459824,10,4,1,1,0
2019,459824,40,0,79,33,46
2019,459824,40,1,10,5,5
2019,459824,40,2,18,8,10
2019,459824,40,3,50,19,31
2019,459824,40,4,1,1,0
2019,459824,41,0,59,26,33
2019,459824,41,1,7,4,3
2019,459824,41,2,18,8,10
2019,459824,41,3,34,14,20
2019,459824,42,0,20,7,13
2019,459824,42,1,3,1,2
2019,459824,42,3,16,5,11
2019,459824,42,4,1,1,0
2019,459824,44,0,59,26,33
2019,459824,44,1,7,4,3
2019,459824,44,2,18,8,10
2019,459824,44,3,34,14,20
2019,459842,0,0,14,3,11
2019,459842,10,0,14,3,11
2019,459842,10,1,3,1,2
2019,459842,10,2,2,1,1
2019,459842,10,3,7,0,7
2019,459842,10,4,2,1,1
2019,459842,40,0,14,3,11
2019,459842,40,1,3,1,2
2019,459842,40,2,2,1,1
2019,459842,40,3,7,0,7
2019,459842,40,4,2,1,1
2019,459842,41,0,14,3,11
2019,459842,41,1,3,1,2
2019,459842,41,2,2,1,1
2019,459842,41,3,7,0,7
2019,459842,41,4,2,1,1
2019,459842,45,0,14,3,11
2019,459842,45,1,3,1,2
2019,459842,45,2,2,1,1
2019,459842,45,3,7,0,7
2019,459842,45,4,2,1,1
2019,459851,0,0,19,0,19
2019,459851,10,0,19,0,19
2019,459851,10,1,2,0,2
2019,459851,10,2,8,0,8
2019,459851,10,3,6,0,6
2019,459851,10,4,3,0,3
2019,459851,40,0,19,0,19
2019,459851,40,1,2,0,2
2019,459851,40,2,8,0,8
2019,459851,40,3,6,0,6
2019,459851,40,4,3,0,3
2019,459851,41,0,19,0,19
2019,459851,41,1,2,0,2
2019,459851,41,2,8,0,8
2019,459851,41,3,6,0,6
2019,459851,41,4,3,0,3
2019,459851,45,0,19,0,19
2019,459851,45,1,2,0,2
2019,459851,45,2,8,0,8
2019,459851,45,3,6,0,6
2019,459851,45,4,3,0,3
2019,459949,0,0,182,93,89
2019,459949,10,0,182,93,89
2019,459949,10,1,17,11,6
2019,459949,10,2,44,19,25
2019,459949,10,3,62,35,27
2019,459949,10,4,19,12,7
2019,459949,10,5,40,16,24
2019,459949,20,0,49,28,21
2019,459949,20,1,17,11,6
2019,459949,20,2,32,17,15
2019,459949,30,0,74,37,37
2019,459949,30,2,12,2,10
2019,459949,30,3,62,35,27
2019,459949,40,0,59,28,31
2019,459949,40,4,19,12,7
2019,459949,40,5,40,16,24
2019,459949,41,0,19,12,7
2019,459949,41,4,19,12,7
2019,459949,42,0,40,16,24
2019,459949,42,5,40,16,24
2019,459949,45,0,19,12,7
2019,459949,45,4,19,12,7
2019,459958,0,0,6,3,3
2019,459958,10,0,6,3,3
2019,459958,10,4,6,3,3
2019,459958,40,0,6,3,3
2019,459958,40,4,6,3,3
2019,459958,41,0,6,3,3
2019,459958,41,4,6,3,3
2019,459958,45,0,6,3,3
2019,459958,45,4,6,3,3
2019,459994,0,0,112,33,79
2019,459994,10,0,112,33,79
2019,459994,10,6,112,33,79
2019,459994,40,0,112,33,79
2019,459994,40,6,112,33,79
2019,459994,41,0,71,26,45
2019,459994,41,6,71,26,45
2019,459994,42,0,41,7,34
2019,459994,42,6,41,7,34
2019,459994,45,0,71,26,45
2019,459994,45,6,71,26,45
2019,460020,0,0,8,2,6
2019,460020,10,0,8,2,6
2019,460020,10,4,8,2,6
2019,460020,40,0,8,2,6
2019,460020,40,4,8,2,6
2019,460020,41,0,8,2,6
2019,460020,41,4,8,2,6
2019,460020,45,0,8,2,6
2019,460020,45,4,8,2,6
2019,460136,0,0,42,7,35
2019,460136,10,0,42,7,35
2019,460136,10,4,42,7,35
2019,460136,40,0,42,7,35
2019,460136,40,4,42,7,35
2019,460136,41,0,42,7,35
2019,460136,41,4,42,7,35
2019,460136,45,0,42,7,35
2019,460136,45,4,42,7,35
2019,460181,0,0,13,4,9
2019,460181,10,0,13,4,9
2019,460181,10,4,13,4,9
2019,460181,40,0,13,4,9
2019,460181,40,4,13,4,9
2019,460181,41,0,13,4,9
2019,460181,41,4,13,4,9
2019,460181,45,0,13,4,9
2019,460181,45,4,13,4,9
2019,460190,0,0,3,1,2
2019,460190,10,0,3,1,2
2019,460190,10,4,3,1,2
2019,460190,40,0,3,1,2
2019,460190,40,4,3,1,2
2019,460190,41,0,3,1,2
2019,460190,41,4,3,1,2
2019,460190,45,0,3,1,2
2019,460190,45,4,3,1,2
2019,460206,0,0,12,2,10
2019,460206,10,0,12,2,10
2019,460206,10,4,12,2,10
2019,460206,40,0,12,2,10
2019,460206,40,4,12,2,10
2019,460206,41,0,12,2,10
2019,460206,41,4,12,2,10
2019,460206,45,0,12,2,10
2019,460206,45,4,12,2,10
2019,460349,0,0,1,1,0
2019,460349,10,0,1,1,0
2019,460349,10,5,1,1,0
2019,460349,40,0,1,1,0
2019,460349,40,5,1,1,0
2019,460349,42,0,1,1,0
2019,460349,42,5,1,1,0
2019,460376,0,0,8,6,2
2019,460376,10,0,8,6,2
2019,460376,10,1,1,1,0
2019,460376,10,2,3,1,2
2019,460376,10,3,3,3,0
2019,460376,10,4,1,1,0
2019,460376,40,0,8,6,2
2019,460376,40,1,1,1,0
2019,460376,40,2,3,1,2
2019,460376,40,3,3,3,0
2019,460376,40,4,1,1,0
2019,460376,41,0,8,6,2
2019,460376,41,1,1,1,0
2019,460376,41,2,3,1,2
2019,460376,41,3,3,3,0
2019,460376,41,4,1,1,0
2019,460376,45,0,8,6,2
2019,460376,45,1,1,1,0
2019,460376,45,2,3,1,2
2019,460376,45,3,3,3,0
2019,460376,45,4,1,1,0
2019,460394,0,0,102,42,60
2019,460394,10,0,102,42,60
2019,460394,10,4,102,42,60
2019,460394,20,0,60,27,33
2019,460394,20,4,60,27,33
2019,460394,30,0,32,11,21
2019,460394,30,4,32,11,21
2019,460394,40,0,10,4,6
2019,460394,40,4,10,4,6
2019,460394,42,0,9,3,6
2019,460394,42,4,9,3,6
2019,460394,43,0,1,1,0
2019,460394,43,4,1,1,0
2019,460464,0,0,98,42,56
2019,460464,10,0,98,42,56
2019,460464,10,4,98,42,56
2019,460464,20,0,61,27,34
2019,460464,20,4,61,27,34
2019,460464,30,0,32,14,18
2019,460464,30,4,32,14,18
2019,460464,40,0,5,1,4
2019,460464,40,4,5,1,4
2019,460464,42,0,5,1,4
2019,460464,42,4,5,1,4
2019,460543,0,0,35,35,0
2019,460543,50,0,35,35,0
2019,460677,0,0,12,2,10
2019,460677,10,0,12,2,10
2019,460677,10,4,12,2,10
2019,460677,40,0,12,2,10
2019,460677,40,4,12,2,10
2019,460677,43,0,12,2,10
2019,460677,43,4,12,2,10
2019,460738,0,0,16,0,16
2019,460738,10,0,13,0,13
2019,460738,10,2,6,0,6
2019,460738,10,3,5,0,5
2019,460738,10,4,2,0,2
2019,460738,40,0,13,0,13
2019,460738,40,2,6,0,6
2019,460738,40,3,5,0,5
2019,460738,40,4,2,0,2
2019,460738,41,0,13,0,13
2019,460738,41,2,6,0,6
2019,460738,41,3,5,0,5
2019,460738,41,4,2,0,2
2019,460738,44,0,13,0,13
2019,460738,44,2,6,0,6
2019,460738,44,3,5,0,5
2019,460738,44,4,2,0,2
2019,460738,50,0,3,0,3
2019,460756,0,0,16,6,10
2019,460756,10,0,16,6,10
2019,460756,10,4,16,6,10
2019,460756,40,0,16,6,10
2019,460756,40,4,16,6,10
2019,460756,41,0,16,6,10
2019,460756,41,4,16,6,10
2019,460756,45,0,16,6,10
2019,460756,45,4,16,6,10
2019,460817,0,0,7,3,4
2019,460817,10,0,7,3,4
2019,460817,10,4,7,3,4
2019,460817,40,0,7,3,4
2019,460817,40,4,7,3,4
2019,460817,41,0,7,3,4
2019,460817,41,4,7,3,4
2019,460817,45,0,7,3,4
2019,460817,45,4,7,3,4
2019,460826,0,0,10,6,4
2019,460826,10,0,10,6,4
2019,460826,10,4,10,6,4
2019,460826,40,0,10,6,4
2019,460826,40,4,10,6,4
2019,460826,41,0,10,6,4
2019,460826,41,4,10,6,4
2019,460826,45,0,10,6,4
2019,460826,45,4,10,6,4
2019,460835,0,0,10,4,6
2019,460835,10,0,10,4,6
2019,460835,10,4,10,4,6
2019,460835,40,0,10,4,6
2019,460835,40,4,10,4,6
2019,460835,41,0,10,4,6
2019,460835,41,4,10,4,6
2019,460835,45,0,10,4,6
2019,460835,45,4,10,4,6
2019,460871,0,0,11,1,10
2019,460871,10,0,11,1,10
2019,460871,10,3,2,0,2
2019,460871,10,4,9,1,8
2019,460871,40,0,11,1,10
2019,460871,40,3,2,0,2
2019,460871,40,4,9,1,8
2019,460871,41,0,11,1,10
2019,460871,41,3,2,0,2
2019,460871,41,4,9,1,8
2019,460871,45,0,11,1,10
2019,460871,45,3,2,0,2
2019,460871,45,4,9,1,8
2019,460899,0,0,10,8,2
2019,460899,10,0,10,8,2
2019,460899,10,6,10,8,2
2019,460899,40,0,10,8,2
2019,460899,40,6,10,8,2
2019,460899,41,0,10,8,2
2019,460899,41,6,10,8,2
2019,460899,45,0,10,8,2
2019,460899,45,6,10,8,2
2019,461014,0,0,13,6,7
2019,461014,50,0,13,6,7
2019,461148,0,0,146,101,45
2019,461148,10,0,102,77,25
2019,461148,10,4,102,77,25
2019,461148,40,0,102,77,25
2019,461148,40,4,102,77,25
2019,461148,41,0,63,44,19
2019,461148,41,4,63,44,19
2019,461148,43,0,39,33,6
2019,461148,43,4,39,33,6
2019,461148,45,0,63,44,19
2019,461148,45,4,63,44,19
2019,461148,50,0,44,24,20
2019,461218,0,0,6,3,3
2019,461218,10,0,6,3,3
2019,461218,10,4,6,3,3
2019,461218,40,0,6,3,3
2019,461218,40,4,6,3,3
2019,461218,41,0,6,3,3
2019,461218,41,4,6,3,3
2019,461218,45,0,6,3,3
2019,461218,45,4,6,3,3
2019,461315,0,0,5,2,3
2019,461315,10,0,5,2,3
2019,461315,10,4,5,2,3
2019,461315,40,0,5,2,3
2019,461315,40,4,5,2,3
2019,461315,42,0,5,2,3
2019,461315,42,4,5,2,3
2019,461324,0,0,6,2,4
2019,461324,10,0,6,2,4
2019,461324,10,4,6,2,4
2019,461324,40,0,6,2,4
2019,461324,40,4,6,2,4
2019,461324,41,0,6,2,4
2019,461324,41,4,6,2,4
2019,461324,45,0,6,2,4
2019,461324,45,4,6,2,4
2019,461689,0,0,19,2,17
2019,461689,10,0,19,2,17
2019,461689,10,4,19,2,17
2019,461689,40,0,19,2,17
2019,461689,40,4,19,2,17
2019,461689,41,0,19,2,17
2019,461689,41,4,19,2,17
2019,461689,45,0,19,2,17
2019,461689,45,4,19,2,17
2019,461759,0,0,7,5,2
2019,461759,10,0,7,5,2
2019,461759,10,6,7,5,2
2019,461759,40,0,7,5,2
2019,461759,40,6,7,5,2
2019,461759,41,0,7,5,2
2019,461759,41,6,7,5,2
2019,461759,45,0,7,5,2
2019,461759,45,6,7,5,2
2019,461795,0,0,15,12,3
2019,461795,10,0,15,12,3
2019,461795,10,1,1,1,0
2019,461795,10,2,6,5,1
2019,461795,10,3,3,1,2
2019,461795,10,4,5,5,0
2019,461795,40,0,15,12,3
2019,461795,40,1,1,1,0
2019,461795,40,2,6,5,1
2019,461795,40,3,3,1,2
2019,461795,40,4,5,5,0
2019,461795,42,0,15,12,3
2019,461795,42,1,1,1,0
2019,461795,42,2,6,5,1
2019,461795,42,3,3,1,2
2019,461795,42,4,5,5,0
2019,461953,0,0,11,1,10
2019,461953,10,0,11,1,10
2019,461953,10,5,11,1,10
2019,461953,40,0,11,1,10
2019,461953,40,5,11,1,10
2019,461953,41,0,11,1,10
2019,461953,41,5,11,1,10
2019,461953,45,0,11,1,10
2019,461953,45,5,11,1,10
2019,462354,0,0,11,9,2
2019,462354,10,0,11,9,2
2019,462354,10,1,11,9,2
2019,462354,40,0,11,9,2
2019,462354,40,1,11,9,2
2019,462354,41,0,11,9,2
2019,462354,41,1,11,9,2
2019,462354,45,0,11,9,2
2019,462354,45,1,11,9,2
2019,464226,0,0,10,3,7
2019,464226,10,0,10,3,7
2019,464226,10,1,2,0,2
2019,464226,10,2,2,2,0
2019,464226,10,3,5,1,4
2019,464226,10,4,1,0,1
2019,464226,20,0,2,1,1
2019,464226,20,1,1,0,1
2019,464226,20,2,1,1,0
2019,464226,40,0,8,2,6
2019,464226,40,1,1,0,1
2019,464226,40,2,1,1,0
2019,464226,40,3,5,1,4
2019,464226,40,4,1,0,1
2019,464226,42,0,8,2,6
2019,464226,42,1,1,0,1
2019,464226,42,2,1,1,0
2019,464226,42,3,5,1,4
2019,464226,42,4,1,0,1
2019,465812,0,0,169,64,105
2019,465812,10,0,169,64,105
2019,465812,10,6,169,64,105
2019,465812,40,0,169,64,105
2019,465812,40,6,169,64,105
2019,465812,41,0,169,64,105
2019,465812,41,6,169,64,105
2019,465812,45,0,169,64,105
2019,465812,45,6,169,64,105
2019,466921,0,0,14,1,13
2019,466921,10,0,14,1,13
2019,466921,10,1,1,0,1
2019,466921,10,3,4,1,3
2019,466921,10,4,9,0,9
2019,466921,40,0,14,1,13
2019,466921,40,1,1,0,1
2019,466921,40,3,4,1,3
2019,466921,40,4,9,0,9
2019,466921,41,0,14,1,13
2019,466921,41,1,1,0,1
2019,466921,41,3,4,1,3
2019,466921,41,4,9,0,9
2019,466921,45,0,14,1,13
2019,466921,45,1,1,0,1
2019,466921,45,3,4,1,3
2019,466921,45,4,9,0,9
2019,466930,0,0,28,0,28
2019,466930,10,0,28,0,28
2019,466930,10,2,1,0,1
2019,466930,10,3,16,0,16
2019,466930,10,4,11,0,11
2019,466930,40,0,28,0,28
2019,466930,40,2,1,0,1
2019,466930,40,3,16,0,16
2019,466930,40,4,11,0,11
2019,466930,41,0,28,0,28
2019,466930,41,2,1,0,1
2019,466930,41,3,16,0,16
2019,466930,41,4,11,0,11
2019,466930,45,0,28,0,28
2019,466930,45,2,1,0,1
2019,466930,45,3,16,0,16
2019,466930,45,4,11,0,11
2019,469416,0,0,27,12,15
2019,469416,10,0,27,12,15
2019,469416,10,1,27,12,15
2019,469416,40,0,27,12,15
2019,469416,40,1,27,12,15
2019,469416,41,0,27,12,15
2019,469416,41,1,27,12,15
2019,469416,44,0,27,12,15
2019,469416,44,1,27,12,15
2019,469629,0,0,8,8,0
2019,469629,10,0,8,8,0
2019,469629,10,4,8,8,0
2019,469629,40,0,8,8,0
2019,469629,40,4,8,8,0
2019,469629,41,0,8,8,0
2019,469629,41,4,8,8,0
2019,469629,45,0,8,8,0
2019,469629,45,4,8,8,0
2019,474863,0,0,11,6,5
2019,474863,10,0,11,6,5
2019,474863,10,5,11,6,5
2019,474863,40,0,11,6,5
2019,474863,40,5,11,6,5
2019,474863,41,0,11,6,5
2019,474863,41,5,11,6,5
2019,474863,45,0,11,6,5
2019,474863,45,5,11,6,5
2019,474890,0,0,7,3,4
2019,474890,10,0,7,3,4
2019,474890,10,6,7,3,4
2019,474890,40,0,7,3,4
2019,474890,40,6,7,3,4
2019,474890,41,0,7,3,4
2019,474890,41,6,7,3,4
2019,474890,45,0,7,3,4
2019,474890,45,6,7,3,4
2019,475033,0,0,154,34,120
2019,475033,10,0,149,33,116
2019,475033,10,3,123,29,94
2019,475033,10,4,26,4,22
2019,475033,40,0,149,33,116
2019,475033,40,3,123,29,94
2019,475033,40,4,26,4,22
2019,475033,41,0,149,33,116
2019,475033,41,3,123,29,94
2019,475033,41,4,26,4,22
2019,475033,45,0,149,33,116
2019,475033,45,3,123,29,94
2019,475033,45,4,26,4,22
2019,475033,50,0,5,1,4
2019,475060,0,0,4,1,3
2019,475060,10,0,4,1,3
2019,475060,10,4,4,1,3
2019,475060,40,0,4,1,3
2019,475060,40,4,4,1,3
2019,475060,41,0,4,1,3
2019,475060,41,4,4,1,3
2019,475060,45,0,4,1,3
2019,475060,45,4,4,1,3
2019,475273,0,0,14,6,8
2019,475273,10,0,14,6,8
2019,475273,10,1,7,4,3
2019,475273,10,2,1,0,1
2019,475273,10,3,6,2,4
2019,475273,20,0,4,2,2
2019,475273,20,1,4,2,2
2019,475273,30,0,2,0,2
2019,475273,30,2,1,0,1
2019,475273,30,3,1,0,1
2019,475273,40,0,8,4,4
2019,475273,40,1,3,2,1
2019,475273,40,3,5,2,3
2019,475273,41,0,8,4,4
2019,475273,41,1,3,2,1
2019,475273,41,3,5,2,3
2019,475273,44,0,8,4,4
2019,475273,44,1,3,2,1
2019,475273,44,3,5,2,3
2019,475398,0,0,7,6,1
2019,475398,10,0,7,6,1
2019,475398,10,6,7,6,1
2019,475398,40,0,7,6,1
2019,475398,40,6,7,6,1
2019,475398,41,0,1,1,0
2019,475398,41,6,1,1,0
2019,475398,42,0,6,5,1
2019,475398,42,6,6,5,1
2019,475398,45,0,1,1,0
2019,475398,45,6,1,1,0
2019,475477,0,0,2,0,2
2019,475477,10,0,2,0,2
2019,475477,10,4,2,0,2
2019,475477,40,0,2,0,2
2019,475477,40,4,2,0,2
2019,475477,41,0,2,0,2
2019,475477,41,4,2,0,2
2019,475477,45,0,2,0,2
2019,475477,45,4,2,0,2
2019,475495,0,0,58,31,27
2019,475495,10,0,58,31,27
2019,475495,10,1,10,7,3
2019,475495,10,2,15,8,7
2019,475495,10,3,20,9,11
2019,475495,10,4,13,7,6
2019,475495,40,0,58,31,27
2019,475495,40,1,10,7,3
2019,475495,40,2,15,8,7
2019,475495,40,3,20,9,11
2019,475495,40,4,13,7,6
2019,475495,41,0,58,31,27
2019,475495,41,1,10,7,3
2019,475495,41,2,15,8,7
2019,475495,41,3,20,9,11
2019,475495,41,4,13,7,6
2019,475495,45,0,58,31,27
2019,475495,45,1,10,7,3
2019,475495,45,2,15,8,7
2019,475495,45,3,20,9,11
2019,475495,45,4,13,7,6
2019,475565,0,0,51,20,31
2019,475565,10,0,51,20,31
2019,475565,10,1,7,3,4
2019,475565,10,2,8,3,5
2019,475565,10,3,29,8,21
2019,475565,10,4,1,1,0
2019,475565,10,5,6,5,1
2019,475565,20,0,11,5,6
2019,475565,20,1,6,3,3
2019,475565,20,2,4,1,3
2019,475565,20,5,1,1,0
2019,475565,30,0,37,13,24
2019,475565,30,2,4,2,2
2019,475565,30,3,29,8,21
2019,475565,30,5,4,3,1
2019,475565,40,0,3,2,1
2019,475565,40,1,1,0,1
2019,475565,40,4,1,1,0
2019,475565,40,5,1,1,0
2019,475565,42,0,3,2,1
2019,475565,42,1,1,0,1
2019,475565,42,4,1,1,0
2019,475565,42,5,1,1,0
2019,475608,0,0,13,12,1
2019,475608,10,0,13,12,1
2019,475608,10,1,5,5,0
2019,475608,10,2,4,4,0
2019,475608,10,3,4,3,1
2019,475608,40,0,13,12,1
2019,475608,40,1,5,5,0
2019,475608,40,2,4,4,0
2019,475608,40,3,4,3,1
2019,475608,41,0,12,11,1
2019,475608,41,1,5,5,0
2019,475608,41,2,4,4,0
2019,475608,41,3,3,2,1
2019,475608,42,0,1,1,0
2019,475608,42,3,1,1,0
2019,475608,44,0,12,11,1
2019,475608,44,1,5,5,0
2019,475608,44,2,4,4,0
2019,475608,44,3,3,2,1
2019,475714,0,0,2,0,2
2019,475714,10,0,2,0,2
2019,475714,10,4,2,0,2
2019,475714,40,0,2,0,2
2019,475714,40,4,2,0,2
2019,475714,41,0,2,0,2
2019,475714,41,4,2,0,2
2019,475714,45,0,2,0,2
2019,475714,45,4,2,0,2
2019,475732,0,0,28,0,28
2019,475732,10,0,28,0,28
2019,475732,10,3,8,0,8
2019,475732,10,4,20,0,20
2019,475732,40,0,28,0,28
2019,475732,40,3,8,0,8
2019,475732,40,4,20,0,20
2019,475732,41,0,28,0,28
2019,475732,41,3,8,0,8
2019,475732,41,4,20,0,20
2019,475732,45,0,28,0,28
2019,475732,45,3,8,0,8
2019,475732,45,4,20,0,20
2019,475741,0,0,8,0,8
2019,475741,10,0,8,0,8
2019,475741,10,2,1,0,1
2019,475741,10,3,3,0,3
2019,475741,10,4,4,0,4
2019,475741,40,0,8,0,8
2019,475741,40,2,1,0,1
2019,475741,40,3,3,0,3
2019,475741,40,4,4,0,4
2019,475741,41,0,8,0,8
2019,475741,41,2,1,0,1
2019,475741,41,3,3,0,3
2019,475741,41,4,4,0,4
2019,475741,45,0,8,0,8
2019,475741,45,2,1,0,1
2019,475741,45,3,3,0,3
2019,475741,45,4,4,0,4
2019,476683,0,0,9,1,8
2019,476683,50,0,9,1,8
2019,476717,0,0,26,26,0
2019,476717,10,0,26,26,0
2019,476717,10,4,26,26,0
2019,476717,40,0,26,26,0
2019,476717,40,4,26,26,0
2019,476717,42,0,26,26,0
2019,476717,42,4,26,26,0
2019,476726,0,0,12,7,5
2019,476726,10,0,12,7,5
2019,476726,10,4,12,7,5
2019,476726,40,0,12,7,5
2019,476726,40,4,12,7,5
2019,476726,41,0,12,7,5
2019,476726,41,4,12,7,5
2019,476726,45,0,12,7,5
2019,476726,45,4,12,7,5
2019,476939,0,0,14,5,9
2019,476939,10,0,14,5,9
2019,476939,10,4,14,5,9
2019,476939,40,0,14,5,9
2019,476939,40,4,14,5,9
2019,476939,41,0,14,5,9
2019,476939,41,4,14,5,9
2019,476939,45,0,14,5,9
2019,476939,45,4,14,5,9
2019,476948,0,0,6,6,0
2019,476948,10,0,6,6,0
2019,476948,10,4,6,6,0
2019,476948,40,0,6,6,0
2019,476948,40,4,6,6,0
2019,476948,41,0,6,6,0
2019,476948,41,4,6,6,0
2019,476948,45,0,6,6,0
2019,476948,45,4,6,6,0
2019,476975,0,0,35,16,19
2019,476975,10,0,35,16,19
2019,476975,10,6,35,16,19
2019,476975,40,0,35,16,19
2019,476975,40,6,35,16,19
2019,476975,41,0,35,16,19
2019,476975,41,6,35,16,19
2019,476975,45,0,35,16,19
2019,476975,45,6,35,16,19
2019,477039,0,0,24,4,20
2019,477039,10,0,24,4,20
2019,477039,10,2,2,1,1
2019,477039,10,3,1,0,1
2019,477039,10,4,21,3,18
2019,477039,40,0,24,4,20
2019,477039,40,2,2,1,1
2019,477039,40,3,1,0,1
2019,477039,40,4,21,3,18
2019,477039,41,0,24,4,20
2019,477039,41,2,2,1,1
2019,477039,41,3,1,0,1
2019,477039,41,4,21,3,18
2019,477039,45,0,24,4,20
2019,477039,45,2,2,1,1
2019,477039,45,3,1,0,1
2019,477039,45,4,21,3,18
2019,478634,0,0,3,2,1
2019,478634,10,0,3,2,1
2019,478634,10,6,3,2,1
2019,478634,40,0,3,2,1
2019,478634,40,6,3,2,1
2019,478634,41,0,3,2,1
2019,478634,41,6,3,2,1
2019,478634,45,0,3,2,1
2019,478634,45,6,3,2,1
2019,480073,0,0,8,0,8
2019,480073,10,0,8,0,8
2019,480073,10,3,3,0,3
2019,480073,10,4,5,0,5
2019,480073,40,0,8,0,8
2019,480073,40,3,3,0,3
2019,480073,40,4,5,0,5
2019,480073,41,0,8,0,8
2019,480073,41,3,3,0,3
2019,480073,41,4,5,0,5
2019,480073,45,0,8,0,8
2019,480073,45,3,3,0,3
2019,480073,45,4,5,0,5
2019,480091,0,0,32,5,27
2019,480091,10,0,32,5,27
2019,480091,10,4,32,5,27
2019,480091,40,0,32,5,27
2019,480091,40,4,32,5,27
2019,480091,41,0,32,5,27
2019,480091,41,4,32,5,27
2019,480091,45,0,32,5,27
2019,480091,45,4,32,5,27
2019,480189,0,0,39,10,29
2019,480189,10,0,39,10,29
2019,480189,10,3,10,4,6
2019,480189,10,4,26,5,21
2019,480189,10,5,3,1,2
2019,480189,40,0,39,10,29
2019,480189,40,3,10,4,6
2019,480189,40,4,26,5,21
2019,480189,40,5,3,1,2
2019,480189,42,0,39,10,29
2019,480189,42,3,10,4,6
2019,480189,42,4,26,5,21
2019,480189,42,5,3,1,2
2019,480204,0,0,12,4,8
2019,480204,10,0,12,4,8
2019,480204,10,4,12,4,8
2019,480204,40,0,12,4,8
2019,480204,40,4,12,4,8
2019,480204,41,0,12,4,8
2019,480204,41,4,12,4,8
2019,480204,45,0,12,4,8
2019,480204,45,4,12,4,8
2019,480569,0,0,10,5,5
2019,480569,10,0,10,5,5
2019,480569,10,2,3,1,2
2019,480569,10,3,4,2,2
2019,480569,10,4,3,2,1
2019,480569,20,0,1,1,0
2019,480569,20,2,1,1,0
2019,480569,40,0,9,4,5
2019,480569,40,2,2,0,2
2019,480569,40,3,4,2,2
2019,480569,40,4,3,2,1
2019,480569,42,0,9,4,5
2019,480569,42,2,2,0,2
2019,480569,42,3,4,2,2
2019,480569,42,4,3,2,1
2019,480657,0,0,11,0,11
2019,480657,10,0,11,0,11
2019,480657,10,4,11,0,11
2019,480657,40,0,11,0,11
2019,480657,40,4,11,0,11
2019,480657,41,0,11,0,11
2019,480657,41,4,11,0,11
2019,480657,45,0,11,0,11
2019,480657,45,4,11,0,11
2019,480790,0,0,75,42,33
2019,480790,10,0,75,42,33
2019,480790,10,1,16,13,3
2019,480790,10,2,15,8,7
2019,480790,10,3,34,17,17
2019,480790,10,4,10,4,6
2019,480790,40,0,75,42,33
2019,480790,40,1,16,13,3
2019,480790,40,2,15,8,7
2019,480790,40,3,34,17,17
2019,480790,40,4,10,4,6
2019,480790,41,0,48,27,21
2019,480790,41,1,13,10,3
2019,480790,41,2,10,5,5
2019,480790,41,3,20,10,10
2019,480790,41,4,5,2,3
2019,480790,42,0,27,15,12
2019,480790,42,1,3,3,0
2019,480790,42,2,5,3,2
2019,480790,42,3,14,7,7
2019,480790,42,4,5,2,3
2019,480790,44,0,46,26,20
2019,480790,44,1,13,10,3
2019,480790,44,2,10,5,5
2019,480790,44,3,20,10,10
2019,480790,44,4,3,1,2
2019,480790,45,0,2,1,1
2019,480790,45,4,2,1,1
2019,480824,0,0,8,0,8
2019,480824,10,0,8,0,8
2019,480824,10,4,8,0,8
2019,480824,40,0,8,0,8
2019,480824,40,4,8,0,8
2019,480824,41,0,8,0,8
2019,480824,41,4,8,0,8
2019,480824,45,0,8,0,8
2019,480824,45,4,8,0,8
2019,480833,0,0,18,2,16
2019,480833,10,0,18,2,16
2019,480833,10,4,18,2,16
2019,480833,40,0,18,2,16
2019,480833,40,4,18,2,16
2019,480833,41,0,18,2,16
2019,480833,41,4,18,2,16
2019,480833,45,0,18,2,16
2019,480833,45,4,18,2,16
2019,480967,0,0,10,4,6
2019,480967,10,0,10,4,6
2019,480967,10,4,10,4,6
2019,480967,40,0,10,4,6
2019,480967,40,4,10,4,6
2019,480967,41,0,10,4,6
2019,480967,41,4,10,4,6
2019,480967,45,0,10,4,6
2019,480967,45,4,10,4,6
2019,481030,0,0,7,3,4
2019,481030,10,0,7,3,4
2019,481030,10,1,2,1,1
2019,481030,10,3,3,0,3
2019,481030,10,4,1,1,0
2019,481030,10,5,1,1,0
2019,481030,40,0,7,3,4
2019,481030,40,1,2,1,1
2019,481030,40,3,3,0,3
2019,481030,40,4,1,1,0
2019,481030,40,5,1,1,0
2019,481030,42,0,7,3,4
2019,481030,42,1,2,1,1
2019,481030,42,3,3,0,3
2019,481030,42,4,1,1,0
2019,481030,42,5,1,1,0
2019,481094,0,0,9,3,6
2019,481094,10,0,9,3,6
2019,481094,10,6,9,3,6
2019,481094,40,0,9,3,6
2019,481094,40,6,9,3,6
2019,481094,41,0,5,1,4
2019,481094,41,6,5,1,4
2019,481094,42,0,4,2,2
2019,481094,42,6,4,2,2
2019,481094,44,0,5,1,4
2019,481094,44,6,5,1,4
2019,481155,0,0,12,4,8
2019,481155,10,0,12,4,8
2019,481155,10,4,12,4,8
2019,481155,40,0,12,4,8
2019,481155,40,4,12,4,8
2019,481155,41,0,12,4,8
2019,481155,41,4,12,4,8
2019,481155,44,0,12,4,8
2019,481155,44,4,12,4,8
2019,481225,0,0,4,4,0
2019,481225,10,0,4,4,0
2019,481225,10,6,4,4,0
2019,481225,40,0,4,4,0
2019,481225,40,6,4,4,0
2019,481225,42,0,4,4,0
2019,481225,42,6,4,4,0
2019,481401,0,0,8,8,0
2019,481401,10,0,8,8,0
2019,481401,10,1,6,6,0
2019,481401,10,2,1,1,0
2019,481401,10,3,1,1,0
2019,481401,40,0,8,8,0
2019,481401,40,1,6,6,0
2019,481401,40,2,1,1,0
2019,481401,40,3,1,1,0
2019,481401,41,0,8,8,0
2019,481401,41,1,6,6,0
2019,481401,41,2,1,1,0
2019,481401,41,3,1,1,0
2019,481401,45,0,8,8,0
2019,481401,45,1,6,6,0
2019,481401,45,2,1,1,0
2019,481401,45,3,1,1,0
2019,482149,0,0,947,511,436
2019,482149,10,0,890,497,393
2019,482149,10,1,205,145,60
2019,482149,10,2,227,121,106
2019,482149,10,3,360,188,172
2019,482149,10,4,47,20,27
2019,482149,10,5,50,22,28
2019,482149,10,6,1,1,0
2019,482149,20,0,179,109,70
2019,482149,20,1,99,67,32
2019,482149,20,2,70,38,32
2019,482149,20,3,10,4,6
2019,482149,30,0,80,38,42
2019,482149,30,1,3,3,0
2019,482149,30,2,4,3,1
2019,482149,30,3,73,32,41
2019,482149,40,0,631,350,281
2019,482149,40,1,103,75,28
2019,482149,40,2,153,80,73
2019,482149,40,3,277,152,125
2019,482149,40,4,47,20,27
2019,482149,40,5,50,22,28
2019,482149,40,6,1,1,0
2019,482149,42,0,631,350,281
2019,482149,42,1,103,75,28
2019,482149,42,2,153,80,73
2019,482149,42,3,277,152,125
2019,482149,42,4,47,20,27
2019,482149,42,5,50,22,28
2019,482149,42,6,1,1,0
2019,482149,50,0,57,14,43
2019,482158,0,0,269,135,134
2019,482158,10,0,264,131,133
2019,482158,10,1,53,33,20
2019,482158,10,2,67,29,38
2019,482158,10,3,100,44,56
2019,482158,10,5,44,25,19
2019,482158,20,0,132,70,62
2019,482158,20,1,53,33,20
2019,482158,20,2,66,28,38
2019,482158,20,3,13,9,4
2019,482158,30,0,88,36,52
2019,482158,30,2,1,1,0
2019,482158,30,3,87,35,52
2019,482158,40,0,44,25,19
2019,482158,40,5,44,25,19
2019,482158,42,0,44,25,19
2019,482158,42,5,44,25,19
2019,482158,50,0,5,4,1
2019,482413,0,0,13,11,2
2019,482413,10,0,13,11,2
2019,482413,10,1,13,11,2
2019,482413,40,0,13,11,2
2019,482413,40,1,13,11,2
2019,482413,41,0,13,11,2
2019,482413,41,1,13,11,2
2019,482413,45,0,13,11,2
2019,482413,45,1,13,11,2
2019,482422,0,0,5,2,3
2019,482422,10,0,5,2,3
2019,482422,10,1,3,2,1
2019,482422,10,3,2,0,2
2019,482422,40,0,5,2,3
2019,482422,40,1,3,2,1
2019,482422,40,3,2,0,2
2019,482422,41,0,5,2,3
2019,482422,41,1,3,2,1
2019,482422,41,3,2,0,2
2019,482422,45,0,5,2,3
2019,482422,45,1,3,2,1
2019,482422,45,3,2,0,2
2019,482431,0,0,22,20,2
2019,482431,10,0,22,20,2
2019,482431,10,1,20,18,2
2019,482431,10,2,2,2,0
2019,482431,40,0,22,20,2
2019,482431,40,1,20,18,2
2019,482431,40,2,2,2,0
2019,482431,41,0,22,20,2
2019,482431,41,1,20,18,2
2019,482431,41,2,2,2,0
2019,482431,45,0,22,20,2
2019,482431,45,1,20,18,2
2019,482431,45,2,2,2,0
2019,482459,0,0,7,6,1
2019,482459,10,0,7,6,1
2019,482459,10,1,7,6,1
2019,482459,40,0,7,6,1
2019,482459,40,1,7,6,1
2019,482459,41,0,7,6,1
2019,482459,41,1,7,6,1
2019,482459,45,0,7,6,1
2019,482459,45,1,7,6,1
2019,482468,0,0,8,6,2
2019,482468,10,0,8,6,2
2019,482468,10,1,7,5,2
2019,482468,10,2,1,1,0
2019,482468,40,0,8,6,2
2019,482468,40,1,7,5,2
2019,482468,40,2,1,1,0
2019,482468,41,0,8,6,2
2019,482468,41,1,7,5,2
2019,482468,41,2,1,1,0
2019,482468,45,0,8,6,2
2019,482468,45,1,7,5,2
2019,482468,45,2,1,1,0
2019,482477,0,0,57,38,19
2019,482477,10,0,57,38,19
2019,482477,10,1,49,32,17
2019,482477,10,2,4,2,2
2019,482477,10,3,4,4,0
2019,482477,40,0,57,38,19
2019,482477,40,1,49,32,17
2019,482477,40,2,4,2,2
2019,482477,40,3,4,4,0
2019,482477,41,0,57,38,19
2019,482477,41,1,49,32,17
2019,482477,41,2,4,2,2
2019,482477,41,3,4,4,0
2019,482477,45,0,57,38,19
2019,482477,45,1,49,32,17
2019,482477,45,2,4,2,2
2019,482477,45,3,4,4,0
2019,482556,0,0,8,5,3
2019,482556,10,0,8,5,3
2019,482556,10,1,8,5,3
2019,482556,40,0,8,5,3
2019,482556,40,1,8,5,3
2019,482556,41,0,8,5,3
2019,482556,41,1,8,5,3
2019,482556,45,0,8,5,3
2019,482556,45,1,8,5,3
2019,482574,0,0,8,6,2
2019,482574,10,0,8,6,2
2019,482574,10,1,7,6,1
2019,482574,10,2,1,0,1
2019,482574,40,0,8,6,2
2019,482574,40,1,7,6,1
2019,482574,40,2,1,0,1
2019,482574,41,0,8,6,2
2019,482574,41,1,7,6,1
2019,482574,41,2,1,0,1
2019,482574,45,0,8,6,2
2019,482574,45,1,7,6,1
2019,482574,45,2,1,0,1
2019,482608,0,0,3,2,1
2019,482608,10,0,3,2,1
2019,482608,10,1,3,2,1
2019,482608,40,0,3,2,1
2019,482608,40,1,3,2,1
2019,482608,41,0,3,2,1
2019,482608,41,1,3,2,1
2019,482608,45,0,3,2,1
2019,482608,45,1,3,2,1
2019,482635,0,0,13,7,6
2019,482635,10,0,13,7,6
2019,482635,10,1,9,5,4
2019,482635,10,2,4,2,2
2019,482635,40,0,13,7,6
2019,482635,40,1,9,5,4
2019,482635,40,2,4,2,2
2019,482635,41,0,13,7,6
2019,482635,41,1,9,5,4
2019,482635,41,2,4,2,2
2019,482635,45,0,13,7,6
2019,482635,45,1,9,5,4
2019,482635,45,2,4,2,2
2019,482653,0,0,3,2,1
2019,482653,10,0,3,2,1
2019,482653,10,1,2,1,1
2019,482653,10,2,1,1,0
2019,482653,40,0,3,2,1
2019,482653,40,1,2,1,1
2019,482653,40,2,1,1,0
2019,482653,41,0,3,2,1
2019,482653,41,1,2,1,1
2019,482653,41,2,1,1,0
2019,482653,45,0,3,2,1
2019,482653,45,1,2,1,1
2019,482653,45,2,1,1,0
2019,482680,0,0,740,365,375
2019,482680,10,0,740,365,375
2019,482680,10,1,127,80,47
2019,482680,10,2,141,79,62
2019,482680,10,3,237,114,123
2019,482680,10,5,171,65,106
2019,482680,10,6,64,27,37
2019,482680,20,0,270,159,111
2019,482680,20,1,125,79,46
2019,482680,20,2,127,72,55
2019,482680,20,3,18,8,10
2019,482680,30,0,219,110,109
2019,482680,30,1,1,0,1
2019,482680,30,2,14,7,7
2019,482680,30,3,204,103,101
2019,482680,40,0,251,96,155
2019,482680,40,1,1,1,0
2019,482680,40,3,15,3,12
2019,482680,40,5,171,65,106
2019,482680,40,6,64,27,37
2019,482680,42,0,251,96,155
2019,482680,42,1,1,1,0
2019,482680,42,3,15,3,12
2019,482680,42,5,171,65,106
2019,482680,42,6,64,27,37
2019,482699,0,0,64,33,31
2019,482699,10,0,64,33,31
2019,482699,10,1,9,4,5
2019,482699,10,2,12,5,7
2019,482699,10,3,23,10,13
2019,482699,10,4,9,7,2
2019,482699,10,5,11,7,4
2019,482699,20,0,20,8,12
2019,482699,20,1,9,4,5
2019,482699,20,2,9,3,6
2019,482699,20,3,2,1,1
2019,482699,30,0,30,17,13
2019,482699,30,2,3,2,1
2019,482699,30,3,21,9,12
2019,482699,30,4,6,6,0
2019,482699,40,0,14,8,6
2019,482699,40,4,3,1,2
2019,482699,40,5,11,7,4
2019,482699,42,0,14,8,6
2019,482699,42,4,3,1,2
2019,482699,42,5,11,7,4
2019,482705,0,0,118,46,72
2019,482705,10,0,117,46,71
2019,482705,10,1,7,4,3
2019,482705,10,2,46,15,31
2019,482705,10,3,39,15,24
2019,482705,10,4,22,11,11
2019,482705,10,5,1,0,1
2019,482705,10,6,2,1,1
2019,482705,40,0,117,46,71
2019,482705,40,1,7,4,3
2019,482705,40,2,46,15,31
2019,482705,40,3,39,15,24
2019,482705,40,4,22,11,11
2019,482705,40,5,1,0,1
2019,482705,40,6,2,1,1
2019,482705,41,0,6,4,2
2019,482705,41,2,3,3,0
2019,482705,41,4,3,1,2
2019,482705,42,0,111,42,69
2019,482705,42,1,7,4,3
2019,482705,42,2,43,12,31
2019,482705,42,3,39,15,24
2019,482705,42,4,19,10,9
2019,482705,42,5,1,0,1
2019,482705,42,6,2,1,1
2019,482705,44,0,6,4,2
2019,482705,44,2,3,3,0
2019,482705,44,4,3,1,2
2019,482705,50,0,1,0,1
2019,482936,0,0,75,55,20
2019,482936,10,0,75,55,20
2019,482936,10,1,4,3,1
2019,482936,10,2,13,11,2
2019,482936,10,3,49,35,14
2019,482936,10,4,9,6,3
2019,482936,40,0,75,55,20
2019,482936,40,1,4,3,1
2019,482936,40,2,13,11,2
2019,482936,40,3,49,35,14
2019,482936,40,4,9,6,3
2019,482936,41,0,72,53,19
2019,482936,41,1,4,3,1
2019,482936,41,2,13,11,2
2019,482936,41,3,46,33,13
2019,482936,41,4,9,6,3
2019,482936,43,0,3,2,1
2019,482936,43,3,3,2,1
2019,482936,44,0,63,47,16
2019,482936,44,1,4,3,1
2019,482936,44,2,13,11,2
2019,482936,44,3,46,33,13
2019,482936,45,0,9,6,3
2019,482936,45,4,9,6,3
2019,482990,0,0,2,1,1
2019,482990,10,0,2,1,1
2019,482990,10,4,2,1,1
2019,482990,40,0,2,1,1
2019,482990,40,4,2,1,1
2019,482990,41,0,2,1,1
2019,482990,41,4,2,1,1
2019,482990,45,0,2,1,1
2019,482990,45,4,2,1,1
2019,483018,0,0,22,11,11
2019,483018,10,0,22,11,11
2019,483018,10,2,4,1,3
2019,483018,10,3,17,10,7
2019,483018,10,4,1,0,1
2019,483018,20,0,3,1,2
2019,483018,20,2,3,1,2
2019,483018,30,0,7,5,2
2019,483018,30,2,1,0,1
2019,483018,30,3,6,5,1
2019,483018,40,0,12,5,7
2019,483018,40,3,11,5,6
2019,483018,40,4,1,0,1
2019,483018,41,0,6,2,4
2019,483018,41,3,5,2,3
2019,483018,41,4,1,0,1
2019,483018,42,0,6,3,3
2019,483018,42,3,6,3,3
2019,483018,45,0,6,2,4
2019,483018,45,3,5,2,3
2019,483018,45,4,1,0,1
2019,483036,0,0,87,42,45
2019,483036,10,0,87,42,45
2019,483036,10,1,5,5,0
2019,483036,10,2,23,8,15
2019,483036,10,3,41,23,18
2019,483036,10,4,1,0,1
2019,483036,10,5,17,6,11
2019,483036,20,0,22,12,10
2019,483036,20,1,5,5,0
2019,483036,20,2,17,7,10
2019,483036,30,0,41,22,19
2019,483036,30,2,4,1,3
2019,483036,30,3,35,20,15
2019,483036,30,5,2,1,1
2019,483036,40,0,24,8,16
2019,483036,40,2,2,0,2
2019,483036,40,3,6,3,3
2019,483036,40,4,1,0,1
2019,483036,40,5,15,5,10
2019,483036,42,0,11,1,10
2019,483036,42,3,3,0,3
2019,483036,42,4,1,0,1
2019,483036,42,5,7,1,6
2019,483036,43,0,13,7,6
2019,483036,43,2,2,0,2
2019,483036,43,3,3,3,0
2019,483036,43,5,8,4,4
2019,483045,0,0,214,92,122
2019,483045,10,0,204,84,120
2019,483045,10,6,204,84,120
2019,483045,40,0,204,84,120
2019,483045,40,6,204,84,120
2019,483045,42,0,201,83,118
2019,483045,42,6,201,83,118
2019,483045,43,0,3,1,2
2019,483045,43,6,3,1,2
2019,483045,50,0,10,8,2
2019,483124,0,0,876,410,466
2019,483124,10,0,876,410,466
2019,483124,10,1,147,101,46
2019,483124,10,2,162,76,86
2019,483124,10,3,146,65,81
2019,483124,10,4,162,59,103
2019,483124,10,5,258,109,149
2019,483124,10,6,1,0,1
2019,483124,20,0,232,139,93
2019,483124,20,1,118,84,34
2019,483124,20,2,114,55,59
2019,483124,30,0,75,38,37
2019,483124,30,1,1,1,0
2019,483124,30,2,3,0,3
2019,483124,30,3,71,37,34
2019,483124,40,0,569,233,336
2019,483124,40,1,28,16,12
2019,483124,40,2,45,21,24
2019,483124,40,3,75,28,47
2019,483124,40,4,162,59,103
2019,483124,40,5,258,109,149
2019,483124,40,6,1,0,1
2019,483124,41,0,72,31,41
2019,483124,41,1,6,2,4
2019,483124,41,2,7,6,1
2019,483124,41,3,3,0,3
2019,483124,41,5,56,23,33
2019,483124,42,0,496,202,294
2019,483124,42,1,22,14,8
2019,483124,42,2,38,15,23
2019,483124,42,3,72,28,44
2019,483124,42,4,162,59,103
2019,483124,42,5,202,86,116
2019,483124,43,0,1,0,1
2019,483124,43,6,1,0,1
2019,483124,44,0,72,31,41
2019,483124,44,1,6,2,4
2019,483124,44,2,7,6,1
2019,483124,44,3,3,0,3
2019,483124,44,5,56,23,33
2019,483212,0,0,91,41,50
2019,483212,10,0,91,41,50
2019,483212,10,1,1,0,1
2019,483212,10,2,7,2,5
2019,483212,10,3,9,3,6
2019,483212,10,4,73,35,38
2019,483212,10,6,1,1,0
2019,483212,20,0,2,0,2
2019,483212,20,1,1,0,1
2019,483212,20,4,1,0,1
2019,483212,40,0,89,41,48
2019,483212,40,2,7,2,5
2019,483212,40,3,9,3,6
2019,483212,40,4,72,35,37
2019,483212,40,6,1,1,0
2019,483212,42,0,89,41,48
2019,483212,42,2,7,2,5
2019,483212,42,3,9,3,6
2019,483212,42,4,72,35,37
2019,483212,42,6,1,1,0
2019,483595,0,0,1,1,0
2019,483595,10,0,1,1,0
2019,483595,10,3,1,1,0
2019,483595,40,0,1,1,0
2019,483595,40,3,1,1,0
2019,483595,42,0,1,1,0
2019,483595,42,3,1,1,0
2019,483780,0,0,3,3,0
2019,483780,10,0,3,3,0
2019,483780,10,1,3,3,0
2019,483780,40,0,3,3,0
2019,483780,40,1,3,3,0
2019,483780,41,0,3,3,0
2019,483780,41,1,3,3,0
2019,483780,44,0,3,3,0
2019,483780,44,1,3,3,0
2019,483814,0,0,7,0,7
2019,483814,10,0,7,0,7
2019,483814,10,4,7,0,7
2019,483814,40,0,7,0,7
2019,483814,40,4,7,0,7
2019,483814,41,0,7,0,7
2019,483814,41,4,7,0,7
2019,483814,45,0,7,0,7
2019,483814,45,4,7,0,7
2019,483975,0,0,31,19,12
2019,483975,10,0,31,19,12
2019,483975,10,1,3,3,0
2019,483975,10,2,11,7,4
2019,483975,10,3,12,8,4
2019,483975,10,4,5,1,4
2019,483975,40,0,31,19,12
2019,483975,40,1,3,3,0
2019,483975,40,2,11,7,4
2019,483975,40,3,12,8,4
2019,483975,40,4,5,1,4
2019,483975,41,0,31,19,12
2019,483975,41,1,3,3,0
2019,483975,41,2,11,7,4
2019,483975,41,3,12,8,4
2019,483975,41,4,5,1,4
2019,483975,44,0,31,19,12
2019,483975,44,1,3,3,0
2019,483975,44,2,11,7,4
2019,483975,44,3,12,8,4
2019,483975,44,4,5,1,4
2019,484002,0,0,26,5,21
2019,484002,10,0,26,5,21
2019,484002,10,4,26,5,21
2019,484002,40,0,26,5,21
2019,484002,40,4,26,5,21
2019,484002,41,0,26,5,21
2019,484002,41,4,26,5,21
2019,484002,45,0,26,5,21
2019,484002,45,4,26,5,21
2019,484066,0,0,23,1,22
2019,484066,10,0,23,1,22
2019,484066,10,4,23,1,22
2019,484066,40,0,23,1,22
2019,484066,40,4,23,1,22
2019,484066,41,0,23,1,22
2019,484066,41,4,23,1,22
2019,484066,45,0,23,1,22
2019,484066,45,4,23,1,22
2019,484473,0,0,10,3,7
2019,484473,10,0,10,3,7
2019,484473,10,5,6,2,4
2019,484473,10,6,4,1,3
2019,484473,40,0,10,3,7
2019,484473,40,5,6,2,4
2019,484473,40,6,4,1,3
2019,484473,42,0,10,3,7
2019,484473,42,5,6,2,4
2019,484473,42,6,4,1,3
2019,484613,0,0,127,28,99
2019,484613,10,0,127,28,99
2019,484613,10,6,127,28,99
2019,484613,40,0,127,28,99
2019,484613,40,6,127,28,99
2019,484613,41,0,127,28,99
2019,484613,41,6,127,28,99
2019,484613,45,0,127,28,99
2019,484613,45,6,127,28,99
2019,484835,0,0,1,1,0
2019,484835,10,0,1,1,0
2019,484835,10,1,1,1,0
2019,484835,20,0,1,1,0
2019,484835,20,1,1,1,0
2019,484862,0,0,6,5,1
2019,484862,10,0,6,5,1
2019,484862,10,1,6,5,1
2019,484862,40,0,6,5,1
2019,484862,40,1,6,5,1
2019,484862,42,0,1,1,0
2019,484862,42,1,1,1,0
2019,484862,43,0,5,4,1
2019,484862,43,1,5,4,1
2019,484905,0,0,121,56,65
2019,484905,10,0,115,54,61
2019,484905,10,1,10,5,5
2019,484905,10,2,19,11,8
2019,484905,10,3,33,16,17
2019,484905,10,4,10,3,7
2019,484905,10,5,43,19,24
2019,484905,20,0,25,13,12
2019,484905,20,1,9,4,5
2019,484905,20,2,16,9,7
2019,484905,30,0,33,17,16
2019,484905,30,2,3,2,1
2019,484905,30,3,30,15,15
2019,484905,40,0,57,24,33
2019,484905,40,1,1,1,0
2019,484905,40,3,3,1,2
2019,484905,40,4,10,3,7
2019,484905,40,5,43,19,24
2019,484905,42,0,57,24,33
2019,484905,42,1,1,1,0
2019,484905,42,3,3,1,2
2019,484905,42,4,10,3,7
2019,484905,42,5,43,19,24
2019,484905,50,0,6,2,4
2019,484932,0,0,89,31,58
2019,484932,10,0,74,28,46
2019,484932,10,1,16,6,10
2019,484932,10,2,20,7,13
2019,484932,10,3,23,8,15
2019,484932,10,4,15,7,8
2019,484932,40,0,74,28,46
2019,484932,40,1,16,6,10
2019,484932,40,2,20,7,13
2019,484932,40,3,23,8,15
2019,484932,40,4,15,7,8
2019,484932,42,0,74,28,46
2019,484932,42,1,16,6,10
2019,484932,42,2,20,7,13
2019,484932,42,3,23,8,15
2019,484932,42,4,15,7,8
2019,484932,50,0,15,3,12
2019,485111,0,0,130,60,70
2019,485111,10,0,130,60,70
2019,485111,10,1,36,19,17
2019,485111,10,2,16,8,8
2019,485111,10,3,78,33,45
2019,485111,40,0,130,60,70
2019,485111,40,1,36,19,17
2019,485111,40,2,16,8,8
2019,485111,40,3,78,33,45
2019,485111,42,0,130,60,70
2019,485111,42,1,36,19,17
2019,485111,42,2,16,8,8
2019,485111,42,3,78,33,45
2019,485139,0,0,4,4,0
2019,485139,10,0,4,4,0
2019,485139,10,4,4,4,0
2019,485139,40,0,4,4,0
2019,485139,40,4,4,4,0
2019,485139,41,0,4,4,0
2019,485139,41,4,4,4,0
2019,485139,45,0,4,4,0
2019,485139,45,4,4,4,0
2019,485263,0,0,14,7,7
2019,485263,10,0,14,7,7
2019,485263,10,6,14,7,7
2019,485263,40,0,14,7,7
2019,485263,40,6,14,7,7
2019,485263,41,0,14,7,7
2019,485263,41,6,14,7,7
2019,485263,45,0,14,7,7
2019,485263,45,6,14,7,7
2019,485272,0,0,27,6,21
2019,485272,10,0,27,6,21
2019,485272,10,2,2,1,1
2019,485272,10,4,25,5,20
2019,485272,40,0,27,6,21
2019,485272,40,2,2,1,1
2019,485272,40,4,25,5,20
2019,485272,41,0,27,6,21
2019,485272,41,2,2,1,1
2019,485272,41,4,25,5,20
2019,485272,45,0,27,6,21
2019,485272,45,2,2,1,1
2019,485272,45,4,25,5,20
2019,485458,0,0,89,40,49
2019,485458,10,0,89,40,49
2019,485458,10,6,89,40,49
2019,485458,40,0,89,40,49
2019,485458,40,6,89,40,49
2019,485458,41,0,79,36,43
2019,485458,41,6,79,36,43
2019,485458,43,0,10,4,6
2019,485458,43,6,10,4,6
2019,485458,45,0,79,36,43
2019,485458,45,6,79,36,43
2019,485537,0,0,69,44,25
2019,485537,10,0,44,26,18
2019,485537,10,1,13,11,2
2019,485537,10,2,15,7,8
2019,485537,10,3,13,7,6
2019,485537,10,4,3,1,2
2019,485537,20,0,10,10,0
2019,485537,20,1,9,9,0
2019,485537,20,2,1,1,0
2019,485537,30,0,17,10,7
2019,485537,30,1,4,2,2
2019,485537,30,2,6,4,2
2019,485537,30,3,7,4,3
2019,485537,40,0,17,6,11
2019,485537,40,2,8,2,6
2019,485537,40,3,6,3,3
2019,485537,40,4,3,1,2
2019,485537,42,0,17,6,11
2019,485537,42,2,8,2,6
2019,485537,42,3,6,3,3
2019,485537,42,4,3,1,2
2019,485537,50,0,25,18,7
2019,485546,0,0,3,3,0
2019,485546,50,0,3,3,0
2019,485698,0,0,10,9,1
2019,485698,10,0,10,9,1
2019,485698,10,1,10,9,1
2019,485698,40,0,10,9,1
2019,485698,40,1,10,9,1
2019,485698,42,0,10,9,1
2019,485698,42,1,10,9,1
2019,485768,0,0,4,2,2
2019,485768,10,0,4,2,2
2019,485768,10,1,3,1,2
2019,485768,10,4,1,1,0
2019,485768,40,0,4,2,2
2019,485768,40,1,3,1,2
2019,485768,40,4,1,1,0
2019,485768,41,0,4,2,2
2019,485768,41,1,3,1,2
2019,485768,41,4,1,1,0
2019,485768,44,0,4,2,2
2019,485768,44,1,3,1,2
2019,485768,44,4,1,1,0
2019,485999,0,0,12,12,0
2019,485999,10,0,12,12,0
2019,485999,10,4,12,12,0
2019,485999,40,0,12,12,0
2019,485999,40,4,12,12,0
2019,485999,42,0,12,12,0
2019,485999,42,4,12,12,0
2019,486053,0,0,13,13,0
2019,486053,10,0,13,13,0
2019,486053,10,1,1,1,0
2019,486053,10,2,2,2,0
2019,486053,10,3,9,9,0
2019,486053,10,4,1,1,0
2019,486053,40,0,13,13,0
2019,486053,40,1,1,1,0
2019,486053,40,2,2,2,0
2019,486053,40,3,9,9,0
2019,486053,40,4,1,1,0
2019,486053,41,0,13,13,0
2019,486053,41,1,1,1,0
2019,486053,41,2,2,2,0
2019,486053,41,3,9,9,0
2019,486053,41,4,1,1,0
2019,486053,45,0,13,13,0
2019,486053,45,1,1,1,0
2019,486053,45,2,2,2,0
2019,486053,45,3,9,9,0
2019,486053,45,4,1,1,0
2019,486080,0,0,42,29,13
2019,486080,10,0,42,29,13
2019,486080,10,1,31,21,10
2019,486080,10,2,9,6,3
2019,486080,10,3,2,2,0
2019,486080,40,0,42,29,13
2019,486080,40,1,31,21,10
2019,486080,40,2,9,6,3
2019,486080,40,3,2,2,0
2019,486080,41,0,42,29,13
2019,486080,41,1,31,21,10
2019,486080,41,2,9,6,3
2019,486080,41,3,2,2,0
2019,486080,45,0,42,29,13
2019,486080,45,1,31,21,10
2019,486080,45,2,9,6,3
2019,486080,45,3,2,2,0
2019,486196,0,0,10,10,0
2019,486196,10,0,10,10,0
2019,486196,10,4,10,10,0
2019,486196,40,0,10,10,0
2019,486196,40,4,10,10,0
2019,486196,42,0,10,10,0
2019,486196,42,4,10,10,0
2019,486257,0,0,5,4,1
2019,486257,10,0,5,4,1
2019,486257,10,1,1,1,0
2019,486257,10,3,4,3,1
2019,486257,40,0,5,4,1
2019,486257,40,1,1,1,0
2019,486257,40,3,4,3,1
2019,486257,41,0,5,4,1
2019,486257,41,1,1,1,0
2019,486257,41,3,4,3,1
2019,486257,45,0,5,4,1
2019,486257,45,1,1,1,0
2019,486257,45,3,4,3,1
2019,486284,0,0,6,5,1
2019,486284,10,0,6,5,1
2019,486284,10,6,6,5,1
2019,486284,40,0,6,5,1
2019,486284,40,6,6,5,1
2019,486284,41,0,6,5,1
2019,486284,41,6,6,5,1
2019,486284,45,0,6,5,1
2019,486284,45,6,6,5,1
2019,486433,0,0,5,3,2
2019,486433,10,0,5,3,2
2019,486433,10,4,5,3,2
2019,486433,40,0,5,3,2
2019,486433,40,4,5,3,2
2019,486433,41,0,5,3,2
2019,486433,41,4,5,3,2
2019,486433,44,0,5,3,2
2019,486433,44,4,5,3,2
2019,486813,0,0,26,10,16
2019,486813,10,0,26,10,16
2019,486813,10,4,26,10,16
2019,486813,40,0,26,10,16
2019,486813,40,4,26,10,16
2019,486813,41,0,26,10,16
2019,486813,41,4,26,10,16
2019,486813,45,0,26,10,16
2019,486813,45,4,26,10,16
2019,486822,0,0,28,5,23
2019,486822,10,0,28,5,23
2019,486822,10,4,28,5,23
2019,486822,40,0,28,5,23
2019,486822,40,4,28,5,23
2019,486822,41,0,28,5,23
2019,486822,41,4,28,5,23
2019,486822,45,0,28,5,23
2019,486822,45,4,28,5,23
2019,486840,0,0,1178,602,576
2019,486840,10,0,1178,602,576
2019,486840,10,1,262,161,101
2019,486840,10,2,281,151,130
2019,486840,10,3,344,179,165
2019,486840,10,4,51,15,36
2019,486840,10,5,240,96,144
2019,486840,20,0,553,316,237
2019,486840,20,1,260,160,100
2019,486840,20,2,274,146,128
2019,486840,20,3,19,10,9
2019,486840,30,0,229,124,105
2019,486840,30,2,4,2,2
2019,486840,30,3,225,122,103
2019,486840,40,0,396,162,234
2019,486840,40,1,2,1,1
2019,486840,40,2,3,3,0
2019,486840,40,3,100,47,53
2019,486840,40,4,51,15,36
2019,486840,40,5,240,96,144
2019,486840,41,0,2,0,2
2019,486840,41,1,1,0,1
2019,486840,41,5,1,0,1
2019,486840,42,0,394,162,232
2019,486840,42,1,1,1,0
2019,486840,42,2,3,3,0
2019,486840,42,3,100,47,53
2019,486840,42,4,51,15,36
2019,486840,42,5,239,96,143
2019,486840,45,0,2,0,2
2019,486840,45,1,1,0,1
2019,486840,45,5,1,0,1
2019,486901,0,0,92,50,42
2019,486901,10,0,92,50,42
2019,486901,10,1,33,23,10
2019,486901,10,2,31,13,18
2019,486901,10,3,24,12,12
2019,486901,10,4,4,2,2
2019,486901,20,0,62,35,27
2019,486901,20,1,32,22,10
2019,486901,20,2,30,13,17
2019,486901,30,0,23,12,11
2019,486901,30,1,1,1,0
2019,486901,30,2,1,0,1
2019,486901,30,3,21,11,10
2019,486901,40,0,7,3,4
2019,486901,40,3,3,1,2
2019,486901,40,4,4,2,2
2019,486901,42,0,7,3,4
2019,486901,42,3,3,1,2
2019,486901,42,4,4,2,2
2019,486938,0,0,10,1,9
2019,486938,10,0,10,1,9
2019,486938,10,3,6,0,6
2019,486938,10,4,4,1,3
2019,486938,40,0,10,1,9
2019,486938,40,3,6,0,6
2019,486938,40,4,4,1,3
2019,486938,41,0,10,1,9
2019,486938,41,3,6,0,6
2019,486938,41,4,4,1,3
2019,486938,45,0,10,1,9
2019,486938,45,3,6,0,6
2019,486938,45,4,4,1,3
2019,486947,0,0,9,0,9
2019,486947,10,0,9,0,9
2019,486947,10,3,4,0,4
2019,486947,10,4,5,0,5
2019,486947,40,0,9,0,9
2019,486947,40,3,4,0,4
2019,486947,40,4,5,0,5
2019,486947,41,0,9,0,9
2019,486947,41,3,4,0,4
2019,486947,41,4,5,0,5
2019,486947,45,0,9,0,9
2019,486947,45,3,4,0,4
2019,486947,45,4,5,0,5
2019,486956,0,0,17,0,17
2019,486956,10,0,17,0,17
2019,486956,10,2,1,0,1
2019,486956,10,3,4,0,4
2019,486956,10,4,12,0,12
2019,486956,40,0,17,0,17
2019,486956,40,2,1,0,1
2019,486956,40,3,4,0,4
2019,486956,40,4,12,0,12
2019,486956,41,0,17,0,17
2019,486956,41,2,1,0,1
2019,486956,41,3,4,0,4
2019,486956,41,4,12,0,12
2019,486956,45,0,17,0,17
2019,486956,45,2,1,0,1
2019,486956,45,3,4,0,4
2019,486956,45,4,12,0,12
2019,486965,0,0,8,6,2
2019,486965,10,0,8,6,2
2019,486965,10,6,8,6,2
2019,486965,40,0,8,6,2
2019,486965,40,6,8,6,2
2019,486965,41,0,8,6,2
2019,486965,41,6,8,6,2
2019,486965,45,0,8,6,2
2019,486965,45,6,8,6,2
2019,487010,0,0,1319,781,538
2019,487010,10,0,1319,781,538
2019,487010,10,1,300,227,73
2019,487010,10,2,336,206,130
2019,487010,10,3,606,325,281
2019,487010,10,4,77,23,54
2019,487010,20,0,301,213,88
2019,487010,20,1,200,153,47
2019,487010,20,2,99,60,39
2019,487010,20,3,2,0,2
2019,487010,30,0,72,39,33
2019,487010,30,1,7,4,3
2019,487010,30,2,12,8,4
2019,487010,30,3,53,27,26
2019,487010,40,0,946,529,417
2019,487010,40,1,93,70,23
2019,487010,40,2,225,138,87
2019,487010,40,3,551,298,253
2019,487010,40,4,77,23,54
2019,487010,42,0,946,529,417
2019,487010,42,1,93,70,23
2019,487010,42,2,225,138,87
2019,487010,42,3,551,298,253
2019,487010,42,4,77,23,54
2019,487092,0,0,93,44,49
2019,487092,10,0,92,43,49
2019,487092,10,1,14,5,9
2019,487092,10,2,25,12,13
2019,487092,10,3,35,17,18
2019,487092,10,4,1,1,0
2019,487092,10,5,17,8,9
2019,487092,20,0,34,15,19
2019,487092,20,1,10,4,6
2019,487092,20,2,24,11,13
2019,487092,30,0,26,12,14
2019,487092,30,1,2,1,1
2019,487092,30,2,1,1,0
2019,487092,30,3,23,10,13
2019,487092,40,0,32,16,16
2019,487092,40,1,2,0,2
2019,487092,40,3,12,7,5
2019,487092,40,4,1,1,0
2019,487092,40,5,17,8,9
2019,487092,41,0,16,5,11
2019,487092,41,1,2,0,2
2019,487092,41,5,14,5,9
2019,487092,43,0,16,11,5
2019,487092,43,3,12,7,5
2019,487092,43,4,1,1,0
2019,487092,43,5,3,3,0
2019,487092,44,0,16,5,11
2019,487092,44,1,2,0,2
2019,487092,44,5,14,5,9
2019,487092,50,0,1,1,0
2019,487162,0,0,151,56,95
2019,487162,10,0,151,56,95
2019,487162,10,6,151,56,95
2019,487162,40,0,151,56,95
2019,487162,40,6,151,56,95
2019,487162,41,0,151,56,95
2019,487162,41,6,151,56,95
2019,487162,45,0,151,56,95
2019,487162,45,6,151,56,95
2019,487296,0,0,19,8,11
2019,487296,10,0,19,8,11
2019,487296,10,1,3,1,2
2019,487296,10,2,1,1,0
2019,487296,10,3,14,6,8
2019,487296,10,5,1,0,1
2019,487296,20,0,3,1,2
2019,487296,20,1,2,0,2
2019,487296,20,2,1,1,0
2019,487296,30,0,1,0,1
2019,487296,30,3,1,0,1
2019,487296,40,0,15,7,8
2019,487296,40,1,1,1,0
2019,487296,40,3,13,6,7
2019,487296,40,5,1,0,1
2019,487296,42,0,15,7,8
2019,487296,42,1,1,1,0
2019,487296,42,3,13,6,7
2019,487296,42,5,1,0,1
2019,487302,0,0,10,3,7
2019,487302,10,0,10,3,7
2019,487302,10,4,10,3,7
2019,487302,40,0,10,3,7
2019,487302,40,4,10,3,7
2019,487302,41,0,10,3,7
2019,487302,41,4,10,3,7
2019,487302,45,0,10,3,7
2019,487302,45,4,10,3,7
2019,487311,0,0,29,27,2
2019,487311,10,0,29,27,2
2019,487311,10,4,29,27,2
2019,487311,40,0,29,27,2
2019,487311,40,4,29,27,2
2019,487311,41,0,29,27,2
2019,487311,41,4,29,27,2
2019,487311,45,0,29,27,2
2019,487311,45,4,29,27,2
2019,487320,0,0,526,376,150
2019,487320,10,0,526,376,150
2019,487320,10,1,5,4,1
2019,487320,10,2,32,17,15
2019,487320,10,4,489,355,134
2019,487320,40,0,526,376,150
2019,487320,40,1,5,4,1
2019,487320,40,2,32,17,15
2019,487320,40,4,489,355,134
2019,487320,42,0,487,353,134
2019,487320,42,1,5,4,1
2019,487320,42,2,30,16,14
2019,487320,42,4,452,333,119
2019,487320,43,0,39,23,16
2019,487320,43,2,2,1,1
2019,487320,43,4,37,22,15
2019,487375,0,0,19,5,14
2019,487375,10,0,19,5,14
2019,487375,10,4,19,5,14
2019,487375,40,0,19,5,14
2019,487375,40,4,19,5,14
2019,487375,41,0,19,5,14
2019,487375,41,4,19,5,14
2019,487375,45,0,19,5,14
2019,487375,45,4,19,5,14
2019,487384,0,0,2,0,2
2019,487384,50,0,2,0,2
2019,487393,0,0,11,5,6
2019,487393,50,0,11,5,6
2019,487409,0,0,2,0,2
2019,487409,50,0,2,0,2
2019,487418,0,0,8,3,5
2019,487418,50,0,8,3,5
2019,487427,0,0,5,4,1
2019,487427,50,0,5,4,1
2019,487436,0,0,2,0,2
2019,487436,50,0,2,0,2
2019,487445,0,0,6,1,5
2019,487445,50,0,6,1,5
2019,487454,0,0,5,3,2
2019,487454,50,0,5,3,2
2019,487472,0,0,11,7,4
2019,487472,50,0,11,7,4
2019,487490,0,0,11,7,4
2019,487490,50,0,11,7,4
2019,487524,0,0,132,69,63
2019,487524,10,0,132,69,63
2019,487524,10,1,11,6,5
2019,487524,10,2,40,22,18
2019,487524,10,3,52,26,26
2019,487524,10,4,29,15,14
2019,487524,40,0,132,69,63
2019,487524,40,1,11,6,5
2019,487524,40,2,40,22,18
2019,487524,40,3,52,26,26
2019,487524,40,4,29,15,14
2019,487524,41,0,59,33,26
2019,487524,41,1,11,6,5
2019,487524,41,2,32,19,13
2019,487524,41,3,12,7,5
2019,487524,41,4,4,1,3
2019,487524,42,0,73,36,37
2019,487524,42,2,8,3,5
2019,487524,42,3,40,19,21
2019,487524,42,4,25,14,11
2019,487524,44,0,59,33,26
2019,487524,44,1,11,6,5
2019,487524,44,2,32,19,13
2019,487524,44,3,12,7,5
2019,487524,44,4,4,1,3
2019,487588,0,0,4,0,4
2019,487588,10,0,4,0,4
2019,487588,10,4,4,0,4
2019,487588,40,0,4,0,4
2019,487588,40,4,4,0,4
2019,487588,41,0,4,0,4
2019,487588,41,4,4,0,4
2019,487588,45,0,4,0,4
2019,487588,45,4,4,0,4
2019,487597,0,0,37,35,2
2019,487597,50,0,37,35,2
2019,487603,0,0,3,1,2
2019,487603,10,0,3,1,2
2019,487603,10,2,2,1,1
2019,487603,10,4,1,0,1
2019,487603,30,0,2,1,1
2019,487603,30,2,2,1,1
2019,487603,40,0,1,0,1
2019,487603,40,4,1,0,1
2019,487603,42,0,1,0,1
2019,487603,42,4,1,0,1
2019,487649,0,0,3,3,0
2019,487649,10,0,3,3,0
2019,487649,10,1,3,3,0
2019,487649,40,0,3,3,0
2019,487649,40,1,3,3,0
2019,487649,41,0,3,3,0
2019,487649,41,1,3,3,0
2019,487649,45,0,3,3,0
2019,487649,45,1,3,3,0
2019,487861,0,0,6,1,5
2019,487861,10,0,6,1,5
2019,487861,10,4,6,1,5
2019,487861,40,0,6,1,5
2019,487861,40,4,6,1,5
2019,487861,41,0,6,1,5
2019,487861,41,4,6,1,5
2019,487861,45,0,6,1,5
2019,487861,45,4,6,1,5
2019,487977,0,0,12,2,10
2019,487977,10,0,12,2,10
2019,487977,10,4,12,2,10
2019,487977,40,0,12,2,10
2019,487977,40,4,12,2,10
2019,487977,41,0,12,2,10
2019,487977,41,4,12,2,10
2019,487977,45,0,12,2,10
2019,487977,45,4,12,2,10
2019,488077,0,0,25,23,2
2019,488077,10,0,25,23,2
2019,488077,10,6,25,23,2
2019,488077,40,0,25,23,2
2019,488077,40,6,25,23,2
2019,488077,41,0,25,23,2
2019,488077,41,6,25,23,2
2019,488077,45,0,25,23,2
2019,488077,45,6,25,23,2
2019,488305,0,0,3,3,0
2019,488305,10,0,3,3,0
2019,488305,10,4,3,3,0
2019,488305,40,0,3,3,0
2019,488305,40,4,3,3,0
2019,488305,41,0,3,3,0
2019,488305,41,4,3,3,0
2019,488305,44,0,3,3,0
2019,488305,44,4,3,3,0
2019,488527,0,0,26,18,8
2019,488527,10,0,26,18,8
2019,488527,10,1,3,3,0
2019,488527,10,2,6,5,1
2019,488527,10,3,16,10,6
2019,488527,10,4,1,0,1
2019,488527,40,0,26,18,8
2019,488527,40,1,3,3,0
2019,488527,40,2,6,5,1
2019,488527,40,3,16,10,6
2019,488527,40,4,1,0,1
2019,488527,41,0,2,2,0
2019,488527,41,1,1,1,0
2019,488527,41,2,1,1,0
2019,488527,42,0,24,16,8
2019,488527,42,1,2,2,0
2019,488527,42,2,5,4,1
2019,488527,42,3,16,10,6
2019,488527,42,4,1,0,1
2019,488527,44,0,2,2,0
2019,488527,44,1,1,1,0
2019,488527,44,2,1,1,0
2019,488554,0,0,20,14,6
2019,488554,10,0,20,14,6
2019,488554,10,1,2,1,1
2019,488554,10,2,10,7,3
2019,488554,10,3,6,5,1
2019,488554,10,4,2,1,1
2019,488554,40,0,20,14,6
2019,488554,40,1,2,1,1
2019,488554,40,2,10,7,3
2019,488554,40,3,6,5,1
2019,488554,40,4,2,1,1
2019,488554,41,0,20,14,6
2019,488554,41,1,2,1,1
2019,488554,41,2,10,7,3
2019,488554,41,3,6,5,1
2019,488554,41,4,2,1,1
2019,488554,44,0,20,14,6
2019,488554,44,1,2,1,1
2019,488554,44,2,10,7,3
2019,488554,44,3,6,5,1
2019,488554,44,4,2,1,1
2019,488572,0,0,48,27,21
2019,488572,10,0,48,27,21
2019,488572,10,1,10,6,4
2019,488572,10,2,14,9,5
2019,488572,10,3,21,11,10
2019,488572,10,4,3,1,2
2019,488572,40,0,48,27,21
2019,488572,40,1,10,6,4
2019,488572,40,2,14,9,5
2019,488572,40,3,21,11,10
2019,488572,40,4,3,1,2
2019,488572,41,0,14,10,4
2019,488572,41,1,5,3,2
2019,488572,41,2,7,6,1
2019,488572,41,3,2,1,1
2019,488572,42,0,34,17,17
2019,488572,42,1,5,3,2
2019,488572,42,2,7,3,4
2019,488572,42,3,19,10,9
2019,488572,42,4,3,1,2
2019,488572,44,0,14,10,4
2019,488572,44,1,5,3,2
2019,488572,44,2,7,6,1
2019,488572,44,3,2,1,1
2019,488730,0,0,76,30,46
2019,488730,10,0,70,28,42
2019,488730,10,1,15,9,6
2019,488730,10,2,18,3,15
2019,488730,10,3,18,8,10
2019,488730,10,4,19,8,11
2019,488730,20,0,48,20,28
2019,488730,20,1,15,9,6
2019,488730,20,2,17,3,14
2019,488730,20,3,9,5,4
2019,488730,20,4,7,3,4
2019,488730,30,0,1,1,0
2019,488730,30,4,1,1,0
2019,488730,40,0,21,7,14
2019,488730,40,2,1,0,1
2019,488730,40,3,9,3,6
2019,488730,40,4,11,4,7
2019,488730,42,0,21,7,14
2019,488730,42,2,1,0,1
2019,488730,42,3,9,3,6
2019,488730,42,4,11,4,7
2019,488730,50,0,6,2,4
2019,488785,0,0,5,3,2
2019,488785,10,0,5,3,2
2019,488785,10,3,5,3,2
2019,488785,40,0,5,3,2
2019,488785,40,3,5,3,2
2019,488785,41,0,4,2,2
2019,488785,41,3,4,2,2
2019,488785,42,0,1,1,0
2019,488785,42,3,1,1,0
2019,488785,44,0,4,2,2
2019,488785,44,3,4,2,2
2019,488800,0,0,12,0,12
2019,488800,10,0,12,0,12
2019,488800,10,1,4,0,4
2019,488800,10,4,8,0,8
2019,488800,40,0,12,0,12
2019,488800,40,1,4,0,4
2019,488800,40,4,8,0,8
2019,488800,42,0,12,0,12
2019,488800,42,1,4,0,4
2019,488800,42,4,8,0,8
2019,489201,0,0,102,48,54
2019,489201,10,0,102,48,54
2019,489201,10,4,102,48,54
2019,489201,20,0,52,26,26
2019,489201,20,4,52,26,26
2019,489201,30,0,39,20,19
2019,489201,30,4,39,20,19
2019,489201,40,0,11,2,9
2019,489201,40,4,11,2,9
2019,489201,42,0,9,1,8
2019,489201,42,4,9,1,8
2019,489201,43,0,2,1,1
2019,489201,43,4,2,1,1
2019,489283,0,0,21,7,14
2019,489283,10,0,21,7,14
2019,489283,10,4,21,7,14
2019,489283,40,0,21,7,14
2019,489283,40,4,21,7,14
2019,489283,41,0,21,7,14
2019,489283,41,4,21,7,14
2019,489283,45,0,21,7,14
2019,489283,45,4,21,7,14
2019,489344,0,0,5,0,5
2019,489344,10,0,5,0,5
2019,489344,10,3,3,0,3
2019,489344,10,4,2,0,2
2019,489344,40,0,5,0,5
2019,489344,40,3,3,0,3
2019,489344,40,4,2,0,2
2019,489344,41,0,5,0,5
2019,489344,41,3,3,0,3
2019,489344,41,4,2,0,2
2019,489344,45,0,5,0,5
2019,489344,45,3,3,0,3
2019,489344,45,4,2,0,2
2019,489353,0,0,6,0,6
2019,489353,10,0,6,0,6
2019,489353,10,2,1,0,1
2019,489353,10,3,3,0,3
2019,489353,10,4,2,0,2
2019,489353,40,0,6,0,6
2019,489353,40,2,1,0,1
2019,489353,40,3,3,0,3
2019,489353,40,4,2,0,2
2019,489353,41,0,6,0,6
2019,489353,41,2,1,0,1
2019,489353,41,3,3,0,3
2019,489353,41,4,2,0,2
2019,489353,45,0,6,0,6
2019,489353,45,2,1,0,1
2019,489353,45,3,3,0,3
2019,489353,45,4,2,0,2
2019,489779,0,0,346,115,231
2019,489779,10,0,346,115,231
2019,489779,10,6,346,115,231
2019,489779,40,0,346,115,231
2019,489779,40,6,346,115,231
2019,489779,41,0,346,115,231
2019,489779,41,6,346,115,231
2019,489779,45,0,346,115,231
2019,489779,45,6,346,115,231
2019,489858,0,0,33,13,20
2019,489858,10,0,33,13,20
2019,489858,10,1,1,1,0
2019,489858,10,2,13,4,9
2019,489858,10,3,18,8,10
2019,489858,10,4,1,0,1
2019,489858,40,0,33,13,20
2019,489858,40,1,1,1,0
2019,489858,40,2,13,4,9
2019,489858,40,3,18,8,10
2019,489858,40,4,1,0,1
2019,489858,41,0,33,13,20
2019,489858,41,1,1,1,0
2019,489858,41,2,13,4,9
2019,489858,41,3,18,8,10
2019,489858,41,4,1,0,1
2019,489858,45,0,33,13,20
2019,489858,45,1,1,1,0
2019,489858,45,2,13,4,9
2019,489858,45,3,18,8,10
2019,489858,45,4,1,0,1
2019,489937,0,0,25,15,10
2019,489937,10,0,25,15,10
2019,489937,10,6,25,15,10
2019,489937,40,0,25,15,10
2019,489937,40,6,25,15,10
2019,489937,42,0,25,15,10
2019,489937,42,6,25,15,10
2019,490054,0,0,14,0,14
2019,490054,10,0,14,0,14
2019,490054,10,4,14,0,14
2019,490054,40,0,14,0,14
2019,490054,40,4,14,0,14
2019,490054,41,0,14,0,14
2019,490054,41,4,14,0,14
2019,490054,45,0,14,0,14
2019,490054,45,4,14,0,14
2019,490063,0,0,5,1,4
2019,490063,10,0,5,1,4
2019,490063,10,4,5,1,4
2019,490063,40,0,5,1,4
2019,490063,40,4,5,1,4
2019,490063,41,0,5,1,4
2019,490063,41,4,5,1,4
2019,490063,45,0,5,1,4
2019,490063,45,4,5,1,4
2019,490106,0,0,2,2,0
2019,490106,10,0,2,2,0
2019,490106,10,1,2,2,0
2019,490106,40,0,2,2,0
2019,490106,40,1,2,2,0
2019,490106,41,0,2,2,0
2019,490106,41,1,2,2,0
2019,490106,45,0,2,2,0
2019,490106,45,1,2,2,0
2019,490133,0,0,28,21,7
2019,490133,10,0,28,21,7
2019,490133,10,1,3,3,0
2019,490133,10,3,25,18,7
2019,490133,40,0,28,21,7
2019,490133,40,1,3,3,0
2019,490133,40,3,25,18,7
2019,490133,41,0,28,21,7
2019,490133,41,1,3,3,0
2019,490133,41,3,25,18,7
2019,490133,45,0,28,21,7
2019,490133,45,1,3,3,0
2019,490133,45,3,25,18,7
2019,490203,0,0,7,1,6
2019,490203,10,0,7,1,6
2019,490203,10,4,7,1,6
2019,490203,40,0,7,1,6
2019,490203,40,4,7,1,6
2019,490203,42,0,7,1,6
2019,490203,42,4,7,1,6
2019,490276,0,0,12,12,0
2019,490276,10,0,12,12,0
2019,490276,10,4,12,12,0
2019,490276,40,0,12,12,0
2019,490276,40,4,12,12,0
2019,490276,42,0,12,12,0
2019,490276,42,4,12,12,0
2019,490285,0,0,8,6,2
2019,490285,10,0,8,6,2
2019,490285,10,4,8,6,2
2019,490285,40,0,8,6,2
2019,490285,40,4,8,6,2
2019,490285,41,0,8,6,2
2019,490285,41,4,8,6,2
2019,490285,45,0,8,6,2
2019,490285,45,4,8,6,2
2019,490373,0,0,120,68,52
2019,490373,10,0,120,68,52
2019,490373,10,1,27,22,5
2019,490373,10,2,21,11,10
2019,490373,10,3,72,35,37
2019,490373,40,0,120,68,52
2019,490373,40,1,27,22,5
2019,490373,40,2,21,11,10
2019,490373,40,3,72,35,37
2019,490373,41,0,120,68,52
2019,490373,41,1,27,22,5
2019,490373,41,2,21,11,10
2019,490373,41,3,72,35,37
2019,490373,45,0,120,68,52
2019,490373,45,1,27,22,5
2019,490373,45,2,21,11,10
2019,490373,45,3,72,35,37
2019,490559,0,0,25,6,19
2019,490559,50,0,25,6,19
2019,490753,0,0,1,1,0
2019,490753,10,0,1,1,0
2019,490753,10,4,1,1,0
2019,490753,40,0,1,1,0
2019,490753,40,4,1,1,0
2019,490753,41,0,1,1,0
2019,490753,41,4,1,1,0
2019,490753,45,0,1,1,0
2019,490753,45,4,1,1,0
2019,490805,0,0,324,174,150
2019,490805,10,0,283,162,121
2019,490805,10,1,81,54,27
2019,490805,10,2,100,55,45
2019,490805,10,3,74,39,35
2019,490805,10,4,28,14,14
2019,490805,20,0,180,108,72
2019,490805,20,1,81,54,27
2019,490805,20,2,99,54,45
2019,490805,30,0,65,34,31
2019,490805,30,2,1,1,0
2019,490805,30,3,64,33,31
2019,490805,40,0,38,20,18
2019,490805,40,3,10,6,4
2019,490805,40,4,28,14,14
2019,490805,41,0,3,1,2
2019,490805,41,4,3,1,2
2019,490805,42,0,33,18,15
2019,490805,42,3,9,5,4
2019,490805,42,4,24,13,11
2019,490805,43,0,2,1,1
2019,490805,43,3,1,1,0
2019,490805,43,4,1,0,1
2019,490805,45,0,3,1,2
2019,490805,45,4,3,1,2
2019,490805,50,0,41,12,29
2019,490832,0,0,10,1,9
2019,490832,50,0,10,1,9
2019,490878,0,0,12,4,8
2019,490878,10,0,12,4,8
2019,490878,10,4,12,4,8
2019,490878,40,0,12,4,8
2019,490878,40,4,12,4,8
2019,490878,41,0,12,4,8
2019,490878,41,4,12,4,8
2019,490878,45,0,12,4,8
2019,490878,45,4,12,4,8
2019,490975,0,0,6,2,4
2019,490975,10,0,6,2,4
2019,490975,10,4,6,2,4
2019,490975,40,0,6,2,4
2019,490975,40,4,6,2,4
2019,490975,41,0,6,2,4
2019,490975,41,4,6,2,4
2019,490975,45,0,6,2,4
2019,490975,45,4,6,2,4
2019,491057,0,0,9,9,0
2019,491057,10,0,9,9,0
2019,491057,10,4,9,9,0
2019,491057,40,0,9,9,0
2019,491057,40,4,9,9,0
2019,491057,42,0,9,9,0
2019,491057,42,4,9,9,0
2019,491181,0,0,12,0,12
2019,491181,10,0,12,0,12
2019,491181,10,4,12,0,12
2019,491181,40,0,12,0,12
2019,491181,40,4,12,0,12
2019,491181,41,0,12,0,12
2019,491181,41,4,12,0,12
2019,491181,45,0,12,0,12
2019,491181,45,4,12,0,12
2019,491525,0,0,6,4,2
2019,491525,10,0,6,4,2
2019,491525,10,1,6,4,2
2019,491525,40,0,6,4,2
2019,491525,40,1,6,4,2
2019,491525,41,0,3,1,2
2019,491525,41,1,3,1,2
2019,491525,42,0,3,3,0
2019,491525,42,1,3,3,0
2019,491525,44,0,3,1,2
2019,491525,44,1,3,1,2
2019,491808,0,0,4,1,3
2019,491808,10,0,4,1,3
2019,491808,10,1,4,1,3
2019,491808,40,0,4,1,3
2019,491808,40,1,4,1,3
2019,491808,41,0,4,1,3
2019,491808,41,1,4,1,3
2019,491808,45,0,4,1,3
2019,491808,45,1,4,1,3
2019,491844,0,0,7,4,3
2019,491844,10,0,7,4,3
2019,491844,10,4,7,4,3
2019,491844,40,0,7,4,3
2019,491844,40,4,7,4,3
2019,491844,41,0,2,1,1
2019,491844,41,4,2,1,1
2019,491844,42,0,5,3,2
2019,491844,42,4,5,3,2
2019,491844,44,0,1,0,1
2019,491844,44,4,1,0,1
2019,491844,45,0,1,1,0
2019,491844,45,4,1,1,0
2019,492102,0,0,5,4,1
2019,492102,10,0,5,4,1
2019,492102,10,1,2,1,1
2019,492102,10,2,1,1,0
2019,492102,10,3,1,1,0
2019,492102,10,6,1,1,0
2019,492102,40,0,5,4,1
2019,492102,40,1,2,1,1
2019,492102,40,2,1,1,0
2019,492102,40,3,1,1,0
2019,492102,40,6,1,1,0
2019,492102,41,0,5,4,1
2019,492102,41,1,2,1,1
2019,492102,41,2,1,1,0
2019,492102,41,3,1,1,0
2019,492102,41,6,1,1,0
2019,492102,45,0,5,4,1
2019,492102,45,1,2,1,1
2019,492102,45,2,1,1,0
2019,492102,45,3,1,1,0
2019,492102,45,6,1,1,0
2019,492449,0,0,20,5,15
2019,492449,10,0,20,5,15
2019,492449,10,4,20,5,15
2019,492449,40,0,20,5,15
2019,492449,40,4,20,5,15
2019,492449,41,0,20,5,15
2019,492449,41,4,20,5,15
2019,492449,45,0,20,5,15
2019,492449,45,4,20,5,15
2019,492689,0,0,287,153,134
2019,492689,10,0,284,153,131
2019,492689,10,1,34,25,9
2019,492689,10,2,47,33,14
2019,492689,10,3,169,85,84
2019,492689,10,4,13,3,10
2019,492689,10,5,20,7,13
2019,492689,10,6,1,0,1
2019,492689,20,0,30,24,6
2019,492689,20,1,21,18,3
2019,492689,20,2,8,6,2
2019,492689,20,6,1,0,1
2019,492689,30,0,17,9,8
2019,492689,30,1,2,2,0
2019,492689,30,2,8,5,3
2019,492689,30,3,7,2,5
2019,492689,40,0,237,120,117
2019,492689,40,1,11,5,6
2019,492689,40,2,31,22,9
2019,492689,40,3,162,83,79
2019,492689,40,4,13,3,10
2019,492689,40,5,20,7,13
2019,492689,42,0,237,120,117
2019,492689,42,1,11,5,6
2019,492689,42,2,31,22,9
2019,492689,42,3,162,83,79
2019,492689,42,4,13,3,10
2019,492689,42,5,20,7,13
2019,492689,50,0,3,0,3
2019,492722,0,0,9,3,6
2019,492722,10,0,9,3,6
2019,492722,10,4,9,3,6
2019,492722,40,0,9,3,6
2019,492722,40,4,9,3,6
2019,492722,41,0,9,3,6
2019,492722,41,4,9,3,6
2019,492722,45,0,9,3,6
2019,492722,45,4,9,3,6
2019,492759,0,0,5,2,3
2019,492759,10,0,5,2,3
2019,492759,10,3,4,1,3
2019,492759,10,4,1,1,0
2019,492759,40,0,5,2,3
2019,492759,40,3,4,1,3
2019,492759,40,4,1,1,0
2019,492759,41,0,5,2,3
2019,492759,41,3,4,1,3
2019,492759,41,4,1,1,0
2019,492759,45,0,5,2,3
2019,492759,45,3,4,1,3
2019,492759,45,4,1,1,0
2019,492801,0,0,8,2,6
2019,492801,10,0,8,2,6
2019,492801,10,1,1,1,0
2019,492801,10,2,3,1,2
2019,492801,10,4,4,0,4
2019,492801,20,0,4,2,2
2019,492801,20,1,1,1,0
2019,492801,20,2,3,1,2
2019,492801,40,0,4,0,4
2019,492801,40,4,4,0,4
2019,492801,42,0,4,0,4
2019,492801,42,4,4,0,4
2019,493600,0,0,19,19,0
2019,493600,10,0,19,19,0
2019,493600,10,4,19,19,0
2019,493600,40,0,19,19,0
2019,493600,40,4,19,19,0
2019,493600,42,0,19,19,0
2019,493600,42,4,19,19,0
2019,493619,0,0,10,7,3
2019,493619,10,0,10,7,3
2019,493619,10,6,10,7,3
2019,493619,40,0,10,7,3
2019,493619,40,6,10,7,3
2019,493619,41,0,10,7,3
2019,493619,41,6,10,7,3
2019,493619,44,0,5,3,2
2019,493619,44,6,5,3,2
2019,493619,45,0,5,4,1
2019,493619,45,6,5,4,1
2019,493646,0,0,17,0,17
2019,493646,10,0,17,0,17
2019,493646,10,4,17,0,17
2019,493646,40,0,17,0,17
2019,493646,40,4,17,0,17
2019,493646,42,0,17,0,17
2019,493646,42,4,17,0,17
2019,493947,0,0,32,17,15
2019,493947,10,0,32,17,15
2019,493947,10,1,3,2,1
2019,493947,10,2,12,8,4
2019,493947,10,3,16,7,9
2019,493947,10,4,1,0,1
2019,493947,40,0,32,17,15
2019,493947,40,1,3,2,1
2019,493947,40,2,12,8,4
2019,493947,40,3,16,7,9
2019,493947,40,4,1,0,1
2019,493947,41,0,32,17,15
2019,493947,41,1,3,2,1
2019,493947,41,2,12,8,4
2019,493947,41,3,16,7,9
2019,493947,41,4,1,0,1
2019,493947,44,0,32,17,15
2019,493947,44,1,3,2,1
2019,493947,44,2,12,8,4
2019,493947,44,3,16,7,9
2019,493947,44,4,1,0,1
2019,494162,0,0,3,1,2
2019,494162,10,0,3,1,2
2019,494162,10,4,3,1,2
2019,494162,40,0,3,1,2
2019,494162,40,4,3,1,2
2019,494162,41,0,3,1,2
2019,494162,41,4,3,1,2
2019,494162,45,0,3,1,2
2019,494162,45,4,3,1,2
2019,494171,0,0,12,0,12
2019,494171,10,0,12,0,12
2019,494171,10,4,12,0,12
2019,494171,40,0,12,0,12
2019,494171,40,4,12,0,12
2019,494171,41,0,12,0,12
2019,494171,41,4,12,0,12
2019,494171,45,0,12,0,12
2019,494171,45,4,12,0,12
2019,494278,0,0,4,1,3
2019,494278,10,0,4,1,3
2019,494278,10,4,4,1,3
2019,494278,40,0,4,1,3
2019,494278,40,4,4,1,3
2019,494278,42,0,4,1,3
2019,494278,42,4,4,1,3
2019,494287,0,0,7,0,7
2019,494287,10,0,7,0,7
2019,494287,10,4,7,0,7
2019,494287,40,0,7,0,7
2019,494287,40,4,7,0,7
2019,494287,42,0,7,0,7
2019,494287,42,4,7,0,7
2019,494436,0,0,13,5,8
2019,494436,50,0,13,5,8
2019,494737,0,0,19,19,0
2019,494737,10,0,19,19,0
2019,494737,10,4,19,19,0
2019,494737,40,0,19,19,0
2019,494737,40,4,19,19,0
2019,494737,42,0,19,19,0
2019,494737,42,4,19,19,0
2019,494843,0,0,20,5,15
2019,494843,10,0,20,5,15
2019,494843,10,4,20,5,15
2019,494843,40,0,20,5,15
2019,494843,40,4,20,5,15
2019,494843,41,0,20,5,15
2019,494843,41,4,20,5,15
2019,494843,45,0,20,5,15
2019,494843,45,4,20,5,15
2019,494852,0,0,25,8,17
2019,494852,10,0,25,8,17
2019,494852,10,6,25,8,17
2019,494852,40,0,25,8,17
2019,494852,40,6,25,8,17
2019,494852,41,0,25,8,17
2019,494852,41,6,25,8,17
2019,494852,45,0,25,8,17
2019,494852,45,6,25,8,17
